id,att_tackle,cmp_tackle,att_tackle_def,att_tackle_mid,att_tackle_att,cmp_drib_tackle,att_drib_tackle,uns_drib_tackle,block,block_shot,block_pass,intercept,tackle_plus_intercept,clearance,error,season,comp
00844823,36,28,22,13,1,24,36,12,21,9,12,38,74,98,2,18,GER
00a6485f,46,29,27,16,3,21,31,10,32,2,30,19,65,46,1,18,GER
012c38ec,2,1,1,0,1,1,2,1,1,0,1,0,2,0,1,18,GER
016ff750,33,28,11,12,10,15,31,16,35,2,33,15,48,32,0,18,GER
0174ba21,2,2,1,0,1,0,1,1,1,1,0,0,2,1,0,18,GER
01c3aff5,36,23,11,21,4,13,32,19,16,2,14,20,56,32,0,18,GER
01e5f06e,0,0,0,0,0,0,0,0,0,0,0,0,0,0,0,18,GER
03bd0bf4,51,36,38,12,1,31,46,15,39,21,18,55,106,200,1,18,GER
042e8a49,11,10,2,6,3,5,10,5,6,0,6,7,18,1,0,18,GER
048a1cbc,10,8,5,4,1,2,5,3,3,0,3,11,21,8,0,18,GER
04c11885,44,25,19,23,2,22,37,15,38,7,31,20,64,46,1,18,GER
05439de2,23,14,11,9,3,14,20,6,21,6,15,10,33,23,0,18,GER
05d548d8,62,52,41,18,3,35,51,16,31,12,19,55,117,59,2,18,GER
061e8e23,24,19,9,12,3,6,19,13,12,0,12,6,30,7,0,18,GER
070ec0b1,51,37,33,18,0,26,34,8,49,21,28,50,101,123,1,18,GER
080440a4,79,51,55,22,2,47,61,14,40,27,13,49,128,135,3,18,GER
088ca1bd,23,16,6,13,4,11,18,7,16,1,15,10,33,35,1,18,GER
09586899,14,11,1,7,6,4,12,8,9,0,9,4,18,4,0,18,GER
096a77c4,4,2,2,2,0,4,7,3,2,0,2,0,4,1,0,18,GER
0a1cb833,1,1,1,0,0,0,0,0,2,0,2,0,1,17,4,18,GER
0a89e877,42,28,23,16,3,27,43,16,23,3,20,31,73,32,0,18,GER
0b4f388a,14,10,3,7,4,2,9,7,13,0,13,6,20,3,0,18,GER
0cf778df,4,3,1,2,1,2,5,3,3,0,3,0,4,1,0,18,GER
0d55d942,0,0,0,0,0,0,1,1,0,0,0,0,0,9,1,18,GER
0d8a37c2,1,1,1,0,0,1,2,1,0,0,0,0,1,5,1,18,GER
0dabaf14,9,6,2,5,2,4,10,6,2,0,2,4,13,3,0,18,GER
0eb5720b,45,32,32,11,2,22,37,15,28,12,16,21,66,91,3,18,GER
0f26fd24,20,14,10,6,4,6,8,2,2,0,2,9,29,7,0,18,GER
0fbecd11,49,26,20,25,4,25,41,16,39,5,34,30,79,24,0,18,GER
1025db8e,57,44,36,18,3,27,41,14,36,10,26,54,111,128,0,18,GER
106bca06,22,17,10,9,3,11,23,12,16,0,16,15,37,13,1,18,GER
11dbba47,37,24,21,14,2,12,28,16,22,1,21,10,47,7,0,18,GER
11fd2b75,20,16,8,12,0,10,18,8,14,1,13,21,41,10,0,18,GER
1238a3f9,13,10,1,5,7,4,9,5,26,5,21,2,15,20,1,18,GER
125cb9fe,19,14,15,4,0,8,10,2,8,6,2,20,39,49,1,18,GER
126cf855,0,0,0,0,0,0,0,0,0,0,0,0,0,0,0,18,GER
13ddc856,7,5,3,3,1,2,8,6,7,0,7,3,10,2,0,18,GER
140afefb,21,14,17,4,0,11,19,8,21,3,18,6,27,10,2,18,GER
15413fa5,56,42,24,29,3,28,54,26,27,5,22,29,85,22,1,18,GER
15b287da,1,1,0,1,0,0,0,0,0,0,0,1,2,0,0,18,GER
15ea94de,0,0,0,0,0,0,4,4,1,0,1,0,0,1,1,18,GER
16b8fabd,0,0,0,0,0,0,0,0,0,0,0,0,0,0,1,18,GER
16daec92,56,44,21,27,8,20,52,32,38,1,37,39,95,22,1,18,GER
17370b95,43,30,18,22,3,29,40,11,30,6,24,18,61,81,0,18,GER
17376543,0,0,0,0,0,0,0,0,0,0,0,0,0,0,0,18,GER
17780d2b,3,1,0,2,1,0,1,1,2,0,2,6,9,2,0,18,GER
1900032e,58,41,43,15,0,32,48,16,55,39,16,40,98,161,3,18,GER
1ae836b1,4,2,1,2,1,1,1,0,3,0,3,2,6,3,0,18,GER
1bcca8b8,16,16,8,8,0,6,16,10,13,0,13,13,29,12,0,18,GER
1bf33a9a,46,30,12,20,14,26,44,18,24,2,22,16,62,11,0,18,GER
1c08a3c8,35,32,15,18,2,16,23,7,22,5,17,19,54,20,0,18,GER
1cd87320,68,53,43,20,5,38,57,19,39,10,29,30,98,58,1,18,GER
1d8e9add,38,28,30,7,1,23,34,11,37,23,14,25,63,114,2,18,GER
1e43fad8,1,0,1,0,0,1,3,2,1,0,1,1,2,12,7,18,GER
20030c06,49,30,35,14,0,29,43,14,45,18,27,28,77,155,1,18,GER
2042d931,19,11,12,5,2,9,17,8,37,1,36,10,29,29,0,18,GER
21166ff4,42,26,26,15,1,15,26,11,30,20,10,54,96,91,2,18,GER
22051fbe,56,42,30,21,5,34,50,16,38,8,30,35,91,66,1,18,GER
226008f1,1,0,0,1,0,1,1,0,1,0,1,3,4,3,0,18,GER
229cd98a,5,5,0,2,3,3,4,1,12,2,10,0,5,6,0,18,GER
258a6f4d,22,15,6,12,4,4,17,13,17,3,14,6,28,21,0,18,GER
25ab9c9c,16,10,14,2,0,10,19,9,24,17,7,14,30,71,0,18,GER
2628fd2b,0,0,0,0,0,0,1,1,0,0,0,1,1,11,2,18,GER
26db8853,38,25,13,23,2,19,44,25,25,3,22,21,59,14,1,18,GER
27d2618c,1,1,1,0,0,1,2,1,0,0,0,0,1,8,5,18,GER
2903a856,23,19,12,11,0,12,26,14,15,4,11,12,35,16,0,18,GER
2930c9d8,0,0,0,0,0,0,0,0,2,1,1,1,1,4,0,18,GER
2973d8ff,8,6,1,4,3,2,4,2,4,0,4,0,8,5,0,18,GER
2979c05a,16,13,8,5,3,11,22,11,19,2,17,12,28,9,0,18,GER
29f7cfd9,11,7,3,6,2,7,10,3,5,2,3,8,19,9,0,18,GER
2a29eb9b,31,19,16,15,0,13,23,10,15,6,9,18,49,41,0,18,GER
2b350e6b,12,8,8,2,2,6,13,7,11,3,8,5,17,3,0,18,GER
2b83fa49,16,11,11,4,1,11,14,3,12,3,9,17,33,26,0,18,GER
2bcc6d52,14,9,0,10,4,4,14,10,28,3,25,10,24,9,0,18,GER
2c38b327,5,3,2,3,0,4,6,2,3,0,3,1,6,2,0,18,GER
2db2fd7b,26,18,18,7,1,19,32,13,20,12,8,21,47,52,1,18,GER
2e64bb49,0,0,0,0,0,0,0,0,0,0,0,0,0,1,0,18,GER
2e7ff968,1,1,1,0,0,1,3,2,0,0,0,0,1,12,3,18,GER
302527b2,16,14,12,4,0,6,17,11,14,9,5,11,27,60,0,18,GER
30261ba1,0,0,0,0,0,0,0,0,0,0,0,0,0,0,0,18,GER
30c220c3,54,43,20,27,7,17,38,21,28,1,27,44,98,37,1,18,GER
31114001,19,10,7,9,3,7,11,4,14,2,12,3,22,8,0,18,GER
316de854,4,3,2,1,1,2,5,3,6,0,6,1,5,1,0,18,GER
3189f61a,25,22,7,17,1,8,23,15,18,6,12,23,48,27,2,18,GER
32e96d52,0,0,0,0,0,0,1,1,0,0,0,0,0,0,0,18,GER
3376a776,38,29,32,6,0,24,26,2,27,11,16,28,66,116,2,18,GER
33a81b3d,12,7,9,2,1,5,7,2,3,0,3,6,18,10,0,18,GER
33b554b7,67,48,28,33,6,33,73,40,43,8,35,26,93,47,1,18,GER
33ec696b,0,0,0,0,0,0,3,3,0,0,0,0,0,0,0,18,GER
346d51d9,69,49,20,42,7,42,66,24,26,6,20,34,103,29,2,18,GER
34b54da7,13,11,9,4,0,8,13,5,10,1,9,6,19,25,0,18,GER
34c313d5,14,12,2,12,0,4,6,2,6,1,5,3,17,5,0,18,GER
362aa29d,0,0,0,0,0,0,0,0,0,0,0,0,0,0,0,18,GER
36a3ff67,16,8,2,12,2,5,12,7,16,3,13,4,20,9,0,18,GER
379c0717,0,0,0,0,0,0,0,0,0,0,0,0,0,0,0,18,GER
37c213cf,1,1,0,0,1,1,1,0,1,0,1,0,1,2,0,18,GER
37f606f0,52,36,19,31,2,16,40,24,38,2,36,15,67,7,0,18,GER
381e52af,2,2,1,1,0,1,2,1,3,0,3,1,3,8,0,18,GER
384d58d9,74,48,38,32,4,40,61,21,52,9,43,45,119,40,1,18,GER
3963c25b,2,2,2,0,0,1,1,0,1,1,0,3,5,8,0,18,GER
3a233281,16,12,7,4,5,8,13,5,28,0,28,15,31,6,0,18,GER
3c05e082,54,41,18,31,5,27,44,17,22,3,19,27,81,34,2,18,GER
3c6089ab,35,30,10,15,10,13,27,14,17,1,16,7,42,14,1,18,GER
3cd9e95a,3,2,3,0,0,3,6,3,0,0,0,0,3,18,2,18,GER
3dffff26,52,41,27,19,6,37,68,31,30,2,28,22,74,77,0,18,GER
3e99c613,2,2,0,2,0,2,3,1,2,2,0,0,2,8,0,18,GER
3eb0f2df,38,28,11,18,9,11,26,15,22,4,18,24,62,23,0,18,GER
3f30b506,22,15,18,4,0,15,18,3,17,9,8,21,43,68,1,18,GER
3f65898c,67,41,36,25,6,36,57,21,34,2,32,51,118,83,1,18,GER
3f7cd8f1,60,45,29,30,1,33,55,22,35,12,23,47,107,52,0,18,GER
3faa1780,36,32,18,14,4,19,36,17,18,0,18,13,49,13,2,18,GER
410ab123,44,29,14,26,4,17,32,15,23,2,21,10,54,9,0,18,GER
4114f306,60,40,31,28,1,30,64,34,35,5,30,25,85,27,1,18,GER
420c18a1,0,0,0,0,0,0,0,0,0,0,0,3,3,6,3,18,GER
433dc9a2,25,19,13,8,4,11,18,7,11,1,10,10,35,9,1,18,GER
43a166b4,6,5,2,3,1,1,7,6,16,2,14,3,9,17,0,18,GER
442b56fa,3,3,1,1,1,0,1,1,3,0,3,3,6,2,0,18,GER
44e471ca,2,2,2,0,0,2,2,0,5,0,5,0,2,0,0,18,GER
45870256,1,1,1,0,0,1,1,0,0,0,0,0,1,1,0,18,GER
45954ec7,15,10,10,4,1,7,14,7,18,13,5,31,46,50,0,18,GER
45a03961,55,40,40,13,2,36,47,11,59,34,25,70,125,192,1,18,GER
45b7edae,44,32,29,14,1,22,39,17,27,14,13,41,85,111,4,18,GER
463503e2,17,14,5,11,1,12,18,6,12,3,9,30,47,55,0,18,GER
47064058,0,0,0,0,0,0,2,2,0,0,0,1,1,15,6,18,GER
48035304,66,46,41,22,3,37,55,18,39,9,30,51,117,108,3,18,GER
482b70ad,23,16,9,11,3,6,16,10,13,3,10,13,36,15,0,18,GER
49296448,32,23,14,13,5,20,38,18,26,5,21,20,52,40,0,18,GER
496aeede,89,70,43,34,12,39,76,37,29,4,25,43,132,37,1,18,GER
49d53c68,31,27,20,10,1,21,27,6,14,5,9,28,59,56,0,18,GER
49fe9070,16,11,2,8,6,3,19,16,26,0,26,7,23,11,0,18,GER
49ffe0f2,12,9,3,9,0,4,18,14,11,2,9,6,18,12,0,18,GER
4a15e95b,0,0,0,0,0,0,3,3,0,0,0,0,0,11,3,18,GER
4b5e7e90,0,0,0,0,0,0,0,0,1,1,0,0,0,1,0,18,GER
4bd00a50,48,40,32,14,2,33,46,13,29,8,21,29,77,47,0,18,GER
4d74201d,9,7,3,6,0,3,7,4,7,0,7,3,12,6,0,18,GER
4d8cd038,5,5,0,5,0,1,3,2,6,2,4,1,6,2,0,18,GER
4e204552,1,1,1,0,0,1,2,1,1,0,1,1,2,2,0,18,GER
4f16405e,16,11,4,8,4,10,20,10,22,3,19,8,24,30,0,18,GER
500cd987,23,20,6,15,2,8,20,12,10,1,9,8,31,2,0,18,GER
50871bcc,49,32,16,23,10,20,54,34,39,1,38,28,77,18,0,18,GER
51dbeea9,81,64,41,36,4,46,68,22,42,12,30,35,116,113,2,18,GER
531807b3,7,3,2,4,1,1,2,1,3,1,2,0,7,9,0,18,GER
5343eb4e,21,15,6,8,7,5,14,9,16,0,16,6,27,12,0,18,GER
536cebe5,37,29,7,21,9,7,24,17,27,2,25,6,43,13,0,18,GER
53e07d0b,8,7,1,4,3,2,5,3,9,2,7,0,8,10,0,18,GER
53eeaf6a,7,6,1,5,1,0,1,1,4,0,4,1,8,3,0,18,GER
541cdd20,46,28,27,18,1,23,53,30,24,7,17,42,88,71,0,18,GER
549c6ba7,17,13,3,13,1,7,15,8,12,1,11,2,19,24,0,18,GER
54b4dc4e,38,30,15,17,6,12,28,16,21,3,18,14,52,21,0,18,GER
54b6ee79,11,9,3,6,2,6,9,3,10,2,8,3,14,5,0,18,GER
54e4866f,8,5,3,3,2,4,8,4,8,1,7,5,13,6,0,18,GER
5528407e,81,57,25,55,1,42,70,28,33,9,24,49,130,46,1,18,GER
55537f53,1,0,1,0,0,0,1,1,0,0,0,2,3,1,0,18,GER
555d5edd,39,26,13,21,5,19,42,23,33,4,29,17,56,7,0,18,GER
5603d397,0,0,0,0,0,0,0,0,0,0,0,0,0,2,0,18,GER
56413b1f,75,61,17,50,8,33,62,29,46,5,41,48,123,27,2,18,GER
565bf0da,40,32,29,10,1,27,36,9,29,15,14,40,80,141,1,18,GER
57200916,0,0,0,0,0,0,0,0,0,0,0,0,0,0,0,18,GER
5722eced,31,20,16,11,4,19,29,10,22,4,18,10,41,10,1,18,GER
5939baa2,95,75,45,48,2,49,74,25,39,7,32,64,159,76,1,18,GER
59e4b92e,62,47,25,28,9,33,47,14,41,18,23,36,98,96,0,18,GER
5afafbfe,32,22,11,14,7,18,27,9,6,0,6,6,38,2,0,18,GER
5b52d1f7,0,0,0,0,0,0,0,0,0,0,0,0,0,0,0,18,GER
5c4bf6ba,0,0,0,0,0,0,1,1,0,0,0,1,1,10,2,18,GER
5c899683,2,2,2,0,0,2,3,1,0,0,0,1,3,2,0,18,GER
5caa62a7,18,16,7,7,4,9,18,9,28,2,26,12,30,11,0,18,GER
5d8e331f,57,36,23,30,4,31,50,19,42,10,32,44,101,51,2,18,GER
5ddb8f9f,41,34,17,14,10,24,28,4,21,4,17,13,54,47,0,18,GER
5e1df051,2,0,0,1,1,0,0,0,1,0,1,0,2,0,0,18,GER
5e66fa06,65,49,39,21,5,41,65,24,56,27,29,39,104,112,3,18,GER
5ed9b537,32,25,20,12,0,18,23,5,14,3,11,20,52,66,0,18,GER
5f9f0531,36,24,12,20,4,11,37,26,20,2,18,14,50,18,2,18,GER
603cb947,8,6,4,3,1,3,8,5,15,0,15,6,14,7,0,18,GER
612cb8d3,12,11,6,5,1,4,13,9,8,0,8,4,16,7,0,18,GER
61b0b44d,17,11,6,10,1,6,7,1,15,3,12,5,22,14,0,18,GER
61fc9685,17,12,6,8,3,7,22,15,20,2,18,6,23,3,0,18,GER
626fab5f,22,18,14,6,2,15,16,1,12,3,9,14,36,15,0,18,GER
62ab9184,37,28,18,14,5,22,34,12,25,5,20,15,52,31,0,18,GER
6435e737,21,16,13,7,1,11,26,15,9,2,7,17,38,25,0,18,GER
64c07ae1,26,22,16,9,1,19,29,10,28,12,16,21,47,94,1,18,GER
64f69877,23,20,7,8,8,11,26,15,16,1,15,3,26,35,0,18,GER
652d4c37,33,22,8,18,7,14,32,18,13,3,10,16,49,8,0,18,GER
66385c46,26,19,8,15,3,10,20,10,25,0,25,11,37,9,0,18,GER
6743cef5,16,13,4,8,4,11,22,11,28,0,28,6,22,1,0,18,GER
677da306,42,23,27,13,2,17,24,7,23,10,13,34,76,66,6,18,GER
67cdbc0e,69,51,36,28,5,33,69,36,22,1,21,28,97,20,1,18,GER
68635c10,56,45,40,14,2,30,41,11,35,17,18,37,93,130,3,18,GER
6873f3bc,47,43,31,10,6,25,36,11,22,11,11,16,63,50,0,18,GER
68829001,26,18,7,18,1,5,22,17,23,3,20,10,36,13,1,18,GER
69374ff5,47,37,21,21,5,14,29,15,25,2,23,18,65,23,0,18,GER
699fb8db,60,42,47,13,0,38,64,26,35,17,18,53,113,140,0,18,GER
6a81a181,15,10,3,9,3,9,17,8,9,0,9,8,23,1,0,18,GER
6b85f966,1,0,0,1,0,0,0,0,1,0,1,0,1,0,0,18,GER
6bd5cd5d,34,20,26,8,0,25,35,10,36,24,12,25,59,89,1,18,GER
6bd603db,78,63,48,26,4,43,65,22,50,10,40,50,128,80,0,18,GER
6c6a3300,2,2,1,1,0,1,8,7,3,0,3,3,5,4,0,18,GER
6cafd68d,19,16,10,9,0,13,18,5,19,8,11,10,29,50,0,18,GER
6d8f8441,0,0,0,0,0,0,0,0,0,0,0,0,0,0,0,18,GER
6e33125f,18,12,13,5,0,12,16,4,21,14,7,20,38,63,1,18,GER
6ec6fde0,47,39,29,16,2,24,35,11,18,4,14,22,69,60,1,18,GER
6fd8a334,0,0,0,0,0,0,1,1,0,0,0,0,0,0,1,18,GER
70dcf94d,62,49,20,34,8,23,57,34,43,1,42,30,92,42,0,18,GER
710fbdd1,5,4,0,3,2,4,7,3,2,0,2,0,5,1,0,18,GER
7124239e,2,2,1,1,0,0,0,0,0,0,0,0,2,0,0,18,GER
715bf047,35,27,10,15,10,15,30,15,16,1,15,12,47,4,0,18,GER
71a20ce8,19,17,2,11,6,4,16,12,16,1,15,4,23,33,0,18,GER
733fecf1,5,5,1,3,1,4,11,7,6,0,6,1,6,8,0,18,GER
7364c4d1,9,5,2,6,1,4,6,2,4,0,4,3,12,0,0,18,GER
73e2f6eb,1,0,1,0,0,1,2,1,2,0,2,0,1,8,5,18,GER
7483d9f9,3,1,2,1,0,2,2,0,1,0,1,1,4,1,0,18,GER
74c7c2db,17,14,1,10,6,7,11,4,16,2,14,7,24,9,0,18,GER
74ced675,8,5,3,5,0,4,8,4,5,0,5,2,10,5,0,18,GER
74d70fb5,22,15,13,9,0,15,22,7,14,9,5,29,51,76,1,18,GER
76e5da9d,16,10,7,7,2,6,7,1,10,2,8,2,18,13,0,18,GER
77e84962,45,35,11,25,9,15,26,11,22,3,19,27,72,6,1,18,GER
78952998,5,4,1,3,1,1,2,1,0,0,0,1,6,0,0,18,GER
78e68b4d,39,32,27,11,1,22,31,9,21,9,12,32,71,64,0,18,GER
791abba1,57,43,46,10,1,40,64,24,49,29,20,57,114,238,6,18,GER
791af558,40,32,12,23,5,17,36,19,18,0,18,8,48,2,0,18,GER
79c90e45,44,30,22,18,4,20,44,24,27,8,19,34,78,45,1,18,GER
79ca3e23,16,12,7,6,3,6,14,8,15,0,15,4,20,8,0,18,GER
79fa1799,2,2,2,0,0,2,2,0,1,1,0,1,3,0,0,18,GER
7aac47fe,17,15,8,8,1,8,12,4,4,2,2,9,26,26,0,18,GER
7c104bb7,5,4,2,3,0,0,0,0,3,0,3,2,7,2,0,18,GER
7cd6badb,52,39,11,29,12,14,38,24,53,4,49,31,83,32,1,18,GER
7d3e7da6,1,0,1,0,0,1,1,0,0,0,0,3,4,6,1,18,GER
7d841904,2,1,0,1,1,0,0,0,1,1,0,1,3,0,0,18,GER
7e689867,31,24,12,13,6,21,39,18,16,0,16,9,40,19,0,18,GER
7f609bfc,28,21,18,7,3,15,27,12,15,4,11,24,52,30,0,18,GER
7f73bdf4,1,1,0,1,0,0,2,2,0,0,0,1,2,0,0,18,GER
7f97771d,31,22,11,15,5,9,19,10,16,5,11,33,64,40,1,18,GER
7fe12375,0,0,0,0,0,0,0,0,0,0,0,0,0,2,0,18,GER
80f36c88,50,40,12,33,5,28,55,27,11,1,10,18,68,7,1,18,GER
815c314f,13,12,9,4,0,5,8,3,7,7,0,17,30,52,0,18,GER
81aeb1dd,2,2,0,0,2,0,1,1,3,1,2,1,3,0,0,18,GER
821233cc,9,9,5,3,1,6,7,1,6,2,4,5,14,16,0,18,GER
826e8b63,65,47,36,19,10,34,59,25,27,8,19,33,98,65,1,18,GER
8279c033,14,11,5,9,0,2,4,2,6,1,5,3,17,5,0,18,GER
834d0be5,16,10,2,12,2,3,8,5,17,4,13,4,20,16,0,18,GER
83e0eeb4,0,0,0,0,0,0,1,1,0,0,0,0,0,0,0,18,GER
8494acc4,37,29,23,11,3,22,39,17,23,10,13,25,62,55,1,18,GER
849c826a,17,12,6,6,5,7,16,9,4,0,4,7,24,4,0,18,GER
857a5abe,36,25,23,13,0,27,39,12,35,18,17,46,82,123,2,18,GER
8593f88c,73,54,45,21,7,38,63,25,38,7,31,20,93,68,0,18,GER
861e0116,1,1,1,0,0,0,0,0,1,0,1,0,1,2,0,18,GER
863ff1ee,20,15,4,15,1,6,16,10,11,2,9,9,29,15,0,18,GER
86b30561,2,2,1,1,0,1,1,0,0,0,0,0,2,5,0,18,GER
86e119e0,51,41,23,23,5,25,57,32,31,4,27,28,79,34,0,18,GER
8778c910,0,0,0,0,0,0,0,0,0,0,0,0,0,1,0,18,GER
88d4144a,19,11,14,4,1,10,19,9,8,1,7,9,28,11,0,18,GER
88e357ef,32,22,10,18,4,13,24,11,15,1,14,8,40,9,2,18,GER
8954fddc,0,0,0,0,0,0,1,1,1,0,1,0,0,0,0,18,GER
89565ac5,35,27,21,12,2,20,30,10,27,6,21,30,65,57,1,18,GER
896c126c,17,12,9,8,0,5,9,4,11,2,9,3,20,17,0,18,GER
89ac64a6,22,15,14,8,0,15,17,2,11,4,7,7,29,43,2,18,GER
8b6e0db2,8,6,3,4,1,3,4,1,4,0,4,9,17,26,1,18,GER
8be4fd6a,2,2,0,0,2,1,4,3,7,1,6,1,3,10,0,18,GER
8c90fd7a,4,4,3,1,0,2,5,3,2,1,1,2,6,7,0,18,GER
8d78e732,5,3,1,1,3,0,3,3,6,0,6,5,10,10,0,18,GER
8e235926,35,27,13,15,7,11,26,15,27,1,26,10,45,56,0,18,GER
8e58987d,58,46,25,29,4,23,45,22,23,3,20,16,74,21,0,18,GER
8e92be30,1,0,0,1,0,0,1,1,1,0,1,0,1,0,0,18,GER
8ed9b33a,27,21,10,16,1,9,23,14,14,5,9,41,68,43,0,18,GER
8f0f2230,16,13,9,6,1,6,7,1,10,4,6,1,17,17,0,18,GER
8ff2354e,29,19,16,9,4,15,19,4,15,1,14,23,52,42,1,18,GER
9050ddc4,55,42,28,23,4,27,42,15,31,1,30,20,75,53,0,18,GER
923f4dda,3,3,0,2,1,1,5,4,9,1,8,1,4,11,0,18,GER
92948149,25,20,16,8,1,16,24,8,11,2,9,13,38,28,1,18,GER
92ffb8f9,8,6,2,6,0,4,9,5,2,1,1,4,12,0,0,18,GER
931b7c30,60,54,36,24,0,41,69,28,54,35,19,43,103,181,2,18,GER
94302c52,11,10,9,2,0,9,15,6,13,8,5,9,20,31,0,18,GER
94c18565,33,25,9,18,6,9,19,10,23,0,23,17,50,13,0,18,GER
95173427,4,4,4,0,0,3,4,1,3,2,1,3,7,3,0,18,GER
97655ccd,45,38,21,22,2,24,33,9,38,10,28,33,78,60,0,18,GER
97bfa797,16,11,4,11,1,3,7,4,17,1,16,4,20,4,0,18,GER
9853983f,13,8,2,4,7,3,9,6,4,0,4,2,15,13,0,18,GER
99b7584f,17,10,4,10,3,4,25,21,21,2,19,8,25,26,0,18,GER
99be8fb5,4,3,0,2,2,1,1,0,2,0,2,0,4,6,0,18,GER
99d6044d,0,0,0,0,0,0,0,0,1,0,1,0,0,1,0,18,GER
99de6b6f,71,56,43,27,1,31,46,15,40,18,22,51,122,114,0,18,GER
99f7e9aa,62,45,35,25,2,34,57,23,20,3,17,35,97,51,1,18,GER
9a2e0ccc,24,17,3,15,6,9,21,12,19,1,18,8,32,4,0,18,GER
9a493fb7,28,21,6,21,1,10,21,11,9,0,9,10,38,5,1,18,GER
9ab16552,38,23,19,19,0,21,33,12,40,19,21,25,63,74,0,18,GER
9ab48bde,39,23,19,11,9,16,33,17,33,0,33,10,49,34,0,18,GER
9b285700,7,6,1,3,3,4,8,4,6,0,6,0,7,1,0,18,GER
9b88e120,31,25,21,9,1,15,25,10,8,2,6,21,52,25,2,18,GER
9d12e142,1,1,1,0,0,1,3,2,1,0,1,0,1,10,4,18,GER
9efa1d25,50,43,19,24,7,14,34,20,17,1,16,8,58,9,0,18,GER
9f381d8b,13,10,0,11,2,1,5,4,6,2,4,1,14,9,0,18,GER
9f979eb2,34,23,25,9,0,23,35,12,25,13,12,34,68,110,1,18,GER
9fb640a8,22,15,7,12,3,8,15,7,10,0,10,16,38,17,1,18,GER
9fec8860,45,34,22,20,3,22,32,10,25,3,22,39,84,53,0,18,GER
a0606ae8,1,1,1,0,0,1,1,0,2,0,2,1,2,14,5,18,GER
a0e209bc,17,12,7,9,1,10,14,4,5,1,4,12,29,22,1,18,GER
a165a577,0,0,0,0,0,0,1,1,0,0,0,0,0,0,0,18,GER
a167537f,24,18,11,9,4,11,29,18,23,1,22,16,40,12,1,18,GER
a2a85828,11,11,6,4,1,5,7,2,8,2,6,2,13,3,0,18,GER
a2e7de6f,59,41,32,24,3,22,38,16,29,12,17,38,97,71,1,18,GER
a3ddb1b9,32,23,4,21,7,5,22,17,30,3,27,9,41,19,0,18,GER
a4e14205,7,5,3,3,1,0,3,3,5,0,5,5,12,1,0,18,GER
a4effc55,9,8,5,3,1,6,7,1,9,0,9,11,20,20,1,18,GER
a4f94a0d,91,67,35,44,12,44,84,40,41,5,36,35,126,52,0,18,GER
a53b661f,37,29,15,17,5,14,27,13,34,3,31,24,61,27,0,18,GER
a572e291,28,18,7,19,2,11,21,10,8,2,6,18,46,15,0,18,GER
a5ae8f8e,45,32,30,13,2,30,52,22,34,12,22,34,79,134,1,18,GER
a5d77c4e,0,0,0,0,0,0,1,1,1,0,1,0,0,0,0,18,GER
a5ec3ede,46,34,25,19,2,24,37,13,31,18,13,26,72,87,2,18,GER
a63a995f,47,34,26,20,1,21,31,10,31,12,19,24,71,74,1,18,GER
a7813ac4,45,35,21,18,6,22,44,22,46,11,35,24,69,75,2,18,GER
a93b6f4e,3,3,3,0,0,1,2,1,5,2,3,1,4,8,0,18,GER
a96e5dc0,32,21,18,13,1,21,35,14,20,2,18,12,44,48,0,18,GER
aad48be9,49,31,32,17,0,22,30,8,39,14,25,34,83,165,0,18,GER
ab700320,29,23,12,16,1,18,24,6,19,3,16,24,53,20,0,18,GER
abb42ce6,33,23,14,18,1,17,29,12,15,7,8,26,59,24,1,18,GER
acc7b7ec,12,9,4,3,5,4,12,8,5,1,4,7,19,1,1,18,GER
ad00b1a8,3,2,2,1,0,2,3,1,0,0,0,0,3,1,0,18,GER
ad3389d5,0,0,0,0,0,0,2,2,0,0,0,0,0,23,3,18,GER
aeda1f69,48,38,20,21,7,23,50,27,29,4,25,8,56,28,0,18,GER
afb0c500,0,0,0,0,0,0,0,0,0,0,0,0,0,0,0,18,GER
b1823b08,2,2,1,1,0,1,2,1,1,0,1,2,4,1,0,18,GER
b1cd37e6,48,38,16,21,11,20,41,21,42,1,41,10,58,12,0,18,GER
b3325a30,59,47,21,26,12,27,64,37,38,3,35,21,80,17,1,18,GER
b3b7f5a6,27,21,11,13,3,11,17,6,15,0,15,33,60,52,0,18,GER
b48215cd,25,16,13,10,2,12,25,13,4,0,4,9,34,11,0,18,GER
b500b384,24,20,9,12,3,6,15,9,14,1,13,14,38,8,0,18,GER
b5920350,4,4,2,1,1,2,5,3,2,0,2,3,7,2,0,18,GER
b5f63410,7,6,4,3,0,5,6,1,6,2,4,2,9,5,0,18,GER
b682dcf6,65,47,50,13,2,39,47,8,36,11,25,30,95,112,0,18,GER
b69261a0,54,40,31,19,4,30,45,15,46,12,34,27,81,71,0,18,GER
b6a6e0a7,40,30,22,13,5,26,41,15,18,3,15,17,57,27,0,18,GER
b742cc0d,28,19,16,12,0,15,24,9,14,2,12,28,56,43,1,18,GER
b825a650,43,34,17,20,6,17,40,23,37,2,35,33,76,33,0,18,GER
b82880c6,34,30,23,10,1,19,31,12,37,15,22,58,92,134,1,18,GER
b883006f,0,0,0,0,0,0,0,0,1,0,1,0,0,0,0,18,GER
b93b7882,35,30,16,15,4,20,35,15,26,3,23,19,54,32,1,18,GER
b9ebc83e,0,0,0,0,0,0,0,0,0,0,0,0,0,0,0,18,GER
ba115a40,25,16,4,16,5,7,14,7,17,4,13,8,33,39,0,18,GER
bb25c778,0,0,0,0,0,0,0,0,0,0,0,0,0,1,0,18,GER
bbb496b5,12,7,7,5,0,5,9,4,7,1,6,6,18,18,0,18,GER
bcb2ccd8,0,0,0,0,0,0,2,2,0,0,0,0,0,12,4,18,GER
bd142efb,47,34,35,12,0,30,38,8,22,13,9,34,81,112,2,18,GER
bd7d2e6d,87,71,55,29,3,56,75,19,50,21,29,34,121,132,1,18,GER
beb882a8,70,48,32,34,4,34,58,24,41,6,35,40,110,51,0,18,GER
bee0bab1,22,17,10,9,3,10,19,9,26,1,25,13,35,5,0,18,GER
c0a0c18f,1,1,0,1,0,1,1,0,0,0,0,0,1,0,0,18,GER
c0dc9fc7,4,3,2,2,0,1,7,6,3,0,3,1,5,5,0,18,GER
c18d22f5,42,33,17,21,4,21,29,8,23,3,20,18,60,44,0,18,GER
c1b7847c,57,39,31,22,4,28,57,29,37,2,35,11,68,32,0,18,GER
c2009df3,47,35,23,18,6,18,40,22,39,6,33,28,75,65,2,18,GER
c21fb312,7,5,0,3,4,1,7,6,6,0,6,2,9,7,0,18,GER
c311243f,35,26,17,18,0,14,22,8,27,3,24,29,64,27,1,18,GER
c3fd9887,10,8,1,5,4,4,7,3,8,1,7,4,14,23,0,18,GER
c419e035,0,0,0,0,0,0,0,0,2,0,2,0,0,1,0,18,GER
c50281a0,63,52,26,32,5,35,53,18,34,7,27,28,91,40,0,18,GER
c50e5bba,90,60,53,34,3,50,87,37,63,2,61,56,146,96,1,18,GER
c5fd13e9,36,25,29,6,1,26,29,3,27,16,11,21,57,104,1,18,GER
c6637acf,53,40,20,27,6,17,42,25,36,1,35,15,68,42,2,18,GER
c70b221c,1,1,0,1,0,0,3,3,2,1,1,0,1,0,0,18,GER
c8e25f78,50,40,25,18,7,22,47,25,40,12,28,44,94,55,0,18,GER
c952f633,1,1,1,0,0,1,2,1,0,0,0,0,1,3,0,18,GER
ca618d23,24,20,8,13,3,9,24,15,10,0,10,7,31,13,0,18,GER
ca8033cb,56,41,34,18,4,28,37,9,33,6,27,33,89,79,0,18,GER
cbac6ec9,0,0,0,0,0,0,0,0,0,0,0,0,0,1,1,18,GER
cc58c4ea,7,6,6,1,0,3,7,4,3,2,1,4,11,7,0,18,GER
cc86b9a3,50,34,22,22,6,14,50,36,45,4,41,41,91,35,0,18,GER
cd82452e,33,24,15,13,5,10,32,22,30,2,28,10,43,26,0,18,GER
ce218223,27,19,8,13,6,10,31,21,28,3,25,15,42,14,0,18,GER
cf01fe3a,4,3,3,1,0,2,3,1,0,0,0,1,5,4,1,18,GER
d003e213,39,33,24,11,4,28,47,19,17,6,11,32,71,30,0,18,GER
d0421d25,14,10,6,7,1,6,11,5,17,10,7,19,33,56,0,18,GER
d1273f09,100,66,48,43,9,49,94,45,59,4,55,67,167,71,0,18,GER
d1661819,60,48,29,26,5,29,37,8,41,2,39,40,100,40,1,18,GER
d2416c2e,23,19,2,13,8,7,12,5,24,5,19,9,32,8,0,18,GER
d248cd8f,57,43,36,17,4,31,45,14,32,9,23,55,112,141,1,18,GER
d3096421,34,19,10,19,5,14,33,19,20,1,19,7,41,12,0,18,GER
d45472b2,3,3,1,1,1,0,0,0,0,0,0,0,3,3,0,18,GER
d459281d,24,20,17,4,3,11,16,5,15,2,13,5,29,23,0,18,GER
d4a2533d,35,24,13,15,7,12,20,8,25,2,23,7,42,4,0,18,GER
d4d0a9ad,76,61,43,26,7,46,86,40,41,6,35,46,122,65,1,18,GER
d571df78,0,0,0,0,0,0,1,1,2,1,1,1,1,0,0,18,GER
d5dd5f1f,5,5,1,1,3,2,8,6,16,1,15,3,8,1,0,18,GER
d6862409,8,6,1,5,2,2,5,3,5,1,4,3,11,6,0,18,GER
d6f6ce93,0,0,0,0,0,0,1,1,0,0,0,0,0,4,1,18,GER
d8f5dc3d,5,5,5,0,0,4,9,5,2,0,2,5,10,6,0,18,GER
d9a5d930,11,9,3,4,4,3,11,8,18,1,17,5,16,6,0,18,GER
da59a197,8,7,5,2,1,2,4,2,2,1,1,8,16,4,1,18,GER
db401046,2,1,2,0,0,2,2,0,0,0,0,1,3,16,1,18,GER
db4ed67b,38,23,11,21,6,13,30,17,18,2,16,12,50,7,0,18,GER
db7161ed,0,0,0,0,0,0,0,0,0,0,0,0,0,1,0,18,GER
dba67bc4,35,23,17,12,6,18,38,20,23,2,21,18,53,12,0,18,GER
dbf053da,5,5,2,2,1,2,7,5,8,0,8,5,10,2,0,18,GER
dc29b608,0,0,0,0,0,0,0,0,0,0,0,0,0,1,1,18,GER
dc3fa3b5,81,57,29,48,4,47,87,40,31,3,28,48,129,29,0,18,GER
dc62fbee,49,42,17,21,11,19,43,24,26,0,26,17,66,11,1,18,GER
dd669209,10,9,6,3,1,8,12,4,6,0,6,5,15,6,0,18,GER
de164de6,8,8,4,4,0,2,4,2,4,3,1,11,19,29,0,18,GER
de1a2530,0,0,0,0,0,0,0,0,0,0,0,0,0,1,0,18,GER
debc2f28,20,14,3,12,5,6,14,8,19,0,19,5,25,5,0,18,GER
df8e7b62,25,16,8,10,7,12,25,13,19,2,17,14,39,8,1,18,GER
dfb6490a,29,21,9,13,7,17,29,12,13,0,13,17,46,19,0,18,GER
dfc85b89,2,1,2,0,0,2,2,0,1,0,1,0,2,0,0,18,GER
e199d5b0,3,1,2,1,0,3,4,1,0,0,0,1,4,5,1,18,GER
e26c4233,17,11,9,8,0,13,19,6,23,11,12,24,41,66,0,18,GER
e26fcca3,91,65,41,43,7,41,74,33,45,10,35,47,138,38,1,18,GER
e27da244,20,13,15,4,1,16,22,6,11,5,6,10,30,46,0,18,GER
e280527c,38,28,12,20,6,23,49,26,23,2,21,24,62,21,1,18,GER
e33c06cf,34,25,25,7,2,24,31,7,24,16,8,33,67,58,0,18,GER
e4086af3,1,0,0,1,0,0,0,0,2,0,2,2,3,1,0,18,GER
e5a35ae9,10,6,1,8,1,3,10,7,11,0,11,3,13,2,0,18,GER
e5d652c1,6,5,2,4,0,1,4,3,1,0,1,2,8,0,0,18,GER
e5d85da8,1,1,0,0,1,0,0,0,0,0,0,1,2,0,0,18,GER
e5f63987,8,4,3,5,0,2,12,10,16,1,15,5,13,13,0,18,GER
e665a2db,5,3,2,3,0,3,4,1,2,0,2,3,8,1,0,18,GER
e6c15f6e,19,12,15,2,2,14,22,8,6,0,6,5,24,15,0,18,GER
e6c43eec,65,46,43,20,2,30,50,20,34,10,24,66,131,63,0,18,GER
e7d22eae,41,37,17,23,1,21,36,15,19,3,16,11,52,11,0,18,GER
e7d59f4f,39,27,11,21,7,13,37,24,23,0,23,19,58,11,0,18,GER
e82d2807,1,1,0,1,0,0,0,0,1,0,1,3,4,0,0,18,GER
e8385ec4,11,6,4,7,0,2,12,10,6,1,5,4,15,1,1,18,GER
e87ad81a,10,9,8,2,0,5,9,4,3,2,1,6,16,21,0,18,GER
ea003d07,0,0,0,0,0,0,2,2,1,1,0,0,0,2,0,18,GER
ea6bc03a,34,24,21,13,0,10,18,8,27,11,16,35,69,67,0,18,GER
eafac393,12,8,9,2,1,5,9,4,9,7,2,16,28,39,1,18,GER
eb61713c,0,0,0,0,0,0,0,0,0,0,0,1,1,0,0,18,GER
eba42d2b,48,38,23,21,4,19,47,28,25,3,22,54,102,11,0,18,GER
ecab64a0,89,66,33,54,2,42,64,22,31,6,25,45,134,23,0,18,GER
ecbb3fdf,22,19,8,7,7,9,18,9,13,1,12,7,29,7,1,18,GER
ee57792b,16,10,6,8,2,8,17,9,6,1,5,18,34,9,1,18,GER
f04f45a2,1,1,0,1,0,1,1,0,0,0,0,0,1,0,0,18,GER
f0797d57,30,25,23,7,0,21,28,7,20,11,9,19,49,58,1,18,GER
f24ea523,6,6,2,3,1,2,6,4,4,0,4,2,8,3,0,18,GER
f25c8e3a,65,48,25,33,7,17,43,26,26,3,23,36,101,18,0,18,GER
f261abcb,83,62,38,40,5,46,83,37,26,5,21,57,140,41,1,18,GER
f26834c7,7,5,5,1,1,3,7,4,4,0,4,1,8,8,0,18,GER
f2e3b81c,3,3,1,2,0,1,1,0,3,0,3,0,3,2,0,18,GER
f35430a4,48,38,37,10,1,28,37,9,40,22,18,36,84,85,0,18,GER
f3722c97,25,17,8,14,3,12,25,13,23,0,23,12,37,17,0,18,GER
f3cccffe,46,34,27,16,3,17,32,15,30,4,26,36,82,48,1,18,GER
f4081572,40,34,9,28,3,15,39,24,12,0,12,20,60,29,1,18,GER
f4ec4fd0,34,22,10,22,2,11,36,25,29,6,23,23,57,43,1,18,GER
f503ea63,39,28,19,19,1,18,29,11,20,3,17,21,60,19,0,18,GER
f521b80a,48,37,27,20,1,35,45,10,40,17,23,40,88,114,1,18,GER
f61c7c4e,19,16,9,5,5,13,17,4,11,0,11,7,26,3,0,18,GER
f69fba57,13,10,4,9,0,4,18,14,13,2,11,8,21,22,0,18,GER
f71890f5,1,1,1,0,0,1,1,0,0,0,0,0,1,8,1,18,GER
f7aa75bd,57,43,39,15,3,35,50,15,24,7,17,27,84,92,0,18,GER
f820504e,10,6,2,6,2,8,15,7,9,1,8,9,19,18,0,18,GER
f86ad3f5,9,8,4,4,1,7,10,3,11,1,10,9,18,17,1,18,GER
f86cabbd,18,12,16,2,0,7,13,6,20,13,7,23,41,43,1,18,GER
f93e6e94,27,18,7,18,2,10,27,17,28,2,26,17,44,33,0,18,GER
f9446dcd,17,12,3,10,4,5,22,17,9,0,9,11,28,4,1,18,GER
f956479d,0,0,0,0,0,0,0,0,1,0,1,0,0,0,0,18,GER
f972644c,17,14,8,8,1,8,17,9,5,1,4,1,18,10,0,18,GER
f9acca3a,54,41,29,20,5,32,58,26,44,8,36,28,82,58,0,18,GER
f9e7c4ac,18,13,7,5,6,8,15,7,15,1,14,14,32,7,0,18,GER
fa274d97,40,29,17,14,9,20,27,7,33,5,28,23,63,24,0,18,GER
fa661778,37,28,15,18,4,18,46,28,45,1,44,27,64,46,0,18,GER
fb2a63bb,8,7,3,4,1,5,6,1,6,1,5,4,12,4,0,18,GER
fb377d11,1,1,0,1,0,1,1,0,0,0,0,0,1,0,0,18,GER
fb59286d,36,26,18,15,3,16,40,24,31,4,27,15,51,16,0,18,GER
fbbc8e15,0,0,0,0,0,0,0,0,3,0,3,0,0,3,0,18,GER
fbffc4b1,13,11,13,0,0,6,14,8,17,12,5,14,27,43,2,18,GER
fc62f087,75,53,45,25,5,38,50,12,37,14,23,50,125,75,0,18,GER
fc93fdf1,4,4,1,3,0,3,8,5,1,0,1,2,6,2,0,18,GER
fdd5d298,1,1,1,0,0,0,0,0,1,0,1,1,2,0,0,18,GER
fe2db476,51,37,23,23,5,30,52,22,39,11,28,42,93,64,1,18,GER
fe641c1a,79,61,27,46,6,36,53,17,37,12,25,43,122,74,4,18,GER
fe888e39,0,0,0,0,0,0,1,1,2,1,1,1,1,2,0,18,GER
fed7cb61,34,23,8,23,3,12,25,13,33,2,31,19,53,23,0,18,GER
ff182fdc,7,6,2,3,2,0,3,3,10,1,9,1,8,9,0,18,GER
ffbbc83b,68,46,30,36,2,35,58,23,26,3,23,39,107,25,1,18,GER
00459419,21,16,9,8,4,7,19,12,20,3,17,13,34,35,0,18,ENG
008a6e6d,14,10,6,7,1,6,12,6,11,5,6,15,29,85,1,18,ENG
00963611,1,1,1,0,0,1,2,1,4,3,1,6,7,11,1,18,ENG
01226327,48,35,27,17,4,19,31,12,28,9,19,44,92,74,0,18,ENG
02b29014,79,52,28,42,9,27,79,52,43,10,33,54,133,61,0,18,ENG
032f894e,12,7,6,6,0,6,18,12,9,1,8,7,19,5,1,18,ENG
0356cf4f,0,0,0,0,0,0,0,0,0,0,0,0,0,1,0,18,ENG
0420d84f,14,14,9,3,2,6,11,5,16,12,4,10,24,29,2,18,ENG
0442183b,3,1,2,1,0,0,1,1,2,1,1,0,3,3,0,18,ENG
07802f7f,5,3,1,3,1,0,0,0,4,0,4,2,7,1,0,18,ENG
08aa17d0,57,32,21,28,8,16,36,20,47,6,41,48,105,80,0,18,ENG
099e666f,41,33,28,10,3,20,32,12,17,7,10,28,69,95,0,18,ENG
0c61c77c,1,0,1,0,0,0,0,0,0,0,0,0,1,0,0,18,ENG
0cc5f4a5,0,0,0,0,0,0,0,0,0,0,0,0,0,0,0,18,ENG
0d267745,58,43,35,22,1,19,44,25,21,10,11,48,106,129,3,18,ENG
0db5d2c8,55,36,40,13,2,19,45,26,49,20,29,76,131,249,5,18,ENG
0e6bc38c,42,30,21,16,5,9,32,23,31,3,28,23,65,29,1,18,ENG
0ef89a37,17,14,4,10,3,3,21,18,10,0,10,10,27,5,1,18,ENG
10072610,0,0,0,0,0,0,1,1,0,0,0,0,0,0,0,18,ENG
101da2b5,62,35,22,28,12,24,65,41,38,6,32,47,109,68,2,18,ENG
10b9fa99,1,1,0,1,0,0,0,0,0,0,0,0,1,2,0,18,ENG
111c3236,46,34,21,16,9,18,37,19,16,0,16,30,76,42,2,18,ENG
1148323a,0,0,0,0,0,0,0,0,0,0,0,0,0,4,0,18,ENG
119b9a8e,8,7,6,2,0,3,8,5,2,1,1,11,19,27,0,18,ENG
11b9265b,35,26,21,12,2,13,29,16,19,2,17,12,47,44,0,18,ENG
129af0db,13,8,0,7,6,1,21,20,17,4,13,6,19,20,0,18,ENG
12aa7661,51,31,34,14,3,18,44,26,24,8,16,29,80,95,2,18,ENG
15ea812b,46,26,36,10,0,17,38,21,55,43,12,50,96,223,2,18,ENG
15f3ec41,0,0,0,0,0,0,0,0,0,0,0,0,0,0,0,18,ENG
15fd5593,3,1,1,2,0,2,6,4,2,1,1,1,4,2,0,18,ENG
16380240,20,13,6,10,4,5,22,17,11,1,10,12,32,9,0,18,ENG
1695c659,0,0,0,0,0,0,1,1,0,0,0,1,1,0,0,18,ENG
16ceb862,9,7,2,4,3,2,8,6,1,0,1,2,11,9,0,18,ENG
1840e36d,0,0,0,0,0,0,0,0,0,0,0,0,0,8,1,18,ENG
184e4970,47,26,23,20,4,15,55,40,13,3,10,26,73,33,3,18,ENG
189cee7b,11,7,2,7,2,3,14,11,6,1,5,6,17,1,0,18,ENG
18b896d6,31,21,20,10,1,15,31,16,29,15,14,24,55,115,1,18,ENG
18e96f64,3,2,3,0,0,2,2,0,6,6,0,4,7,21,0,18,ENG
1931bde9,41,29,18,15,8,12,41,29,27,1,26,21,62,8,1,18,ENG
199ff86e,1,1,1,0,0,0,0,0,0,0,0,1,2,0,0,18,ENG
19b8b0b9,22,15,8,8,6,9,26,17,24,4,20,11,33,15,0,18,ENG
19ba6c6d,11,8,2,4,5,0,19,19,23,3,20,7,18,30,0,18,ENG
1a160ea3,34,21,20,12,2,11,27,16,28,8,20,36,70,68,0,18,ENG
1a2935f6,26,17,14,11,1,12,22,10,26,15,11,38,64,146,2,18,ENG
1a4ef233,8,4,7,1,0,3,7,4,7,3,4,7,15,21,1,18,ENG
1ae30132,17,16,9,7,1,4,11,7,22,6,16,22,39,77,0,18,ENG
1b780599,15,9,10,5,0,8,8,0,5,2,3,5,20,20,0,18,ENG
1b7ec703,0,0,0,0,0,0,1,1,1,0,1,0,0,1,0,18,ENG
1bebde9d,0,0,0,0,0,0,0,0,0,0,0,0,0,1,0,18,ENG
1bf811d4,9,5,6,3,0,4,9,5,6,2,4,9,18,16,0,18,ENG
1c7012b8,36,24,25,10,1,15,25,10,19,13,6,27,63,77,1,18,ENG
1cb49278,26,13,23,3,0,10,15,5,25,17,8,39,65,109,5,18,ENG
1d387eee,10,5,2,6,2,2,8,6,5,0,5,2,12,5,0,18,ENG
1d6ac165,3,1,1,2,0,0,3,3,6,2,4,3,6,15,0,18,ENG
1d8c99b0,25,18,10,13,2,4,16,12,16,1,15,32,57,23,0,18,ENG
1e0b6a73,49,34,26,16,7,24,43,19,29,18,11,49,98,194,4,18,ENG
1e26e376,0,0,0,0,0,0,0,0,0,0,0,0,0,0,0,18,ENG
1ecb65be,28,19,13,13,2,7,15,8,9,0,9,9,37,12,0,18,ENG
1ef37668,71,47,43,26,2,24,51,27,70,25,45,61,132,127,5,18,ENG
1f9a3a04,33,20,19,13,1,14,22,8,12,6,6,32,65,71,0,18,ENG
20b104bc,50,36,33,16,1,24,53,29,46,8,38,31,81,73,0,18,ENG
210d9ecb,2,1,2,0,0,1,1,0,5,4,1,3,5,7,0,18,ENG
21512407,52,30,29,21,2,21,44,23,31,6,25,20,72,53,1,18,ENG
21a66e33,2,1,0,2,0,1,4,3,1,1,0,1,3,1,0,18,ENG
21a66f6a,17,12,2,8,7,4,15,11,15,4,11,5,22,19,0,18,ENG
22551915,61,35,38,15,8,27,46,19,17,4,13,42,103,130,2,18,ENG
2475dcc6,46,29,16,22,8,11,35,24,38,2,36,19,65,29,1,18,ENG
24fae784,6,4,5,1,0,3,3,0,2,0,2,3,9,6,0,18,ENG
25b166d0,2,2,0,1,1,0,1,1,4,1,3,1,3,2,0,18,ENG
25f50295,32,22,23,8,1,16,24,8,24,14,10,39,71,127,0,18,ENG
2649ff32,15,10,6,8,1,3,17,14,10,2,8,8,23,7,0,18,ENG
26679cdf,18,11,10,7,1,6,26,20,11,4,7,12,30,9,0,18,ENG
2691c772,21,14,1,14,6,5,29,24,26,5,21,2,23,19,0,18,ENG
26f6dca8,20,11,6,11,3,2,34,32,7,1,6,30,50,5,2,18,ENG
27d7453c,7,5,3,4,0,2,10,8,10,1,9,2,9,12,0,18,ENG
282f75f3,67,33,49,18,0,25,48,23,73,58,15,71,138,230,2,18,ENG
285a3d44,36,20,25,9,2,13,25,12,33,23,10,40,76,224,1,18,ENG
29733c72,18,13,4,12,2,2,24,22,10,0,10,15,33,10,1,18,ENG
2973d8ff,5,4,2,3,0,1,3,2,0,0,0,1,6,3,0,18,ENG
2acd49b9,23,17,14,5,4,9,12,3,11,1,10,9,32,23,1,18,ENG
2afc7272,67,35,37,30,0,26,69,43,33,12,21,35,102,25,2,18,ENG
2b114be3,27,21,14,7,6,8,22,14,22,1,21,13,40,6,0,18,ENG
2b471f99,55,40,21,29,5,12,30,18,18,6,12,36,91,36,4,18,ENG
2b622f01,4,2,3,0,1,1,3,2,2,0,2,2,6,2,0,18,ENG
2b91cf8e,25,17,17,8,0,11,21,10,15,10,5,17,42,144,1,18,ENG
2baec6ce,0,0,0,0,0,0,0,0,0,0,0,0,0,0,0,18,ENG
2c0f8e9e,41,26,19,8,14,11,59,48,13,2,11,23,64,1,0,18,ENG
2ce2508a,85,52,40,37,8,31,86,55,50,12,38,71,156,81,3,18,ENG
2e4f5f03,31,17,19,9,3,15,29,14,22,2,20,26,57,56,0,18,ENG
2f4c5a52,19,16,10,7,2,6,23,17,18,5,13,9,28,6,0,18,ENG
2f72f79e,34,26,18,10,6,12,29,17,21,4,17,31,65,81,0,18,ENG
2f7acede,15,12,8,5,2,8,16,8,12,2,10,11,26,10,1,18,ENG
2f90f6b8,58,45,18,32,8,15,39,24,33,5,28,21,79,23,0,18,ENG
2ff964a0,37,24,15,19,3,7,41,34,33,6,27,19,56,27,0,18,ENG
31dce0c8,0,0,0,0,0,0,0,0,0,0,0,0,0,0,0,18,ENG
3201b03d,38,22,31,6,1,22,45,23,31,19,12,34,72,132,1,18,ENG
3233eefd,33,23,24,9,0,8,21,13,30,20,10,39,72,179,1,18,ENG
32e7ce92,0,0,0,0,0,0,0,0,0,0,0,1,1,4,0,18,ENG
3312f911,57,36,35,20,2,23,43,20,34,8,26,24,81,67,0,18,ENG
33508c78,68,49,30,29,9,18,69,51,25,4,21,22,90,26,2,18,ENG
3515d404,23,16,9,11,3,3,27,24,29,1,28,8,31,31,0,18,ENG
356a9a62,15,11,10,5,0,6,11,5,9,1,8,12,27,45,1,18,ENG
3680d723,3,2,0,3,0,0,0,0,4,2,2,2,5,15,0,18,ENG
36c2ca73,0,0,0,0,0,0,0,0,0,0,0,1,1,8,0,18,ENG
3727dd3c,39,24,17,21,1,8,26,18,26,5,21,28,67,33,0,18,ENG
381d7d54,7,6,5,0,2,2,9,7,2,0,2,1,8,2,0,18,ENG
3831b9fe,39,31,27,8,4,20,42,22,27,12,15,42,81,126,0,18,ENG
38aefb74,2,1,0,2,0,1,1,0,1,1,0,1,3,0,0,18,ENG
38c7feef,37,24,15,16,6,8,24,16,29,2,27,26,63,22,0,18,ENG
3925dbd6,1,1,0,1,0,0,1,1,1,0,1,0,1,2,0,18,ENG
3935e52e,49,37,28,13,8,20,39,19,15,3,12,26,75,56,0,18,ENG
39583cfd,5,3,2,2,1,2,11,9,0,0,0,4,9,3,1,18,ENG
3a24769f,0,0,0,0,0,0,1,1,3,1,2,0,0,2,0,18,ENG
3a949a25,0,0,0,0,0,0,0,0,0,0,0,0,0,3,2,18,ENG
3bb625ac,17,9,10,7,0,9,21,12,13,1,12,16,33,8,0,18,ENG
3bb7b8b4,1,1,1,0,0,0,0,0,1,0,1,0,1,15,6,18,ENG
3be1a627,0,0,0,0,0,0,1,1,2,0,2,1,1,1,0,18,ENG
3c066877,1,1,0,1,0,0,0,0,0,0,0,0,1,0,0,18,ENG
3ca7254a,20,11,6,8,6,5,18,13,13,1,12,13,33,7,1,18,ENG
3cefa66a,44,32,18,21,5,13,30,17,18,4,14,12,56,24,3,18,ENG
3e5e4e63,37,19,28,7,2,19,29,10,63,45,18,54,91,232,4,18,ENG
3e9e06cb,38,28,25,7,6,13,36,23,39,26,13,52,90,140,0,18,ENG
3ea50f67,0,0,0,0,0,0,0,0,0,0,0,0,0,0,0,18,ENG
3eb22ec9,27,18,11,9,7,6,30,24,17,1,16,10,37,12,1,18,ENG
3f2d59fe,64,46,42,18,4,28,54,26,23,15,8,57,121,175,2,18,ENG
3fe6bd8c,28,19,21,7,0,13,27,14,27,10,17,23,51,107,1,18,ENG
407feb71,1,0,1,0,0,0,0,0,3,0,3,1,2,0,0,18,ENG
4115ce4e,6,3,6,0,0,3,6,3,2,1,1,5,11,27,0,18,ENG
422862ea,9,6,2,6,1,2,5,3,6,5,1,6,15,6,0,18,ENG
43458538,36,26,11,17,8,4,27,23,23,3,20,4,40,14,1,18,ENG
434ad289,0,0,0,0,0,0,0,0,0,0,0,0,0,1,0,18,ENG
436a9dd0,56,29,32,20,4,20,69,49,33,6,27,34,90,22,2,18,ENG
43a166b4,0,0,0,0,0,0,0,0,0,0,0,0,0,0,0,18,ENG
4468ec10,17,15,6,9,2,4,23,19,27,0,27,11,28,14,1,18,ENG
44781702,47,33,13,21,13,25,48,23,24,5,19,28,75,70,1,18,ENG
450ab6fc,31,19,19,11,1,12,19,7,33,24,9,28,59,232,1,18,ENG
4535e4bb,0,0,0,0,0,0,3,3,0,0,0,3,3,10,3,18,ENG
453f566a,6,3,2,3,1,2,8,6,5,0,5,0,6,2,0,18,ENG
45963054,15,9,3,7,5,1,8,7,21,1,20,2,17,17,0,18,ENG
45da6694,46,31,29,10,7,22,52,30,16,5,11,33,79,61,0,18,ENG
46b5375e,0,0,0,0,0,0,0,0,0,0,0,0,0,0,0,18,ENG
46ee5234,41,24,27,10,4,16,30,14,32,12,20,48,89,102,0,18,ENG
47a34c4f,12,6,6,3,3,6,10,4,11,0,11,10,22,12,2,18,ENG
47b7e3af,102,60,39,51,12,23,55,32,39,5,34,38,140,52,0,18,ENG
4806ec67,0,0,0,0,0,0,2,2,0,0,0,2,2,26,5,18,ENG
4830e0af,5,4,2,0,3,1,7,6,4,0,4,1,6,2,0,18,ENG
495945ef,13,10,10,3,0,2,16,14,17,9,8,19,32,16,0,18,ENG
49b05a83,2,0,0,1,1,0,0,0,3,0,3,2,4,0,1,18,ENG
4a537185,10,7,3,5,2,3,13,10,5,0,5,0,10,3,0,18,ENG
4ab53cdb,31,21,12,11,8,9,50,41,32,2,30,19,50,41,0,18,ENG
4b40d9ca,0,0,0,0,0,0,1,1,0,0,0,0,0,21,0,18,ENG
4b511457,93,64,41,44,8,32,100,68,59,19,40,69,162,77,2,18,ENG
4c370d81,65,50,9,36,20,8,58,50,40,2,38,18,83,10,0,18,ENG
4cde5509,2,1,1,0,1,0,1,1,0,0,0,0,2,1,0,18,ENG
4d034881,9,6,2,6,1,2,17,15,12,1,11,6,15,3,0,18,ENG
4e9a0555,7,3,2,3,2,3,13,10,12,4,8,0,7,16,0,18,ENG
4f974391,34,21,12,20,2,19,30,11,42,17,25,44,78,117,1,18,ENG
5167c97e,0,0,0,0,0,0,0,0,0,0,0,0,0,0,0,18,ENG
51a3caf1,6,4,5,1,0,6,8,2,4,1,3,7,13,6,0,18,ENG
51b41c5c,58,40,34,21,3,15,44,29,18,7,11,61,119,59,1,18,ENG
51cf8561,23,16,11,9,3,7,13,6,3,0,3,6,29,7,0,18,ENG
52105203,10,5,8,2,0,7,17,10,17,14,3,23,33,98,1,18,ENG
5271c8f1,5,4,2,0,3,5,7,2,5,0,5,8,13,9,0,18,ENG
53538b39,40,28,23,14,3,10,55,45,18,4,14,20,60,22,0,18,ENG
53af52f3,1,0,1,0,0,1,3,2,1,0,1,0,1,18,5,18,ENG
53cad200,80,59,47,26,7,27,54,27,48,22,26,54,134,135,1,18,ENG
5540c9dc,58,38,46,12,0,26,50,24,55,37,18,60,118,278,2,18,ENG
562eed5c,11,9,7,4,0,4,15,11,27,14,13,22,33,104,0,18,ENG
56f6f826,2,2,1,1,0,1,4,3,3,3,0,1,3,9,0,18,ENG
57c433c8,5,2,1,4,0,0,3,3,3,0,3,1,6,2,0,18,ENG
57df7a11,58,37,36,16,6,25,58,33,25,2,23,26,84,38,1,18,ENG
580d52dd,39,24,18,17,4,12,49,37,23,5,18,45,84,23,0,18,ENG
59bf127b,64,41,25,32,7,16,48,32,23,6,17,37,101,38,4,18,ENG
59e6e5bf,15,8,5,3,7,2,15,13,13,1,12,10,25,23,1,18,ENG
5a1900a4,53,33,22,23,8,14,53,39,37,8,29,29,82,18,1,18,ENG
5a4280b1,32,23,28,4,0,16,26,10,25,14,11,19,51,129,1,18,ENG
5acc4a10,43,26,15,25,3,19,47,28,21,1,20,43,86,38,0,18,ENG
5b54bf3b,1,0,1,0,0,1,4,3,0,0,0,0,1,4,0,18,ENG
5bddccc9,30,26,13,12,5,8,19,11,14,1,13,2,32,9,0,18,ENG
5be28712,2,2,0,2,0,0,1,1,4,3,1,6,8,22,2,18,ENG
5c2b4f07,48,27,27,13,8,11,31,20,20,1,19,31,79,54,1,18,ENG
5dbefa9d,34,24,9,20,5,8,32,24,18,1,17,9,43,11,0,18,ENG
5eae500a,7,4,1,3,3,0,13,13,9,2,7,3,10,22,2,18,ENG
5eebbfdf,31,17,16,13,2,12,35,23,12,1,11,14,45,11,0,18,ENG
5eecec3d,15,11,11,4,0,4,11,7,8,5,3,19,34,44,0,18,ENG
5f09991f,47,32,29,15,3,16,34,18,24,5,19,47,94,64,2,18,ENG
601ef102,6,4,0,6,0,3,6,3,3,0,3,0,6,0,0,18,ENG
61abe9b6,5,4,2,2,1,1,5,4,4,1,3,2,7,15,0,18,ENG
6265208f,22,17,10,11,1,7,34,27,25,2,23,11,33,39,0,18,ENG
62a0089e,1,0,0,0,1,1,1,0,0,0,0,0,1,0,0,18,ENG
63d17038,0,0,0,0,0,0,1,1,0,0,0,0,0,0,0,18,ENG
6421ec64,25,17,9,11,5,10,39,29,9,1,8,16,41,6,2,18,ENG
64b08de7,9,9,3,4,2,1,5,4,9,2,7,5,14,3,1,18,ENG
653ee42d,104,62,63,39,2,32,114,82,53,16,37,63,167,69,1,18,ENG
67d23ab0,35,27,14,16,5,10,29,19,20,0,20,12,47,12,0,18,ENG
6813ac34,96,67,54,28,14,48,98,50,72,13,59,61,157,152,0,18,ENG
68796d61,25,16,3,18,4,4,28,24,15,1,14,8,33,6,0,18,ENG
691bef82,6,4,3,2,1,2,7,5,3,0,3,7,13,14,0,18,ENG
6992791d,16,8,8,4,4,7,15,8,21,6,15,6,22,15,0,18,ENG
6adbc307,29,20,24,5,0,13,25,12,30,18,12,41,70,108,2,18,ENG
6b47c5db,138,89,68,65,5,45,119,74,67,10,57,51,189,103,2,18,ENG
6c679c6d,39,26,25,11,3,16,55,39,29,3,26,23,62,16,0,18,ENG
6c96b263,2,2,2,0,0,2,4,2,0,0,0,1,3,3,0,18,ENG
6ca5ec4b,19,15,8,8,3,5,18,13,19,1,18,7,26,10,1,18,ENG
6cc47ae1,1,0,0,1,0,0,1,1,0,0,0,1,2,1,1,18,ENG
6cdd8245,48,26,25,16,7,21,52,31,11,1,10,25,73,21,0,18,ENG
6d6f09dc,4,3,1,2,1,2,7,5,5,0,5,1,5,0,0,18,ENG
6dfd5af0,22,16,8,9,5,6,24,18,13,0,13,11,33,3,0,18,ENG
6eaed4eb,34,20,26,8,0,14,30,16,21,15,6,46,80,154,0,18,ENG
6fd8a334,13,10,13,0,0,7,13,6,16,8,8,16,29,46,0,18,ENG
715fc0fe,8,7,4,1,3,2,7,5,5,0,5,4,12,8,0,18,ENG
71672fa0,1,1,1,0,0,1,1,0,0,0,0,0,1,23,7,18,ENG
71ef519e,46,32,22,18,6,14,53,39,37,5,32,35,81,63,1,18,ENG
72c812f3,117,93,65,41,11,35,86,51,59,9,50,62,179,48,1,18,ENG
7314bba4,31,19,22,9,0,7,20,13,66,59,7,50,81,332,5,18,ENG
73489527,33,22,12,18,3,10,46,36,35,7,28,46,79,25,0,18,ENG
7391c2d9,25,15,18,4,3,10,22,12,16,2,14,12,37,49,1,18,ENG
73d9bdc7,2,0,0,1,1,0,12,12,7,4,3,1,3,31,0,18,ENG
74b2cd7e,30,24,18,10,2,8,18,10,40,27,13,58,88,197,1,18,ENG
74e12f1e,60,44,25,27,8,20,62,42,36,15,21,41,101,86,1,18,ENG
7527558b,31,24,16,12,3,8,33,25,7,0,7,15,46,16,0,18,ENG
758dd7f0,36,22,25,8,3,15,30,15,25,6,19,18,54,65,0,18,ENG
75f2c59f,10,8,4,5,1,2,13,11,16,0,16,9,19,6,0,18,ENG
76c131da,7,6,5,1,1,3,8,5,4,0,4,1,8,2,0,18,ENG
76dd1480,38,26,15,14,9,16,57,41,37,7,30,34,72,36,0,18,ENG
76eca7e2,0,0,0,0,0,0,0,0,1,0,1,2,2,5,1,18,ENG
76fa5f80,1,1,1,0,0,0,1,1,1,0,1,0,1,4,0,18,ENG
78803d03,30,17,21,6,3,14,22,8,17,11,6,38,68,76,0,18,ENG
78b8ac63,4,3,0,2,2,1,3,2,2,0,2,0,4,3,0,18,ENG
7914b9fe,29,21,15,9,5,10,21,11,21,14,7,27,56,127,1,18,ENG
7a11550b,58,45,32,23,3,21,40,19,19,8,11,34,92,57,1,18,ENG
7a1f2c08,11,8,6,4,1,0,2,2,7,1,6,12,23,13,0,18,ENG
7b4de647,0,0,0,0,0,0,2,2,0,0,0,2,2,16,7,18,ENG
7ba6d84e,0,0,0,0,0,0,1,1,1,0,1,0,0,9,3,18,ENG
7bb5f40e,27,16,17,5,5,10,29,19,21,1,20,24,51,43,0,18,ENG
7bc34048,21,12,18,3,0,10,19,9,16,11,5,21,42,77,1,18,ENG
7c104bb7,1,1,0,1,0,0,2,2,2,0,2,1,2,3,0,18,ENG
7c2a398c,6,3,1,5,0,1,3,2,1,0,1,0,6,2,0,18,ENG
7c4243d4,20,13,8,8,4,10,37,27,6,0,6,13,33,8,1,18,ENG
7ca2d989,0,0,0,0,0,0,0,0,0,0,0,0,0,1,0,18,ENG
7ca9f0f0,1,1,1,0,0,1,3,2,2,2,0,0,1,1,0,18,ENG
7d2d3329,9,5,6,3,0,2,10,8,12,1,11,8,17,4,0,18,ENG
7d41b619,16,12,5,8,3,6,23,17,33,12,21,16,32,52,2,18,ENG
7dbbe367,35,19,17,14,4,15,45,30,19,11,8,14,49,34,0,18,ENG
7f4f3e49,48,36,26,15,7,8,21,13,22,0,22,14,62,76,1,18,ENG
7fe90ccd,26,11,14,9,3,11,25,14,11,2,9,6,32,26,0,18,ENG
7fec31a0,50,25,19,26,5,19,68,49,36,8,28,25,75,35,0,18,ENG
80c31c97,35,25,26,8,1,12,18,6,41,27,14,31,66,146,1,18,ENG
810e3c74,30,21,10,13,7,5,27,22,18,3,15,9,39,13,0,18,ENG
819aa8e7,39,21,11,15,13,12,54,42,36,1,35,24,63,28,0,18,ENG
819b3158,27,15,8,14,5,9,37,28,14,1,13,16,43,12,0,18,ENG
82b1198a,0,0,0,0,0,0,0,0,0,0,0,0,0,1,0,18,ENG
82dbf623,6,3,1,2,3,1,2,1,0,0,0,0,6,6,0,18,ENG
82e34b69,15,11,3,8,4,3,11,8,14,1,13,5,20,20,0,18,ENG
8309b068,7,3,6,1,0,4,6,2,1,1,0,1,8,4,0,18,ENG
833fb62e,2,1,0,1,1,0,3,3,1,0,1,1,3,0,0,18,ENG
8397a50c,1,1,1,0,0,0,0,0,2,2,0,6,7,13,1,18,ENG
839c14e1,54,34,40,10,4,22,31,9,32,8,24,24,78,109,2,18,ENG
85b011bb,0,0,0,0,0,0,2,2,0,0,0,1,1,3,3,18,ENG
861e0116,12,6,6,4,2,6,9,3,7,2,5,5,17,19,0,18,ENG
867239d3,33,23,13,15,5,5,33,28,16,0,16,21,54,26,0,18,ENG
86dd77d1,47,31,20,21,6,18,31,13,21,2,19,29,76,75,2,18,ENG
87449a74,1,1,0,1,0,1,2,1,0,0,0,0,1,0,0,18,ENG
87575fd9,15,8,6,8,1,2,11,9,12,3,9,14,29,19,1,18,ENG
875898c7,60,51,48,12,0,36,61,25,32,17,15,40,100,177,2,18,ENG
87935cf3,21,14,15,5,1,9,16,7,19,11,8,30,51,101,3,18,ENG
8816329f,17,16,10,7,0,7,20,13,35,5,30,13,30,27,1,18,ENG
892d5bb1,39,27,16,17,6,10,63,53,32,1,31,18,57,15,0,18,ENG
89cbc961,0,0,0,0,0,0,0,0,1,1,0,3,3,14,0,18,ENG
89d10e53,15,11,6,7,2,8,15,7,12,6,6,9,24,15,0,18,ENG
89e4b358,8,5,5,3,0,4,5,1,8,6,2,3,11,38,0,18,ENG
8a7ff278,35,30,23,12,0,16,28,12,27,11,16,28,63,76,0,18,ENG
8aa5f52c,45,26,33,12,0,14,34,20,25,16,9,45,90,133,4,18,ENG
8aadeaef,0,0,0,0,0,0,0,0,0,0,0,0,0,0,0,18,ENG
8abd0c03,23,18,15,3,5,11,24,13,5,1,4,20,43,30,0,18,ENG
8ae9869d,83,61,56,27,0,24,41,17,54,30,24,75,158,275,1,18,ENG
8aec0537,36,24,18,16,2,10,67,57,31,5,26,14,50,20,0,18,ENG
8b04d6c1,45,29,24,18,3,13,56,43,30,3,27,37,82,26,1,18,ENG
8b0d6fe9,4,3,2,1,1,2,5,3,2,1,1,4,8,7,0,18,ENG
8b6e0db2,2,1,1,1,0,1,1,0,0,0,0,0,2,0,0,18,ENG
8b788c01,15,13,9,2,4,3,12,9,5,1,4,3,18,7,0,18,ENG
8b8e759d,2,2,0,1,1,2,2,0,0,0,0,0,2,0,0,18,ENG
8b9ebd03,22,17,7,12,3,0,16,16,13,1,12,10,32,10,0,18,ENG
8cceca90,7,5,5,2,0,3,12,9,7,2,5,10,17,23,0,18,ENG
8d228291,7,5,1,3,3,3,10,7,15,3,12,1,8,10,0,18,ENG
8d3c902d,71,49,43,26,2,23,62,39,31,11,20,32,103,56,1,18,ENG
8df7a2fb,33,20,22,11,0,16,29,13,51,42,9,33,66,217,1,18,ENG
8e65a5e5,0,0,0,0,0,0,0,0,0,0,0,1,1,4,0,18,ENG
8f62b6ee,1,1,1,0,0,1,4,3,0,0,0,2,3,34,8,18,ENG
8f866fe8,3,2,0,2,1,1,15,14,3,0,3,4,7,6,0,18,ENG
8f898ba8,5,1,0,3,2,0,1,1,4,0,4,0,5,5,0,18,ENG
90f87966,11,6,5,6,0,2,6,4,12,9,3,14,25,37,1,18,ENG
914ab9a1,42,25,28,14,0,21,36,15,37,23,14,34,76,185,0,18,ENG
91bdc54a,0,0,0,0,0,0,0,0,0,0,0,1,1,5,0,18,ENG
9228b07c,30,20,14,11,5,12,54,42,19,5,14,24,54,21,0,18,ENG
92e7e919,17,10,2,12,3,2,28,26,18,0,18,10,27,12,0,18,ENG
9306d5ea,93,64,29,59,5,26,89,63,51,12,39,69,162,48,0,18,ENG
9328b835,0,0,0,0,0,0,0,0,0,0,0,0,0,10,2,18,ENG
935e6b8f,51,33,13,32,6,18,52,34,33,2,31,31,82,27,0,18,ENG
939bc634,1,0,1,0,0,1,5,4,0,0,0,4,5,13,6,18,ENG
93ee387c,4,3,2,2,0,1,3,2,0,0,0,3,7,4,0,18,ENG
94b2001f,43,29,25,12,6,19,35,16,15,6,9,19,62,33,0,18,ENG
960acc0a,53,28,22,25,6,16,41,25,21,9,12,13,66,18,0,18,ENG
96bb8cc2,32,21,14,17,1,8,28,20,17,3,14,7,39,29,0,18,ENG
96e0490d,16,14,7,7,2,6,19,13,5,3,2,7,23,23,0,18,ENG
97572117,64,39,43,17,4,28,43,15,20,9,11,27,91,93,0,18,ENG
977ffc24,7,5,1,5,1,2,7,5,7,0,7,3,10,3,0,18,ENG
980522ec,51,29,16,30,5,17,59,42,38,1,37,31,82,21,0,18,ENG
984a5a64,5,4,4,1,0,2,4,2,2,0,2,3,8,8,0,18,ENG
987718f5,34,19,21,11,2,10,29,19,31,7,24,29,63,34,1,18,ENG
989d5705,16,10,4,10,2,3,17,14,11,2,9,8,24,21,1,18,ENG
98be0d02,32,21,17,14,1,11,36,25,14,0,14,14,46,14,0,18,ENG
99813635,3,1,3,0,0,2,10,8,3,0,3,1,4,1,0,18,ENG
9a104dee,6,3,2,2,2,1,11,10,9,4,5,1,7,13,0,18,ENG
9a8c6673,3,3,0,3,0,1,2,1,1,0,1,1,4,1,0,18,ENG
9a9c05db,55,34,26,27,2,28,60,32,35,15,20,39,94,141,2,18,ENG
9aa186b2,21,16,7,10,4,12,30,18,22,10,12,17,38,45,0,18,ENG
9aacb284,7,3,2,4,1,2,10,8,6,1,5,13,20,13,2,18,ENG
9c318325,15,10,3,7,5,4,20,16,10,2,8,8,23,5,0,18,ENG
9c94165b,18,15,10,7,1,11,18,7,16,2,14,4,22,22,1,18,ENG
9d107085,48,34,32,12,4,22,41,19,34,7,27,31,79,114,0,18,ENG
9d597f08,0,0,0,0,0,0,0,0,0,0,0,0,0,0,0,18,ENG
9dab6e3b,1,1,1,0,0,1,1,0,0,0,0,0,1,0,0,18,ENG
9dbb75ca,24,17,6,11,7,4,27,23,19,3,16,7,31,5,0,18,ENG
9e525177,30,19,20,7,3,15,19,4,18,7,11,15,45,45,0,18,ENG
9e53837d,3,2,2,1,0,0,1,1,3,3,0,1,4,10,0,18,ENG
9f472354,25,20,1,19,5,10,30,20,14,2,12,12,37,29,0,18,ENG
9f736ed2,14,12,7,5,2,6,22,16,5,0,5,10,24,11,0,18,ENG
9fa0a0b8,0,0,0,0,0,0,1,1,1,0,1,0,0,0,0,18,ENG
9feb8f24,96,62,41,43,12,27,87,60,43,9,34,58,154,68,1,18,ENG
a0666d3e,34,18,7,18,9,9,19,10,16,1,15,15,49,6,0,18,ENG
a1232f4e,17,10,10,5,2,5,12,7,11,6,5,25,42,58,1,18,ENG
a179d516,0,0,0,0,0,0,0,0,0,0,0,0,0,3,0,18,ENG
a1d5bd30,14,11,4,5,5,6,18,12,18,0,18,8,22,19,0,18,ENG
a32204c9,0,0,0,0,0,0,1,1,1,0,1,2,2,0,0,18,ENG
a36d4785,0,0,0,0,0,0,1,1,0,0,0,0,0,0,0,18,ENG
a39bb753,6,3,2,3,1,3,21,18,11,0,11,3,9,0,0,18,ENG
a3b03921,4,2,4,0,0,1,1,0,3,0,3,1,5,2,0,18,ENG
a440d8ca,5,3,3,2,0,2,5,3,1,0,1,9,14,30,0,18,ENG
a498e276,23,13,17,6,0,9,18,9,31,23,8,36,59,173,3,18,ENG
a53649b7,1,1,0,1,0,0,0,0,0,0,0,0,1,0,0,18,ENG
a634b9d2,9,6,8,1,0,6,9,3,3,2,1,8,17,4,0,18,ENG
a65ce836,67,54,32,29,6,18,43,25,32,4,28,28,95,37,1,18,ENG
a67a09fb,41,27,25,12,4,14,40,26,23,3,20,58,99,86,0,18,ENG
a6951bf8,5,4,2,3,0,1,3,2,1,0,1,3,8,2,0,18,ENG
a6de6361,0,0,0,0,0,0,0,0,0,0,0,0,0,0,0,18,ENG
a6e316c1,20,13,14,6,0,12,27,15,7,3,4,19,39,58,2,18,ENG
a9142dc3,42,33,33,8,1,21,34,13,17,9,8,31,73,74,1,18,ENG
aa51343f,4,3,1,2,1,0,1,1,0,0,0,0,4,3,0,18,ENG
aa5859cb,14,8,4,8,2,3,21,18,15,3,12,11,25,36,0,18,ENG
aa8e289e,9,5,3,6,0,2,9,7,14,2,12,9,18,10,0,18,ENG
ab070c55,11,4,3,7,1,2,17,15,15,3,12,3,14,44,0,18,ENG
ab651565,32,17,16,14,2,12,31,19,20,0,20,15,47,17,2,18,ENG
ab7263c1,1,1,0,1,0,0,1,1,2,0,2,1,2,3,0,18,ENG
abe66106,23,13,9,7,7,3,20,17,11,1,10,7,30,5,0,18,ENG
ac05f970,15,9,7,6,2,4,14,10,14,0,14,13,28,16,0,18,ENG
ac7d7378,8,7,6,2,0,3,7,4,7,4,3,11,19,16,0,18,ENG
ac861941,61,43,15,39,7,17,42,25,32,11,21,48,109,93,7,18,ENG
ad1ffcfd,23,18,13,10,0,9,36,27,25,11,14,19,42,49,1,18,ENG
ad7b19ef,70,44,39,28,3,24,97,73,47,4,43,79,149,29,4,18,ENG
ae0a7ddf,57,33,39,14,4,26,54,28,37,7,30,44,101,114,0,18,ENG
af721f98,10,6,2,5,3,4,19,15,3,2,1,2,12,6,0,18,ENG
aff418dc,9,5,2,5,2,5,17,12,2,0,2,9,18,11,2,18,ENG
b070482d,4,3,0,3,1,1,1,0,2,0,2,0,4,0,0,18,ENG
b0c71810,37,24,12,14,11,12,35,23,20,1,19,6,43,6,0,18,ENG
b1313ec4,36,26,20,13,3,19,44,25,22,1,21,11,47,24,0,18,ENG
b18095b6,25,13,18,3,4,9,14,5,18,6,12,25,50,56,0,18,ENG
b1b25949,0,0,0,0,0,0,1,1,0,0,0,0,0,8,0,18,ENG
b217ef29,35,24,23,11,1,12,24,12,26,15,11,35,70,101,1,18,ENG
b27b49b4,4,4,4,0,0,2,4,2,2,1,1,3,7,3,0,18,ENG
b28bbd58,60,34,35,12,13,24,75,51,49,1,48,35,95,28,0,18,ENG
b2bc3b1f,30,23,9,13,8,4,23,19,24,0,24,7,37,4,0,18,ENG
b318a643,14,6,0,7,7,5,26,21,27,0,27,14,28,20,0,18,ENG
b400bde0,19,14,7,7,5,3,32,29,24,0,24,9,28,9,0,18,ENG
b581987a,3,3,2,0,1,0,1,1,3,2,1,2,5,15,0,18,ENG
b63f4077,4,3,1,2,1,1,6,5,4,0,4,0,4,6,0,18,ENG
b66315ae,23,15,6,10,7,3,22,19,16,0,16,8,31,6,0,18,ENG
b6964eb6,40,25,28,12,0,16,28,12,32,28,4,63,103,162,1,18,ENG
b7d082af,89,64,33,48,8,16,62,46,44,7,37,48,137,30,2,18,ENG
b827d5b3,52,33,16,29,7,16,52,36,32,4,28,27,79,34,0,18,ENG
b92dd711,6,5,0,5,1,5,8,3,3,1,2,1,7,1,0,18,ENG
b98570d1,72,41,27,35,10,24,64,40,44,9,35,26,98,36,2,18,ENG
b9fbae28,113,77,55,52,6,33,92,59,40,4,36,85,198,29,3,18,ENG
ba1e04b3,53,34,20,29,4,17,51,34,37,16,21,24,77,27,1,18,ENG
ba23a904,64,41,40,20,4,25,36,11,29,11,18,60,124,177,0,18,ENG
bb5fbd2b,54,41,34,14,6,22,54,32,27,3,24,13,67,49,0,18,ENG
bcf30f17,3,1,2,1,0,1,5,4,4,2,2,1,4,1,0,18,ENG
bd1d1cbb,4,2,1,0,3,1,3,2,2,0,2,2,6,5,0,18,ENG
bd8a7d05,14,11,8,4,2,3,10,7,6,1,5,11,25,8,0,18,ENG
bda6ffd4,36,27,23,13,0,13,27,14,14,6,8,16,52,25,2,18,ENG
be927d03,53,32,30,17,6,18,47,29,24,5,19,57,110,86,1,18,ENG
bf54c8cc,3,3,2,1,0,1,7,6,3,0,3,1,4,3,0,18,ENG
c0e27d1a,18,11,13,4,1,11,21,10,9,5,4,24,42,45,2,18,ENG
c204f844,2,2,1,0,1,1,1,0,3,1,2,5,7,4,0,18,ENG
c24dba2a,2,1,0,1,1,0,3,3,11,0,11,4,6,3,0,18,ENG
c3e39f12,0,0,0,0,0,0,0,0,0,0,0,0,0,7,4,18,ENG
c5942695,4,4,3,1,0,4,6,2,3,0,3,1,5,0,0,18,ENG
c596fcb0,9,5,2,6,1,1,14,13,15,3,12,3,12,15,0,18,ENG
c5b7c315,33,25,26,5,2,19,43,24,39,28,11,53,86,214,0,18,ENG
c5bdb6e3,4,3,1,1,2,0,0,0,4,0,4,3,7,0,0,18,ENG
c5f13182,2,0,1,1,0,0,2,2,0,0,0,3,5,2,1,18,ENG
c61f1719,15,9,11,4,0,8,11,3,13,10,3,16,31,120,1,18,ENG
c6896eab,43,29,26,15,2,20,44,24,21,8,13,34,77,65,3,18,ENG
c691bfe2,28,20,8,11,9,3,23,20,20,0,20,9,37,8,0,18,ENG
c7aee75b,0,0,0,0,0,0,0,0,0,0,0,0,0,0,0,18,ENG
c92e1a31,9,6,3,5,1,3,20,17,10,2,8,3,12,4,0,18,ENG
c951a6df,40,23,23,16,1,12,34,22,21,6,15,23,63,43,0,18,ENG
ca2bc3df,23,15,12,9,2,7,19,12,6,0,6,16,39,34,0,18,ENG
ca9178af,6,2,1,2,3,0,4,4,5,1,4,2,8,2,0,18,ENG
caa1a7f0,0,0,0,0,0,0,0,0,0,0,0,0,0,0,0,18,ENG
caffaf5a,27,20,22,5,0,18,25,7,32,14,18,41,68,133,2,18,ENG
cb4f24c6,1,1,1,0,0,1,2,1,1,0,1,0,1,2,4,18,ENG
cc2d7ad5,16,4,9,6,1,7,12,5,13,5,8,15,31,52,0,18,ENG
cc70a1d5,1,1,1,0,0,1,1,0,1,0,1,1,2,26,1,18,ENG
cd1acf9d,37,25,23,9,5,22,36,14,20,5,15,28,65,46,1,18,ENG
cde3309f,0,0,0,0,0,0,0,0,0,0,0,0,0,3,4,18,ENG
ce4246f5,50,38,35,13,2,21,28,7,42,23,19,61,111,246,2,18,ENG
ce5143da,20,13,9,5,6,4,12,8,22,1,21,11,31,13,0,18,ENG
ce9c203e,2,2,2,0,0,1,5,4,2,0,2,0,2,3,0,18,ENG
cea4ee8f,46,30,15,21,10,8,34,26,33,7,26,19,65,22,1,18,ENG
cee31595,58,44,28,27,3,23,61,38,39,2,37,36,94,44,2,18,ENG
cf15bbb1,30,21,10,17,3,11,30,19,22,6,16,15,45,24,1,18,ENG
cfd5e123,39,32,25,11,3,15,26,11,24,6,18,40,79,81,1,18,ENG
cfe6238d,24,17,17,7,0,10,26,16,9,1,8,12,36,48,0,18,ENG
d0042ab9,23,16,15,7,1,10,21,11,12,9,3,23,46,86,2,18,ENG
d07e3b41,9,6,5,3,1,1,4,3,6,0,6,8,17,8,0,18,ENG
d080ed5e,56,40,21,32,3,17,56,39,36,8,28,34,90,25,0,18,ENG
d0b3ceb9,1,0,1,0,0,0,7,7,0,0,0,1,2,12,1,18,ENG
d2424d1b,36,26,21,10,5,15,32,17,31,4,27,28,64,71,3,18,ENG
d2bff301,20,11,14,5,1,13,19,6,10,8,2,16,36,73,1,18,ENG
d328a254,25,16,11,11,3,8,22,14,17,1,16,18,43,19,0,18,ENG
d368feb8,32,22,24,8,0,16,27,11,41,32,9,35,67,229,5,18,ENG
d436eb94,2,1,2,0,0,1,3,2,0,0,0,0,2,5,3,18,ENG
d4cb83cc,54,32,19,29,6,21,48,27,26,7,19,56,110,83,2,18,ENG
d56543a0,11,8,7,2,2,7,20,13,20,4,16,17,28,34,0,18,ENG
d596e193,0,0,0,0,0,0,1,1,1,0,1,2,2,15,3,18,ENG
d5dd5f1f,5,4,3,2,0,1,7,6,14,1,13,3,8,7,0,18,ENG
d6f88a1d,22,13,8,13,1,6,28,22,12,2,10,14,36,0,0,18,ENG
d7492450,19,13,15,4,0,14,26,12,16,11,5,9,28,67,3,18,ENG
d790907f,26,16,10,13,3,5,17,12,11,2,9,11,37,27,1,18,ENG
d79a8c87,19,14,13,5,1,4,12,8,16,10,6,21,40,40,2,18,ENG
d822a850,0,0,0,0,0,0,1,1,0,0,0,0,0,3,1,18,ENG
d8931174,63,46,47,15,1,26,43,17,35,28,7,48,111,181,1,18,ENG
d93c2511,11,9,4,5,2,5,13,8,3,0,3,13,24,9,0,18,ENG
d9cfca3d,9,5,6,3,0,0,8,8,5,2,3,3,12,9,0,18,ENG
da052c14,82,60,20,35,27,15,54,39,43,3,40,24,106,20,1,18,ENG
da2b8db3,0,0,0,0,0,0,0,0,0,0,0,0,0,0,0,18,ENG
da7b447d,38,24,28,9,1,18,40,22,26,10,16,38,76,162,0,18,ENG
dc6f5bdd,17,10,10,6,1,5,14,9,14,11,3,18,35,47,0,18,ENG
dd0daf32,33,24,13,14,6,10,46,36,24,2,22,15,48,10,0,18,ENG
de112b84,13,10,5,4,4,7,27,20,16,0,16,6,19,13,2,18,ENG
def899bd,25,18,20,5,0,9,20,11,25,17,8,41,66,133,2,18,ENG
df540668,19,9,9,9,1,10,31,21,6,1,5,7,26,10,0,18,ENG
e06683ca,25,15,13,9,3,6,8,2,22,15,7,47,72,161,2,18,ENG
e0900238,30,20,13,16,1,14,31,17,13,3,10,10,40,20,1,18,ENG
e0991c04,7,5,6,0,1,1,8,7,11,6,5,7,14,56,2,18,ENG
e0bc6fdc,6,4,4,2,0,5,5,0,2,0,2,2,8,10,0,18,ENG
e2716bd0,32,21,11,17,4,9,45,36,28,5,23,18,50,7,0,18,ENG
e342ad68,12,6,2,5,5,3,23,20,10,0,10,5,17,5,0,18,ENG
e3a5814e,25,17,12,7,6,14,31,17,15,1,14,12,37,35,2,18,ENG
e46012d4,62,43,23,25,14,23,80,57,45,2,43,25,87,14,2,18,ENG
e514ab62,6,3,5,0,1,1,3,2,3,2,1,3,9,7,1,18,ENG
e58a03c6,12,10,2,8,2,1,21,20,16,2,14,6,18,17,0,18,ENG
e5d01ecf,36,28,22,11,3,14,27,13,15,2,13,34,70,31,1,18,ENG
e61b8aee,78,57,35,40,3,26,69,43,30,9,21,37,115,68,4,18,ENG
e726e11e,37,29,21,13,3,14,24,10,29,4,25,15,52,39,2,18,ENG
e76cb9cc,16,12,13,3,0,10,17,7,7,3,4,15,31,44,1,18,ENG
e77dc3b2,7,4,0,6,1,1,4,3,5,1,4,2,9,9,0,18,ENG
e7ca0439,47,26,36,10,1,16,31,15,24,12,12,63,110,216,1,18,ENG
e860c42f,92,60,49,35,8,54,100,46,60,13,47,60,152,144,4,18,ENG
e9208654,38,27,18,14,6,23,36,13,22,6,16,26,64,80,3,18,ENG
e92cd3f7,6,3,1,4,1,4,12,8,5,0,5,2,8,5,0,18,ENG
e97fd090,21,15,7,13,1,7,30,23,19,2,17,22,43,31,0,18,ENG
eaeca114,53,32,34,16,3,22,40,18,47,24,23,48,101,246,2,18,ENG
eb58eef0,34,23,13,16,5,11,23,12,20,2,18,25,59,20,0,18,ENG
eb7822d7,70,42,32,34,4,23,71,48,50,13,37,64,134,62,2,18,ENG
ebd0a048,19,10,7,11,1,2,10,8,14,2,12,17,36,25,0,18,ENG
ec7e6ad1,41,24,19,21,1,11,31,20,28,4,24,22,63,45,1,18,ENG
ec9a28ce,23,14,13,9,1,7,22,15,12,2,10,26,49,27,0,18,ENG
ed1e53f3,1,1,0,1,0,0,1,1,0,0,0,0,1,1,0,18,ENG
eed56f6c,4,1,0,1,3,1,7,6,1,0,1,0,4,4,0,18,ENG
ef619b0b,35,27,18,17,0,8,44,36,14,3,11,24,59,6,1,18,ENG
efe6f6ac,5,1,4,1,0,2,3,1,1,0,1,1,6,3,0,18,ENG
f0021247,14,11,6,5,3,6,19,13,7,0,7,8,22,4,1,18,ENG
f07be45a,28,19,11,13,4,10,42,32,25,6,19,16,44,43,2,18,ENG
f15a50e8,39,29,27,10,2,17,24,7,12,2,10,26,65,43,2,18,ENG
f1e8372d,12,9,2,6,4,2,10,8,10,0,10,4,16,1,0,18,ENG
f25b010f,40,29,30,6,4,20,30,10,35,27,8,38,78,201,1,18,ENG
f2f29dda,18,12,4,11,3,2,18,16,16,4,12,5,23,27,0,18,ENG
f3709655,5,3,4,1,0,2,5,3,0,0,0,4,9,8,1,18,ENG
f42456eb,0,0,0,0,0,0,0,0,0,0,0,0,0,4,0,18,ENG
f4290206,51,33,30,18,3,23,44,21,36,5,31,47,98,76,1,18,ENG
f520049f,7,4,6,1,0,1,3,2,4,3,1,3,10,28,1,18,ENG
f586779e,10,8,1,7,2,1,13,12,8,1,7,1,11,11,0,18,ENG
f5deef4c,17,11,10,6,1,9,14,5,15,11,4,13,30,67,1,18,ENG
f5e6d08d,22,17,19,3,0,8,15,7,20,9,11,31,53,92,1,18,ENG
f5efb153,43,21,27,12,4,19,33,14,28,15,13,54,97,138,3,18,ENG
f631c17f,6,4,3,2,1,4,12,8,3,0,3,7,13,3,0,18,ENG
f6d7d690,0,0,0,0,0,0,1,1,1,1,0,2,2,0,0,18,ENG
f72293fc,43,27,16,19,8,20,47,27,21,1,20,34,77,43,0,18,ENG
f76e6b4e,2,1,2,0,0,1,4,3,1,0,1,0,2,15,1,18,ENG
f7d50789,19,13,7,11,1,8,15,7,11,5,6,4,23,55,0,18,ENG
f7ee69fb,36,24,19,11,6,9,37,28,20,0,20,33,69,15,0,18,ENG
f874dd44,57,43,36,12,9,25,52,27,42,8,34,23,80,89,4,18,ENG
f8fcd2a5,29,22,19,8,2,14,33,19,22,13,9,48,77,131,1,18,ENG
fa031b34,64,44,26,28,10,10,39,29,39,5,34,24,88,32,1,18,ENG
faf55ce4,24,17,17,7,0,9,20,11,25,12,13,30,54,88,0,18,ENG
fb2dec57,5,4,1,2,2,0,13,13,9,3,6,4,9,9,0,18,ENG
fc166e49,1,0,0,1,0,0,0,0,1,0,1,0,1,1,0,18,ENG
fd3f57ce,13,4,3,7,3,1,5,4,3,0,3,5,18,4,0,18,ENG
fdd85f94,73,44,35,35,3,18,83,65,35,11,24,60,133,80,2,18,ENG
fe012aca,0,0,0,0,0,0,0,0,0,0,0,0,0,0,0,18,ENG
ff527768,61,36,32,22,7,16,76,60,28,10,18,47,108,32,1,18,ENG
ff9fcd4d,18,8,2,6,10,10,21,11,6,1,5,5,23,11,0,18,ENG
ffec9769,2,2,1,1,0,1,6,5,2,0,2,1,3,3,0,18,ENG
0027c6cc,13,8,8,5,0,10,11,1,3,2,1,5,18,21,0,18,EL
003a5c72,16,12,9,6,1,10,18,8,7,5,2,15,31,11,0,18,EL
003d7410,0,0,0,0,0,0,7,7,0,0,0,2,2,7,1,18,EL
011d8c56,0,0,0,0,0,0,0,0,0,0,0,0,0,0,0,18,EL
016ff750,2,2,0,1,1,1,7,6,3,0,3,5,7,0,0,18,EL
0174ba21,1,1,1,0,0,1,1,0,1,0,1,2,3,2,0,18,EL
0193a8bf,10,7,3,7,0,2,6,4,10,2,8,5,15,1,0,18,EL
01eb744d,10,8,5,3,2,3,18,15,8,0,8,8,18,5,0,18,EL
02f4b798,1,1,1,0,0,0,2,2,2,1,1,7,8,6,0,18,EL
038aa94a,16,12,13,3,0,8,16,8,11,0,11,13,29,22,0,18,EL
03de83d9,0,0,0,0,0,0,3,3,0,0,0,0,0,1,1,18,EL
03f946ed,1,1,0,0,1,0,4,4,1,0,1,3,4,2,0,18,EL
042d286e,1,1,0,1,0,0,4,4,3,0,3,2,3,0,0,18,EL
0488e833,5,5,2,3,0,1,3,2,3,1,2,7,12,7,0,18,EL
0489db27,2,2,2,0,0,2,2,0,2,1,1,1,3,4,0,18,EL
048a1cbc,1,1,1,0,0,0,0,0,0,0,0,0,1,1,0,18,EL
04f2ed4d,5,4,4,1,0,4,7,3,9,6,3,11,16,24,0,18,EL
053f6e16,1,1,1,0,0,1,1,0,2,0,2,3,4,6,0,18,EL
0557ff4f,15,8,7,5,3,8,11,3,12,4,8,18,33,16,0,18,EL
0562b7f1,0,0,0,0,0,0,0,0,0,0,0,0,0,0,0,18,EL
05a275e0,6,3,4,1,1,4,10,6,5,1,4,7,13,10,0,18,EL
05ad9890,0,0,0,0,0,0,0,0,0,0,0,1,1,0,0,18,EL
05cb19c5,3,3,0,2,1,0,4,4,0,0,0,1,4,1,0,18,EL
05e19d6a,14,10,5,7,2,7,14,7,10,0,10,4,18,6,0,18,EL
061e8e23,1,1,1,0,0,0,0,0,1,0,1,1,2,2,0,18,EL
0630eb63,6,6,1,5,0,1,3,2,5,0,5,4,10,6,0,18,EL
06eae126,6,5,1,3,2,4,7,3,8,0,8,1,7,2,0,18,EL
0711c00f,5,1,4,1,0,3,4,1,3,1,2,5,10,9,0,18,EL
075fe5a3,1,1,1,0,0,0,1,1,2,2,0,2,3,14,0,18,EL
077b773d,1,0,1,0,0,0,1,1,0,0,0,1,2,3,0,18,EL
07a0baa9,11,7,5,6,0,5,11,6,0,0,0,5,16,1,1,18,EL
080ac8d8,12,8,5,4,3,4,9,5,8,3,5,1,13,8,0,18,EL
0810b6df,1,1,1,0,0,1,2,1,0,0,0,1,2,1,0,18,EL
08593525,49,33,24,22,3,16,42,26,17,4,13,29,78,27,0,18,EL
08990838,7,6,5,2,0,2,4,2,6,5,1,11,18,44,0,18,EL
08f5afaa,1,0,1,0,0,1,3,2,0,0,0,0,1,4,1,18,EL
08fe932d,3,3,1,1,1,0,2,2,2,1,1,5,8,8,0,18,EL
0984c5d5,4,3,2,2,0,1,3,2,3,0,3,1,5,3,0,18,EL
099e666f,11,8,8,3,0,7,10,3,5,1,4,4,15,10,0,18,EL
09a9e921,0,0,0,0,0,0,2,2,1,0,1,0,0,3,0,18,EL
09bcc566,5,4,0,3,2,0,1,1,3,0,3,1,6,2,0,18,EL
0a215326,4,4,3,1,0,1,4,3,4,1,3,1,5,1,0,18,EL
0ac94a23,3,2,1,0,2,2,5,3,3,0,3,1,4,1,0,18,EL
0aeeed3f,6,4,2,3,1,0,4,4,7,0,7,3,9,2,0,18,EL
0af4dcf0,0,0,0,0,0,0,2,2,2,1,1,0,0,4,0,18,EL
0b221abd,0,0,0,0,0,0,0,0,0,0,0,0,0,2,1,18,EL
0b2c9aec,0,0,0,0,0,0,0,0,0,0,0,0,0,0,0,18,EL
0b5a292a,2,1,0,2,0,0,0,0,2,0,2,1,3,2,0,18,EL
0b5b8057,2,1,1,1,0,0,1,1,1,1,0,0,2,2,0,18,EL
0be28faf,5,3,4,1,0,1,3,2,3,0,3,6,11,4,0,18,EL
0be3255b,1,1,1,0,0,1,1,0,0,0,0,0,1,4,0,18,EL
0be46103,1,1,0,1,0,1,2,1,3,3,0,1,2,4,0,18,EL
0cd0e21b,4,4,0,4,0,1,2,1,5,0,5,8,12,12,0,18,EL
0d077b88,25,14,11,10,4,5,18,13,9,2,7,15,40,8,0,18,EL
0daa34cc,0,0,0,0,0,0,0,0,1,0,1,2,2,0,0,18,EL
0e5753c7,18,10,10,5,3,9,12,3,9,1,8,5,23,14,1,18,EL
0e61c46b,0,0,0,0,0,0,0,0,0,0,0,0,0,1,0,18,EL
0eeafda5,13,6,11,2,0,3,7,4,10,7,3,13,26,45,1,18,EL
0efacb06,0,0,0,0,0,0,2,2,2,0,2,0,0,5,0,18,EL
0f5e0b8a,11,6,9,1,1,5,7,2,6,0,6,3,14,16,0,18,EL
0f816ae5,4,4,3,0,1,1,1,0,1,1,0,4,8,4,0,18,EL
0f888175,4,3,1,2,1,0,2,2,3,0,3,0,4,5,0,18,EL
0f8bd0a6,4,4,2,1,1,1,4,3,7,2,5,5,9,16,0,18,EL
0f9b8301,9,2,3,5,1,4,10,6,2,0,2,3,12,5,0,18,EL
0fffd034,0,0,0,0,0,0,0,0,0,0,0,0,0,0,0,18,EL
10206347,0,0,0,0,0,0,0,0,0,0,0,0,0,0,0,18,EL
10a81962,4,1,4,0,0,3,6,3,3,1,2,2,6,9,1,18,EL
10d58a78,2,2,1,1,0,1,4,3,4,0,4,2,4,2,0,18,EL
10efd0e1,6,6,4,2,0,2,6,4,3,1,2,0,6,4,0,18,EL
110a95ca,1,1,1,0,0,1,1,0,0,0,0,0,1,2,1,18,EL
119b9a8e,10,9,6,4,0,6,10,4,7,5,2,8,18,34,0,18,EL
11a1a615,3,2,2,1,0,3,3,0,0,0,0,2,5,2,0,18,EL
11c0fa9d,6,3,1,1,4,1,4,3,6,0,6,3,9,0,0,18,EL
120c594d,6,5,3,1,2,2,2,0,1,1,0,4,10,1,0,18,EL
1238a3f9,2,1,1,1,0,1,1,0,0,0,0,1,3,0,0,18,EL
12947ab7,1,1,1,0,0,1,1,0,0,0,0,1,2,0,0,18,EL
12dcbdcc,25,14,12,11,2,14,21,7,14,2,12,7,32,18,0,18,EL
12e6d21a,0,0,0,0,0,0,0,0,5,1,4,2,2,5,0,18,EL
130a7a3f,8,8,4,2,2,4,6,2,2,0,2,1,9,1,0,18,EL
1321d6f0,2,1,1,1,0,2,2,0,1,0,1,1,3,5,0,18,EL
134832c6,2,1,1,1,0,1,1,0,2,0,2,2,4,0,0,18,EL
136e7649,0,0,0,0,0,0,0,0,0,0,0,0,0,1,0,18,EL
1381e699,3,2,2,1,0,2,2,0,4,3,1,1,4,18,0,18,EL
13a78e01,19,12,12,5,2,10,21,11,13,4,9,11,30,24,0,18,EL
13ac19de,9,5,6,2,1,3,11,8,3,0,3,4,13,2,0,18,EL
13b0c150,10,9,5,5,0,3,3,0,8,6,2,8,18,18,0,18,EL
140afefb,0,0,0,0,0,0,0,0,2,0,2,0,0,1,0,18,EL
1432d037,1,0,1,0,0,1,2,1,1,0,1,0,1,0,0,18,EL
1443ca7d,1,0,1,0,0,1,2,1,3,2,1,0,1,5,0,18,EL
144607cc,1,1,0,0,1,0,0,0,0,0,0,1,2,1,0,18,EL
14e8fe86,9,6,5,4,0,4,10,6,9,1,8,5,14,10,0,18,EL
15413fa5,15,8,6,8,1,4,17,13,7,1,6,4,19,4,0,18,EL
1598599e,10,8,4,6,0,4,6,2,2,1,1,7,17,1,1,18,EL
15b949ab,8,7,3,4,1,5,6,1,0,0,0,10,18,3,0,18,EL
15d0c248,18,14,13,4,1,7,15,8,11,7,4,27,45,33,1,18,EL
15e99107,0,0,0,0,0,0,0,0,0,0,0,0,0,0,0,18,EL
15e9c7e6,4,3,2,2,0,1,3,2,4,0,4,1,5,0,1,18,EL
15fd5593,4,3,2,2,0,3,11,8,6,2,4,6,10,3,0,18,EL
16380240,7,6,1,4,2,2,8,6,1,0,1,3,10,1,0,18,EL
163bbd4a,1,0,0,0,1,0,1,1,0,0,0,0,1,0,0,18,EL
16657b95,14,7,3,7,4,0,12,12,5,0,5,4,18,3,0,18,EL
1668b4b1,0,0,0,0,0,0,0,0,0,0,0,0,0,0,0,18,EL
166a981d,4,4,1,2,1,2,2,0,2,0,2,6,10,7,0,18,EL
16952f65,8,4,3,4,1,2,14,12,8,0,8,2,10,3,0,18,EL
169fd162,4,3,2,0,2,2,11,9,5,0,5,2,6,3,0,18,EL
16ceb862,3,2,0,2,1,0,1,1,1,0,1,1,4,4,0,18,EL
17370b95,12,8,9,2,1,6,8,2,3,1,2,5,17,31,0,18,EL
173eb3cd,7,4,3,4,0,3,10,7,3,2,1,4,11,6,0,18,EL
1770bd68,11,8,4,3,4,1,5,4,7,1,6,10,21,8,0,18,EL
1771f2c1,5,4,2,3,0,3,5,2,3,1,2,1,6,3,0,18,EL
17e3e467,6,5,2,3,1,0,3,3,1,0,1,0,6,0,0,18,EL
182c10aa,6,4,2,3,1,1,3,2,3,1,2,3,9,3,0,18,EL
18682b13,5,2,1,4,0,3,4,1,0,0,0,4,9,6,0,18,EL
194ace07,8,3,4,4,0,2,5,3,4,0,4,6,14,8,0,18,EL
197640fd,3,2,2,1,0,1,7,6,6,0,6,3,6,8,0,18,EL
19e4dca5,11,8,9,1,1,7,13,6,12,6,6,20,31,74,0,18,EL
1a105265,0,0,0,0,0,0,0,0,0,0,0,0,0,1,0,18,EL
1a4b9094,28,21,17,11,0,14,27,13,12,2,10,19,47,27,0,18,EL
1a63f024,19,11,9,10,0,4,8,4,8,2,6,11,30,7,0,18,EL
1a799243,40,24,18,19,3,24,48,24,17,2,15,17,57,31,0,18,EL
1a97dc06,4,4,2,1,1,0,4,4,2,2,0,7,11,8,0,18,EL
1aa98b10,0,0,0,0,0,0,0,0,0,0,0,0,0,0,0,18,EL
1bd5735a,10,6,3,5,2,6,9,3,5,0,5,4,14,10,0,18,EL
1bf33a9a,7,6,2,4,1,2,8,6,5,0,5,1,8,0,0,18,EL
1bfdb73a,6,4,4,2,0,3,5,2,3,2,1,8,14,20,0,18,EL
1c37137f,12,5,6,4,2,5,16,11,4,0,4,12,24,24,0,18,EL
1c529186,4,3,2,2,0,1,1,0,3,0,3,0,4,9,0,18,EL
1c639185,10,7,3,6,1,4,10,6,5,1,4,9,19,9,0,18,EL
1c78737d,11,6,5,6,0,2,20,18,7,3,4,11,22,18,0,18,EL
1c98558c,0,0,0,0,0,0,0,0,0,0,0,0,0,5,0,18,EL
1cfd188f,0,0,0,0,0,0,0,0,0,0,0,0,0,0,0,18,EL
1d1691ad,10,9,4,3,3,5,5,0,5,1,4,6,16,12,0,18,EL
1d2d5cc8,0,0,0,0,0,0,0,0,0,0,0,0,0,2,0,18,EL
1d5f96d9,0,0,0,0,0,0,0,0,0,0,0,0,0,1,0,18,EL
1d8e9add,7,4,6,1,0,5,5,0,6,5,1,5,12,14,0,18,EL
1db295e5,8,4,7,1,0,0,0,0,4,4,0,14,22,41,0,18,EL
1de2f2de,9,5,4,3,2,4,9,5,2,0,2,7,16,8,0,18,EL
1e062a01,7,5,2,4,1,0,2,2,8,2,6,7,14,3,0,18,EL
1e064bfb,1,0,1,0,0,1,2,1,0,0,0,0,1,2,0,18,EL
1e29552f,0,0,0,0,0,0,0,0,0,0,0,0,0,0,0,18,EL
1e415dd6,6,3,5,1,0,2,8,6,3,2,1,5,11,19,0,18,EL
1ecb65be,2,2,0,2,0,0,3,3,3,0,3,2,4,1,0,18,EL
1f9bc0d4,1,1,1,0,0,0,1,1,2,0,2,0,1,0,0,18,EL
1fbbfbde,9,7,6,3,0,3,5,2,3,3,0,6,15,19,1,18,EL
1fe67e86,16,15,9,7,0,8,14,6,7,4,3,2,18,18,0,18,EL
20030c06,1,1,0,1,0,1,1,0,3,3,0,5,6,11,0,18,EL
20094685,21,10,5,11,5,7,32,25,10,0,10,7,28,10,0,18,EL
2042d931,3,3,0,3,0,1,1,0,3,0,3,2,5,3,1,18,EL
20730eae,0,0,0,0,0,0,0,0,1,0,1,0,0,0,0,18,EL
2077ae86,0,0,0,0,0,0,0,0,1,0,1,0,0,0,0,18,EL
2079b3cc,8,5,3,3,2,2,9,7,5,0,5,5,13,3,0,18,EL
20c1ef47,4,3,2,1,1,0,2,2,5,0,5,5,9,2,0,18,EL
20dbf9e0,1,1,0,1,0,0,2,2,3,0,3,1,2,0,0,18,EL
213ab9bb,2,2,1,1,0,0,0,0,1,0,1,0,2,2,0,18,EL
2146785a,18,9,10,7,1,9,15,6,3,0,3,10,28,13,0,18,EL
21519148,3,2,0,3,0,1,5,4,3,0,3,5,8,1,0,18,EL
2196d7d2,5,3,3,1,1,0,3,3,3,0,3,3,8,1,0,18,EL
22551915,3,2,1,2,0,1,6,5,3,1,2,8,11,7,2,18,EL
22721b88,35,25,20,9,6,17,29,12,17,4,13,26,61,60,0,18,EL
2277a390,7,5,4,2,1,3,4,1,7,4,3,8,15,16,1,18,EL
22b752ee,3,3,1,2,0,2,2,0,3,1,2,3,6,10,0,18,EL
22bfb57e,3,1,1,1,1,1,2,1,0,0,0,0,3,0,0,18,EL
22cd43d2,3,2,2,1,0,1,2,1,0,0,0,2,5,2,0,18,EL
2306bfde,0,0,0,0,0,0,0,0,1,0,1,5,5,2,1,18,EL
2319ebe3,8,6,4,4,0,5,10,5,5,1,4,2,10,2,0,18,EL
23c63b7f,0,0,0,0,0,0,0,0,0,0,0,0,0,1,0,18,EL
2409762c,2,2,0,2,0,0,2,2,1,0,1,1,3,1,0,18,EL
242dbdeb,8,5,7,1,0,6,8,2,2,0,2,6,14,9,0,18,EL
248be14f,11,4,7,4,0,6,12,6,1,1,0,9,20,19,0,18,EL
24baba9d,20,12,17,1,2,4,10,6,5,0,5,5,25,20,0,18,EL
24e9421b,4,2,1,3,0,1,3,2,2,0,2,1,5,1,0,18,EL
25126342,3,2,1,2,0,1,2,1,7,4,3,3,6,37,1,18,EL
2557c196,1,1,0,1,0,0,0,0,2,0,2,0,1,5,0,18,EL
2567b7b6,11,8,5,6,0,7,22,15,6,0,6,12,23,11,0,18,EL
25736bcf,5,4,2,3,0,4,7,3,5,3,2,7,12,19,0,18,EL
25763990,0,0,0,0,0,0,0,0,1,1,0,1,1,0,0,18,EL
258aff54,8,5,2,6,0,0,2,2,3,1,2,2,10,5,0,18,EL
25c72b36,0,0,0,0,0,0,0,0,0,0,0,0,0,0,0,18,EL
26a796c1,5,4,0,2,3,2,7,5,5,3,2,5,10,4,0,18,EL
26b7d548,2,1,0,2,0,1,2,1,2,1,1,3,5,10,0,18,EL
273c483b,0,0,0,0,0,0,0,0,0,0,0,0,0,0,0,18,EL
27b1390c,2,1,0,0,2,0,0,0,1,0,1,1,3,0,0,18,EL
27d2618c,0,0,0,0,0,0,0,0,0,0,0,0,0,0,0,18,EL
27d34558,0,0,0,0,0,0,0,0,0,0,0,1,1,0,0,18,EL
27d902c8,0,0,0,0,0,0,0,0,0,0,0,0,0,0,0,18,EL
27f0fcda,2,1,1,1,0,0,2,2,3,0,3,2,4,5,0,18,EL
27ff9bdb,1,0,0,1,0,1,1,0,1,0,1,0,1,0,0,18,EL
281659b5,2,2,2,0,0,2,3,1,4,4,0,8,10,26,1,18,EL
283699b4,13,10,6,6,1,5,10,5,5,2,3,10,23,7,0,18,EL
28aeafaa,8,3,6,2,0,6,12,6,5,0,5,8,16,2,0,18,EL
28baf8f6,4,2,0,3,1,1,5,4,2,0,2,0,4,0,0,18,EL
28c2d647,6,5,1,1,4,2,3,1,1,0,1,4,10,12,0,18,EL
29102874,4,2,2,2,0,0,1,1,4,4,0,4,8,21,0,18,EL
293211e1,3,2,1,2,0,2,2,0,3,0,3,0,3,4,0,18,EL
2973d8ff,0,0,0,0,0,0,1,1,1,1,0,0,0,2,0,18,EL
29aee77c,0,0,0,0,0,0,1,1,2,1,1,1,1,0,0,18,EL
29ef0f49,4,3,0,3,1,1,4,3,1,0,1,1,5,3,0,18,EL
29f7cfd9,1,1,0,0,1,0,1,1,3,0,3,1,2,2,0,18,EL
2a1beb34,9,4,1,6,2,1,11,10,12,1,11,15,24,6,0,18,EL
2a6cd437,2,2,0,2,0,0,0,0,3,2,1,4,6,6,0,18,EL
2a82aa85,6,3,2,3,1,2,4,2,1,0,1,0,6,0,0,18,EL
2b16cb1a,0,0,0,0,0,0,2,2,3,0,3,2,2,2,0,18,EL
2b3efa4a,7,6,5,2,0,3,6,3,3,3,0,4,11,7,0,18,EL
2b59d76f,10,8,5,4,1,4,8,4,7,1,6,10,20,9,0,18,EL
2b83fa49,1,1,1,0,0,1,1,0,3,1,2,3,4,3,0,18,EL
2b9fdeea,15,11,5,8,2,5,15,10,11,0,11,2,17,6,0,18,EL
2bd83368,1,0,0,1,0,0,0,0,0,0,0,0,1,0,0,18,EL
2c0f8e9e,0,0,0,0,0,0,0,0,0,0,0,0,0,0,0,18,EL
2c125b75,4,3,1,2,1,1,2,1,3,0,3,2,6,0,0,18,EL
2ccd89a3,18,13,15,2,1,8,13,5,4,1,3,15,33,25,0,18,EL
2cd3d3ce,7,5,2,5,0,1,4,3,5,0,5,2,9,0,0,18,EL
2d3b60c1,0,0,0,0,0,0,0,0,1,1,0,2,2,6,0,18,EL
2d49b833,14,11,7,7,0,4,12,8,7,1,6,14,28,28,0,18,EL
2d970560,2,2,2,0,0,2,4,2,0,0,0,0,2,4,0,18,EL
2deaf8b2,2,2,1,1,0,1,2,1,2,1,1,2,4,3,1,18,EL
2e06f387,0,0,0,0,0,0,0,0,0,0,0,0,0,0,0,18,EL
2e2ec9cf,2,2,2,0,0,2,3,1,2,0,2,4,6,5,0,18,EL
2e3596d1,7,5,3,4,0,4,5,1,2,1,1,6,13,15,0,18,EL
2e8fc160,3,3,1,1,1,2,4,2,1,0,1,1,4,0,0,18,EL
2ebc1b44,9,5,3,3,3,0,3,3,5,0,5,10,19,3,0,18,EL
2f3452eb,1,1,1,0,0,0,2,2,0,0,0,2,3,0,0,18,EL
2f557579,0,0,0,0,0,0,2,2,2,0,2,1,1,0,0,18,EL
2f798b41,0,0,0,0,0,0,0,0,1,0,1,0,0,10,0,18,EL
2f94b2a0,3,1,1,2,0,0,2,2,7,0,7,4,7,4,0,18,EL
2f9c21da,4,1,4,0,0,3,8,5,9,2,7,10,14,3,0,18,EL
2fd78b8e,4,3,0,4,0,2,6,4,0,0,0,1,5,3,0,18,EL
2ff964a0,2,1,1,1,0,2,2,0,0,0,0,1,3,0,0,18,EL
3061e1ec,0,0,0,0,0,0,1,1,0,0,0,2,2,5,0,18,EL
30643ce2,0,0,0,0,0,0,0,0,2,0,2,2,2,3,0,18,EL
30c220c3,8,5,4,4,0,6,10,4,4,0,4,4,12,1,0,18,EL
314a0ea4,4,4,4,0,0,3,8,5,3,0,3,4,8,2,0,18,EL
314bdac5,13,4,6,5,2,4,21,17,9,3,6,11,24,6,0,18,EL
314c2af0,0,0,0,0,0,0,1,1,2,0,2,0,0,1,0,18,EL
319322cd,12,9,10,2,0,6,8,2,9,7,2,8,20,15,1,18,EL
31d7f557,8,4,2,5,1,2,5,3,4,1,3,2,10,4,0,18,EL
31daff3a,5,5,4,0,1,3,6,3,2,1,1,3,8,1,0,18,EL
31e3ab68,0,0,0,0,0,0,0,0,0,0,0,0,0,2,0,18,EL
3200c583,13,5,5,7,1,8,13,5,4,0,4,5,18,4,0,18,EL
321a71a7,7,5,3,3,1,2,2,0,7,4,3,18,25,9,0,18,EL
3233eefd,0,0,0,0,0,0,0,0,2,2,0,4,4,10,0,18,EL
323b698f,8,3,3,5,0,0,1,1,1,0,1,3,11,0,0,18,EL
32c0491f,4,4,3,1,0,3,6,3,1,0,1,0,4,4,0,18,EL
33072e69,3,2,1,0,2,0,1,1,3,0,3,1,4,3,1,18,EL
33332e0b,7,5,2,4,1,0,7,7,2,2,0,11,18,14,0,18,EL
33591ff0,0,0,0,0,0,0,0,0,0,0,0,0,0,0,0,18,EL
3376a776,4,4,1,2,1,3,3,0,1,1,0,6,10,9,0,18,EL
3392603d,0,0,0,0,0,0,1,1,0,0,0,0,0,1,1,18,EL
339fe0e8,0,0,0,0,0,0,1,1,0,0,0,0,0,2,1,18,EL
33c7af24,2,1,1,1,0,2,2,0,1,0,1,6,8,1,0,18,EL
33d38e32,0,0,0,0,0,0,2,2,3,0,3,1,1,0,0,18,EL
3423f250,6,5,4,1,1,2,13,11,5,0,5,14,20,4,0,18,EL
346d51d9,11,6,5,5,1,4,9,5,3,0,3,5,16,4,0,18,EL
3470f44e,0,0,0,0,0,0,0,0,0,0,0,0,0,0,0,18,EL
3480cb6b,18,9,12,4,2,10,20,10,7,2,5,12,30,12,0,18,EL
348e0505,0,0,0,0,0,0,0,0,2,2,0,0,0,3,0,18,EL
3493992e,2,1,1,1,0,0,2,2,0,0,0,1,3,1,0,18,EL
34bf7740,1,1,0,1,0,0,1,1,3,0,3,0,1,2,0,18,EL
34c3ec17,7,5,2,5,0,2,3,1,0,0,0,1,8,0,0,18,EL
35375f7c,1,1,0,1,0,1,1,0,0,0,0,0,1,1,0,18,EL
35862524,11,7,5,6,0,4,9,5,9,2,7,9,20,8,0,18,EL
35bec436,2,2,1,0,1,0,0,0,1,0,1,1,3,3,0,18,EL
35dd6d80,47,37,34,9,4,33,49,16,9,3,6,21,68,46,0,18,EL
3626daea,7,5,2,5,0,2,7,5,7,1,6,6,13,10,0,18,EL
36a3ff67,2,1,0,2,0,1,4,3,2,0,2,2,4,0,0,18,EL
36d320ec,2,1,1,1,0,0,1,1,2,2,0,0,2,4,1,18,EL
36f288ba,3,3,3,0,0,2,6,4,4,4,0,1,4,7,0,18,EL
3708e9fa,9,8,1,7,1,5,17,12,4,1,3,8,17,1,0,18,EL
375622c5,7,4,5,2,0,2,7,5,1,0,1,2,9,0,0,18,EL
3799e138,15,13,5,7,3,10,24,14,5,0,5,13,28,11,0,18,EL
37f606f0,4,3,0,3,1,2,7,5,2,0,2,4,8,2,0,18,EL
3811e046,2,1,0,2,0,0,1,1,3,0,3,1,3,1,0,18,EL
3904e745,5,3,1,3,1,2,3,1,4,0,4,7,12,19,0,18,EL
390eb94b,2,2,1,1,0,2,2,0,1,0,1,0,2,0,1,18,EL
3935e52e,7,5,5,2,0,5,10,5,5,0,5,2,9,6,1,18,EL
394c5d32,3,2,1,2,0,1,5,4,5,2,3,8,11,6,0,18,EL
3959661b,2,1,1,1,0,1,2,1,3,0,3,0,2,1,0,18,EL
3a8b9635,0,0,0,0,0,0,0,0,0,0,0,1,1,1,0,18,EL
3ad17caa,1,1,1,0,0,0,0,0,1,0,1,0,1,0,0,18,EL
3ad56bf8,3,3,3,0,0,2,5,3,2,1,1,3,6,15,0,18,EL
3b333ac3,15,11,10,3,2,8,16,8,8,3,5,10,25,15,0,18,EL
3b57f7f8,3,3,2,1,0,1,8,7,5,0,5,19,22,12,1,18,EL
3b99b9e1,1,1,0,1,0,0,0,0,1,1,0,1,2,2,0,18,EL
3c285843,0,0,0,0,0,0,1,1,0,0,0,1,1,6,1,18,EL
3cd9e95a,0,0,0,0,0,0,1,1,0,0,0,0,0,0,1,18,EL
3cefcaef,6,4,4,1,1,5,9,4,2,0,2,6,12,11,0,18,EL
3cfc870f,3,1,1,0,2,1,2,1,3,0,3,4,7,0,0,18,EL
3d0fd3d7,0,0,0,0,0,0,0,0,0,0,0,0,0,0,0,18,EL
3d13d9e4,0,0,0,0,0,0,0,0,0,0,0,0,0,0,0,18,EL
3d227f54,0,0,0,0,0,0,0,0,0,0,0,0,0,0,0,18,EL
3d68d631,1,0,0,1,0,0,0,0,1,0,1,1,2,1,0,18,EL
3d7b7d68,0,0,0,0,0,0,1,1,0,0,0,0,0,0,0,18,EL
3da610eb,8,3,5,2,1,2,6,4,4,0,4,5,13,1,0,18,EL
3db34c8e,8,7,2,3,3,2,9,7,2,0,2,1,9,7,0,18,EL
3dfc70ed,0,0,0,0,0,0,0,0,0,0,0,1,1,0,0,18,EL
3e092724,4,4,1,3,0,1,2,1,1,0,1,2,6,0,0,18,EL
3e587547,4,2,3,1,0,4,7,3,1,0,1,1,5,2,0,18,EL
3ead85f9,12,10,7,4,1,4,7,3,4,1,3,6,18,41,0,18,EL
3eb0f2df,0,0,0,0,0,0,2,2,1,1,0,2,2,3,0,18,EL
3ecc11d8,11,8,7,4,0,6,8,2,4,3,1,7,18,22,0,18,EL
3ef0fa48,2,2,1,0,1,1,6,5,7,1,6,6,8,4,0,18,EL
3effaa34,7,2,0,5,2,1,7,6,3,0,3,2,9,8,0,18,EL
3f2d59fe,19,14,14,5,0,8,20,12,7,0,7,16,35,47,0,18,EL
3f30b506,4,3,2,2,0,3,4,1,4,2,2,8,12,11,0,18,EL
3f359b33,4,4,2,2,0,2,3,1,6,5,1,4,8,26,0,18,EL
3faa1780,4,4,1,3,0,3,6,3,4,0,4,2,6,0,0,18,EL
3fc45c73,3,2,2,1,0,3,4,1,2,0,2,3,6,5,0,18,EL
404a2746,4,2,2,2,0,2,2,0,2,1,1,3,7,24,0,18,EL
40f0ed6c,5,3,2,2,1,2,6,4,2,0,2,2,7,3,0,18,EL
410c2fbc,2,0,2,0,0,0,0,0,13,13,0,2,4,30,0,18,EL
4114f306,6,5,3,3,0,2,6,4,1,0,1,0,6,1,0,18,EL
414f7c7d,0,0,0,0,0,0,0,0,1,0,1,0,0,1,0,18,EL
41582151,14,10,9,4,1,9,15,6,8,2,6,11,25,15,0,18,EL
418befe0,10,7,7,3,0,5,6,1,3,0,3,4,14,8,0,18,EL
41afd8cf,12,6,9,3,0,3,9,6,5,3,2,12,24,9,0,18,EL
42276181,2,2,0,1,1,1,3,2,2,0,2,1,3,1,0,18,EL
423e3d0b,3,1,0,3,0,0,3,3,1,1,0,2,5,2,0,18,EL
4285332d,8,6,6,2,0,3,10,7,5,4,1,13,21,49,0,18,EL
42a6cc47,0,0,0,0,0,0,1,1,1,0,1,0,0,0,0,18,EL
42dcf26d,6,3,4,1,1,2,6,4,3,2,1,6,12,13,0,18,EL
42ec696a,0,0,0,0,0,0,0,0,0,0,0,0,0,2,0,18,EL
42fe6b05,4,4,1,3,0,2,3,1,2,0,2,1,5,1,0,18,EL
4315f30d,3,2,2,1,0,1,6,5,2,2,0,5,8,6,0,18,EL
4326c2a9,0,0,0,0,0,0,0,0,0,0,0,1,1,0,0,18,EL
43309491,0,0,0,0,0,0,1,1,0,0,0,0,0,0,0,18,EL
435f829f,0,0,0,0,0,0,0,0,1,1,0,0,0,1,0,18,EL
4383b0da,2,1,0,1,1,0,0,0,0,0,0,1,3,0,0,18,EL
438ae11e,11,7,5,4,2,6,9,3,4,1,3,5,16,5,0,18,EL
43cd8b69,0,0,0,0,0,0,4,4,0,0,0,0,0,1,0,18,EL
43d249bd,7,4,3,4,0,3,5,2,4,1,3,3,10,4,0,18,EL
441950f5,4,2,2,2,0,1,5,4,3,1,2,2,6,3,0,18,EL
4431aed2,0,0,0,0,0,0,1,1,1,0,1,0,0,2,0,18,EL
4442fbcd,20,16,5,13,2,9,21,12,10,1,9,13,33,11,0,18,EL
44865466,7,4,5,2,0,4,7,3,3,0,3,13,20,11,0,18,EL
448a3608,1,0,0,0,1,0,1,1,0,0,0,0,1,3,0,18,EL
44f050bc,3,1,2,1,0,1,2,1,1,0,1,3,6,16,1,18,EL
450ad405,8,6,3,4,1,3,5,2,6,1,5,4,12,14,1,18,EL
45db685d,1,0,0,1,0,1,1,0,0,0,0,0,1,0,0,18,EL
46152b69,9,2,2,7,0,2,6,4,4,1,3,5,14,2,0,18,EL
46a8347f,3,1,1,2,0,2,3,1,0,0,0,3,6,8,0,18,EL
46d50339,11,9,9,2,0,9,11,2,7,1,6,5,16,20,1,18,EL
47064058,1,1,1,0,0,1,1,0,0,0,0,0,1,3,0,18,EL
4737cebe,2,2,1,1,0,1,1,0,2,0,2,1,3,2,0,18,EL
474cf8e0,1,1,1,0,0,0,1,1,1,1,0,1,2,0,0,18,EL
4760b2f2,3,2,3,0,0,3,5,2,9,7,2,12,15,43,1,18,EL
47a34c4f,11,8,5,5,1,5,13,8,13,2,11,15,26,15,1,18,EL
4806ec67,1,0,1,0,0,1,1,0,0,0,0,1,2,1,0,18,EL
4841ba80,0,0,0,0,0,0,1,1,0,0,0,0,0,1,0,18,EL
488350bf,3,3,1,2,0,1,2,1,2,0,2,0,3,1,0,18,EL
48add958,6,4,1,4,1,1,5,4,1,0,1,4,10,0,0,18,EL
491d3ad0,0,0,0,0,0,0,1,1,0,0,0,1,1,1,0,18,EL
493924a7,16,13,9,6,1,4,9,5,7,3,4,9,25,26,0,18,EL
494bff86,1,0,1,0,0,1,4,3,1,0,1,2,3,2,0,18,EL
49ea92be,12,12,3,6,3,5,8,3,13,1,12,12,24,2,0,18,EL
49fe9070,2,2,1,1,0,0,6,6,8,0,8,1,3,1,0,18,EL
4a895384,10,8,6,2,2,6,8,2,17,16,1,13,23,38,2,18,EL
4a97f4c2,9,6,3,5,1,4,12,8,5,0,5,4,13,1,0,18,EL
4aea5077,47,29,19,23,5,26,38,12,24,9,15,22,69,52,0,18,EL
4bd414c1,0,0,0,0,0,0,0,0,2,1,1,1,1,7,0,18,EL
4c07f0e8,18,17,10,5,3,7,15,8,15,4,11,17,35,13,1,18,EL
4c45cdc2,6,6,1,5,0,4,17,13,5,0,5,7,13,3,1,18,EL
4c54b6ec,3,1,2,0,1,1,1,0,0,0,0,1,4,3,0,18,EL
4c5e78da,6,6,2,3,1,1,7,6,5,0,5,3,9,6,0,18,EL
4c6facae,6,5,3,3,0,1,3,2,2,0,2,5,11,3,0,18,EL
4c78b5ed,21,16,5,12,4,13,27,14,8,0,8,17,38,9,0,18,EL
4c82730b,19,9,6,9,4,6,19,13,7,0,7,9,28,0,0,18,EL
4cc82fe1,11,7,8,3,0,4,6,2,10,6,4,12,23,36,1,18,EL
4d478e8b,11,9,7,4,0,6,12,6,5,0,5,5,16,3,0,18,EL
4d64b28e,0,0,0,0,0,0,0,0,0,0,0,0,0,1,0,18,EL
4dedd469,5,4,2,2,1,3,7,4,11,2,9,13,18,32,0,18,EL
4e034598,0,0,0,0,0,0,0,0,0,0,0,0,0,3,0,18,EL
4e0afc5d,9,6,7,2,0,2,6,4,6,2,4,8,17,12,1,18,EL
4e219ad2,5,3,1,2,2,2,12,10,3,1,2,4,9,0,0,18,EL
4e3f5992,13,11,5,7,1,7,17,10,7,0,7,8,21,14,0,18,EL
4e6dbac4,11,5,3,4,4,2,9,7,6,3,3,5,16,10,0,18,EL
4e80a8ef,16,11,7,9,0,3,11,8,8,1,7,5,21,8,0,18,EL
4f182a8f,3,3,2,1,0,2,4,2,3,0,3,3,6,0,0,18,EL
50310821,0,0,0,0,0,0,2,2,0,0,0,0,0,0,0,18,EL
504a654c,1,1,0,1,0,0,0,0,0,0,0,0,1,0,0,18,EL
507c7bdf,13,6,7,6,0,7,16,9,7,0,7,4,17,1,0,18,EL
50c1ff86,5,5,5,0,0,3,6,3,4,0,4,5,10,12,0,18,EL
50ccf47d,24,13,15,9,0,10,13,3,9,3,6,14,38,32,0,18,EL
50e14b3c,0,0,0,0,0,0,0,0,0,0,0,2,2,3,0,18,EL
512a52c6,9,8,4,5,0,8,15,7,11,1,10,6,15,11,0,18,EL
518738b4,5,3,0,3,2,0,5,5,2,0,2,4,9,3,0,18,EL
51a3caf1,2,2,1,1,0,2,2,0,1,0,1,5,7,16,0,18,EL
51b41c5c,13,9,2,11,0,2,6,4,3,2,1,19,32,10,0,18,EL
51e9bb3f,4,4,1,2,1,1,4,3,4,1,3,13,17,2,0,18,EL
520c318f,0,0,0,0,0,0,0,0,0,0,0,0,0,0,0,18,EL
5294a83f,10,8,0,8,2,1,15,14,6,0,6,7,17,2,0,18,EL
529f49ab,16,10,14,0,2,10,24,14,12,2,10,14,30,10,0,18,EL
52e101a8,1,1,1,0,0,1,1,0,1,1,0,0,1,0,0,18,EL
52ec54d0,6,3,2,4,0,1,3,2,0,0,0,9,15,23,1,18,EL
532e1e4f,1,1,1,0,0,1,1,0,2,2,0,0,1,2,0,18,EL
53520a67,8,6,6,2,0,2,6,4,5,1,4,5,13,7,0,18,EL
53685aa2,5,4,2,2,1,2,3,1,1,1,0,3,8,6,0,18,EL
53b03dac,0,0,0,0,0,0,0,0,0,0,0,1,1,6,3,18,EL
53de807a,8,8,6,2,0,6,8,2,4,0,4,11,19,11,1,18,EL
53e07d0b,0,0,0,0,0,0,0,0,0,0,0,0,0,0,0,18,EL
54131505,1,0,0,1,0,0,3,3,2,0,2,0,1,1,0,18,EL
54771b10,20,16,12,7,1,15,29,14,8,3,5,15,35,25,0,18,EL
549922a7,0,0,0,0,0,0,0,0,0,0,0,0,0,1,0,18,EL
54b4dc4e,9,5,5,3,1,3,10,7,5,1,4,5,14,3,0,18,EL
54c9ed15,1,0,1,0,0,1,1,0,0,0,0,1,2,10,0,18,EL
54e0c0cc,0,0,0,0,0,0,0,0,2,0,2,0,0,0,0,18,EL
55126f3b,19,11,8,9,2,5,38,33,13,1,12,10,29,13,1,18,EL
555311f2,5,5,1,4,0,0,2,2,1,0,1,0,5,1,0,18,EL
555d5edd,2,2,1,1,0,1,3,2,4,0,4,1,3,1,1,18,EL
5594dfa6,1,1,1,0,0,0,2,2,2,0,2,0,1,0,0,18,EL
5595a4ff,8,7,3,5,0,6,7,1,1,0,1,9,17,17,1,18,EL
5631b735,13,9,2,7,4,3,16,13,24,4,20,10,23,8,0,18,EL
56ae428b,4,3,4,0,0,1,2,1,11,5,6,7,11,29,0,18,EL
5700824a,9,6,5,3,1,1,6,5,3,0,3,2,11,1,0,18,EL
5710a281,29,17,16,10,3,11,24,13,7,1,6,6,35,7,0,18,EL
57ae16f4,8,5,2,3,3,1,6,5,7,0,7,1,9,1,0,18,EL
57f60036,5,5,2,3,0,2,4,2,5,3,2,9,14,22,0,18,EL
583d6c1f,0,0,0,0,0,0,3,3,0,0,0,0,0,0,0,18,EL
58a3b151,0,0,0,0,0,0,0,0,0,0,0,0,0,0,0,18,EL
58ad9383,0,0,0,0,0,0,0,0,1,0,1,0,0,5,0,18,EL
58ae47b2,5,4,1,3,1,3,10,7,5,0,5,3,8,1,0,18,EL
58dda688,7,4,4,3,0,3,7,4,6,3,3,6,13,19,1,18,EL
59b7d823,16,9,6,9,1,8,17,9,6,2,4,8,24,22,0,18,EL
59e6e5bf,2,2,0,1,1,0,0,0,3,0,3,0,2,1,0,18,EL
59f0c185,0,0,0,0,0,0,0,0,0,0,0,0,0,0,0,18,EL
5a1c49d1,2,2,0,1,1,0,1,1,0,0,0,2,4,4,0,18,EL
5a5d394c,0,0,0,0,0,0,0,0,0,0,0,0,0,0,0,18,EL
5a969ba8,5,1,1,4,0,3,4,1,1,0,1,1,6,1,0,18,EL
5ada5385,3,3,2,1,0,2,4,2,2,0,2,1,4,0,0,18,EL
5b0b23dc,10,8,3,7,0,2,7,5,7,3,4,9,19,6,0,18,EL
5b61fba7,0,0,0,0,0,0,0,0,0,0,0,0,0,0,0,18,EL
5b6cf07c,2,1,0,2,0,0,3,3,0,0,0,3,5,2,0,18,EL
5b887c7a,4,4,2,2,0,2,3,1,8,4,4,8,12,24,2,18,EL
5ba3c9cb,5,4,1,4,0,1,5,4,1,0,1,0,5,2,0,18,EL
5be28712,1,1,0,1,0,0,0,0,2,1,1,9,10,4,0,18,EL
5c46e908,6,5,5,1,0,3,6,3,5,2,3,11,17,16,0,18,EL
5c4dc0ff,0,0,0,0,0,0,4,4,4,0,4,1,1,5,0,18,EL
5c7845f6,4,2,2,2,0,1,2,1,1,0,1,1,5,0,0,18,EL
5c899683,2,2,2,0,0,1,2,1,1,0,1,2,4,1,0,18,EL
5caa62a7,12,7,7,4,1,9,24,15,5,0,5,9,21,2,0,18,EL
5cb1d026,30,19,20,5,5,15,29,14,12,2,10,31,61,34,0,18,EL
5cdddffa,22,15,8,11,3,9,19,10,12,3,9,15,37,6,0,18,EL
5ce0b5ba,11,7,2,7,2,2,10,8,11,2,9,15,26,4,0,18,EL
5d0d1ec7,3,3,3,0,0,1,6,5,4,4,0,8,11,22,0,18,EL
5d13b8ab,4,2,1,2,1,2,3,1,2,0,2,0,4,4,0,18,EL
5d2bb85b,3,2,1,1,1,1,4,3,3,0,3,1,4,3,0,18,EL
5d311e8d,2,1,0,2,0,1,2,1,1,1,0,2,4,3,0,18,EL
5d5219b1,2,2,0,1,1,0,5,5,3,0,3,0,2,0,0,18,EL
5db295be,7,6,2,5,0,2,3,1,3,1,2,3,10,1,0,18,EL
5db2faf1,10,7,5,3,2,4,10,6,4,2,2,5,15,24,0,18,EL
5e8936be,0,0,0,0,0,0,1,1,0,0,0,1,1,4,0,18,EL
5e91ddf8,0,0,0,0,0,0,0,0,0,0,0,0,0,0,2,18,EL
5ed9b537,2,2,2,0,0,1,3,2,4,2,2,5,7,21,2,18,EL
5f9970a0,0,0,0,0,0,0,0,0,0,0,0,0,0,1,0,18,EL
5fdd516f,26,19,17,8,1,16,29,13,10,2,8,21,47,26,1,18,EL
601299e9,10,4,6,2,2,3,17,14,4,1,3,9,19,5,0,18,EL
601be846,4,3,2,2,0,2,3,1,1,0,1,3,7,2,0,18,EL
602bb3f7,18,10,10,8,0,11,12,1,7,4,3,10,28,30,1,18,EL
603cb947,0,0,0,0,0,0,1,1,1,0,1,1,1,1,0,18,EL
605873e1,8,5,1,4,3,2,6,4,3,2,1,10,18,7,0,18,EL
60713cb3,0,0,0,0,0,0,0,0,0,0,0,0,0,3,0,18,EL
60963682,6,6,2,2,2,3,5,2,5,5,0,5,11,9,0,18,EL
60e86875,3,2,2,1,0,0,6,6,3,0,3,0,3,2,0,18,EL
60fd5334,3,1,2,1,0,1,2,1,1,1,0,2,5,6,1,18,EL
612cb8d3,2,1,0,2,0,0,2,2,3,0,3,2,4,0,0,18,EL
615c4d8f,8,3,4,4,0,1,10,9,3,0,3,5,13,6,0,18,EL
61ae3d36,5,3,2,3,0,3,6,3,4,0,4,6,11,7,0,18,EL
61b0b44d,4,2,0,3,1,1,2,1,0,0,0,0,4,1,0,18,EL
61f63784,17,13,11,6,0,12,13,1,7,5,2,6,23,34,0,18,EL
6257811f,0,0,0,0,0,0,0,0,1,0,1,0,0,0,0,18,EL
625c144a,0,0,0,0,0,0,0,0,0,0,0,0,0,1,3,18,EL
62a0089e,1,1,1,0,0,0,0,0,1,0,1,0,1,0,0,18,EL
62e4f112,0,0,0,0,0,0,0,0,0,0,0,0,0,0,0,18,EL
63a60d73,5,3,4,1,0,1,2,1,6,4,2,3,8,21,0,18,EL
63fe0133,9,5,6,3,0,2,6,4,6,2,4,9,18,11,0,18,EL
6407ce4d,1,1,0,1,0,0,2,2,2,0,2,1,2,1,0,18,EL
6419c6f7,3,3,2,1,0,3,7,4,2,0,2,7,10,36,1,18,EL
642bb0c6,1,1,1,0,0,0,0,0,1,0,1,0,1,1,0,18,EL
6434f10d,17,15,7,9,1,7,17,10,6,0,6,7,24,7,1,18,EL
6435e737,5,3,3,2,0,0,5,5,6,0,6,6,11,8,0,18,EL
6448e765,0,0,0,0,0,0,1,1,6,4,2,4,4,5,0,18,EL
644faf10,6,3,0,6,0,1,2,1,0,0,0,0,6,0,0,18,EL
64a674d9,6,6,3,1,2,2,2,0,1,0,1,2,8,3,0,18,EL
64ded08c,8,4,5,2,1,1,5,4,2,0,2,5,13,0,0,18,EL
64e801aa,16,11,6,10,0,7,14,7,12,3,9,20,36,19,1,18,EL
64ec2f85,12,9,5,7,0,2,6,4,7,3,4,17,29,6,0,18,EL
6503ae16,0,0,0,0,0,0,0,0,0,0,0,0,0,1,0,18,EL
65166f80,1,1,1,0,0,1,1,0,0,0,0,0,1,1,0,18,EL
6554bb97,2,2,0,2,0,1,3,2,1,0,1,4,6,3,0,18,EL
65adf2db,1,0,0,1,0,0,0,0,0,0,0,0,1,0,0,18,EL
65d750b5,15,12,4,9,2,7,31,24,11,3,8,11,26,5,0,18,EL
6603fed7,4,3,2,1,1,1,3,2,4,0,4,0,4,1,0,18,EL
6613c819,9,8,6,3,0,1,5,4,3,1,2,14,23,11,0,18,EL
668f2f7c,11,7,8,3,0,4,9,5,3,2,1,8,19,17,0,18,EL
676ff98c,0,0,0,0,0,0,1,1,0,0,0,0,0,0,0,18,EL
6800f515,3,2,1,1,1,3,4,1,1,0,1,1,4,0,0,18,EL
6809ec76,5,3,2,3,0,3,6,3,6,0,6,4,9,7,0,18,EL
68252d6d,3,1,0,1,2,0,4,4,4,0,4,5,8,3,0,18,EL
683b919f,3,3,2,1,0,0,2,2,4,0,4,0,3,0,0,18,EL
685857dc,5,3,0,5,0,1,9,8,6,0,6,8,13,1,0,18,EL
68635c10,7,4,3,2,2,1,5,4,4,2,2,11,18,14,0,18,EL
68829001,16,11,5,8,3,7,12,5,3,2,1,4,20,5,0,18,EL
68a87d66,0,0,0,0,0,0,0,0,0,0,0,0,0,0,0,18,EL
692d8bb0,1,1,0,1,0,1,5,4,1,0,1,0,1,0,0,18,EL
69960ac3,4,3,4,0,0,3,3,0,2,2,0,4,8,13,0,18,EL
699fb8db,7,5,4,2,1,3,6,3,3,2,1,4,11,13,0,18,EL
6a5a9744,0,0,0,0,0,0,0,0,0,0,0,0,0,0,0,18,EL
6a99e0b1,9,7,2,7,0,2,23,21,8,0,8,5,14,2,0,18,EL
6b2c894b,12,10,8,3,1,3,7,4,4,4,0,7,19,10,0,18,EL
6b6cbca4,6,4,6,0,0,2,3,1,7,4,3,14,20,24,0,18,EL
6b85f966,7,6,2,4,1,2,4,2,0,0,0,3,10,4,0,18,EL
6b8b53d7,3,2,2,1,0,2,3,1,1,0,1,0,3,0,0,18,EL
6bb2c084,21,12,10,9,2,4,12,8,12,2,10,18,39,10,2,18,EL
6be86f3d,0,0,0,0,0,0,0,0,0,0,0,0,0,0,0,18,EL
6bfaecc4,0,0,0,0,0,0,0,0,0,0,0,1,1,2,0,18,EL
6bff8a73,8,8,6,2,0,5,6,1,2,1,1,9,17,18,0,18,EL
6c228bb6,0,0,0,0,0,0,0,0,0,0,0,0,0,0,0,18,EL
6c6a3300,4,3,3,1,0,2,6,4,4,0,4,5,9,0,0,18,EL
6c6e2719,6,3,3,2,1,5,8,3,4,0,4,4,10,15,0,18,EL
6c7e441a,0,0,0,0,0,0,0,0,1,1,0,1,1,4,0,18,EL
6ca5ec4b,3,1,2,1,0,2,6,4,4,2,2,1,4,0,0,18,EL
6cafd68d,9,8,5,3,1,5,11,6,11,4,7,4,13,9,1,18,EL
6cd38213,0,0,0,0,0,0,1,1,1,0,1,1,1,6,1,18,EL
6ceef869,5,2,5,0,0,2,2,0,6,3,3,4,9,4,0,18,EL
6d3f2898,4,3,2,1,1,3,3,0,1,0,1,2,6,4,0,18,EL
6dce77a5,9,8,4,5,0,3,9,6,10,3,7,16,25,14,0,18,EL
6dfd8f05,3,3,0,3,0,2,2,0,2,0,2,3,6,1,0,18,EL
6e4df551,8,4,2,5,1,4,13,9,5,2,3,9,17,1,0,18,EL
6e5497ca,7,5,0,5,2,0,2,2,2,0,2,0,7,4,0,18,EL
6e7f1353,27,19,10,14,3,9,45,36,19,0,19,10,37,9,0,18,EL
6e8272e0,5,1,1,2,2,0,5,5,2,0,2,7,12,6,0,18,EL
6e905b8d,0,0,0,0,0,0,0,0,0,0,0,0,0,2,0,18,EL
6f4cf369,6,3,6,0,0,3,5,2,1,1,0,9,15,11,0,18,EL
6f5f82c0,2,0,1,1,0,2,4,2,0,0,0,3,5,1,0,18,EL
6f639ec7,9,8,4,5,0,5,14,9,14,1,13,5,14,6,0,18,EL
6fd1ba62,7,5,2,2,3,2,9,7,5,0,5,9,16,1,0,18,EL
705f5269,0,0,0,0,0,0,0,0,0,0,0,0,0,0,0,18,EL
706a60e1,3,1,0,3,0,2,3,1,0,0,0,1,4,1,0,18,EL
70a9cba5,4,3,2,1,1,3,3,0,1,0,1,1,5,3,0,18,EL
70c52749,13,10,8,5,0,6,13,7,13,3,10,9,22,17,0,18,EL
70e5566a,0,0,0,0,0,0,0,0,0,0,0,0,0,0,0,18,EL
71672fa0,0,0,0,0,0,0,0,0,0,0,0,0,0,2,0,18,EL
71a998b9,17,12,10,6,1,5,14,9,10,4,6,15,32,31,0,18,EL
71d5ca31,10,9,9,1,0,2,3,1,7,6,1,16,26,64,0,18,EL
71ec39ef,26,16,9,14,3,8,18,10,15,4,11,17,43,21,0,18,EL
7214c684,0,0,0,0,0,0,0,0,1,0,1,3,3,3,0,18,EL
721608e5,2,2,2,0,0,1,1,0,0,0,0,0,2,0,0,18,EL
729e3e14,4,3,1,3,0,1,3,2,3,1,2,2,6,4,0,18,EL
72c812f3,8,5,2,4,2,2,5,3,1,0,1,3,11,0,0,18,EL
731e29b8,8,3,2,5,1,1,10,9,10,0,10,4,12,1,0,18,EL
73221bb0,2,1,2,0,0,0,0,0,0,0,0,0,2,0,0,18,EL
7352dca8,2,1,1,0,1,0,1,1,1,0,1,1,3,2,0,18,EL
741e058f,1,1,0,1,0,0,1,1,1,0,1,3,4,0,0,18,EL
746b64a7,2,2,2,0,0,0,4,4,10,7,3,8,10,45,0,18,EL
7483d9f9,15,12,9,6,0,7,18,11,14,10,4,20,35,28,0,18,EL
74bafc9c,14,6,5,7,2,5,14,9,5,0,5,5,19,0,0,18,EL
74d70fb5,4,4,2,2,0,2,3,1,2,0,2,3,7,18,0,18,EL
75229233,7,7,4,3,0,1,5,4,5,2,3,14,21,9,0,18,EL
762179d9,3,2,0,2,1,2,4,2,4,0,4,4,7,1,0,18,EL
7628b359,6,4,1,3,2,2,6,4,6,0,6,9,15,9,0,18,EL
76806215,0,0,0,0,0,0,0,0,1,0,1,1,1,4,4,18,EL
768667c0,0,0,0,0,0,0,0,0,0,0,0,0,0,1,0,18,EL
768a35ac,0,0,0,0,0,0,0,0,0,0,0,0,0,0,0,18,EL
76d5857d,4,3,3,1,0,2,5,3,4,3,1,6,10,11,0,18,EL
76d753f8,19,14,6,12,1,4,29,25,7,0,7,8,27,4,0,18,EL
76dd1480,6,5,1,5,0,2,4,2,7,1,6,1,7,2,0,18,EL
76ecfb22,3,3,2,1,0,1,3,2,1,1,0,3,6,2,0,18,EL
7750462c,0,0,0,0,0,0,0,0,1,0,1,0,0,0,1,18,EL
77cf8da0,10,9,6,4,0,6,7,1,7,2,5,4,14,9,0,18,EL
77d7c96f,9,5,6,3,0,3,3,0,5,0,5,7,16,13,0,18,EL
77f278a0,5,2,1,3,1,1,6,5,4,0,4,3,8,2,0,18,EL
781b698a,0,0,0,0,0,0,1,1,1,1,0,0,0,1,0,18,EL
78841da9,0,0,0,0,0,0,0,0,0,0,0,0,0,1,0,18,EL
78952998,5,3,4,1,0,3,10,7,1,0,1,4,9,2,0,18,EL
79019bf4,7,6,2,5,0,4,9,5,3,0,3,9,16,6,0,18,EL
79370f8c,5,2,2,3,0,3,6,3,0,0,0,1,6,0,0,18,EL
794e2914,2,1,1,1,0,2,2,0,0,0,0,2,4,4,0,18,EL
799caf80,6,3,1,2,3,2,4,2,1,0,1,4,10,2,0,18,EL
79b0d6a0,0,0,0,0,0,0,0,0,0,0,0,0,0,1,0,18,EL
79c90e45,3,1,1,1,1,0,1,1,8,3,5,5,8,5,0,18,EL
79ca3e23,5,5,2,2,1,2,4,2,0,0,0,2,7,1,0,18,EL
7a2cf111,7,5,3,4,0,3,8,5,2,1,1,7,14,14,0,18,EL
7aac47fe,4,4,3,1,0,1,1,0,1,0,1,4,8,7,0,18,EL
7abbf224,1,1,1,0,0,0,0,0,1,0,1,2,3,7,0,18,EL
7b4a62af,0,0,0,0,0,0,0,0,0,0,0,0,0,0,0,18,EL
7b66eec0,4,4,2,2,0,3,6,3,11,8,3,14,18,53,0,18,EL
7b9ecf02,2,1,1,1,0,1,3,2,1,1,0,9,11,22,0,18,EL
7beecde1,2,2,1,1,0,1,4,3,3,2,1,4,6,9,0,18,EL
7bfd96fd,3,2,3,0,0,2,2,0,3,1,2,7,10,11,0,18,EL
7c104bb7,2,1,1,1,0,0,4,4,0,0,0,5,7,0,0,18,EL
7c1a0c67,0,0,0,0,0,0,1,1,3,0,3,2,2,5,0,18,EL
7c224498,9,6,6,3,0,5,14,9,10,1,9,12,21,33,0,18,EL
7ca9f0f0,11,10,9,2,0,5,10,5,5,2,3,8,19,2,1,18,EL
7cd78926,26,20,17,8,1,9,18,9,6,1,5,15,41,24,0,18,EL
7d74f9fd,1,0,0,0,1,0,0,0,0,0,0,1,2,1,0,18,EL
7d974435,9,7,4,5,0,6,16,10,5,2,3,9,18,3,0,18,EL
7dca49f6,5,3,0,4,1,2,7,5,6,0,6,3,8,5,0,18,EL
7e56d3db,5,4,3,1,1,2,4,2,4,0,4,4,9,7,0,18,EL
7e925fa3,5,4,3,2,0,4,4,0,2,0,2,5,10,6,0,18,EL
7e927fda,18,14,13,5,0,8,8,0,7,4,3,20,38,49,0,18,EL
7eb97a8e,2,0,0,2,0,1,1,0,2,0,2,0,2,0,0,18,EL
7ebfac0f,2,2,2,0,0,2,3,1,0,0,0,2,4,0,0,18,EL
7f5ca4f8,2,1,1,1,0,2,2,0,0,0,0,4,6,2,0,18,EL
7f609bfc,10,5,8,2,0,7,10,3,5,3,2,15,25,19,0,18,EL
7f78ad23,12,9,10,2,0,4,7,3,5,1,4,6,18,11,0,18,EL
7fd58fe3,13,10,7,6,0,6,20,14,2,0,2,11,24,8,1,18,EL
807e869a,13,7,4,8,1,3,12,9,8,0,8,2,15,5,0,18,EL
808d48f3,16,10,8,7,1,10,14,4,1,1,0,6,22,12,0,18,EL
80a479ab,2,1,0,2,0,0,0,0,1,0,1,1,3,2,0,18,EL
810486a5,20,14,13,7,0,8,12,4,11,7,4,18,38,30,1,18,EL
81442ecb,14,11,7,2,5,4,5,1,7,0,7,2,16,0,0,18,EL
816192f0,3,2,1,2,0,1,2,1,3,0,3,4,7,6,1,18,EL
816cdcbb,2,1,0,2,0,2,4,2,0,0,0,1,3,0,0,18,EL
819f3a54,3,3,2,1,0,2,3,1,3,0,3,3,6,4,0,18,EL
81b013ec,12,9,8,3,1,4,11,7,9,1,8,13,25,6,0,18,EL
81fa2f75,5,4,5,0,0,2,7,5,11,2,9,9,14,10,0,18,EL
8229a21c,22,16,19,3,0,13,20,7,10,4,6,9,31,42,0,18,EL
826313e2,15,7,13,1,1,7,20,13,6,0,6,13,28,28,0,18,EL
82671804,40,20,16,23,1,10,34,24,25,5,20,19,59,40,1,18,EL
8270ccf9,6,4,4,1,1,3,6,3,2,1,1,4,10,8,0,18,EL
82927de4,8,6,2,5,1,2,7,5,9,0,9,3,11,4,0,18,EL
82b1198a,0,0,0,0,0,0,0,0,0,0,0,0,0,3,0,18,EL
833fb62e,4,1,0,2,2,2,2,0,1,0,1,0,4,0,1,18,EL
8395ab90,1,1,1,0,0,0,0,0,1,0,1,3,4,2,0,18,EL
83b9c48f,33,24,13,18,2,10,20,10,9,2,7,23,56,9,0,18,EL
84399660,7,6,2,4,1,4,5,1,1,0,1,5,12,1,0,18,EL
8454388c,10,7,6,3,1,4,6,2,5,1,4,3,13,12,0,18,EL
84549a07,3,3,1,1,1,0,1,1,2,1,1,2,5,2,0,18,EL
84566787,0,0,0,0,0,0,0,0,2,0,2,0,0,0,0,18,EL
8494acc4,0,0,0,0,0,0,1,1,0,0,0,2,2,5,0,18,EL
8497faf7,18,12,7,9,2,7,11,4,3,1,2,9,27,8,0,18,EL
84ad89fa,8,1,5,3,0,5,13,8,4,2,2,17,25,13,0,18,EL
84cef920,19,16,17,2,0,10,15,5,9,3,6,25,44,37,0,18,EL
84e5adcd,2,1,0,0,2,0,2,2,1,0,1,1,3,6,0,18,EL
8530dd74,0,0,0,0,0,0,1,1,1,0,1,0,0,0,0,18,EL
85f8571a,8,6,6,2,0,2,7,5,3,0,3,12,20,31,0,18,EL
85fd00dd,15,11,10,4,1,10,11,1,3,0,3,5,20,14,0,18,EL
86dd16a8,14,8,10,4,0,4,12,8,3,0,3,9,23,18,0,18,EL
8746d5d0,6,3,3,2,1,4,8,4,5,1,4,8,14,10,0,18,EL
87c7c2b1,0,0,0,0,0,0,1,1,0,0,0,0,0,1,0,18,EL
884a8908,6,3,4,1,1,3,4,1,3,0,3,6,12,2,0,18,EL
889b3bd7,0,0,0,0,0,0,0,0,1,0,1,0,0,1,0,18,EL
88a9ea33,0,0,0,0,0,0,5,5,0,0,0,2,2,5,0,18,EL
88b748d2,1,1,1,0,0,1,1,0,0,0,0,0,1,6,0,18,EL
88cd098e,5,4,1,3,1,2,4,2,2,0,2,1,6,0,0,18,EL
88d4144a,13,11,5,7,1,8,14,6,4,0,4,16,29,10,0,18,EL
88e357ef,0,0,0,0,0,0,0,0,0,0,0,0,0,0,0,18,EL
89565ac5,6,4,3,3,0,4,5,1,4,1,3,8,14,3,0,18,EL
896c126c,7,6,5,1,1,4,12,8,1,0,1,5,12,7,0,18,EL
89b2c8a9,0,0,0,0,0,0,1,1,0,0,0,0,0,0,0,18,EL
8a2248b4,0,0,0,0,0,0,0,0,0,0,0,0,0,2,0,18,EL
8a6ab963,0,0,0,0,0,0,0,0,0,0,0,0,0,2,0,18,EL
8b3fd3af,0,0,0,0,0,0,1,1,0,0,0,1,1,0,0,18,EL
8c3c640c,5,4,1,4,0,1,2,1,5,2,3,3,8,0,0,18,EL
8cc29864,1,1,0,1,0,0,0,0,1,1,0,4,5,5,0,18,EL
8ce063f9,2,1,0,2,0,1,1,0,4,0,4,4,6,1,0,18,EL
8cfcf5bb,2,1,2,0,0,1,1,0,0,0,0,3,5,4,0,18,EL
8d3bca49,1,1,1,0,0,1,1,0,0,0,0,0,1,1,0,18,EL
8d3d3b0a,1,1,0,1,0,0,0,0,0,0,0,0,1,0,0,18,EL
8da74c05,1,1,0,1,0,0,0,0,0,0,0,5,6,2,1,18,EL
8dbff17c,13,8,10,2,1,9,17,8,11,8,3,24,37,82,1,18,EL
8e19242c,0,0,0,0,0,0,1,1,0,0,0,0,0,1,0,18,EL
8e92be30,0,0,0,0,0,0,0,0,1,0,1,0,0,0,0,18,EL
8ed1d91b,15,12,10,5,0,10,15,5,11,7,4,8,23,11,0,18,EL
8f056768,28,21,13,10,5,12,36,24,15,2,13,11,39,14,0,18,EL
8f299faf,9,9,8,1,0,7,10,3,5,3,2,10,19,20,0,18,EL
8f4d116f,9,6,5,4,0,4,8,4,12,7,5,24,33,51,0,18,EL
8f696594,5,5,2,1,2,3,10,7,4,0,4,3,8,1,0,18,EL
8ff07990,2,2,1,0,1,2,2,0,1,0,1,1,3,2,0,18,EL
903b3b77,6,6,6,0,0,1,4,3,9,8,1,19,25,47,0,18,EL
90624e56,0,0,0,0,0,0,2,2,2,0,2,2,2,1,0,18,EL
908eea67,5,4,3,2,0,2,4,2,6,5,1,8,13,15,0,18,EL
9109185e,1,0,1,0,0,0,0,0,0,0,0,0,1,0,1,18,EL
91538ba3,6,3,5,1,0,2,4,2,10,7,3,15,21,33,0,18,EL
917ddcdf,0,0,0,0,0,0,1,1,2,1,1,0,0,1,0,18,EL
91899ca8,3,3,2,1,0,1,4,3,5,4,1,10,13,13,0,18,EL
921f6058,11,7,10,1,0,5,8,3,9,6,3,12,23,22,0,18,EL
92232aad,8,4,4,3,1,2,3,1,3,0,3,4,12,21,0,18,EL
9228b07c,6,2,3,3,0,2,10,8,5,2,3,2,8,4,0,18,EL
923f4dda,2,2,0,1,1,0,1,1,1,0,1,0,2,4,0,18,EL
92432bc6,56,35,13,37,6,21,46,25,32,3,29,23,79,22,0,18,EL
9243fea6,0,0,0,0,0,0,1,1,0,0,0,0,0,0,0,18,EL
92948149,10,7,8,2,0,5,6,1,4,0,4,3,13,8,0,18,EL
92c62328,0,0,0,0,0,0,0,0,0,0,0,1,1,3,4,18,EL
92fffd91,1,1,1,0,0,1,2,1,2,0,2,4,5,0,0,18,EL
936d9e3e,0,0,0,0,0,0,0,0,0,0,0,0,0,0,0,18,EL
93a194e1,6,4,3,3,0,2,5,3,7,3,4,11,17,41,0,18,EL
93a50d2c,9,4,4,4,1,2,5,3,2,1,1,10,19,33,0,18,EL
93b0fa3c,9,5,5,3,1,2,13,11,2,0,2,3,12,1,0,18,EL
93b891d1,5,4,1,3,1,0,3,3,7,3,4,2,7,2,0,18,EL
93bf37c5,0,0,0,0,0,0,1,1,2,1,1,1,1,4,0,18,EL
94d260aa,9,5,4,4,1,6,8,2,8,6,2,18,27,42,1,18,EL
94f8d10c,7,6,5,2,0,5,9,4,8,7,1,8,15,89,0,18,EL
950ff24d,1,0,1,0,0,1,1,0,0,0,0,0,1,1,1,18,EL
951a4ee4,7,4,3,4,0,2,7,5,2,1,1,6,13,1,0,18,EL
951f1739,0,0,0,0,0,0,6,6,3,0,3,0,0,2,0,18,EL
958aba30,2,2,0,2,0,2,4,2,3,1,2,5,7,30,0,18,EL
95a34045,10,7,7,3,0,4,5,1,4,4,0,17,27,43,0,18,EL
963829d0,10,7,4,5,1,2,12,10,7,0,7,1,11,11,0,18,EL
9674002f,8,3,2,3,3,2,6,4,3,0,3,5,13,0,0,18,EL
96f2d977,7,5,5,2,0,2,6,4,1,0,1,1,8,1,0,18,EL
972d595a,0,0,0,0,0,0,0,0,0,0,0,0,0,0,0,18,EL
9731ab71,2,1,2,0,0,0,2,2,0,0,0,0,2,1,0,18,EL
97bfa797,3,3,0,2,1,1,4,3,1,0,1,1,4,3,0,18,EL
9804ba8b,0,0,0,0,0,0,0,0,0,0,0,0,0,0,0,18,EL
9836e892,0,0,0,0,0,0,1,1,1,0,1,4,4,1,0,18,EL
9866afec,11,7,3,7,1,2,10,8,4,0,4,8,19,1,0,18,EL
98d2c2c4,34,27,12,21,1,8,21,13,14,0,14,21,55,10,1,18,EL
98daa26a,3,1,1,2,0,0,2,2,1,0,1,1,4,5,0,18,EL
998d5709,2,2,2,0,0,0,1,1,0,0,0,1,3,1,0,18,EL
99a5321f,3,2,1,0,2,1,2,1,4,2,2,4,7,2,0,18,EL
99de6b6f,2,2,1,1,0,0,2,2,1,0,1,3,5,2,0,18,EL
9a1f2e1c,23,15,9,10,4,11,13,2,4,1,3,15,38,18,0,18,EL
9a2e0ccc,7,6,0,6,1,1,8,7,4,0,4,2,9,3,0,18,EL
9a34c46d,14,4,7,3,4,8,11,3,9,1,8,5,19,14,0,18,EL
9a493fb7,11,5,6,3,2,5,8,3,5,1,4,7,18,4,0,18,EL
9a6cfc02,3,1,1,1,1,0,0,0,3,0,3,7,10,6,0,18,EL
9ae9eaea,16,11,12,3,1,6,10,4,6,2,4,12,28,36,0,18,EL
9b6df52f,2,2,1,0,1,1,4,3,0,0,0,4,6,11,0,18,EL
9c318325,4,3,1,2,1,3,7,4,11,1,10,3,7,6,0,18,EL
9cc4ae6d,0,0,0,0,0,0,0,0,0,0,0,0,0,0,0,18,EL
9d01ec0f,11,8,8,3,0,3,4,1,2,0,2,0,11,2,0,18,EL
9d0f626a,0,0,0,0,0,0,0,0,0,0,0,0,0,1,1,18,EL
9d12e142,0,0,0,0,0,0,0,0,0,0,0,0,0,6,2,18,EL
9d1e8e76,8,6,2,5,1,4,14,10,3,0,3,10,18,4,0,18,EL
9d1f0c99,10,5,8,2,0,5,6,1,3,1,2,6,16,10,0,18,EL
9d4c45d6,10,7,3,6,1,0,5,5,1,0,1,3,13,1,0,18,EL
9d971f13,11,7,1,7,3,1,15,14,7,1,6,5,16,4,0,18,EL
9dbb75ca,4,4,0,3,1,0,6,6,4,0,4,1,5,0,0,18,EL
9dc39955,0,0,0,0,0,0,0,0,1,0,1,0,0,0,0,18,EL
9deab2db,6,4,4,1,1,2,3,1,2,0,2,5,11,0,1,18,EL
9efa1d25,6,2,1,2,3,0,7,7,3,1,2,1,7,2,0,18,EL
9f0ea33f,0,0,0,0,0,0,1,1,1,0,1,0,0,2,0,18,EL
9f156830,3,2,3,0,0,1,4,3,1,1,0,3,6,1,0,18,EL
9f1893b9,10,5,3,7,0,0,8,8,12,0,12,3,13,3,0,18,EL
9f323c71,7,3,6,1,0,1,5,4,4,0,4,4,11,9,0,18,EL
9f381d8b,6,2,1,2,3,1,2,1,1,0,1,1,7,0,0,18,EL
9f979eb2,4,4,3,1,0,1,3,2,3,3,0,1,5,11,0,18,EL
9f9c57f0,1,1,0,1,0,0,2,2,3,1,2,1,2,7,1,18,EL
9fc0f253,8,5,6,2,0,6,7,1,5,1,4,7,15,31,0,18,EL
9fc2531b,5,2,1,3,1,0,5,5,0,0,0,1,6,3,0,18,EL
Besar-Iseni,0,0,0,0,0,0,0,0,0,0,0,0,0,0,0,18,EL
Binyam-Belay,0,0,0,0,0,0,0,0,0,0,0,0,0,0,0,18,EL
Filip-Stojchevski,0,0,0,0,0,0,0,0,0,0,0,0,0,0,0,18,EL
Petr-Hronek,0,0,0,0,0,0,0,0,0,0,0,0,0,0,0,18,EL
a0255c67,4,3,2,0,2,2,4,2,1,0,1,1,5,0,0,18,EL
a0313275,12,7,9,1,2,3,7,4,2,0,2,4,16,8,0,18,EL
a08b5224,1,0,1,0,0,1,1,0,1,0,1,0,1,0,0,18,EL
a08b974a,28,21,9,15,4,9,22,13,23,0,23,12,40,18,0,18,EL
a0c8a672,0,0,0,0,0,0,0,0,0,0,0,1,1,1,0,18,EL
a0d59251,15,12,13,1,1,9,23,14,6,2,4,8,23,9,0,18,EL
a1216563,14,7,5,5,4,3,12,9,10,1,9,7,21,6,0,18,EL
a1474d8e,0,0,0,0,0,0,1,1,3,0,3,0,0,0,0,18,EL
a190d597,1,0,0,0,1,1,3,2,1,0,1,1,2,2,0,18,EL
a19be070,3,1,0,0,3,0,2,2,3,0,3,0,3,0,0,18,EL
a1a9ef78,6,4,6,0,0,3,3,0,8,6,2,5,11,40,0,18,EL
a2560346,0,0,0,0,0,0,0,0,0,0,0,0,0,0,0,18,EL
a26c1727,8,3,5,1,2,0,4,4,5,0,5,2,10,1,0,18,EL
a2f2d806,1,1,0,1,0,0,0,0,1,0,1,2,3,8,0,18,EL
a33a0dc0,4,3,0,4,0,0,1,1,3,0,3,1,5,2,0,18,EL
a3b03921,11,10,7,3,1,3,6,3,8,1,7,4,15,0,0,18,EL
a3b0ed18,0,0,0,0,0,0,0,0,0,0,0,0,0,1,1,18,EL
a3bf2258,4,3,1,2,1,2,5,3,1,0,1,0,4,0,0,18,EL
a3ddb1b9,4,3,1,3,0,4,8,4,0,0,0,2,6,1,0,18,EL
a44f7c60,7,6,3,3,1,4,10,6,3,1,2,4,11,4,0,18,EL
a47e7ecd,6,3,4,2,0,5,9,4,6,3,3,5,11,34,0,18,EL
a498e276,5,3,5,0,0,3,3,0,4,3,1,6,11,14,1,18,EL
a49fd565,5,4,3,1,1,3,5,2,4,1,3,10,15,18,0,18,EL
a4bd9edd,0,0,0,0,0,0,0,0,0,0,0,0,0,0,0,18,EL
a4effc55,4,2,0,3,1,2,3,1,2,2,0,3,7,8,0,18,EL
a4fe8cda,6,2,2,2,2,1,11,10,5,1,4,2,8,3,0,18,EL
a5296e55,0,0,0,0,0,0,3,3,1,0,1,1,1,1,0,18,EL
a53649b7,0,0,0,0,0,0,0,0,0,0,0,0,0,0,0,18,EL
a565da59,0,0,0,0,0,0,0,0,0,0,0,0,0,3,1,18,EL
a5d101a9,11,9,6,5,0,0,14,14,16,5,11,22,33,18,0,18,EL
a5db0bec,11,9,3,7,1,2,13,11,7,3,4,3,14,14,0,18,EL
a62c16d0,12,5,3,6,3,3,10,7,7,0,7,1,13,7,0,18,EL
a63a995f,6,3,3,3,0,3,7,4,3,1,2,9,15,8,0,18,EL
a6951bf8,10,8,4,6,0,1,5,4,3,1,2,11,21,0,0,18,EL
a6de370d,13,6,5,2,6,3,5,2,11,0,11,3,16,0,0,18,EL
a7121625,0,0,0,0,0,0,0,0,0,0,0,0,0,1,0,18,EL
a78147dd,8,6,5,3,0,2,8,6,4,1,3,8,16,3,0,18,EL
a78ff07f,2,2,1,1,0,1,3,2,1,0,1,2,4,0,0,18,EL
a81ed730,14,8,4,9,1,5,18,13,5,1,4,7,21,4,0,18,EL
a81f4896,9,7,6,2,1,6,9,3,5,4,1,4,13,26,0,18,EL
a8327abd,13,8,6,6,1,5,10,5,4,1,3,7,20,1,0,18,EL
a898d91e,2,1,1,1,0,0,0,0,2,1,1,1,3,1,0,18,EL
a8a874f1,25,17,11,8,6,5,13,8,4,0,4,11,36,5,1,18,EL
a8c0acb7,5,4,4,1,0,3,3,0,2,0,2,1,6,12,0,18,EL
a9440c25,2,2,2,0,0,0,3,3,3,1,2,3,5,5,0,18,EL
a96e5dc0,3,2,1,1,1,1,4,3,1,0,1,4,7,6,1,18,EL
a97afc61,2,1,2,0,0,1,6,5,2,1,1,5,7,7,0,18,EL
a9a3b55d,0,0,0,0,0,0,0,0,0,0,0,1,1,0,0,18,EL
a9aa0d1d,18,12,7,10,1,3,13,10,7,3,4,3,21,3,0,18,EL
a9e68c94,6,5,2,3,1,2,11,9,1,0,1,3,9,0,0,18,EL
aa51343f,2,1,0,2,0,0,2,2,2,1,1,0,2,0,0,18,EL
aa8e289e,7,3,1,3,3,2,12,10,9,0,9,6,13,6,0,18,EL
aa954c2b,1,1,0,1,0,0,0,0,0,0,0,0,1,0,0,18,EL
aacdfe88,29,20,20,8,1,24,30,6,8,3,5,15,44,27,0,18,EL
aad48be9,3,1,2,1,0,1,1,0,3,1,2,2,5,14,0,18,EL
aad4f74f,0,0,0,0,0,0,0,0,0,0,0,0,0,0,0,18,EL
aad56ca3,0,0,0,0,0,0,0,0,0,0,0,0,0,0,0,18,EL
aad9c3f3,5,3,1,2,2,1,4,3,3,0,3,0,5,0,0,18,EL
aae44006,1,0,0,0,1,1,1,0,0,0,0,0,1,0,0,18,EL
aaee68f1,0,0,0,0,0,0,0,0,2,0,2,1,1,0,0,18,EL
ab6928f2,0,0,0,0,0,0,0,0,2,1,1,3,3,2,0,18,EL
ab700320,6,5,1,4,1,2,6,4,7,1,6,3,9,2,0,18,EL
abb42ce6,6,4,2,4,0,3,8,5,0,0,0,8,14,5,0,18,EL
abcfaa50,1,1,1,0,0,1,2,1,1,0,1,0,1,0,0,18,EL
ac7e640b,15,9,8,7,0,6,11,5,11,5,6,21,36,26,0,18,EL
ad10eae0,11,8,4,7,0,6,12,6,1,0,1,10,21,18,0,18,EL
ad178594,1,1,1,0,0,1,2,1,2,2,0,5,6,5,0,18,EL
ad625c12,2,0,1,0,1,1,1,0,1,0,1,0,2,0,0,18,EL
ae0f7da7,2,2,1,1,0,0,4,4,3,0,3,3,5,1,0,18,EL
ae3e6d85,5,3,2,3,0,1,6,5,7,1,6,3,8,3,0,18,EL
aec6b711,0,0,0,0,0,0,1,1,1,0,1,1,1,0,0,18,EL
aeee3365,1,1,1,0,0,0,0,0,0,0,0,0,1,2,0,18,EL
af03f0b9,5,3,1,4,0,1,5,4,3,0,3,0,5,0,0,18,EL
af50141d,5,2,2,2,1,2,8,6,2,0,2,4,9,2,0,18,EL
af8cabe1,2,1,1,0,1,1,2,1,1,0,1,3,5,4,0,18,EL
af8e4246,6,4,2,4,0,0,4,4,0,0,0,2,8,0,0,18,EL
af97a8af,6,4,2,4,0,0,3,3,2,0,2,0,6,3,1,18,EL
afda7d82,11,9,3,6,2,1,10,9,6,1,5,8,19,3,0,18,EL
b01e6102,7,4,4,3,0,4,8,4,3,1,2,5,12,16,0,18,EL
b037bd4f,4,2,1,2,1,0,7,7,3,0,3,5,9,0,0,18,EL
b073f5ea,3,3,1,2,0,1,3,2,6,5,1,7,10,13,0,18,EL
b0fce72c,3,2,0,2,1,1,3,2,1,0,1,1,4,3,0,18,EL
b1062a37,8,4,7,1,0,4,8,4,13,10,3,16,24,51,0,18,EL
b12c68bf,18,12,7,7,4,5,21,16,12,2,10,15,33,17,0,18,EL
b15e93aa,8,8,4,4,0,0,3,3,4,0,4,3,11,1,0,18,EL
b175c21c,1,0,1,0,0,0,4,4,3,0,3,5,6,4,0,18,EL
b18095b6,3,2,2,1,0,0,1,1,1,1,0,2,5,8,0,18,EL
b182a240,3,3,1,2,0,1,2,1,0,0,0,1,4,0,0,18,EL
b1deecf8,6,5,6,0,0,0,0,0,2,1,1,3,9,13,0,18,EL
b20eece9,1,0,1,0,0,1,2,1,1,0,1,0,1,4,0,18,EL
b20f5a66,2,1,2,0,0,0,3,3,4,2,2,5,7,11,0,18,EL
b2484b77,4,3,1,2,1,3,4,1,3,0,3,3,7,2,0,18,EL
b2bee28a,0,0,0,0,0,0,1,1,2,0,2,1,1,0,0,18,EL
b2db927b,4,3,3,1,0,1,4,3,0,0,0,4,8,5,0,18,EL
b2ec3323,8,5,2,5,1,1,6,5,8,1,7,3,11,0,0,18,EL
b2f1fbd5,10,7,6,3,1,3,8,5,13,4,9,10,20,32,2,18,EL
b340a30a,0,0,0,0,0,0,2,2,2,0,2,1,1,3,0,18,EL
b3aed40d,19,17,13,5,1,15,22,7,9,5,4,5,24,29,0,18,EL
b3b310f0,2,1,2,0,0,1,2,1,1,0,1,0,2,3,0,18,EL
b3dc6eca,6,6,2,4,0,4,5,1,8,3,5,13,19,26,0,18,EL
b418dbd4,21,13,8,11,2,8,19,11,7,0,7,3,24,9,0,18,EL
b437b9bd,1,1,1,0,0,1,1,0,0,0,0,1,2,0,0,18,EL
b4541446,2,2,2,0,0,1,3,2,2,0,2,1,3,1,0,18,EL
b45e185a,6,5,3,3,0,2,4,2,3,0,3,3,9,1,0,18,EL
b48215cd,5,4,3,2,0,1,7,6,8,0,8,5,10,3,0,18,EL
b4825073,7,6,5,2,0,4,9,5,3,0,3,7,14,10,0,18,EL
b54ea609,5,4,4,1,0,3,5,2,2,1,1,11,16,11,0,18,EL
b583aef5,0,0,0,0,0,0,0,0,0,0,0,0,0,3,0,18,EL
b58b3e7b,0,0,0,0,0,0,0,0,0,0,0,0,0,0,0,18,EL
b5920350,0,0,0,0,0,0,2,2,1,0,1,0,0,1,0,18,EL
b5b2e1ba,5,2,0,4,1,1,1,0,0,0,0,1,6,0,0,18,EL
b653b65b,5,2,2,3,0,0,2,2,0,0,0,3,8,0,0,18,EL
b682dcf6,16,8,12,4,0,9,12,3,8,4,4,4,20,20,1,18,EL
b686f4c0,8,7,3,4,1,5,9,4,6,0,6,2,10,4,0,18,EL
b6a6e0a7,9,8,6,3,0,7,13,6,4,0,4,5,14,5,0,18,EL
b6b2b820,2,2,0,1,1,0,3,3,1,0,1,1,3,1,0,18,EL
b7084daf,3,1,0,2,1,1,4,3,1,0,1,0,3,1,1,18,EL
b70be510,8,8,6,1,1,6,9,3,7,6,1,11,19,33,0,18,EL
b746d309,4,3,3,1,0,1,4,3,3,2,1,6,10,6,0,18,EL
b75af9ce,4,2,2,1,1,1,6,5,2,0,2,5,9,0,0,18,EL
b7d8cbb9,0,0,0,0,0,0,1,1,0,0,0,1,1,0,0,18,EL
b7e1c3b5,1,0,0,1,0,0,1,1,0,0,0,1,2,1,0,18,EL
b7f2edff,6,5,2,3,1,2,2,0,2,1,1,2,8,6,0,18,EL
b825a650,2,2,2,0,0,2,8,6,3,2,1,9,11,4,1,18,EL
b8814868,17,10,7,10,0,3,13,10,11,0,11,12,29,7,0,18,EL
b8ae831b,19,15,15,4,0,13,19,6,2,2,0,18,37,38,0,18,EL
b8fb9e84,5,2,0,5,0,0,0,0,0,0,0,0,5,1,0,18,EL
b9177a6f,4,2,1,2,1,2,4,2,9,0,9,1,5,1,0,18,EL
b93b7882,0,0,0,0,0,0,1,1,1,0,1,0,0,2,0,18,EL
b9747ada,0,0,0,0,0,0,1,1,3,0,3,1,1,1,0,18,EL
b9c19ad9,1,0,1,0,0,0,1,1,0,0,0,2,3,2,0,18,EL
ba6e52b0,4,1,2,2,0,1,6,5,2,1,1,11,15,23,0,18,EL
ba7673a6,1,0,0,1,0,0,0,0,1,0,1,0,1,0,0,18,EL
ba998e22,4,3,2,2,0,1,3,2,2,1,1,8,12,28,0,18,EL
bafcf742,25,16,16,9,0,15,23,8,11,6,5,12,37,28,0,18,EL
bb19da7c,2,1,0,1,1,1,5,4,1,0,1,1,3,0,0,18,EL
bb25c778,0,0,0,0,0,0,0,0,0,0,0,0,0,3,0,18,EL
bb31def4,0,0,0,0,0,0,0,0,0,0,0,0,0,0,0,18,EL
bb6ab7af,4,2,3,1,0,2,3,1,0,0,0,2,6,1,0,18,EL
bba30585,9,6,6,3,0,8,14,6,3,2,1,14,23,25,0,18,EL
bbddc31f,2,2,1,1,0,0,1,1,1,0,1,2,4,3,0,18,EL
bc5b5be5,3,1,0,2,1,0,3,3,0,0,0,0,3,0,0,18,EL
bc6bd723,2,2,0,2,0,1,5,4,0,0,0,1,3,2,0,18,EL
bcb2ccd8,0,0,0,0,0,0,0,0,0,0,0,0,0,1,0,18,EL
bcd1bea2,5,4,3,2,0,1,5,4,5,2,3,1,6,3,0,18,EL
bcd9b19c,18,14,8,9,1,7,11,4,3,0,3,13,31,14,0,18,EL
bdf7b97d,4,2,3,1,0,2,7,5,0,0,0,0,4,3,0,18,EL
be170419,6,6,5,1,0,2,3,1,4,2,2,5,11,11,0,18,EL
be42a291,8,6,2,3,3,1,15,14,3,0,3,1,9,0,0,18,EL
be6cd760,1,0,0,1,0,0,0,0,3,3,0,1,2,6,0,18,EL
beb391dd,8,3,6,2,0,1,7,6,1,0,1,1,9,3,0,18,EL
beb6c168,9,7,3,6,0,2,7,5,8,2,6,7,16,14,0,18,EL
bece776f,11,5,3,6,2,3,11,8,7,0,7,1,12,0,0,18,EL
beec76cc,5,3,0,3,2,1,6,5,2,2,0,2,7,6,0,18,EL
bef09ca8,8,5,7,1,0,5,9,4,7,3,4,3,11,10,1,18,EL
bf309d24,6,3,0,2,4,2,4,2,0,0,0,1,7,2,0,18,EL
bf5fc4fc,2,1,2,0,0,0,3,3,1,0,1,1,3,1,0,18,EL
bfc5768b,21,15,7,11,3,8,24,16,9,1,8,13,34,16,0,18,EL
bfe272bd,1,1,1,0,0,0,0,0,2,2,0,1,2,0,0,18,EL
c01c66d9,9,6,6,3,0,5,8,3,6,3,3,11,20,9,0,18,EL
c0321811,28,23,14,13,1,14,20,6,12,1,11,17,45,17,0,18,EL
c05dfb74,2,2,0,2,0,0,0,0,2,0,2,1,3,0,0,18,EL
c089980e,0,0,0,0,0,0,1,1,1,0,1,1,1,4,0,18,EL
c0b1a6da,0,0,0,0,0,0,0,0,0,0,0,0,0,0,0,18,EL
c1268aa3,7,5,7,0,0,3,4,1,12,9,3,18,25,51,1,18,EL
c14bc029,26,18,12,10,4,4,28,24,13,3,10,18,44,14,0,18,EL
c18d22f5,9,8,7,1,1,4,7,3,6,1,5,6,15,6,0,18,EL
c18f2143,16,10,13,2,1,8,11,3,4,3,1,21,37,32,0,18,EL
c1a13650,1,1,0,0,1,0,0,0,1,0,1,0,1,3,0,18,EL
c1b7847c,20,16,13,7,0,7,17,10,5,1,4,10,30,10,1,18,EL
c2009df3,1,1,0,1,0,0,0,0,0,0,0,0,1,0,0,18,EL
c2304da8,19,12,10,8,1,3,5,2,6,2,4,18,37,21,2,18,EL
c2e41cfb,0,0,0,0,0,0,0,0,0,0,0,0,0,1,0,18,EL
c3ee18ef,21,16,15,5,1,15,25,10,9,3,6,2,23,20,0,18,EL
c3fd9887,1,1,0,1,0,0,1,1,1,0,1,0,1,3,0,18,EL
c41ca3d8,1,0,0,1,0,0,0,0,1,0,1,0,1,3,0,18,EL
c43a8301,6,4,2,3,1,2,4,2,3,2,1,3,9,15,0,18,EL
c43e5e7e,7,4,2,4,1,1,8,7,9,2,7,1,8,6,0,18,EL
c44a1d58,19,9,11,8,0,13,27,14,7,2,5,12,31,4,0,18,EL
c47541e0,14,11,10,4,0,2,6,4,3,0,3,8,22,7,0,18,EL
c48130b7,1,1,1,0,0,0,1,1,0,0,0,0,1,0,1,18,EL
c49afee6,2,2,0,2,0,0,0,0,0,0,0,0,2,0,0,18,EL
c4a306a1,15,10,11,3,1,3,6,3,6,5,1,11,26,31,0,18,EL
c4af5889,3,0,1,1,1,0,0,0,0,0,0,2,5,0,0,18,EL
c56dc39e,7,4,3,2,2,3,8,5,3,3,0,10,17,22,1,18,EL
c5b7c315,3,2,2,1,0,0,5,5,3,2,1,1,4,15,0,18,EL
c5bdb6e3,6,3,3,1,2,2,6,4,7,3,4,8,14,6,0,18,EL
c5ea2dab,3,2,3,0,0,3,3,0,5,1,4,6,9,13,1,18,EL
c5eaff5c,0,0,0,0,0,0,0,0,1,0,1,1,1,0,0,18,EL
c5fd13e9,2,1,1,1,0,0,3,3,5,2,3,3,5,7,0,18,EL
c6500a29,1,1,0,1,0,0,4,4,0,0,0,0,1,2,0,18,EL
c67b8590,2,1,1,1,0,1,3,2,0,0,0,1,3,1,0,18,EL
c693347d,0,0,0,0,0,0,0,0,0,0,0,0,0,0,0,18,EL
c699e60c,1,1,0,0,1,0,1,1,1,0,1,1,2,0,0,18,EL
c6ac6579,0,0,0,0,0,0,1,1,1,0,1,1,1,2,0,18,EL
c6f99e42,11,7,7,4,0,6,10,4,5,2,3,11,22,38,1,18,EL
c71e97ba,6,4,3,1,2,0,7,7,2,1,1,1,7,1,0,18,EL
c76153e5,14,11,11,3,0,5,13,8,5,2,3,11,25,21,0,18,EL
c7e0f364,6,2,1,3,2,2,6,4,3,0,3,2,8,9,0,18,EL
c7f24d4b,1,0,0,0,1,0,0,0,0,0,0,2,3,2,0,18,EL
c84c1afc,0,0,0,0,0,0,0,0,0,0,0,0,0,1,0,18,EL
c886b062,6,4,3,1,2,1,6,5,3,0,3,1,7,8,0,18,EL
c904f3d5,0,0,0,0,0,0,0,0,0,0,0,1,1,5,1,18,EL
c90b2e8f,2,1,1,1,0,1,1,0,2,2,0,3,5,12,0,18,EL
c98971d1,2,2,1,1,0,0,1,1,0,0,0,1,3,4,0,18,EL
c9e5f0f6,1,0,0,1,0,0,1,1,2,0,2,0,1,0,0,18,EL
ca45605e,0,0,0,0,0,0,0,0,1,0,1,0,0,0,0,18,EL
ca8033cb,6,5,3,3,0,3,5,2,3,1,2,6,12,19,0,18,EL
ca9178af,15,9,8,7,0,6,13,7,9,2,7,6,21,7,0,18,EL
cb85d8d0,6,5,6,0,0,2,10,8,5,4,1,11,17,26,0,18,EL
cbd92a70,1,0,1,0,0,0,0,0,0,0,0,0,1,1,0,18,EL
cbdf7d5c,0,0,0,0,0,0,1,1,0,0,0,0,0,0,0,18,EL
cbec1196,3,3,1,1,1,0,4,4,3,0,3,4,7,7,0,18,EL
cc3477f4,0,0,0,0,0,0,0,0,0,0,0,0,0,0,0,18,EL
cc700722,5,3,2,3,0,1,4,3,1,0,1,2,7,0,0,18,EL
cc77354e,25,11,14,11,0,6,22,16,6,3,3,16,41,20,0,18,EL
cc89c822,0,0,0,0,0,0,0,0,0,0,0,0,0,0,0,18,EL
cc96d422,14,10,7,4,3,5,15,10,9,2,7,9,23,6,1,18,EL
ccc520dc,11,10,7,2,2,5,11,6,5,1,4,6,17,2,0,18,EL
ccc66d00,19,12,9,7,3,14,27,13,17,4,13,6,25,8,0,18,EL
cd0ecf81,9,3,5,3,1,2,4,2,2,0,2,3,12,1,0,18,EL
cd0fa27b,11,8,1,7,3,3,14,11,9,0,9,3,14,3,0,18,EL
cd59b9df,0,0,0,0,0,0,0,0,0,0,0,0,0,0,0,18,EL
cda08080,6,4,5,1,0,3,8,5,8,3,5,11,17,22,0,18,EL
cda0b317,0,0,0,0,0,0,0,0,0,0,0,0,0,2,0,18,EL
cdf65d12,3,3,2,1,0,1,2,1,1,0,1,3,6,1,0,18,EL
ce5143da,11,8,2,7,2,2,12,10,11,2,9,5,16,14,0,18,EL
ce538b0b,5,5,3,2,0,0,1,1,1,0,1,1,6,5,0,18,EL
ce6480b1,11,6,5,3,3,4,9,5,6,0,6,10,21,4,0,18,EL
ce940592,8,5,1,6,1,6,7,1,8,4,4,9,17,13,0,18,EL
cea0df32,3,2,1,2,0,1,4,3,3,1,2,1,4,3,0,18,EL
ceb30355,6,4,5,1,0,3,6,3,4,3,1,7,13,23,0,18,EL
cf41510e,2,1,2,0,0,1,3,2,4,2,2,6,8,12,0,18,EL
cf8ef0a1,6,2,1,3,2,4,8,4,4,0,4,3,9,5,0,18,EL
cfa65a2e,9,7,4,5,0,1,2,1,1,1,0,0,9,1,0,18,EL
cfd8d664,16,12,7,9,0,8,13,5,8,1,7,8,24,13,0,18,EL
cff7dcb0,0,0,0,0,0,0,2,2,2,0,2,1,1,3,0,18,EL
d0042ab9,3,2,3,0,0,2,6,4,5,0,5,8,11,12,0,18,EL
d02e0cab,10,5,4,5,1,3,20,17,14,3,11,13,23,12,0,18,EL
d045ccb2,0,0,0,0,0,0,0,0,0,0,0,0,0,0,0,18,EL
d054d8b0,5,2,0,3,2,0,2,2,1,0,1,2,7,4,0,18,EL
d071af92,10,8,5,5,0,1,5,4,8,0,8,13,23,0,0,18,EL
d0a01d27,13,9,6,6,1,5,7,2,1,0,1,3,16,5,0,18,EL
d0c41b99,0,0,0,0,0,0,0,0,0,0,0,1,1,7,1,18,EL
d0d8dd44,9,8,6,3,0,6,7,1,10,6,4,10,19,21,0,18,EL
d0e6399c,0,0,0,0,0,0,0,0,1,0,1,0,0,1,0,18,EL
d13aea07,15,9,8,4,3,9,20,11,2,1,1,10,25,14,0,18,EL
d189e48f,1,1,0,0,1,0,0,0,0,0,0,0,1,3,0,18,EL
d1992a3b,4,2,3,1,0,4,8,4,4,0,4,6,10,26,0,18,EL
d2110326,4,3,2,1,1,2,4,2,7,5,2,11,15,28,0,18,EL
d2416c2e,1,1,1,0,0,1,5,4,4,0,4,3,4,1,0,18,EL
d248cd8f,10,4,5,5,0,5,9,4,3,1,2,3,13,41,1,18,EL
d2800f47,9,5,3,6,0,2,4,2,4,1,3,8,17,5,0,18,EL
d2aea9ac,0,0,0,0,0,0,2,2,0,0,0,0,0,0,0,18,EL
d2ba04be,0,0,0,0,0,0,0,0,0,0,0,1,1,0,0,18,EL
d2ee6d5b,3,2,2,1,0,2,6,4,1,0,1,1,4,0,0,18,EL
d3149135,0,0,0,0,0,0,0,0,0,0,0,0,0,3,0,18,EL
d31c4115,1,0,0,1,0,0,4,4,2,0,2,4,5,6,0,18,EL
d38174c3,0,0,0,0,0,0,0,0,1,1,0,0,0,0,0,18,EL
d40cff47,0,0,0,0,0,0,2,2,0,0,0,0,0,0,0,18,EL
d4535821,7,2,5,2,0,5,7,2,1,0,1,1,8,8,0,18,EL
d46ce637,2,2,1,0,1,1,2,1,2,0,2,1,3,2,0,18,EL
d4931a5a,2,2,1,1,0,0,1,1,0,0,0,1,3,0,0,18,EL
d4aa40b8,3,2,3,0,0,0,2,2,1,0,1,2,5,3,0,18,EL
d4cb83cc,11,6,4,6,1,3,11,8,8,2,6,8,19,13,1,18,EL
d4e7c451,2,2,1,1,0,1,3,2,8,1,7,3,5,3,0,18,EL
d4e93bab,16,12,5,10,1,6,15,9,7,2,5,8,24,6,0,18,EL
d4f8f243,5,3,3,1,1,0,4,4,1,0,1,1,6,3,0,18,EL
d552c4a1,6,4,3,2,1,1,1,0,2,0,2,4,10,4,0,18,EL
d5575935,42,33,12,25,5,11,45,34,24,2,22,20,62,14,0,18,EL
d56b9362,12,8,6,6,0,3,8,5,2,1,1,7,19,9,0,18,EL
d5ce52a5,0,0,0,0,0,0,0,0,1,0,1,0,0,0,0,18,EL
d60ffe68,1,0,0,0,1,0,0,0,1,0,1,1,2,0,0,18,EL
d61b3354,3,2,1,2,0,1,1,0,0,0,0,4,7,1,0,18,EL
d637fc22,12,9,3,6,3,6,13,7,4,0,4,4,16,12,0,18,EL
d63e2912,24,18,13,9,2,8,15,7,9,6,3,20,44,39,0,18,EL
d659a854,2,1,0,2,0,0,0,0,0,0,0,0,2,0,0,18,EL
d732f72c,2,1,1,1,0,1,1,0,3,0,3,0,2,3,0,18,EL
d7398ac3,8,6,3,4,1,4,8,4,3,0,3,1,9,6,0,18,EL
d757fd45,7,4,4,3,0,2,4,2,5,1,4,3,10,5,0,18,EL
d79a8c87,11,6,7,3,1,4,7,3,6,3,3,12,23,17,0,18,EL
d7a70e5e,14,12,6,6,2,5,6,1,4,2,2,3,17,5,0,18,EL
d7c09951,1,0,1,0,0,0,0,0,0,0,0,1,2,2,0,18,EL
d820a7c8,3,3,1,2,0,1,4,3,3,0,3,3,6,1,0,18,EL
d849ef0f,13,7,8,5,0,4,11,7,8,3,5,8,21,17,0,18,EL
d87e2cae,1,0,0,1,0,0,2,2,0,0,0,0,1,4,0,18,EL
d8ff3b2c,1,1,1,0,0,1,2,1,0,0,0,3,4,1,0,18,EL
d9847696,1,1,0,1,0,0,0,0,3,1,2,0,1,0,0,18,EL
d995ed27,4,4,0,4,0,1,2,1,3,0,3,6,10,3,0,18,EL
d9bda115,5,2,0,4,1,1,5,4,5,0,5,10,15,2,0,18,EL
da1185fc,5,5,3,1,1,3,4,1,3,0,3,4,9,1,0,18,EL
da1c9094,0,0,0,0,0,0,0,0,0,0,0,0,0,0,0,18,EL
da270297,1,1,0,1,0,1,2,1,0,0,0,0,1,2,0,18,EL
da4bd8fb,0,0,0,0,0,0,0,0,0,0,0,0,0,2,0,18,EL
da617483,20,13,15,5,0,14,15,1,17,14,3,17,37,49,1,18,EL
da6cb94b,13,8,5,7,1,7,9,2,5,3,2,10,23,31,0,18,EL
da974c7b,4,4,2,2,0,2,2,0,5,4,1,3,7,2,0,18,EL
dab0da1c,3,2,2,1,0,1,2,1,0,0,0,0,3,1,0,18,EL
dab75831,1,0,0,0,1,0,0,0,0,0,0,0,1,0,0,18,EL
dabec4c3,6,5,4,2,0,2,5,3,17,7,10,9,15,57,0,18,EL
db4ed67b,11,8,4,6,1,6,9,3,4,0,4,3,14,2,0,18,EL
db7161ed,2,2,1,0,1,1,1,0,0,0,0,0,2,0,0,18,EL
db750822,5,4,4,1,0,1,17,16,3,0,3,2,7,3,0,18,EL
dc3fa3b5,14,8,3,10,1,2,11,9,8,2,6,6,20,8,0,18,EL
dc4511f3,0,0,0,0,0,0,0,0,0,0,0,0,0,0,0,18,EL
dc4f62fd,8,3,3,4,1,2,9,7,6,1,5,4,12,2,0,18,EL
dc52c72f,22,17,12,7,3,9,15,6,7,3,4,17,39,41,0,18,EL
dc62fbee,12,10,4,6,2,2,4,2,0,0,0,5,17,1,0,18,EL
dc6f5bdd,8,6,7,1,0,3,9,6,8,6,2,13,21,30,4,18,EL
dc8f5b58,3,2,3,0,0,1,1,0,3,1,2,1,4,7,0,18,EL
dc90cfbe,1,0,0,1,0,0,2,2,0,0,0,0,1,5,0,18,EL
dcd160e4,5,5,2,3,0,1,3,2,3,0,3,0,5,9,1,18,EL
dd08d93a,2,1,0,2,0,1,2,1,1,0,1,2,4,1,0,18,EL
dd0daf32,11,7,4,2,5,3,13,10,6,0,6,2,13,4,0,18,EL
dd2044f4,4,4,3,1,0,1,1,0,3,0,3,4,8,9,0,18,EL
de0282f9,4,2,3,1,0,2,3,1,3,0,3,1,5,7,0,18,EL
de39485a,1,0,1,0,0,1,1,0,0,0,0,0,1,0,0,18,EL
dead55e5,11,8,3,6,2,3,5,2,3,1,2,5,16,1,0,18,EL
debc6b55,2,1,1,1,0,0,2,2,1,0,1,0,2,1,0,18,EL
dee86451,7,7,3,4,0,3,3,0,2,2,0,2,9,2,0,18,EL
def69cd0,12,7,6,4,2,1,7,6,3,0,3,5,17,8,0,18,EL
df525574,11,9,4,6,1,4,10,6,7,0,7,7,18,20,0,18,EL
df69b544,10,6,1,6,3,3,17,14,8,1,7,8,18,1,0,18,EL
df85d472,1,1,0,1,0,0,0,0,0,0,0,1,2,1,0,18,EL
dff153a4,16,10,6,9,1,8,20,12,8,3,5,13,29,14,0,18,EL
e0314d87,19,11,12,7,0,8,17,9,7,2,5,12,31,36,0,18,EL
e0a1c004,6,5,4,2,0,3,13,10,8,2,6,5,11,12,0,18,EL
e0cd04e0,1,1,0,1,0,0,0,0,0,0,0,0,1,0,0,18,EL
e12d7851,4,4,2,2,0,1,2,1,0,0,0,1,5,5,0,18,EL
e14ec482,0,0,0,0,0,0,0,0,0,0,0,1,1,1,0,18,EL
e16dd48e,3,0,3,0,0,2,2,0,3,0,3,3,6,5,0,18,EL
e1bbb68d,2,2,0,1,1,0,1,1,0,0,0,1,3,1,0,18,EL
e248e62f,2,1,2,0,0,1,1,0,2,0,2,0,2,1,0,18,EL
e280527c,10,9,1,7,2,4,15,11,3,0,3,3,13,2,0,18,EL
e2a302a8,10,7,5,5,0,3,5,2,8,1,7,4,14,2,0,18,EL
e2bf2abc,2,1,1,1,0,0,2,2,0,0,0,5,7,1,0,18,EL
e3207d47,0,0,0,0,0,0,0,0,0,0,0,0,0,0,0,18,EL
e32721e6,0,0,0,0,0,0,0,0,0,0,0,0,0,0,0,18,EL
e358587b,0,0,0,0,0,0,0,0,0,0,0,1,1,2,0,18,EL
e373f1ec,5,3,0,4,1,3,4,1,2,1,1,7,12,2,0,18,EL
e3993b65,8,6,4,3,1,6,13,7,6,0,6,6,14,2,0,18,EL
e3a5814e,20,14,8,8,4,5,9,4,10,1,9,14,34,16,0,18,EL
e3d0b0c4,5,3,4,1,0,3,4,1,7,3,4,23,28,70,2,18,EL
e41ee432,2,2,1,1,0,2,4,2,8,6,2,9,11,23,0,18,EL
e4738e91,3,2,0,3,0,2,6,4,3,2,1,5,8,6,0,18,EL
e4a26a91,7,3,2,5,0,5,8,3,6,2,4,7,14,7,0,18,EL
e4ed2628,9,7,5,4,0,4,6,2,1,0,1,4,13,4,0,18,EL
e4fcb211,4,2,0,4,0,2,5,3,0,0,0,1,5,2,0,18,EL
e599253a,0,0,0,0,0,0,2,2,0,0,0,0,0,0,0,18,EL
e61b8aee,8,7,4,2,2,3,8,5,10,5,5,7,15,19,0,18,EL
e61c6efb,4,4,3,1,0,1,8,7,5,2,3,7,11,17,0,18,EL
e66a1ad7,0,0,0,0,0,0,0,0,0,0,0,0,0,4,0,18,EL
e6ad16b2,2,1,0,2,0,1,1,0,1,0,1,1,3,1,0,18,EL
e704919e,0,0,0,0,0,0,0,0,0,0,0,0,0,0,1,18,EL
e73659d3,1,1,1,0,0,0,1,1,1,0,1,0,1,5,0,18,EL
e7986081,1,1,0,0,1,1,2,1,1,0,1,0,1,5,0,18,EL
e7ee38c3,0,0,0,0,0,0,0,0,0,0,0,1,1,2,0,18,EL
e814316b,0,0,0,0,0,0,0,0,0,0,0,0,0,0,0,18,EL
e81f0356,2,2,1,1,0,1,2,1,0,0,0,3,5,9,0,18,EL
e8ce5a3e,0,0,0,0,0,0,0,0,0,0,0,0,0,0,0,18,EL
e8d0a3a1,0,0,0,0,0,0,0,0,0,0,0,0,0,0,0,18,EL
e94d79e3,0,0,0,0,0,0,0,0,0,0,0,4,4,2,0,18,EL
e961d3ac,0,0,0,0,0,0,0,0,0,0,0,0,0,1,0,18,EL
e97150c0,10,9,7,3,0,6,8,2,5,4,1,19,29,17,0,18,EL
e978d6b6,0,0,0,0,0,0,0,0,0,0,0,0,0,0,0,18,EL
ea07ceb3,4,4,1,2,1,1,2,1,1,0,1,2,6,0,0,18,EL
ea0ff634,7,3,1,6,0,0,5,5,4,0,4,2,9,4,0,18,EL
ea490705,4,4,0,2,2,2,3,1,2,0,2,1,5,1,0,18,EL
ea6a7ab4,8,7,2,5,1,2,2,0,4,0,4,2,10,0,0,18,EL
ea7a8366,15,11,7,7,1,6,12,6,9,1,8,5,20,4,0,18,EL
eac044ad,19,13,5,8,6,7,19,12,11,0,11,9,28,13,0,18,EL
ead960f2,8,7,2,4,2,3,8,5,6,0,6,4,12,2,0,18,EL
eafac393,9,2,6,3,0,9,13,4,10,5,5,9,18,23,0,18,EL
eb174a27,3,1,2,1,0,0,0,0,1,1,0,3,6,10,0,18,EL
eb2b33aa,0,0,0,0,0,0,1,1,0,0,0,0,0,0,0,18,EL
eb3f56e5,2,2,2,0,0,1,1,0,4,2,2,4,6,7,0,18,EL
eb5bc3eb,4,3,3,1,0,2,3,1,1,0,1,1,5,5,0,18,EL
eb87ec70,1,1,0,1,0,0,0,0,1,1,0,0,1,0,0,18,EL
ebc29a56,2,1,1,1,0,1,6,5,2,0,2,0,2,3,0,18,EL
ebc49727,1,1,0,1,0,0,0,0,0,0,0,1,2,1,0,18,EL
ecab64a0,7,3,2,5,0,5,9,4,2,0,2,3,10,3,0,18,EL
ecbb3fdf,10,5,5,4,1,6,10,4,1,0,1,6,16,3,1,18,EL
ecf151ac,2,0,0,2,0,0,0,0,0,0,0,1,3,0,0,18,EL
ed16934e,2,0,0,1,1,1,4,3,0,0,0,0,2,0,0,18,EL
ed2b33cb,8,5,7,1,0,4,8,4,0,0,0,4,12,6,0,18,EL
ed560575,16,11,6,6,4,7,12,5,8,1,7,16,32,17,0,18,EL
ed5886d2,17,10,7,10,0,5,13,8,24,4,20,4,21,12,0,18,EL
ed60d19f,3,2,2,1,0,2,3,1,4,0,4,3,6,2,0,18,EL
ed90babd,1,1,0,1,0,0,2,2,1,0,1,1,2,0,0,18,EL
ed99d19e,0,0,0,0,0,0,0,0,1,0,1,0,0,0,0,18,EL
eddcbbc4,7,6,7,0,0,4,8,4,7,1,6,4,11,5,0,18,EL
ee833569,0,0,0,0,0,0,0,0,0,0,0,1,1,1,1,18,EL
ee8508c0,0,0,0,0,0,0,0,0,0,0,0,0,0,1,0,18,EL
ef3909cd,2,1,2,0,0,1,1,0,1,0,1,0,2,6,0,18,EL
ef4249ff,3,3,2,1,0,3,3,0,2,0,2,4,7,1,1,18,EL
ef5b337e,5,1,1,4,0,2,8,6,7,1,6,11,16,12,0,18,EL
ef619b0b,13,8,6,5,2,4,10,6,3,1,2,11,24,3,0,18,EL
ef8cafeb,1,1,0,1,0,1,3,2,4,4,0,4,5,13,0,18,EL
ef8f266e,0,0,0,0,0,0,2,2,1,0,1,0,0,0,0,18,EL
efc33b33,0,0,0,0,0,0,0,0,1,1,0,1,1,11,0,18,EL
efe679a0,14,7,7,6,1,8,14,6,5,1,4,19,33,28,1,18,EL
f00de885,0,0,0,0,0,0,0,0,0,0,0,0,0,4,2,18,EL
f04f45a2,2,1,1,1,0,1,1,0,0,0,0,1,3,0,0,18,EL
f07be45a,4,4,1,2,1,1,4,3,2,1,1,3,7,5,0,18,EL
f08a8947,12,7,8,4,0,6,7,1,10,9,1,11,23,32,0,18,EL
f0da930c,9,7,8,1,0,3,6,3,10,7,3,15,24,38,0,18,EL
f0e3b343,0,0,0,0,0,0,2,2,1,1,0,2,2,4,0,18,EL
f0faccb9,0,0,0,0,0,0,0,0,0,0,0,0,0,0,0,18,EL
f0fc9d0e,1,0,0,1,0,0,2,2,4,1,3,0,1,4,0,18,EL
f15b778f,20,15,8,12,0,5,10,5,0,0,0,8,28,7,0,18,EL
f1b17a24,12,6,4,7,1,4,8,4,8,1,7,6,18,10,0,18,EL
f1bed920,2,2,1,1,0,0,1,1,2,0,2,2,4,2,0,18,EL
f24ea523,3,2,0,3,0,0,5,5,5,0,5,2,5,1,0,18,EL
f25c8e3a,11,7,0,8,3,4,7,3,6,1,5,7,18,3,0,18,EL
f2d063ec,22,12,13,6,3,9,24,15,8,1,7,9,31,6,0,18,EL
f2e3b81c,1,1,0,1,0,0,1,1,1,0,1,0,1,0,0,18,EL
f2eaebe9,9,7,4,3,2,4,9,5,0,0,0,2,11,2,0,18,EL
f30a4ab1,7,5,0,5,2,2,4,2,1,0,1,3,10,1,0,18,EL
f33238db,0,0,0,0,0,0,0,0,0,0,0,0,0,0,0,18,EL
f346787e,1,1,0,1,0,1,2,1,1,1,0,1,2,0,0,18,EL
f373db50,12,6,9,3,0,3,9,6,6,1,5,6,18,14,0,18,EL
f3f5941f,11,6,4,6,1,6,18,12,10,1,9,15,26,8,1,18,EL
f4081572,5,2,3,2,0,2,3,1,1,0,1,5,10,6,0,18,EL
f447fcdb,12,7,5,4,3,5,13,8,11,4,7,13,25,16,1,18,EL
f4a8e2ed,3,3,0,2,1,0,1,1,2,0,2,2,5,4,0,18,EL
f4eb377b,0,0,0,0,0,0,1,1,0,0,0,3,3,5,1,18,EL
f5044e54,11,9,6,2,3,5,15,10,11,2,9,9,20,10,0,18,EL
f50a668a,10,8,9,1,0,6,8,2,4,4,0,10,20,25,1,18,EL
f5b6fb78,6,5,3,3,0,1,7,6,1,1,0,2,8,1,0,18,EL
f5eedf74,9,4,2,5,2,2,3,1,4,0,4,3,12,0,0,18,EL
f5efb153,5,2,3,2,0,4,7,3,6,4,2,11,16,32,1,18,EL
f69d4d79,2,0,0,2,0,1,2,1,2,1,1,2,4,7,0,18,EL
f69fba57,4,3,1,2,1,0,4,4,2,0,2,0,4,1,0,18,EL
f6ac68c1,4,4,3,1,0,2,3,1,1,0,1,5,9,23,0,18,EL
f6d4b6b2,0,0,0,0,0,0,0,0,0,0,0,0,0,1,0,18,EL
f7223718,10,7,6,4,0,2,6,4,9,1,8,4,14,15,0,18,EL
f73abe54,9,6,2,6,1,4,7,3,1,0,1,4,13,3,0,18,EL
f7815d38,1,0,1,0,0,0,8,8,6,1,5,1,2,2,0,18,EL
f7aa75bd,6,4,5,1,0,4,6,2,1,1,0,4,10,4,0,18,EL
f7b10c66,0,0,0,0,0,0,0,0,1,0,1,0,0,2,0,18,EL
f7b1d4e0,6,2,2,1,3,3,8,5,8,2,6,4,10,2,0,18,EL
f7dc2ae5,12,6,4,7,1,2,5,3,5,3,2,13,25,10,0,18,EL
f7e87032,10,7,2,7,1,3,6,3,1,0,1,6,16,8,0,18,EL
f814f0f1,5,3,4,1,0,1,5,4,2,0,2,2,7,5,0,18,EL
f833a830,6,5,2,2,2,1,7,6,2,0,2,3,9,2,0,18,EL
f86cabbd,9,8,3,5,1,7,9,2,3,0,3,9,18,9,0,18,EL
f874dd44,14,8,10,3,1,5,16,11,5,1,4,10,24,19,0,18,EL
f8bfb4ae,4,1,3,1,0,3,3,0,5,2,3,8,12,21,0,18,EL
f8eca1b6,0,0,0,0,0,0,0,0,2,0,2,0,0,2,0,18,EL
f9a5c9c1,4,2,1,2,1,1,9,8,5,0,5,8,12,6,0,18,EL
f9c927de,9,3,4,4,1,2,10,8,5,2,3,5,14,2,0,18,EL
fa274d97,12,8,7,3,2,5,11,6,10,0,10,7,19,9,0,18,EL
fa6292e2,9,5,6,2,1,7,11,4,4,2,2,3,12,5,0,18,EL
fa7e8a83,9,8,7,2,0,6,7,1,1,0,1,5,14,2,0,18,EL
faa1b07d,1,1,1,0,0,0,2,2,0,0,0,5,6,4,0,18,EL
fae8f607,11,6,1,7,3,2,7,5,4,1,3,11,22,4,0,18,EL
faed84db,2,2,2,0,0,0,0,0,1,0,1,1,3,3,0,18,EL
fb054320,6,5,4,2,0,1,3,2,7,1,6,3,9,1,1,18,EL
fb2a63bb,6,5,2,4,0,4,7,3,4,0,4,1,7,0,0,18,EL
fb2c533b,10,6,5,5,0,3,8,5,6,2,4,15,25,8,0,18,EL
fb5022e4,4,2,2,2,0,2,4,2,2,1,1,2,6,1,0,18,EL
fb517645,9,9,3,6,0,2,3,1,8,0,8,5,14,6,0,18,EL
fb59286d,9,6,4,3,2,1,15,14,16,2,14,10,19,3,0,18,EL
fb5d47b3,13,10,10,2,1,7,10,3,9,2,7,6,19,16,0,18,EL
fb5eb6e0,0,0,0,0,0,0,0,0,0,0,0,0,0,0,0,18,EL
fbafd1b0,11,8,9,1,1,6,7,1,4,2,2,6,17,10,0,18,EL
fbb23472,21,19,12,8,1,4,21,17,11,1,10,13,34,4,0,18,EL
fc176c8b,0,0,0,0,0,0,0,0,0,0,0,0,0,0,0,18,EL
fc1cf07a,12,11,4,7,1,6,8,2,6,2,4,13,25,14,0,18,EL
fc3f41aa,3,3,1,1,1,0,5,5,2,0,2,3,6,0,0,18,EL
fc4cf6a7,4,3,2,1,1,0,2,2,2,0,2,4,8,8,1,18,EL
fc4f85b1,14,9,13,1,0,9,12,3,6,6,0,12,26,45,0,18,EL
fcb8b607,4,3,2,1,1,2,5,3,6,0,6,4,8,2,0,18,EL
fcd24f5f,0,0,0,0,0,0,0,0,0,0,0,0,0,1,0,18,EL
fce2302c,4,1,1,1,2,1,3,2,3,1,2,2,6,4,0,18,EL
fd2bc67d,11,8,8,3,0,6,11,5,6,2,4,17,28,29,1,18,EL
fd4ee68b,19,12,8,8,3,7,16,9,9,4,5,13,32,6,0,18,EL
fd6f2466,9,5,6,3,0,3,6,3,3,0,3,12,21,5,0,18,EL
fe2db476,5,5,4,1,0,3,6,3,3,0,3,3,8,4,0,18,EL
fe322052,3,2,2,0,1,1,2,1,4,0,4,8,11,3,0,18,EL
fec5accc,1,0,0,0,1,0,5,5,3,2,1,2,3,6,0,18,EL
fefce889,0,0,0,0,0,0,0,0,0,0,0,0,0,1,0,18,EL
ff98492b,2,1,2,0,0,1,2,1,1,0,1,4,6,0,0,18,EL
ffbbc83b,11,9,3,6,2,4,8,4,2,1,1,6,17,4,0,18,EL
ffc3c7ba,3,3,2,0,1,1,3,2,1,1,0,2,5,2,0,18,EL
ffd740c5,18,9,13,5,0,9,20,11,7,0,7,12,30,9,0,18,EL
000b3da6,70,45,36,27,7,22,55,33,19,2,17,29,99,23,0,18,SPA
003a5c72,52,37,19,23,10,19,73,54,43,13,30,41,93,30,0,18,SPA
00b28772,21,13,10,8,3,8,16,8,15,6,9,16,37,8,0,18,SPA
011d8c56,0,0,0,0,0,0,1,1,0,0,0,2,2,7,0,18,SPA
01ae64cd,2,2,2,0,0,0,1,1,2,1,1,2,4,19,0,18,SPA
01eb744d,41,29,12,16,13,8,57,49,30,1,29,25,66,17,0,18,SPA
02c15616,15,8,7,8,0,6,11,5,7,0,7,5,20,8,0,18,SPA
02d2c436,49,43,37,9,3,17,33,16,32,21,11,77,126,185,1,18,SPA
04965583,6,4,2,3,1,1,10,9,4,0,4,9,15,1,0,18,SPA
04a65a8f,35,22,17,17,1,7,25,18,10,3,7,23,58,20,0,18,SPA
04ac8285,0,0,0,0,0,0,0,0,0,0,0,0,0,0,0,18,SPA
04e17fd5,31,25,10,14,7,6,26,20,11,0,11,9,40,32,0,18,SPA
05384ea1,33,24,21,8,4,14,25,11,21,11,10,39,72,64,1,18,SPA
05a4465d,95,65,38,51,6,24,89,65,34,11,23,35,130,67,0,18,SPA
0657888a,22,14,6,8,8,9,22,13,16,1,15,14,36,15,0,18,SPA
070a3904,64,43,29,28,7,19,62,43,31,5,26,52,116,48,1,18,SPA
07a0baa9,3,2,1,0,2,2,3,1,0,0,0,0,3,2,0,18,SPA
07d67579,1,1,0,1,0,0,6,6,6,0,6,1,2,5,0,18,SPA
080ac8d8,3,2,0,0,3,1,1,0,0,0,0,0,3,0,0,18,SPA
08511d65,40,29,22,18,0,19,28,9,22,12,10,47,87,91,0,18,SPA
0959c2a2,25,16,12,10,3,8,15,7,12,1,11,21,46,17,0,18,SPA
09a9e921,10,2,2,4,4,1,12,11,16,1,15,8,18,16,0,18,SPA
0a0cc13c,13,7,3,6,4,3,11,8,12,1,11,6,19,5,0,18,SPA
0a447501,8,8,0,4,4,0,3,3,5,0,5,4,12,6,0,18,SPA
0ac94a23,27,16,12,10,5,6,23,17,18,1,17,13,40,10,0,18,SPA
0ae4e09a,8,4,2,5,1,2,13,11,11,0,11,1,9,5,0,18,SPA
0af4dcf0,10,7,3,6,1,1,7,6,9,1,8,3,13,27,0,18,SPA
0b90bb97,17,9,4,9,4,4,22,18,14,1,13,2,19,19,0,18,SPA
0c3f7197,14,7,6,7,1,6,11,5,7,1,6,4,18,7,0,18,SPA
0d10333c,90,69,28,54,8,29,74,45,38,4,34,38,128,27,0,18,SPA
0e7ccfc4,18,13,7,8,3,9,16,7,18,4,14,16,34,20,0,18,SPA
0ef89a37,27,14,8,14,5,9,32,23,14,0,14,6,33,4,0,18,SPA
0f138d5a,13,9,8,5,0,3,13,10,9,5,4,14,27,30,0,18,SPA
1001ae82,32,18,6,21,5,6,26,20,18,1,17,7,39,8,0,18,SPA
102fda08,0,0,0,0,0,0,0,0,0,0,0,0,0,0,0,18,SPA
10e25802,6,4,4,2,0,2,4,2,7,1,6,9,15,8,1,18,SPA
113fb4ea,0,0,0,0,0,0,0,0,0,0,0,0,0,2,0,18,SPA
119b9a8e,38,23,27,11,0,14,25,11,19,13,6,27,65,94,1,18,SPA
11c30a46,6,4,1,4,1,1,5,4,5,0,5,4,10,0,0,18,SPA
1214f0a6,4,3,4,0,0,2,4,2,2,1,1,0,4,1,0,18,SPA
1250086e,16,10,10,4,2,8,12,4,15,8,7,19,35,33,1,18,SPA
12a875ce,0,0,0,0,0,0,1,1,0,0,0,0,0,0,0,18,SPA
12c50af5,11,9,3,8,0,3,8,5,7,0,7,2,13,3,0,18,SPA
130a7a3f,41,28,22,10,9,13,62,49,39,5,34,22,63,37,0,18,SPA
13b0c150,16,11,8,7,1,10,15,5,17,12,5,12,28,72,0,18,SPA
148d4105,11,5,3,7,1,4,9,5,2,0,2,8,19,8,0,18,SPA
1512328c,38,23,17,13,8,15,47,32,25,3,22,13,51,9,0,18,SPA
1633fc8a,48,30,28,20,0,30,43,13,27,19,8,53,101,137,0,18,SPA
167c1bb0,34,22,18,16,0,13,40,27,19,12,7,25,59,78,1,18,SPA
174651c8,17,10,7,7,3,7,18,11,10,5,5,20,37,30,1,18,SPA
174f09a6,19,10,11,7,1,4,15,11,23,13,10,33,52,113,0,18,SPA
1771f2c1,36,27,20,14,2,13,24,11,21,7,14,30,66,50,2,18,SPA
1961b2aa,19,12,8,10,1,5,13,8,7,1,6,4,23,6,0,18,SPA
19b776e9,33,24,12,16,5,6,27,21,19,2,17,18,51,10,0,18,SPA
1a317a1b,34,25,24,9,1,18,30,12,18,3,15,19,53,50,1,18,SPA
1b17ed86,32,22,15,13,4,9,27,18,19,0,19,19,51,21,0,18,SPA
1b84dbe1,22,17,13,6,3,8,12,4,15,3,12,12,34,18,0,18,SPA
1bda5842,30,24,9,11,10,8,33,25,14,0,14,12,42,1,0,18,SPA
1c8dc17d,25,16,10,10,5,10,28,18,7,0,7,17,42,14,0,18,SPA
1d1691ad,41,27,22,15,4,20,35,15,25,7,18,26,67,50,0,18,SPA
1d5f96d9,7,3,2,3,2,3,8,5,6,2,4,1,8,10,0,18,SPA
1f079188,41,28,20,17,4,20,42,22,24,6,18,30,71,31,0,18,SPA
1fa85681,0,0,0,0,0,0,0,0,0,0,0,0,0,0,0,18,SPA
1fb1c435,23,13,9,12,2,3,21,18,14,2,12,17,40,11,1,18,SPA
1fe0492d,76,40,42,27,7,35,59,24,40,10,30,44,120,94,0,18,SPA
1fe67e86,34,24,17,13,4,15,27,12,24,5,19,17,51,61,0,18,SPA
20b9f052,0,0,0,0,0,0,0,0,0,0,0,1,1,15,2,18,SPA
21164a21,4,2,2,2,0,2,3,1,3,2,1,1,5,4,0,18,SPA
217011a0,7,6,2,4,1,1,1,0,4,0,4,0,7,0,0,18,SPA
21d4e122,46,29,29,16,1,25,48,23,28,7,21,42,88,64,1,18,SPA
220c11f1,22,14,2,17,3,3,29,26,10,0,10,5,27,32,0,18,SPA
22df75d8,1,0,1,0,0,0,0,0,1,0,1,0,1,0,0,18,SPA
2306bfde,1,0,0,1,0,1,2,1,5,0,5,5,6,1,0,18,SPA
23593121,15,11,3,12,0,3,11,8,7,0,7,2,17,4,0,18,SPA
23f32ea1,0,0,0,0,0,0,1,1,0,0,0,1,1,0,0,18,SPA
240d3a0b,80,59,23,47,10,31,80,49,28,4,24,70,150,25,0,18,SPA
24279b8b,1,0,1,0,0,1,3,2,0,0,0,1,2,5,4,18,SPA
244f57b9,3,2,2,0,1,0,4,4,1,0,1,2,5,1,0,18,SPA
24f59bb2,26,17,15,8,3,10,18,8,21,2,19,20,46,37,1,18,SPA
251336da,24,17,11,10,3,9,16,7,13,4,9,22,46,11,1,18,SPA
2513a588,13,10,3,5,5,1,7,6,6,0,6,5,18,8,0,18,SPA
2515040a,25,16,21,3,1,10,17,7,10,6,4,20,45,84,0,18,SPA
25c72b36,0,0,0,0,0,0,0,0,0,0,0,0,0,1,0,18,SPA
26f2473f,1,1,1,0,0,1,2,1,0,0,0,1,2,9,2,18,SPA
283c7121,1,0,0,0,1,0,1,1,1,0,1,2,3,2,0,18,SPA
28d596a0,0,0,0,0,0,0,2,2,0,0,0,2,2,6,2,18,SPA
293211e1,11,8,2,6,3,1,6,5,6,0,6,3,14,18,0,18,SPA
294450ba,20,15,12,7,1,11,21,10,13,5,8,10,30,27,1,18,SPA
2946f9a1,55,40,29,19,7,20,38,18,21,9,12,46,101,51,0,18,SPA
29b61deb,80,54,28,48,4,23,87,64,28,3,25,30,110,25,0,18,SPA
2a0c8ba4,31,24,8,19,4,10,68,58,24,0,24,30,61,12,0,18,SPA
2a70c756,17,10,3,12,2,4,12,8,11,1,10,3,20,4,0,18,SPA
2b15a82a,4,2,3,1,0,1,1,0,0,0,0,5,9,8,0,18,SPA
2bee98fd,15,12,1,10,4,3,22,19,6,3,3,10,25,12,0,18,SPA
2cea96ce,13,10,10,3,0,7,16,9,6,0,6,14,27,27,0,18,SPA
2e23c66b,4,3,0,0,4,0,6,6,8,1,7,5,9,17,0,18,SPA
2e8fc160,54,38,27,23,4,18,42,24,22,10,12,22,76,37,0,18,SPA
2ef16f06,0,0,0,0,0,0,2,2,1,0,1,0,0,0,0,18,SPA
2f3e911a,56,36,41,12,3,31,59,28,26,5,21,49,105,78,0,18,SPA
3024e383,61,44,36,19,6,38,58,20,31,1,30,38,99,76,0,18,SPA
30672832,0,0,0,0,0,0,1,1,1,0,1,2,2,0,0,18,SPA
307fcd26,1,0,1,0,0,0,0,0,0,0,0,0,1,4,0,18,SPA
31223bcf,21,15,6,10,5,9,23,14,7,0,7,16,37,11,0,18,SPA
314eeab1,0,0,0,0,0,0,0,0,0,0,0,1,1,0,0,18,SPA
322ba2df,12,9,7,5,0,5,9,4,7,1,6,5,17,17,1,18,SPA
32b84cec,1,1,0,1,0,0,1,1,2,0,2,2,3,0,0,18,SPA
335fa267,63,40,30,25,8,25,49,24,18,8,10,39,102,30,1,18,SPA
348e4809,13,6,9,4,0,7,20,13,26,19,7,26,39,92,1,18,SPA
3536fdc1,0,2,0,0,0,0,0,0,0,0,0,1,0,0,0,18,SPA
355c883a,50,33,31,17,2,32,50,18,13,7,6,41,91,66,0,18,SPA
35f6db55,54,34,12,28,14,13,52,39,22,1,21,23,77,25,0,18,SPA
379652be,2,2,2,0,0,0,5,5,2,0,2,3,5,3,0,18,SPA
37e103f8,0,0,0,0,0,0,1,1,0,0,0,0,0,0,0,18,SPA
37f1cf47,57,38,34,14,9,25,38,13,21,2,19,52,109,50,1,18,SPA
37f96552,11,6,4,6,1,3,18,15,14,1,13,18,29,3,0,18,SPA
38699c72,9,5,2,7,0,1,5,4,3,0,3,3,12,2,0,18,SPA
39583cfd,8,5,6,1,1,3,4,1,2,0,2,8,16,0,0,18,SPA
39e9c09a,1,1,1,0,0,1,3,2,1,0,1,0,1,3,0,18,SPA
3a6a49f7,6,6,3,3,0,1,4,3,2,0,2,3,9,4,0,18,SPA
3a9c4b7b,17,14,15,1,1,14,22,8,5,2,3,10,27,18,0,18,SPA
3aa4a3be,14,8,4,5,5,4,17,13,14,1,13,1,15,12,0,18,SPA
3b9f859b,8,6,3,3,2,3,7,4,4,0,4,13,21,11,0,18,SPA
3c7bc9bd,99,61,47,48,4,48,101,53,30,5,25,77,176,40,0,18,SPA
3d7e48ce,20,16,4,9,7,1,10,9,9,0,9,5,25,1,0,18,SPA
3e1858af,14,11,2,11,1,2,12,10,11,0,11,22,36,4,0,18,SPA
3e4f735d,58,44,42,14,2,38,74,36,31,3,28,58,116,89,1,18,SPA
3e5a168c,1,0,1,0,0,1,3,2,0,0,0,2,3,1,0,18,SPA
3ecc11d8,12,7,8,4,0,6,9,3,8,2,6,11,23,18,0,18,SPA
3eed9821,50,35,35,15,0,20,29,9,25,17,8,37,87,72,3,18,SPA
3f10bd22,32,25,17,9,6,12,26,14,14,5,9,19,51,37,0,18,SPA
3f79a1c8,59,35,21,32,6,17,39,22,26,3,23,32,91,19,0,18,SPA
3fc45c73,42,29,29,12,1,23,40,17,26,12,14,53,95,137,0,18,SPA
41c12f75,3,1,1,0,2,3,5,2,3,0,3,1,4,2,0,18,SPA
42276181,11,9,3,4,4,1,10,9,6,0,6,4,15,11,0,18,SPA
4242011c,36,22,29,6,1,18,33,15,27,19,8,66,102,169,0,18,SPA
42dcf26d,38,26,30,7,1,22,41,19,34,23,11,53,91,188,0,18,SPA
43f71e77,18,10,3,6,9,4,27,23,25,4,21,7,25,27,0,18,SPA
4410f0b0,3,2,1,2,0,1,4,3,0,0,0,0,3,0,0,18,SPA
44b61913,16,13,13,3,0,6,14,8,9,7,2,13,29,35,0,18,SPA
45af8a54,26,17,7,13,6,11,26,15,15,0,15,9,35,2,0,18,SPA
45b9b619,15,10,7,6,2,8,29,21,15,1,14,2,17,12,0,18,SPA
45e304c8,10,5,2,4,4,2,6,4,5,0,5,7,17,1,0,18,SPA
4601e194,63,42,35,22,6,26,52,26,34,5,29,68,131,67,1,18,SPA
46166b49,8,5,1,3,4,2,6,4,7,0,7,4,12,9,0,18,SPA
467bae22,39,32,16,15,8,6,34,28,20,2,18,11,50,11,0,18,SPA
46a8347f,48,30,25,17,6,26,40,14,24,8,16,36,84,63,0,18,SPA
46e07328,1,1,0,1,0,0,0,0,0,0,0,0,1,0,0,18,SPA
4737cebe,16,11,2,8,6,5,18,13,12,0,12,11,27,5,0,18,SPA
474ecac8,36,23,30,5,1,18,32,14,27,13,14,40,76,140,1,18,SPA
48593154,6,5,1,3,2,1,3,2,5,0,5,3,9,5,0,18,SPA
485e4939,8,6,4,4,0,3,6,3,3,0,3,8,16,4,0,18,SPA
487d9b09,59,42,40,11,8,24,36,12,22,5,17,24,83,66,0,18,SPA
48e4c485,4,4,1,1,2,2,5,3,2,0,2,2,6,1,0,18,SPA
48e89655,45,32,14,21,10,17,57,40,28,3,25,22,67,16,0,18,SPA
4958bfb2,59,40,27,22,10,22,38,16,33,15,18,38,97,42,2,18,SPA
49ea92be,44,30,18,21,5,16,58,42,31,0,31,21,65,9,0,18,SPA
4a478107,37,23,15,15,7,13,65,52,28,0,28,26,63,20,0,18,SPA
4a895384,2,2,2,0,0,1,4,3,3,2,1,7,9,25,1,18,SPA
4ac7608e,27,19,20,7,0,18,26,8,25,10,15,19,46,69,0,18,SPA
4accb7e0,32,17,11,17,4,13,33,20,14,3,11,14,46,12,0,18,SPA
4b32b2be,1,1,0,1,0,0,0,0,0,0,0,0,1,0,0,18,SPA
4b3f2936,10,6,2,6,2,2,3,1,8,1,7,0,10,1,0,18,SPA
4bc5f2b4,5,2,4,1,0,0,3,3,3,0,3,3,8,2,0,18,SPA
4c0a6a48,1,0,1,0,0,0,1,1,1,0,1,0,1,0,0,18,SPA
4c2e9442,7,4,1,4,2,0,18,18,9,4,5,3,10,34,0,18,SPA
4c5b14d2,22,19,11,10,1,4,16,12,17,2,15,15,37,38,0,18,SPA
4cafb146,2,2,2,0,0,0,0,0,0,0,0,0,2,1,0,18,SPA
4d224fe8,109,78,64,39,6,42,84,42,56,11,45,63,172,49,3,18,SPA
4db76f57,33,18,17,15,1,11,23,12,12,5,7,33,66,40,0,18,SPA
4e2c27bb,1,1,0,0,1,0,0,0,0,0,0,0,1,0,0,18,SPA
4efd29bb,2,0,1,0,1,0,4,4,2,1,1,2,4,9,0,18,SPA
4f28a6ff,67,50,32,35,0,21,38,17,44,27,17,35,102,157,1,18,SPA
4f6d9bcd,2,1,2,0,0,2,7,5,6,1,5,3,5,4,0,18,SPA
4ffb647d,12,5,10,2,0,7,10,3,10,6,4,22,34,67,0,18,SPA
5070881b,15,13,9,6,0,8,9,1,14,8,6,8,23,20,0,18,SPA
50b51fac,25,12,6,16,3,9,24,15,13,5,8,18,43,24,2,18,SPA
51e3954c,35,25,30,5,0,22,36,14,18,6,12,31,66,50,1,18,SPA
529f49ab,94,64,48,39,7,33,69,36,32,7,25,53,147,34,1,18,SPA
532e1e4f,0,0,0,0,0,0,1,1,1,1,0,0,0,4,0,18,SPA
54073b28,54,42,26,23,5,17,62,45,15,3,12,30,84,17,0,18,SPA
5418d47c,2,1,2,0,0,1,4,3,1,0,1,1,3,1,0,18,SPA
54f5ce34,43,24,32,9,2,23,33,10,10,2,8,24,67,46,0,18,SPA
55126f3b,75,45,31,32,12,27,95,68,40,3,37,24,99,38,0,18,SPA
555f3a0b,14,12,13,1,0,8,21,13,15,8,7,25,39,122,0,18,SPA
56cafd0a,0,0,0,0,0,0,0,0,0,0,0,0,0,1,0,18,SPA
576575e5,1,1,1,0,0,0,0,0,2,2,0,8,9,2,0,18,SPA
57ebd662,40,25,14,22,4,12,50,38,25,8,17,38,78,34,0,18,SPA
581c5276,0,0,0,0,0,0,0,0,0,0,0,0,0,0,0,18,SPA
5890cef1,17,15,11,4,2,6,17,11,19,3,16,25,42,52,1,18,SPA
58afe001,56,41,19,30,7,14,47,33,26,3,23,25,81,36,0,18,SPA
58bc7d18,1,0,1,0,0,1,1,0,0,0,0,2,3,6,2,18,SPA
59b7d823,71,42,37,26,8,34,53,19,29,3,26,16,87,46,1,18,SPA
59d53e8a,31,19,22,7,2,16,34,18,16,4,12,21,52,26,0,18,SPA
5a3f6fae,32,22,24,7,1,16,25,9,13,3,10,29,61,49,0,18,SPA
5ab0ea87,88,48,27,46,15,39,79,40,37,10,27,51,139,15,1,18,SPA
5b2a4b8d,4,4,1,2,1,0,1,1,2,0,2,2,6,1,0,18,SPA
5b5724d2,12,6,7,5,0,5,7,2,6,3,3,6,18,29,0,18,SPA
5c256395,3,1,2,1,0,2,3,1,0,0,0,2,5,2,0,18,SPA
5c2da10f,8,5,2,6,0,1,6,5,4,0,4,2,10,4,0,18,SPA
5c7845f6,39,29,17,16,6,14,42,28,20,5,15,32,71,31,0,18,SPA
5ca20b7a,68,52,31,31,6,39,62,23,28,5,23,61,129,85,0,18,SPA
5ce0b5ba,85,57,35,41,9,37,90,53,44,8,36,75,160,35,0,18,SPA
5cec2487,66,48,36,22,8,30,55,25,35,10,25,53,119,89,0,18,SPA
5d311e8d,7,3,7,0,0,5,7,2,3,3,0,10,17,17,0,18,SPA
5db04597,74,55,39,23,12,25,49,24,28,7,21,50,124,82,0,18,SPA
5f0241b2,1,1,1,0,0,0,2,2,0,0,0,1,2,5,3,18,SPA
5f5501ed,15,8,5,6,4,8,21,13,6,0,6,1,16,6,0,18,SPA
5f7db81a,17,13,5,9,3,5,15,10,7,0,7,7,24,5,0,18,SPA
6025fab1,33,22,14,15,4,15,41,26,13,4,9,31,64,7,0,18,SPA
603116a7,53,37,19,23,11,22,58,36,26,2,24,30,83,23,2,18,SPA
60713cb3,0,0,0,0,0,0,0,0,0,0,0,0,0,0,2,18,SPA
608f2092,42,27,31,8,3,21,37,16,24,3,21,32,74,42,2,18,SPA
60ee859c,1,0,0,1,0,1,1,0,1,0,1,0,1,0,0,18,SPA
61220da2,57,36,25,27,5,19,58,39,31,10,21,45,102,37,0,18,SPA
61bb7498,0,0,0,0,0,0,0,0,0,0,0,0,0,2,0,18,SPA
61bd33d0,39,21,12,19,8,13,42,29,36,0,36,18,57,10,0,18,SPA
625c144a,2,1,2,0,0,2,6,4,0,0,0,0,2,10,2,18,SPA
63f04c6c,57,40,24,21,12,19,56,37,39,5,34,32,89,26,0,18,SPA
6434f10d,104,71,50,48,6,30,86,56,49,21,28,52,156,100,1,18,SPA
6435143e,1,1,0,1,0,0,0,0,0,0,0,0,1,0,0,18,SPA
643b39a6,24,19,4,14,6,7,28,21,7,1,6,7,31,5,1,18,SPA
64e8ed6d,6,3,0,4,2,1,5,4,3,0,3,0,6,0,0,18,SPA
65d62814,1,0,1,0,0,1,1,0,1,0,1,0,1,11,2,18,SPA
65d750b5,80,49,39,37,4,38,104,66,28,10,18,44,124,38,0,18,SPA
6639e500,26,15,12,11,3,10,30,20,9,1,8,11,37,5,0,18,SPA
6922f806,24,16,5,10,9,4,23,19,15,2,13,7,31,35,0,18,SPA
6941883f,2,2,1,0,1,0,3,3,1,1,0,4,6,0,0,18,SPA
697295b1,14,9,10,4,0,7,13,6,18,11,7,16,30,41,2,18,SPA
69cbc8b6,19,10,12,7,0,7,17,10,9,5,4,22,41,37,0,18,SPA
6a7586f4,10,4,4,6,0,2,3,1,0,0,0,0,10,0,0,18,SPA
6a99e0b1,28,17,11,15,2,8,41,33,24,2,22,17,45,13,0,18,SPA
6c2f5996,48,33,17,27,4,14,46,32,29,11,18,40,88,72,0,18,SPA
6ca663b4,0,0,0,0,0,0,0,0,1,0,1,1,1,1,0,18,SPA
6ce1f46f,55,35,19,29,7,22,59,37,20,2,18,16,71,10,1,18,SPA
6cffc9df,1,1,1,0,0,1,3,2,0,0,0,0,1,2,0,18,SPA
6d5701f2,10,8,6,4,0,4,6,2,6,3,3,6,16,16,0,18,SPA
6d8f8441,35,23,26,7,2,18,39,21,17,5,12,34,69,46,0,18,SPA
6dce77a5,42,31,18,22,2,10,32,22,22,7,15,35,77,57,0,18,SPA
6df0dc74,4,4,1,3,0,0,5,5,2,2,0,4,8,9,0,18,SPA
6f0d613a,1,1,0,1,0,0,2,2,2,0,2,0,1,1,0,18,SPA
6f51e382,1,0,1,0,0,1,3,2,1,0,1,4,5,12,1,18,SPA
6f5f82c0,3,2,1,2,0,2,5,3,1,0,1,4,7,1,0,18,SPA
6f7d826d,10,9,4,6,0,3,11,8,1,0,1,4,14,0,0,18,SPA
6fb59070,0,0,0,0,0,0,0,0,1,0,1,0,0,10,1,18,SPA
6fd1ba62,42,29,16,15,11,16,65,49,17,0,17,18,60,13,0,18,SPA
70438d35,10,5,5,5,0,6,13,7,5,0,5,11,21,24,1,18,SPA
70d74ece,14,8,2,6,6,3,20,17,18,0,18,8,22,19,0,18,SPA
71d4e271,18,14,8,8,2,5,14,9,13,1,12,16,34,5,0,18,SPA
72a99e38,32,24,12,14,6,7,37,30,19,0,19,16,48,4,1,18,SPA
72b92c4e,5,2,4,1,0,3,6,3,1,0,1,5,10,6,0,18,SPA
730bd100,15,13,6,8,1,7,12,5,5,0,5,5,20,0,0,18,SPA
7329018e,31,23,7,19,5,11,29,18,8,2,6,19,50,16,0,18,SPA
73683fa9,0,0,0,0,0,0,1,1,0,0,0,0,0,1,0,18,SPA
7460ca0d,88,57,35,43,10,31,87,56,37,10,27,34,122,27,1,18,SPA
75751c99,4,3,4,0,0,3,4,1,0,0,0,3,7,22,6,18,SPA
76ee80ee,1,1,0,1,0,1,1,0,0,0,0,0,1,1,0,18,SPA
7789bf63,3,1,1,1,1,1,1,0,0,0,0,3,6,3,0,18,SPA
78c40e94,3,2,1,2,0,1,3,2,3,2,1,2,5,3,0,18,SPA
79135368,62,45,22,34,6,17,66,49,26,4,22,30,92,42,0,18,SPA
7956236f,0,0,0,0,0,0,0,0,0,0,0,0,0,3,0,18,SPA
79c0821a,37,27,19,18,0,8,27,19,9,4,5,5,42,5,0,18,SPA
7a4cd784,1,1,1,0,0,1,1,0,0,0,0,0,1,7,1,18,SPA
7a9fae62,0,0,0,0,0,0,0,0,0,0,0,0,0,3,0,18,SPA
7c218bf9,0,0,0,0,0,0,0,0,0,0,0,0,0,0,0,18,SPA
7c2a398c,19,10,5,10,4,5,17,12,13,0,13,5,24,2,0,18,SPA
7c4243d4,13,10,2,7,4,6,8,2,3,2,1,0,13,5,0,18,SPA
7c689c48,0,0,0,0,0,0,0,0,4,2,2,1,1,0,0,18,SPA
7cefa219,8,5,5,3,0,6,18,12,12,5,7,12,20,16,0,18,SPA
7dcf86f6,26,22,10,10,6,5,34,29,15,1,14,23,49,11,1,18,SPA
7e28d6f7,0,0,0,0,0,0,0,0,0,0,0,0,0,0,0,18,SPA
7eb97a8e,8,4,2,4,2,2,17,15,1,0,1,1,9,2,0,18,SPA
7ebfac0f,9,6,3,5,1,3,9,6,2,0,2,1,10,3,0,18,SPA
7f203b54,20,13,14,6,0,9,18,9,43,27,16,30,50,110,1,18,SPA
808d48f3,67,43,39,22,6,33,51,18,30,8,22,46,113,97,0,18,SPA
81069528,104,69,52,40,12,50,84,34,37,13,24,58,162,104,1,18,SPA
81f0781e,41,28,7,22,12,12,53,41,27,6,21,19,60,46,0,18,SPA
82927de4,52,33,19,26,7,18,60,42,29,3,26,22,74,18,0,18,SPA
833fb62e,8,8,1,5,2,1,7,6,2,0,2,4,12,2,0,18,SPA
83627094,3,2,3,0,0,0,4,4,0,0,0,1,4,6,0,18,SPA
83a83b0a,4,3,4,0,0,3,4,1,1,0,1,3,7,3,0,18,SPA
84399660,22,13,7,12,3,4,22,18,11,0,11,10,32,6,0,18,SPA
8497faf7,36,22,25,10,1,16,28,12,19,5,14,21,57,54,0,18,SPA
8499c713,1,1,0,0,1,0,1,1,1,0,1,0,1,0,0,18,SPA
850c0a0d,38,30,24,12,2,21,40,19,21,10,11,78,116,108,2,18,SPA
8617e3d9,26,20,12,12,2,12,32,20,13,1,12,24,50,25,0,18,SPA
8696bc90,25,20,8,9,8,5,14,9,13,2,11,9,34,5,0,18,SPA
8754c7ca,79,56,35,37,7,28,77,49,36,9,27,46,125,62,0,18,SPA
87882adc,19,11,14,5,0,7,31,24,15,7,8,19,38,32,2,18,SPA
87ec1a2a,16,7,8,6,2,6,29,23,15,0,15,8,24,4,0,18,SPA
8875b8c9,0,0,0,0,0,0,1,1,1,0,1,0,0,11,1,18,SPA
88a359d4,24,14,11,8,5,7,25,18,22,4,18,10,34,49,0,18,SPA
89151b16,22,14,14,6,2,7,12,5,17,13,4,36,58,95,2,18,SPA
895ff3ca,6,2,3,3,0,3,6,3,2,0,2,0,6,0,0,18,SPA
89f951b5,52,31,16,30,6,15,45,30,42,7,35,44,96,16,0,18,SPA
8b6d1830,1,1,0,1,0,0,1,1,4,2,2,2,3,2,0,18,SPA
8b8a56ce,35,24,25,8,2,13,22,9,16,10,6,32,67,109,0,18,SPA
8c3c640c,33,23,10,13,10,7,39,32,32,2,30,18,51,19,0,18,SPA
8c44e37b,9,7,1,6,2,1,13,12,7,0,7,3,12,5,0,18,SPA
8c83efb6,18,9,8,7,3,10,17,7,2,0,2,8,26,5,0,18,SPA
8ca253a3,5,3,2,2,1,1,12,11,7,0,7,2,7,16,0,18,SPA
8cc3d96e,37,24,15,14,8,11,32,21,21,2,19,23,60,13,0,18,SPA
8cfc2f69,28,19,3,19,6,3,26,23,18,3,15,6,34,14,0,18,SPA
8d957256,2,0,2,0,0,2,6,4,0,0,0,4,6,29,3,18,SPA
8db394aa,63,43,44,19,0,28,50,22,27,16,11,66,129,131,4,18,SPA
8e010ff4,38,23,15,18,5,11,45,34,25,1,24,22,60,21,0,18,SPA
8e088e04,30,16,22,6,2,16,27,11,9,3,6,9,39,23,0,18,SPA
8ef81d2d,13,10,4,8,1,5,7,2,2,2,0,3,16,2,0,18,SPA
8f8c6934,1,0,1,0,0,1,1,0,0,0,0,2,3,13,2,18,SPA
9038c2a1,32,25,11,14,7,11,38,27,14,1,13,20,52,8,0,18,SPA
90f83973,2,1,0,1,1,1,5,4,1,1,0,2,4,2,0,18,SPA
9109185e,2,1,2,0,0,2,2,0,0,0,0,0,2,7,1,18,SPA
9243fea6,8,6,3,2,3,3,4,1,4,0,4,2,10,3,0,18,SPA
92b4a127,29,21,14,15,0,14,38,24,22,11,11,43,72,106,2,18,SPA
92d38e6c,48,33,43,5,0,29,46,17,27,12,15,62,110,89,0,18,SPA
93568a16,5,5,2,2,1,1,11,10,2,0,2,5,10,5,0,18,SPA
942b4f90,12,8,2,5,5,1,2,1,10,0,10,5,17,2,0,18,SPA
9592289a,21,14,4,10,7,1,20,19,26,1,25,8,29,34,0,18,SPA
960fb42d,61,40,31,30,0,29,53,24,25,12,13,56,117,91,2,18,SPA
963829d0,61,41,23,34,4,21,71,50,38,13,25,22,83,44,0,18,SPA
967f34d3,0,0,0,0,0,0,2,2,1,0,1,3,3,16,1,18,SPA
9704b62b,1,0,0,1,0,0,4,4,1,1,0,1,2,3,0,18,SPA
9744ff80,27,19,10,13,4,11,49,38,39,1,38,30,57,34,1,18,SPA
97852360,0,0,0,0,0,0,0,0,1,0,1,3,3,12,4,18,SPA
983ccabe,0,0,0,0,0,0,0,0,0,0,0,0,0,0,1,18,SPA
9857e65d,14,8,8,3,3,4,13,9,5,0,5,5,19,1,0,18,SPA
9970da54,0,0,0,0,0,0,0,0,0,0,0,0,0,0,0,18,SPA
999908af,43,30,25,15,3,13,39,26,22,1,21,35,78,21,0,18,SPA
99bebd12,7,7,3,1,3,2,10,8,10,1,9,2,9,7,0,18,SPA
9b337c7c,18,12,7,9,2,3,18,15,18,2,16,16,34,19,0,18,SPA
9b5ce51a,51,35,26,23,2,17,45,28,25,10,15,49,100,43,0,18,SPA
9b878773,3,2,2,1,0,2,11,9,2,0,2,1,4,2,0,18,SPA
9ba48d64,64,44,38,22,4,35,65,30,29,11,18,63,127,121,0,18,SPA
9d2a3d5f,19,15,11,4,4,6,30,24,16,1,15,15,34,20,1,18,SPA
9d4c3227,5,4,4,0,1,1,2,1,1,0,1,3,8,3,0,18,SPA
9d4c45d6,30,20,10,16,4,3,16,13,14,0,14,4,34,9,0,18,SPA
9e098912,0,0,0,0,0,0,0,0,0,0,0,0,0,0,0,18,SPA
9e1035f8,8,7,3,5,0,2,6,4,1,0,1,3,11,1,0,18,SPA
9f0ea33f,2,2,2,0,0,1,5,4,0,0,0,0,2,11,2,18,SPA
9f323c71,28,21,11,15,2,13,29,16,15,2,13,19,47,36,0,18,SPA
9f8e9423,28,19,20,7,1,8,15,7,27,10,17,33,61,109,2,18,SPA
9fa0a0b8,2,1,1,1,0,1,2,1,5,0,5,3,5,0,0,18,SPA
a0b4bb3e,22,12,5,10,7,5,35,30,11,0,11,15,37,2,0,18,SPA
a10361d2,24,14,13,9,2,12,22,10,9,1,8,17,41,12,0,18,SPA
a190d597,17,11,2,10,5,4,15,11,14,4,10,5,22,3,0,18,SPA
a25250f8,78,53,31,39,8,38,114,76,46,3,43,47,125,29,0,18,SPA
a2609621,14,8,12,1,1,5,10,5,13,10,3,16,30,57,1,18,SPA
a300ac7e,17,12,5,8,4,1,32,31,19,1,18,9,26,1,0,18,SPA
a3a306f6,38,20,20,18,0,14,38,24,14,1,13,15,53,12,0,18,SPA
a4971d84,87,65,71,15,1,34,52,18,33,14,19,78,165,190,1,18,SPA
a55d8df5,0,0,0,0,0,0,0,0,0,0,0,0,0,0,0,18,SPA
a58bb1e1,19,13,7,8,4,3,14,11,13,1,12,12,31,18,0,18,SPA
a60823a4,33,23,21,10,2,17,30,13,22,7,15,26,59,45,0,18,SPA
a6154613,17,10,4,5,8,4,19,15,4,3,1,8,25,31,0,18,SPA
a68856b5,2,1,0,2,0,0,1,1,0,0,0,1,3,1,0,18,SPA
a6951bf8,18,14,11,6,1,9,16,7,9,2,7,20,38,23,0,18,SPA
a6b9bd00,11,7,5,6,0,4,17,13,10,1,9,5,16,4,0,18,SPA
a6de370d,30,24,6,18,6,9,32,23,25,0,25,11,41,3,0,18,SPA
a7a9d95a,4,3,0,2,2,0,6,6,5,0,5,11,15,3,0,18,SPA
a7f00c8c,111,77,64,40,7,65,96,31,24,4,20,55,166,113,0,18,SPA
a83d8b0c,10,7,8,2,0,2,4,2,4,2,2,4,14,4,0,18,SPA
a8599c17,1,0,0,1,0,0,0,0,0,0,0,0,1,7,0,18,SPA
a8e6bebf,37,23,15,15,7,11,30,19,15,0,15,18,55,10,0,18,SPA
a8fbae1d,41,22,28,13,0,16,22,6,23,9,14,62,103,140,0,18,SPA
a92669f6,11,8,7,3,1,3,5,2,8,1,7,13,24,24,0,18,SPA
a9dc785c,1,1,1,0,0,1,2,1,1,0,1,1,2,8,3,18,SPA
aa0ac32d,12,9,8,4,0,4,11,7,8,8,0,9,21,60,2,18,SPA
aa55fe48,1,1,0,1,0,0,0,0,0,0,0,1,2,1,0,18,SPA
aaa4239e,1,1,1,0,0,0,1,1,0,0,0,1,2,0,0,18,SPA
aad4f74f,0,0,0,0,0,0,0,0,0,0,0,1,1,4,0,18,SPA
ab13a5aa,0,0,0,0,0,0,0,0,0,0,0,3,3,12,1,18,SPA
ac290817,8,5,5,0,3,3,15,12,7,1,6,6,14,6,0,18,SPA
ac295d9e,4,4,4,0,0,4,11,7,1,0,1,2,6,26,2,18,SPA
ac3fb1be,18,12,15,3,0,10,14,4,22,11,11,24,42,139,0,18,SPA
ac454a4f,35,26,13,21,1,12,37,25,12,4,8,14,49,27,0,18,SPA
ad178594,22,15,18,4,0,14,26,12,23,13,10,30,52,73,0,18,SPA
ad340e17,33,19,13,17,3,11,31,20,20,4,16,23,56,23,0,18,SPA
ad4d0985,106,72,56,45,5,49,113,64,38,14,24,79,185,73,1,18,SPA
ad6295d4,28,19,14,12,2,17,36,19,18,4,14,15,43,44,1,18,SPA
adfc9123,31,22,22,9,0,16,36,20,40,27,13,30,61,127,0,18,SPA
aec0fb6f,32,15,10,18,4,13,42,29,16,5,11,23,55,17,0,18,SPA
b037bd4f,28,20,12,13,3,13,36,23,6,1,5,28,56,12,0,18,SPA
b05e2dbd,77,60,52,22,3,43,68,25,43,12,31,56,133,90,1,18,SPA
b0616e3d,78,49,40,26,12,32,62,30,35,6,29,66,144,69,1,18,SPA
b0fce72c,17,8,6,11,0,4,25,21,14,3,11,8,25,15,0,18,SPA
b14d0c5d,41,28,30,11,0,18,25,7,26,9,17,31,72,101,1,18,SPA
b19db005,10,7,2,5,3,1,13,12,8,0,8,5,15,2,0,18,SPA
b233e8e4,31,24,25,6,0,14,21,7,18,9,9,29,60,85,1,18,SPA
b2d03887,20,15,8,10,2,3,13,10,8,0,8,15,35,13,0,18,SPA
b2d0ec1b,49,36,21,21,7,14,33,19,17,2,15,10,59,17,0,18,SPA
b32b7d1b,2,2,1,0,1,2,3,1,2,0,2,1,3,0,0,18,SPA
b35db3f6,7,5,0,2,5,1,11,10,11,0,11,9,16,16,0,18,SPA
b3dc6eca,33,22,29,4,0,13,25,12,27,18,9,58,91,134,1,18,SPA
b418dbd4,82,51,28,36,18,26,71,45,55,3,52,30,112,23,0,18,SPA
b43b81f1,16,8,12,3,1,10,15,5,6,4,2,29,45,66,2,18,SPA
b579e83d,24,17,9,12,3,12,26,14,17,3,14,27,51,10,0,18,SPA
b5bdf144,0,0,0,0,0,0,2,2,1,0,1,1,1,12,3,18,SPA
b5dd3469,18,16,6,8,4,3,8,5,8,2,6,10,28,11,0,18,SPA
b742cc0d,38,28,30,8,0,21,39,18,19,10,9,32,70,97,1,18,SPA
b7c99b9b,20,15,13,5,2,11,19,8,23,14,9,29,49,109,0,18,SPA
b7ca5c51,47,27,41,4,2,32,46,14,30,14,16,51,98,142,2,18,SPA
b7f2edff,6,4,3,3,0,2,8,6,2,0,2,3,9,8,0,18,SPA
b8836910,61,39,34,22,5,15,47,32,39,7,32,34,95,36,0,18,SPA
ba3ca78f,0,0,0,0,0,0,0,0,0,0,0,2,2,15,0,18,SPA
ba5004e1,86,64,54,21,11,44,90,46,34,8,26,46,132,76,1,18,SPA
ba71d071,9,5,5,4,0,1,3,2,7,3,4,14,23,41,0,18,SPA
bad38a94,29,26,15,9,5,13,18,5,14,3,11,14,43,27,0,18,SPA
bb4b1242,11,8,3,3,5,2,8,6,13,1,12,6,17,8,0,18,SPA
bb7337cc,39,28,17,15,7,11,38,27,25,3,22,15,54,16,1,18,SPA
bba30585,30,22,16,13,1,18,29,11,41,18,23,43,73,96,0,18,SPA
bbe88396,2,1,1,1,0,0,1,1,1,0,1,3,5,3,0,18,SPA
bc6f5f06,52,37,38,13,1,20,34,14,32,22,10,56,108,118,1,18,SPA
bd207a4d,7,3,3,4,0,2,12,10,5,0,5,6,13,1,0,18,SPA
bd6351cd,1,1,0,1,0,1,1,0,1,0,1,2,3,0,0,18,SPA
bdf7b97d,11,8,3,7,1,2,6,4,4,1,3,2,13,9,0,18,SPA
be170419,73,52,54,19,0,38,56,18,52,27,25,67,140,155,2,18,SPA
be3a0121,25,16,20,5,0,15,24,9,25,11,14,35,60,115,0,18,SPA
bf97c188,55,37,35,18,2,36,67,31,32,20,12,42,97,83,1,18,SPA
bfa29677,0,0,0,0,0,0,0,0,1,0,1,0,0,3,0,18,SPA
bfb15d99,0,0,0,0,0,0,0,0,0,0,0,0,0,1,0,18,SPA
c00097d2,35,22,27,8,0,17,32,15,29,18,11,41,76,75,1,18,SPA
c05dfb74,10,8,2,6,2,1,7,6,4,0,4,4,14,3,0,18,SPA
c0617e2b,8,7,3,2,3,4,16,12,6,0,6,5,13,1,0,18,SPA
c0a0c18f,9,6,2,6,1,3,13,10,5,1,4,1,10,5,0,18,SPA
c0b1a6da,0,0,0,0,0,0,0,0,0,0,0,0,0,1,0,18,SPA
c0c7ff58,83,53,34,40,9,26,73,47,35,3,32,42,125,36,1,18,SPA
c0de5ff5,1,1,0,1,0,1,1,0,1,0,1,2,3,2,0,18,SPA
c14bc029,132,90,53,69,10,40,104,64,61,12,49,55,187,77,0,18,SPA
c2111b45,8,7,6,2,0,2,5,3,6,5,1,16,24,21,1,18,SPA
c2846353,20,13,12,8,0,10,20,10,11,6,5,22,42,17,0,18,SPA
c3ee18ef,93,68,51,35,7,55,74,19,35,10,25,40,133,90,0,18,SPA
c4af5889,1,0,1,0,0,1,3,2,1,1,0,1,2,1,1,18,SPA
c4b8bcf4,11,8,2,5,4,1,8,7,7,0,7,7,18,10,0,18,SPA
c5eaff5c,1,1,1,0,0,1,2,1,1,0,1,1,2,0,0,18,SPA
c5fa58ea,48,31,15,29,4,13,38,25,26,6,20,23,71,38,0,18,SPA
c67cd65c,43,24,30,12,1,16,32,16,25,9,16,23,66,83,0,18,SPA
c6e8cf1f,21,16,9,8,4,5,16,11,14,6,8,17,38,13,0,18,SPA
c7526c18,39,26,14,19,6,20,30,10,27,8,19,28,67,36,2,18,SPA
c818c4d9,0,0,0,0,0,0,1,1,0,0,0,0,0,0,0,18,SPA
c84c1afc,0,0,0,0,0,0,1,1,0,0,0,0,0,2,0,18,SPA
c8aa95da,59,45,45,14,0,32,61,29,36,20,16,45,104,141,1,18,SPA
c904f3d5,6,5,6,0,0,4,6,2,5,1,4,5,11,13,2,18,SPA
c90977db,14,8,5,8,1,4,23,19,10,1,9,7,21,3,0,18,SPA
c9cb972b,0,0,0,0,0,0,0,0,0,0,0,0,0,2,0,18,SPA
c9e39d91,19,15,9,6,4,7,17,10,13,0,13,4,23,12,0,18,SPA
cac2537b,39,26,14,16,9,10,38,28,11,0,11,16,55,7,0,18,SPA
cb574619,84,55,55,26,3,35,53,18,30,15,15,68,152,111,1,18,SPA
cbdf7d5c,1,0,0,1,0,1,1,0,0,0,0,0,1,0,0,18,SPA
cc29324e,2,2,1,1,0,1,5,4,5,3,2,6,8,8,0,18,SPA
cc2dd8a5,2,2,0,2,0,0,0,0,0,0,0,0,2,0,0,18,SPA
cce181df,88,57,38,43,7,23,68,45,46,14,32,62,150,66,0,18,SPA
cefb32b1,21,13,6,11,4,10,29,19,18,4,14,17,38,14,1,18,SPA
cfd65a29,28,22,11,8,9,6,31,25,21,2,19,10,38,12,1,18,SPA
cfd68aa7,0,0,0,0,0,0,0,0,0,0,0,0,0,1,0,18,SPA
cfd8d664,33,24,21,9,3,21,32,11,14,4,10,26,59,35,0,18,SPA
d04b94db,34,25,19,11,4,17,29,12,16,2,14,22,56,26,1,18,SPA
d054d8b0,18,14,5,9,4,2,10,8,8,2,6,7,25,20,0,18,SPA
d0d79694,13,9,7,5,1,5,11,6,10,3,7,18,31,28,0,18,SPA
d109f62b,1,1,0,0,1,0,0,0,0,0,0,0,1,2,0,18,SPA
d1491e00,33,25,7,13,13,9,44,35,18,1,17,12,45,9,0,18,SPA
d189e48f,0,0,0,0,0,0,0,0,1,0,1,0,0,0,0,18,SPA
d24e154c,0,0,0,0,0,0,1,1,0,0,0,0,0,0,1,18,SPA
d2ac648c,21,10,8,10,3,6,21,15,6,1,5,19,40,9,0,18,SPA
d2be40f2,20,14,8,12,0,8,19,11,12,5,7,25,45,51,2,18,SPA
d2fa73e7,48,34,19,23,6,21,62,41,21,1,20,15,63,15,0,18,SPA
d3272fba,3,3,1,2,0,0,4,4,1,0,1,1,4,0,0,18,SPA
d49f3e6b,12,8,3,7,2,3,10,7,5,0,5,6,18,4,0,18,SPA
d4c9725f,21,15,16,2,3,13,25,12,9,2,7,17,38,20,0,18,SPA
d4ef9ac5,12,11,11,1,0,5,10,5,4,0,4,6,18,29,0,18,SPA
d5127c3f,1,1,0,1,0,0,1,1,0,0,0,0,1,0,0,18,SPA
d66b9872,9,4,0,2,7,0,4,4,18,2,16,9,18,5,0,18,SPA
d70a2141,32,23,15,16,1,11,24,13,14,4,10,38,70,77,2,18,SPA
d70ce98e,17,8,0,11,6,2,18,16,11,1,10,7,24,0,0,18,SPA
d79afcfc,11,8,2,7,2,3,8,5,7,0,7,6,17,1,0,18,SPA
d83bbc54,30,21,8,18,4,8,25,17,23,3,20,30,60,47,0,18,SPA
d8712bf9,9,7,1,4,4,3,8,5,5,0,5,3,12,1,0,18,SPA
d87e2cae,10,7,1,5,4,2,9,7,10,1,9,5,15,31,0,18,SPA
d9764034,28,16,24,4,0,17,32,15,19,10,9,36,64,108,0,18,SPA
d9b0cc38,0,0,0,0,0,0,0,0,0,0,0,0,0,0,0,18,SPA
d9ba39fc,68,43,37,21,10,36,53,17,30,6,24,76,144,61,0,18,SPA
d9bda115,49,36,22,25,2,20,49,29,32,10,22,41,90,24,1,18,SPA
d9faee7e,4,1,2,2,0,1,2,1,3,0,3,0,4,0,0,18,SPA
da27e268,8,7,3,5,0,3,4,1,4,2,2,4,12,10,0,18,SPA
dac68523,47,27,20,25,2,20,37,17,23,6,17,38,85,16,1,18,SPA
db0cd1ae,33,24,24,7,2,20,45,25,28,14,14,30,63,114,3,18,SPA
db714daf,6,3,2,3,1,1,5,4,0,0,0,2,8,3,0,18,SPA
db750822,24,18,13,8,3,7,32,25,20,4,16,12,36,14,0,18,SPA
dbe5a587,22,10,17,5,0,15,27,12,16,13,3,25,47,51,1,18,SPA
dc008610,9,7,4,4,1,4,17,13,9,2,7,3,12,12,0,18,SPA
dc4511f3,0,0,0,0,0,0,1,1,0,0,0,0,0,1,3,18,SPA
de39485a,17,13,7,5,5,3,8,5,9,0,9,4,21,3,0,18,SPA
de7d40d6,15,13,9,6,0,7,19,12,7,1,6,11,26,25,0,18,SPA
dea698d9,7,4,3,3,1,1,6,5,10,3,7,6,13,14,0,18,SPA
debc6b55,0,0,0,0,0,0,1,1,2,0,2,0,0,0,0,18,SPA
def69cd0,24,13,7,16,1,12,34,22,15,5,10,23,47,12,1,18,SPA
df69b544,36,24,6,23,7,10,30,20,20,1,19,10,46,14,0,18,SPA
df9326db,2,1,1,1,0,0,0,0,1,0,1,3,5,4,0,18,SPA
e08647d6,2,1,1,1,0,0,2,2,1,0,1,0,2,0,0,18,SPA
e0cd04e0,12,7,5,3,4,6,7,1,2,0,2,0,12,1,0,18,SPA
e12d7851,25,22,12,9,4,17,25,8,11,3,8,16,41,68,0,18,SPA
e185aa52,9,7,2,7,0,1,7,6,10,4,6,11,20,10,0,18,SPA
e1cbb531,64,45,24,35,5,23,65,42,25,9,16,39,103,22,0,18,SPA
e1cea3f7,15,11,7,5,3,4,22,18,6,0,6,4,19,7,0,18,SPA
e1deea75,7,7,6,1,0,4,7,3,6,3,3,10,17,22,0,18,SPA
e208bcc8,34,19,18,15,1,6,22,16,15,4,11,14,48,4,0,18,SPA
e28868f3,102,78,60,31,11,43,91,48,48,8,40,93,195,92,1,18,SPA
e42d61c7,21,15,9,6,6,11,25,14,9,1,8,10,31,19,1,18,SPA
e4b8c5b6,36,28,24,12,0,11,20,9,18,11,7,24,60,84,0,18,SPA
e4ed2628,83,52,41,33,9,36,49,13,27,7,20,35,118,34,0,18,SPA
e54bd0a2,71,49,27,38,6,20,40,20,28,10,18,43,114,37,0,18,SPA
e5cd9da6,39,21,24,14,1,10,18,8,18,7,11,15,54,65,1,18,SPA
e6bc67d7,38,26,18,15,5,16,51,35,22,0,22,16,54,10,0,18,SPA
e7375367,6,5,4,2,0,5,11,6,7,4,3,8,14,15,0,18,SPA
e7ab4179,25,14,21,4,0,14,20,6,10,8,2,17,42,71,2,18,SPA
e7f4603c,39,18,15,18,6,13,39,26,31,2,29,30,69,15,0,18,SPA
e897d8ba,14,8,1,7,6,2,11,9,15,1,14,10,24,14,0,18,SPA
e9a12436,23,17,13,8,2,11,20,9,8,1,7,19,42,26,0,18,SPA
ea6a7ab4,25,21,9,12,4,9,45,36,21,1,20,17,42,10,0,18,SPA
eb2fe5b6,16,9,2,8,6,2,23,21,16,2,14,3,19,4,1,18,SPA
eb5bc3eb,50,27,31,17,2,19,29,10,17,5,12,24,74,55,0,18,SPA
ec3efd7f,12,10,7,4,1,4,14,10,5,0,5,4,16,6,0,18,SPA
ec699fdd,16,14,11,5,0,10,15,5,7,5,2,12,28,53,1,18,SPA
ecada4fc,2,1,2,0,0,1,1,0,0,0,0,3,5,10,2,18,SPA
ecd8c01e,8,5,5,2,1,4,6,2,0,0,0,2,10,0,0,18,SPA
ed239245,39,26,23,13,3,24,41,17,26,9,17,36,75,68,0,18,SPA
ed79b7d3,1,1,0,1,0,0,1,1,5,0,5,0,1,2,0,18,SPA
ee8508c0,0,0,0,0,0,0,0,0,0,0,0,2,2,7,0,18,SPA
ef322658,41,27,17,18,6,15,55,40,27,5,22,22,63,29,1,18,SPA
ef345601,31,24,13,14,4,12,36,24,8,0,8,23,54,5,0,18,SPA
efa708aa,36,25,10,22,4,3,28,25,21,0,21,11,47,2,0,18,SPA
f03f284b,67,49,47,19,1,27,54,27,43,26,17,67,134,161,0,18,SPA
f0a31c00,21,15,8,12,1,14,31,17,10,2,8,15,36,11,0,18,SPA
f0da930c,38,27,29,6,3,23,35,12,28,15,13,30,68,101,1,18,SPA
f11fe861,25,18,18,7,0,13,26,13,11,3,8,31,56,107,0,18,SPA
f1bed920,44,32,18,20,6,19,34,15,22,6,16,27,71,39,0,18,SPA
f3112790,36,21,25,8,3,21,38,17,17,9,8,47,83,64,0,18,SPA
f3b1d9a2,78,53,32,28,18,24,89,65,36,3,33,33,111,20,0,18,SPA
f519b556,2,2,0,2,0,0,5,5,2,0,2,1,3,11,0,18,SPA
f573a8bf,9,7,4,4,1,3,8,5,2,0,2,5,14,0,0,18,SPA
f6798fc3,1,1,1,0,0,0,2,2,0,0,0,4,5,14,0,18,SPA
f69d934e,27,16,16,9,2,11,16,5,5,1,4,14,41,13,0,18,SPA
f69e9eee,1,0,1,0,0,1,3,2,0,0,0,1,2,2,3,18,SPA
f6ac68c1,30,20,23,7,0,16,39,23,38,23,15,45,75,150,1,18,SPA
f7dc2ae5,32,20,20,9,3,19,30,11,20,7,13,45,77,84,0,18,SPA
f8eca1b6,15,11,2,6,7,1,22,21,23,4,19,6,21,16,0,18,SPA
fa6561bf,1,1,1,0,0,1,1,0,0,0,0,0,1,2,0,18,SPA
fa937f7a,71,53,25,37,9,22,63,41,23,1,22,12,83,17,3,18,SPA
faec2ec4,75,47,36,36,3,29,67,38,20,7,13,26,101,48,0,18,SPA
fb5d47b3,110,66,63,37,10,58,87,29,58,11,47,58,168,114,0,18,SPA
fbd6378b,54,35,27,25,2,19,34,15,39,24,15,71,125,133,3,18,SPA
fc4f85b1,50,33,37,11,2,26,47,21,33,20,13,59,109,145,1,18,SPA
fc8cb238,1,0,1,0,0,1,1,0,1,0,1,1,2,6,0,18,SPA
fd47b4f2,32,18,26,6,0,19,34,15,45,36,9,50,82,183,0,18,SPA
fd51b456,48,33,16,21,11,12,42,30,28,2,26,7,55,9,0,18,SPA
fd9c4805,18,12,8,6,4,9,33,24,12,1,11,12,30,7,1,18,SPA
fe05804b,21,14,16,5,0,13,27,14,21,10,11,39,60,124,0,18,SPA
fed17f5a,51,32,21,21,9,22,53,31,25,1,24,5,56,19,0,18,SPA
ffad706e,47,35,31,12,4,18,35,17,7,2,5,18,65,48,0,18,SPA
00672021,3,2,1,1,1,2,2,0,0,0,0,1,4,1,0,18,CL
008a6e6d,1,1,0,1,0,0,1,1,6,6,0,4,5,18,0,18,CL
01b8a2b2,0,0,0,0,0,0,0,0,0,0,0,0,0,0,0,18,CL
01eb744d,2,0,1,0,1,0,6,6,3,0,3,3,5,2,0,18,CL
02c15616,0,0,0,0,0,0,1,1,0,0,0,1,1,0,0,18,CL
02ce2030,2,2,2,0,0,1,2,1,6,6,0,10,12,25,0,18,CL
042d286e,0,0,0,0,0,0,3,3,0,0,0,1,1,2,0,18,CL
042e8a49,6,4,1,4,1,0,2,2,4,0,4,1,7,0,0,18,CL
0442183b,1,1,1,0,0,0,0,0,0,0,0,0,1,1,0,18,CL
048a1cbc,1,0,1,0,0,0,2,2,3,0,3,4,5,2,0,18,CL
04965583,5,4,2,2,1,2,5,3,0,0,0,5,10,1,0,18,CL
04ac8285,0,0,0,0,0,0,0,0,0,0,0,0,0,1,0,18,CL
04f2ed4d,5,2,1,4,0,2,5,3,5,3,2,11,16,15,0,18,CL
05439de2,7,5,3,2,2,2,5,3,5,2,3,7,14,9,2,18,CL
0562b7f1,0,0,0,0,0,0,2,2,1,0,1,0,0,1,0,18,CL
05a84d52,5,3,2,2,1,2,3,1,1,0,1,5,10,3,0,18,CL
05d548d8,18,12,14,4,0,6,13,7,7,2,5,10,28,27,0,18,CL
061e8e23,4,2,0,1,3,0,0,0,2,0,2,0,4,1,0,18,CL
07802f7f,3,2,0,2,1,1,1,0,3,0,3,1,4,0,0,18,CL
08511d65,19,14,15,4,0,6,19,13,20,13,7,18,37,49,1,18,CL
089550f5,2,2,2,0,0,1,3,2,2,1,1,2,4,3,0,18,CL
08a2c314,0,0,0,0,0,0,0,0,0,0,0,0,0,1,1,18,CL
08aa17d0,7,4,2,4,1,3,4,1,6,0,6,6,13,19,0,18,CL
09586899,5,4,2,2,1,1,7,6,4,0,4,1,6,1,0,18,CL
0a215326,1,1,0,0,1,0,1,1,1,0,1,0,1,0,0,18,CL
0aa874f4,15,12,9,6,0,6,17,11,8,2,6,7,22,8,0,18,CL
0ab1f153,17,10,7,7,3,6,13,7,2,0,2,5,22,5,1,18,CL
0b5a292a,1,1,0,0,1,0,1,1,0,0,0,1,2,1,0,18,CL
0be28faf,13,3,6,7,0,3,15,12,8,2,6,12,25,9,0,18,CL
0d267745,17,14,11,5,1,7,13,6,5,3,2,18,35,39,1,18,CL
0d82903c,30,18,18,6,6,6,15,9,9,3,6,8,38,14,1,18,CL
0d863fdc,7,6,5,2,0,1,2,1,13,12,1,16,23,19,1,18,CL
0e34de55,4,3,0,4,0,1,4,3,4,1,3,5,9,1,0,18,CL
0e7ccfc4,2,2,0,1,1,2,3,1,0,0,0,2,4,2,0,18,CL
0ef05b3e,0,0,0,0,0,0,0,0,1,0,1,1,1,0,0,18,CL
0ef89a37,3,0,1,2,0,1,3,2,3,1,2,4,7,2,0,18,CL
0f8bd0a6,4,2,1,2,1,3,6,3,3,1,2,6,10,11,0,18,CL
0ff9eabc,9,6,4,5,0,1,6,5,10,0,10,3,12,4,0,18,CL
10072610,0,0,0,0,0,0,0,0,0,0,0,1,1,0,0,18,CL
101da2b5,17,10,8,8,1,10,30,20,9,1,8,14,31,19,1,18,CL
10d8eff2,2,2,2,0,0,2,3,1,1,0,1,1,3,4,0,18,CL
110338ae,0,0,0,0,0,0,0,0,0,0,0,0,0,1,0,18,CL
111c3236,10,8,3,7,0,6,14,8,3,0,3,8,18,15,0,18,CL
114b510e,12,10,7,3,2,8,13,5,5,4,1,8,20,23,1,18,CL
119b9a8e,13,9,9,3,1,5,12,7,1,0,1,2,15,16,0,18,CL
11b9265b,17,11,8,6,3,9,14,5,6,0,6,9,26,27,0,18,CL
129af0db,1,1,0,1,0,0,4,4,1,0,1,1,2,6,0,18,CL
12c50af5,1,0,0,0,1,0,6,6,1,0,1,0,1,0,0,18,CL
13c44fc5,14,9,4,10,0,6,9,3,4,0,4,9,23,11,0,18,CL
1467af0d,26,14,11,11,4,14,25,11,13,4,9,14,40,5,0,18,CL
14a04bea,1,1,0,1,0,1,3,2,0,0,0,0,1,0,0,18,CL
14b8fcdf,1,1,0,0,1,0,0,0,2,1,1,0,1,4,0,18,CL
157c5e0b,3,1,2,1,0,1,3,2,1,0,1,2,5,1,0,18,CL
15b6e8d7,7,2,4,3,0,4,19,15,2,0,2,21,28,14,0,18,CL
16b9d5cf,0,0,0,0,0,0,1,1,0,0,0,2,2,4,0,18,CL
16ceb862,0,0,0,0,0,0,1,1,0,0,0,0,0,1,0,18,CL
17370b95,4,1,2,1,1,2,4,2,3,0,3,0,4,3,0,18,CL
1840e36d,0,0,0,0,0,0,0,0,0,0,0,2,2,0,1,18,CL
1880614f,4,2,1,3,0,2,9,7,1,0,1,2,6,2,0,18,CL
18b896d6,7,7,3,4,0,3,8,5,1,0,1,6,13,11,1,18,CL
1932f8f4,1,1,1,0,0,0,2,2,1,0,1,1,2,0,0,18,CL
1961b2aa,8,7,1,6,1,3,6,3,0,0,0,2,10,2,0,18,CL
19cda00b,1,1,1,0,0,1,2,1,1,0,1,0,1,0,0,18,CL
1a2935f6,16,12,13,3,0,9,10,1,11,6,5,17,33,68,2,18,CL
1a992676,6,4,2,2,2,1,7,6,2,1,1,6,12,2,0,18,CL
1b7ec703,0,0,0,0,0,0,0,0,0,0,0,0,0,1,0,18,CL
1b84dbe1,8,4,3,2,3,2,3,1,3,0,3,6,14,7,0,18,CL
1bebde9d,0,0,0,0,0,0,0,0,0,0,0,0,0,0,0,18,CL
1bf33a9a,6,5,1,2,3,1,5,4,3,0,3,2,8,0,0,18,CL
1c8dc17d,0,0,0,0,0,0,1,1,0,0,0,2,2,0,0,18,CL
1cb49278,5,3,4,1,0,3,6,3,4,1,3,8,13,22,1,18,CL
1ddbb0da,0,0,0,0,0,0,0,0,0,0,0,0,0,0,0,18,CL
1e26e376,0,0,0,0,0,0,0,0,0,0,0,0,0,0,0,18,CL
1f9328da,18,11,3,11,4,6,16,10,10,0,10,4,22,4,2,18,CL
1f9a3a04,4,3,3,1,0,3,4,1,4,3,1,1,5,7,0,18,CL
1fbbfbde,12,9,10,2,0,6,12,6,10,7,3,14,26,19,0,18,CL
20030c06,10,8,4,5,1,5,11,6,10,2,8,7,17,30,0,18,CL
21512407,4,2,1,3,0,2,4,2,4,0,4,2,6,12,0,18,CL
21a66f6a,2,2,0,2,0,1,5,4,4,2,2,2,4,8,0,18,CL
22a94b80,0,0,0,0,0,0,0,0,0,0,0,0,0,1,0,18,CL
22ca11f1,0,0,0,0,0,0,0,0,0,0,0,0,0,0,0,18,CL
230255f5,0,0,0,0,0,0,0,0,0,0,0,0,0,0,0,18,CL
2327c29e,0,0,0,0,0,0,2,2,0,0,0,0,0,0,0,18,CL
2334478a,7,4,3,3,1,4,7,3,2,1,1,0,7,4,0,18,CL
23593121,1,1,0,1,0,0,2,2,1,0,1,0,1,0,0,18,CL
244a1281,8,4,4,4,0,3,9,6,7,1,6,24,32,23,0,18,CL
2513a588,2,2,0,0,2,1,1,0,0,0,0,1,3,0,0,18,CL
2557c196,8,6,2,3,3,1,4,3,5,1,4,1,9,16,0,18,CL
2649ff32,1,0,0,1,0,0,1,1,1,0,1,0,1,1,0,18,CL
273c483b,2,1,1,1,0,0,5,5,2,0,2,1,3,4,0,18,CL
27b89843,3,2,2,1,0,1,3,2,5,0,5,2,5,4,0,18,CL
27c8e860,1,0,1,0,0,0,2,2,5,5,0,7,8,21,0,18,CL
27ff9bdb,6,6,1,5,0,4,6,2,4,0,4,3,9,0,0,18,CL
28b1f3ce,0,0,0,0,0,0,2,2,0,0,0,1,1,0,0,18,CL
292a652a,0,0,0,0,0,0,0,0,1,1,0,2,2,1,0,18,CL
294450ba,1,1,1,0,0,1,2,1,1,1,0,0,1,3,0,18,CL
2946f9a1,22,15,14,7,1,8,18,10,4,2,2,13,35,18,0,18,CL
29733c72,7,5,3,4,0,1,8,7,4,0,4,6,13,0,1,18,CL
2973d8ff,0,0,0,0,0,0,1,1,0,0,0,0,0,2,0,18,CL
2a70dcc9,1,0,1,0,0,1,5,4,1,0,1,0,1,1,0,18,CL
2acd49b9,9,6,5,3,1,5,9,4,1,0,1,4,13,8,0,18,CL
2b114be3,7,6,0,4,3,1,4,3,12,0,12,3,10,1,1,18,CL
2b1c4abd,1,0,0,1,0,0,1,1,0,0,0,0,1,0,0,18,CL
2b622f01,0,0,0,0,0,0,0,0,0,0,0,0,0,0,0,18,CL
2baec6ce,1,1,0,0,1,0,0,0,0,0,0,1,2,0,0,18,CL
2bea06e0,0,0,0,0,0,0,0,0,0,0,0,0,0,1,0,18,CL
2c0f8e9e,4,3,0,4,0,0,6,6,2,0,2,2,6,0,0,18,CL
2c6e72bf,2,1,2,0,0,1,4,3,4,0,4,4,6,0,1,18,CL
2db2fd7b,3,3,2,1,0,2,5,3,8,4,4,9,12,22,1,18,CL
2e4f5f03,11,4,9,2,0,6,16,10,8,4,4,5,16,28,0,18,CL
2e85c59c,0,0,0,0,0,0,0,0,0,0,0,0,0,0,0,18,CL
2f061b36,0,0,0,0,0,0,0,0,0,0,0,0,0,0,0,18,CL
2f3452eb,14,10,9,4,1,5,12,7,3,1,2,14,28,15,0,18,CL
2f557579,1,1,0,1,0,0,7,7,3,0,3,7,8,0,0,18,CL
2f7acede,6,4,2,3,1,3,9,6,5,1,4,7,13,5,0,18,CL
2f7af524,9,7,6,3,0,4,7,3,0,0,0,4,13,9,0,18,CL
2f90f6b8,25,14,12,9,4,7,32,25,18,6,12,11,36,11,0,18,CL
2f965a72,0,0,0,0,0,0,0,0,0,0,0,0,0,5,0,18,CL
31c69ef1,4,3,3,1,0,1,2,1,2,2,0,1,5,13,0,18,CL
31d7f557,8,5,3,5,0,2,7,5,0,0,0,2,10,4,0,18,CL
321f83a2,4,3,1,3,0,2,5,3,6,0,6,1,5,1,0,18,CL
32c0491f,8,5,3,5,0,2,3,1,16,3,13,8,16,12,0,18,CL
32e73151,4,2,2,2,0,2,8,6,4,0,4,5,9,0,0,18,CL
32e7ce92,0,0,0,0,0,0,0,0,0,0,0,0,0,7,3,18,CL
33508c78,19,12,10,3,6,6,22,16,11,1,10,14,33,4,0,18,CL
335fa267,15,12,5,5,5,5,13,8,8,1,7,4,19,4,0,18,CL
341a40ef,3,0,2,1,0,0,1,1,2,0,2,4,7,5,0,18,CL
34269bdf,6,4,3,3,0,1,4,3,5,3,2,6,12,10,1,18,CL
346d51d9,13,9,6,6,1,3,10,7,2,0,2,6,19,7,0,18,CL
34c3b935,1,0,1,0,0,1,2,1,0,0,0,1,2,4,1,18,CL
34c3ec17,7,5,3,3,1,2,15,13,7,0,7,12,19,9,1,18,CL
352cabbc,0,0,0,0,0,0,0,0,0,0,0,0,0,1,0,18,CL
36b76751,0,0,0,0,0,0,1,1,1,0,1,4,4,0,0,18,CL
3708e9fa,13,9,5,6,2,5,23,18,5,1,4,10,23,2,0,18,CL
38ac43d3,11,7,6,4,1,6,16,10,6,2,4,4,15,11,0,18,CL
38c7feef,7,4,4,3,0,2,8,6,7,2,5,3,10,5,0,18,CL
39583cfd,0,0,0,0,0,0,5,5,0,0,0,2,2,0,0,18,CL
3b15ef2d,4,4,2,2,0,1,4,3,4,0,4,21,25,35,0,18,CL
3b8674e6,6,5,1,3,2,3,12,9,5,1,4,9,15,6,0,18,CL
3bb7b8b4,0,0,0,0,0,0,3,3,0,0,0,1,1,5,0,18,CL
3bb7f478,6,5,0,3,3,0,4,4,2,0,2,0,6,9,1,18,CL
3c1b7c60,10,5,3,5,2,7,18,11,6,1,5,7,17,0,0,18,CL
3c6089ab,10,8,4,5,1,4,8,4,8,0,8,4,14,5,0,18,CL
3ca7254a,7,4,6,1,0,2,9,7,0,0,0,9,16,1,0,18,CL
3e587547,7,3,4,3,0,2,4,2,2,1,1,13,20,14,0,18,CL
3e6b69c2,20,13,12,8,0,4,19,15,7,3,4,6,26,8,0,18,CL
3e975352,0,0,0,0,0,0,3,3,0,0,0,0,0,0,0,18,CL
3e99c613,0,0,0,0,0,0,0,0,0,0,0,1,1,0,0,18,CL
3eb22ec9,10,3,3,3,4,3,17,14,6,1,5,5,15,2,0,18,CL
3eed9821,12,7,10,2,0,5,7,2,9,7,2,20,32,21,1,18,CL
3ef0fa48,8,5,2,5,1,1,5,4,3,0,3,4,12,5,0,18,CL
3f0cc58f,4,2,0,3,1,0,3,3,1,1,0,2,6,3,0,18,CL
3f10bd22,3,1,2,1,0,0,2,2,2,0,2,8,11,16,0,18,CL
3f359b33,0,0,0,0,0,0,0,0,2,2,0,0,0,3,0,18,CL
3f944dad,8,4,2,6,0,1,4,3,3,0,3,5,13,3,0,18,CL
407feb71,0,0,0,0,0,0,0,0,0,0,0,0,0,0,0,18,CL
41e7ef1c,9,4,5,1,3,2,6,4,8,1,7,5,14,14,0,18,CL
42276181,0,0,0,0,0,0,3,3,2,1,1,2,2,0,0,18,CL
42a632ba,7,5,6,1,0,2,2,0,5,1,4,6,13,15,0,18,CL
42ec696a,0,0,0,0,0,0,0,0,0,0,0,1,1,4,1,18,CL
42fd9c7f,2,2,1,1,0,0,1,1,5,0,5,4,6,1,0,18,CL
433dc9a2,1,0,1,0,0,1,1,0,0,0,0,0,1,2,0,18,CL
436a9dd0,13,10,6,7,0,1,12,11,8,1,7,12,25,7,0,18,CL
44781702,8,6,4,3,1,4,10,6,8,1,7,6,14,23,0,18,CL
44c3d1d2,0,0,0,0,0,0,4,4,2,0,2,2,2,6,0,18,CL
45af8a54,4,3,2,1,1,0,4,4,2,1,1,3,7,5,0,18,CL
45b9b619,13,7,2,8,3,2,13,11,4,0,4,7,20,3,0,18,CL
45db685d,7,3,3,3,1,2,8,6,6,2,4,3,10,0,0,18,CL
4601e194,12,6,7,4,1,5,13,8,9,3,6,10,22,15,0,18,CL
460976a2,6,5,1,4,1,1,8,7,2,0,2,1,7,5,0,18,CL
467bae22,10,6,3,5,2,4,15,11,4,0,4,1,11,5,0,18,CL
46907171,1,1,0,1,0,1,3,2,0,0,0,2,3,0,0,18,CL
46a8347f,1,1,1,0,0,0,0,0,1,1,0,2,3,3,0,18,CL
47fd5136,9,7,7,2,0,5,7,2,6,4,2,13,22,25,0,18,CL
489a73e9,0,0,0,0,0,0,0,0,0,0,0,0,0,0,0,18,CL
49296448,12,10,5,3,4,6,15,9,6,1,5,11,23,14,0,18,CL
49312f11,5,2,2,2,1,1,2,1,4,2,2,4,9,13,0,18,CL
4958bfb2,23,15,11,7,5,9,14,5,13,5,8,17,40,14,0,18,CL
49fe9070,4,3,2,2,0,2,6,4,2,1,1,1,5,0,0,18,CL
4a5a45c7,5,3,1,4,0,1,3,2,4,1,3,4,9,2,0,18,CL
4bd414c1,8,5,7,1,0,5,6,1,6,5,1,6,14,16,1,18,CL
4c370d81,23,17,3,15,5,0,20,20,11,1,10,3,26,5,0,18,CL
4c45cdc2,3,0,2,0,1,1,12,11,7,0,7,1,4,5,0,18,CL
4c5b714f,6,4,3,3,0,1,4,3,3,1,2,5,11,6,0,18,CL
4cde5509,0,0,0,0,0,0,0,0,0,0,0,0,0,0,0,18,CL
4d034881,3,2,1,1,1,0,3,3,4,0,4,3,6,0,0,18,CL
4d1cea6a,10,6,7,3,0,4,13,9,1,0,1,6,16,13,2,18,CL
4d224fe8,45,29,25,14,6,21,45,24,31,11,20,23,68,25,1,18,CL
4d425e6e,13,11,4,8,1,3,8,5,8,1,7,9,22,12,0,18,CL
4d982baf,0,0,0,0,0,0,0,0,0,0,0,1,1,0,0,18,CL
4dbd0916,2,1,1,0,1,0,2,2,3,0,3,2,4,0,0,18,CL
4e18cf1c,1,1,0,1,0,0,0,0,0,0,0,1,2,0,1,18,CL
4e358a2d,21,11,13,8,0,10,18,8,17,12,5,21,42,45,1,18,CL
4f28a6ff,16,12,14,2,0,5,7,2,12,7,5,17,33,32,0,18,CL
4f56170e,3,3,3,0,0,2,3,1,3,0,3,12,15,13,0,18,CL
4f5a953e,5,5,4,1,0,3,5,2,4,2,2,8,13,13,0,18,CL
4fa7cb9b,6,1,3,3,0,1,14,13,7,0,7,8,14,3,0,18,CL
4fdf1fd9,4,2,2,2,0,2,5,3,7,6,1,4,8,30,1,18,CL
50310821,0,0,0,0,0,0,0,0,0,0,0,0,0,0,0,18,CL
5070881b,2,2,0,2,0,1,3,2,1,1,0,1,3,1,0,18,CL
507c7bdf,15,7,6,7,2,5,16,11,6,1,5,4,19,1,1,18,CL
509a4ccb,0,0,0,0,0,0,2,2,0,0,0,1,1,0,0,18,CL
518918ad,10,8,7,2,1,0,7,7,6,1,5,4,14,3,0,18,CL
51a3c4c8,11,6,10,1,0,3,10,7,12,8,4,22,33,39,0,18,CL
51cf8561,1,1,0,1,0,1,5,4,0,0,0,1,2,1,1,18,CL
520c318f,0,0,0,0,0,0,1,1,0,0,0,0,0,2,0,18,CL
523057ea,18,13,11,7,0,9,19,10,8,4,4,22,40,42,0,18,CL
5271c8f1,0,0,0,0,0,0,2,2,0,0,0,0,0,0,0,18,CL
527f063d,1,1,0,1,0,0,5,5,1,1,0,5,6,6,0,18,CL
529f49ab,9,6,6,3,0,4,15,11,6,3,3,6,15,6,1,18,CL
532d2690,14,10,8,6,0,7,22,15,13,3,10,14,28,13,0,18,CL
53cad200,13,8,4,7,2,8,14,6,10,6,4,17,30,14,0,18,CL
53fc526b,0,0,0,0,0,0,1,1,0,0,0,0,0,0,0,18,CL
54c9ed15,14,9,9,4,1,8,13,5,8,3,5,14,28,28,0,18,CL
55126f3b,6,4,5,0,1,2,9,7,6,0,6,2,8,0,0,18,CL
56208b05,3,2,0,3,0,2,4,2,1,1,0,1,4,6,0,18,CL
563a68ad,6,3,5,1,0,2,8,6,4,3,1,6,12,21,0,18,CL
56b5d64e,13,9,5,7,1,5,8,3,9,0,9,5,18,1,0,18,CL
56bf1cc0,0,0,0,0,0,0,0,0,0,0,0,1,1,3,1,18,CL
56f7a928,9,4,1,8,0,3,7,4,5,0,5,4,13,3,0,18,CL
57ef0d97,7,6,4,3,0,3,11,8,8,1,7,2,9,6,1,18,CL
58a9a4d9,6,4,3,1,2,1,6,5,3,0,3,0,6,4,0,18,CL
58bc7d18,0,0,0,0,0,0,0,0,0,0,0,0,0,1,0,18,CL
5984e9f9,3,2,2,1,0,0,0,0,5,3,2,3,6,18,0,18,CL
59bf127b,12,11,3,6,3,2,6,4,3,0,3,7,19,2,0,18,CL
59d93937,9,7,6,2,1,4,12,8,2,0,2,1,10,2,0,18,CL
5a2cb25d,12,12,7,4,1,1,9,8,9,0,9,9,21,4,1,18,CL
5a7301ae,9,2,4,5,0,5,14,9,4,1,3,15,24,4,2,18,CL
5ab0ea87,23,17,7,14,2,10,28,18,13,4,9,5,28,8,0,18,CL
5af687a1,4,3,0,4,0,1,3,2,5,0,5,3,7,0,1,18,CL
5afafbfe,3,2,0,1,2,0,3,3,3,0,3,3,6,1,0,18,CL
5b887c7a,6,4,4,1,1,3,4,1,5,3,2,6,12,21,0,18,CL
5c2b4f07,8,7,6,1,1,4,12,8,3,1,2,17,25,13,0,18,CL
5c4f4e43,5,4,3,2,0,2,18,16,7,0,7,5,10,5,0,18,CL
5caa62a7,3,2,0,3,0,2,3,1,0,0,0,2,5,0,0,18,CL
5cec2c74,0,0,0,0,0,0,1,1,1,0,1,0,0,0,0,18,CL
5cef5a64,0,0,0,0,0,0,2,2,0,0,0,0,0,0,0,18,CL
5d4f7d61,3,3,0,3,0,1,4,3,4,0,4,0,3,0,0,18,CL
5d91cf0f,2,1,1,1,0,2,4,2,1,0,1,0,2,2,0,18,CL
5e082d51,3,2,0,2,1,1,10,9,5,1,4,3,6,4,1,18,CL
5e1028e5,2,2,2,0,0,0,1,1,3,0,3,0,2,1,0,18,CL
5eae500a,6,2,1,2,3,1,3,2,0,0,0,0,6,4,0,18,CL
5eecec3d,3,2,2,1,0,2,4,2,8,6,2,6,9,25,0,18,CL
5f0241b2,0,0,0,0,0,0,0,0,0,0,0,0,0,2,0,18,CL
5f424f35,9,7,4,3,2,3,4,1,4,0,4,8,17,3,0,18,CL
5f956fcf,1,1,0,0,1,0,2,2,4,0,4,3,4,3,0,18,CL
6025fab1,15,8,5,8,2,5,18,13,9,2,7,14,29,4,0,18,CL
603116a7,17,9,6,9,2,9,26,17,13,2,11,15,32,11,0,18,CL
60a93897,6,3,5,1,0,2,5,3,1,1,0,8,14,17,0,18,CL
61b0b44d,2,2,1,1,0,1,1,0,0,0,0,0,2,2,0,18,CL
62ba5881,0,0,0,0,0,0,0,0,0,0,0,0,0,0,1,18,CL
632e0184,2,2,1,1,0,2,2,0,0,0,0,0,2,0,0,18,CL
635f2732,13,8,4,7,2,0,5,5,11,0,11,5,18,1,0,18,CL
63b0ca6b,0,0,0,0,0,0,2,2,2,0,2,0,0,3,0,18,CL
63c3659d,4,2,4,0,0,2,2,0,3,3,0,3,7,19,0,18,CL
6438d426,4,1,3,0,1,0,4,4,4,0,4,7,11,3,0,18,CL
64bac8b2,5,3,2,3,0,0,6,6,4,0,4,1,6,4,0,18,CL
64e8ed6d,1,1,0,1,0,1,2,1,0,0,0,0,1,2,0,18,CL
652d4c37,9,4,2,7,0,3,9,6,8,2,6,3,12,4,1,18,CL
6554bb97,15,12,5,8,2,3,9,6,2,1,1,3,18,4,3,18,CL
65553d96,0,0,0,0,0,0,0,0,2,0,2,0,0,0,0,18,CL
65585e3a,7,4,4,3,0,3,5,2,4,0,4,2,9,2,0,18,CL
65d750b5,7,2,2,3,2,4,13,9,5,1,4,2,9,4,0,18,CL
66116290,5,4,3,1,1,1,1,0,3,2,1,2,7,4,0,18,CL
67b3d74b,6,4,2,2,2,5,5,0,2,1,1,4,10,3,0,18,CL
67cdbc0e,20,14,9,7,4,8,17,9,8,2,6,10,30,4,0,18,CL
6800f515,6,3,0,4,2,1,3,2,6,0,6,6,12,2,0,18,CL
68829001,6,3,1,3,2,0,1,1,0,0,0,2,8,0,0,18,CL
68dc0dac,3,2,2,1,0,0,15,15,14,5,9,7,10,6,0,18,CL
691bef82,13,8,8,3,2,3,11,8,8,1,7,13,26,23,0,18,CL
69384e5d,11,6,2,6,3,2,8,6,7,0,7,1,12,0,0,18,CL
6b6c793c,2,1,2,0,0,0,0,0,1,1,0,1,3,3,0,18,CL
6b6d252d,8,4,2,6,0,1,5,4,4,0,4,3,11,1,0,18,CL
6b85f966,0,0,0,0,0,0,1,1,1,0,1,3,3,0,0,18,CL
6c7762c3,2,0,2,0,0,0,0,0,2,1,1,1,3,2,0,18,CL
6ce1f46f,19,12,7,9,3,5,18,13,10,0,10,7,26,0,0,18,CL
6d3f2898,9,4,2,5,2,5,9,4,6,3,3,8,17,7,0,18,CL
6d4d9e18,1,1,0,1,0,1,1,0,2,0,2,0,1,2,0,18,CL
6db16dda,0,0,0,0,0,0,0,0,0,0,0,0,0,0,0,18,CL
6e592fa4,4,2,3,1,0,1,5,4,2,0,2,5,9,6,0,18,CL
6f1721f0,1,1,0,1,0,0,3,3,0,0,0,0,1,1,0,18,CL
6f51e382,0,0,0,0,0,0,0,0,0,0,0,0,0,1,1,18,CL
70cf63ca,0,0,0,0,0,0,0,0,0,0,0,0,0,0,0,18,CL
70d31829,2,0,2,0,0,1,1,0,2,0,2,2,4,2,0,18,CL
70d74ece,5,5,0,4,1,1,5,4,1,0,1,1,6,8,0,18,CL
713c144a,10,6,3,6,1,1,6,5,8,0,8,4,14,1,0,18,CL
715bf047,18,12,4,7,7,8,24,16,11,0,11,9,27,0,0,18,CL
715e5b0e,2,2,0,2,0,0,1,1,0,0,0,0,2,0,0,18,CL
7214c684,0,0,0,0,0,0,0,0,0,0,0,0,0,0,0,18,CL
7272a72a,6,4,1,1,4,0,9,9,12,1,11,4,10,3,0,18,CL
72d0e1b6,2,2,0,2,0,0,0,0,0,0,0,1,3,0,0,18,CL
732b0cf9,1,1,0,1,0,1,1,0,2,0,2,0,1,0,0,18,CL
733fecf1,0,0,0,0,0,0,0,0,0,0,0,0,0,1,0,18,CL
75a72a99,18,13,13,4,1,8,16,8,11,2,9,12,30,12,0,18,CL
769b907d,6,5,4,2,0,3,4,1,0,0,0,1,7,0,0,18,CL
76c131da,0,0,0,0,0,0,1,1,0,0,0,0,0,0,0,18,CL
77e84962,26,19,7,16,3,8,19,11,12,1,11,14,40,2,0,18,CL
78150923,5,2,1,4,0,2,4,2,4,0,4,1,6,1,0,18,CL
78841da9,6,3,2,3,1,2,14,12,7,1,6,4,10,4,0,18,CL
78c40e94,0,0,0,0,0,0,2,2,1,1,0,2,2,0,0,18,CL
79019bf4,2,2,2,0,0,0,4,4,1,0,1,1,3,5,0,18,CL
79083382,15,8,9,6,0,7,14,7,13,11,2,4,19,31,0,18,CL
7914b9fe,5,4,5,0,0,1,3,2,4,2,2,6,11,15,0,18,CL
79584585,0,0,0,0,0,0,0,0,0,0,0,1,1,0,0,18,CL
79b0d6a0,0,0,0,0,0,0,0,0,0,0,0,2,2,4,1,18,CL
79c0821a,7,4,3,4,0,3,7,4,2,0,2,5,12,3,0,18,CL
7a11550b,10,7,6,4,0,2,8,6,10,1,9,12,22,14,0,18,CL
7a20d90a,9,6,5,4,0,0,3,3,5,4,1,9,18,42,1,18,CL
7a2e46a8,1,1,1,0,0,0,1,1,0,0,0,1,2,7,1,18,CL
7a69c649,12,9,10,2,0,7,16,9,8,0,8,13,25,21,1,18,CL
7b456af7,0,0,0,0,0,0,0,0,0,0,0,0,0,6,0,18,CL
7ba6d84e,0,0,0,0,0,0,0,0,0,0,0,0,0,0,0,18,CL
7be09c86,13,10,6,6,1,3,7,4,1,0,1,2,15,4,0,18,CL
7c0000fd,13,8,12,1,0,7,11,4,2,1,1,13,26,21,0,18,CL
7c1a0c67,14,10,3,9,2,5,11,6,3,1,2,7,21,27,0,18,CL
7c2965bb,5,4,0,5,0,1,5,4,7,0,7,3,8,1,0,18,CL
7c473e12,6,6,6,0,0,1,4,3,8,4,4,12,18,37,1,18,CL
7cab69b5,6,5,5,1,0,0,6,6,7,3,4,13,19,31,2,18,CL
7d3e7da6,0,0,0,0,0,0,0,0,0,0,0,0,0,3,1,18,CL
7e56d3db,5,5,3,2,0,2,2,0,2,1,1,6,11,5,0,18,CL
7e81a17d,3,3,0,2,1,0,6,6,4,1,3,0,3,0,0,18,CL
7ebfac0f,5,2,3,1,1,2,5,3,1,0,1,5,10,0,0,18,CL
7f3b388c,18,7,8,7,3,7,11,4,6,0,6,8,26,5,0,18,CL
7f5ca4f8,7,3,4,3,0,3,5,2,9,9,0,8,15,17,0,18,CL
7f6bff1f,3,2,3,0,0,3,7,4,8,7,1,5,8,24,0,18,CL
7f97771d,19,9,9,8,2,6,18,12,9,3,6,19,38,19,0,18,CL
7fe90ccd,2,2,1,0,1,1,4,3,4,0,4,3,5,10,0,18,CL
80b81359,0,0,0,0,0,0,0,0,0,0,0,0,0,0,0,18,CL
80f36c88,10,6,4,5,1,4,14,10,2,0,2,6,16,3,0,18,CL
810e3c74,9,4,4,4,1,0,2,2,1,0,1,0,9,0,0,18,CL
81442ecb,7,5,3,3,1,0,2,2,4,0,4,8,15,3,0,18,CL
819b3158,16,11,5,9,2,3,12,9,0,0,0,8,24,2,0,18,CL
821233cc,0,0,0,0,0,0,0,0,2,2,0,0,0,9,0,18,CL
82dbf623,1,0,0,0,1,1,3,2,1,0,1,0,1,5,0,18,CL
8320fe65,6,5,4,2,0,6,6,0,2,1,1,4,10,8,0,18,CL
8325870c,5,2,5,0,0,2,6,4,8,6,2,5,10,21,0,18,CL
833fb62e,1,1,0,1,0,1,2,1,2,0,2,0,1,0,0,18,CL
834b5c4c,1,0,1,0,0,1,2,1,0,0,0,0,1,1,0,18,CL
83534f30,6,4,2,4,0,2,13,11,4,1,3,6,12,3,0,18,CL
8494acc4,12,7,3,8,1,6,7,1,1,1,0,6,18,16,0,18,CL
849c826a,6,6,0,4,2,1,6,5,2,0,2,2,8,2,0,18,CL
84ad89fa,6,8,5,1,0,5,9,4,4,0,4,8,14,22,0,18,CL
852351df,10,8,7,2,1,5,9,4,5,2,3,11,21,12,0,18,CL
854ee61a,3,2,1,1,1,0,0,0,1,0,1,1,4,1,1,18,CL
85613cf0,0,0,0,0,0,0,0,0,0,0,0,0,0,0,0,18,CL
85686f86,1,0,0,0,1,1,1,0,0,0,0,0,1,0,0,18,CL
85b0c4c6,1,1,1,0,0,1,1,0,1,0,1,2,3,0,0,18,CL
862fa9fb,0,0,0,0,0,0,0,0,1,1,0,1,1,6,0,18,CL
8637e09a,1,0,1,0,0,0,0,0,0,0,0,0,1,1,0,18,CL
864db10a,12,8,6,3,3,7,11,4,5,2,3,14,26,15,0,18,CL
867239d3,8,5,1,6,1,1,3,2,1,1,0,3,11,2,0,18,CL
86c75897,14,8,9,5,0,3,7,4,5,4,1,14,28,44,0,18,CL
86dd77d1,8,5,4,3,1,4,8,4,7,2,5,11,19,19,1,18,CL
86e7deaf,5,3,4,1,0,3,4,1,8,4,4,4,9,30,0,18,CL
874d7a32,7,5,1,6,0,2,6,4,4,1,3,6,13,6,0,18,CL
87575fd9,3,3,0,3,0,0,3,3,0,0,0,2,5,6,0,18,CL
8778c910,0,0,0,0,0,0,0,0,0,0,0,0,0,0,0,18,CL
8794e251,12,10,6,6,0,2,10,8,10,1,9,12,24,18,1,18,CL
87d8b5a3,7,5,7,0,0,6,12,6,1,1,0,5,12,11,0,18,CL
881ef58c,1,0,0,0,1,0,2,2,4,0,4,2,3,0,0,18,CL
8827bf46,9,5,3,3,3,3,5,2,5,1,4,2,11,1,0,18,CL
89565ac5,5,4,3,1,1,4,5,1,3,2,1,11,16,10,0,18,CL
89ac64a6,8,5,8,0,0,4,11,7,11,5,6,13,21,32,0,18,CL
89b2c8a9,4,3,0,3,1,1,9,8,1,0,1,3,7,2,0,18,CL
89d10e53,9,7,4,5,0,5,5,0,4,1,3,3,12,4,0,18,CL
89f951b5,13,8,4,6,3,4,16,12,5,1,4,16,29,2,1,18,CL
8a08491a,10,4,0,6,4,1,6,5,5,0,5,4,14,7,1,18,CL
8a7a5ad7,13,9,11,2,0,6,16,10,7,2,5,10,23,41,1,18,CL
8b788c01,1,1,1,0,0,0,1,1,1,0,1,1,2,0,0,18,CL
8b8a56ce,12,6,7,5,0,6,9,3,11,8,3,12,24,33,0,18,CL
8b8e759d,0,0,0,0,0,0,0,0,0,0,0,0,0,0,0,18,CL
8b9ebd03,5,3,2,2,1,1,5,4,5,0,5,1,6,0,0,18,CL
8ce30c57,14,9,11,3,0,5,12,7,9,4,5,12,26,33,0,18,CL
8d78e732,7,6,0,2,5,0,12,12,7,1,6,2,9,3,0,18,CL
8e92be30,0,0,0,0,0,0,0,0,0,0,0,0,0,0,0,18,CL
8f62b6ee,0,0,0,0,0,0,0,0,0,0,0,0,0,2,0,18,CL
8f898ba8,3,2,0,2,1,1,1,0,3,2,1,1,4,1,0,18,CL
8f8c6934,0,0,0,0,0,0,0,0,0,0,0,0,0,2,0,18,CL
8fd9996f,13,11,7,6,0,3,11,8,7,4,3,10,23,8,0,18,CL
8fe2101a,1,0,0,1,0,0,0,0,0,0,0,0,1,0,0,18,CL
8ff2354e,16,15,9,6,1,6,14,8,3,1,2,9,25,11,0,18,CL
90339309,8,4,7,1,0,3,3,0,4,0,4,8,16,15,0,18,CL
903b6e8b,0,0,0,0,0,0,1,1,0,0,0,0,0,4,2,18,CL
90f3beec,9,6,5,3,1,1,3,2,12,3,9,8,17,11,0,18,CL
9139bb12,9,6,3,4,2,2,15,13,7,0,7,2,11,1,0,18,CL
91976866,0,0,0,0,0,0,0,0,0,0,0,0,0,0,0,18,CL
92e7e919,7,5,3,3,1,2,11,9,4,0,4,0,7,2,0,18,CL
935e6b8f,24,14,6,16,2,7,23,16,17,5,12,16,40,12,0,18,CL
942b4f90,3,2,0,2,1,2,4,2,2,0,2,2,5,2,0,18,CL
947e036f,22,18,9,12,1,7,13,6,4,1,3,3,25,6,0,18,CL
94b2001f,12,9,5,6,1,7,10,3,7,1,6,7,19,13,0,18,CL
96094cbc,9,5,3,6,0,5,18,13,6,2,4,2,11,2,1,18,CL
962e54cb,2,1,0,2,0,0,1,1,0,0,0,0,2,0,0,18,CL
963a328b,15,11,4,11,0,4,15,11,6,0,6,4,19,1,0,18,CL
96e0490d,8,5,5,3,0,2,2,0,2,1,1,5,13,5,0,18,CL
972d595a,1,1,1,0,0,1,1,0,0,0,0,0,1,1,0,18,CL
97333cf5,6,1,0,6,0,0,9,9,2,0,2,5,11,1,0,18,CL
9744ff80,11,7,3,5,3,2,21,19,10,1,9,9,20,7,0,18,CL
97bfa797,0,0,0,0,0,0,0,0,6,0,6,1,1,0,0,18,CL
980522ec,5,3,0,3,2,1,7,6,7,2,5,4,9,2,0,18,CL
981869fc,1,1,1,0,0,0,1,1,2,0,2,4,5,3,0,18,CL
984a5a64,0,0,0,0,0,0,0,0,0,0,0,0,0,0,0,18,CL
98e0ad35,11,9,9,2,0,8,14,6,12,2,10,10,21,16,0,18,CL
99813635,2,1,1,1,0,1,8,7,7,0,7,1,3,0,0,18,CL
99b1d0e6,0,0,0,0,0,0,1,1,0,0,0,1,1,9,0,18,CL
9a104dee,2,0,0,2,0,2,10,8,4,1,3,3,5,7,0,18,CL
9a2e0ccc,5,4,0,4,1,0,4,4,5,0,5,1,6,2,0,18,CL
9bcd6455,3,2,0,3,0,1,4,3,3,0,3,0,3,2,0,18,CL
9c824717,9,6,5,3,1,4,11,7,5,2,3,10,19,6,0,18,CL
9c94165b,0,0,0,0,0,0,1,1,2,0,2,2,2,7,0,18,CL
9d12e142,0,0,0,0,0,0,1,1,0,0,0,0,0,3,2,18,CL
9d60028d,0,0,0,0,0,0,1,1,1,0,1,0,0,0,0,18,CL
9d73993b,5,2,1,3,1,1,8,7,4,0,4,1,6,4,1,18,CL
9d8586c4,15,12,5,9,1,8,13,5,2,0,2,11,26,19,2,18,CL
9d8ba8ec,12,8,11,1,0,5,9,4,10,8,2,10,22,39,2,18,CL
9efa1d25,9,6,4,4,1,2,13,11,5,0,5,2,11,1,0,18,CL
9f31b1d3,6,3,4,2,0,1,3,2,4,1,3,2,8,4,0,18,CL
9f8e9423,12,9,10,2,0,8,17,9,21,13,8,14,26,71,0,18,CL
9fb640a8,1,1,0,1,0,0,2,2,1,0,1,8,9,8,0,18,CL
Bruno-Costa,0,0,0,0,0,0,0,0,0,0,0,0,0,0,0,18,CL
a022e78c,1,1,1,0,0,0,1,1,1,0,1,1,2,0,0,18,CL
a02543c3,7,4,3,4,0,4,11,7,3,0,3,7,14,10,0,18,CL
a0b4bb3e,14,11,5,4,5,4,21,17,6,1,5,2,16,1,0,18,CL
a1232f4e,8,4,5,3,0,2,2,0,6,4,2,2,10,10,2,18,CL
a1c2666d,1,1,1,0,0,1,2,1,0,0,0,0,1,0,0,18,CL
a1d5bd30,4,2,2,2,0,1,5,4,3,0,3,1,5,0,0,18,CL
a274dccb,0,0,0,0,0,0,0,0,0,0,0,2,2,0,0,18,CL
a372a9f2,10,8,7,3,0,4,14,10,7,2,5,8,18,9,0,18,CL
a382462b,5,2,4,0,1,1,3,2,2,0,2,2,7,3,0,18,CL
a39bb753,2,2,0,1,1,0,2,2,3,0,3,1,3,2,0,18,CL
a3e1d20d,6,4,5,1,0,2,7,5,5,5,0,6,12,34,0,18,CL
a40d5a0c,17,12,8,5,4,7,26,19,9,0,9,8,25,3,0,18,CL
a45eac1f,0,0,0,0,0,0,1,1,1,0,1,1,1,1,0,18,CL
a49fd565,4,2,4,0,0,1,8,7,4,3,1,5,9,35,1,18,CL
a4aa453f,1,0,0,1,0,0,2,2,2,0,2,1,2,1,0,18,CL
a4effc55,1,1,1,0,0,0,1,1,1,1,0,1,2,4,0,18,CL
a4f642c5,3,2,0,1,2,0,3,3,0,0,0,0,3,1,0,18,CL
a5296e55,2,1,1,0,1,0,4,4,3,0,3,7,9,2,0,18,CL
a58bb1e1,2,1,0,1,1,1,1,0,3,0,3,1,3,6,0,18,CL
a6154613,4,4,1,1,2,1,10,9,5,0,5,2,6,5,0,18,CL
a65ce836,13,9,5,7,1,1,10,9,14,1,13,7,20,3,0,18,CL
a6997e06,3,3,2,1,0,2,3,1,4,2,2,3,6,11,1,18,CL
a72c139d,2,2,2,0,0,2,3,1,2,1,1,1,3,4,1,18,CL
a78ff07f,0,0,0,0,0,0,3,3,1,1,0,2,2,4,0,18,CL
a7a9d95a,1,0,1,0,0,0,0,0,2,0,2,2,3,0,0,18,CL
a8542814,19,15,5,13,1,3,19,16,9,1,8,8,27,2,0,18,CL
a8741470,2,2,1,1,0,2,2,0,2,2,0,4,6,13,0,18,CL
a8c62306,3,2,0,3,0,0,4,4,5,0,5,2,5,1,0,18,CL
a92669f6,6,3,2,4,0,4,4,0,5,3,2,6,12,8,0,18,CL
a96e5dc0,8,6,4,4,0,5,9,4,5,2,3,4,12,11,0,18,CL
a9e68c94,5,2,3,2,0,2,13,11,10,1,9,3,8,7,0,18,CL
aae44006,0,0,0,0,0,0,0,0,0,0,0,0,0,0,0,18,CL
ab4b3e35,11,8,7,4,0,5,20,15,12,0,12,14,25,5,1,18,CL
ab6928f2,6,4,5,1,0,4,9,5,3,0,3,12,18,12,0,18,CL
abe66106,2,1,0,0,2,0,3,3,1,0,1,2,4,1,0,18,CL
ac861941,14,9,6,6,2,5,10,5,8,4,4,5,19,23,1,18,CL
ad1d334f,25,19,8,15,2,10,25,15,9,0,9,18,43,6,3,18,CL
ad28ee23,0,0,0,0,0,0,0,0,1,0,1,0,0,0,0,18,CL
ad6295d4,4,2,1,3,0,1,1,0,1,0,1,2,6,6,0,18,CL
ad6df2d5,10,9,5,3,2,0,15,15,15,6,9,8,18,9,0,18,CL
ade993b9,5,4,2,3,0,1,7,6,8,0,8,7,12,4,0,18,CL
adfbe1f5,0,0,0,0,0,0,0,0,0,0,0,0,0,0,0,18,CL
adfc9123,12,9,9,3,0,5,7,2,9,7,2,6,18,38,0,18,CL
ae4e2852,7,3,5,2,0,6,7,1,4,2,2,1,8,18,1,18,CL
ae8ec371,9,4,6,2,1,4,11,7,3,0,3,3,12,4,0,18,CL
aef6e670,2,1,2,0,0,0,0,0,1,0,1,1,3,7,0,18,CL
af00baef,13,10,6,7,0,4,12,8,3,3,0,5,18,14,0,18,CL
af245161,0,0,0,0,0,0,0,0,0,0,0,0,0,6,0,18,CL
af45e954,12,7,4,7,1,3,12,9,10,0,10,4,16,7,0,18,CL
af7e69d1,8,7,6,1,1,3,6,3,2,0,2,4,12,9,0,18,CL
afa0d4e0,8,5,3,4,1,2,5,3,4,0,4,4,12,8,0,18,CL
b0616e3d,21,12,11,7,3,9,19,10,6,2,4,19,40,39,0,18,CL
b15780e3,0,0,0,0,0,0,1,1,0,0,0,1,1,1,1,18,CL
b182a240,2,0,1,0,1,2,5,3,4,0,4,2,4,0,0,18,CL
b19db005,1,1,0,1,0,0,6,6,1,0,1,2,3,1,0,18,CL
b1f4086c,7,3,4,2,1,6,13,7,5,0,5,5,12,3,0,18,CL
b20ce5eb,7,4,7,0,0,3,7,4,8,5,3,10,17,28,2,18,CL
b217ef29,4,3,3,1,0,1,6,5,2,2,0,8,12,11,0,18,CL
b2484b77,2,1,1,1,0,0,1,1,3,0,3,2,4,1,0,18,CL
b2d0ec1b,4,2,2,1,1,2,7,5,2,0,2,3,7,3,0,18,CL
b33e0095,0,0,0,0,0,0,0,0,0,0,0,0,0,0,0,18,CL
b39a793e,6,2,1,4,1,0,1,1,8,1,7,1,7,4,0,18,CL
b400bde0,4,2,1,2,1,0,3,3,8,0,8,5,9,0,0,18,CL
b561db50,2,1,0,2,0,1,1,0,10,0,10,5,7,1,0,18,CL
b6170459,11,9,5,6,0,3,18,15,9,6,3,5,16,13,0,18,CL
b66315ae,9,6,4,4,1,0,8,8,9,0,9,7,16,3,0,18,CL
b682dcf6,13,8,11,2,0,4,8,4,4,2,2,8,21,25,0,18,CL
b6964eb6,10,5,6,3,1,4,7,3,14,10,4,3,13,27,0,18,CL
b6b2b820,2,1,1,1,0,0,2,2,1,0,1,2,4,0,0,18,CL
b6e50615,6,6,4,1,1,3,3,0,2,2,0,2,8,7,0,18,CL
b742cc0d,17,10,10,4,3,8,14,6,9,2,7,11,28,16,0,18,CL
b7e7937d,0,0,0,0,0,0,0,0,0,0,0,0,0,1,0,18,CL
b825a650,6,4,0,5,1,3,7,4,5,0,5,9,15,8,0,18,CL
b853e0ad,23,16,11,10,2,8,26,18,15,3,12,9,32,6,1,18,CL
b8c1de25,9,6,5,3,1,1,8,7,4,0,4,7,16,3,2,18,CL
b9052bad,1,1,0,0,1,0,0,0,1,0,1,0,1,0,0,18,CL
b9fbae28,22,18,10,10,2,4,13,9,8,1,7,15,37,3,0,18,CL
ba23a904,14,11,9,4,1,8,12,4,1,0,1,14,28,25,0,18,CL
ba6e52b0,3,2,1,2,0,2,2,0,4,3,1,2,5,5,0,18,CL
bb7337cc,11,6,5,2,4,1,10,9,2,1,1,5,16,5,0,18,CL
bbcc9c00,0,0,0,0,0,0,1,1,0,0,0,0,0,0,0,18,CL
bbddc31f,5,2,3,2,0,1,1,0,4,1,3,9,14,3,0,18,CL
bc1f61c9,0,0,0,0,0,0,0,0,0,0,0,0,0,7,2,18,CL
bcb2ccd8,0,0,0,0,0,0,0,0,0,0,0,0,0,2,1,18,CL
bcf5058a,0,0,0,0,0,0,0,0,0,0,0,0,0,4,2,18,CL
bd4f5f94,3,0,1,2,0,2,2,0,2,0,2,3,6,3,0,18,CL
bdf7b97d,2,2,1,1,0,0,3,3,1,0,1,1,3,1,0,18,CL
bdf8165d,12,5,5,6,1,2,15,13,3,1,2,4,16,5,0,18,CL
be927d03,6,4,3,2,1,2,3,1,5,1,4,9,15,10,0,18,CL
bf075f6b,1,1,1,0,0,0,3,3,3,1,2,2,3,5,0,18,CL
bf309d24,5,2,2,2,1,1,6,5,7,1,6,7,12,3,0,18,CL
bf97c188,25,12,16,6,3,14,29,15,9,0,9,9,34,21,0,18,CL
c0617e2b,2,1,1,1,0,1,5,4,2,0,2,2,4,0,0,18,CL
c0cddebe,7,5,3,4,0,2,10,8,4,1,3,9,16,4,0,18,CL
c0e27d1a,7,5,2,4,1,1,7,6,2,0,2,7,14,5,1,18,CL
c14bc029,20,14,6,11,3,9,19,10,14,3,11,14,34,19,0,18,CL
c1b7847c,0,0,0,0,0,0,0,0,0,0,0,0,0,0,0,18,CL
c204f844,6,2,1,4,1,2,9,7,2,0,2,1,7,5,0,18,CL
c2111b45,0,0,0,0,0,0,0,0,1,1,0,0,0,3,0,18,CL
c316607a,1,1,1,0,0,1,2,1,1,0,1,1,2,1,0,18,CL
c3ee18ef,1,1,1,0,0,0,1,1,5,1,4,7,8,8,0,18,CL
c44a1d58,9,5,4,4,1,3,9,6,2,1,1,6,15,3,0,18,CL
c49afee6,0,0,0,0,0,0,1,1,0,0,0,0,0,0,0,18,CL
c5224618,10,8,7,2,1,7,15,8,8,4,4,26,36,42,1,18,CL
c5adc293,5,4,2,2,1,3,7,4,3,1,2,5,10,3,0,18,CL
c5fd13e9,2,1,1,1,0,1,4,3,2,2,0,6,8,9,0,18,CL
c6056d58,10,9,8,2,0,5,8,3,4,1,3,4,14,31,0,18,CL
c67b8590,6,2,3,3,0,3,11,8,5,1,4,4,10,4,0,18,CL
c691bfe2,22,10,11,6,5,8,21,13,13,0,13,7,29,7,1,18,CL
c7069d87,8,5,6,2,0,0,8,8,5,0,5,8,16,8,1,18,CL
c707411f,14,8,9,5,0,7,14,7,16,10,6,10,24,48,0,18,CL
c7526c18,11,8,7,3,1,2,9,7,11,4,7,12,23,16,0,18,CL
c75e82dc,8,7,8,0,0,4,6,2,2,2,0,2,10,13,0,18,CL
c81d773d,0,0,0,0,0,0,1,1,0,0,0,2,2,3,0,18,CL
c8a88acd,0,0,0,0,0,0,0,0,0,0,0,2,2,4,0,18,CL
c8c60119,7,4,2,4,1,1,1,0,2,1,1,3,10,8,0,18,CL
c8d7131c,10,8,7,3,0,3,5,2,4,1,3,13,23,11,0,18,CL
c906ce0f,16,11,7,8,1,3,7,4,16,12,4,13,29,41,2,18,CL
c9081f9a,8,6,7,0,1,5,9,4,1,0,1,6,14,2,0,18,CL
c90b2e8f,3,1,2,1,0,2,3,1,0,0,0,14,17,22,0,18,CL
c9e99e49,24,15,14,7,3,7,18,11,13,2,11,13,37,14,1,18,CL
ca8033cb,9,7,6,3,0,3,11,8,2,1,1,7,16,11,0,18,CL
cb7786d5,9,7,4,4,1,3,18,15,6,0,6,10,19,8,0,18,CL
cc700722,8,5,1,5,2,2,13,11,7,0,7,3,11,2,0,18,CL
ccc66d00,8,5,2,6,0,3,13,10,4,2,2,4,12,2,0,18,CL
cd1acf9d,25,14,16,8,1,16,28,12,4,2,2,22,47,27,1,18,CL
ce9e8024,6,2,2,4,0,0,3,3,4,3,1,10,16,10,0,18,CL
cea4ee8f,11,6,3,6,2,1,5,4,2,0,2,1,12,1,0,18,CL
cf182add,14,11,8,5,1,4,8,4,8,2,6,15,29,17,0,18,CL
cf961d8d,3,3,3,0,0,0,1,1,6,3,3,5,8,15,0,18,CL
cfd65a29,11,8,4,5,2,3,12,9,12,1,11,8,19,4,0,18,CL
cfd8d664,10,8,5,4,1,4,5,1,1,0,1,5,15,4,0,18,CL
d003e213,17,11,9,5,3,8,14,6,2,0,2,13,30,13,1,18,CL
d04b94db,15,13,11,4,0,8,17,9,8,1,7,8,23,15,0,18,CL
d0a01d27,17,13,10,6,1,6,17,11,8,0,8,6,23,27,0,18,CL
d0d79694,0,0,0,0,0,0,0,0,1,0,1,1,1,1,0,18,CL
d1675302,13,10,8,4,1,6,10,4,2,0,2,14,27,11,0,18,CL
d18f2675,0,0,0,0,0,0,0,0,0,0,0,0,0,0,0,18,CL
d2416c2e,2,2,0,2,0,0,1,1,0,0,0,0,2,2,0,18,CL
d248cd8f,15,14,12,2,1,5,9,4,7,3,4,12,27,36,1,18,CL
d2bff301,2,1,2,0,0,2,5,3,2,2,0,3,5,4,0,18,CL
d3aaad90,2,1,2,0,0,0,2,2,1,0,1,4,6,1,0,18,CL
d4222f7b,10,6,9,1,0,7,8,1,6,6,0,15,25,21,0,18,CL
d49b243a,0,0,0,0,0,0,2,2,2,0,2,1,1,1,0,18,CL
d49f80d7,2,1,1,1,0,0,0,0,10,8,2,6,8,16,0,18,CL
d4aa40b8,0,0,0,0,0,0,0,0,0,0,0,0,0,1,0,18,CL
d4c9725f,3,2,1,1,1,3,6,3,0,0,0,1,4,1,0,18,CL
d4f46475,5,4,3,2,0,0,0,0,5,3,2,4,9,13,0,18,CL
d5dd5f1f,1,0,0,0,1,0,2,2,3,0,3,0,1,0,0,18,CL
d5f2f82b,9,6,4,4,1,1,4,3,9,4,5,10,19,42,0,18,CL
d637fc22,17,14,6,10,1,9,18,9,8,2,6,9,26,9,0,18,CL
d70ce98e,9,7,2,5,2,0,7,7,4,0,4,3,12,0,0,18,CL
d7398ac3,8,6,5,2,1,3,10,7,8,3,5,10,18,10,0,18,CL
d7553721,5,2,3,0,2,3,9,6,1,0,1,1,6,2,0,18,CL
d7ffd345,1,0,1,0,0,1,1,0,0,0,0,1,2,5,2,18,CL
d807c7f6,0,0,0,0,0,0,0,0,2,2,0,0,0,4,0,18,CL
d8c679be,10,6,2,8,0,5,15,10,12,3,9,9,19,6,0,18,CL
d93c2511,3,1,0,3,0,2,6,4,4,0,4,3,6,4,0,18,CL
d9565625,1,0,1,0,0,0,1,1,1,0,1,2,3,7,0,18,CL
da270297,0,0,0,0,0,0,0,0,1,0,1,0,0,0,0,18,CL
da7b447d,7,5,3,4,0,3,11,8,11,6,5,16,23,31,0,18,CL
da974c7b,10,7,8,2,0,3,6,3,9,7,2,9,19,19,0,18,CL
db4ed67b,5,2,3,1,1,1,2,1,3,0,3,2,7,3,1,18,CL
dbe16ade,2,0,1,1,0,1,1,0,2,0,2,1,3,2,0,18,CL
dc3a9a0d,3,0,2,0,1,1,3,2,1,0,1,3,6,0,0,18,CL
dc3fa3b5,10,8,3,6,1,4,14,10,3,0,3,6,16,7,0,18,CL
dc415e39,10,5,3,7,0,1,4,3,2,0,2,3,13,0,0,18,CL
dc90cfbe,3,0,3,0,0,0,0,0,1,0,1,1,4,3,0,18,CL
dd0daf32,10,7,1,6,3,2,9,7,6,0,6,3,13,1,0,18,CL
dd669209,7,5,1,5,1,3,8,5,2,0,2,6,13,4,0,18,CL
de39485a,4,2,0,3,1,2,6,4,4,1,3,3,7,0,1,18,CL
dea698d9,5,2,1,4,0,1,4,3,8,3,5,3,8,10,0,18,CL
dee86451,11,8,3,8,0,3,10,7,2,1,1,5,16,4,0,18,CL
df324174,12,8,7,5,0,10,19,9,12,6,6,4,16,39,2,18,CL
df69b544,6,4,1,5,0,1,1,0,4,0,4,2,8,2,0,18,CL
df6bcd09,0,0,0,0,0,0,0,0,0,0,0,0,0,1,0,18,CL
dff19848,2,2,0,1,1,0,0,0,1,1,0,0,2,2,0,18,CL
e044ce1e,1,1,0,1,0,0,1,1,1,1,0,1,2,2,0,18,CL
e06683ca,5,5,3,1,1,1,2,1,5,3,2,10,15,42,0,18,CL
e07c2923,2,1,2,0,0,2,3,1,1,0,1,0,2,0,0,18,CL
e0900238,0,0,0,0,0,0,0,0,0,0,0,0,0,0,0,18,CL
e0921a4f,4,3,0,4,0,1,9,8,7,0,7,0,4,1,0,18,CL
e0991c04,1,0,1,0,0,1,2,1,1,1,0,3,4,3,0,18,CL
e162b013,0,0,0,0,0,0,0,0,1,0,1,0,0,0,0,18,CL
e26bd2f4,7,5,2,5,0,1,6,5,3,2,1,6,13,4,0,18,CL
e2716bd0,3,1,2,1,0,1,1,0,2,0,2,6,9,2,0,18,CL
e280527c,8,5,2,5,1,1,7,6,3,0,3,2,10,4,0,18,CL
e288d4b3,12,9,10,1,1,8,23,15,8,0,8,17,29,10,0,18,CL
e304acd5,1,1,1,0,0,1,2,1,1,0,1,0,1,1,0,18,CL
e33c06cf,7,6,5,2,0,4,7,3,11,9,2,11,18,16,0,18,CL
e342ad68,6,4,1,3,2,0,7,7,4,0,4,5,11,3,0,18,CL
e358587b,0,0,0,0,0,0,0,0,0,0,0,0,0,2,1,18,CL
e40d028b,0,0,0,0,0,0,3,3,0,0,0,0,0,2,1,18,CL
e42d61c7,3,3,0,2,1,2,3,1,3,0,3,1,4,3,0,18,CL
e45ee4bc,8,5,0,7,1,2,10,8,4,0,4,3,11,0,0,18,CL
e46012d4,13,9,2,9,2,7,22,15,6,2,4,12,25,2,0,18,CL
e4ed2628,22,14,13,8,1,8,13,5,8,1,7,13,35,4,1,18,CL
e50623a0,0,0,0,0,0,0,2,2,1,0,1,1,1,0,0,18,CL
e599253a,13,8,7,6,0,5,12,7,5,1,4,7,20,2,0,18,CL
e66e4ddc,17,14,14,3,0,9,18,9,8,4,4,7,24,16,0,18,CL
e6ad16b2,8,5,0,7,1,1,11,10,4,0,4,5,13,5,2,18,CL
e6c80256,0,0,0,0,0,0,0,0,2,0,2,0,0,0,0,18,CL
e726e11e,9,7,6,3,0,7,9,2,1,0,1,2,11,9,0,18,CL
e73659d3,4,1,1,3,0,2,6,4,1,0,1,2,6,4,0,18,CL
e73c9bb2,12,10,8,2,2,7,14,7,5,2,3,19,31,17,0,18,CL
e77dc3b2,1,0,1,0,0,0,1,1,1,0,1,0,1,0,0,18,CL
e7986081,3,3,0,3,0,0,0,0,1,0,1,1,4,2,0,18,CL
e7ef333b,8,6,4,3,1,5,5,0,2,2,0,10,18,30,0,18,CL
e85fb9b8,15,10,8,5,2,3,8,5,8,3,5,13,28,46,0,18,CL
e90af77c,0,0,0,0,0,0,0,0,0,0,0,0,0,0,0,18,CL
e90dc1d5,1,1,1,0,0,1,2,1,5,0,5,1,2,0,0,18,CL
ea8d470b,7,4,5,0,2,3,8,5,2,1,1,2,9,3,0,18,CL
ead14875,13,10,3,10,0,5,11,6,4,2,2,4,17,12,0,18,CL
eb2fe5b6,3,1,0,2,1,0,4,4,1,0,1,2,5,0,0,18,CL
eb58eef0,14,10,5,8,1,6,15,9,4,0,4,10,24,12,1,18,CL
eb7822d7,17,11,7,10,0,8,13,5,5,1,4,14,31,7,0,18,CL
ebc49727,3,3,0,2,1,0,3,3,9,0,9,10,13,4,0,18,CL
ecada4fc,0,0,0,0,0,0,0,0,0,0,0,2,2,1,2,18,CL
ecbb3fdf,0,0,0,0,0,0,0,0,0,0,0,0,0,0,0,18,CL
ed1e53f3,2,1,0,2,0,1,7,6,0,0,0,0,2,1,0,18,CL
ed90babd,2,2,1,1,0,0,1,1,0,0,0,0,2,0,0,18,CL
eda40760,22,14,9,10,3,9,17,8,10,2,8,18,40,23,1,18,CL
edd6c8e9,0,0,0,0,0,0,0,0,1,1,0,2,2,4,0,18,CL
ee0da7af,10,6,8,1,1,7,13,6,0,0,0,5,15,2,1,18,CL
ee3519f5,18,11,10,8,0,5,15,10,6,4,2,14,32,9,0,18,CL
ee8508c0,0,0,0,0,0,0,0,0,0,0,0,0,0,1,0,18,CL
ee93c1a9,4,3,4,0,0,2,4,2,1,0,1,0,4,2,0,18,CL
eef95b11,0,0,0,0,0,0,2,2,1,1,0,2,2,7,0,18,CL
ef233486,0,0,0,0,0,0,0,0,0,0,0,0,0,0,0,18,CL
ef2e5e1a,21,15,9,9,3,5,22,17,11,3,8,12,33,2,0,18,CL
ef8cafeb,11,9,5,6,0,7,8,1,4,2,2,13,24,14,0,18,CL
f0da930c,9,8,7,2,0,6,13,7,5,1,4,6,15,18,0,18,CL
f0faccb9,2,2,0,1,1,1,3,2,5,2,3,4,6,0,0,18,CL
f175ca0a,2,2,0,2,0,0,0,0,0,0,0,2,4,1,0,18,CL
f179ee11,6,4,5,1,0,4,5,1,2,0,2,5,11,4,1,18,CL
f1b55719,19,11,10,7,2,7,16,9,7,4,3,12,31,9,0,18,CL
f2308b33,9,7,7,2,0,7,8,1,4,0,4,2,11,5,0,18,CL
f25c8e3a,15,10,4,9,2,3,11,8,8,1,7,12,27,6,0,18,CL
f27680d9,3,2,3,0,0,3,5,2,2,1,1,3,6,3,0,18,CL
f33238db,4,2,2,1,1,0,3,3,1,0,1,0,4,1,0,18,CL
f346787e,3,1,2,1,0,1,4,3,2,1,1,1,4,9,0,18,CL
f36c432f,0,0,0,0,0,0,0,0,0,0,0,0,0,1,0,18,CL
f4081572,4,2,2,1,1,2,7,5,3,3,0,9,13,1,0,18,CL
f40dd3c7,9,7,8,0,1,2,4,2,6,4,2,16,25,12,0,18,CL
f4290206,13,10,6,5,2,6,14,8,11,1,10,12,25,11,0,18,CL
f4b52308,0,0,0,0,0,0,2,2,2,0,2,0,0,0,0,18,CL
f520049f,2,0,1,1,0,1,1,0,3,3,0,5,7,4,1,18,CL
f533776b,11,6,7,3,1,7,9,2,1,0,1,5,16,7,0,18,CL
f5a00fa4,15,6,5,8,2,7,17,10,6,3,3,7,22,8,0,18,CL
f5deef4c,5,2,4,1,0,2,3,1,10,5,5,7,12,16,0,18,CL
f619413f,0,0,0,0,0,0,0,0,0,0,0,0,0,0,0,18,CL
f61c7c4e,4,2,2,1,1,1,10,9,5,0,5,4,8,4,0,18,CL
f69d4d79,6,1,6,0,0,4,10,6,10,5,5,6,12,36,1,18,CL
f6ac68c1,3,3,1,1,1,0,3,3,4,3,1,6,9,10,0,18,CL
f6db3bd5,0,0,0,0,0,0,0,0,0,0,0,0,0,0,0,18,CL
f6ddac8f,2,1,1,1,0,1,3,2,1,1,0,1,3,3,0,18,CL
f7d50789,6,5,3,3,0,4,6,2,5,2,3,2,8,20,0,18,CL
f7ee69fb,10,6,1,6,3,2,5,3,4,1,3,6,16,1,0,18,CL
f8280175,1,1,1,0,0,1,1,0,0,0,0,0,1,1,0,18,CL
f864af2c,7,5,4,3,0,2,5,3,5,2,3,3,10,10,0,18,CL
f86ad3f5,1,1,1,0,0,1,2,1,2,0,2,3,4,4,0,18,CL
fa937f7a,13,9,2,9,2,6,22,16,5,2,3,6,19,2,0,18,CL
faa1b07d,6,5,4,2,0,2,7,5,6,4,2,14,20,15,1,18,CL
faec2ec4,14,9,1,8,5,6,18,12,7,0,7,2,16,6,1,18,CL
fb938d24,12,9,7,5,0,4,14,10,5,0,5,7,19,0,0,18,CL
fc4f85b1,9,7,6,3,0,5,11,6,1,0,1,8,17,11,0,18,CL
fce2302c,11,7,6,5,0,4,10,6,8,1,7,16,27,19,0,18,CL
fd51b456,17,8,8,9,0,6,16,10,8,0,8,6,23,12,0,18,CL
fe2db476,2,1,0,2,0,0,1,1,1,0,1,5,7,7,0,18,CL
fe4a25be,0,0,0,0,0,0,0,0,0,0,0,1,1,0,0,18,CL
feb5d3ab,18,13,10,8,0,10,20,10,10,1,9,6,24,14,1,18,CL
ffc1c226,0,0,0,0,0,0,1,1,0,0,0,1,1,4,0,18,CL
0000acda,54,38,18,22,14,17,52,35,52,2,50,28,82,36,0,18,ITA
00528660,19,12,7,7,5,7,17,10,23,6,17,22,41,50,0,18,ITA
00823e9a,11,7,4,6,1,4,8,4,10,0,10,0,11,5,0,18,ITA
00b0bb87,34,27,20,9,5,15,30,15,33,11,22,38,72,99,3,18,ITA
019f4d0d,24,15,16,8,0,15,20,5,16,10,6,23,47,48,1,18,ITA
01b8a2b2,0,0,0,0,0,0,0,0,0,0,0,0,0,4,0,18,ITA
01efac19,58,38,22,27,9,21,58,37,34,2,32,18,76,26,1,18,ITA
023937a9,55,35,30,22,3,18,48,30,39,16,23,47,102,107,1,18,ITA
02b2937c,18,10,12,5,1,6,12,6,7,1,6,6,24,17,0,18,ITA
02caf6e0,61,47,33,21,7,27,62,35,32,7,25,31,92,73,2,18,ITA
0375723e,33,24,17,13,3,11,43,32,20,1,19,36,69,12,0,18,ITA
03760df0,0,0,0,0,0,0,0,0,0,0,0,2,2,10,4,18,ITA
03f946ed,8,3,2,4,2,1,11,10,14,3,11,4,12,5,0,18,ITA
048877f5,0,0,0,0,0,0,0,0,0,0,0,0,0,23,3,18,ITA
0489bb30,0,0,0,0,0,0,0,0,0,0,0,0,0,0,0,18,ITA
05e19d6a,48,34,20,19,9,17,44,27,47,11,36,26,74,45,3,18,ITA
06050480,54,35,35,14,5,29,50,21,31,6,25,41,95,90,0,18,ITA
060606ec,31,22,15,9,7,8,24,16,12,1,11,10,41,8,1,18,ITA
07767f42,56,38,30,20,6,20,65,45,26,7,19,58,114,78,2,18,ITA
07abb358,58,44,23,29,6,13,54,41,29,2,27,43,101,41,0,18,ITA
07ea0ef2,8,4,5,3,0,4,6,2,6,0,6,0,8,3,0,18,ITA
081b6080,23,17,10,10,3,7,25,18,13,4,9,16,39,7,2,18,ITA
0821331c,28,20,22,6,0,11,26,15,19,10,9,27,55,111,0,18,ITA
085e71a7,0,0,0,0,0,0,0,0,0,0,0,0,0,0,1,18,ITA
0861b8d6,2,2,1,1,0,2,8,6,4,0,4,1,3,11,2,18,ITA
089550f5,28,21,12,14,2,15,23,8,11,0,11,18,46,30,0,18,ITA
08aa9cd1,0,0,0,0,0,0,0,0,0,0,0,0,0,0,0,18,ITA
08f5afaa,1,0,1,0,0,1,1,0,0,0,0,1,2,13,8,18,ITA
09538fdb,10,7,0,8,2,2,7,5,27,4,23,8,18,18,0,18,ITA
09899de8,12,9,10,2,0,4,9,5,12,8,4,7,19,41,2,18,ITA
0a1efd3c,7,5,0,5,2,0,5,5,17,1,16,2,9,11,0,18,ITA
0ab1f153,28,19,17,9,2,11,27,16,14,0,14,19,47,14,1,18,ITA
0b5a292a,55,39,18,32,5,30,52,22,30,5,25,14,69,43,1,18,ITA
0c2ac3cb,14,9,1,10,3,3,16,13,15,0,15,7,21,9,0,18,ITA
0c971997,15,13,11,3,1,8,11,3,11,9,2,21,36,66,0,18,ITA
0cd0e21b,28,15,14,11,3,10,16,6,14,2,12,15,43,23,0,18,ITA
0d2bdb4b,6,4,2,4,0,2,4,2,2,0,2,4,10,1,0,18,ITA
0d422df7,0,0,0,0,0,0,0,0,0,0,0,1,1,0,0,18,ITA
0d72fbca,0,0,0,0,0,0,0,0,1,0,1,0,0,1,0,18,ITA
0d82903c,57,31,33,17,7,20,39,19,21,1,20,30,87,45,0,18,ITA
0e21fc3c,46,31,17,25,4,20,58,38,15,4,11,18,64,41,1,18,ITA
0f22b650,3,2,0,1,2,0,6,6,1,0,1,2,5,0,0,18,ITA
10dc46f0,0,0,0,0,0,0,0,0,0,0,0,1,1,35,3,18,ITA
10e7f486,18,14,10,5,3,7,15,8,11,1,10,9,27,31,0,18,ITA
117beb8f,20,15,14,5,1,9,13,4,26,18,8,33,53,152,1,18,ITA
1253a12e,50,41,33,16,1,20,51,31,32,19,13,48,98,175,0,18,ITA
13d820de,25,17,20,4,1,12,20,8,24,17,7,30,55,139,0,18,ITA
144607cc,40,25,19,14,7,8,28,20,20,1,19,22,62,29,0,18,ITA
149c5f5d,19,11,10,4,5,7,19,12,8,1,7,6,25,32,0,18,ITA
14b8fcdf,18,12,11,5,2,7,13,6,18,14,4,20,38,87,1,18,ITA
1522dab2,47,31,33,13,1,18,29,11,29,17,12,51,98,131,2,18,ITA
157d29b6,21,15,3,9,9,6,24,18,17,0,17,8,29,6,0,18,ITA
15d0c248,40,28,24,16,0,15,25,10,26,14,12,18,58,50,1,18,ITA
15e9c7e6,9,6,2,2,5,3,9,6,8,0,8,2,11,0,0,18,ITA
162efffd,31,18,10,17,4,4,32,28,34,1,33,16,47,8,0,18,ITA
16657b95,66,50,21,32,13,18,59,41,43,6,37,23,89,27,0,18,ITA
16b9d5cf,1,1,0,1,0,1,1,0,1,0,1,0,1,5,0,18,ITA
16bc48f8,0,0,0,0,0,0,0,0,0,0,0,0,0,0,0,18,ITA
174944a3,1,0,1,0,0,0,0,0,2,2,0,2,3,13,0,18,ITA
17cddb4d,68,49,37,28,3,20,48,28,35,8,27,38,106,31,0,18,ITA
18736214,0,0,0,0,0,0,0,0,0,0,0,0,0,2,0,18,ITA
1880614f,10,6,4,6,0,3,18,15,8,1,7,9,19,10,0,18,ITA
197640fd,54,37,32,14,8,13,27,14,25,4,21,26,80,48,0,18,ITA
1a584cb2,5,5,4,1,0,2,6,4,1,0,1,3,8,9,1,18,ITA
1ab0b878,14,8,5,6,3,2,11,9,9,0,9,6,20,4,0,18,ITA
1ad1f50d,9,6,2,4,3,1,17,16,10,0,10,9,18,1,0,18,ITA
1b62a7df,0,0,0,0,0,0,0,0,0,0,0,0,0,0,0,18,ITA
1b729ba2,24,17,7,13,4,5,19,14,24,5,19,20,44,61,1,18,ITA
1c17dfe0,1,0,0,1,0,0,0,0,1,0,1,2,3,2,0,18,ITA
1c50f354,8,5,4,3,1,5,25,20,9,3,6,5,13,6,0,18,ITA
1c529186,20,17,10,9,1,6,11,5,22,2,20,8,28,29,0,18,ITA
1c8c5aed,37,29,19,14,4,11,18,7,15,4,11,22,59,70,1,18,ITA
1ceeae3e,4,3,2,1,1,0,4,4,3,1,2,1,5,6,0,18,ITA
1e12c53b,30,21,19,7,4,12,30,18,22,9,13,48,78,151,1,18,ITA
1ea5f91c,29,18,9,14,6,10,46,36,46,8,38,20,49,27,0,18,ITA
1f9328da,49,36,14,28,7,9,33,24,18,1,17,18,67,31,1,18,ITA
1fca9171,26,13,14,8,4,5,20,15,24,2,22,16,42,25,0,18,ITA
2054d037,29,23,11,9,9,6,18,12,17,3,14,13,42,15,0,18,ITA
2146785a,64,50,33,24,7,21,41,20,19,4,15,33,97,82,1,18,ITA
2258c078,52,36,23,26,3,18,55,37,39,9,30,58,110,26,2,18,ITA
22ca11f1,0,0,0,0,0,0,0,0,1,1,0,1,1,1,0,18,ITA
23214a49,12,9,9,3,0,6,8,2,5,4,1,13,25,26,0,18,ITA
2334478a,17,11,5,9,3,4,11,7,9,2,7,5,22,18,1,18,ITA
23f9e9d3,6,4,1,5,0,1,2,1,7,1,6,1,7,6,0,18,ITA
24228180,21,18,3,13,5,7,14,7,14,1,13,11,32,17,0,18,ITA
251d982a,2,2,1,1,0,1,2,1,3,1,2,7,9,8,0,18,ITA
263b855a,11,6,7,4,0,5,13,8,3,0,3,5,16,5,1,18,ITA
2648e18f,12,9,4,6,2,5,13,8,11,1,10,9,21,13,0,18,ITA
269b4638,8,5,2,5,1,2,13,11,7,1,6,3,11,9,0,18,ITA
27f0ddef,48,32,33,15,0,15,29,14,47,25,22,37,85,160,2,18,ITA
2a1beb34,77,50,27,44,6,29,82,53,40,5,35,46,123,36,0,18,ITA
2c851997,33,20,4,15,14,9,56,47,30,3,27,18,51,24,0,18,ITA
2d970560,61,46,35,22,4,27,46,19,17,2,15,22,83,40,0,18,ITA
2ead2809,8,5,4,4,0,1,11,10,7,1,6,3,11,8,0,18,ITA
2ec0f902,9,6,3,6,0,1,6,5,12,3,9,2,11,9,0,18,ITA
2edeb221,37,21,15,21,1,13,48,35,35,6,29,45,82,46,1,18,ITA
2f3452eb,64,45,28,30,6,32,56,24,35,4,31,43,107,68,4,18,ITA
2f557579,29,17,11,13,5,13,33,20,20,0,20,17,46,4,0,18,ITA
2fb3ad46,5,3,4,1,0,3,5,2,1,0,1,10,15,12,0,18,ITA
30223b33,0,0,0,0,0,0,3,3,1,0,1,0,0,11,5,18,ITA
30f5ffa9,86,55,69,16,1,44,70,26,38,26,12,35,121,180,0,18,ITA
314f2124,48,37,38,10,0,22,25,3,30,23,7,38,86,131,2,18,ITA
31d7f557,17,10,9,6,2,7,19,12,15,4,11,13,30,21,0,18,ITA
322ba2df,11,8,7,4,0,6,12,6,9,4,5,13,24,69,0,18,ITA
326d09ef,2,1,2,0,0,1,4,3,2,0,2,2,4,16,7,18,ITA
32a33c68,12,9,5,4,3,3,8,5,4,1,3,11,23,11,0,18,ITA
32b9b5fa,2,2,2,0,0,2,2,0,0,0,0,1,3,12,4,18,ITA
32d1c24f,14,11,12,2,0,4,8,4,25,16,9,37,51,97,1,18,ITA
32ebfe1e,80,44,33,42,5,16,68,52,52,5,47,58,138,67,1,18,ITA
331c0a43,62,37,25,31,6,14,72,58,46,8,38,67,129,70,0,18,ITA
339c6ed4,13,7,11,0,2,6,11,5,14,7,7,11,24,68,0,18,ITA
339fe0e8,0,0,0,0,0,0,0,0,0,0,0,2,2,13,4,18,ITA
33b8d077,60,43,21,31,8,19,63,44,30,7,23,18,78,18,0,18,ITA
33ecf462,7,3,3,2,2,2,7,5,12,0,12,8,15,7,0,18,ITA
343c0d52,32,23,9,17,6,8,40,32,27,1,26,12,44,32,0,18,ITA
343f753a,0,0,0,0,0,0,0,0,0,0,0,0,0,1,0,18,ITA
349601c3,0,0,0,0,0,0,0,0,0,0,0,0,0,1,0,18,ITA
3535098b,34,23,21,9,4,12,22,10,20,5,15,11,45,72,1,18,ITA
356c9002,12,7,7,5,0,8,39,31,20,2,18,22,34,24,0,18,ITA
3626daea,14,5,9,4,1,7,15,8,25,6,19,18,32,44,1,18,ITA
3799e138,22,16,10,10,2,6,29,23,8,1,7,10,32,8,1,18,ITA
384dd218,29,20,11,14,4,10,17,7,25,0,25,22,51,43,0,18,ITA
3858e611,19,14,14,4,1,10,21,11,27,22,5,46,65,126,0,18,ITA
38ac43d3,14,9,1,9,4,2,23,21,13,3,10,20,34,20,0,18,ITA
39bec070,27,13,11,14,2,11,33,22,19,6,13,23,50,31,1,18,ITA
3b15ef2d,28,21,20,6,2,8,15,7,18,13,5,43,71,89,1,18,ITA
3b333ac3,31,25,13,13,5,15,26,11,32,5,27,30,61,46,1,18,ITA
3b57f7f8,9,7,4,3,2,6,14,8,10,3,7,13,22,15,0,18,ITA
3b8674e6,18,11,10,7,1,2,16,14,5,1,4,3,21,14,0,18,ITA
3b9858f5,5,3,4,1,0,0,2,2,0,0,0,4,9,12,0,18,ITA
3bb7af3b,12,8,2,8,2,2,11,9,3,1,2,1,13,5,0,18,ITA
3bb7f478,15,10,1,9,5,3,15,12,9,1,8,4,19,36,0,18,ITA
3c05c659,16,12,6,8,2,9,19,10,4,0,4,4,20,6,0,18,ITA
3d50bcdb,8,5,1,3,4,1,6,5,6,0,6,7,15,4,0,18,ITA
3d5ed93d,0,0,0,0,0,0,0,0,0,0,0,1,1,1,0,18,ITA
3d936ba9,5,4,4,1,0,3,9,6,8,6,2,7,12,13,1,18,ITA
3dd45b70,36,26,21,14,1,19,49,30,24,3,21,33,69,47,3,18,ITA
3ead85f9,20,14,17,2,1,9,14,5,24,14,10,23,43,154,1,18,ITA
3effaa34,5,4,1,0,4,2,7,5,10,1,9,4,9,6,0,18,ITA
40f0ed6c,1,1,0,0,1,0,2,2,1,0,1,1,2,8,0,18,ITA
4133cfcf,9,6,3,3,3,2,10,8,4,0,4,6,15,4,0,18,ITA
41bd99ea,0,0,0,0,0,0,0,0,0,0,0,1,1,1,1,18,ITA
422ec08a,14,10,5,4,5,4,10,6,8,0,8,5,19,6,0,18,ITA
42591ed0,7,5,4,2,1,3,7,4,8,1,7,7,14,35,0,18,ITA
42fff925,19,17,6,8,5,5,17,12,9,3,6,4,23,20,0,18,ITA
43a1bea5,67,42,23,32,12,18,70,52,45,2,43,21,88,29,3,18,ITA
43a2e16c,16,13,6,8,2,0,21,21,14,0,14,11,27,15,0,18,ITA
43b78598,3,2,1,2,0,1,8,7,14,6,8,5,8,23,1,18,ITA
440c84ed,41,31,15,20,6,6,43,37,22,0,22,15,56,15,0,18,ITA
4431aed2,4,2,0,3,1,0,17,17,14,1,13,0,4,9,0,18,ITA
4468b31a,23,19,12,10,1,11,44,33,29,0,29,25,48,26,0,18,ITA
44ac04e9,54,34,15,30,9,19,49,30,28,6,22,20,74,31,0,18,ITA
44eb9093,82,64,38,35,9,30,59,29,31,7,24,45,127,68,1,18,ITA
45392b06,37,27,20,14,3,15,39,24,29,8,21,24,61,23,2,18,ITA
455a2b79,28,14,7,18,3,7,54,47,22,2,20,24,52,20,1,18,ITA
4590c6e7,9,7,4,5,0,3,7,4,0,0,0,1,10,3,0,18,ITA
45db685d,62,46,14,39,9,15,68,53,32,3,29,50,112,12,2,18,ITA
4611e028,70,48,41,29,0,24,75,51,49,13,36,46,116,83,1,18,ITA
46ed55b6,17,9,11,5,1,8,20,12,17,13,4,27,44,94,1,18,ITA
46f5c54d,28,21,18,6,4,11,20,9,19,9,10,35,63,99,0,18,ITA
47146acb,13,6,10,1,2,6,11,5,4,3,1,5,18,27,0,18,ITA
47a500ae,16,8,12,3,1,6,17,11,31,21,10,29,45,151,1,18,ITA
47dc80f5,18,11,5,11,2,7,16,9,13,3,10,12,30,7,0,18,ITA
49136c42,2,1,2,0,0,0,1,1,1,1,0,3,5,10,0,18,ITA
49d399d5,0,0,0,0,0,0,0,0,0,0,0,0,0,3,0,18,ITA
4a56052c,65,45,34,23,8,20,69,49,39,4,35,37,102,59,0,18,ITA
4a5a45c7,36,20,16,11,9,10,35,25,21,2,19,41,77,21,1,18,ITA
4ac07e1b,4,3,4,0,0,1,6,5,1,0,1,3,7,11,1,18,ITA
4ae67f27,0,0,0,0,0,0,0,0,0,0,0,0,0,1,0,18,ITA
4b029b31,14,8,10,4,0,5,9,4,10,5,5,19,33,56,0,18,ITA
4b6960d2,10,6,4,5,1,5,14,9,8,3,5,10,20,28,0,18,ITA
4bd414c1,29,19,15,14,0,13,19,6,18,13,5,32,61,129,1,18,ITA
4c62d0c8,0,0,0,0,0,0,1,1,0,0,0,1,1,14,2,18,ITA
4c78b5ed,107,80,43,59,5,29,100,71,33,7,26,70,177,59,0,18,ITA
4c7940d6,12,9,3,4,5,2,13,11,7,2,5,6,18,11,0,18,ITA
4cc93246,0,0,0,0,0,0,1,1,1,0,1,0,0,0,0,18,ITA
4d3ab428,12,7,4,6,2,8,21,13,13,0,13,8,20,11,0,18,ITA
4dba2a97,32,22,11,20,1,7,35,28,24,2,22,19,51,13,0,18,ITA
4e219ad2,18,14,3,5,10,4,31,27,25,0,25,16,34,2,1,18,ITA
4e358a2d,56,43,38,18,0,25,31,6,30,22,8,46,102,161,3,18,ITA
4e6dbac4,55,39,11,34,10,13,52,39,29,6,23,33,88,36,1,18,ITA
4f2908e5,46,34,29,13,4,14,26,12,39,13,26,40,86,132,1,18,ITA
4f8ce0e1,0,0,0,0,0,0,0,0,0,0,0,1,1,7,1,18,ITA
4fa7cb9b,17,14,10,5,2,8,25,17,15,0,15,7,24,7,0,18,ITA
50b51fac,7,6,2,5,0,4,6,2,3,1,2,8,15,10,0,18,ITA
5128bde4,19,12,16,2,1,9,18,9,8,0,8,13,32,12,0,18,ITA
51c614fd,1,1,1,0,0,0,1,1,0,0,0,1,2,0,0,18,ITA
524eb8c5,27,20,11,10,6,10,31,21,16,0,16,12,39,6,0,18,ITA
52611641,101,73,36,57,8,30,77,47,52,17,35,72,173,36,1,18,ITA
528492ea,39,29,16,18,5,15,52,37,32,2,30,19,58,29,1,18,ITA
5294a83f,39,28,8,23,8,10,44,34,30,2,28,16,55,7,0,18,ITA
52e2ef8f,35,24,22,12,1,17,38,21,21,2,19,22,57,46,2,18,ITA
52ec54d0,30,21,22,7,1,11,18,7,31,22,9,51,81,132,0,18,ITA
5313ed43,20,17,8,12,0,4,20,16,17,3,14,27,47,26,1,18,ITA
532d2690,23,13,12,9,2,9,33,24,18,13,5,43,66,45,2,18,ITA
53636fce,4,2,2,2,0,1,4,3,5,3,2,7,11,28,0,18,ITA
5370cba7,15,10,7,3,5,4,16,12,4,0,4,4,19,8,0,18,ITA
539230cf,8,4,6,2,0,3,6,3,6,5,1,12,20,35,0,18,ITA
53a0e358,31,17,9,16,6,11,65,54,23,0,23,17,48,14,1,18,ITA
53de807a,53,38,36,16,1,25,41,16,30,14,16,55,108,105,1,18,ITA
54e53b7e,19,11,2,11,6,0,10,10,25,2,23,5,24,3,0,18,ITA
55667895,31,18,25,6,0,14,16,2,30,23,7,21,52,77,2,18,ITA
55ae91f0,20,11,13,6,1,9,15,6,8,1,7,9,29,25,0,18,ITA
56400c01,52,39,36,13,3,15,41,26,29,16,13,38,90,105,1,18,ITA
56b2957b,54,40,14,29,11,16,43,27,39,7,32,38,92,35,0,18,ITA
5710a281,59,36,28,26,5,22,61,39,49,12,37,28,87,51,1,18,ITA
58027adc,7,5,1,3,3,1,5,4,3,0,3,2,9,3,0,18,ITA
58d97e77,2,1,1,1,0,0,3,3,1,0,1,0,2,5,0,18,ITA
5a325298,10,7,2,4,4,0,10,10,6,1,5,5,15,4,0,18,ITA
5aa53281,20,14,11,8,1,10,17,7,8,2,6,15,35,22,0,18,ITA
5bdd44d8,2,2,0,1,1,0,2,2,2,0,2,0,2,0,0,18,ITA
5d311e8d,2,2,1,1,0,0,1,1,1,1,0,3,5,5,0,18,ITA
5d4f7d61,9,7,1,5,3,1,9,8,14,0,14,2,11,11,0,18,ITA
5e861944,23,16,8,10,5,3,32,29,13,2,11,14,37,13,0,18,ITA
5eb72339,22,18,8,10,4,12,28,16,38,14,24,24,46,74,0,18,ITA
5efc5389,16,12,9,5,2,11,18,7,12,3,9,15,31,28,0,18,ITA
61228681,0,0,0,0,0,0,0,0,0,0,0,0,0,1,0,18,ITA
614c38fb,45,25,20,20,5,8,26,18,17,3,14,24,69,15,0,18,ITA
616aea37,33,19,20,13,0,9,23,14,26,15,11,34,67,116,1,18,ITA
61b3978f,63,47,30,28,5,31,53,22,33,8,25,30,93,98,2,18,ITA
635b0bae,24,18,13,9,2,11,26,15,20,5,15,22,46,90,1,18,ITA
644faf10,0,0,0,0,0,0,0,0,0,0,0,0,0,0,0,18,ITA
64cd167d,33,25,13,19,1,18,25,7,19,10,9,38,71,78,0,18,ITA
65c75ea8,43,32,22,16,5,16,25,9,25,2,23,15,58,19,1,18,ITA
65e4dede,5,3,5,0,0,3,4,1,7,4,3,11,16,15,0,18,ITA
68252d6d,24,19,5,13,6,8,29,21,19,0,19,16,40,2,0,18,ITA
686cbe7d,0,0,0,0,0,0,3,3,1,0,1,1,1,2,0,18,ITA
68852c0a,26,19,18,6,2,7,21,14,10,3,7,11,37,37,1,18,ITA
6928979a,92,69,37,43,12,25,78,53,48,6,42,45,137,53,0,18,ITA
6989550f,0,0,0,0,0,0,0,0,0,0,0,0,0,15,3,18,ITA
69cbc8b6,8,5,8,0,0,0,3,3,5,2,3,6,14,33,0,18,ITA
6a189491,9,8,3,5,1,4,4,0,3,0,3,5,14,16,0,18,ITA
6aafdc27,25,18,18,7,0,10,19,9,29,21,8,53,78,151,1,18,ITA
6c1f7328,31,21,13,9,9,7,30,23,21,2,19,8,39,17,1,18,ITA
6ca663b4,0,0,0,0,0,0,4,4,2,0,2,1,1,13,0,18,ITA
6cc97b6a,44,33,22,12,10,16,35,19,27,8,19,47,91,55,0,18,ITA
6e4df551,14,9,6,5,3,5,26,21,16,1,15,22,36,7,0,18,ITA
6eee05f1,32,17,28,4,0,12,30,18,37,23,14,62,94,178,1,18,ITA
6ef56efd,9,7,5,3,1,1,7,6,9,2,7,20,29,28,0,18,ITA
6fe90922,47,31,15,23,9,8,56,48,47,6,41,45,92,62,0,18,ITA
70fd593e,1,0,0,0,1,0,2,2,2,0,2,3,4,2,0,18,ITA
7280b54f,21,16,12,6,3,5,10,5,7,0,7,5,26,12,1,18,ITA
72c803a0,25,15,16,8,1,7,18,11,20,1,19,5,30,6,0,18,ITA
741e058f,3,2,0,3,0,1,2,1,3,0,3,0,3,0,0,18,ITA
74419746,0,0,0,0,0,0,0,0,1,0,1,0,0,7,1,18,ITA
756959aa,27,19,11,15,1,9,27,18,15,4,11,18,45,11,0,18,ITA
75b86fb3,2,2,2,0,0,1,1,0,0,0,0,1,3,3,0,18,ITA
75efed2e,18,11,11,6,1,6,17,11,8,1,7,5,23,1,0,18,ITA
77cf6852,23,16,14,8,1,10,19,9,12,4,8,16,39,39,1,18,ITA
78841da9,33,27,15,14,4,10,47,37,42,5,37,22,55,31,0,18,ITA
788b31e2,16,9,6,8,2,7,13,6,11,0,11,7,23,5,0,18,ITA
79083382,42,30,25,15,2,18,34,16,18,9,9,39,81,63,0,18,ITA
7a2e46a8,1,0,1,0,0,0,1,1,0,0,0,2,3,22,4,18,ITA
7b536033,9,5,4,4,1,2,10,8,5,1,4,4,13,5,0,18,ITA
7b5f516f,0,0,0,0,0,0,0,0,0,0,0,0,0,0,0,18,ITA
7c0000fd,26,15,14,11,1,9,16,7,14,7,7,17,43,46,0,18,ITA
7cc89a5f,1,1,0,0,1,0,0,0,1,0,1,1,2,0,0,18,ITA
7d3cbc67,1,1,1,0,0,0,1,1,0,0,0,1,2,0,0,18,ITA
7d50454d,45,33,31,12,2,16,34,18,33,21,12,50,95,156,0,18,ITA
7f267d66,9,7,5,3,1,6,13,7,8,0,8,4,13,12,0,18,ITA
7f78ad23,48,29,24,18,6,18,28,10,36,6,30,33,81,93,3,18,ITA
7fd58fe3,66,40,32,22,12,21,80,59,32,4,28,36,102,39,0,18,ITA
7fe90ccd,1,0,1,0,0,0,0,0,0,0,0,2,3,1,0,18,ITA
8011fcf6,28,18,11,13,4,7,30,23,24,5,19,10,38,10,1,18,ITA
80ad4216,0,0,0,0,0,0,0,0,0,0,0,0,0,0,0,18,ITA
80dbbd10,12,9,1,5,6,1,12,11,16,3,13,1,13,20,0,18,ITA
81255c03,15,9,4,9,2,0,12,12,9,1,8,11,26,24,0,18,ITA
82f32d55,2,2,1,1,0,1,3,2,5,0,5,2,4,1,0,18,ITA
8320fe65,2,2,1,1,0,0,2,2,0,0,0,1,3,3,0,18,ITA
844a87c2,0,0,0,0,0,0,1,1,0,0,0,0,0,0,0,18,ITA
84594618,33,18,20,12,1,16,26,10,20,11,9,33,66,96,0,18,ITA
852351df,26,17,16,7,3,10,23,13,9,2,7,22,48,28,1,18,ITA
854ee61a,8,3,1,1,6,2,8,6,5,0,5,3,11,6,0,18,ITA
85613cf0,2,1,0,1,1,0,1,1,5,0,5,1,3,4,0,18,ITA
86015b20,19,14,9,7,3,7,24,17,13,2,11,20,39,16,0,18,ITA
8650af85,12,8,8,4,0,5,10,5,42,38,4,31,43,149,4,18,ITA
86695068,85,57,34,36,15,38,73,35,49,1,48,37,122,22,0,18,ITA
8697c095,6,2,2,4,0,3,10,7,0,0,0,2,8,1,0,18,ITA
87243064,1,1,0,0,1,0,4,4,4,0,4,0,1,0,0,18,ITA
878ee034,6,2,1,3,2,1,3,2,3,0,3,1,7,2,0,18,ITA
8790f988,0,0,0,0,0,0,0,0,1,0,1,0,0,0,0,18,ITA
8827bf46,20,12,10,8,2,2,7,5,15,2,13,11,31,11,1,18,ITA
88895312,32,25,11,17,4,8,30,22,19,2,17,17,49,14,1,18,ITA
88c89891,19,14,13,6,0,9,17,8,10,3,7,20,39,32,2,18,ITA
89976232,30,23,14,10,6,12,18,6,15,6,9,34,64,70,0,18,ITA
89b2c8a9,28,22,5,13,10,5,36,31,18,2,16,5,33,8,1,18,ITA
8a08491a,19,17,3,7,9,2,19,17,19,4,15,7,26,20,0,18,ITA
8a2d3fdb,1,0,0,1,0,0,0,0,0,0,0,0,1,0,0,18,ITA
8b0b02c9,1,1,0,0,1,0,1,1,1,0,1,0,1,0,0,18,ITA
8b66d9cc,3,1,1,1,1,0,3,3,4,0,4,4,7,1,1,18,ITA
8b9b8e43,2,0,2,0,0,0,0,0,0,0,0,1,3,8,0,18,ITA
8c725b43,63,47,42,19,2,19,41,22,33,16,17,63,126,185,1,18,ITA
8c964914,9,6,3,4,2,1,4,3,7,0,7,4,13,3,0,18,ITA
8cabdc1e,0,0,0,0,0,0,2,2,0,0,0,0,0,27,6,18,ITA
8cc29864,7,1,4,3,0,5,9,4,2,1,1,7,14,10,0,18,ITA
8cea6319,51,34,32,16,3,25,49,24,42,24,18,48,99,157,1,18,ITA
8cf63012,0,0,0,0,0,0,0,0,0,0,0,0,0,0,0,18,ITA
8d8178ac,25,18,6,12,7,10,28,18,16,2,14,12,37,14,0,18,ITA
8e45910b,9,7,5,3,1,5,10,5,4,0,4,6,15,7,0,18,ITA
8e4b894b,2,1,2,0,0,0,0,0,1,0,1,3,5,1,0,18,ITA
8ea2c099,8,7,5,2,1,4,9,5,8,3,5,15,23,42,0,18,ITA
8ec95452,13,8,11,2,0,8,12,4,32,25,7,16,29,117,1,18,ITA
8efa621b,11,9,7,4,0,7,11,4,14,11,3,7,18,61,0,18,ITA
8f3565b3,28,20,4,16,8,2,20,18,20,3,17,7,35,27,0,18,ITA
8fef5412,4,2,1,3,0,2,3,1,3,0,3,1,5,5,0,18,ITA
905a4f61,9,3,6,3,0,1,4,3,2,0,2,1,10,1,0,18,ITA
9085dd7c,92,67,53,24,15,24,60,36,41,5,36,23,115,76,0,18,ITA
90b70194,74,48,34,25,15,29,78,49,39,6,33,39,113,47,1,18,ITA
91899ca8,22,15,13,7,2,8,16,8,9,3,6,12,34,58,1,18,ITA
91976866,0,0,0,0,0,0,0,0,0,0,0,0,0,0,0,18,ITA
921f6058,60,39,36,19,5,24,51,27,36,21,15,39,99,111,1,18,ITA
92a5ac34,4,2,1,3,0,1,4,3,5,0,5,2,6,3,0,18,ITA
92b4758e,55,38,35,17,3,19,38,19,33,16,17,75,130,161,1,18,ITA
93390969,10,9,3,6,1,8,12,4,10,2,8,8,18,25,0,18,ITA
93b891d1,11,10,3,5,3,2,7,5,6,0,6,1,12,4,0,18,ITA
93cf32a8,56,40,40,15,1,22,33,11,44,22,22,57,113,163,1,18,ITA
9413b19f,0,0,0,0,0,0,1,1,0,0,0,0,0,5,0,18,ITA
9417f322,20,11,13,7,0,7,11,4,23,14,9,30,50,124,3,18,ITA
951a4ee4,1,0,1,0,0,1,1,0,0,0,0,0,1,0,0,18,ITA
952a03fe,26,17,15,11,0,10,25,15,35,18,17,36,62,147,0,18,ITA
957d41d2,12,8,9,2,1,5,11,6,5,1,4,6,18,10,0,18,ITA
958a601f,20,12,14,5,1,9,18,9,11,4,7,21,41,40,1,18,ITA
95cfe655,1,1,0,1,0,1,3,2,2,0,2,0,1,6,0,18,ITA
961a4174,1,1,1,0,0,0,1,1,0,0,0,1,2,0,0,18,ITA
96960855,12,7,6,5,1,2,10,8,3,0,3,5,17,0,0,18,ITA
97c9bce3,19,14,12,7,0,6,11,5,10,8,2,26,45,35,0,18,ITA
97e2aa67,6,4,3,2,1,4,8,4,3,1,2,2,8,3,0,18,ITA
983ff2c7,44,34,26,12,6,16,37,21,40,16,24,40,84,105,3,18,ITA
98d2c2c4,89,62,35,41,13,27,82,55,46,13,33,28,117,37,2,18,ITA
98e958af,12,8,2,8,2,3,24,21,14,4,10,9,21,12,0,18,ITA
99b1d0e6,31,27,16,10,5,9,17,8,11,2,9,15,46,38,1,18,ITA
99d8fc35,52,34,41,8,3,17,30,13,64,44,20,39,91,203,0,18,ITA
9a560ebe,27,21,24,2,1,13,22,9,26,17,9,36,63,120,2,18,ITA
9b30df1e,28,22,21,7,0,12,21,9,24,18,6,58,86,148,0,18,ITA
9b7533de,3,2,3,0,0,2,3,1,5,2,3,3,6,11,0,18,ITA
9be4ee80,18,9,5,12,1,8,27,19,6,3,3,16,34,13,0,18,ITA
9c31bb89,11,8,5,5,1,5,14,9,4,0,4,5,16,6,1,18,ITA
9c8f641a,4,2,1,3,0,0,3,3,1,1,0,1,5,3,0,18,ITA
9dabfcf5,13,12,4,9,0,3,16,13,10,4,6,15,28,14,1,18,ITA
9e1577aa,74,48,33,32,9,36,58,22,42,5,37,43,117,103,2,18,ITA
9e61c019,20,11,7,7,6,3,19,16,14,1,13,8,28,4,0,18,ITA
9f069180,11,7,7,4,0,3,5,2,3,0,3,5,16,0,0,18,ITA
9f1893b9,34,21,7,11,16,6,35,29,17,0,17,11,45,8,1,18,ITA
9f84febe,1,1,1,0,0,0,0,0,0,0,0,1,2,0,0,18,ITA
9fa26bc2,0,0,0,0,0,0,0,0,0,0,0,0,0,0,0,18,ITA
Christian-Rutjens,0,0,0,0,0,0,0,0,0,0,0,0,0,0,0,18,ITA
a128b07e,19,10,8,10,1,5,27,22,14,1,13,8,27,15,0,18,ITA
a12d0c05,6,2,4,2,0,1,2,1,3,2,1,1,7,4,0,18,ITA
a1c7b425,23,14,3,11,9,8,21,13,15,0,15,7,30,4,0,18,ITA
a39b9ef6,5,5,2,2,1,1,18,17,17,3,14,3,8,13,0,18,ITA
a3e1d20d,9,7,5,4,0,5,8,3,4,3,1,6,15,17,0,18,ITA
a3e4b724,18,10,7,10,1,5,17,12,10,0,10,3,21,5,1,18,ITA
a40d5a0c,25,17,6,14,5,8,20,12,19,0,19,11,36,13,0,18,ITA
a440d8ca,1,0,0,1,0,0,0,0,0,0,0,2,3,5,0,18,ITA
a44d3a3c,1,0,0,0,1,0,5,5,3,0,3,2,3,1,0,18,ITA
a4ec7d09,0,0,0,0,0,0,0,0,0,0,0,0,0,1,0,18,ITA
a4fe8cda,11,10,2,7,2,1,10,9,11,1,10,3,14,12,0,18,ITA
a5296e55,31,19,7,21,3,9,24,15,32,3,29,13,44,19,1,18,ITA
a5cd894b,1,1,1,0,0,0,0,0,0,0,0,2,3,4,0,18,ITA
a889ffc7,4,2,2,1,1,0,1,1,1,0,1,1,5,6,0,18,ITA
a8a874f1,16,13,6,9,1,4,18,14,10,2,8,9,25,13,0,18,ITA
aa5a409a,20,13,10,7,3,4,14,10,13,2,11,4,24,16,0,18,ITA
aae9d04a,62,39,36,20,6,28,47,19,30,8,22,58,120,76,0,18,ITA
ab1ca213,40,29,18,19,3,11,41,30,26,3,23,13,53,35,0,18,ITA
ab4449d6,0,0,0,0,0,0,0,0,0,0,0,0,0,1,0,18,ITA
ac4003af,0,0,0,0,0,0,1,1,0,0,0,1,1,13,4,18,ITA
ac7e640b,39,26,15,24,0,13,33,20,31,18,13,41,80,113,1,18,ITA
acdad0aa,39,21,12,18,9,10,55,45,22,2,20,14,53,20,0,18,ITA
ad469944,12,8,2,7,3,0,4,4,8,2,6,2,14,18,0,18,ITA
ad6df2d5,36,30,13,18,5,13,51,38,25,5,20,64,100,27,2,18,ITA
ae4e2852,22,17,7,13,2,9,13,4,12,2,10,14,36,32,0,18,ITA
ae64d449,42,30,16,25,1,18,64,46,32,5,27,42,84,27,1,18,ITA
ae82fa48,17,13,7,4,6,6,20,14,10,2,8,6,23,6,0,18,ITA
aeed5c06,1,0,1,0,0,1,4,3,1,0,1,1,2,0,0,18,ITA
afa0d4e0,36,23,13,11,12,8,29,21,20,3,17,25,61,42,2,18,ITA
b0243215,4,1,1,2,1,1,3,2,5,1,4,10,14,19,0,18,ITA
b02af64f,0,0,0,0,0,0,3,3,0,0,0,0,0,0,0,18,ITA
b0f7e36c,62,41,22,22,18,16,54,38,34,1,33,18,80,16,0,18,ITA
b1deecf8,25,20,21,4,0,15,16,1,12,6,6,15,40,50,1,18,ITA
b1e61f23,3,2,3,0,0,1,3,2,2,0,2,0,3,0,0,18,ITA
b39569c0,1,1,1,0,0,0,0,0,0,0,0,0,1,0,0,18,ITA
b39dfab0,0,0,0,0,0,0,0,0,0,0,0,0,0,11,2,18,ITA
b3a20f18,3,1,3,0,0,1,3,2,3,2,1,2,5,8,0,18,ITA
b3fd7075,66,53,33,27,6,18,64,46,55,3,52,43,109,27,0,18,ITA
b4c3070a,4,4,2,2,0,1,2,1,1,0,1,3,7,1,0,18,ITA
b5365398,13,8,11,2,0,10,11,1,6,3,3,10,23,44,0,18,ITA
b5b27493,33,19,21,10,2,14,50,36,14,1,13,18,51,30,0,18,ITA
b5bf1770,11,8,8,3,0,5,8,3,4,3,1,5,16,17,0,18,ITA
b5cae4e6,10,7,0,9,1,0,10,10,2,1,1,4,14,11,0,18,ITA
b6b2b820,11,7,3,6,2,1,11,10,4,1,3,2,13,1,0,18,ITA
b6ca47a2,12,8,10,1,1,6,12,6,33,26,7,11,23,154,3,18,ITA
b70bde8f,17,13,11,6,0,9,22,13,16,3,13,22,39,10,1,18,ITA
b746d309,29,21,11,15,3,7,24,17,17,4,13,19,48,15,0,18,ITA
b7a5bc86,50,33,29,17,4,16,42,26,24,5,19,50,100,132,2,18,ITA
b8c1de25,26,18,7,12,7,9,23,14,15,4,11,23,49,19,1,18,ITA
b96b595c,51,32,26,22,3,22,36,14,42,21,21,88,139,255,1,18,ITA
ba06950a,5,4,3,1,1,3,6,3,19,14,5,20,25,113,0,18,ITA
ba3d3bea,33,25,12,19,2,5,28,23,18,5,13,37,70,20,1,18,ITA
bbafc0c4,49,33,25,20,4,14,37,23,23,5,18,20,69,61,0,18,ITA
bd6351cd,42,29,27,11,4,17,42,25,15,2,13,35,77,51,0,18,ITA
bd84fc61,40,31,20,15,5,13,43,30,7,2,5,24,64,26,0,18,ITA
be5e1c4c,8,7,1,4,3,3,11,8,7,0,7,1,9,5,0,18,ITA
be9938ed,13,8,10,3,0,5,8,3,9,3,6,7,20,23,0,18,ITA
bee704fc,39,25,20,16,3,16,29,13,18,8,10,23,62,70,0,18,ITA
bf309d24,11,9,3,7,1,1,7,6,12,2,10,9,20,5,0,18,ITA
bf57eaab,1,0,0,1,0,0,0,0,3,0,3,0,1,0,0,18,ITA
c01c66d9,33,24,19,13,1,19,30,11,13,8,5,24,57,67,0,18,ITA
c0cddebe,49,35,14,25,10,10,35,25,28,4,24,32,81,22,1,18,ITA
c15d1af9,5,3,1,2,2,0,1,1,4,1,3,1,6,6,0,18,ITA
c1c2c925,29,21,15,13,1,12,18,6,23,16,7,18,47,43,1,18,ITA
c1d18f10,4,3,3,1,0,3,4,1,6,4,2,3,7,40,0,18,ITA
c23c8e0d,0,0,0,0,0,0,3,3,0,0,0,1,1,13,0,18,ITA
c316607a,8,4,7,1,0,2,5,3,2,1,1,16,24,19,1,18,ITA
c414df9d,62,41,21,35,6,11,53,42,25,3,22,41,103,37,1,18,ITA
c4f97172,6,5,2,3,1,1,7,6,6,2,4,2,8,4,0,18,ITA
c53083ad,17,11,6,10,1,6,15,9,13,1,12,15,32,24,1,18,ITA
c56dc39e,72,40,34,38,0,35,68,33,35,14,21,63,135,119,1,18,ITA
c5942695,13,8,4,4,5,1,7,6,3,1,2,2,15,0,0,18,ITA
c5adc293,8,4,3,5,0,4,6,2,10,2,8,15,23,19,0,18,ITA
c67836b8,3,2,2,0,1,1,4,3,3,1,2,4,7,18,0,18,ITA
c693347d,9,5,3,3,3,1,7,6,7,0,7,2,11,7,0,18,ITA
c6dda86e,13,10,3,9,1,7,15,8,9,3,6,10,23,7,0,18,ITA
c707411f,23,20,14,7,2,9,15,6,31,24,7,46,69,133,2,18,ITA
c710f7d5,13,9,5,7,1,2,11,9,3,1,2,6,19,9,0,18,ITA
c7259b83,91,60,48,34,9,26,69,43,41,13,28,86,177,75,0,18,ITA
c75b6a02,85,53,40,38,7,21,63,42,46,12,34,46,131,37,1,18,ITA
c77be0cf,5,4,2,1,2,3,5,2,5,2,3,5,10,15,0,18,ITA
cc700722,107,68,24,65,18,36,104,68,52,3,49,28,135,16,0,18,ITA
cd0fa27b,37,27,11,18,8,8,31,23,29,2,27,22,59,15,0,18,ITA
cda2ec29,44,32,29,12,3,13,22,9,27,14,13,43,87,116,2,18,ITA
ce30bfc8,63,45,28,29,6,20,54,34,18,3,15,45,108,32,2,18,ITA
ce5b170a,35,26,24,5,6,11,13,2,16,3,13,23,58,37,0,18,ITA
cecbce23,0,0,0,0,0,0,1,1,0,0,0,1,1,10,3,18,ITA
cedb3e36,63,45,30,24,9,17,38,21,39,7,32,28,91,29,0,18,ITA
cfbf9881,59,34,40,17,2,25,36,11,25,6,19,28,87,95,0,18,ITA
d023d70f,66,49,25,31,10,17,77,60,40,2,38,18,84,13,0,18,ITA
d0643f8f,28,21,17,10,1,12,38,26,13,0,13,6,34,7,0,18,ITA
d0d8dd44,31,22,14,17,0,14,23,9,43,24,19,71,102,156,1,18,ITA
d0dbca9f,73,54,42,23,8,36,67,31,41,15,26,47,120,117,4,18,ITA
d0e6399c,0,0,0,0,0,0,0,0,0,0,0,0,0,0,0,18,ITA
d183e9d6,40,31,18,18,4,24,38,14,29,4,25,17,57,60,1,18,ITA
d3298c99,10,9,8,1,1,6,20,14,8,0,8,30,40,19,0,18,ITA
d37b0350,27,13,5,14,8,2,21,19,13,5,8,13,40,28,0,18,ITA
d3aaad90,22,16,9,8,5,5,21,16,16,1,15,24,46,8,0,18,ITA
d3d758d8,63,46,30,27,6,8,44,36,47,15,32,22,85,19,0,18,ITA
d3de9af0,12,7,1,7,4,1,6,5,13,0,13,5,17,22,1,18,ITA
d4535821,28,21,17,8,3,12,28,16,22,2,20,31,59,33,0,18,ITA
d4931a5a,6,5,1,4,1,0,8,8,4,1,3,3,9,12,0,18,ITA
d49f3e6b,9,8,5,3,1,1,3,2,5,0,5,2,11,2,0,18,ITA
d5bd1abc,0,0,0,0,0,0,0,0,0,0,0,0,0,0,0,18,ITA
d5c04323,1,1,1,0,0,0,0,0,0,0,0,8,9,10,1,18,ITA
d61b3354,17,7,11,6,0,4,13,9,13,5,8,29,46,43,3,18,ITA
d705ba44,32,23,9,15,8,3,30,27,14,1,13,6,38,19,1,18,ITA
d711d04f,10,9,3,6,1,2,13,11,8,0,8,4,14,5,0,18,ITA
d7403bd5,8,6,2,6,0,1,7,6,8,1,7,16,24,10,2,18,ITA
d7d32194,15,13,4,9,2,3,11,8,10,1,9,5,20,26,0,18,ITA
d85c238b,7,5,4,0,3,2,3,1,0,0,0,5,12,0,0,18,ITA
d9624b51,35,21,28,4,3,13,25,12,39,21,18,83,118,276,1,18,ITA
d97f2e8d,31,22,21,7,3,21,40,19,27,10,17,15,46,42,0,18,ITA
d995ed27,31,20,7,19,5,9,45,36,31,6,25,33,64,17,0,18,ITA
d9e750e5,5,4,2,3,0,2,6,4,1,0,1,1,6,3,0,18,ITA
da5a981b,17,10,12,4,1,4,10,6,9,1,8,8,25,28,2,18,ITA
da974c7b,54,42,31,19,4,20,40,20,36,16,20,40,94,119,3,18,ITA
dbe5a587,11,9,8,3,0,7,14,7,10,5,5,9,20,33,1,18,ITA
dc1c2fce,18,15,7,8,3,5,17,12,22,3,19,10,28,13,0,18,ITA
dc61b402,37,24,14,15,8,10,36,26,21,2,19,21,58,19,0,18,ITA
dd06d56c,0,0,0,0,0,0,0,0,0,0,0,1,1,9,0,18,ITA
de045b15,38,22,25,13,0,21,39,18,33,27,6,45,83,210,1,18,ITA
de0f152c,82,57,49,26,7,36,84,48,46,7,39,51,133,127,0,18,ITA
df301450,13,9,7,5,1,6,11,5,6,1,5,2,15,6,0,18,ITA
dfbb3234,0,0,0,0,0,0,1,1,1,0,1,0,0,0,0,18,ITA
e0314d87,58,38,34,20,4,30,54,24,24,6,18,72,130,137,0,18,ITA
e0921a4f,19,11,4,10,5,4,32,28,22,0,22,12,31,4,0,18,ITA
e0bc6fdc,0,0,0,0,0,0,0,0,0,0,0,0,0,0,0,18,ITA
e14ec482,8,7,7,1,0,2,6,4,3,1,2,3,11,4,0,18,ITA
e288d4b3,38,28,20,13,5,18,47,29,19,8,11,44,82,62,1,18,ITA
e304acd5,17,10,9,5,3,6,21,15,7,2,5,4,21,7,0,18,ITA
e327bd76,29,20,15,12,2,9,26,17,8,3,5,11,40,22,1,18,ITA
e33f36d5,65,41,40,24,1,25,39,14,43,24,19,37,102,124,1,18,ITA
e34fc66d,8,3,6,2,0,4,4,0,6,4,2,9,17,41,1,18,ITA
e358587b,1,0,1,0,0,1,2,1,0,0,0,0,1,13,2,18,ITA
e40d028b,0,0,0,0,0,0,0,0,0,0,0,0,0,11,2,18,ITA
e5bf73f3,5,2,1,3,1,2,4,2,2,0,2,1,6,2,0,18,ITA
e61bdd69,49,31,28,15,6,19,48,29,23,0,23,19,68,12,1,18,ITA
e66ebabb,0,0,0,0,0,0,0,0,0,0,0,2,2,16,4,18,ITA
e6ad16b2,36,22,10,15,11,15,37,22,35,2,33,14,50,16,0,18,ITA
e74f0e59,39,25,19,13,7,16,26,10,47,10,37,27,66,165,0,18,ITA
e85fb9b8,28,19,17,10,1,7,15,8,21,14,7,47,75,142,3,18,ITA
e8c930bb,71,41,26,38,7,28,71,43,48,2,46,71,142,52,3,18,ITA
e94d79e3,28,18,23,3,2,17,32,15,13,9,4,23,51,54,1,18,ITA
e967e202,17,7,11,4,2,8,23,15,12,1,11,6,23,16,0,18,ITA
ea06dd97,63,33,23,36,4,20,56,36,29,5,24,57,120,40,1,18,ITA
eade5337,2,1,0,2,0,0,0,0,3,0,3,0,2,1,0,18,ITA
eb0d77a4,5,5,2,3,0,1,1,0,1,0,1,0,5,0,0,18,ITA
ec30b9c8,17,13,7,8,2,7,23,16,23,2,21,18,35,25,0,18,ITA
eccbe56a,22,14,11,8,3,5,10,5,7,1,6,9,31,5,0,18,ITA
ed5886d2,70,37,27,36,7,14,58,44,49,8,41,43,113,64,0,18,ITA
ed90babd,4,3,0,2,2,1,4,3,2,0,2,0,4,2,0,18,ITA
eda40760,58,47,34,16,8,27,49,22,24,7,17,53,111,100,2,18,ITA
ee4f2f3b,11,9,1,3,7,2,25,23,34,0,34,7,18,23,0,18,ITA
ee833569,1,1,1,0,0,1,1,0,0,0,0,1,2,5,3,18,ITA
ee93c1a9,8,5,4,3,1,1,7,6,9,0,9,11,19,18,1,18,ITA
ef2e5e1a,57,38,19,24,14,15,46,31,27,3,24,27,84,21,0,18,ITA
ef5b337e,38,23,12,18,8,16,37,21,32,6,26,13,51,43,0,18,ITA
f0021247,8,4,3,3,2,2,8,6,6,1,5,4,12,5,0,18,ITA
f058ed1f,0,0,0,0,0,0,0,0,0,0,0,0,0,0,0,18,ITA
f0f7f62f,0,0,0,0,0,0,0,0,0,0,0,0,0,1,0,18,ITA
f124b4c9,25,19,16,7,2,6,27,21,12,2,10,13,38,22,0,18,ITA
f1cfc209,66,40,30,34,2,24,66,42,33,8,25,57,123,61,1,18,ITA
f2308b33,0,0,0,0,0,0,1,1,1,1,0,3,3,1,0,18,ITA
f26e3c59,54,43,31,17,6,22,59,37,38,3,35,25,79,55,1,18,ITA
f2c1300a,32,21,26,6,0,10,17,7,10,6,4,43,75,92,0,18,ITA
f45f9427,15,10,11,3,1,7,13,6,7,4,3,13,28,19,0,18,ITA
f54dfca8,18,14,8,9,1,7,24,17,8,2,6,13,31,16,1,18,ITA
f554e29b,0,0,0,0,0,0,0,0,1,0,1,0,0,12,0,18,ITA
f5e9a8bd,19,14,13,6,0,9,19,10,21,15,6,37,56,78,2,18,ITA
f68b64fc,45,32,30,15,0,22,40,18,22,5,17,28,73,59,0,18,ITA
f6a06749,0,0,0,0,0,0,0,0,0,0,0,0,0,0,0,18,ITA
f6f6b6e8,8,5,7,1,0,6,8,2,11,5,6,5,13,22,1,18,ITA
f7223718,11,6,8,2,1,4,6,2,3,0,3,3,14,32,0,18,ITA
f7c9fcd6,29,19,25,3,1,12,19,7,18,9,9,22,51,67,1,18,ITA
f91e81c9,36,27,25,10,1,21,39,18,35,14,21,31,67,82,2,18,ITA
f9714604,42,23,25,14,3,18,30,12,27,15,12,34,76,82,0,18,ITA
fa449bba,1,1,1,0,0,0,2,2,1,1,0,1,2,4,1,18,ITA
fac896b0,0,0,0,0,0,0,0,0,0,0,0,0,0,0,0,18,ITA
fb2c533b,19,12,9,9,1,5,19,14,14,3,11,17,36,13,0,18,ITA
fb77bfef,11,7,6,5,0,4,6,2,7,5,2,13,24,15,0,18,ITA
fba81826,59,40,31,22,6,21,44,23,53,15,38,64,123,66,0,18,ITA
fe48a073,1,1,0,1,0,0,3,3,2,0,2,1,2,1,0,18,ITA
fed5f993,35,21,26,8,1,16,29,13,50,38,12,50,85,161,2,18,ITA
ff120e44,1,1,0,1,0,0,0,0,0,0,0,1,2,1,0,18,ITA
ff219f73,13,8,5,5,3,0,4,4,0,0,0,5,18,6,0,18,ITA
ff800ed8,34,21,26,6,2,20,35,15,11,4,7,28,62,88,1,18,ITA
00242715,57,38,44,12,1,22,37,15,27,14,13,55,112,139,1,18,FRA
0049d544,7,4,1,3,3,1,4,3,1,0,1,4,11,4,0,18,FRA
0515a4cb,62,45,47,14,1,35,65,30,49,40,9,62,124,249,2,18,FRA
06f33dc8,17,11,4,7,6,2,10,8,5,0,5,4,21,8,0,18,FRA
06f46837,14,9,4,5,5,5,15,10,9,0,9,5,19,8,0,18,FRA
070a3904,9,3,1,5,3,1,7,6,0,0,0,3,12,3,0,18,FRA
07296190,6,4,2,3,1,3,11,8,7,1,6,7,13,4,0,18,FRA
083525e5,45,29,34,11,0,21,43,22,38,25,13,71,116,211,5,18,FRA
086d7db3,19,12,5,8,6,4,29,25,13,5,8,4,23,33,0,18,FRA
0984c5d5,34,17,13,19,2,5,30,25,9,4,5,16,50,17,0,18,FRA
0b4d8274,19,13,7,6,6,1,22,21,15,4,11,13,32,8,1,18,FRA
0d2158d5,63,38,22,36,5,18,66,48,26,9,17,40,103,25,2,18,FRA
0d57f1c1,0,0,0,0,0,0,1,1,0,0,0,1,1,1,0,18,FRA
0e12089d,0,0,0,0,0,0,0,0,0,0,0,0,0,2,0,18,FRA
0e96a5e1,3,2,0,3,0,1,2,1,0,0,0,1,4,0,0,18,FRA
0eb03d5b,18,14,11,7,0,6,14,8,18,10,8,27,45,67,0,18,FRA
0eeafda5,44,29,28,15,1,23,40,17,22,14,8,37,81,126,0,18,FRA
0f52f925,73,46,40,27,6,31,68,37,42,6,36,38,111,85,0,18,FRA
0fe7f7bc,14,8,2,9,3,0,20,20,11,0,11,6,20,23,1,18,FRA
1040e783,48,28,27,13,8,21,39,18,25,11,14,31,79,76,0,18,FRA
1061c207,0,0,0,0,0,0,0,0,0,0,0,0,0,2,2,18,FRA
10650926,14,8,7,6,1,10,15,5,11,5,6,5,19,20,0,18,FRA
10efd0e1,25,14,9,12,4,9,56,47,16,4,12,26,51,15,4,18,FRA
11ced928,11,6,1,5,5,3,11,8,6,1,5,6,17,14,1,18,FRA
1232e1dc,42,29,29,9,4,21,31,10,22,16,6,29,71,154,2,18,FRA
1251f42e,8,4,0,4,4,1,9,8,5,0,5,3,11,2,0,18,FRA
13203c45,40,27,17,19,4,15,26,11,26,3,23,15,55,52,0,18,FRA
13c44fc5,69,40,34,25,10,23,38,15,19,2,17,66,135,86,0,18,FRA
1467af0d,51,33,20,25,6,12,55,43,25,6,19,26,77,11,3,18,FRA
148e136f,65,43,31,24,10,19,77,58,31,0,31,15,80,4,2,18,FRA
15285503,0,0,0,0,0,0,0,0,0,0,0,0,0,0,0,18,FRA
1598599e,13,6,8,5,0,5,17,12,9,1,8,13,26,10,1,18,FRA
15a21c79,3,0,1,2,0,1,1,0,2,1,1,1,4,9,0,18,FRA
15e1afd5,23,17,17,5,1,10,26,16,5,3,2,26,49,48,0,18,FRA
166a981d,15,12,9,5,1,9,19,10,5,2,3,15,30,18,0,18,FRA
16714a62,38,24,26,12,0,15,32,17,42,26,16,65,103,221,1,18,FRA
167d5018,19,11,12,7,0,8,16,8,21,11,10,39,58,119,2,18,FRA
176674ab,22,12,11,8,3,9,23,14,20,0,20,12,34,7,0,18,FRA
17f29fb0,6,5,2,3,1,2,11,9,3,2,1,5,11,1,0,18,FRA
19cda00b,13,10,5,3,5,7,39,32,18,2,16,10,23,8,0,18,FRA
1a4b9094,65,42,42,20,3,22,38,16,20,4,16,32,97,53,2,18,FRA
1a6f2a66,6,4,0,4,2,1,4,3,3,0,3,3,9,1,0,18,FRA
1a992676,20,14,4,13,3,6,32,26,18,2,16,28,48,8,0,18,FRA
1ac3b888,22,12,5,10,7,6,26,20,11,2,9,9,31,13,0,18,FRA
1ad8cb67,41,34,28,12,1,22,49,27,25,12,13,51,92,112,3,18,FRA
1b82f8df,107,74,33,61,13,33,107,74,44,8,36,67,174,66,1,18,FRA
1bc6135b,1,1,1,0,0,0,5,5,1,0,1,3,4,1,0,18,FRA
1c344204,58,42,46,12,0,16,34,18,24,16,8,54,112,138,5,18,FRA
1d0900d4,2,2,2,0,0,2,2,0,0,0,0,2,4,14,2,18,FRA
1d2d5cc8,0,0,0,0,0,0,0,0,0,0,0,0,0,10,3,18,FRA
1e23a224,6,0,4,2,0,3,5,2,2,2,0,1,7,12,0,18,FRA
1ec4e202,31,14,12,14,5,11,51,40,18,1,17,16,47,20,0,18,FRA
1ec7e1c5,52,35,40,12,0,20,33,13,45,25,20,36,88,184,2,18,FRA
1f713024,26,17,23,3,0,12,31,19,20,10,10,33,59,122,2,18,FRA
1f8c7aa9,33,22,7,18,8,8,42,34,21,2,19,28,61,41,1,18,FRA
1f9a3a04,6,4,4,2,0,0,2,2,5,3,2,5,11,14,0,18,FRA
20094685,30,20,12,12,6,12,56,44,16,2,14,7,37,6,1,18,FRA
20573d10,3,2,3,0,0,1,1,0,0,0,0,1,4,2,0,18,FRA
20c2c0e8,28,18,12,11,5,7,25,18,16,3,13,11,39,15,2,18,FRA
20e73fac,55,30,18,30,7,20,93,73,48,4,44,45,100,29,0,18,FRA
2174bc8d,48,33,23,21,4,21,49,28,20,6,14,28,76,45,0,18,FRA
2235f850,3,2,1,1,1,2,5,3,0,0,0,2,5,1,0,18,FRA
22721b88,52,35,32,12,8,23,56,33,28,11,17,45,97,86,1,18,FRA
22a62523,4,1,1,1,2,1,2,1,1,0,1,1,5,0,0,18,FRA
22bfb57e,4,2,2,2,0,1,2,1,1,0,1,3,7,1,1,18,FRA
22c77851,0,0,0,0,0,0,1,1,1,0,1,0,0,0,0,18,FRA
23b6ab66,1,0,0,1,0,1,3,2,0,0,0,2,3,3,0,18,FRA
23c63b7f,0,0,0,0,0,0,2,2,1,0,1,0,0,1,0,18,FRA
2434f24a,0,0,0,0,0,0,2,2,0,0,0,3,3,13,4,18,FRA
243f4a0b,64,42,25,37,2,20,61,41,26,4,22,32,96,35,0,18,FRA
247accfd,71,51,45,22,4,24,50,26,52,26,26,58,129,148,0,18,FRA
24eb7ed6,21,12,6,11,4,6,28,22,16,0,16,20,41,18,0,18,FRA
2515040a,4,2,3,1,0,1,5,4,4,3,1,7,11,38,1,18,FRA
25444898,29,15,17,9,3,17,29,12,16,2,14,22,51,31,0,18,FRA
26383ea5,0,0,0,0,0,0,0,0,0,0,0,0,0,4,1,18,FRA
26777636,0,0,0,0,0,0,0,0,0,0,0,0,0,0,0,18,FRA
2677a1de,26,18,7,10,9,7,39,32,29,0,29,7,33,7,0,18,FRA
268c3cfc,0,0,0,0,0,0,0,0,0,0,0,0,0,2,0,18,FRA
26975a92,0,0,0,0,0,0,0,0,0,0,0,1,1,10,2,18,FRA
275e2c51,31,21,16,15,0,14,29,15,32,19,13,34,65,151,1,18,FRA
276cce2e,29,22,18,8,3,12,28,16,20,6,14,19,48,76,0,18,FRA
28a65a2c,0,0,0,0,0,0,0,0,0,0,0,0,0,3,2,18,FRA
29d8ad3f,16,15,13,3,0,10,16,6,13,7,6,16,32,96,1,18,FRA
2b16cb1a,18,14,13,2,3,12,28,16,12,1,11,11,29,10,0,18,FRA
2b622f01,1,1,0,1,0,0,1,1,0,0,0,0,1,0,0,18,FRA
2b9fdeea,44,28,16,20,8,15,46,31,22,1,21,17,61,20,0,18,FRA
2bae5658,10,3,1,6,3,1,12,11,8,0,8,2,12,5,0,18,FRA
2e0367a6,47,32,20,17,10,20,52,32,22,2,20,13,60,7,0,18,FRA
2e52206e,12,7,5,6,1,1,13,12,9,3,6,6,18,26,0,18,FRA
2f798b41,7,3,5,2,0,4,7,3,5,5,0,4,11,20,0,18,FRA
2f8f43f3,22,11,6,14,2,6,31,25,17,3,14,7,29,11,0,18,FRA
2f965a72,0,0,0,0,0,0,1,1,0,0,0,0,0,7,4,18,FRA
2fa2a875,1,1,1,0,0,0,0,0,1,0,1,0,1,14,1,18,FRA
3010aefb,40,28,17,13,10,7,35,28,22,3,19,15,55,9,0,18,FRA
30395d3b,38,30,18,16,4,11,37,26,8,2,6,12,50,7,0,18,FRA
3067cbef,20,11,14,4,2,6,10,4,14,6,8,10,30,46,0,18,FRA
3071a619,24,17,8,10,6,7,38,31,32,2,30,25,49,22,0,18,FRA
31377e38,7,3,5,1,1,4,5,1,1,0,1,2,9,2,0,18,FRA
31bbb7e2,58,37,23,29,6,25,66,41,19,0,19,24,82,22,1,18,FRA
321a71a7,48,36,28,18,2,20,41,21,36,13,23,65,113,105,4,18,FRA
3250c6cd,4,3,1,1,2,2,6,4,1,0,1,0,4,1,0,18,FRA
346c15cc,1,0,1,0,0,0,2,2,1,0,1,2,3,0,0,18,FRA
34cfec6b,8,5,4,4,0,4,20,16,5,3,2,9,17,19,0,18,FRA
35c5f9b1,4,4,2,2,0,1,7,6,0,0,0,0,4,2,0,18,FRA
3681cfff,39,26,27,12,0,16,30,14,38,27,11,56,95,241,1,18,FRA
375622c5,20,11,8,11,1,7,20,13,11,1,10,5,25,11,2,18,FRA
3767b3b7,74,42,55,18,1,31,69,38,57,26,31,84,158,135,3,18,FRA
378825c7,56,39,31,21,4,26,55,29,24,16,8,37,93,177,1,18,FRA
3814120d,0,0,0,0,0,0,2,2,0,0,0,1,1,6,3,18,FRA
392d98fc,32,23,16,9,7,8,25,17,22,3,19,18,50,15,0,18,FRA
3acddfdd,7,5,1,3,3,0,2,2,5,0,5,2,9,2,0,18,FRA
3befc2b6,57,38,15,37,5,21,52,31,32,7,25,15,72,45,1,18,FRA
3cefcaef,45,28,29,13,3,20,31,11,18,5,13,25,70,43,0,18,FRA
3dd738a1,91,50,37,41,13,36,71,35,25,3,22,37,128,90,0,18,FRA
3e016e5a,10,9,3,4,3,1,11,10,11,1,10,5,15,1,0,18,FRA
3e092724,9,7,4,4,1,2,11,9,7,1,6,11,20,7,2,18,FRA
3e87d087,0,0,0,0,0,0,0,0,0,0,0,1,1,1,0,18,FRA
3eaf8817,8,5,4,0,4,0,7,7,6,2,4,2,10,11,0,18,FRA
3f5b4635,62,46,36,24,2,31,59,28,29,16,13,56,118,124,2,18,FRA
3f944dad,0,0,0,0,0,0,0,0,1,1,0,0,0,0,0,18,FRA
41e7ef1c,44,32,20,15,9,15,39,24,16,3,13,35,79,41,2,18,FRA
42eaa028,13,10,3,6,4,4,14,10,8,0,8,6,19,3,0,18,FRA
42fd9c7f,12,9,3,4,5,1,13,12,4,1,3,1,13,1,0,18,FRA
4315f30d,24,18,17,7,0,8,18,10,14,6,8,31,55,44,2,18,FRA
43e7a164,65,43,52,11,2,25,52,27,34,5,29,57,122,155,2,18,FRA
446aa6e1,21,15,17,3,1,14,37,23,18,16,2,20,41,129,2,18,FRA
44f8c299,62,45,21,37,4,20,67,47,41,6,35,32,94,19,0,18,FRA
45076ff8,10,5,5,5,0,1,8,7,9,1,8,2,12,2,0,18,FRA
450e277f,13,7,10,3,0,7,20,13,14,11,3,21,34,120,0,18,FRA
45e17712,25,12,15,8,2,7,17,10,15,4,11,14,39,33,0,18,FRA
4657faba,1,0,1,0,0,0,4,4,0,0,0,0,1,4,0,18,FRA
468fdbad,73,50,41,28,4,17,54,37,30,3,27,33,106,36,0,18,FRA
46d50339,29,21,21,8,0,11,26,15,18,6,12,16,45,47,0,18,FRA
46faabfa,6,5,4,1,1,2,8,6,6,0,6,4,10,8,0,18,FRA
4749367a,9,5,6,3,0,5,10,5,6,1,5,2,11,5,0,18,FRA
47c2e669,5,3,3,1,1,2,6,4,1,0,1,0,5,6,0,18,FRA
4887118d,0,0,0,0,0,0,0,0,2,0,2,0,0,2,0,18,FRA
48b28bfd,70,34,32,37,1,17,55,38,29,7,22,75,145,58,1,18,FRA
4914ed4a,28,20,19,4,5,19,31,12,21,6,15,37,65,83,1,18,FRA
4a57580c,33,25,9,19,5,11,48,37,15,2,13,13,46,23,1,18,FRA
4b96c347,21,11,9,8,4,8,27,19,21,2,19,20,41,7,0,18,FRA
4be0b467,3,0,1,2,0,0,3,3,5,1,4,1,4,8,0,18,FRA
4bf69118,8,6,6,2,0,7,11,4,2,0,2,1,9,7,0,18,FRA
4c5b714f,59,39,24,27,8,23,45,22,20,4,16,46,105,52,1,18,FRA
4c700f46,37,18,22,14,1,20,53,33,22,12,10,37,74,92,3,18,FRA
4d1666ff,26,19,19,7,0,13,17,4,14,11,3,14,40,97,0,18,FRA
4d3e9033,0,0,0,0,0,0,0,0,0,0,0,0,0,0,1,18,FRA
4db2157a,73,45,29,42,2,18,61,43,37,15,22,34,107,53,1,18,FRA
4dbd0916,33,17,9,19,5,10,41,31,22,1,21,18,51,16,1,18,FRA
4df04a86,0,0,0,0,0,0,0,0,0,0,0,0,0,0,0,18,FRA
4e0afc5d,89,68,58,26,5,36,56,20,46,16,30,39,128,72,2,18,FRA
4e7bfc23,14,9,4,9,1,4,25,21,15,1,14,8,22,5,0,18,FRA
4e7d66f8,143,86,63,71,9,46,119,73,70,10,60,53,196,91,0,18,FRA
4e7db402,1,0,1,0,0,1,4,3,0,0,0,2,3,20,5,18,FRA
4f093689,4,4,1,3,0,0,1,1,0,0,0,1,5,0,0,18,FRA
5046b7d4,16,11,3,8,5,4,22,18,18,1,17,9,25,1,0,18,FRA
509a4ccb,12,8,5,6,1,1,11,10,10,1,9,6,18,5,0,18,FRA
5148dcc5,42,30,16,23,3,9,28,19,11,1,10,14,56,6,0,18,FRA
516dc25b,24,14,7,17,0,7,31,24,18,6,12,21,45,15,0,18,FRA
51a3caf1,6,5,5,1,0,3,6,3,2,2,0,3,9,16,0,18,FRA
51c30111,37,18,9,24,4,8,39,31,19,5,14,30,67,25,0,18,FRA
51fa3fed,1,1,0,1,0,0,1,1,1,0,1,0,1,0,0,18,FRA
527f063d,15,9,5,4,6,2,16,14,10,1,9,5,20,22,0,18,FRA
53283127,23,17,15,6,2,9,24,15,11,3,8,19,42,31,1,18,FRA
535b0343,8,6,7,1,0,3,9,6,7,4,3,4,12,15,1,18,FRA
54131505,12,9,4,6,2,3,7,4,5,0,5,1,13,1,0,18,FRA
542cc80f,68,45,27,39,2,12,54,42,20,1,19,57,125,26,0,18,FRA
563fcd6b,2,2,2,0,0,2,4,2,1,0,1,2,4,1,0,18,FRA
5693aa98,0,0,0,0,0,0,0,0,0,0,0,1,1,0,0,18,FRA
56b52c4e,6,5,3,2,1,4,6,2,4,1,3,4,10,3,0,18,FRA
56f7a928,47,24,14,28,5,17,55,38,24,5,19,34,81,20,1,18,FRA
574aa9ec,4,2,3,1,0,1,3,2,0,0,0,3,7,6,0,18,FRA
57c433c8,5,4,1,2,2,0,7,7,4,0,4,2,7,11,0,18,FRA
57e3f0c7,30,18,14,11,5,11,42,31,23,0,23,10,40,20,0,18,FRA
57ef0d97,28,21,14,11,3,8,24,16,15,6,9,21,49,26,1,18,FRA
58ae47b2,22,11,5,13,4,8,37,29,19,2,17,19,41,7,1,18,FRA
5984e9f9,13,8,8,5,0,5,9,4,6,3,3,11,24,54,1,18,FRA
5aca2a18,0,0,0,0,0,0,0,0,0,0,0,0,0,0,0,18,FRA
5b1bf5e3,54,32,14,27,13,9,40,31,33,3,30,26,80,19,0,18,FRA
5c4dc0ff,16,11,0,5,11,2,23,21,9,1,8,3,19,20,0,18,FRA
5cdddffa,68,44,25,35,8,12,44,32,57,8,49,41,109,12,0,18,FRA
5ceba7fc,17,8,2,5,10,5,29,24,13,0,13,15,32,2,0,18,FRA
5cec2c74,27,14,5,20,2,11,37,26,23,6,17,26,53,16,1,18,FRA
5d42d487,11,8,5,3,3,3,13,10,7,0,7,3,14,5,0,18,FRA
5d59e0df,19,11,3,9,7,5,33,28,27,3,24,9,28,50,0,18,FRA
5d66c10d,3,2,0,2,1,1,6,5,5,1,4,3,6,2,0,18,FRA
5d8d7454,136,89,71,58,7,50,105,55,43,13,30,88,224,136,0,18,FRA
5e22e2a4,59,40,25,29,5,23,83,60,39,8,31,43,102,48,2,18,FRA
5e6342d4,41,27,23,16,2,22,48,26,19,1,18,18,59,18,0,18,FRA
6043997c,4,2,4,0,0,0,3,3,2,2,0,3,7,18,2,18,FRA
60d90c55,0,0,0,0,0,0,0,0,0,0,0,0,0,2,0,18,FRA
61590953,0,0,0,0,0,0,1,1,0,0,0,0,0,1,0,18,FRA
6191093d,23,14,10,12,1,7,36,29,15,3,12,19,42,9,1,18,FRA
61d618fa,11,8,5,3,3,2,11,9,3,0,3,2,13,3,0,18,FRA
639b42f5,2,1,2,0,0,2,2,0,3,0,3,5,7,2,0,18,FRA
6421dd73,35,25,15,15,5,7,39,32,24,3,21,28,63,12,0,18,FRA
64ba07c0,43,31,33,7,3,17,28,11,11,2,9,9,52,35,0,18,FRA
65585e3a,23,15,6,12,5,6,16,10,13,0,13,13,36,5,0,18,FRA
6605d143,0,0,0,0,0,0,0,0,0,0,0,0,0,0,0,18,FRA
66116290,11,6,0,8,3,2,13,11,13,3,10,10,21,11,0,18,FRA
6690ef25,62,50,37,19,6,23,41,18,36,25,11,44,106,152,0,18,FRA
677ee102,39,28,20,19,0,15,26,11,29,10,19,30,69,42,0,18,FRA
67ac5bb8,1,1,1,0,0,0,1,1,2,1,1,0,1,4,1,18,FRA
67d251a2,9,7,5,3,1,4,9,5,6,3,3,8,17,14,0,18,FRA
6853490f,15,10,3,7,5,1,28,27,13,1,12,14,29,6,0,18,FRA
689c9cf4,43,30,25,14,4,14,24,10,21,1,20,14,57,50,0,18,FRA
68a87d66,11,9,6,1,4,2,11,9,3,0,3,7,18,7,0,18,FRA
69384e5d,20,14,3,11,6,7,40,33,4,0,4,5,25,2,0,18,FRA
6aeb647a,20,14,10,9,1,11,14,3,10,8,2,17,37,58,1,18,FRA
6afaebf2,0,0,0,0,0,0,3,3,2,0,2,0,0,2,0,18,FRA
6b200d45,39,26,28,10,1,21,31,10,35,22,13,36,75,142,1,18,FRA
6b994195,36,27,23,13,0,11,24,13,19,15,4,31,67,113,1,18,FRA
6b9f2f3e,9,7,5,3,1,3,6,3,2,2,0,7,16,11,0,18,FRA
6ba71da5,26,16,20,6,0,10,16,6,30,22,8,31,57,128,2,18,FRA
6bb2c084,88,65,23,57,8,32,94,62,50,7,43,67,155,46,3,18,FRA
6bca20fe,9,5,4,5,0,4,7,3,0,0,0,2,11,0,0,18,FRA
6c203af0,67,50,30,32,5,19,39,20,13,2,11,31,98,31,1,18,FRA
6c6ecdd4,48,36,15,29,4,15,33,18,20,4,16,20,68,29,0,18,FRA
6ca88b2a,28,15,20,7,1,10,34,24,23,7,16,27,55,75,0,18,FRA
6dfd8f05,0,0,0,0,0,0,0,0,0,0,0,0,0,0,0,18,FRA
6e5b5a45,17,13,11,6,0,6,12,6,10,4,6,19,36,24,1,18,FRA
6e7f1353,64,40,13,34,17,21,71,50,30,0,30,25,89,5,1,18,FRA
6f5ead86,21,13,9,9,3,10,22,12,15,2,13,6,27,5,0,18,FRA
6f8cd6d0,20,15,6,10,4,6,25,19,14,0,14,5,25,12,0,18,FRA
6fb7edd3,4,3,1,1,2,1,16,15,7,0,7,3,7,1,0,18,FRA
6fbde63a,62,41,21,31,10,17,62,45,31,4,27,28,90,14,0,18,FRA
706a60e1,5,5,3,2,0,0,2,2,1,0,1,0,5,0,0,18,FRA
70d8e84c,43,30,33,10,0,28,40,12,18,11,7,16,59,97,0,18,FRA
71ec39ef,98,59,41,55,2,38,98,60,41,16,25,52,150,79,0,18,FRA
730bd100,12,6,4,5,3,2,5,3,2,0,2,3,15,2,0,18,FRA
743fd71f,0,0,0,0,0,0,3,3,2,0,2,0,0,0,0,18,FRA
75a63397,27,22,11,12,4,5,21,16,10,0,10,18,45,13,0,18,FRA
75d97aa6,19,14,13,4,2,5,40,35,21,2,19,20,39,17,0,18,FRA
76806215,0,0,0,0,0,0,1,1,0,0,0,1,1,2,0,18,FRA
770d7eb8,87,47,53,28,6,21,47,26,18,10,8,42,129,70,2,18,FRA
775185ae,0,0,0,0,0,0,0,0,0,0,0,0,0,0,0,18,FRA
7768df30,32,19,24,7,1,10,32,22,37,24,13,53,85,152,4,18,FRA
776972d5,10,8,4,3,3,2,7,5,7,0,7,1,11,1,0,18,FRA
779847d6,39,28,25,9,5,18,36,18,34,19,15,35,74,182,3,18,FRA
77d7c96f,37,25,24,10,3,15,26,11,20,7,13,29,66,52,0,18,FRA
77f278a0,10,6,2,5,3,2,9,7,5,0,5,3,13,0,0,18,FRA
7844c810,0,0,0,0,0,0,0,0,0,0,0,0,0,0,0,18,FRA
79584585,12,4,4,7,1,8,12,4,3,1,2,6,18,6,0,18,FRA
7961f7aa,37,22,10,18,9,11,35,24,32,1,31,24,61,30,0,18,FRA
79685569,10,8,1,8,1,3,10,7,13,5,8,8,18,8,0,18,FRA
796b1c41,57,25,22,27,8,15,50,35,12,2,10,27,84,9,0,18,FRA
79b2399c,50,37,29,17,4,16,70,54,29,0,29,34,84,26,0,18,FRA
7a137df4,0,0,0,0,0,0,0,0,0,0,0,0,0,0,0,18,FRA
7abfcbff,21,15,9,7,5,5,15,10,22,0,22,15,36,8,0,18,FRA
7add56e1,0,0,0,0,0,0,1,1,5,3,2,1,1,2,0,18,FRA
7adea561,43,25,35,7,1,17,39,22,25,16,9,28,71,121,0,18,FRA
7af0e1f8,81,59,50,26,5,41,80,39,21,7,14,39,120,73,0,18,FRA
7b075c75,9,5,7,2,0,2,3,1,22,16,6,16,25,50,1,18,FRA
7b536033,0,0,0,0,0,0,0,0,0,0,0,0,0,0,0,18,FRA
7c2965bb,55,32,15,27,13,21,78,57,23,2,21,16,71,22,0,18,FRA
7c56da38,5,2,2,2,1,3,14,11,8,2,6,5,10,2,1,18,FRA
7c6d6c96,42,29,32,8,2,22,31,9,58,47,11,49,91,191,6,18,FRA
7cab69b5,48,32,32,15,1,24,31,7,46,32,14,56,104,169,1,18,FRA
7cb9de24,0,0,0,0,0,0,0,0,0,0,0,0,0,3,0,18,FRA
7cdda3bf,9,7,1,6,2,2,7,5,8,2,6,1,10,7,1,18,FRA
7cf431a5,31,21,9,19,3,6,41,35,21,1,20,18,49,14,1,18,FRA
7cf9f0ed,17,11,5,9,3,10,23,13,5,0,5,6,23,11,0,18,FRA
7d45b97a,20,16,12,7,1,9,14,5,12,2,10,9,29,35,0,18,FRA
7d9b37bf,12,8,4,7,1,5,21,16,14,1,13,14,26,10,0,18,FRA
7de29631,0,0,0,0,0,0,0,0,0,0,0,0,0,0,0,18,FRA
7e82a78f,25,18,10,12,3,3,25,22,8,1,7,11,36,8,0,18,FRA
7f3b388c,114,64,38,67,9,48,112,64,48,13,35,43,157,62,0,18,FRA
7f622eef,32,21,14,14,4,13,34,21,29,2,27,11,43,16,2,18,FRA
7f9111ea,49,36,28,17,4,20,37,17,16,7,9,34,83,64,1,18,FRA
7fb301af,2,2,1,0,1,1,2,1,2,0,2,4,6,14,0,18,FRA
7fecbcdb,29,22,23,6,0,16,30,14,8,1,7,11,40,52,0,18,FRA
7ffaf233,6,5,2,2,2,1,9,8,10,0,10,1,7,7,0,18,FRA
813aae2f,11,10,4,6,1,3,10,7,10,0,10,9,20,6,0,18,FRA
81aeb1dd,14,8,8,5,1,8,17,9,4,1,3,3,17,4,0,18,FRA
81d3318f,32,24,11,14,7,10,35,25,18,2,16,15,47,8,0,18,FRA
81d9a76b,0,0,0,0,0,0,0,0,0,0,0,1,1,0,0,18,FRA
821233cc,23,14,16,7,0,10,27,17,13,9,4,18,41,96,1,18,FRA
82671804,89,54,45,40,4,26,62,36,44,13,31,50,139,56,1,18,FRA
833a91a1,16,11,6,9,1,5,17,12,12,1,11,10,26,25,0,18,FRA
8417953b,0,0,0,0,0,0,0,0,0,0,0,0,0,2,0,18,FRA
84549a07,17,11,6,9,2,4,14,10,12,0,12,7,24,6,1,18,FRA
84d94b91,81,49,33,43,5,34,87,53,52,17,35,55,136,81,2,18,FRA
85322440,9,7,3,4,2,3,11,8,3,1,2,12,21,13,0,18,FRA
857e2586,0,0,0,0,0,0,1,1,2,0,2,0,0,0,0,18,FRA
85a44ecc,26,17,13,10,3,10,35,25,15,1,14,8,34,10,0,18,FRA
8614496d,3,1,3,0,0,3,5,2,2,1,1,3,6,12,0,18,FRA
86a2ba20,5,2,2,2,1,2,3,1,1,0,1,5,10,0,0,18,FRA
86e7deaf,31,23,19,12,0,12,21,9,28,18,10,18,49,114,0,18,FRA
871fc5f8,1,0,0,1,0,0,1,1,1,0,1,1,2,0,0,18,FRA
872cd68c,48,30,40,6,2,16,39,23,23,5,18,37,85,75,1,18,FRA
8730ed6a,0,0,0,0,0,0,0,0,0,0,0,0,0,0,0,18,FRA
873ce3a2,0,0,0,0,0,0,0,0,0,0,0,0,0,0,0,18,FRA
8746d5d0,18,12,13,5,0,7,20,13,6,0,6,13,31,23,0,18,FRA
8794e251,59,36,27,23,9,15,36,21,29,10,19,33,92,22,1,18,FRA
8802c1d5,29,25,17,9,3,10,36,26,14,0,14,5,34,15,0,18,FRA
881ef58c,33,21,9,16,8,5,23,18,13,0,13,10,43,14,1,18,FRA
883f251e,9,9,2,3,4,3,7,4,6,3,3,2,11,21,0,18,FRA
88615858,20,9,9,8,3,4,28,24,11,0,11,15,35,13,0,18,FRA
88fdac8b,8,4,8,0,0,4,4,0,6,4,2,8,16,22,1,18,FRA
8a2248b4,0,0,0,0,0,0,2,2,0,0,0,0,0,5,3,18,FRA
8b298f56,24,15,4,13,7,12,42,30,16,1,15,14,38,15,1,18,FRA
8ba3a754,8,5,7,1,0,5,10,5,5,2,3,6,14,7,0,18,FRA
8c2c48a9,3,1,0,3,0,1,6,5,0,0,0,2,5,3,0,18,FRA
8cb8dc58,13,7,6,7,0,9,12,3,14,11,3,16,29,72,0,18,FRA
8d043f1d,16,9,7,6,3,5,13,8,6,1,5,10,26,1,0,18,FRA
8da74c05,58,36,32,21,5,26,47,21,26,5,21,41,99,22,1,18,FRA
8dbff17c,39,29,22,15,2,22,41,19,25,19,6,45,84,163,3,18,FRA
8e2d5426,22,12,10,10,2,5,26,21,13,5,8,30,52,18,0,18,FRA
8e87af42,10,8,3,6,1,2,7,5,2,0,2,5,15,0,0,18,FRA
8eec784d,1,1,1,0,0,1,1,0,0,0,0,0,1,0,0,18,FRA
8f325097,21,11,12,8,1,7,16,9,5,2,3,13,34,12,0,18,FRA
8f696594,13,9,4,3,6,3,28,25,15,0,15,9,22,5,0,18,FRA
8f898ba8,3,1,0,2,1,0,4,4,3,1,2,0,3,8,0,18,FRA
8ff07990,7,4,1,3,3,0,6,6,9,2,7,8,15,26,0,18,FRA
8ff4872e,44,29,24,15,5,22,42,20,20,2,18,48,92,74,0,18,FRA
9001138b,6,4,1,3,2,1,16,15,9,1,8,5,11,4,0,18,FRA
909222de,50,32,12,29,9,7,35,28,21,0,21,19,69,9,0,18,FRA
90fcf472,33,22,17,11,5,7,26,19,15,1,14,15,48,4,0,18,FRA
91e58f66,55,40,26,26,3,15,61,46,32,10,22,61,116,47,1,18,FRA
91f2da4c,12,7,1,6,5,2,10,8,12,2,10,4,16,13,0,18,FRA
92232aad,34,25,22,8,4,17,30,13,16,10,6,27,61,73,0,18,FRA
9260926b,43,29,24,19,0,14,27,13,30,13,17,41,84,70,3,18,FRA
92b56413,25,20,12,9,4,5,13,8,12,0,12,12,37,16,1,18,FRA
933d3b51,55,39,32,20,3,19,29,10,34,15,19,45,100,126,0,18,FRA
942c6dc3,1,1,0,1,0,0,1,1,0,0,0,0,1,0,0,18,FRA
9453d2f4,4,1,0,2,2,0,5,5,4,1,3,2,6,1,0,18,FRA
950ff24d,0,0,0,0,0,0,0,0,0,0,0,0,0,0,3,18,FRA
96908f80,0,0,0,0,0,0,0,0,0,0,0,0,0,0,0,18,FRA
96fcd380,0,0,0,0,0,0,0,0,0,0,0,0,0,1,2,18,FRA
97b87472,1,0,1,0,0,0,4,4,0,0,0,0,1,1,0,18,FRA
97fb4608,32,20,13,15,4,10,28,18,15,6,9,32,64,31,0,18,FRA
9836e892,2,2,1,1,0,0,1,1,0,0,0,0,2,0,0,18,FRA
9980269a,6,6,3,1,2,2,4,2,0,0,0,0,6,6,0,18,FRA
9a1f2e1c,54,28,30,18,6,22,43,21,20,3,17,42,96,53,0,18,FRA
9a493fb7,16,8,9,5,2,5,16,11,8,3,5,19,35,7,1,18,FRA
9a506145,18,12,7,11,0,3,17,14,11,2,9,16,34,39,0,18,FRA
9ae9eaea,34,20,22,8,4,14,29,15,14,6,8,26,60,69,0,18,FRA
9b6d9b53,73,54,47,23,3,26,68,42,43,9,34,58,131,124,0,18,FRA
9b8970ce,9,5,5,3,1,2,4,2,5,3,2,7,16,8,0,18,FRA
9dafff2a,20,13,8,12,0,6,13,7,7,1,6,12,32,11,0,18,FRA
9dd5da03,2,1,0,1,1,1,1,0,1,1,0,1,3,2,1,18,FRA
9e27e5de,16,11,5,9,2,8,31,23,20,4,16,11,27,8,0,18,FRA
9f29c204,64,44,37,22,5,23,49,26,25,5,20,59,123,91,1,18,FRA
9f6325f9,6,3,4,2,0,2,4,2,7,0,7,4,10,14,0,18,FRA
9ffdf29a,0,0,0,0,0,0,0,0,0,0,0,0,0,0,0,18,FRA
a0791826,5,1,4,1,0,3,6,3,1,0,1,1,6,2,0,18,FRA
a08b974a,83,57,30,44,9,30,93,63,42,3,39,30,113,26,0,18,FRA
a0f9b535,50,36,26,18,6,18,78,60,43,4,39,20,70,17,1,18,FRA
a1017967,31,23,22,9,0,18,32,14,18,8,10,34,65,87,1,18,FRA
a1d04509,18,11,6,10,2,4,14,10,16,4,12,6,24,9,0,18,FRA
a2da58b1,0,0,0,0,0,0,0,0,0,0,0,0,0,0,0,18,FRA
a3d524cb,0,0,0,0,0,0,1,1,0,0,0,0,0,5,2,18,FRA
a44d3a3c,0,0,0,0,0,0,2,2,1,0,1,0,0,0,0,18,FRA
a4527d33,1,1,1,0,0,1,3,2,0,0,0,3,4,9,2,18,FRA
a4b1028a,79,55,43,31,5,41,66,25,31,12,19,61,140,117,0,18,FRA
a4c3f7af,23,15,8,14,1,8,32,24,11,6,5,18,41,25,2,18,FRA
a51728e3,7,5,5,1,1,5,7,2,2,0,2,5,12,43,0,18,FRA
a557e6b0,12,9,5,6,1,5,15,10,7,4,3,46,58,21,0,18,FRA
a56bd2ee,0,0,0,0,0,0,1,1,0,0,0,0,0,14,4,18,FRA
a5876fca,12,7,3,4,5,8,13,5,11,2,9,3,15,34,0,18,FRA
a5db0bec,66,42,22,39,5,20,66,46,30,0,30,39,105,34,0,18,FRA
a6138e4a,12,9,4,6,2,4,14,10,5,0,5,10,22,13,0,18,FRA
a712ca2b,58,43,35,22,1,21,48,27,38,25,13,76,134,128,0,18,FRA
a8797cf1,54,37,21,26,7,24,56,32,30,5,25,38,92,41,2,18,FRA
a87e9eb6,4,1,3,1,0,3,3,0,1,0,1,1,5,0,0,18,FRA
a8b4a643,27,19,8,18,1,8,28,20,20,8,12,25,52,64,1,18,FRA
aa1a8c7e,16,11,4,8,4,6,16,10,8,1,7,4,20,5,0,18,FRA
aad56ca3,1,1,1,0,0,0,1,1,0,0,0,2,3,0,0,18,FRA
ab914649,8,5,3,3,2,2,5,3,6,0,6,4,12,7,0,18,FRA
abccacf7,1,0,0,0,1,0,0,0,0,0,0,0,1,2,0,18,FRA
ac62861c,40,27,10,25,5,14,75,61,52,7,45,49,89,58,2,18,FRA
ac73ec79,70,55,41,25,4,25,44,19,26,14,12,73,143,104,2,18,FRA
ad625c12,0,0,0,0,0,0,3,3,1,0,1,2,2,2,1,18,FRA
adf825b9,0,0,0,0,0,0,0,0,0,0,0,1,1,0,0,18,FRA
ae59b359,13,9,8,5,0,3,14,11,8,1,7,7,20,6,1,18,FRA
ae7d0ecd,0,0,0,0,0,0,1,1,0,0,0,3,3,9,1,18,FRA
ae82fa48,0,0,0,0,0,0,0,0,4,0,4,1,1,0,0,18,FRA
aef6e670,39,28,20,18,1,9,14,5,17,10,7,24,63,80,1,18,FRA
af0c835b,15,7,6,7,2,5,8,3,7,1,6,3,18,4,0,18,FRA
b0547a87,37,30,10,16,11,10,38,28,28,4,24,21,58,14,0,18,FRA
b056e3da,1,0,1,0,0,1,2,1,0,0,0,1,2,12,3,18,FRA
b18a3023,58,31,36,22,0,28,50,22,26,16,10,56,114,153,1,18,FRA
b2bd0f6c,30,21,18,11,1,12,61,49,30,4,26,19,49,17,0,18,FRA
b396a0b1,5,2,2,1,2,4,8,4,1,0,1,4,9,3,0,18,FRA
b4a014b1,70,42,51,15,4,28,38,10,50,29,21,29,99,155,3,18,FRA
b4c816a9,2,2,0,2,0,0,2,2,0,0,0,0,2,1,0,18,FRA
b51242ef,34,18,21,10,3,8,23,15,9,3,6,37,71,39,1,18,FRA
b666421b,54,32,40,13,1,14,29,15,25,10,15,52,106,132,2,18,FRA
b6dac747,28,17,14,12,2,11,43,32,9,2,7,19,47,13,0,18,FRA
b6e50615,39,27,21,11,7,12,25,13,15,2,13,24,63,53,0,18,FRA
b7e7937d,0,0,0,0,0,0,0,0,0,0,0,0,0,0,0,18,FRA
b82880c6,0,0,0,0,0,0,0,0,0,0,0,1,1,8,0,18,FRA
b86fe156,29,19,10,15,4,7,29,22,17,2,15,20,49,13,3,18,FRA
b92edde2,53,29,32,16,5,28,51,23,14,6,8,35,88,63,1,18,FRA
b931d9d1,71,48,48,18,5,41,65,24,21,1,20,28,99,50,0,18,FRA
b99bec05,44,32,22,16,6,19,47,28,31,4,27,34,78,65,1,18,FRA
bb4a42be,11,9,4,6,1,4,15,11,7,1,6,7,18,2,0,18,FRA
bc270726,1,0,1,0,0,1,1,0,0,0,0,4,5,15,4,18,FRA
bc6bd723,15,9,5,7,3,5,32,27,14,3,11,8,23,21,0,18,FRA
bcb98316,9,5,2,5,2,3,4,1,7,3,4,4,13,2,0,18,FRA
bcc81786,59,43,45,10,4,22,31,9,25,7,18,45,104,127,1,18,FRA
bced0375,72,47,35,34,3,29,69,40,33,7,26,24,96,19,1,18,FRA
bcf1b2e9,6,4,5,1,0,5,7,2,2,0,2,2,8,35,1,18,FRA
bd4f5f94,20,10,15,4,1,10,27,17,12,6,6,31,51,66,0,18,FRA
beb391dd,17,12,6,9,2,3,25,22,11,1,10,14,31,14,0,18,FRA
bece776f,45,33,11,24,10,8,40,32,11,0,11,8,53,5,0,18,FRA
beff5d14,4,4,1,3,0,0,4,4,7,0,7,3,7,3,0,18,FRA
bf354e77,9,6,4,5,0,1,4,3,7,1,6,1,10,0,0,18,FRA
bfdb33aa,20,10,5,10,5,7,29,22,17,0,17,9,29,3,1,18,FRA
c0cddebe,1,1,1,0,0,0,0,0,2,1,1,0,1,0,0,18,FRA
c121a641,0,0,0,0,0,0,1,1,0,0,0,0,0,0,0,18,FRA
c1febb46,65,45,21,36,8,14,54,40,34,2,32,34,99,35,0,18,FRA
c2211709,89,54,34,47,8,37,88,51,59,10,49,77,166,57,4,18,FRA
c26a3918,84,49,56,22,6,42,76,34,34,2,32,34,118,103,0,18,FRA
c27dfb82,50,31,14,32,4,15,50,35,27,0,27,25,75,27,0,18,FRA
c3512013,13,9,9,2,2,6,13,7,9,1,8,7,20,15,0,18,FRA
c3725db2,15,13,10,5,0,5,12,7,11,6,5,26,41,62,1,18,FRA
c4527123,5,3,3,2,0,2,6,4,8,7,1,6,11,23,0,18,FRA
c46fa34c,47,28,17,27,3,15,64,49,35,2,33,32,79,30,0,18,FRA
c47541e0,32,20,7,20,5,10,35,25,24,3,21,39,71,31,1,18,FRA
c4bbea9f,44,26,33,11,0,13,36,23,28,14,14,58,102,140,5,18,FRA
c53083ad,25,16,12,10,3,7,29,22,12,1,11,11,36,22,0,18,FRA
c58270f8,6,4,0,5,1,0,3,3,3,1,2,2,8,15,0,18,FRA
c5a500ca,63,36,28,21,14,24,72,48,39,2,37,14,77,30,0,18,FRA
c6056d58,36,23,22,12,2,15,29,14,28,18,10,54,90,279,2,18,FRA
c650629d,33,23,10,20,3,4,34,30,15,4,11,21,54,7,0,18,FRA
c69ef855,57,37,23,30,4,22,69,47,27,6,21,31,88,31,0,18,FRA
c6ac6579,3,2,1,2,0,1,4,3,1,1,0,0,3,2,0,18,FRA
c6e5d20f,25,16,10,11,4,5,23,18,21,3,18,25,50,29,0,18,FRA
c76b7567,71,52,41,23,7,22,73,51,58,4,54,18,89,20,0,18,FRA
c801616a,92,59,35,46,11,28,120,92,40,5,35,40,132,45,1,18,FRA
c8c02ac7,17,12,10,5,2,9,25,16,10,2,8,12,29,44,0,18,FRA
c8c60119,51,29,31,13,7,18,30,12,15,2,13,22,73,61,0,18,FRA
c9e99e49,80,57,45,27,8,33,58,25,24,3,21,28,108,21,0,18,FRA
cac76a72,0,0,0,0,0,0,0,0,0,0,0,0,0,14,1,18,FRA
cb9ec45d,11,7,7,4,0,7,11,4,3,1,2,4,15,12,0,18,FRA
cc41f558,14,8,13,1,0,5,14,9,10,2,8,5,19,17,0,18,FRA
cc77354e,14,14,9,5,0,8,12,4,7,3,4,3,17,18,0,18,FRA
ccb1c3af,12,7,2,7,3,1,11,10,11,0,11,1,13,2,0,18,FRA
ccbbe661,9,8,3,5,1,0,7,7,2,1,1,3,12,11,0,18,FRA
cd387ff4,33,20,21,12,0,7,22,15,33,18,15,46,79,116,3,18,FRA
cdf65d12,36,26,22,13,1,15,22,7,19,15,4,15,51,72,2,18,FRA
ce17b5eb,0,0,0,0,0,0,0,0,0,0,0,0,0,1,0,18,FRA
ce316f8c,24,13,14,8,2,5,19,14,16,1,15,8,32,6,1,18,FRA
ce492295,15,12,9,6,0,9,12,3,13,7,6,16,31,98,2,18,FRA
cee88597,34,22,22,6,6,12,28,16,23,9,14,27,61,64,1,18,FRA
cf4053e2,16,11,9,7,0,6,27,21,18,1,17,10,26,15,0,18,FRA
cfd8dde3,28,19,5,16,7,6,28,22,18,1,17,11,39,11,0,18,FRA
cfe852d8,0,0,0,0,0,0,2,2,0,0,0,0,0,12,3,18,FRA
d14229f3,27,15,11,8,8,11,42,31,22,1,21,9,36,8,1,18,FRA
d2110326,10,6,7,3,0,4,7,3,14,9,5,12,22,52,1,18,FRA
d2448564,69,43,39,18,12,21,73,52,31,3,28,23,92,19,1,18,FRA
d28b4a9d,2,2,0,2,0,0,0,0,3,1,2,1,3,1,0,18,FRA
d2aa8ac0,54,33,20,33,1,20,43,23,21,7,14,19,73,29,0,18,FRA
d33c706e,20,13,2,9,9,4,19,15,10,0,10,12,32,22,0,18,FRA
d3b58e33,1,1,1,0,0,1,1,0,0,0,0,0,1,2,0,18,FRA
d3ce9f1f,41,27,29,8,4,13,35,22,13,2,11,15,56,37,1,18,FRA
d4133fa1,26,16,11,12,3,7,24,17,13,1,12,31,57,56,0,18,FRA
d504b3e1,13,8,7,5,1,6,17,11,7,2,5,1,14,9,0,18,FRA
d512db65,0,0,0,0,0,0,3,3,0,0,0,1,1,0,0,18,FRA
d520120b,3,1,1,1,1,1,11,10,11,6,5,3,6,36,0,18,FRA
d5f2f82b,28,14,14,14,0,13,21,8,36,22,14,14,42,114,2,18,FRA
d63e2912,66,45,30,30,6,32,49,17,32,7,25,45,111,90,1,18,FRA
d6a889ea,51,37,31,16,4,17,25,8,13,5,8,38,89,47,0,18,FRA
d72db2f5,2,1,0,1,1,0,7,7,5,0,5,2,4,0,0,18,FRA
d7553721,77,58,26,36,15,26,74,48,30,5,25,19,96,12,1,18,FRA
d7bf3d19,59,37,18,38,3,25,69,44,29,7,22,85,144,35,2,18,FRA
d8b97bb3,0,0,0,0,0,0,2,2,2,0,2,0,0,1,0,18,FRA
d9afac11,5,3,0,3,2,2,9,7,7,2,5,1,6,11,0,18,FRA
dbb10755,37,24,29,8,0,11,21,10,28,18,10,24,61,120,4,18,FRA
dc366c36,0,0,0,0,0,0,1,1,0,0,0,3,3,22,3,18,FRA
dc3a9a0d,31,24,6,22,3,7,34,27,17,0,17,11,42,2,1,18,FRA
dcf7cf44,22,11,7,14,1,8,32,24,8,1,7,6,28,5,1,18,FRA
de343d38,25,14,8,16,1,8,18,10,9,3,6,18,43,21,1,18,FRA
de488e56,60,32,46,9,5,26,56,30,52,16,36,57,117,171,0,18,FRA
de4fe7a2,4,4,1,0,3,0,7,7,2,0,2,2,6,12,0,18,FRA
e067808c,4,4,1,2,1,1,6,5,5,1,4,1,5,4,0,18,FRA
e0d725fe,14,11,5,5,4,4,18,14,10,0,10,7,21,3,0,18,FRA
e162b013,38,21,22,12,4,18,34,16,7,2,5,18,56,54,2,18,FRA
e1b3413d,60,47,41,14,5,40,61,21,25,8,17,51,111,98,1,18,FRA
e2f9bb5f,3,1,2,1,0,1,2,1,1,0,1,1,4,1,0,18,FRA
e39f8724,0,0,0,0,0,0,1,1,0,0,0,0,0,0,1,18,FRA
e3ad3368,0,0,0,0,0,0,0,0,1,0,1,0,0,0,0,18,FRA
e3d0b0c4,27,25,16,10,1,9,25,16,32,18,14,57,84,235,4,18,FRA
e3e05edf,2,1,1,1,0,0,1,1,2,1,1,6,8,6,0,18,FRA
e50623a0,16,10,6,9,1,6,24,18,6,2,4,16,32,29,0,18,FRA
e54a9890,6,3,2,3,1,2,10,8,12,2,10,6,12,5,0,18,FRA
e61bdd69,1,1,0,1,0,0,0,0,0,0,0,0,1,0,0,18,FRA
e61d33f1,1,1,1,0,0,0,2,2,1,0,1,2,3,2,0,18,FRA
e65dd8dc,0,0,0,0,0,0,0,0,0,0,0,0,0,2,0,18,FRA
e68f2cb4,18,10,7,7,4,2,11,9,11,1,10,15,33,8,0,18,FRA
e6bc67d7,0,0,0,0,0,0,0,0,0,0,0,0,0,0,0,18,FRA
e750cba4,1,1,1,0,0,1,2,1,0,0,0,2,3,10,1,18,FRA
e768de1f,29,18,16,10,3,12,30,18,8,4,4,19,48,10,0,18,FRA
e893fc23,2,1,0,2,0,1,3,2,2,1,1,0,2,3,0,18,FRA
e90af77c,4,1,1,2,1,1,4,3,1,0,1,0,4,0,0,18,FRA
e97150c0,39,27,23,15,1,18,23,5,28,23,5,46,85,129,5,18,FRA
ea0ff634,16,11,5,7,4,3,18,15,11,0,11,6,22,19,0,18,FRA
eacb45fd,41,33,27,9,5,14,45,31,16,7,9,37,78,83,1,18,FRA
eaf71a5e,84,57,41,37,6,27,68,41,30,11,19,26,110,61,3,18,FRA
eb78322b,2,1,2,0,0,0,0,0,0,0,0,1,3,8,0,18,FRA
ec1aa15e,7,6,4,3,0,2,5,3,3,1,2,9,16,15,1,18,FRA
ec400194,44,29,33,9,2,14,47,33,29,12,17,43,87,79,1,18,FRA
ed45c4a5,73,49,25,39,9,17,64,47,42,6,36,40,113,13,1,18,FRA
edd1466a,58,49,31,19,8,20,35,15,17,1,16,33,91,46,1,18,FRA
ef7cd87a,74,52,28,38,8,23,67,44,40,10,30,62,136,49,1,18,FRA
ef9c1c95,93,54,36,50,7,43,113,70,56,4,52,57,150,96,1,18,FRA
f00de885,0,0,0,0,0,0,0,0,0,0,0,1,1,17,4,18,FRA
f09a8b75,16,9,5,5,6,6,14,8,2,0,2,14,30,9,0,18,FRA
f3085377,8,5,6,0,2,6,8,2,4,1,3,4,12,5,0,18,FRA
f323d995,36,25,27,9,0,15,32,17,29,19,10,40,76,182,5,18,FRA
f329ec76,1,1,1,0,0,1,3,2,0,0,0,3,4,0,0,18,FRA
f352a2db,13,9,1,9,3,3,16,13,8,0,8,12,25,16,0,18,FRA
f3600c02,26,14,11,11,4,10,38,28,14,2,12,17,43,21,0,18,FRA
f3642ba8,6,3,5,1,0,5,6,1,6,3,3,1,7,15,0,18,FRA
f36c432f,4,4,0,3,1,0,9,9,5,0,5,3,7,3,0,18,FRA
f449640d,50,36,29,16,5,21,47,26,27,2,25,28,78,47,1,18,FRA
f45cf4f7,0,0,0,0,0,0,0,0,0,0,0,0,0,0,0,18,FRA
f5044e54,78,47,29,39,10,27,76,49,52,11,41,34,112,38,2,18,FRA
f51edbf3,6,3,3,3,0,3,5,2,0,0,0,0,6,4,0,18,FRA
f5a00fa4,65,41,19,37,9,27,80,53,52,12,40,36,101,54,0,18,FRA
f6496133,2,2,0,2,0,0,3,3,2,0,2,0,2,1,0,18,FRA
f6db3bd5,0,0,0,0,0,0,2,2,1,0,1,0,0,13,2,18,FRA
f7691f63,77,51,37,32,8,30,84,54,35,2,33,52,129,41,1,18,FRA
f83c8d6c,33,21,13,15,5,4,42,38,17,2,15,12,45,51,0,18,FRA
f86ca403,24,16,9,13,2,3,17,14,21,9,12,24,48,34,0,18,FRA
f99fe221,18,10,12,6,0,11,20,9,5,0,5,17,35,26,0,18,FRA
fa00f0c9,0,0,0,0,0,0,0,0,0,0,0,0,0,0,0,18,FRA
fa18c72e,41,31,23,17,1,10,47,37,24,0,24,16,57,11,1,18,FRA
fa27b5a0,3,2,1,2,0,2,2,0,1,0,1,1,4,4,1,18,FRA
faf873a7,0,0,0,0,0,0,0,0,0,0,0,1,1,1,1,18,FRA
fbbb9269,93,61,54,34,5,43,68,25,26,6,20,54,147,104,0,18,FRA
fca455cc,25,16,9,12,4,6,35,29,10,1,9,18,43,14,0,18,FRA
fcb38f57,1,1,1,0,0,1,1,0,0,0,0,0,1,8,6,18,FRA
fcbcbd94,8,6,1,4,3,3,23,20,10,2,8,3,11,11,0,18,FRA
fd2bc67d,43,28,32,10,1,21,36,15,44,25,19,47,90,130,2,18,FRA
fd771f95,6,4,0,4,2,1,6,5,6,2,4,0,6,3,0,18,FRA
ff0ab48c,50,39,33,15,2,20,47,27,47,13,34,50,100,99,2,18,FRA
ff16ecad,52,38,33,14,5,20,48,28,26,10,16,60,112,95,2,18,FRA
ffa90327,23,18,7,13,3,9,29,20,11,1,10,7,30,7,1,18,FRA
00242715,49,30,35,12,2,20,33,13,42,24,18,44,93,143,1,19,GER
00242b75,4,4,2,0,2,1,2,1,0,0,0,2,6,1,0,19,GER
00844823,34,23,26,8,0,22,51,29,42,19,23,39,73,140,2,19,GER
00a6485f,35,19,17,17,1,11,27,16,32,6,26,22,57,54,0,19,GER
00c3d4dc,0,0,0,0,0,0,0,0,0,0,0,0,0,0,0,19,GER
012c38ec,0,0,0,0,0,0,0,0,0,0,0,0,0,0,0,19,GER
016ff750,46,31,23,17,6,21,53,32,52,12,40,44,90,65,0,19,GER
01c3aff5,28,14,5,17,6,11,35,24,28,9,19,36,64,46,1,19,GER
032f894e,5,5,2,1,2,3,10,7,7,0,7,4,9,2,0,19,GER
03bd0bf4,10,7,8,2,0,5,8,3,8,3,5,14,24,25,0,19,GER
042e8a49,11,6,4,4,3,6,19,13,20,0,20,5,16,3,0,19,GER
048a1cbc,25,12,11,7,7,12,23,11,7,1,6,18,43,12,1,19,GER
04c11885,18,11,7,9,2,6,36,30,29,4,25,28,46,47,0,19,GER
05439de2,34,21,13,13,8,17,26,9,24,3,21,31,65,40,0,19,GER
05d548d8,26,17,19,6,1,9,24,15,20,8,12,34,60,50,1,19,GER
05f99a4a,4,4,2,1,1,1,2,1,2,0,2,3,7,5,0,19,GER
061e8e23,7,5,3,4,0,2,9,7,10,0,10,3,10,6,0,19,GER
070ec0b1,40,25,25,15,0,18,30,12,31,14,17,52,92,98,0,19,GER
080440a4,82,61,50,28,4,37,63,26,44,20,24,35,117,119,0,19,GER
088ca1bd,44,22,23,19,2,16,28,12,22,8,14,43,87,70,2,19,GER
09586899,3,1,0,3,0,0,1,1,6,1,5,3,6,0,0,19,GER
096a77c4,12,6,8,2,2,3,11,8,3,1,2,3,15,1,0,19,GER
0999a593,0,0,0,0,0,0,0,0,0,0,0,0,0,0,0,19,GER
09bcc566,21,13,10,5,6,4,25,21,17,0,17,9,30,5,0,19,GER
0a1cb833,3,0,3,0,0,3,6,3,1,0,1,3,6,14,1,19,GER
0a89e877,0,0,0,0,0,0,0,0,2,0,2,3,3,0,0,19,GER
0b4f388a,22,17,4,13,5,1,9,8,11,0,11,4,26,6,0,19,GER
0c3057a9,9,6,3,6,0,3,16,13,8,3,5,3,12,10,0,19,GER
0c61c77c,25,17,11,6,8,8,15,7,13,0,13,9,34,19,0,19,GER
0d55d942,0,0,0,0,0,0,1,1,0,0,0,0,0,13,2,19,GER
0e0ab524,7,5,5,2,0,5,5,0,7,6,1,4,11,16,0,19,GER
0e4fef6e,14,7,5,7,2,5,11,6,12,1,11,14,28,13,0,19,GER
0f26fd24,15,13,8,4,3,3,11,8,7,0,7,4,19,0,0,19,GER
0fbecd11,42,29,21,21,0,14,35,21,25,12,13,15,57,17,1,19,GER
1025db8e,42,31,23,19,0,24,39,15,44,21,23,56,98,71,1,19,GER
106bca06,26,16,12,13,1,12,29,17,14,0,14,9,35,12,0,19,GER
11fd2b75,20,10,9,9,2,10,24,14,21,7,14,23,43,8,0,19,GER
1238a3f9,5,2,1,4,0,2,9,7,11,0,11,1,6,7,0,19,GER
13203c45,42,29,25,15,2,20,30,10,50,7,43,31,73,54,0,19,GER
13ddc856,5,3,1,1,3,1,6,5,9,0,9,2,7,2,0,19,GER
150d5992,0,0,0,0,0,0,0,0,0,0,0,0,0,0,0,19,GER
15ea94de,2,0,0,2,0,1,2,1,1,0,1,1,3,0,0,19,GER
15fd5593,64,47,24,33,7,14,49,35,44,9,35,47,111,47,0,19,GER
16daec92,31,20,7,13,11,11,42,31,26,1,25,24,55,10,0,19,GER
17611373,14,10,1,8,5,2,13,11,16,1,15,4,18,20,0,19,GER
17695062,1,0,0,1,0,1,1,0,0,0,0,1,2,0,0,19,GER
17780d2b,31,17,17,13,1,9,29,20,36,14,22,29,60,35,1,19,GER
1ae836b1,28,18,11,12,5,12,24,12,18,2,16,14,42,21,0,19,GER
1bcca8b8,34,24,11,20,3,13,28,15,18,2,16,11,45,16,0,19,GER
1bf33a9a,10,6,2,6,2,2,6,4,12,2,10,6,16,10,0,19,GER
1c08a3c8,20,11,7,10,3,6,19,13,11,3,8,14,34,15,0,19,GER
1c96ad85,17,11,12,4,1,8,13,5,12,1,11,11,28,14,0,19,GER
1cd87320,32,18,24,8,0,20,33,13,20,5,15,26,58,44,2,19,GER
1d8e9add,24,15,20,4,0,12,32,20,28,11,17,33,57,103,3,19,GER
1e43fad8,0,0,0,0,0,0,0,0,0,0,0,2,2,10,4,19,GER
20030c06,49,26,31,15,3,24,38,14,33,15,18,36,85,140,0,19,GER
2042d931,21,12,5,11,5,6,24,18,23,1,22,6,27,25,0,19,GER
206c37d3,0,0,0,0,0,0,0,0,0,0,0,0,0,0,0,19,GER
2200181e,53,29,38,15,0,23,47,24,34,16,18,59,112,118,3,19,GER
22051fbe,9,7,6,3,0,8,10,2,5,3,2,16,25,24,0,19,GER
229cd98a,9,5,3,4,2,2,6,4,0,0,0,3,12,5,0,19,GER
2374aaca,19,14,3,7,9,9,19,10,32,2,30,11,30,27,0,19,GER
258a6f4d,4,3,1,2,1,1,3,2,3,0,3,0,4,7,0,19,GER
2590ddf7,0,0,0,0,0,0,0,0,0,0,0,0,0,0,0,19,GER
25ab9c9c,24,16,18,5,1,12,16,4,25,13,12,26,50,90,0,19,GER
25c633b0,4,3,3,1,0,2,7,5,4,1,3,4,8,11,0,19,GER
26db8853,52,22,17,28,7,27,61,34,30,4,26,45,97,36,1,19,GER
278f6efc,2,1,2,0,0,2,5,3,0,0,0,1,3,2,0,19,GER
27d2618c,0,0,0,0,0,0,0,0,0,0,0,1,1,8,1,19,GER
2903a856,37,18,11,19,7,9,37,28,33,2,31,16,53,14,1,19,GER
2979c05a,2,0,1,0,1,1,2,1,3,2,1,4,6,1,0,19,GER
2a29eb9b,35,22,23,12,0,16,26,10,15,5,10,30,65,50,1,19,GER
2b09d998,29,17,12,16,1,11,26,15,17,1,16,16,45,8,0,19,GER
2b350e6b,0,0,0,0,0,0,0,0,0,0,0,0,0,0,0,19,GER
2b5527c4,20,13,12,5,3,7,13,6,16,1,15,8,28,19,0,19,GER
2bb48e86,5,2,4,0,1,5,5,0,0,0,0,1,6,0,0,19,GER
2bcc6d52,11,9,2,5,4,3,8,5,5,0,5,2,13,10,0,19,GER
2bed2986,18,12,7,11,0,9,26,17,15,2,13,8,26,13,1,19,GER
2d61d13a,33,19,22,9,2,9,19,10,15,8,7,23,56,58,1,19,GER
2db2fd7b,21,15,12,9,0,10,22,12,8,3,5,25,46,49,0,19,GER
2e7ff968,0,0,0,0,0,0,0,0,0,0,0,0,0,0,1,19,GER
2f3e911a,55,30,29,21,5,20,38,18,38,11,27,38,93,75,1,19,GER
2ff76adc,7,2,3,4,0,5,6,1,6,0,6,6,13,10,0,19,GER
302527b2,6,6,4,2,0,3,6,3,9,7,2,11,17,42,0,19,GER
30a09cb5,4,2,4,0,0,1,3,2,1,0,1,0,4,13,0,19,GER
30c220c3,63,37,34,22,7,26,50,24,31,3,28,27,90,48,0,19,GER
31114001,0,0,0,0,0,0,0,0,1,0,1,0,0,0,0,19,GER
316162b6,38,22,17,17,4,12,38,26,20,3,17,13,51,19,0,19,GER
3189f61a,32,17,8,21,3,4,18,14,28,8,20,35,67,19,0,19,GER
33144cc5,4,1,4,0,0,1,5,4,2,0,2,0,4,1,0,19,GER
3376a776,36,22,23,12,1,12,18,6,24,16,8,34,70,88,0,19,GER
33b554b7,41,22,16,23,2,20,61,41,49,10,39,20,61,31,0,19,GER
346d51d9,32,18,19,12,1,24,41,17,18,10,8,16,48,56,2,19,GER
34a0f5ff,14,10,7,5,2,3,7,4,18,2,16,7,21,9,0,19,GER
34b306a1,22,14,12,10,0,9,25,16,17,12,5,21,43,44,0,19,GER
34b54da7,15,10,9,5,1,6,8,2,10,7,3,27,42,51,1,19,GER
34e12499,6,6,6,0,0,2,2,0,3,1,2,5,11,10,0,19,GER
36a3ff67,33,22,11,16,6,6,31,25,28,1,27,8,41,32,0,19,GER
36a59ba4,22,15,9,9,4,10,36,26,20,1,19,10,32,23,0,19,GER
37c213cf,3,2,1,2,0,0,1,1,1,0,1,1,4,3,0,19,GER
37f606f0,2,1,1,1,0,1,6,5,1,0,1,3,5,1,0,19,GER
384d58d9,40,21,15,24,1,12,30,18,38,9,29,26,66,20,0,19,GER
3861d9cc,1,0,1,0,0,1,2,1,0,0,0,0,1,0,0,19,GER
3a233281,15,11,9,2,4,6,20,14,20,0,20,14,29,11,0,19,GER
3c05e082,36,23,10,20,6,12,30,18,28,5,23,27,63,21,0,19,GER
3c6089ab,42,23,13,15,14,10,38,28,46,6,40,9,51,12,0,19,GER
3cb009c5,0,0,0,0,0,0,0,0,0,0,0,0,0,0,0,19,GER
3dffff26,26,17,16,9,1,10,29,19,27,4,23,23,49,34,1,19,GER
3e81a228,36,24,17,18,1,14,25,11,18,4,14,40,76,22,0,19,GER
3eb0f2df,8,5,3,4,1,2,3,1,5,0,5,8,16,5,0,19,GER
3eeb80e0,5,4,3,1,1,2,4,2,6,0,6,2,7,3,0,19,GER
3f65898c,53,38,27,16,10,22,51,29,33,8,25,69,122,100,0,19,GER
3f7cd8f1,23,15,9,12,2,10,28,18,35,11,24,34,57,45,1,19,GER
3faa1780,1,1,0,0,1,0,0,0,0,0,0,0,1,0,0,19,GER
41d1fbc6,2,1,1,1,0,0,1,1,0,0,0,1,3,1,0,19,GER
420c18a1,2,2,2,0,0,2,2,0,1,0,1,1,3,12,5,19,GER
420ff5a3,10,9,3,5,2,2,4,2,4,0,4,2,12,1,0,19,GER
434cf5b7,21,10,11,8,2,10,20,10,10,0,10,9,30,4,0,19,GER
437f2b00,1,0,0,0,1,1,3,2,2,0,2,0,1,0,0,19,GER
441197b8,43,28,31,10,2,31,52,21,29,11,18,29,72,123,0,19,GER
442b56fa,18,9,6,9,3,2,7,5,13,1,12,8,26,9,0,19,GER
45954ec7,14,9,9,5,0,10,13,3,12,5,7,20,34,42,1,19,GER
45a03961,28,20,21,6,1,12,19,7,27,19,8,48,76,189,2,19,GER
45b7edae,12,4,8,4,0,7,8,1,6,2,4,9,21,21,1,19,GER
463503e2,18,13,14,3,1,7,11,4,21,11,10,39,57,103,2,19,GER
47064058,0,0,0,0,0,0,0,0,0,0,0,2,2,11,5,19,GER
48035304,41,19,34,7,0,23,33,10,30,13,17,47,88,135,6,19,GER
482b70ad,34,26,15,15,4,6,20,14,24,4,20,21,55,32,0,19,GER
49296448,46,26,17,22,7,25,54,29,35,9,26,34,80,41,3,19,GER
496aeede,41,22,17,23,1,15,40,25,19,4,15,21,62,23,0,19,GER
49fe9070,18,12,6,8,4,3,16,13,18,2,16,3,21,7,0,19,GER
49ffe0f2,33,18,12,19,2,14,28,14,29,5,24,19,52,23,1,19,GER
4a15e95b,0,0,0,0,0,0,0,0,1,0,1,1,1,18,2,19,GER
4d74201d,2,1,1,0,1,1,2,1,2,1,1,0,2,1,0,19,GER
4d8cd038,10,5,1,8,1,1,12,11,8,0,8,3,13,30,0,19,GER
4e204552,15,9,8,2,5,7,17,10,15,1,14,13,28,12,0,19,GER
4e3e4138,1,0,0,1,0,1,2,1,1,0,1,0,1,0,0,19,GER
4f16405e,3,0,0,1,2,1,5,4,10,4,6,1,4,17,0,19,GER
500cd987,6,1,2,4,0,2,4,2,4,1,3,0,6,0,0,19,GER
50871bcc,50,33,22,20,8,17,48,31,35,2,33,27,77,12,0,19,GER
50e6dc35,13,9,4,4,5,1,10,9,15,2,13,3,16,22,0,19,GER
53070b63,4,4,2,2,0,1,2,1,3,0,3,2,6,0,1,19,GER
531807b3,7,4,3,4,0,3,10,7,9,1,8,3,10,4,0,19,GER
536cebe5,22,9,5,12,5,5,12,7,18,1,17,8,30,3,0,19,GER
53e07d0b,19,13,3,12,4,4,11,7,8,1,7,4,23,8,0,19,GER
541127d5,10,4,3,6,1,3,11,8,6,0,6,2,12,3,0,19,GER
541cdd20,42,28,26,16,0,20,43,23,16,9,7,46,88,47,0,19,GER
54507986,3,1,1,1,1,1,4,3,1,0,1,2,5,2,0,19,GER
549c6ba7,2,1,0,2,0,1,4,3,3,1,2,1,3,3,0,19,GER
54b4dc4e,57,35,20,27,10,11,51,40,34,10,24,22,79,25,0,19,GER
54b6ee79,10,6,4,2,4,4,7,3,14,1,13,1,11,7,0,19,GER
54e4866f,32,17,13,11,8,14,32,18,12,2,10,4,36,15,0,19,GER
5528407e,63,34,30,29,4,34,60,26,21,5,16,41,104,54,0,19,GER
555d5edd,14,9,8,4,2,3,13,10,11,0,11,7,21,4,0,19,GER
56413b1f,48,30,21,22,5,21,66,45,31,2,29,25,73,27,1,19,GER
565bf0da,22,14,13,8,1,11,25,14,23,12,11,24,46,64,0,19,GER
5722eced,11,6,6,3,2,3,8,5,3,0,3,5,16,4,0,19,GER
58007d77,1,1,0,0,1,0,0,0,1,0,1,0,1,0,0,19,GER
58ce23e5,9,3,0,6,3,3,11,8,8,1,7,3,12,2,0,19,GER
5939baa2,51,31,24,24,3,25,46,21,41,9,32,32,83,65,2,19,GER
597ff9d3,0,0,0,0,0,0,0,0,0,0,0,0,0,0,0,19,GER
59e4b92e,56,39,22,28,6,18,36,18,44,22,22,80,136,95,1,19,GER
5afafbfe,0,0,0,0,0,0,0,0,0,0,0,0,0,0,0,19,GER
5c4bf6ba,0,0,0,0,0,0,1,1,0,0,0,1,1,3,0,19,GER
5c4d9be7,44,27,31,10,3,22,40,18,17,3,14,13,57,58,0,19,GER
5caa62a7,5,2,3,1,1,1,5,4,4,0,4,4,9,2,0,19,GER
5d8e331f,45,22,19,22,4,14,36,22,21,4,17,32,77,41,0,19,GER
5db04597,15,13,10,5,0,6,13,7,8,4,4,13,28,17,0,19,GER
5ddb8f9f,61,35,29,25,7,18,42,24,51,9,42,32,93,67,0,19,GER
5dfc6ad5,47,33,19,24,4,17,28,11,33,6,27,47,94,49,0,19,GER
5e1df051,22,11,10,8,4,9,29,20,13,2,11,1,23,7,0,19,GER
5e66fa06,49,32,33,14,2,22,50,28,56,33,23,69,118,169,3,19,GER
5ed9b537,44,32,30,14,0,17,27,10,29,18,11,58,102,126,0,19,GER
603cb947,9,4,1,5,3,4,26,22,15,3,12,8,17,13,0,19,GER
6190474d,0,0,0,0,0,0,1,1,0,0,0,0,0,0,0,19,GER
61b0b44d,3,2,0,2,1,0,1,1,0,0,0,0,3,2,0,19,GER
61fc9685,16,10,6,9,1,10,19,9,12,0,12,5,21,7,0,19,GER
626fab5f,8,6,4,4,0,0,3,3,10,3,7,11,19,15,1,19,GER
62ab9184,52,34,22,20,10,16,43,27,35,7,28,30,82,34,0,19,GER
62ba5881,0,0,0,0,0,0,0,0,0,0,0,0,0,0,0,19,GER
635f2732,51,32,21,25,5,16,44,28,59,2,57,37,88,13,0,19,GER
638a4d71,3,1,0,2,1,1,5,4,4,0,4,4,7,11,0,19,GER
64c07ae1,7,3,4,3,0,4,7,3,7,3,4,9,16,22,0,19,GER
64f69877,33,20,7,14,12,13,27,14,17,1,16,6,39,33,0,19,GER
652d4c37,0,0,0,0,0,0,2,2,1,1,0,0,0,0,0,19,GER
66385c46,17,7,5,9,3,4,18,14,14,2,12,7,24,10,0,19,GER
664590fa,30,20,12,18,0,10,19,9,13,5,8,24,54,17,0,19,GER
676ff98c,2,1,1,1,0,0,1,1,0,0,0,0,2,0,0,19,GER
677da306,13,7,7,5,1,9,10,1,6,2,4,6,19,11,1,19,GER
68829001,50,28,21,25,4,19,43,24,23,5,18,29,79,22,1,19,GER
69374ff5,52,30,24,20,8,20,45,25,18,6,12,26,78,21,1,19,GER
699fb8db,41,21,34,6,1,18,32,14,45,22,23,45,86,214,0,19,GER
6b32d0a6,57,34,49,6,2,32,51,19,53,18,35,48,105,139,2,19,GER
6bba916f,0,0,0,0,0,0,3,3,0,0,0,1,1,0,0,19,GER
6bd5cd5d,26,20,19,6,1,16,29,13,46,29,17,44,70,138,2,19,GER
6bd603db,51,31,29,15,7,23,51,28,39,5,34,30,81,32,1,19,GER
6be813ab,0,0,0,0,0,0,2,2,0,0,0,0,0,0,0,19,GER
6c6a3300,24,16,8,11,5,9,24,15,16,2,14,6,30,6,1,19,GER
6cafd68d,8,5,2,4,2,3,7,4,8,5,3,4,12,14,0,19,GER
6e33125f,25,14,21,3,1,11,14,3,25,17,8,19,44,72,0,19,GER
6ec6fde0,33,21,18,15,0,17,28,11,25,7,18,22,55,27,4,19,GER
6fd8a334,18,12,14,4,0,9,14,5,15,8,7,25,43,66,0,19,GER
70678132,30,22,14,13,3,11,34,23,15,2,13,8,38,23,0,19,GER
70dcf94d,71,47,37,24,10,30,75,45,31,4,27,36,107,49,0,19,GER
710fbdd1,0,0,0,0,0,0,0,0,0,0,0,0,0,0,0,19,GER
715bf047,12,8,3,4,5,5,19,14,9,0,9,4,16,1,0,19,GER
71a20ce8,19,11,6,10,3,2,12,10,17,6,11,5,24,33,0,19,GER
7242b495,57,37,38,14,5,26,59,33,25,6,19,36,93,85,1,19,GER
7391c2d9,10,7,5,4,1,4,8,4,8,3,5,8,18,10,0,19,GER
73e2f6eb,0,0,0,0,0,0,0,0,0,0,0,0,0,0,0,19,GER
74c7c2db,19,12,3,10,6,5,12,7,9,1,8,7,26,4,0,19,GER
74d70fb5,24,15,18,6,0,7,14,7,17,11,6,20,44,79,1,19,GER
76e5da9d,13,5,2,8,3,6,8,2,8,3,5,10,23,16,0,19,GER
773968e4,18,12,7,8,3,3,24,21,14,4,10,5,23,44,0,19,GER
77b41ac0,46,26,29,17,0,21,47,26,43,13,30,33,79,49,0,19,GER
77e84962,87,65,31,44,12,25,48,23,23,4,19,44,131,17,1,19,GER
78cd577c,24,20,21,3,0,8,14,6,23,16,7,25,49,108,1,19,GER
791abba1,54,37,34,19,1,27,46,19,44,29,15,68,122,146,3,19,GER
791af558,8,4,2,4,2,2,7,5,5,0,5,1,9,0,0,19,GER
79c90e45,30,19,12,13,5,11,24,13,37,10,27,34,64,71,1,19,GER
79ca3e23,54,33,13,35,6,15,55,40,36,4,32,15,69,17,1,19,GER
7aac47fe,32,19,18,11,3,13,22,9,36,15,21,56,88,79,1,19,GER
7cd6badb,21,14,8,11,2,3,15,12,22,2,20,14,35,13,0,19,GER
7d3e7da6,0,0,0,0,0,0,0,0,0,0,0,0,0,2,1,19,GER
7d841904,10,6,5,3,2,6,16,10,13,2,11,8,18,10,0,19,GER
7e689867,6,3,4,2,0,1,7,6,5,2,3,3,9,2,0,19,GER
7f609bfc,45,32,28,15,2,17,28,11,26,11,15,21,66,58,0,19,GER
7f97771d,26,15,7,17,2,5,16,11,17,5,12,31,57,13,0,19,GER
7fe12375,0,0,0,0,0,0,0,0,0,0,0,0,0,4,0,19,GER
80f36c88,44,24,11,27,6,11,41,30,23,2,21,15,59,15,0,19,GER
815c314f,33,18,26,7,0,12,24,12,35,21,14,46,79,141,1,19,GER
816192f0,4,2,2,1,1,2,2,0,3,1,2,2,6,1,0,19,GER
826e8b63,35,24,17,15,3,21,39,18,16,3,13,22,57,46,1,19,GER
834d0be5,15,8,5,6,4,4,14,10,9,0,9,1,16,16,0,19,GER
83e0eeb4,3,2,3,0,0,2,5,3,1,0,1,1,4,15,0,19,GER
8494acc4,26,17,15,10,1,14,23,9,9,2,7,18,44,43,1,19,GER
857a5abe,31,20,18,13,0,15,34,19,31,11,20,54,85,122,1,19,GER
8593f88c,38,26,16,16,6,20,43,23,31,7,24,14,52,55,0,19,GER
861e0116,22,14,17,4,1,10,19,9,13,2,11,15,37,31,0,19,GER
864db10a,14,9,7,6,1,6,16,10,14,3,11,16,30,42,1,19,GER
867501bf,35,20,14,16,5,11,53,42,30,2,28,15,50,8,0,19,GER
86b30561,1,0,0,1,0,1,1,0,0,0,0,0,1,1,0,19,GER
86e119e0,52,30,21,27,4,21,61,40,31,10,21,35,87,48,1,19,GER
8778c910,1,1,1,0,0,0,1,1,1,0,1,0,1,8,3,19,GER
87fdfb9b,16,9,8,5,3,7,23,16,14,5,9,3,19,22,1,19,GER
88d4144a,61,37,33,23,5,23,49,26,32,4,28,46,107,64,0,19,GER
88e357ef,36,20,12,13,11,5,30,25,18,0,18,11,47,3,0,19,GER
89565ac5,10,5,7,2,1,5,9,4,7,1,6,9,19,14,0,19,GER
89ac64a6,29,19,14,13,2,14,25,11,22,13,9,27,56,92,2,19,GER
8b6e0db2,12,9,9,3,0,4,6,2,10,9,1,11,23,39,0,19,GER
8b8e759d,45,33,17,20,8,13,38,25,29,6,23,29,74,51,1,19,GER
8bdcb6fd,0,0,0,0,0,0,0,0,0,0,0,1,1,1,0,19,GER
8c8b4a01,14,9,2,11,1,5,9,4,14,2,12,2,16,13,0,19,GER
8d78e732,12,9,0,8,4,3,11,8,11,1,10,7,19,15,0,19,GER
8dfdc6c3,0,0,0,0,0,0,3,3,1,0,1,1,1,0,0,19,GER
8e235926,22,13,7,9,6,4,28,24,29,10,19,15,37,58,0,19,GER
8e58987d,74,48,33,38,3,23,65,42,45,9,36,53,127,16,0,19,GER
8ed9b33a,15,9,9,6,0,3,7,4,7,2,5,18,33,12,0,19,GER
8f0f2230,13,9,3,10,0,7,12,5,5,1,4,2,15,8,0,19,GER
8f6bfe11,7,4,7,0,0,2,7,5,6,1,5,7,14,6,0,19,GER
8fa80ec8,3,3,3,0,0,0,0,0,1,1,0,1,4,4,0,19,GER
8ff2354e,68,44,31,24,13,42,65,23,27,4,23,38,106,69,0,19,GER
9050ddc4,20,15,10,8,2,9,15,6,10,4,6,10,30,14,0,19,GER
912e63b5,17,11,11,5,1,6,16,10,13,2,11,11,28,32,1,19,GER
91cd37b7,3,2,1,1,1,0,1,1,1,0,1,0,3,1,0,19,GER
92432bc6,13,11,4,8,1,8,14,6,9,1,8,4,17,7,0,19,GER
92948149,11,8,6,5,0,4,5,1,6,2,4,12,23,20,0,19,GER
93a50d2c,19,11,14,3,2,10,23,13,11,5,6,23,42,44,0,19,GER
94c18565,6,5,5,1,0,3,6,3,4,1,3,3,9,5,0,19,GER
9593331d,1,1,0,1,0,0,0,0,0,0,0,0,1,0,0,19,GER
962e54cb,3,2,0,2,1,1,2,1,8,1,7,0,3,1,0,19,GER
96f8ab0c,0,0,0,0,0,0,0,0,1,0,1,0,0,0,0,19,GER
97655ccd,1,0,0,0,1,1,2,1,5,0,5,1,2,7,1,19,GER
97bfa797,2,0,0,0,2,0,1,1,6,0,6,3,5,0,0,19,GER
9853983f,13,10,2,10,1,5,8,3,2,0,2,4,17,6,0,19,GER
99b7584f,12,7,4,3,5,4,15,11,8,0,8,3,15,10,0,19,GER
99be8fb5,2,0,0,1,1,1,2,1,7,2,5,1,3,10,0,19,GER
99de6b6f,29,18,18,9,2,14,18,4,16,7,9,21,50,35,0,19,GER
99f7e9aa,42,26,26,14,2,24,43,19,16,3,13,30,72,48,1,19,GER
9a2e0ccc,12,7,0,12,0,5,16,11,16,1,15,3,15,6,0,19,GER
9ab16552,52,34,35,17,0,25,42,17,43,22,21,40,92,101,3,19,GER
9ab48bde,2,0,0,1,1,2,3,1,0,0,0,1,3,0,0,19,GER
9af1f9ff,32,18,21,10,1,17,24,7,12,6,6,11,43,32,0,19,GER
9b88e120,48,29,32,13,3,20,39,19,19,5,14,28,76,80,0,19,GER
9c9bd01f,14,12,5,7,2,5,15,10,9,1,8,5,19,10,0,19,GER
9ceb7642,48,29,20,26,2,16,27,11,34,14,20,24,72,49,1,19,GER
9d12e142,1,0,1,0,0,1,2,1,1,0,1,2,3,8,4,19,GER
9efa1d25,26,19,6,11,9,4,25,21,10,0,10,8,34,4,1,19,GER
9fec8860,53,31,25,22,6,23,39,16,37,11,26,38,91,86,1,19,GER
a0606ae8,2,1,2,0,0,1,4,3,1,0,1,1,3,19,3,19,GER
a165a577,0,0,0,0,0,0,0,0,0,0,0,1,1,2,0,19,GER
a167537f,27,16,13,10,4,7,43,36,27,1,26,17,44,12,1,19,GER
a2a85828,13,6,4,9,0,4,19,15,8,1,7,4,17,3,0,19,GER
a3ddb1b9,20,11,8,8,4,4,23,19,19,2,17,8,28,12,0,19,GER
a4effc55,13,10,10,2,1,4,6,2,17,11,6,25,38,70,2,19,GER
a4f94a0d,61,38,29,26,6,16,50,34,30,3,27,31,92,41,1,19,GER
a53b661f,15,9,4,10,1,4,9,5,18,2,16,9,24,9,0,19,GER
a5ae8f8e,36,24,29,6,1,22,37,15,27,13,14,27,63,111,0,19,GER
a5bea1fb,0,0,0,0,0,0,4,4,3,0,3,3,3,0,2,19,GER
a5ce09f2,16,10,3,11,2,3,20,17,14,0,14,17,33,14,0,19,GER
a5ec3ede,29,13,20,9,0,19,28,9,26,15,11,41,70,59,2,19,GER
a63a995f,45,30,23,21,1,15,33,18,39,18,21,39,84,108,2,19,GER
a70b8345,0,0,0,0,0,0,0,0,0,0,0,0,0,1,0,19,GER
a7813ac4,27,16,16,10,1,18,33,15,30,9,21,26,53,58,0,19,GER
a7a9d95a,3,1,2,0,1,0,6,6,5,0,5,6,9,7,0,19,GER
a8d4428b,2,1,1,0,1,2,2,0,2,0,2,0,2,3,0,19,GER
a92ab7be,0,0,0,0,0,0,0,0,0,0,0,0,0,0,0,19,GER
aad48be9,34,19,23,11,0,9,24,15,45,26,19,37,71,141,1,19,GER
ab700320,31,16,12,19,0,6,25,19,32,9,23,28,59,35,0,19,GER
ac73ec79,38,21,23,12,3,19,22,3,17,3,14,24,62,35,0,19,GER
acc7b7ec,0,0,0,0,0,0,1,1,0,0,0,1,1,0,0,19,GER
ad3389d5,0,0,0,0,0,0,1,1,0,0,0,1,1,9,1,19,GER
ae961785,16,10,8,6,2,8,12,4,4,0,4,3,19,4,0,19,GER
aeaf1bc1,2,1,0,1,1,0,0,0,1,0,1,0,2,0,0,19,GER
aeda1f69,10,7,4,5,1,2,7,5,5,0,5,4,14,0,0,19,GER
af0d79a9,13,7,8,4,1,4,9,5,5,1,4,6,19,34,0,19,GER
afb0c500,0,0,0,0,0,0,1,1,0,0,0,1,1,4,1,19,GER
b04ee927,16,11,4,8,4,2,13,11,15,2,13,14,30,7,0,19,GER
b15e93aa,4,4,2,2,0,0,4,4,4,2,2,0,4,1,0,19,GER
b1cd37e6,64,42,35,22,7,23,65,42,80,6,74,23,87,50,0,19,GER
b3325a30,51,32,20,26,5,14,49,35,37,6,31,23,74,5,1,19,GER
b3b7f5a6,0,0,0,0,0,0,0,0,0,0,0,0,0,0,0,19,GER
b48215cd,17,11,6,4,7,6,21,15,17,0,17,12,29,16,0,19,GER
b500b384,46,28,19,19,8,18,44,26,25,0,25,12,58,9,0,19,GER
b5114f85,39,24,28,8,3,31,38,7,29,26,3,26,65,141,0,19,GER
b69261a0,45,34,34,8,3,31,53,22,37,11,26,19,64,90,0,19,GER
b6a6e0a7,18,12,7,8,3,7,26,19,19,3,16,11,29,10,0,19,GER
b825a650,41,24,16,21,4,8,28,20,32,2,30,33,74,22,0,19,GER
b82880c6,9,6,7,1,1,2,6,4,11,5,6,14,23,32,0,19,GER
b883006f,3,2,1,1,1,0,4,4,5,1,4,0,3,2,0,19,GER
b93b7882,20,13,5,10,5,7,16,9,10,1,9,13,33,16,0,19,GER
b956af7d,2,1,0,2,0,1,2,1,1,0,1,0,2,4,0,19,GER
ba115a40,24,11,7,10,7,8,21,13,21,1,20,15,39,23,0,19,GER
bb25c778,0,0,0,0,0,0,0,0,0,0,0,0,0,1,1,19,GER
bb8a42fa,44,27,27,16,1,17,43,26,15,6,9,26,70,39,0,19,GER
bbb496b5,1,1,1,0,0,1,2,1,0,0,0,0,1,1,0,19,GER
bc6bd723,14,10,7,4,3,5,22,17,17,2,15,3,17,15,2,19,GER
bcb2ccd8,0,0,0,0,0,0,0,0,0,0,0,0,0,11,0,19,GER
bd142efb,44,30,30,10,4,17,32,15,39,26,13,45,89,142,1,19,GER
bd7d2e6d,33,23,21,12,0,11,19,8,31,22,9,26,59,100,0,19,GER
be5e1c4c,13,6,9,3,1,7,16,9,8,0,8,2,15,8,0,19,GER
beb882a8,68,42,29,34,5,24,54,30,49,10,39,30,98,69,0,19,GER
beda9675,8,3,3,4,1,1,3,2,2,1,1,0,8,0,0,19,GER
bee0bab1,13,6,7,4,2,3,19,16,13,0,13,10,23,8,0,19,GER
bf075f6b,12,7,5,5,2,5,13,8,3,0,3,3,15,8,0,19,GER
c0dc9fc7,0,0,0,0,0,0,0,0,0,0,0,0,0,0,0,19,GER
c17bfb65,35,22,9,20,6,10,30,20,36,3,33,14,49,8,0,19,GER
c18d22f5,2,1,1,1,0,1,3,2,2,1,1,1,3,5,0,19,GER
c1b7847c,72,38,21,34,17,20,71,51,67,2,65,32,104,23,0,19,GER
c311243f,15,10,6,7,2,6,15,9,8,1,7,9,24,19,0,19,GER
c3fd9887,12,8,2,5,5,0,10,10,10,4,6,3,15,20,0,19,GER
c476b0c0,2,1,2,0,0,1,5,4,1,0,1,2,4,13,2,19,GER
c4e87b8b,30,23,10,12,8,7,35,28,27,3,24,9,39,33,0,19,GER
c50281a0,43,29,20,20,3,18,35,17,26,4,22,21,64,26,0,19,GER
c58a9db7,0,0,0,0,0,0,0,0,0,0,0,0,0,1,0,19,GER
c5bdb6e3,17,10,8,4,5,2,13,11,12,1,11,5,22,2,0,19,GER
c5fd13e9,1,1,0,1,0,0,1,1,1,1,0,0,1,7,0,19,GER
c6637acf,12,10,5,6,1,3,11,8,16,1,15,5,17,10,0,19,GER
c89e8aae,0,0,0,0,0,0,0,0,0,0,0,0,0,3,1,19,GER
c8c60119,18,11,7,11,0,5,8,3,4,1,3,9,27,25,0,19,GER
c8cfb04d,5,3,4,0,1,2,2,0,1,0,1,7,12,5,1,19,GER
ca618d23,18,13,6,9,3,4,18,14,10,1,9,3,21,15,2,19,GER
ca8033cb,50,29,33,12,5,29,45,16,37,5,32,29,79,74,0,19,GER
cba16a46,21,11,6,10,5,12,33,21,11,0,11,10,31,6,0,19,GER
cbac6ec9,1,1,1,0,0,1,2,1,0,0,0,3,4,8,5,19,GER
cc86b9a3,41,22,7,27,7,14,38,24,25,4,21,26,67,14,1,19,GER
cd59b9df,1,1,1,0,0,1,1,0,0,0,0,2,3,5,3,19,GER
cd82452e,64,38,22,39,3,22,53,31,28,2,26,27,91,32,0,19,GER
ce17b5eb,0,0,0,0,0,0,2,2,0,0,0,0,0,17,1,19,GER
ce218223,9,5,1,7,1,4,8,4,8,2,6,7,16,10,0,19,GER
cf01fe3a,2,1,2,0,0,0,0,0,1,0,1,0,2,1,0,19,GER
d003e213,15,7,6,6,3,6,14,8,8,3,5,19,34,11,0,19,GER
d1273f09,93,52,55,29,9,44,103,59,66,10,56,50,143,72,1,19,GER
d1661819,41,27,20,19,2,21,26,5,23,5,18,24,65,24,2,19,GER
d2416c2e,20,10,5,10,5,3,25,22,33,2,31,7,27,28,0,19,GER
d248cd8f,22,16,14,8,0,15,18,3,19,5,14,33,55,47,0,19,GER
d28339cb,1,1,1,0,0,1,1,0,0,0,0,1,2,3,4,19,GER
d3096421,21,15,8,10,3,7,20,13,11,1,10,4,25,5,0,19,GER
d453346c,3,0,1,1,1,1,1,0,0,0,0,1,4,1,0,19,GER
d459281d,46,26,31,10,5,21,45,24,23,3,20,16,62,37,1,19,GER
d4a2533d,15,7,7,6,2,5,18,13,15,1,14,12,27,9,1,19,GER
d4d0a9ad,82,57,52,21,9,35,75,40,41,2,39,85,167,127,3,19,GER
d571df78,13,9,7,4,2,5,19,14,13,0,13,4,17,7,0,19,GER
d6862409,7,5,1,4,2,0,5,5,12,4,8,6,13,10,0,19,GER
d728acae,7,4,7,0,0,5,10,5,6,4,2,10,17,49,1,19,GER
d73a07e2,1,1,0,1,0,1,2,1,0,0,0,1,2,0,0,19,GER
d781d855,1,1,1,0,0,0,0,0,2,0,2,2,3,1,0,19,GER
d9a5d930,2,0,0,0,2,2,4,2,6,0,6,3,5,3,0,19,GER
db401046,1,0,1,0,0,1,2,1,1,0,1,0,1,11,1,19,GER
db4ed67b,16,10,4,10,2,3,15,12,10,0,10,17,33,8,0,19,GER
db7161ed,1,1,1,0,0,0,0,0,1,0,1,0,1,0,0,19,GER
dbf053da,19,10,7,6,6,10,31,21,21,1,20,14,33,12,1,19,GER
dc29b608,0,0,0,0,0,0,0,0,0,0,0,0,0,1,0,19,GER
dc3fa3b5,75,47,24,43,8,33,67,34,36,3,33,26,101,15,0,19,GER
dc62b55d,10,6,3,5,2,3,13,10,13,1,12,4,14,8,0,19,GER
dc62fbee,37,26,9,22,6,8,32,24,22,1,21,13,50,7,0,19,GER
dd669209,26,17,5,17,4,7,17,10,13,2,11,16,42,14,0,19,GER
de164de6,23,15,21,2,0,9,17,8,17,9,8,35,58,71,0,19,GER
debc2f28,9,6,2,7,0,1,3,2,7,0,7,4,13,1,0,19,GER
df8e7b62,5,3,3,1,1,1,7,6,16,1,15,14,19,4,0,19,GER
dfb6490a,20,14,8,7,5,6,17,11,6,3,3,6,26,12,0,19,GER
dfc85b89,6,3,4,2,0,2,2,0,2,1,1,3,9,1,0,19,GER
e12b0b5b,31,19,17,9,5,16,35,19,17,0,17,19,50,14,0,19,GER
e199d5b0,97,64,69,24,4,45,90,45,51,18,33,67,164,90,2,19,GER
e26c4233,7,2,5,2,0,4,6,2,2,2,0,7,14,8,0,19,GER
e26fcca3,78,50,43,29,6,34,74,40,48,10,38,43,121,34,1,19,GER
e27da244,29,15,18,9,2,13,27,14,28,13,15,37,66,135,3,19,GER
e280527c,45,28,17,21,7,18,46,28,21,2,19,33,78,31,0,19,GER
e33c06cf,28,23,17,10,1,18,25,7,23,13,10,40,68,83,0,19,GER
e385200c,0,0,0,0,0,0,0,0,1,0,1,0,0,2,0,19,GER
e3f6253d,15,10,7,7,1,7,19,12,24,13,11,23,38,45,0,19,GER
e4086af3,3,1,1,1,1,1,1,0,3,0,3,2,5,2,0,19,GER
e42d61c7,34,19,25,8,1,17,36,19,27,4,23,29,63,45,2,19,GER
e4a30d8c,0,0,0,0,0,0,0,0,0,0,0,0,0,1,0,19,GER
e5649a78,63,35,28,27,8,30,67,37,32,5,27,31,94,19,1,19,GER
e5a35ae9,20,13,7,10,3,2,20,18,20,3,17,13,33,8,1,19,GER
e5be34dd,1,0,1,0,0,0,0,0,0,0,0,1,2,0,0,19,GER
e5d85da8,28,14,13,10,5,12,23,11,20,0,20,14,42,4,0,19,GER
e5f63987,9,7,4,3,2,5,19,14,12,2,10,3,12,23,1,19,GER
e665a2db,3,2,2,1,0,1,1,0,0,0,0,3,6,0,0,19,GER
e6c15f6e,4,3,3,1,0,1,2,1,2,0,2,1,5,2,0,19,GER
e6c43eec,31,16,18,13,0,14,25,11,17,8,9,43,74,56,2,19,GER
e7d22eae,38,21,17,16,5,19,42,23,21,1,20,9,47,13,0,19,GER
e7d59f4f,15,8,4,9,2,8,24,16,11,1,10,9,24,2,0,19,GER
ea6bc03a,25,14,17,7,1,7,24,17,31,18,13,32,57,77,4,19,GER
eafac393,8,3,5,3,0,2,11,9,13,4,9,6,14,27,0,19,GER
eb61713c,0,0,0,0,0,0,0,0,0,0,0,0,0,5,0,19,GER
ecab64a0,26,18,13,12,1,5,22,17,10,1,9,20,46,14,0,19,GER
ee7cdd0c,4,2,2,2,0,3,3,0,1,0,1,3,7,7,0,19,GER
f24ea523,44,26,21,20,3,17,66,49,34,5,29,21,65,33,0,19,GER
f2571c91,62,42,45,16,1,33,71,38,23,3,20,38,100,57,0,19,GER
f261abcb,62,39,21,37,4,24,66,42,27,8,19,60,122,48,2,19,GER
f26834c7,23,15,6,12,5,4,12,8,14,3,11,9,32,13,0,19,GER
f35430a4,35,23,22,13,0,20,29,9,32,20,12,38,73,114,1,19,GER
f3722c97,15,7,8,6,1,2,11,9,2,0,2,4,19,1,0,19,GER
f3cccffe,51,33,26,18,7,25,42,17,29,2,27,31,82,55,1,19,GER
f4081572,60,33,22,33,5,23,59,36,30,3,27,37,97,39,1,19,GER
f521b80a,24,14,16,7,1,9,17,8,31,19,12,17,41,98,1,19,GER
f61c7c4e,15,7,7,6,2,4,10,6,9,0,9,7,22,1,0,19,GER
f69fba57,23,11,6,12,5,7,22,15,15,3,12,7,30,8,0,19,GER
f6bdc830,22,16,19,2,1,8,12,4,17,11,6,13,35,26,0,19,GER
f7097e8a,0,0,0,0,0,0,1,1,0,0,0,0,0,0,0,19,GER
f765bb88,0,0,0,0,0,0,1,1,0,0,0,0,0,0,0,19,GER
f7aa75bd,27,21,12,10,5,14,21,7,18,3,15,7,34,56,0,19,GER
f820504e,23,15,9,8,6,10,19,9,28,2,26,22,45,52,0,19,GER
f86ad3f5,8,6,4,3,1,3,11,8,9,6,3,13,21,21,0,19,GER
f86cabbd,34,30,23,10,1,18,28,10,19,7,12,29,63,55,0,19,GER
f93e6e94,29,21,10,16,3,4,24,20,28,2,26,13,42,34,0,19,GER
f9446dcd,17,5,2,13,2,6,38,32,16,1,15,8,25,6,2,19,GER
f956479d,0,0,0,0,0,0,0,0,2,0,2,1,1,0,0,19,GER
f972644c,13,8,4,5,4,7,20,13,16,1,15,13,26,9,1,19,GER
f99fe221,17,15,6,8,3,8,18,10,11,2,9,8,25,8,0,19,GER
f9acca3a,75,48,47,24,4,34,57,23,49,13,36,29,104,66,0,19,GER
f9e7c4ac,7,3,2,5,0,1,9,8,6,1,5,3,10,11,0,19,GER
fa274d97,34,20,19,12,3,15,36,21,32,4,28,24,58,36,0,19,GER
fa661778,14,10,11,3,0,5,13,8,6,0,6,13,27,12,0,19,GER
faf55ce4,25,17,17,6,2,15,27,12,30,23,7,41,66,63,0,19,GER
fbbc8e15,0,0,0,0,0,0,0,0,1,0,1,0,0,3,0,19,GER
fbefefdb,0,0,0,0,0,0,2,2,0,0,0,0,0,1,2,19,GER
fbffc4b1,12,11,8,4,0,6,12,6,8,2,6,4,16,35,0,19,GER
fc62f087,36,20,20,13,3,11,15,4,28,15,13,26,62,91,1,19,GER
fe2db476,57,36,34,15,8,18,33,15,26,3,23,39,96,69,0,19,GER
fe641c1a,69,54,28,39,2,19,30,11,30,9,21,58,127,43,0,19,GER
fe888e39,3,1,3,0,0,3,3,0,1,0,1,0,3,0,0,19,GER
fed7cb61,26,17,10,11,5,8,32,24,31,4,27,16,42,29,0,19,GER
ff182fdc,13,10,5,6,2,4,16,12,6,0,6,3,16,14,0,19,GER
ff45add5,32,18,16,15,1,6,24,18,18,9,9,24,56,31,0,19,GER
ffbbc83b,77,49,30,38,9,36,80,44,34,8,26,72,149,56,1,19,GER
00459419,9,5,4,3,2,1,7,6,4,2,2,3,12,6,0,19,ENG
00963611,1,0,0,1,0,1,1,0,1,1,0,7,8,5,0,19,ENG
01226327,46,27,22,20,4,16,31,15,27,5,22,28,74,51,0,19,ENG
02b29014,71,38,27,32,12,19,57,38,31,8,23,34,105,55,5,19,ENG
03e48abb,0,0,0,0,0,0,0,0,0,0,0,0,0,0,0,19,ENG
0420d84f,44,25,23,18,3,19,30,11,14,5,9,26,70,86,0,19,ENG
0442183b,37,21,18,16,3,13,27,14,14,3,11,18,55,34,1,19,ENG
059948df,4,3,0,4,0,3,7,4,1,1,0,2,6,1,0,19,ENG
074d8166,0,0,0,0,0,0,1,1,0,0,0,0,0,0,0,19,ENG
07802f7f,30,14,5,19,6,11,28,17,30,2,28,5,35,9,0,19,ENG
07ace8c3,1,0,0,1,0,0,1,1,0,0,0,0,1,0,0,19,ENG
08452314,32,18,17,11,4,11,30,19,16,0,16,11,43,4,0,19,ENG
08aa17d0,8,6,2,4,2,3,4,1,9,0,9,5,13,10,0,19,ENG
099e666f,21,16,16,4,1,10,18,8,13,2,11,17,38,36,1,19,ENG
09fec029,35,17,29,4,2,15,28,13,47,30,17,52,87,204,5,19,ENG
0bad4516,58,32,41,16,1,25,41,16,42,21,21,43,101,131,1,19,ENG
0d267745,24,14,17,6,1,5,9,4,6,4,2,29,53,56,1,19,ENG
0d4ceb32,2,1,0,1,1,0,3,3,4,1,3,1,3,6,0,19,ENG
0d85a4e8,0,0,0,0,0,0,0,0,0,0,0,0,0,5,0,19,ENG
0db5d2c8,49,31,27,21,1,27,46,19,29,14,15,69,118,83,0,19,ENG
0f7533cd,16,9,6,7,3,3,8,5,13,0,13,3,19,12,0,19,ENG
101da2b5,57,43,19,30,8,26,47,21,28,4,24,41,98,70,0,19,ENG
10efd0e1,41,28,20,20,1,13,45,32,40,9,31,32,73,17,4,19,ENG
111c3236,23,14,11,7,5,12,23,11,3,0,3,13,36,19,1,19,ENG
119b9a8e,42,20,27,14,1,22,34,12,16,9,7,39,81,98,2,19,ENG
11b9265b,3,2,1,2,0,1,3,2,1,0,1,2,5,0,0,19,ENG
129af0db,8,5,0,5,3,1,7,6,6,1,5,0,8,6,0,19,ENG
12aa7661,68,40,44,20,4,28,53,25,27,8,19,21,89,97,0,19,ENG
12c50af5,1,1,0,1,0,0,5,5,0,0,0,1,2,0,0,19,ENG
1598599e,33,18,16,16,1,6,22,16,24,8,16,26,59,26,2,19,ENG
15d561fa,0,0,0,0,0,0,0,0,1,0,1,0,0,0,0,19,ENG
15ea812b,71,36,52,18,1,29,50,21,72,56,16,42,113,240,2,19,ENG
15f3ec41,8,6,8,0,0,2,4,2,1,0,1,3,11,0,0,19,ENG
16380240,12,5,6,3,3,3,21,18,10,2,8,4,16,5,0,19,ENG
165bed61,0,0,0,0,0,0,0,0,1,0,1,1,1,1,0,19,ENG
16ceb862,3,2,0,1,2,1,4,3,6,1,5,3,6,7,0,19,ENG
17370b95,62,43,43,13,6,31,45,14,32,13,19,34,96,82,0,19,ENG
1770bd68,15,7,7,5,3,9,21,12,7,0,7,8,23,5,0,19,ENG
178ae8f8,28,16,11,11,6,10,38,28,20,1,19,13,41,11,0,19,ENG
189cee7b,3,0,0,3,0,0,6,6,8,1,7,1,4,8,0,19,ENG
18b896d6,34,16,27,6,1,15,27,12,15,8,7,32,66,96,1,19,ENG
18b999f4,3,1,2,1,0,1,1,0,3,0,3,0,3,3,0,19,ENG
1900032e,53,33,37,13,3,28,45,17,35,20,15,35,88,174,1,19,ENG
1931bde9,8,5,1,7,0,1,6,5,0,0,0,4,12,3,1,19,ENG
1961b2aa,39,23,12,24,3,13,59,46,27,4,23,20,59,18,0,19,ENG
19b8b0b9,0,0,0,0,0,0,1,1,0,0,0,0,0,0,0,19,ENG
19ba6c6d,9,6,3,4,2,2,12,10,10,1,9,5,14,15,0,19,ENG
1a2935f6,15,9,10,5,0,7,15,8,11,7,4,11,26,51,2,19,ENG
1a4ef233,18,12,11,6,1,10,15,5,6,4,2,17,35,28,1,19,ENG
1ae30132,32,19,15,14,3,12,21,9,25,12,13,31,63,68,1,19,ENG
1b7ec703,3,3,1,1,1,2,3,1,4,0,4,1,4,0,0,19,ENG
1b84dbe1,71,46,45,18,8,28,45,17,43,9,34,60,131,116,0,19,ENG
1bebde9d,0,0,0,0,0,0,0,0,0,0,0,0,0,1,0,19,ENG
1c7012b8,98,60,35,58,5,38,88,50,51,12,39,52,150,56,0,19,ENG
1cb49278,10,4,2,6,2,2,5,3,4,2,2,4,14,29,0,19,ENG
1d6ac165,4,2,1,2,1,0,0,0,2,1,1,0,4,17,0,19,ENG
1d8c99b0,14,10,5,8,1,3,12,9,11,1,10,19,33,20,0,19,ENG
1e0b6a73,25,14,19,5,1,12,24,12,15,7,8,19,44,73,1,19,ENG
1ecb65be,27,17,11,9,7,10,22,12,17,1,16,22,49,8,0,19,ENG
1f9a3a04,74,46,44,26,4,27,47,20,42,16,26,65,139,106,1,19,ENG
20b104bc,46,32,26,14,6,19,41,22,26,7,19,31,77,68,1,19,ENG
21166ff4,5,2,4,1,0,3,6,3,8,5,3,7,12,22,3,19,ENG
21512407,67,37,43,16,8,37,62,25,38,5,33,23,90,77,2,19,ENG
21a66f6a,10,6,2,8,0,1,14,13,16,6,10,1,11,14,0,19,ENG
24396398,12,5,6,4,2,7,8,1,3,0,3,3,15,5,0,19,ENG
2513a588,15,11,5,5,5,4,19,15,9,0,9,6,21,5,0,19,ENG
2628fd2b,0,0,0,0,0,0,3,3,0,0,0,4,4,16,6,19,ENG
2642bf6c,1,1,1,0,0,1,2,1,0,0,0,7,8,19,1,19,ENG
26679cdf,28,17,16,11,1,5,21,16,17,10,7,15,43,25,0,19,ENG
2691c772,28,17,4,17,7,6,29,23,29,8,21,2,30,25,0,19,ENG
2696b6a9,0,0,0,0,0,0,0,0,1,0,1,0,0,1,0,19,ENG
26f6dca8,12,7,5,6,1,5,18,13,3,1,2,9,21,7,1,19,ENG
282f75f3,42,26,31,10,1,17,39,22,49,38,11,46,88,196,5,19,ENG
2876eaa3,0,0,0,0,0,0,1,1,2,1,1,0,0,1,0,19,ENG
28b40c9c,23,14,16,7,0,14,28,14,19,10,9,25,48,80,2,19,ENG
28d596a0,1,1,1,0,0,1,2,1,1,0,1,0,1,4,2,19,ENG
2928dca2,31,19,26,5,0,17,32,15,35,27,8,30,61,133,3,19,ENG
29733c72,9,4,7,1,1,6,21,15,8,1,7,6,15,6,0,19,ENG
2973d8ff,2,1,1,1,0,1,2,1,8,3,5,3,5,0,0,19,ENG
2acd49b9,36,25,18,14,4,15,29,14,31,4,27,16,52,25,2,19,ENG
2afc7272,13,6,6,7,0,8,19,11,8,2,6,8,21,7,1,19,ENG
2b114be3,24,15,8,7,9,2,23,21,21,2,19,8,32,2,0,19,ENG
2b471f99,49,32,23,23,3,15,34,19,27,3,24,43,92,31,1,19,ENG
2b622f01,35,18,8,20,7,9,27,18,15,1,14,24,59,24,0,19,ENG
2b91cf8e,20,17,15,5,0,9,12,3,11,7,4,12,32,58,0,19,ENG
2c0f8e9e,17,10,5,9,3,5,13,8,7,0,7,9,26,2,0,19,ENG
2ce2508a,90,69,36,47,7,39,91,52,47,15,32,72,162,68,3,19,ENG
2e4f5f03,80,49,41,31,8,39,70,31,33,6,27,29,109,57,3,19,ENG
2f4c5a52,62,37,27,26,9,16,46,30,33,5,28,21,83,21,2,19,ENG
2f7acede,22,13,12,9,1,5,30,25,19,3,16,21,43,19,0,19,ENG
2f90f6b8,43,23,14,24,5,15,41,26,40,5,35,18,61,30,0,19,ENG
2ff964a0,26,16,11,12,3,6,14,8,24,0,24,10,36,18,0,19,ENG
31dce0c8,2,1,0,2,0,0,0,0,0,0,0,0,2,1,0,19,ENG
3201b03d,11,3,8,3,0,3,5,2,7,3,4,6,17,20,0,19,ENG
321a71a7,56,36,45,11,0,23,47,24,30,16,14,54,110,129,2,19,ENG
3233eefd,7,5,3,4,0,1,4,3,1,0,1,2,9,14,0,19,ENG
32f60ed8,6,3,2,4,0,1,4,3,6,0,6,1,7,0,0,19,ENG
3312f911,41,20,18,18,5,10,27,17,30,8,22,19,60,27,1,19,ENG
33508c78,6,4,4,2,0,1,5,4,2,1,1,1,7,0,0,19,ENG
33af5b9e,40,27,26,11,3,15,53,38,34,0,34,32,72,30,0,19,ENG
34ccf6fa,1,0,1,0,0,1,3,2,0,0,0,0,1,1,0,19,ENG
3515d404,36,17,19,13,4,14,43,29,30,6,24,27,63,59,0,19,ENG
356a9a62,4,2,4,0,0,2,4,2,1,1,0,3,7,11,1,19,ENG
3626f7d9,40,20,34,6,0,16,42,26,23,15,8,53,93,175,0,19,ENG
36c2ca73,0,0,0,0,0,0,0,0,0,0,0,0,0,6,2,19,ENG
3727dd3c,22,12,10,9,3,8,17,9,10,3,7,7,29,15,0,19,ENG
3730fcbc,45,23,21,21,3,10,33,23,21,6,15,29,74,30,0,19,ENG
381d7d54,2,1,2,0,0,1,1,0,0,0,0,0,2,0,0,19,ENG
3831b9fe,4,2,1,2,1,1,4,3,3,1,2,4,8,14,0,19,ENG
38c7feef,1,1,0,1,0,1,1,0,0,0,0,1,2,0,0,19,ENG
3925dbd6,19,9,3,13,3,5,15,10,22,8,14,6,25,53,0,19,ENG
3935e52e,34,21,21,7,6,20,34,14,12,3,9,20,54,28,3,19,ENG
39583cfd,11,6,5,3,3,4,26,22,16,0,16,14,25,3,0,19,ENG
3a24769f,15,10,5,7,3,4,14,10,8,1,7,9,24,17,2,19,ENG
3a949a25,2,0,2,0,0,1,3,2,0,0,0,0,2,20,5,19,ENG
3bb7b8b4,3,3,2,1,0,3,3,0,0,0,0,1,4,12,2,19,ENG
3be1a627,6,2,6,0,0,2,3,1,0,0,0,1,7,0,0,19,ENG
3ca7254a,27,14,11,10,6,9,35,26,13,2,11,18,45,8,1,19,ENG
3e5e4e63,36,19,31,5,0,20,27,7,36,21,15,50,86,202,1,19,ENG
3ea50f67,10,6,5,4,1,4,6,2,7,1,6,3,13,7,0,19,ENG
3eb22ec9,52,39,18,21,13,16,67,51,47,3,44,25,77,26,1,19,ENG
3f2d59fe,62,45,42,17,3,31,40,9,34,17,17,58,120,168,1,19,ENG
3fe6bd8c,34,22,24,9,1,19,32,13,25,11,14,37,71,133,0,19,ENG
4047c976,8,4,1,5,2,3,7,4,6,0,6,1,9,6,0,19,ENG
4115ce4e,41,25,25,16,0,21,37,16,44,27,17,71,112,171,0,19,ENG
41cc19c2,0,0,0,0,0,0,0,0,0,0,0,0,0,2,0,19,ENG
41fb0f4e,9,7,3,5,1,3,11,8,6,0,6,3,12,1,0,19,ENG
422862ea,3,2,1,2,0,2,7,5,2,1,1,5,8,7,0,19,ENG
43458538,30,19,7,19,4,8,29,21,28,4,24,7,37,14,0,19,ENG
436a9dd0,54,28,24,22,8,21,61,40,38,6,32,37,91,25,1,19,ENG
43a166b4,6,1,2,3,1,1,4,3,2,0,2,0,6,2,0,19,ENG
44361ade,0,0,0,0,0,0,0,0,1,0,1,0,0,1,0,19,ENG
4468ec10,25,12,7,14,4,6,16,10,19,0,19,9,34,15,0,19,ENG
44781702,56,30,39,13,4,38,54,16,23,10,13,23,79,68,1,19,ENG
44bfb6c5,75,32,33,36,6,27,83,56,57,18,39,73,148,46,3,19,ENG
450ab6fc,32,21,25,5,2,11,14,3,43,28,15,39,71,218,3,19,ENG
4535e4bb,1,0,1,0,0,1,2,1,0,0,0,0,1,13,1,19,ENG
45963054,14,8,3,6,5,4,17,13,16,1,15,6,20,28,0,19,ENG
45da6694,36,24,23,11,2,20,29,9,16,6,10,33,69,71,0,19,ENG
45db685d,76,38,27,41,8,45,96,51,46,7,39,64,140,38,1,19,ENG
46b5375e,0,0,0,0,0,0,0,0,0,0,0,1,1,0,0,19,ENG
4701e130,0,0,0,0,0,0,0,0,0,0,0,0,0,0,0,19,ENG
47a34c4f,13,4,9,1,3,1,2,1,7,4,3,2,15,8,0,19,ENG
47b7e3af,62,42,19,27,16,21,52,31,43,7,36,14,76,22,0,19,ENG
4806ec67,0,0,0,0,0,0,0,0,0,0,0,0,0,20,8,19,ENG
4830e0af,2,1,1,1,0,0,0,0,1,0,1,1,3,0,0,19,ENG
495945ef,58,30,24,27,7,14,39,25,38,9,29,47,105,42,2,19,ENG
4b511457,81,46,39,38,4,32,77,45,43,17,26,52,133,44,1,19,ENG
4b6bcb0d,1,0,1,0,0,0,0,0,0,0,0,1,2,1,0,19,ENG
4c370d81,30,20,5,16,9,7,34,27,35,1,34,6,36,16,0,19,ENG
4d034881,17,9,1,10,6,5,9,4,15,1,14,9,26,3,0,19,ENG
4e015693,0,0,0,0,0,0,0,0,0,0,0,0,0,0,0,19,ENG
4e9a0555,12,8,0,7,5,5,17,12,17,4,13,3,15,26,0,19,ENG
4f974391,29,16,14,11,4,13,25,12,28,7,21,23,52,58,0,19,ENG
50b51fac,4,3,4,0,0,3,8,5,1,0,1,1,5,5,2,19,ENG
51b41c5c,24,16,11,11,2,6,14,8,16,3,13,15,39,16,0,19,ENG
51cf8561,34,20,13,15,6,14,33,19,14,3,11,20,54,19,1,19,ENG
52105203,6,2,5,1,0,3,7,4,16,12,4,5,11,46,0,19,ENG
52611641,65,39,24,32,9,25,57,32,34,7,27,41,106,33,2,19,ENG
5271c8f1,16,10,10,5,1,9,17,8,13,4,9,10,26,18,0,19,ENG
531a4aa8,42,36,26,10,6,16,29,13,24,3,21,22,64,72,1,19,ENG
5343eb4e,8,4,3,5,0,2,7,5,9,0,9,5,13,3,1,19,ENG
53af52f3,1,1,1,0,0,1,1,0,0,0,0,3,4,14,3,19,ENG
53cad200,105,60,52,40,13,38,67,29,63,16,47,43,148,91,3,19,ENG
5534217d,74,42,44,30,0,31,55,24,72,32,40,82,156,181,3,19,ENG
56f7a928,17,8,5,9,3,5,17,12,13,2,11,5,22,13,1,19,ENG
57df7a11,57,25,38,13,6,31,56,25,27,6,21,36,93,72,0,19,ENG
58eee997,3,3,2,0,1,2,3,1,2,0,2,0,3,1,0,19,ENG
59e6e5bf,13,7,3,3,7,7,15,8,16,3,13,7,20,19,0,19,ENG
5a4280b1,18,10,13,5,0,7,17,10,7,5,2,7,25,35,1,19,ENG
5a7301ae,53,26,25,25,3,16,47,31,35,6,29,23,76,34,1,19,ENG
5acc4a10,91,56,36,48,7,33,87,54,50,13,37,85,176,96,1,19,ENG
5bddccc9,22,9,8,12,2,9,25,16,16,1,15,4,26,10,0,19,ENG
5c2b4f07,20,12,12,4,4,8,15,7,8,2,6,7,27,20,0,19,ENG
5cec2487,58,35,29,21,8,32,55,23,30,10,20,48,106,76,1,19,ENG
5e508d0d,3,2,0,3,0,1,3,2,4,2,2,2,5,5,0,19,ENG
5ea8ef20,44,26,18,23,3,17,47,30,28,5,23,30,74,24,3,19,ENG
5eae500a,8,4,0,6,2,2,10,8,12,1,11,2,10,19,0,19,ENG
5eebbfdf,30,22,11,16,3,12,29,17,10,0,10,32,62,24,1,19,ENG
5eecec3d,16,11,9,5,2,4,9,5,15,9,6,14,30,64,1,19,ENG
5ef608f7,1,0,1,0,0,1,3,2,2,0,2,1,2,1,0,19,ENG
5f0241b2,1,1,1,0,0,1,1,0,0,0,0,1,2,13,5,19,ENG
5f09991f,48,24,35,11,2,24,40,16,33,9,24,40,88,91,2,19,ENG
601ef102,0,0,0,0,0,0,0,0,1,0,1,0,0,0,0,19,ENG
6250083a,7,3,4,3,0,4,6,2,2,1,1,1,8,7,0,19,ENG
6265208f,14,8,4,5,5,4,9,5,5,0,5,3,17,15,0,19,ENG
63d17038,0,0,0,0,0,0,0,0,0,0,0,0,0,1,0,19,ENG
6421ec64,14,4,3,9,2,9,19,10,6,1,5,6,20,6,0,19,ENG
6438d426,8,4,1,5,2,3,9,6,12,0,12,6,14,13,1,19,ENG
645a3363,1,0,0,0,1,0,0,0,0,0,0,0,1,0,0,19,ENG
64b08de7,2,1,1,1,0,0,0,0,0,0,0,1,3,0,0,19,ENG
653ee42d,83,57,37,41,5,28,74,46,33,13,20,46,129,47,0,19,ENG
65585e3a,6,3,4,1,1,3,11,8,7,0,7,1,7,2,0,19,ENG
6639e500,8,6,5,2,1,4,15,11,9,2,7,11,19,8,1,19,ENG
6813ac34,47,24,26,15,6,17,44,27,39,15,24,48,95,96,3,19,ENG
68796d61,5,5,2,3,0,0,1,1,7,1,6,2,7,1,0,19,ENG
68dc0dac,16,12,7,6,3,6,19,13,11,1,10,6,22,5,0,19,ENG
6992791d,12,6,5,4,3,3,7,4,8,1,7,2,14,15,0,19,ENG
6a189491,0,0,0,0,0,0,0,0,0,0,0,0,0,0,0,19,ENG
6aa3e78b,22,14,8,8,6,6,22,16,25,2,23,19,41,49,1,19,ENG
6adbc307,25,13,17,7,1,16,28,12,25,13,12,37,62,96,2,19,ENG
6b47c5db,142,98,66,67,9,46,95,49,64,9,55,83,225,85,2,19,ENG
6bb2c084,48,29,23,20,5,18,52,34,25,6,19,34,82,32,0,19,ENG
6c203af0,62,30,33,27,2,20,38,18,21,5,16,33,95,29,2,19,ENG
6c679c6d,33,21,12,15,6,13,30,17,13,0,13,29,62,11,0,19,ENG
6c7762c3,31,17,20,11,0,14,19,5,12,5,7,10,41,50,1,19,ENG
6ca5ec4b,28,14,10,16,2,6,25,19,21,1,20,12,40,13,1,19,ENG
6cafd68d,9,4,8,1,0,4,5,1,3,3,0,8,17,15,1,19,ENG
6cc47ae1,15,10,5,8,2,3,7,4,8,0,8,9,24,13,0,19,ENG
6cdd8245,17,9,11,4,2,6,22,16,4,0,4,5,22,11,0,19,ENG
6d5701f2,14,7,8,6,0,6,9,3,11,5,6,8,22,54,3,19,ENG
6d6f09dc,1,0,1,0,0,1,3,2,2,0,2,1,2,1,0,19,ENG
6eaed4eb,25,15,17,7,1,11,24,13,16,5,11,21,46,49,0,19,ENG
71672fa0,1,1,1,0,0,1,1,0,0,0,0,0,1,5,2,19,ENG
71a08f97,15,11,6,8,1,5,13,8,8,2,6,9,24,22,0,19,ENG
71ef519e,70,44,35,27,8,19,47,28,34,11,23,51,121,76,1,19,ENG
723ba189,0,0,0,0,0,0,0,0,0,0,0,0,0,2,0,19,ENG
72a0fb65,69,36,48,16,5,29,58,29,62,28,34,81,150,179,4,19,ENG
72c812f3,142,89,70,63,9,38,76,38,52,8,44,74,216,48,1,19,ENG
7314bba4,35,20,23,7,5,14,25,11,57,47,10,36,71,244,3,19,ENG
73489527,8,4,2,4,2,3,14,11,11,3,8,8,16,7,0,19,ENG
73d9bdc7,1,1,0,1,0,1,1,0,0,0,0,0,1,2,0,19,ENG
74b2cd7e,31,13,23,6,2,14,23,9,29,19,10,35,66,101,0,19,ENG
74e12f1e,51,27,12,34,5,18,46,28,39,16,23,29,80,82,2,19,ENG
758dd7f0,27,19,14,11,2,9,14,5,9,1,8,17,44,58,0,19,ENG
75a72a99,118,66,66,40,12,54,112,58,60,6,54,60,178,130,1,19,ENG
75f2c59f,21,12,10,10,1,7,24,17,26,0,26,24,45,27,2,19,ENG
76c131da,0,0,0,0,0,0,0,0,0,0,0,0,0,0,0,19,ENG
76dd1480,56,36,20,25,11,16,47,31,38,4,34,28,84,24,0,19,ENG
76eca7e2,0,0,0,0,0,0,2,2,0,0,0,0,0,5,1,19,ENG
76fa5f80,9,5,8,1,0,6,9,3,5,4,1,9,18,25,2,19,ENG
77128f7e,1,0,0,1,0,0,0,0,0,0,0,0,1,0,0,19,ENG
78803d03,25,16,20,3,2,14,18,4,7,2,5,11,36,30,1,19,ENG
78e68b4d,12,6,11,1,0,8,9,1,5,3,2,17,29,32,1,19,ENG
7914b9fe,0,0,0,0,0,0,0,0,0,0,0,0,0,1,0,19,ENG
79b0d6a0,2,0,2,0,0,2,3,1,0,0,0,1,3,7,4,19,ENG
79c0821a,45,29,23,19,3,20,46,26,19,2,17,8,53,18,1,19,ENG
7a11550b,18,11,10,7,1,9,15,6,10,5,5,14,32,42,0,19,ENG
7a2e46a8,2,1,2,0,0,2,2,0,0,0,0,1,3,14,6,19,ENG
7b4de647,0,0,0,0,0,0,3,3,1,0,1,1,1,15,7,19,ENG
7ba6d84e,0,0,0,0,0,0,2,2,1,0,1,0,0,11,4,19,ENG
7c104bb7,15,7,7,5,3,4,6,2,10,0,10,7,22,2,0,19,ENG
7d2d3329,24,10,13,10,1,9,15,6,12,3,9,15,39,13,0,19,ENG
7d41b619,11,6,6,5,0,3,13,10,20,7,13,10,21,34,1,19,ENG
7eb67dad,43,23,26,13,4,18,41,23,25,11,14,29,72,96,1,19,ENG
7f3b388c,59,31,17,38,4,24,59,35,34,6,28,28,87,27,2,19,ENG
7fe90ccd,0,0,0,0,0,0,1,1,0,0,0,3,3,5,0,19,ENG
7fec31a0,57,23,27,21,9,28,53,25,33,11,22,20,77,46,1,19,ENG
80c31c97,27,15,14,12,1,6,7,1,24,10,14,32,59,109,1,19,ENG
810e3c74,29,18,8,11,10,7,28,21,18,2,16,10,39,9,1,19,ENG
819aa8e7,59,22,24,28,7,17,63,46,55,4,51,42,101,33,1,19,ENG
819b3158,19,12,4,12,3,6,31,25,12,3,9,28,47,19,1,19,ENG
82dbf623,4,2,3,0,1,2,3,1,7,2,5,1,5,10,0,19,ENG
82e34b69,24,14,8,10,6,7,32,25,22,4,18,7,31,29,0,19,ENG
8397a50c,4,3,3,1,0,2,3,1,5,2,3,6,10,8,0,19,ENG
839c14e1,22,16,15,6,1,9,15,6,21,5,16,22,44,60,2,19,ENG
849c826a,4,1,2,1,1,4,6,2,4,1,3,2,6,4,2,19,ENG
862a1c15,20,12,7,10,3,4,10,6,14,1,13,8,28,5,0,19,ENG
867239d3,47,30,21,21,5,17,43,26,30,9,21,18,65,39,0,19,ENG
86dd77d1,40,26,20,20,0,24,38,14,19,5,14,36,76,58,2,19,ENG
874125a3,3,2,2,0,1,2,3,1,4,3,1,0,3,2,0,19,ENG
87575fd9,21,13,11,9,1,9,17,8,9,5,4,4,25,34,1,19,ENG
875898c7,28,12,23,5,0,17,26,9,20,13,7,23,51,79,2,19,ENG
87935cf3,25,16,22,3,0,11,18,7,26,16,10,41,66,136,2,19,ENG
87f7500e,5,2,1,2,2,1,3,2,8,0,8,2,7,1,1,19,ENG
8816329f,24,15,9,11,4,5,16,11,13,3,10,7,31,16,0,19,ENG
892d5bb1,14,7,3,7,4,6,18,12,18,1,17,9,23,3,1,19,ENG
89d10e53,49,31,26,16,7,20,32,12,24,4,20,24,73,28,3,19,ENG
89e4b358,50,31,36,11,3,21,37,16,42,30,12,38,88,184,4,19,ENG
8a08491a,10,7,2,4,4,2,11,9,4,0,4,1,11,5,0,19,ENG
8a7ff278,12,7,7,4,1,3,10,7,2,0,2,10,22,35,0,19,ENG
8aa5f52c,35,22,29,6,0,16,32,16,23,15,8,26,61,120,2,19,ENG
8ae9869d,61,36,46,14,1,27,47,20,69,34,35,70,131,138,4,19,ENG
8aec0537,27,12,12,12,3,11,36,25,20,8,12,13,40,23,0,19,ENG
8b04d6c1,71,49,20,44,7,24,73,49,51,8,43,60,131,30,1,19,ENG
8b788c01,9,7,2,5,2,1,11,10,12,0,12,3,12,8,0,19,ENG
8b9ebd03,35,21,11,15,9,9,25,16,16,1,15,14,49,12,2,19,ENG
8d228291,13,7,3,6,4,6,11,5,12,2,10,2,15,13,0,19,ENG
8d3c902d,59,33,23,31,5,9,33,24,29,11,18,16,75,33,0,19,ENG
8df7a2fb,55,24,38,17,0,35,44,9,59,50,9,48,103,235,4,19,ENG
8e65a5e5,0,0,0,0,0,0,0,0,0,0,0,0,0,1,2,19,ENG
8f62b6ee,1,0,1,0,0,0,2,2,0,0,0,0,1,13,5,19,ENG
8f866fe8,6,2,1,4,1,1,2,1,5,0,5,3,9,6,0,19,ENG
914ab9a1,25,14,20,5,0,10,23,13,21,16,5,38,63,111,0,19,ENG
91b43c98,1,0,1,0,0,1,1,0,0,0,0,0,1,0,0,19,ENG
9228b07c,27,17,9,17,1,7,23,16,15,1,14,16,43,9,1,19,ENG
92e7e919,23,12,7,12,4,10,34,24,26,2,24,8,31,4,1,19,ENG
9306d5ea,78,41,18,51,9,27,69,42,46,7,39,73,151,19,1,19,ENG
9319781b,1,0,1,0,0,0,1,1,0,0,0,1,2,5,0,19,ENG
9328b835,1,0,1,0,0,1,3,2,0,0,0,1,2,10,1,19,ENG
935e6b8f,46,36,20,22,4,16,39,23,27,3,24,30,76,17,0,19,ENG
939bc634,0,0,0,0,0,0,1,1,1,0,1,2,2,12,2,19,ENG
94b2001f,20,16,6,12,2,12,17,5,5,0,5,15,35,22,1,19,ENG
96bb8cc2,15,7,5,5,5,6,17,11,7,1,6,7,22,18,1,19,ENG
96e0490d,14,8,10,4,0,4,11,7,9,0,9,7,21,20,0,19,ENG
97333cf5,28,20,14,6,8,8,42,34,14,0,14,12,40,12,0,19,ENG
979b811d,5,4,3,1,1,1,14,13,12,0,12,4,9,5,0,19,ENG
980522ec,41,25,8,20,13,17,59,42,26,3,23,15,56,13,0,19,ENG
984a5a64,7,4,4,2,1,3,4,1,5,1,4,4,11,6,0,19,ENG
989d5705,24,12,13,7,4,9,32,23,20,5,15,12,36,31,0,19,ENG
98be0d02,1,1,0,1,0,0,0,0,2,0,2,1,2,0,0,19,ENG
99813635,16,9,6,7,3,5,12,7,10,1,9,5,21,4,0,19,ENG
99b1d0e6,15,9,5,4,6,9,16,7,11,4,7,9,24,25,1,19,ENG
9a104dee,13,9,3,6,4,4,13,9,12,0,12,5,18,3,0,19,ENG
9a28eba4,16,13,11,3,2,4,9,5,11,0,11,6,22,7,0,19,ENG
9a9c05db,56,35,21,31,4,32,60,28,29,7,22,30,86,80,1,19,ENG
9aa186b2,30,17,10,18,2,13,37,24,21,7,14,21,51,37,1,19,ENG
9b5ce51a,45,31,20,20,5,14,54,40,35,19,16,54,99,88,1,19,ENG
9c318325,7,4,1,4,2,2,6,4,3,1,2,7,14,0,0,19,ENG
9c74fa25,26,18,18,7,1,14,26,12,16,9,7,9,35,20,1,19,ENG
9c94165b,55,29,17,31,7,28,47,19,42,12,30,21,76,93,2,19,ENG
9d107085,25,15,18,6,1,13,22,9,14,4,10,20,45,56,2,19,ENG
9dbb75ca,35,16,6,19,10,5,28,23,27,1,26,15,50,31,0,19,ENG
9dc69d38,15,10,5,7,3,8,22,14,5,2,3,15,30,9,0,19,ENG
9e525177,129,90,90,33,6,55,65,10,49,16,33,84,213,161,0,19,ENG
9f1893b9,89,49,33,44,12,31,101,70,71,0,71,41,130,18,1,19,ENG
9f4647e9,44,27,18,24,2,13,46,33,24,4,20,11,55,23,0,19,ENG
9f472354,15,8,4,5,6,3,16,13,10,1,9,7,22,18,0,19,ENG
9f736ed2,6,5,0,5,1,2,7,5,2,0,2,4,10,4,0,19,ENG
9fbbcf39,39,26,23,14,2,20,37,17,25,12,13,26,65,61,0,19,ENG
a0666d3e,74,43,27,35,12,25,59,34,55,6,49,25,99,30,0,19,ENG
a1232f4e,15,9,14,1,0,8,10,2,9,4,5,13,28,39,1,19,ENG
a179d516,0,0,0,0,0,0,0,0,0,0,0,0,0,1,0,19,ENG
a1d5bd30,24,12,4,12,8,7,29,22,27,0,27,3,27,24,0,19,ENG
a2b105e0,17,13,6,11,0,9,24,15,19,4,15,10,27,7,0,19,ENG
a300ac7e,6,4,3,2,1,1,3,2,2,1,1,2,8,2,0,19,ENG
a39bb753,14,9,2,1,11,5,17,12,10,0,10,13,27,6,1,19,ENG
a3b03921,1,0,0,1,0,0,0,0,1,0,1,1,2,0,0,19,ENG
a48da055,11,3,4,7,0,5,8,3,5,0,5,3,14,6,0,19,ENG
a4ac4b8f,85,52,49,34,2,34,56,22,55,32,23,72,157,177,6,19,ENG
a53649b7,1,1,0,1,0,0,0,0,0,0,0,0,1,1,0,19,ENG
a67a09fb,4,3,0,4,0,1,2,1,0,0,0,4,8,8,0,19,ENG
a6de6361,0,0,0,0,0,0,2,2,0,0,0,0,0,8,2,19,ENG
a712ca2b,68,38,47,21,0,37,57,20,58,36,22,64,132,161,4,19,ENG
a8748947,37,21,9,22,6,12,16,4,21,5,16,10,47,13,1,19,ENG
a9142dc3,18,7,12,6,0,8,13,5,11,5,6,12,30,30,1,19,ENG
aa1a8c7e,10,9,5,5,0,2,4,2,4,0,4,5,15,4,0,19,ENG
aa5859cb,6,4,2,3,1,0,3,3,9,0,9,2,8,8,0,19,ENG
aaf1bf05,46,29,22,19,5,22,54,32,21,1,20,24,70,12,1,19,ENG
ab070c55,5,1,0,4,1,1,4,3,7,2,5,0,5,14,0,19,ENG
ab13a5aa,0,0,0,0,0,0,0,0,0,0,0,0,0,5,2,19,ENG
ab4b3e35,49,30,19,22,8,15,55,40,37,2,35,27,76,14,1,19,ENG
ab651565,45,22,14,19,12,14,41,27,54,2,52,20,65,23,1,19,ENG
abe66106,17,13,6,7,4,5,14,9,14,0,14,7,24,1,0,19,ENG
ac05f970,23,14,12,6,5,6,12,6,38,3,35,18,41,26,1,19,ENG
ac861941,26,16,7,15,4,19,47,28,27,12,15,21,47,46,1,19,ENG
ad1ffcfd,4,1,1,3,0,0,7,7,1,0,1,8,12,4,1,19,ENG
ae0a7ddf,54,32,36,14,4,19,41,22,36,10,26,28,82,88,0,19,ENG
af245161,1,1,1,0,0,0,0,0,0,0,0,0,1,3,2,19,ENG
af341b88,39,25,27,11,1,15,27,12,18,12,6,18,57,60,0,19,ENG
af69e7f0,61,41,35,21,5,24,42,18,34,12,22,31,92,82,1,19,ENG
af721f98,12,3,1,5,6,4,9,5,7,0,7,2,14,7,0,19,ENG
afef14da,0,0,0,0,0,0,1,1,2,1,1,2,2,5,0,19,ENG
b017b770,1,0,0,0,1,0,0,0,0,0,0,0,1,0,0,19,ENG
b18095b6,8,6,4,3,1,4,6,2,2,0,2,2,10,8,0,19,ENG
b217ef29,39,26,23,12,4,13,24,11,12,7,5,32,71,78,0,19,ENG
b28bbd58,62,35,38,16,8,35,89,54,48,5,43,38,100,28,0,19,ENG
b2bc3b1f,39,20,11,23,5,12,34,22,19,0,19,10,49,4,0,19,ENG
b2d03887,28,15,8,15,5,6,31,25,17,2,15,33,61,28,1,19,ENG
b30c7426,26,17,15,7,4,9,29,20,30,0,30,11,37,17,0,19,ENG
b318a643,8,3,2,4,2,4,24,20,14,3,11,5,13,39,0,19,ENG
b400bde0,32,16,11,12,9,9,25,16,28,3,25,17,49,4,0,19,ENG
b4b2f632,34,25,18,12,4,12,26,14,17,1,16,13,47,20,0,19,ENG
b561db50,30,18,5,17,8,6,23,17,25,3,22,26,56,40,0,19,ENG
b581987a,4,2,1,3,0,1,4,3,3,2,1,1,5,8,0,19,ENG
b66315ae,10,3,5,2,3,0,5,5,16,2,14,3,13,4,0,19,ENG
b682dcf6,42,25,30,11,1,15,28,13,34,17,17,26,68,112,1,19,ENG
b6964eb6,30,17,21,9,0,11,17,6,37,25,12,26,56,109,1,19,ENG
b73e459a,0,0,0,0,0,0,0,0,0,0,0,0,0,0,0,19,ENG
b7d082af,76,46,35,36,5,16,54,38,42,9,33,30,106,39,1,19,ENG
b827d5b3,35,22,18,14,3,13,31,18,26,3,23,23,58,30,0,19,ENG
b853e0ad,29,17,12,16,1,15,33,18,26,2,24,16,45,14,2,19,ENG
b937e490,14,9,7,7,0,2,5,3,10,2,8,14,28,16,1,19,ENG
b9e1436c,0,0,0,0,0,0,0,0,1,0,1,0,0,0,0,19,ENG
b9fbae28,75,41,21,41,13,23,67,44,63,6,57,44,119,32,1,19,ENG
ba1e04b3,41,23,23,16,2,18,43,25,27,9,18,12,53,18,0,19,ENG
ba23a904,39,24,17,20,2,14,24,10,18,11,7,32,71,81,0,19,ENG
bb5fbd2b,56,24,27,16,13,19,45,26,34,4,30,27,83,44,0,19,ENG
bc7dc64d,0,0,0,0,0,0,0,0,0,0,0,0,0,0,0,19,ENG
bcfb0142,1,1,1,0,0,0,0,0,1,1,0,0,1,2,0,19,ENG
be4fede9,0,0,0,0,0,0,1,1,0,0,0,3,3,4,0,19,ENG
be927d03,52,32,34,16,2,20,39,19,36,10,26,55,107,74,0,19,ENG
c067631c,38,23,33,5,0,21,32,11,15,5,10,13,51,49,1,19,ENG
c0e27d1a,41,31,27,13,1,21,28,7,33,18,15,35,76,149,1,19,ENG
c24dba2a,3,1,0,2,1,1,6,5,3,1,2,2,5,6,0,19,ENG
c2846353,4,2,3,1,0,3,4,1,0,0,0,0,4,4,0,19,ENG
c3e39f12,0,0,0,0,0,0,0,0,0,0,0,0,0,1,0,19,ENG
c596fcb0,9,7,4,3,2,0,8,8,14,4,10,4,13,16,0,19,ENG
c5b7c315,41,25,22,16,3,19,32,13,30,22,8,43,84,185,4,19,ENG
c6896eab,34,18,17,15,2,12,33,21,21,3,18,23,57,56,0,19,ENG
c691bfe2,35,29,12,17,6,14,43,29,28,4,24,15,50,10,1,19,ENG
c73ada83,0,0,0,0,0,0,0,0,0,0,0,0,0,0,0,19,ENG
c8aa95da,60,39,37,19,4,24,50,26,40,16,24,67,127,145,2,19,ENG
c92e1a31,6,5,4,1,1,1,5,4,5,0,5,2,8,3,0,19,ENG
c951a6df,73,43,19,45,9,23,41,18,32,4,28,40,113,30,0,19,ENG
ca2bc3df,15,9,9,4,2,10,20,10,7,1,6,5,20,7,0,19,ENG
caa1a7f0,1,1,0,0,1,0,0,0,1,1,0,1,2,0,0,19,ENG
caffaf5a,16,12,5,10,1,4,13,9,24,20,4,42,58,103,1,19,ENG
cb4f24c6,0,0,0,0,0,0,1,1,0,0,0,0,0,11,3,19,ENG
cc2d7ad5,55,26,37,15,3,24,50,26,74,35,39,40,95,120,0,19,ENG
cd1acf9d,61,39,31,22,8,36,68,32,19,3,16,35,96,68,0,19,ENG
ce4246f5,32,21,16,14,2,4,11,7,27,12,15,54,86,126,2,19,ENG
ce5143da,3,2,0,2,1,0,0,0,2,0,2,1,4,2,0,19,ENG
cea4ee8f,33,19,6,14,13,5,24,19,33,5,28,19,52,20,0,19,ENG
cee31595,84,51,38,32,14,30,78,48,64,22,42,39,123,55,0,19,ENG
cf15bbb1,2,2,0,2,0,0,0,0,2,0,2,1,3,5,0,19,ENG
cf623c78,35,22,24,8,3,14,33,19,26,6,20,41,76,42,0,19,ENG
cfb29823,2,1,0,1,1,0,3,3,3,1,2,0,2,9,0,19,ENG
cfd5e123,16,10,7,6,3,6,10,4,16,6,10,25,41,57,2,19,ENG
d0042ab9,5,4,4,1,0,1,1,0,3,2,1,3,8,32,0,19,ENG
d07e3b41,2,0,2,0,0,0,1,1,2,0,2,0,2,0,0,19,ENG
d0b3ceb9,2,2,2,0,0,2,6,4,0,0,0,2,4,34,3,19,ENG
d0f72bf1,0,0,0,0,0,0,0,0,0,0,0,0,0,0,0,19,ENG
d1c509d9,0,0,0,0,0,0,0,0,0,0,0,0,0,0,0,19,ENG
d2424d1b,55,29,34,18,3,24,55,31,37,7,30,38,93,156,0,19,ENG
d2583bce,21,14,7,7,7,5,26,21,23,2,21,8,29,29,0,19,ENG
d2bff301,16,10,11,3,2,8,9,1,11,8,3,16,32,55,0,19,ENG
d328a254,73,44,26,39,8,19,42,23,57,16,41,53,126,43,0,19,ENG
d368feb8,11,7,7,4,0,6,10,4,20,17,3,19,30,64,1,19,ENG
d4cb83cc,35,17,21,9,5,15,25,10,28,10,18,31,66,62,0,19,ENG
d557d734,67,42,48,15,4,35,58,23,49,7,42,60,127,107,2,19,ENG
d56543a0,19,11,9,8,2,10,32,22,23,6,17,22,41,33,0,19,ENG
d5dd5f1f,21,17,6,9,6,8,28,20,26,0,26,8,29,22,0,19,ENG
d6f88a1d,2,2,0,1,1,0,2,2,1,0,1,1,3,1,0,19,ENG
d7492450,21,13,18,2,1,14,19,5,18,12,6,11,32,88,1,19,ENG
d79a8c87,11,7,9,2,0,2,8,6,9,7,2,12,23,40,0,19,ENG
d822a850,0,0,0,0,0,0,3,3,0,0,0,1,1,3,2,19,ENG
d8931174,31,17,21,9,1,11,17,6,32,18,14,36,67,155,4,19,ENG
d93c2511,10,9,3,6,1,4,10,6,9,4,5,15,25,16,0,19,ENG
d9565625,24,12,8,14,2,14,19,5,15,2,13,10,34,35,1,19,ENG
d9ba39fc,14,9,8,2,4,4,12,8,13,2,11,14,28,20,0,19,ENG
d9cfca3d,3,1,1,1,1,1,4,3,3,0,3,1,4,3,0,19,ENG
da052c14,38,23,12,19,7,6,20,14,16,0,16,7,45,6,0,19,ENG
da23d58d,1,1,0,0,1,1,5,4,1,0,1,0,1,0,0,19,ENG
da7b447d,37,20,28,9,0,20,37,17,17,9,8,30,67,103,2,19,ENG
da8b19e2,0,0,0,0,0,0,0,0,0,0,0,0,0,0,0,19,ENG
dc008610,10,2,3,4,3,1,6,5,9,1,8,3,13,12,0,19,ENG
dc10b26c,18,7,11,4,3,9,16,7,9,3,6,17,35,16,1,19,ENG
dc31b84c,0,0,0,0,0,0,0,0,0,0,0,0,0,7,0,19,ENG
dc3a9a0d,14,5,3,7,4,3,18,15,10,1,9,7,21,4,1,19,ENG
dc4cae05,37,26,12,19,6,19,44,25,36,7,29,24,61,28,0,19,ENG
dc6f5bdd,64,36,32,27,5,16,48,32,37,12,25,69,133,113,4,19,ENG
dc936144,50,29,34,16,0,22,38,16,30,8,22,60,110,93,0,19,ENG
dd0daf32,28,22,8,17,3,6,22,16,34,2,32,16,44,13,0,19,ENG
de0f152c,30,17,16,13,1,13,25,12,19,4,15,17,47,40,0,19,ENG
de112b84,6,2,4,2,0,2,4,2,5,2,3,1,7,7,0,19,ENG
def899bd,19,13,12,7,0,8,13,5,16,11,5,23,42,67,3,19,ENG
e06683ca,38,28,26,11,1,14,14,0,29,18,11,40,78,201,1,19,ENG
e082af5b,0,0,0,0,0,0,0,0,0,0,0,0,0,8,3,19,ENG
e0900238,13,13,8,5,0,6,12,6,9,3,6,7,20,11,0,19,ENG
e0991c04,5,3,3,2,0,1,6,5,3,2,1,6,11,9,1,19,ENG
e0bc6fdc,14,9,6,5,3,6,10,4,11,1,10,8,22,14,0,19,ENG
e2533c20,51,29,23,25,3,23,84,61,40,12,28,38,89,55,1,19,ENG
e2716bd0,30,18,12,11,7,1,20,19,18,1,17,22,52,15,0,19,ENG
e28868f3,79,43,42,33,4,31,60,29,45,8,37,60,139,64,2,19,ENG
e342ad68,21,9,3,11,7,5,16,11,9,0,9,5,26,6,0,19,ENG
e3a5814e,33,22,19,12,2,14,28,14,22,4,18,19,52,15,2,19,ENG
e3e6502a,1,1,0,1,0,0,0,0,0,0,0,0,1,0,0,19,ENG
e46012d4,22,15,6,12,4,7,21,14,13,1,12,3,25,2,1,19,ENG
e514ab62,27,19,15,7,5,12,26,14,19,3,16,27,54,42,0,19,ENG
e5d01ecf,48,30,34,12,2,24,51,27,24,6,18,36,84,68,0,19,ENG
e608ed4c,0,0,0,0,0,0,0,0,0,0,0,0,0,2,0,19,ENG
e61b8aee,52,29,29,20,3,24,59,35,35,9,26,36,88,56,3,19,ENG
e726e11e,0,0,0,0,0,0,0,0,1,0,1,0,0,0,0,19,ENG
e77dc3b2,8,3,1,4,3,1,8,7,4,1,3,2,10,9,0,19,ENG
e7ca0439,34,20,27,7,0,15,28,13,23,10,13,34,68,184,3,19,ENG
e9208654,26,13,14,11,1,10,25,15,12,4,8,18,44,25,0,19,ENG
e92cd3f7,2,1,0,0,2,1,2,1,0,0,0,0,2,3,0,19,ENG
e97fd090,18,12,7,7,4,3,12,9,10,4,6,11,29,5,0,19,ENG
eaeca114,66,35,42,21,3,22,35,13,51,35,16,32,98,241,0,19,ENG
eb58eef0,41,28,14,20,7,14,27,13,21,7,14,21,62,24,0,19,ENG
eb7822d7,50,30,27,19,4,30,59,29,39,18,21,31,81,53,4,19,ENG
eba42d2b,33,18,14,18,1,11,20,9,6,0,6,15,48,19,0,19,ENG
ec9a28ce,0,0,0,0,0,0,0,0,4,1,3,1,1,2,0,19,ENG
ecbb3fdf,30,19,14,10,6,12,42,30,16,1,15,8,38,17,1,19,ENG
ed1e53f3,7,6,1,3,3,2,9,7,1,0,1,4,11,1,0,19,ENG
ee38d9c5,48,32,20,25,3,14,58,44,20,4,16,12,60,10,1,19,ENG
ef619b0b,34,18,11,15,8,7,25,18,7,1,6,9,43,3,0,19,ENG
f13d02a6,18,14,7,7,4,7,23,16,15,0,15,9,27,6,0,19,ENG
f1e8372d,0,0,0,0,0,0,0,0,0,0,0,0,0,0,0,19,ENG
f25b010f,16,12,12,4,0,10,18,8,19,12,7,25,41,106,1,19,ENG
f25c8e3a,37,15,13,19,5,14,42,28,29,4,25,12,49,16,1,19,ENG
f2f29dda,17,7,4,7,6,4,20,16,20,3,17,2,19,17,1,19,ENG
f4290206,73,46,44,22,7,33,58,25,25,2,23,39,112,101,0,19,ENG
f522d7ec,20,9,8,8,4,5,14,9,11,0,11,1,21,4,0,19,ENG
f573a8bf,15,12,4,8,3,2,5,3,6,0,6,2,17,11,0,19,ENG
f5a00fa4,113,58,50,56,7,44,126,82,56,11,45,40,153,50,0,19,ENG
f5deef4c,40,27,28,12,0,13,23,10,21,12,9,24,64,121,3,19,ENG
f5e6d08d,0,0,0,0,0,0,0,0,0,0,0,0,0,0,0,19,ENG
f5efb153,19,11,9,9,1,10,16,6,20,15,5,30,49,72,0,19,ENG
f72293fc,27,11,14,10,3,16,34,18,25,4,21,33,60,34,0,19,ENG
f7750aa0,48,34,29,16,3,21,33,12,45,24,21,42,90,153,0,19,ENG
f7d50789,37,23,25,10,2,12,22,10,41,22,19,24,61,175,0,19,ENG
f7ee69fb,13,9,6,6,1,4,7,3,4,1,3,7,20,5,2,19,ENG
f874dd44,15,12,8,4,3,6,13,7,17,5,12,20,35,37,3,19,ENG
f8fcd2a5,24,13,20,4,0,13,18,5,28,10,18,33,57,152,3,19,ENG
fa031b34,49,34,19,20,10,8,24,16,30,2,28,16,65,39,0,19,ENG
fc15fb84,36,22,16,17,3,13,44,31,30,3,27,13,49,35,0,19,ENG
fd3f57ce,8,5,2,5,1,1,7,6,3,1,2,3,11,8,0,19,ENG
fd5888a0,4,4,2,1,1,2,6,4,8,1,7,7,11,5,0,19,ENG
fdd85f94,50,28,23,21,6,16,52,36,21,6,15,53,103,37,0,19,ENG
fe558029,0,0,0,0,0,0,0,0,0,0,0,0,0,2,0,19,ENG
fed96827,9,3,9,0,0,7,11,4,12,5,7,14,23,57,2,19,ENG
ff527768,47,26,19,24,4,17,52,35,17,2,15,21,68,13,0,19,ENG
ff9fcd4d,36,24,10,18,8,10,35,25,26,2,24,17,53,9,0,19,ENG
005ca692,1,1,0,1,0,0,2,2,0,0,0,1,2,0,0,19,EL
00672021,2,1,1,0,1,1,8,7,5,1,4,3,5,3,0,19,EL
0076ab7f,16,10,4,11,1,2,3,1,5,2,3,4,20,1,1,19,EL
00bc97e8,1,0,0,1,0,1,2,1,0,0,0,3,4,13,0,19,EL
01834aa0,8,4,6,1,1,5,6,1,7,2,5,9,17,12,0,19,EL
023efc8b,6,5,2,4,0,2,7,5,5,0,5,5,11,3,1,19,EL
02ce2030,9,7,7,2,0,3,8,5,11,9,2,14,23,28,1,19,EL
02df3a4b,8,7,8,0,0,4,6,2,3,1,2,8,16,17,0,19,EL
0331786b,1,0,1,0,0,1,1,0,0,0,0,0,1,3,0,19,EL
0366fc78,9,5,2,6,1,2,8,6,6,0,6,5,14,3,0,19,EL
0375723e,0,0,0,0,0,0,1,1,3,0,3,0,0,0,0,19,EL
03df04ff,0,0,0,0,0,0,0,0,0,0,0,0,0,3,0,19,EL
04965583,7,4,5,1,1,3,5,2,2,0,2,7,14,4,0,19,EL
04da2b40,1,1,1,0,0,1,1,0,0,0,0,1,2,2,0,19,EL
0538066d,0,0,0,0,0,0,0,0,0,0,0,0,0,2,0,19,EL
0562b7f1,3,3,1,0,2,1,4,3,2,1,1,2,5,8,0,19,EL
059a0231,1,1,0,1,0,0,0,0,1,1,0,1,2,0,0,19,EL
05a6c38b,0,0,0,0,0,0,0,0,1,1,0,1,1,2,0,19,EL
05e19d6a,2,1,1,1,0,0,0,0,2,1,1,2,4,1,0,19,EL
0630eb63,0,0,0,0,0,0,0,0,1,0,1,2,2,1,0,19,EL
0638becf,3,2,3,0,0,1,2,1,6,2,4,3,6,3,0,19,EL
06972405,0,0,0,0,0,0,0,0,1,0,1,0,0,0,0,19,EL
06b2765c,6,2,3,3,0,2,4,2,0,0,0,3,9,3,0,19,EL
06e5b0e4,16,10,10,5,1,4,11,7,9,6,3,20,36,41,0,19,EL
06fee814,0,0,0,0,0,0,0,0,0,0,0,0,0,1,0,19,EL
070ec0b1,4,3,3,1,0,1,3,2,7,4,3,9,13,7,0,19,EL
07ab6542,0,0,0,0,0,0,0,0,0,0,0,0,0,0,0,19,EL
07abb358,0,0,0,0,0,0,1,1,0,0,0,1,1,0,0,19,EL
07f8bcc8,6,5,1,4,1,1,2,1,0,0,0,0,6,1,0,19,EL
080440a4,24,14,13,11,0,10,16,6,8,6,2,12,36,29,0,19,EL
08593525,32,25,16,14,2,10,22,12,18,1,17,29,61,14,0,19,EL
086d7db3,0,0,0,0,0,0,0,0,1,0,1,2,2,3,0,19,EL
088e6424,0,0,0,0,0,0,0,0,0,0,0,0,0,1,1,19,EL
089550f5,7,5,4,2,1,6,7,1,1,0,1,2,9,4,1,19,EL
08990838,1,1,0,1,0,1,3,2,2,1,1,3,4,17,0,19,EL
08a2c314,0,0,0,0,0,0,0,0,0,0,0,0,0,1,0,19,EL
08d37c53,1,1,1,0,0,1,1,0,3,2,1,4,5,6,0,19,EL
08fe932d,5,5,4,0,1,4,6,2,1,1,0,2,7,13,0,19,EL
0990f2fb,9,6,6,1,2,4,6,2,8,4,4,3,12,19,0,19,EL
09a9e921,1,1,0,0,1,0,2,2,1,0,1,3,4,6,0,19,EL
0a0cc13c,0,0,0,0,0,0,3,3,1,0,1,0,0,0,0,19,EL
0a215326,5,2,2,3,0,2,8,6,7,0,7,8,13,5,0,19,EL
0a447501,2,1,0,0,2,0,0,0,0,0,0,0,2,2,0,19,EL
0a6dbbf7,6,1,3,2,1,2,3,1,4,3,1,2,8,11,0,19,EL
0a86fd8b,0,0,0,0,0,0,0,0,0,0,0,0,0,0,0,19,EL
0ac94a23,3,2,1,2,0,1,5,4,4,0,4,2,5,0,0,19,EL
0ad69fd0,2,2,0,1,1,0,1,1,0,0,0,1,3,1,0,19,EL
0b5a292a,9,8,4,3,2,4,6,2,6,1,5,5,14,12,0,19,EL
0b90bb97,4,3,0,3,1,1,4,3,3,0,3,0,4,2,0,19,EL
0be28faf,12,7,6,6,0,5,7,2,9,2,7,3,15,6,0,19,EL
0be3255b,0,0,0,0,0,0,1,1,0,0,0,0,0,0,0,19,EL
0be95d34,4,2,1,1,2,2,2,0,5,0,5,2,6,1,0,19,EL
0c09c984,8,4,4,4,0,2,7,5,7,0,7,10,18,5,0,19,EL
0d10333c,8,2,3,4,1,5,11,6,7,0,7,3,11,7,0,19,EL
0e100630,2,2,2,0,0,2,2,0,1,0,1,1,3,2,0,19,EL
0e21fc3c,3,1,0,1,2,2,4,2,7,0,7,4,7,0,0,19,EL
0e4fef6e,1,0,1,0,0,1,3,2,3,2,1,1,2,3,1,19,EL
0e7ccfc4,8,6,4,4,0,6,11,5,7,1,6,0,8,14,0,19,EL
0eb03d5b,1,0,1,0,0,0,0,0,1,1,0,2,3,5,0,19,EL
0eeafda5,0,0,0,0,0,0,0,0,0,0,0,2,2,0,0,19,EL
0ef05b3e,0,0,0,0,0,0,0,0,0,0,0,0,0,0,0,19,EL
0efacb06,0,0,0,0,0,0,1,1,2,0,2,1,1,3,0,19,EL
0f276764,0,0,0,0,0,0,1,1,0,0,0,0,0,2,1,19,EL
0f5e0b8a,0,0,0,0,0,0,0,0,0,0,0,0,0,0,0,19,EL
0fbecd11,13,7,6,6,1,2,4,2,8,0,8,14,27,5,0,19,EL
1001ae82,0,0,0,0,0,0,0,0,0,0,0,0,0,0,0,19,EL
10549b49,2,2,1,1,0,0,1,1,1,0,1,0,2,2,0,19,EL
10b9fa99,1,1,1,0,0,0,2,2,0,0,0,5,6,3,0,19,EL
110a95ca,0,0,0,0,0,0,0,0,0,0,0,0,0,5,1,19,EL
114b510e,7,3,6,1,0,2,3,1,2,1,1,4,11,16,0,19,EL
115b7ab9,0,0,0,0,0,0,0,0,0,0,0,0,0,1,0,19,EL
11c0fa9d,0,0,0,0,0,0,0,0,2,0,2,1,1,1,0,19,EL
121101a4,3,3,1,2,0,1,1,0,0,0,0,7,10,25,0,19,EL
1232e1dc,0,0,0,0,0,0,1,1,1,0,1,5,5,6,0,19,EL
1295552e,20,12,14,5,1,9,20,11,13,2,11,15,35,8,1,19,EL
129af0db,0,0,0,0,0,0,1,1,1,0,1,0,0,2,0,19,EL
12c50af5,0,0,0,0,0,0,0,0,0,0,0,0,0,0,0,19,EL
130a7a3f,6,2,2,3,1,2,7,5,6,0,6,3,9,2,0,19,EL
1321d6f0,10,7,9,1,0,5,9,4,11,6,5,15,25,39,0,19,EL
133faa84,3,1,3,0,0,1,2,1,7,2,5,5,8,8,0,19,EL
13a78e01,13,6,7,6,0,4,11,7,17,3,14,9,22,16,0,19,EL
13b0c150,4,4,3,1,0,2,2,0,1,0,1,5,9,7,0,19,EL
13b44b02,38,18,21,14,3,16,31,15,9,4,5,8,46,28,1,19,EL
13d74bff,11,9,5,4,2,2,13,11,8,0,8,11,22,8,0,19,EL
13ea2544,7,6,2,3,2,4,14,10,3,0,3,12,19,8,0,19,EL
1453e3cf,1,1,0,1,0,1,1,0,0,0,0,0,1,0,0,19,EL
146f2615,5,3,1,2,2,1,4,3,4,0,4,1,6,1,0,19,EL
150a572c,7,5,6,1,0,5,6,1,3,1,2,4,11,12,0,19,EL
156afd6f,0,0,0,0,0,0,1,1,0,0,0,0,0,0,0,19,EL
157c5e0b,12,7,3,5,4,4,10,6,2,0,2,1,13,2,0,19,EL
15b6e8d7,10,5,1,7,2,5,12,7,5,1,4,7,17,15,0,19,EL
15d0c248,11,8,4,7,0,7,13,6,9,7,2,10,21,17,0,19,EL
15e9c7e6,3,1,2,1,0,2,5,3,7,0,7,2,5,3,0,19,EL
15f3ec41,6,4,2,2,2,1,2,1,5,0,5,1,7,0,3,19,EL
16380240,7,5,1,3,3,1,6,5,4,0,4,2,9,1,0,19,EL
163bbd4a,0,0,0,0,0,0,0,0,1,0,1,0,0,0,0,19,EL
167c1bb0,2,1,1,1,0,0,1,1,0,0,0,2,4,8,1,19,EL
16b9d5cf,8,7,6,2,0,1,1,0,3,2,1,2,10,14,1,19,EL
16ceb862,7,3,2,3,2,1,11,10,11,1,10,0,7,7,0,19,EL
16daec92,26,15,5,16,5,10,35,25,16,1,15,24,50,4,0,19,EL
17145c90,10,5,5,5,0,6,11,5,6,1,5,20,30,37,0,19,EL
173db1f4,6,4,4,1,1,3,8,5,11,0,11,5,11,2,0,19,EL
17695062,2,2,0,2,0,1,2,1,4,0,4,4,6,3,0,19,EL
179d2851,0,0,0,0,0,0,1,1,0,0,0,1,1,6,3,19,EL
17e3e467,13,7,3,9,1,5,21,16,4,0,4,1,14,3,0,19,EL
18abe173,9,5,8,1,0,5,9,4,5,2,3,15,24,16,3,19,EL
18b896d6,4,3,2,2,0,1,2,1,1,0,1,2,6,13,0,19,EL
19003991,2,2,1,0,1,1,2,1,1,0,1,1,3,1,0,19,EL
1978a39a,10,6,6,4,0,5,11,6,8,2,6,10,20,14,0,19,EL
199cd404,5,4,2,2,1,2,5,3,3,0,3,3,8,0,0,19,EL
19b776e9,1,1,0,0,1,0,2,2,6,0,6,5,6,0,0,19,EL
19c9e24e,5,2,5,0,0,4,4,0,1,1,0,3,8,9,0,19,EL
19f8e480,5,4,4,1,0,3,4,1,4,1,3,5,10,10,0,19,EL
1a4b9094,6,5,3,3,0,1,1,0,5,2,3,4,10,5,0,19,EL
1a799243,13,10,5,8,0,8,13,5,14,2,12,9,22,23,1,19,EL
1ac58ba6,6,4,5,1,0,4,6,2,3,0,3,8,14,14,1,19,EL
1adcf39e,5,2,3,2,0,3,3,0,0,0,0,2,7,4,0,19,EL
1ae8b66d,7,4,5,2,0,3,11,8,3,0,3,2,9,9,0,19,EL
1b09b065,8,5,2,3,3,4,5,1,2,0,2,1,9,1,0,19,EL
1b4f1169,0,0,0,0,0,0,1,1,1,0,1,0,0,0,0,19,EL
1b82f8df,5,5,1,4,0,1,4,3,6,0,6,5,10,4,0,19,EL
1bcca8b8,2,1,1,1,0,1,4,3,2,0,2,4,6,1,0,19,EL
1c07b06e,6,3,2,4,0,0,3,3,1,1,0,5,11,6,0,19,EL
1c0ddebb,0,0,0,0,0,0,0,0,0,0,0,0,0,2,1,19,EL
1c37137f,3,2,2,0,1,1,3,2,3,0,3,1,4,3,0,19,EL
1c529186,7,4,1,2,4,2,4,2,2,2,0,2,9,4,0,19,EL
1c639185,2,1,2,0,0,0,0,0,1,0,1,1,3,0,0,19,EL
1c78737d,7,3,3,4,0,1,7,6,3,1,2,6,13,4,0,19,EL
1c96ad85,6,4,3,2,1,3,7,4,5,1,4,3,9,3,0,19,EL
1cb49278,14,7,7,7,0,6,8,2,12,4,8,22,36,36,0,19,EL
1d2d5cc8,0,0,0,0,0,0,0,0,0,0,0,0,0,0,1,19,EL
1d5cab82,13,9,7,5,1,3,7,4,6,0,6,2,15,2,0,19,EL
1e064bfb,0,0,0,0,0,0,2,2,0,0,0,1,1,4,1,19,EL
1e101451,0,0,0,0,0,0,0,0,0,0,0,0,0,4,0,19,EL
1e9bde92,0,0,0,0,0,0,2,2,0,0,0,0,0,2,0,19,EL
1ec5df8f,1,0,1,0,0,0,0,0,0,0,0,2,3,12,0,19,EL
1ec7e1c5,16,5,13,3,0,6,10,4,13,8,5,14,30,35,0,19,EL
1eec640e,4,4,1,0,3,2,9,7,1,0,1,0,4,0,0,19,EL
1ef6f38d,3,0,1,2,0,1,2,1,3,1,2,2,5,0,0,19,EL
1f44ac21,0,0,0,0,0,0,0,0,0,0,0,0,0,0,0,19,EL
1f9328da,9,8,5,3,1,3,6,3,0,0,0,1,10,0,0,19,EL
1fa665d0,1,1,1,0,0,1,2,1,1,0,1,0,1,0,0,19,EL
1fb1c435,2,2,1,1,0,0,0,0,1,1,0,1,3,1,0,19,EL
1fbbfbde,16,12,13,3,0,5,9,4,9,3,6,18,34,27,1,19,EL
20030c06,14,9,7,5,2,6,10,4,4,2,2,9,23,20,0,19,EL
20094685,8,5,5,3,0,1,8,7,5,0,5,2,10,3,0,19,EL
2054d037,7,4,2,4,1,1,2,1,3,0,3,3,10,9,1,19,EL
2077ae86,1,0,0,0,1,0,0,0,0,0,0,1,2,0,0,19,EL
20b9f052,0,0,0,0,0,0,0,0,0,0,0,0,0,1,0,19,EL
20c1ef47,1,0,0,1,0,0,2,2,1,0,1,0,1,3,0,19,EL
20e73fac,10,6,6,4,0,5,13,8,8,0,8,6,16,3,0,19,EL
2146785a,17,9,11,6,0,13,19,6,3,1,2,2,19,6,0,19,EL
21519148,8,3,5,3,0,2,9,7,6,0,6,5,13,5,0,19,EL
21a4bd09,5,1,1,4,0,1,3,2,6,1,5,6,11,10,0,19,EL
2224380e,0,0,0,0,0,0,0,0,0,0,0,1,1,0,0,19,EL
2233ef48,3,2,1,2,0,2,5,3,2,0,2,5,8,7,0,19,EL
2249e65b,1,1,0,1,0,0,1,1,1,0,1,0,1,1,0,19,EL
22517bbe,11,4,8,3,0,4,7,3,5,1,4,9,20,18,2,19,EL
22721b88,9,8,7,2,0,4,5,1,5,1,4,13,22,12,0,19,EL
228f73ae,0,0,0,0,0,0,1,1,0,0,0,0,0,0,0,19,EL
22db7a5e,0,0,0,0,0,0,0,0,0,0,0,0,0,4,0,19,EL
23135233,6,4,5,1,0,5,6,1,0,0,0,2,8,0,0,19,EL
23c5db70,3,2,1,1,1,1,4,3,4,0,4,4,7,0,0,19,EL
24228180,9,8,2,3,4,0,3,3,10,2,8,2,11,1,0,19,EL
2434f24a,0,0,0,0,0,0,0,0,0,0,0,1,1,0,0,19,EL
243f4a0b,13,10,6,7,0,5,9,4,6,0,6,6,19,7,1,19,EL
244a31b9,5,3,4,0,1,1,1,0,2,2,0,9,14,20,0,19,EL
245d9bfc,5,3,3,1,1,1,4,3,6,0,6,2,7,0,0,19,EL
24b98f95,0,0,0,0,0,0,0,0,0,0,0,0,0,0,0,19,EL
24c1439d,1,1,0,0,1,1,1,0,0,0,0,0,1,0,0,19,EL
24d9435b,17,10,11,5,1,10,14,4,7,5,2,7,24,16,0,19,EL
24f59bb2,7,3,3,3,1,3,5,2,7,1,6,3,10,5,0,19,EL
2535e885,12,8,9,3,0,7,11,4,6,4,2,6,18,33,0,19,EL
254147d4,4,3,4,0,0,3,6,3,5,0,5,5,9,3,0,19,EL
2557c196,2,1,2,0,0,1,4,3,2,1,1,2,4,3,0,19,EL
2580854e,0,0,0,0,0,0,0,0,1,1,0,2,2,5,0,19,EL
258aff54,7,4,1,4,2,2,8,6,2,0,2,0,7,3,0,19,EL
258b0d9b,11,8,7,4,0,6,9,3,9,7,2,11,22,21,0,19,EL
25b74470,4,1,3,1,0,2,3,1,1,0,1,2,6,1,0,19,EL
25e8594b,19,10,9,9,1,11,18,7,6,3,3,5,24,5,1,19,EL
2628fd2b,0,0,0,0,0,0,0,0,0,0,0,0,0,1,0,19,EL
26383ea5,0,0,0,0,0,0,0,0,0,0,0,0,0,1,1,19,EL
2648e18f,2,0,0,2,0,2,4,2,3,0,3,2,4,3,0,19,EL
26b3d752,6,4,2,3,1,1,4,3,5,2,3,7,13,8,0,19,EL
26ce2263,18,10,9,7,2,5,16,11,12,5,7,8,26,7,0,19,EL
271b8617,0,0,0,0,0,0,0,0,0,0,0,0,0,0,0,19,EL
273c483b,7,5,6,1,0,3,5,2,7,0,7,0,7,2,0,19,EL
27669186,0,0,0,0,0,0,0,0,0,0,0,0,0,1,0,19,EL
27af684a,1,1,1,0,0,1,2,1,0,0,0,2,3,4,0,19,EL
27f54333,3,2,0,2,1,0,3,3,3,0,3,1,4,0,0,19,EL
27fc233a,3,1,2,0,1,3,3,0,0,0,0,2,5,0,0,19,EL
27ff9bdb,7,4,2,4,1,3,7,4,7,0,7,4,11,6,0,19,EL
284f2ce6,2,1,0,2,0,0,1,1,1,0,1,5,7,7,0,19,EL
28d596a0,0,0,0,0,0,0,0,0,0,0,0,0,0,4,3,19,EL
292a652a,0,0,0,0,0,0,0,0,2,1,1,0,0,4,0,19,EL
29a506e1,0,0,0,0,0,0,0,0,0,0,0,0,0,0,0,19,EL
29d8ad3f,5,4,5,0,0,3,5,2,3,2,1,16,21,45,1,19,EL
29e33bf3,4,4,1,2,1,1,4,3,8,0,8,1,5,1,0,19,EL
2a5fab54,0,0,0,0,0,0,0,0,0,0,0,0,0,0,0,19,EL
2a6cd437,6,3,6,0,0,3,4,1,5,4,1,3,9,30,0,19,EL
2a709dc0,1,1,1,0,0,1,3,2,1,0,1,1,2,1,0,19,EL
2b15a82a,6,3,4,2,0,3,3,0,2,0,2,2,8,4,0,19,EL
2b3efa4a,19,14,11,7,1,12,27,15,9,3,6,22,41,35,0,19,EL
2b9fdeea,0,0,0,0,0,0,1,1,0,0,0,0,0,1,0,19,EL
2ba38347,8,6,4,3,1,6,9,3,4,0,4,6,14,14,0,19,EL
2c44a35d,9,5,5,3,1,3,4,1,1,0,1,2,11,4,1,19,EL
2c8b7022,9,6,2,6,1,5,11,6,8,2,6,7,16,16,0,19,EL
2ccd89a3,3,1,1,2,0,1,3,2,2,0,2,0,3,0,0,19,EL
2e2ec9cf,6,2,2,4,0,5,9,4,3,0,3,5,11,4,0,19,EL
2e8fc160,3,1,0,3,0,1,7,6,3,2,1,3,6,6,0,19,EL
2ebc1b44,5,3,2,2,1,2,5,3,5,0,5,1,6,2,0,19,EL
2f3452eb,6,4,3,3,0,5,8,3,2,0,2,9,15,8,0,19,EL
2f557579,3,1,2,1,0,2,4,2,1,0,1,0,3,0,0,19,EL
2f7407fa,0,0,0,0,0,0,0,0,0,0,0,0,0,0,0,19,EL
2f7af524,19,9,10,7,2,8,12,4,7,2,5,10,29,33,0,19,EL
2fabebc0,0,0,0,0,0,0,0,0,0,0,0,0,0,1,0,19,EL
305a3820,3,3,1,2,0,1,2,1,2,2,0,12,15,19,0,19,EL
30643ce2,0,0,0,0,0,0,1,1,1,0,1,0,0,5,0,19,EL
307fcd26,1,1,1,0,0,0,0,0,0,0,0,0,1,6,0,19,EL
30c220c3,17,13,7,8,2,7,9,2,8,1,7,11,28,9,0,19,EL
30d4a2e5,25,20,19,5,1,19,29,10,5,3,2,29,54,26,0,19,EL
30f5ffa9,5,2,5,0,0,3,6,3,6,4,2,6,11,14,0,19,EL
314bdac5,11,7,6,5,0,6,7,1,10,2,8,6,17,9,1,19,EL
314c2af0,0,0,0,0,0,0,0,0,0,0,0,0,0,4,0,19,EL
314f2124,0,0,0,0,0,0,0,0,1,1,0,2,2,6,0,19,EL
316de854,7,5,1,3,3,3,5,2,4,0,4,4,11,1,0,19,EL
31c07205,2,0,1,1,0,0,1,1,0,0,0,2,4,2,0,19,EL
31c69ef1,16,7,11,5,0,12,18,6,7,1,6,4,20,32,0,19,EL
321f83a2,3,1,2,0,1,1,1,0,7,0,7,0,3,1,0,19,EL
322ba2df,3,1,3,0,0,1,3,2,0,0,0,6,9,7,0,19,EL
32c0491f,6,6,6,0,0,2,4,2,4,1,3,5,11,8,0,19,EL
32e7ce92,0,0,0,0,0,0,1,1,0,0,0,0,0,1,0,19,EL
3300c14c,1,1,1,0,0,1,2,1,1,1,0,2,3,7,0,19,EL
33182cb8,13,6,2,7,4,1,1,0,6,1,5,3,16,4,0,19,EL
33508c78,5,5,2,2,1,3,11,8,4,1,3,2,7,1,0,19,EL
339fe0e8,0,0,0,0,0,0,0,0,0,0,0,0,0,2,0,19,EL
33b11df6,0,0,0,0,0,0,0,0,1,0,1,3,3,1,0,19,EL
33b8d077,3,2,1,2,0,1,3,2,1,0,1,3,6,3,0,19,EL
33bd3dae,2,2,0,2,0,0,4,4,5,0,5,3,5,1,0,19,EL
3423f250,9,8,2,6,1,1,4,3,5,0,5,7,16,0,0,19,EL
3470f44e,0,0,0,0,0,0,0,0,0,0,0,0,0,0,0,19,EL
34c3b935,0,0,0,0,0,0,0,0,0,0,0,0,0,2,1,19,EL
34c3ec17,9,7,3,6,0,5,10,5,6,0,6,10,19,7,1,19,EL
3519df17,14,10,11,2,1,6,9,3,3,0,3,17,31,24,0,19,EL
35375f7c,3,2,2,0,1,1,2,1,0,0,0,0,3,1,0,19,EL
356c9002,2,1,1,1,0,2,4,2,1,0,1,0,2,5,0,19,EL
35862524,14,10,3,10,1,6,7,1,5,1,4,4,18,4,0,19,EL
35af81f5,1,0,1,0,0,0,0,0,0,0,0,0,1,0,0,19,EL
35bd124a,0,0,0,0,0,0,0,0,0,0,0,0,0,11,0,19,EL
35c54115,5,4,5,0,0,3,6,3,7,4,3,7,12,20,0,19,EL
35cf43aa,5,3,2,3,0,1,4,3,3,1,2,6,11,4,0,19,EL
360e3062,10,6,7,2,1,6,11,5,7,2,5,11,21,14,0,19,EL
3628b9b9,6,4,3,3,0,0,5,5,3,1,2,20,26,30,1,19,EL
36334b41,11,9,5,6,0,2,12,10,6,0,6,6,17,9,0,19,EL
3640af28,8,7,6,2,0,7,9,2,1,1,0,3,11,7,0,19,EL
365836c9,13,7,7,6,0,5,7,2,8,6,2,13,26,24,1,19,EL
367d7444,4,3,3,1,0,3,5,2,6,5,1,8,12,6,0,19,EL
378825c7,17,9,9,6,2,8,15,7,3,0,3,12,29,16,0,19,EL
37f827ec,5,2,4,1,0,3,5,2,1,1,0,3,8,15,1,19,EL
387750b7,0,0,0,0,0,0,2,2,1,0,1,0,0,5,1,19,EL
38cd5b8f,0,0,0,0,0,0,0,0,0,0,0,0,0,3,1,19,EL
38ceb24a,7,4,3,4,0,2,6,4,5,1,4,6,13,4,0,19,EL
38d14822,0,0,0,0,0,0,0,0,1,0,1,0,0,0,1,19,EL
390ab439,3,3,3,0,0,1,3,2,3,2,1,4,7,8,0,19,EL
392a7aea,4,3,2,2,0,1,1,0,4,1,3,1,5,1,0,19,EL
3935e52e,10,7,7,3,0,4,11,7,10,1,9,9,19,16,0,19,EL
3958025f,0,0,0,0,0,0,0,0,0,0,0,0,0,0,0,19,EL
3a233281,4,4,3,1,0,2,8,6,4,0,4,7,11,0,1,19,EL
3a24769f,11,8,1,9,1,4,9,5,6,1,5,7,18,11,0,19,EL
3aa4a3be,4,3,0,3,1,0,2,2,1,0,1,2,6,1,0,19,EL
3b571db6,7,4,3,4,0,3,4,1,0,0,0,5,12,3,0,19,EL
3b57f7f8,1,0,0,1,0,0,0,0,3,2,1,2,3,1,0,19,EL
3bf81c50,0,0,0,0,0,0,0,0,1,0,1,1,1,1,0,19,EL
3ca7254a,13,10,2,8,3,2,11,9,7,0,7,5,18,4,1,19,EL
3d13d9e4,0,0,0,0,0,0,0,0,0,0,0,0,0,0,0,19,EL
3d68d631,17,14,3,9,5,10,19,9,8,0,8,4,21,2,0,19,EL
3da8cba0,3,2,1,2,0,1,4,3,0,0,0,1,4,0,0,19,EL
3dab8efd,0,0,0,0,0,0,1,1,1,0,1,0,0,0,0,19,EL
3de25195,4,3,2,2,0,3,6,3,3,0,3,3,7,2,0,19,EL
3e975352,0,0,0,0,0,0,0,0,0,0,0,1,1,0,0,19,EL
3ead85f9,3,3,2,1,0,0,2,2,1,1,0,2,5,11,0,19,EL
3ef0af0d,3,2,2,1,0,1,3,2,4,0,4,6,9,4,0,19,EL
3effaa34,2,1,0,1,1,1,2,1,1,0,1,0,2,3,0,19,EL
3f10bd22,7,3,4,3,0,3,4,1,4,0,4,6,13,11,0,19,EL
3f2d59fe,4,4,3,1,0,1,2,1,4,2,2,8,12,17,1,19,EL
3f359b33,10,9,7,3,0,7,12,5,8,3,5,14,24,27,0,19,EL
3f65d5ce,0,0,0,0,0,0,0,0,0,0,0,0,0,1,1,19,EL
41b9d0c0,2,2,1,1,0,0,3,3,4,0,4,0,2,0,0,19,EL
41f32541,3,2,0,2,1,2,5,3,3,1,2,2,5,1,0,19,EL
42276181,1,1,0,0,1,0,2,2,2,0,2,1,2,1,0,19,EL
42353de8,2,2,1,1,0,0,0,0,7,5,2,12,14,33,0,19,EL
42a55711,5,3,2,1,2,2,3,1,5,2,3,2,7,4,0,19,EL
42a632ba,0,0,0,0,0,0,0,0,0,0,0,0,0,2,0,19,EL
42dcf26d,1,1,1,0,0,1,2,1,4,2,2,12,13,22,1,19,EL
42fe6b05,7,4,5,2,0,1,3,2,6,0,6,3,10,5,0,19,EL
43688fa3,4,3,3,1,0,1,5,4,1,0,1,5,9,1,0,19,EL
4383b0da,3,1,0,2,1,0,1,1,0,0,0,1,4,3,0,19,EL
438ae11e,3,1,2,1,0,0,3,3,3,2,1,1,4,2,0,19,EL
43b23d3a,5,4,1,3,1,1,6,5,4,0,4,2,7,5,0,19,EL
441197b8,15,7,8,7,0,11,14,3,11,5,6,11,26,42,1,19,EL
4431aed2,3,1,0,2,1,1,2,1,0,0,0,0,3,0,0,19,EL
448a3608,1,0,0,0,1,0,2,2,4,0,4,1,2,7,0,19,EL
44ac04e9,8,4,5,3,0,3,9,6,6,2,4,4,12,3,0,19,EL
44c3d1d2,0,0,0,0,0,0,0,0,1,0,1,1,1,0,0,19,EL
44eb9093,2,2,2,0,0,1,3,2,3,1,2,5,7,7,0,19,EL
44f050bc,20,15,17,2,1,8,14,6,16,9,7,13,33,47,1,19,EL
4574720b,6,4,1,4,1,2,3,1,4,0,4,2,8,8,0,19,EL
45b9b619,5,1,1,4,0,0,2,2,2,0,2,2,7,5,0,19,EL
45db685d,23,9,6,15,2,10,26,16,15,2,13,15,38,14,1,19,EL
45f5aa2f,7,4,6,1,0,3,4,1,0,0,0,6,13,10,0,19,EL
460976a2,6,4,2,4,0,0,6,6,7,0,7,6,12,6,0,19,EL
467bae22,16,7,8,8,0,2,8,6,5,1,4,10,26,7,0,19,EL
46e58246,8,4,7,1,0,4,6,2,2,1,1,7,15,7,0,19,EL
474cf8e0,6,3,6,0,0,5,6,1,5,2,3,2,8,7,0,19,EL
479ccb18,6,2,0,5,1,0,1,1,2,0,2,0,6,0,0,19,EL
47a34c4f,3,2,1,1,1,1,2,1,9,3,6,4,7,6,1,19,EL
47dbe004,13,10,1,9,3,2,4,2,7,3,4,11,24,8,0,19,EL
47fd5136,2,2,1,1,0,1,2,1,1,0,1,6,8,18,0,19,EL
4802f157,13,6,3,6,4,5,8,3,10,1,9,4,17,16,0,19,EL
487d9b09,7,5,3,3,1,1,5,4,4,0,4,4,11,8,0,19,EL
489e5d93,8,6,1,4,3,2,16,14,6,0,6,0,8,7,0,19,EL
48d5bd33,9,7,4,5,0,2,14,12,13,0,13,7,16,4,0,19,EL
48e4c485,5,2,1,3,1,1,2,1,2,1,1,2,7,2,0,19,EL
494bff86,1,0,1,0,0,1,5,4,6,1,5,3,4,7,0,19,EL
49fe9070,1,1,0,1,0,0,0,0,1,0,1,1,2,0,0,19,EL
4a1abff3,8,7,3,3,2,1,3,2,6,0,6,1,9,1,0,19,EL
4a537185,2,2,2,0,0,0,0,0,0,0,0,1,3,0,0,19,EL
4adc7b42,22,15,6,10,6,10,22,12,8,0,8,4,26,3,0,19,EL
4aea5077,22,17,12,5,5,10,17,7,13,2,11,14,36,24,0,19,EL
4b3c863f,8,5,5,3,0,3,7,4,1,1,0,8,16,23,0,19,EL
4b3e1a38,11,10,10,1,0,6,11,5,17,2,15,10,21,40,1,19,EL
4b6960d2,3,2,2,0,1,2,3,1,2,0,2,4,7,2,0,19,EL
4b751020,4,1,2,1,1,1,5,4,1,0,1,2,6,1,0,19,EL
4b803b3c,1,0,1,0,0,1,1,0,2,0,2,1,2,0,0,19,EL
4bd00a50,1,1,1,0,0,1,1,0,0,0,0,1,2,0,0,19,EL
4c5039bd,0,0,0,0,0,0,0,0,0,0,0,0,0,5,0,19,EL
4c537d70,1,1,0,1,0,0,0,0,0,0,0,1,2,3,0,19,EL
4c5b14d2,5,4,4,1,0,4,6,2,3,1,2,6,11,7,0,19,EL
4c5e78da,18,10,5,8,5,5,14,9,23,2,21,8,26,10,0,19,EL
4c700f46,7,5,4,2,1,2,5,3,4,2,2,7,14,9,0,19,EL
4c78b5ed,14,10,6,8,0,5,9,4,3,2,1,3,17,5,0,19,EL
4c82730b,8,7,4,2,2,4,17,13,5,0,5,2,10,2,0,19,EL
4cc82fe1,3,1,3,0,0,2,2,0,1,1,0,3,6,4,0,19,EL
4d1666ff,8,4,6,2,0,3,4,1,7,3,4,9,17,27,0,19,EL
4d425e6e,11,7,3,5,3,6,13,7,5,0,5,4,15,3,0,19,EL
4d8cd038,8,5,2,3,3,2,4,2,2,0,2,2,10,10,0,19,EL
4e219ad2,2,1,2,0,0,1,2,1,2,0,2,0,2,1,0,19,EL
4e3f5992,0,0,0,0,0,0,0,0,1,0,1,0,0,0,0,19,EL
4e6dbac4,5,2,2,1,2,1,5,4,5,0,5,1,6,9,1,19,EL
4e80a8ef,18,14,11,6,1,5,13,8,11,0,11,11,29,7,0,19,EL
4f0fbd15,6,2,4,1,1,1,1,0,3,1,2,1,7,3,0,19,EL
4f255115,6,5,1,4,1,2,5,3,3,0,3,5,11,2,0,19,EL
4f56170e,2,2,2,0,0,1,5,4,4,2,2,13,15,10,0,19,EL
4f5a953e,2,1,0,2,0,1,2,1,3,1,2,6,8,13,1,19,EL
4fe7e935,11,5,6,3,2,6,12,6,11,3,8,7,18,23,0,19,EL
500cd987,6,3,0,4,2,1,3,2,3,1,2,4,10,2,0,19,EL
50310821,0,0,0,0,0,0,1,1,0,0,0,0,0,0,0,19,EL
507c7bdf,17,7,8,4,5,7,21,14,15,1,14,0,17,2,0,19,EL
509a4ccb,0,0,0,0,0,0,0,0,1,0,1,0,0,1,0,19,EL
516dc25b,1,0,0,1,0,0,1,1,2,0,2,6,7,5,0,19,EL
51960957,0,0,0,0,0,0,1,1,1,0,1,1,1,0,0,19,EL
51a56075,3,3,2,1,0,2,3,1,3,2,1,6,9,12,0,19,EL
51e3954c,7,3,4,3,0,4,5,1,4,2,2,5,12,8,0,19,EL
51e9bb3f,5,3,2,3,0,2,3,1,2,0,2,3,8,2,0,19,EL
51ffa295,7,6,2,1,4,1,15,14,6,2,4,8,15,11,1,19,EL
520c318f,1,0,0,1,0,1,1,0,10,1,9,1,2,3,0,19,EL
52611641,10,4,4,5,1,4,16,12,13,0,13,12,22,8,0,19,EL
5294a83f,2,1,1,0,1,0,2,2,1,1,0,2,4,2,0,19,EL
52e101a8,3,3,2,1,0,1,3,2,0,0,0,6,9,12,0,19,EL
52eab58c,5,2,3,2,0,1,2,1,2,0,2,1,6,3,1,19,EL
52fdf512,4,2,3,1,0,2,4,2,7,5,2,11,15,44,1,19,EL
53070b63,3,2,1,1,1,1,2,1,6,0,6,2,5,2,0,19,EL
536cebe5,13,6,3,6,4,6,12,6,4,0,4,0,13,1,0,19,EL
5384e3bf,1,0,0,1,0,1,3,2,6,5,1,3,4,6,0,19,EL
539230cf,1,0,1,0,0,0,1,1,2,2,0,3,4,1,1,19,EL
53cad200,15,10,11,4,0,7,16,9,17,4,13,19,34,28,0,19,EL
53de807a,2,2,2,0,0,0,1,1,4,3,1,4,6,17,0,19,EL
546bb36e,1,1,1,0,0,0,0,0,1,0,1,1,2,0,0,19,EL
54771b10,4,3,1,3,0,1,1,0,1,0,1,4,8,5,0,19,EL
54c9ed15,11,7,6,5,0,2,8,6,6,2,4,5,16,15,0,19,EL
55043155,1,1,1,0,0,0,1,1,0,0,0,0,1,0,0,19,EL
5512b1a9,0,0,0,0,0,0,0,0,0,0,0,0,0,0,0,19,EL
55305521,0,0,0,0,0,0,0,0,0,0,0,0,0,1,0,19,EL
55537f53,13,7,7,5,1,5,14,9,2,0,2,0,13,2,0,19,EL
55ae91f0,4,4,2,2,0,1,2,1,2,0,2,9,13,14,0,19,EL
5626f324,3,2,3,0,0,2,3,1,3,0,3,1,4,4,0,19,EL
562893c2,13,6,10,1,2,4,10,6,6,1,5,5,18,17,0,19,EL
563a68ad,19,12,7,12,0,7,18,11,10,3,7,12,31,8,0,19,EL
5640992b,0,0,0,0,0,0,0,0,0,0,0,0,0,4,2,19,EL
56413b1f,5,3,1,2,2,1,6,5,8,0,8,8,13,4,0,19,EL
565bf0da,20,10,10,10,0,7,13,6,12,4,8,14,34,27,0,19,EL
568de36f,3,0,1,2,0,2,2,0,0,0,0,0,3,0,0,19,EL
56901a62,0,0,0,0,0,0,0,0,0,0,0,0,0,0,0,19,EL
56923ba9,0,0,0,0,0,0,1,1,5,0,5,2,2,2,0,19,EL
56f6f826,6,3,4,2,0,3,7,4,5,5,0,5,11,42,0,19,EL
5710a281,5,4,1,4,0,2,5,3,4,0,4,0,5,2,0,19,EL
572498c7,6,3,4,1,1,4,16,12,11,1,10,8,14,19,0,19,EL
57376761,1,1,0,1,0,0,4,4,0,0,0,1,2,1,0,19,EL
5832ebfe,6,5,3,3,0,3,5,2,0,0,0,1,7,6,0,19,EL
58640e66,6,6,1,3,2,2,3,1,4,3,1,4,10,2,0,19,EL
586b19eb,5,2,4,1,0,3,4,1,3,2,1,6,11,19,0,19,EL
58ae47b2,1,1,1,0,0,1,3,2,0,0,0,0,1,2,0,19,EL
58b154d6,2,2,2,0,0,1,2,1,1,1,0,3,5,0,0,19,EL
58f077c0,0,0,0,0,0,0,0,0,0,0,0,1,1,3,0,19,EL
5906ab00,0,0,0,0,0,0,0,0,0,0,0,0,0,0,0,19,EL
597d0f13,2,2,2,0,0,1,2,1,3,0,3,1,3,2,0,19,EL
59bf127b,20,11,4,10,6,5,8,3,6,0,6,5,25,5,0,19,EL
59d53e8a,0,0,0,0,0,0,0,0,1,0,1,0,0,0,0,19,EL
5a28b2d9,16,8,11,4,1,5,8,3,14,10,4,14,30,35,1,19,EL
5a2cb25d,4,3,2,1,1,0,0,0,3,0,3,3,7,0,1,19,EL
5a969ba8,1,1,1,0,0,1,5,4,0,0,0,0,1,4,0,19,EL
5af687a1,7,4,3,2,2,4,8,4,2,0,2,3,10,2,0,19,EL
5b6cf07c,5,3,2,2,1,2,3,1,2,0,2,3,8,1,0,19,EL
5b887c7a,0,0,0,0,0,0,0,0,0,0,0,3,3,15,0,19,EL
5bf476ad,0,0,0,0,0,0,2,2,0,0,0,1,1,0,0,19,EL
5c6ba09a,11,7,4,5,2,4,12,8,5,1,4,8,19,15,1,19,EL
5c97684b,2,1,1,0,1,0,0,0,2,0,2,2,4,0,0,19,EL
5c9ac7f0,4,2,0,2,2,1,1,0,3,1,2,2,6,2,0,19,EL
5caa62a7,9,6,4,3,2,3,10,7,4,0,4,4,13,0,0,19,EL
5ceba7fc,0,0,0,0,0,0,1,1,2,0,2,0,0,0,0,19,EL
5cef5a64,1,1,0,1,0,1,2,1,0,0,0,1,2,0,1,19,EL
5d4e9f31,4,2,1,3,0,0,3,3,2,0,2,5,9,4,0,19,EL
5d9577aa,0,0,0,0,0,0,0,0,0,0,0,0,0,0,0,19,EL
5da33b33,15,8,6,6,3,3,9,6,6,0,6,12,27,2,0,19,EL
5dbefa9d,3,2,1,1,1,2,4,2,5,1,4,1,4,2,1,19,EL
5ddb8f9f,35,22,18,13,4,14,32,18,16,1,15,15,50,27,0,19,EL
5e1028e5,10,4,2,5,3,2,12,10,7,0,7,6,16,2,0,19,EL
5e1280ff,7,1,2,3,2,3,5,2,2,0,2,1,8,1,0,19,EL
5e1df051,4,2,3,1,0,1,2,1,3,0,3,1,5,1,0,19,EL
5e861944,0,0,0,0,0,0,1,1,0,0,0,1,1,1,0,19,EL
5e91ddf8,0,0,0,0,0,0,0,0,0,0,0,0,0,2,0,19,EL
5ea8ef20,12,6,7,4,1,7,14,7,8,1,7,9,21,7,1,19,EL
5ed9b537,11,8,6,4,1,3,4,1,5,1,4,6,17,10,0,19,EL
5f2caf8f,6,3,4,2,0,0,0,0,3,0,3,3,9,1,0,19,EL
5f424f35,3,3,3,0,0,2,5,3,0,0,0,2,5,1,0,19,EL
5faa73aa,9,4,0,7,2,6,13,7,9,2,7,2,11,13,0,19,EL
6043997c,2,2,2,0,0,1,1,0,0,0,0,1,3,2,0,19,EL
60a5ee50,4,2,1,1,2,1,6,5,3,0,3,5,9,6,0,19,EL
60c81972,7,4,6,1,0,4,10,6,5,0,5,9,16,17,0,19,EL
60e86875,12,5,3,8,1,3,17,14,10,0,10,6,18,2,0,19,EL
60fd5334,13,5,7,6,0,3,4,1,13,4,9,7,20,20,0,19,EL
6115fddd,0,0,0,0,0,0,0,0,0,0,0,1,1,3,2,19,EL
611d68ee,0,0,0,0,0,0,0,0,0,0,0,0,0,3,0,19,EL
61707054,3,2,2,0,1,1,2,1,2,1,1,0,3,0,0,19,EL
6186e141,3,2,1,2,0,0,0,0,2,0,2,0,3,1,0,19,EL
61911828,0,0,0,0,0,0,0,0,0,0,0,0,0,7,1,19,EL
61bd33d0,1,1,0,1,0,0,0,0,1,0,1,0,1,0,0,19,EL
6228469d,3,3,0,3,0,2,4,2,4,3,1,2,5,2,1,19,EL
625869d0,4,2,3,1,0,1,5,4,3,0,3,5,9,1,0,19,EL
62b7d469,8,4,5,2,1,3,8,5,2,0,2,6,14,5,0,19,EL
62c7067a,4,3,0,3,1,1,2,1,5,0,5,2,6,0,0,19,EL
62d0dcc5,1,1,0,0,1,0,3,3,2,1,1,0,1,0,0,19,EL
62f427bb,6,3,3,2,1,3,5,2,4,1,3,5,11,7,1,19,EL
63a304f3,1,1,0,1,0,1,1,0,0,0,0,1,2,0,0,19,EL
63f04c6c,13,9,10,2,1,8,15,7,9,1,8,10,23,12,0,19,EL
6438d426,2,1,0,2,0,1,3,2,2,0,2,1,3,3,0,19,EL
644faf10,2,2,0,2,0,0,4,4,1,0,1,3,5,0,0,19,EL
64679418,2,1,0,2,0,1,5,4,1,0,1,2,4,2,0,19,EL
6492ae54,8,7,6,2,0,1,6,5,7,2,5,0,8,11,0,19,EL
64f69877,7,3,3,3,1,3,3,0,4,0,4,2,9,4,0,19,EL
6503ae16,0,0,0,0,0,0,0,0,0,0,0,0,0,1,0,19,EL
6554bb97,4,3,4,0,0,0,1,1,4,1,3,4,8,3,0,19,EL
65adf2db,3,1,0,0,3,0,0,0,5,1,4,1,4,4,0,19,EL
6605c8ae,0,0,0,0,0,0,0,0,1,0,1,0,0,0,0,19,EL
6613c819,25,13,10,14,1,11,25,14,11,1,10,23,48,27,1,19,EL
66e86f2e,2,2,2,0,0,1,5,4,1,1,0,3,5,4,0,19,EL
66f5432f,3,1,1,2,0,2,5,3,1,0,1,2,5,0,0,19,EL
675b0427,16,9,12,4,0,10,12,2,11,5,6,27,43,36,0,19,EL
677267d1,4,1,1,3,0,1,2,1,5,0,5,1,5,1,0,19,EL
67b3d74b,6,2,4,2,0,4,4,0,4,0,4,1,7,6,0,19,EL
6800f515,11,8,6,4,1,6,15,9,11,4,7,13,24,12,0,19,EL
691f64f5,1,1,0,1,0,0,2,2,0,0,0,1,2,0,0,19,EL
692a8d3b,4,2,0,3,1,0,0,0,3,0,3,1,5,1,0,19,EL
692cd6de,9,6,9,0,0,5,6,1,3,3,0,6,15,16,0,19,EL
692e9958,2,2,1,1,0,2,2,0,1,1,0,0,2,2,0,19,EL
69374ff5,10,9,3,7,0,3,8,5,3,0,3,1,11,3,0,19,EL
69986380,0,0,0,0,0,0,0,0,1,0,1,0,0,0,0,19,EL
69b9be7e,2,1,1,1,0,1,5,4,6,3,3,4,6,24,0,19,EL
6a479195,5,2,3,2,0,1,4,3,2,0,2,4,9,0,0,19,EL
6b14ce11,6,2,4,2,0,5,7,2,3,0,3,3,9,14,0,19,EL
6b6cbca4,11,8,10,1,0,4,6,2,3,1,2,15,26,26,1,19,EL
6b6d252d,5,2,2,1,2,2,4,2,5,0,5,1,6,1,0,19,EL
6b71ba6c,0,0,0,0,0,0,0,0,0,0,0,0,0,0,0,19,EL
6b994195,4,2,4,0,0,3,3,0,12,7,5,13,17,38,1,19,EL
6b9f2f3e,2,2,1,1,0,1,1,0,0,0,0,0,2,2,0,19,EL
6bfaecc4,0,0,0,0,0,0,0,0,0,0,0,0,0,4,1,19,EL
6c6e2719,2,1,2,0,0,0,2,2,2,0,2,1,3,1,0,19,EL
6ca5ec4b,8,4,3,3,2,5,11,6,3,1,2,1,9,3,0,19,EL
6d1d3dc3,8,6,4,3,1,5,9,4,5,1,4,1,9,2,0,19,EL
6d3f2898,2,1,2,0,0,1,1,0,1,0,1,7,9,5,0,19,EL
6d470bb6,1,0,0,1,0,0,0,0,0,0,0,1,2,0,0,19,EL
6d4d9e18,3,2,1,2,0,0,0,0,0,0,0,0,3,1,0,19,EL
6e7f1353,2,1,1,0,1,1,3,2,3,0,3,3,5,0,0,19,EL
6ec1ddf1,0,0,0,0,0,0,0,0,1,1,0,0,0,0,0,19,EL
6f1721f0,10,5,3,5,2,1,6,5,5,0,5,5,15,1,0,19,EL
6f4e1c93,0,0,0,0,0,0,1,1,0,0,0,1,1,7,0,19,EL
6f5ead86,8,5,3,5,0,3,15,12,6,3,3,3,11,9,0,19,EL
6f8a10be,0,0,0,0,0,0,0,0,0,0,0,0,0,0,0,19,EL
6fbde63a,3,2,0,3,0,0,5,5,1,0,1,2,5,0,0,19,EL
6fd8a334,6,4,4,2,0,4,7,3,6,4,2,14,20,21,0,19,EL
6fe90922,7,4,3,3,1,7,10,3,8,0,8,2,9,2,0,19,EL
706722a8,2,0,0,2,0,0,0,0,4,0,4,0,2,1,0,19,EL
70a9cba5,0,0,0,0,0,0,1,1,1,0,1,0,0,0,0,19,EL
70c52749,12,9,9,1,2,4,4,0,5,1,4,7,19,11,0,19,EL
70cf63ca,2,2,1,1,0,2,11,9,3,0,3,3,5,0,0,19,EL
712dd708,3,2,3,0,0,3,3,0,0,0,0,5,8,6,0,19,EL
715e5b0e,4,3,1,2,1,0,5,5,3,0,3,2,6,1,0,19,EL
71672fa0,0,0,0,0,0,0,0,0,0,0,0,1,1,6,0,19,EL
717f39e8,0,0,0,0,0,0,0,0,0,0,0,0,0,0,0,19,EL
71d5ca31,13,8,12,0,1,5,9,4,8,5,3,10,23,30,0,19,EL
7214c684,2,1,0,2,0,0,3,3,4,2,2,7,9,10,0,19,EL
7230b807,0,0,0,0,0,0,0,0,0,0,0,0,0,0,0,19,EL
7272a72a,2,1,2,0,0,1,5,4,0,0,0,0,2,2,0,19,EL
72a99e38,7,5,3,2,2,3,9,6,2,0,2,6,13,1,1,19,EL
733e7ad8,9,4,6,3,0,4,7,3,5,0,5,1,10,2,0,19,EL
73affbb6,0,0,0,0,0,0,0,0,0,0,0,0,0,0,0,19,EL
73fc8cc3,4,3,2,1,1,1,7,6,4,2,2,5,9,6,0,19,EL
74419746,0,0,0,0,0,0,0,0,0,0,0,0,0,2,0,19,EL
7460ca0d,9,6,4,4,1,7,18,11,9,1,8,5,14,5,0,19,EL
746b64a7,1,1,1,0,0,1,1,0,1,1,0,1,2,8,0,19,EL
746fec7d,3,3,0,2,1,2,3,1,1,0,1,0,3,2,0,19,EL
74733221,0,0,0,0,0,0,0,0,0,0,0,1,1,3,0,19,EL
7483d9f9,18,16,9,9,0,10,16,6,16,8,8,16,34,31,2,19,EL
74bafc9c,1,1,0,0,1,0,1,1,2,0,2,0,1,0,0,19,EL
74d52033,2,2,1,0,1,1,4,3,1,0,1,0,2,0,0,19,EL
74dc806c,3,2,2,1,0,2,7,5,3,0,3,3,6,0,0,19,EL
75229233,21,12,11,10,0,7,12,5,12,5,7,15,36,2,0,19,EL
758da372,3,3,2,1,0,1,4,3,3,1,2,5,8,10,0,19,EL
762179d9,4,2,1,3,0,1,4,3,6,1,5,4,8,2,0,19,EL
76806215,0,0,0,0,0,0,0,0,0,0,0,1,1,2,0,19,EL
76d5857d,6,4,3,2,1,3,5,2,1,0,1,7,13,9,0,19,EL
76d753f8,17,14,8,9,0,4,16,12,10,1,9,7,24,6,0,19,EL
76ecfb22,7,5,4,3,0,2,4,2,2,1,1,1,8,8,1,19,EL
770ebf00,9,5,5,3,1,5,16,11,7,2,5,8,17,3,0,19,EL
7750462c,0,0,0,0,0,0,1,1,0,0,0,0,0,5,2,19,EL
779fe525,4,2,3,0,1,1,5,4,4,2,2,7,11,5,0,19,EL
77f278a0,2,2,0,1,1,0,1,1,1,0,1,0,2,0,0,19,EL
78150923,2,1,0,2,0,1,2,1,0,0,0,7,9,2,0,19,EL
781cff03,2,2,1,1,0,1,4,3,3,0,3,0,2,0,0,19,EL
7825393b,0,0,0,0,0,0,0,0,0,0,0,0,0,1,0,19,EL
7847ad0c,0,0,0,0,0,0,0,0,0,0,0,0,0,3,1,19,EL
78841da9,6,3,3,2,1,2,7,5,2,0,2,3,9,4,0,19,EL
78af782c,3,3,1,1,1,1,2,1,2,0,2,1,4,3,0,19,EL
7914b9fe,3,2,2,1,0,2,5,3,3,3,0,1,4,11,0,19,EL
7956236f,0,0,0,0,0,0,0,0,0,0,0,0,0,0,0,19,EL
797cf5cb,14,8,3,8,3,6,15,9,2,0,2,17,31,5,0,19,EL
79c0821a,27,16,11,13,3,7,21,14,11,3,8,10,37,8,0,19,EL
7a4cea18,4,2,0,1,3,2,4,2,1,0,1,1,5,0,1,19,EL
7a68aefa,9,5,4,4,1,0,6,6,8,1,7,5,14,5,0,19,EL
7a7f9e0d,11,7,0,7,4,3,5,2,9,0,9,1,12,7,0,19,EL
7a854622,1,1,0,0,1,1,1,0,2,0,2,2,3,0,0,19,EL
7a8779f3,0,0,0,0,0,0,0,0,0,0,0,0,0,0,0,19,EL
7ab2fee8,4,3,2,2,0,0,3,3,4,1,3,2,6,9,0,19,EL
7ab59ec0,5,1,2,2,1,3,8,5,7,1,6,6,11,12,0,19,EL
7b456af7,0,0,0,0,0,0,0,0,0,0,0,0,0,2,0,19,EL
7b4a8d08,4,1,2,2,0,1,5,4,3,1,2,1,5,4,0,19,EL
7b602cee,7,2,3,2,2,5,11,6,1,0,1,2,9,3,0,19,EL
7b66eec0,0,0,0,0,0,0,0,0,2,2,0,2,2,5,0,19,EL
7b8ff0ac,0,0,0,0,0,0,0,0,2,1,1,3,3,11,0,19,EL
7bcd6098,3,3,1,2,0,2,2,0,0,0,0,2,5,4,0,19,EL
7be09c86,4,3,2,1,1,2,7,5,3,0,3,2,6,1,0,19,EL
7c224498,2,1,0,1,1,0,1,1,3,2,1,4,6,7,0,19,EL
7c4243d4,22,10,6,13,3,4,9,5,6,2,4,7,29,3,0,19,EL
7c473e12,13,4,10,3,0,8,10,2,8,5,3,16,29,20,0,19,EL
7c4740ec,0,0,0,0,0,0,1,1,1,1,0,1,1,2,0,19,EL
7c7fdb0f,14,12,6,6,2,5,20,15,11,3,8,6,20,13,0,19,EL
7cc5bd9c,9,5,8,1,0,7,9,2,4,4,0,1,10,28,0,19,EL
7cd78926,27,13,15,9,3,15,20,5,6,1,5,8,35,15,0,19,EL
7cf431a5,4,3,1,2,1,1,3,2,4,0,4,1,5,5,0,19,EL
7d036b4a,4,2,0,1,3,2,9,7,5,0,5,3,7,8,0,19,EL
7d48aed2,3,2,1,2,0,2,2,0,1,1,0,3,6,0,0,19,EL
7d5e2c80,3,3,2,1,0,1,3,2,5,3,2,11,14,39,1,19,EL
7d6921f8,3,3,1,2,0,1,5,4,5,0,5,1,4,0,0,19,EL
7d974435,6,3,1,5,0,1,5,4,1,0,1,5,11,8,1,19,EL
7dca49f6,0,0,0,0,0,0,0,0,0,0,0,0,0,0,0,19,EL
7df95c14,3,2,0,3,0,1,3,2,1,1,0,1,4,6,0,19,EL
7e56d3db,8,6,4,3,1,1,3,2,6,1,5,6,14,5,0,19,EL
7e927fda,3,2,2,1,0,3,6,3,5,3,2,6,9,23,0,19,EL
7e964a67,1,1,0,0,1,0,0,0,2,1,1,2,3,2,0,19,EL
7eb97a8e,1,0,1,0,0,0,2,2,4,0,4,1,2,1,0,19,EL
7f043eec,2,1,2,0,0,2,3,1,1,0,1,2,4,1,0,19,EL
7f66ea09,0,0,0,0,0,0,0,0,0,0,0,0,0,0,0,19,EL
7f78ad23,5,5,3,2,0,5,8,3,1,0,1,3,8,9,0,19,EL
7f78f582,2,1,0,1,1,1,2,1,1,0,1,0,2,3,0,19,EL
7fac99d4,10,6,3,7,0,1,7,6,2,0,2,7,17,4,0,19,EL
7fcc71d8,7,4,3,2,2,3,6,3,4,0,4,5,12,3,0,19,EL
7fd58fe3,8,3,3,5,0,1,4,3,3,0,3,8,16,7,0,19,EL
7fe90ccd,10,6,7,3,0,2,6,4,5,2,3,11,21,12,0,19,EL
7ff93107,0,0,0,0,0,0,0,0,1,0,1,0,0,0,0,19,EL
8023bcab,26,17,17,7,2,12,37,25,4,1,3,11,37,16,1,19,EL
80490d7f,8,6,8,0,0,4,4,0,7,5,2,9,17,10,0,19,EL
808d48f3,15,11,7,7,1,3,4,1,3,0,3,9,24,12,0,19,EL
8104e41e,1,0,1,0,0,1,1,0,0,0,0,0,1,2,0,19,EL
81442ecb,21,17,10,9,2,4,8,4,11,1,10,8,29,10,0,19,EL
819a94a2,4,2,4,0,0,2,3,1,1,0,1,3,7,2,0,19,EL
81d3318f,2,1,1,1,0,1,1,0,1,0,1,0,2,1,0,19,EL
81f0781e,8,2,2,4,2,2,9,7,1,0,1,4,12,12,0,19,EL
8229a21c,6,5,6,0,0,2,2,0,2,2,0,2,8,13,0,19,EL
826313e2,14,9,9,4,1,4,20,16,10,5,5,15,29,40,0,19,EL
82671804,14,7,5,9,0,3,9,6,4,2,2,6,20,5,0,19,EL
82927de4,15,10,5,8,2,7,18,11,9,0,9,12,27,4,0,19,EL
82988fd8,1,1,1,0,0,0,0,0,1,0,1,1,2,0,0,19,EL
831cf3ac,5,3,0,4,1,0,2,2,1,0,1,7,12,7,0,19,EL
834d0be5,4,3,1,0,3,2,5,3,6,0,6,1,5,5,0,19,EL
83534f30,6,3,3,2,1,6,6,0,6,1,5,3,9,3,0,19,EL
839c14e1,4,4,2,2,0,1,3,2,3,0,3,1,5,2,0,19,EL
83b9c48f,11,3,3,8,0,3,9,6,8,2,6,11,22,4,0,19,EL
8454388c,5,2,5,0,0,3,6,3,5,0,5,2,7,7,0,19,EL
8455ad90,5,3,1,4,0,4,7,3,0,0,0,1,6,0,0,19,EL
84570bef,6,5,4,2,0,4,5,1,10,8,2,10,16,40,1,19,EL
8474cb83,0,0,0,0,0,0,0,0,0,0,0,0,0,1,0,19,EL
8494acc4,8,3,4,4,0,3,10,7,12,2,10,8,16,9,1,19,EL
84fb6aff,1,0,1,0,0,0,0,0,0,0,0,0,1,1,0,19,EL
854a2041,1,1,1,0,0,0,1,1,3,0,3,1,2,2,0,19,EL
85613cf0,6,3,0,4,2,0,0,0,3,1,2,0,6,3,0,19,EL
85a44ecc,11,4,6,4,1,7,14,7,6,1,5,8,19,14,0,19,EL
85b4255f,1,0,1,0,0,1,1,0,0,0,0,0,1,1,0,19,EL
85d5ccdb,4,3,1,3,0,3,8,5,5,0,5,1,5,2,0,19,EL
85f8571a,6,5,4,2,0,2,6,4,6,6,0,6,12,28,0,19,EL
86012f0e,0,0,0,0,0,0,0,0,1,0,1,0,0,0,0,19,EL
862fa9fb,3,2,2,1,0,1,1,0,2,2,0,3,6,13,0,19,EL
8652a85c,1,0,0,1,0,0,0,0,2,0,2,0,1,0,0,19,EL
86765ca8,7,2,4,3,0,2,4,2,0,0,0,9,16,10,0,19,EL
8696bc90,1,1,1,0,0,1,4,3,5,0,5,2,3,0,0,19,EL
86f9fb71,9,7,6,3,0,5,7,2,6,4,2,4,13,36,0,19,EL
874125a3,4,1,3,1,0,3,3,0,2,1,1,4,8,9,0,19,EL
874d7a32,10,3,6,2,2,4,10,6,4,1,3,7,17,3,1,19,EL
8754c7ca,9,4,5,3,1,3,10,7,6,2,4,7,16,5,0,19,EL
88062e83,2,1,0,0,2,1,1,0,4,2,2,3,5,1,0,19,EL
881cd6be,13,11,4,8,1,7,8,1,7,0,7,7,20,4,0,19,EL
8821f471,4,1,0,3,1,1,3,2,5,0,5,4,8,2,0,19,EL
88392398,6,2,2,4,0,2,3,1,0,0,0,1,7,0,0,19,EL
884a8908,2,1,0,1,1,1,5,4,1,0,1,1,3,0,0,19,EL
886f9aac,1,1,1,0,0,0,1,1,0,0,0,1,2,0,0,19,EL
88b5445c,0,0,0,0,0,0,0,0,0,0,0,0,0,2,0,19,EL
88b748d2,0,0,0,0,0,0,0,0,0,0,0,0,0,2,1,19,EL
890fa4b5,3,3,1,2,0,3,7,4,0,0,0,2,5,2,0,19,EL
89151b16,3,2,2,1,0,2,2,0,2,2,0,10,13,5,0,19,EL
89b2c8a9,2,2,0,2,0,1,4,3,3,0,3,0,2,0,0,19,EL
89cbc961,13,6,7,5,1,7,10,3,9,2,7,10,23,46,2,19,EL
8a08491a,2,1,0,2,0,1,3,2,1,1,0,0,2,1,0,19,EL
8a1d7b51,14,11,12,1,1,5,10,5,7,0,7,14,28,13,1,19,EL
8a387393,1,1,0,1,0,0,0,0,1,1,0,0,1,0,0,19,EL
8a6ab963,0,0,0,0,0,0,0,0,0,0,0,0,0,8,4,19,EL
8a7a5ad7,3,2,2,1,0,2,2,0,1,0,1,4,7,4,0,19,EL
8aafd64f,1,1,0,0,1,0,3,3,0,0,0,2,3,2,0,19,EL
8ae07c1c,0,0,0,0,0,0,0,0,0,0,0,0,0,1,0,19,EL
8b298f56,12,8,5,5,2,6,14,8,6,1,5,11,23,5,0,19,EL
8b66d9cc,1,1,0,1,0,0,3,3,5,0,5,1,2,0,0,19,EL
8b8a56ce,11,6,9,2,0,6,8,2,7,7,0,12,23,33,0,19,EL
8b92fc98,1,0,0,1,0,0,3,3,3,0,3,1,2,0,0,19,EL
8b9ebd03,7,5,1,4,2,1,15,14,9,2,7,5,12,4,1,19,EL
8bc373ea,9,5,6,2,1,1,4,3,6,4,2,16,25,45,0,19,EL
8beb3c36,0,0,0,0,0,0,0,0,2,2,0,0,0,1,0,19,EL
8c5f1522,0,0,0,0,0,0,0,0,0,0,0,0,0,0,0,19,EL
8c70d3ee,0,0,0,0,0,0,0,0,1,1,0,0,0,1,0,19,EL
8ce063f9,2,2,0,1,1,1,2,1,2,2,0,1,3,0,0,19,EL
8d7323e8,3,3,0,1,2,1,4,3,5,0,5,5,8,4,0,19,EL
8dbff17c,0,0,0,0,0,0,1,1,1,0,1,4,4,6,0,19,EL
8e088e04,6,3,3,2,1,4,11,7,8,4,4,6,12,11,0,19,EL
8e371868,8,4,5,3,0,5,8,3,6,2,4,3,11,18,1,19,EL
8e58987d,29,18,12,17,0,17,27,10,13,2,11,18,47,12,0,19,EL
8e7f49d3,3,1,3,0,0,2,6,4,5,5,0,4,7,8,0,19,EL
8ea2c099,8,6,2,2,4,4,7,3,5,4,1,1,9,11,0,19,EL
8ec4c2f7,3,3,2,1,0,1,5,4,7,2,5,2,5,23,1,19,EL
8ed1d91b,3,2,2,1,0,0,1,1,7,3,4,3,6,28,0,19,EL
8eec784d,0,0,0,0,0,0,0,0,0,0,0,0,0,0,0,19,EL
8f056768,23,16,8,13,2,9,18,9,19,1,18,11,34,6,1,19,EL
8f5bfaac,0,0,0,0,0,0,0,0,0,0,0,0,0,0,0,19,EL
8ff2354e,8,3,4,4,0,2,4,2,1,0,1,5,13,4,0,19,EL
90104ffb,3,2,2,1,0,3,4,1,1,0,1,7,10,8,0,19,EL
901d3e51,1,0,0,0,1,0,1,1,1,0,1,2,3,0,0,19,EL
903b6e8b,0,0,0,0,0,0,0,0,1,0,1,0,0,3,0,19,EL
9050ddc4,14,8,6,5,3,5,10,5,11,0,11,4,18,12,0,19,EL
90573602,9,9,7,1,1,5,7,2,6,0,6,6,15,13,0,19,EL
90decc12,1,0,1,0,0,0,0,0,3,2,1,4,5,6,0,19,EL
9139bb12,1,1,1,0,0,1,2,1,1,0,1,2,3,0,0,19,EL
91538ba3,0,0,0,0,0,0,0,0,0,0,0,1,1,3,0,19,EL
91899ca8,0,0,0,0,0,0,0,0,0,0,0,2,2,2,0,19,EL
92432bc6,10,7,4,5,1,5,10,5,6,0,6,9,19,5,0,19,EL
925e1359,0,0,0,0,0,0,0,0,0,0,0,0,0,0,0,19,EL
9260926b,4,2,4,0,0,0,2,2,0,0,0,2,6,7,0,19,EL
92b17b2a,1,1,1,0,0,0,3,3,4,1,3,3,4,4,0,19,EL
934e1968,1,1,0,1,0,0,0,0,2,0,2,4,5,1,0,19,EL
93b891d1,4,1,0,3,1,1,2,1,1,0,1,0,4,1,0,19,EL
93bf37c5,2,2,1,1,0,1,2,1,1,0,1,1,3,8,0,19,EL
940efd73,12,9,3,7,2,8,10,2,4,0,4,1,13,16,0,19,EL
94130fc4,0,0,0,0,0,0,1,1,0,0,0,0,0,0,0,19,EL
9413b19f,0,0,0,0,0,0,0,0,0,0,0,1,1,2,0,19,EL
942b4f90,1,0,0,1,0,0,3,3,1,0,1,1,2,0,0,19,EL
947239ca,1,1,0,1,0,1,2,1,0,0,0,4,5,0,0,19,EL
94d260aa,3,2,2,1,0,2,2,0,2,2,0,6,9,27,0,19,EL
94d628b1,2,1,1,1,0,0,0,0,2,0,2,5,7,5,0,19,EL
94f8d10c,3,3,1,2,0,2,5,3,4,2,2,4,7,24,0,19,EL
952e0df2,8,6,6,1,1,5,6,1,6,2,4,5,13,9,0,19,EL
953597a1,10,8,6,4,0,5,7,2,6,5,1,6,16,26,0,19,EL
958bba56,16,11,9,7,0,7,14,7,11,3,8,9,25,5,1,19,EL
96094cbc,6,5,3,1,2,4,6,2,1,0,1,1,7,0,0,19,EL
960acc0a,10,9,3,5,2,5,8,3,0,0,0,4,14,1,0,19,EL
962e54cb,0,0,0,0,0,0,2,2,3,0,3,0,0,1,0,19,EL
963829d0,13,7,5,6,2,3,15,12,3,1,2,3,16,4,0,19,EL
963a328b,3,3,2,1,0,1,3,2,1,0,1,0,3,0,0,19,EL
96ddfa79,7,4,2,4,1,1,10,9,4,0,4,2,9,3,1,19,EL
96f2d977,6,3,4,1,1,4,7,3,2,0,2,13,19,7,0,19,EL
9744ff80,4,3,1,3,0,0,8,8,13,0,13,1,5,2,0,19,EL
9778d8dd,0,0,0,0,0,0,0,0,0,0,0,0,0,0,0,19,EL
97b87472,1,0,0,1,0,0,0,0,1,1,0,6,7,5,0,19,EL
97bfa797,2,0,0,1,1,0,1,1,3,0,3,2,4,0,0,19,EL
98554bfd,4,3,0,2,2,1,2,1,1,0,1,6,10,4,0,19,EL
98afb06c,0,0,0,0,0,0,3,3,0,0,0,0,0,0,0,19,EL
98d5ecc2,9,5,6,3,0,5,8,3,6,2,4,5,14,21,0,19,EL
9916979a,7,3,1,5,1,2,8,6,2,0,2,5,12,1,0,19,EL
997fff07,0,0,0,0,0,0,1,1,5,2,3,0,0,3,0,19,EL
99a4bb79,0,0,0,0,0,0,0,0,0,0,0,0,0,0,0,19,EL
99b1d0e6,6,3,4,2,0,4,6,2,6,2,4,5,11,10,1,19,EL
9ab16552,19,10,14,5,0,10,21,11,16,5,11,18,37,31,0,19,EL
9ada6f1d,3,3,2,1,0,1,4,3,2,1,1,2,5,1,0,19,EL
9bc78273,0,0,0,0,0,0,0,0,0,0,0,0,0,1,0,19,EL
9bcd6455,1,1,1,0,0,0,2,2,1,0,1,1,2,1,0,19,EL
9bd3b683,0,0,0,0,0,0,1,1,1,0,1,0,0,1,0,19,EL
9bd73cce,1,0,1,0,0,0,0,0,0,0,0,2,3,1,0,19,EL
9c0c2413,17,8,3,10,4,9,20,11,4,1,3,9,26,14,0,19,EL
9c145144,5,3,1,3,1,3,7,4,5,0,5,2,7,9,0,19,EL
9d40ca9c,5,3,4,1,0,2,4,2,4,2,2,6,11,27,1,19,EL
9d60028d,4,3,4,0,0,1,2,1,0,0,0,1,5,0,0,19,EL
9d689a5b,2,1,1,1,0,0,2,2,1,0,1,1,3,1,0,19,EL
9d7d5334,3,1,2,1,0,2,3,1,2,1,1,2,5,6,0,19,EL
9d8586c4,3,2,1,2,0,2,2,0,2,0,2,4,7,4,0,19,EL
9d971f13,9,7,4,4,1,2,3,1,5,0,5,2,11,3,0,19,EL
9dbb75ca,7,4,1,3,3,1,5,4,8,0,8,1,8,6,0,19,EL
9e1035f8,4,2,1,2,1,3,6,3,2,0,2,0,4,5,0,19,EL
9e49c320,0,0,0,0,0,0,0,0,0,0,0,0,0,0,0,19,EL
9f810e29,3,1,0,3,0,0,0,0,1,0,1,1,4,1,0,19,EL
9f9c57f0,1,1,0,0,1,0,1,1,1,0,1,0,1,0,0,19,EL
9fc2531b,7,3,1,4,2,2,9,7,6,2,4,1,8,1,0,19,EL
a0255c67,5,4,1,4,0,2,8,6,6,1,5,2,7,6,0,19,EL
a0313275,8,6,6,2,0,2,6,4,9,0,9,7,15,9,0,19,EL
a04e2dd2,0,0,0,0,0,0,0,0,0,0,0,1,1,2,0,19,EL
a08b5224,0,0,0,0,0,0,1,1,3,0,3,0,0,1,0,19,EL
a08b974a,13,5,3,9,1,3,8,5,2,0,2,1,14,2,0,19,EL
a0aa4566,0,0,0,0,0,0,0,0,1,0,1,0,0,0,0,19,EL
a0d59251,6,3,5,1,0,3,3,0,4,1,3,4,10,9,1,19,EL
a165a577,0,0,0,0,0,0,0,0,0,0,0,0,0,0,0,19,EL
a167537f,9,3,0,5,4,3,10,7,2,0,2,3,12,1,0,19,EL
a179d516,0,0,0,0,0,0,0,0,0,0,0,0,0,0,0,19,EL
a275b145,2,2,1,1,0,0,0,0,4,1,3,1,3,4,0,19,EL
a2947130,8,6,6,2,0,2,5,3,9,5,4,6,14,32,0,19,EL
a2950e2d,3,1,2,1,0,0,7,7,1,0,1,3,6,1,0,19,EL
a2abe631,0,0,0,0,0,0,0,0,0,0,0,0,0,1,0,19,EL
a30a166e,5,2,4,1,0,0,2,2,3,2,1,2,7,4,0,19,EL
a33a0dc0,0,0,0,0,0,0,2,2,0,0,0,0,0,0,0,19,EL
a372a9f2,10,7,5,5,0,4,16,12,7,2,5,8,18,6,0,19,EL
a39bb753,1,0,0,1,0,0,2,2,0,0,0,1,2,1,0,19,EL
a3b03921,9,7,2,3,4,4,8,4,7,0,7,2,11,1,0,19,EL
a3bf2258,0,0,0,0,0,0,2,2,1,0,1,0,0,2,0,19,EL
a3d524cb,0,0,0,0,0,0,0,0,0,0,0,0,0,0,1,19,EL
a45eac1f,3,2,0,2,1,1,5,4,0,0,0,0,3,4,0,19,EL
a4b1028a,15,7,9,5,1,10,18,8,7,3,4,10,25,26,1,19,EL
a4fe8cda,3,3,1,1,1,1,2,1,1,0,1,0,3,1,0,19,EL
a51728e3,3,1,3,0,0,2,4,2,2,2,0,5,8,3,0,19,EL
a5212312,6,5,6,0,0,2,4,2,9,5,4,5,11,22,0,19,EL
a5296e55,5,3,3,2,0,2,4,2,5,1,4,4,9,6,0,19,EL
a53649b7,5,3,0,2,3,0,0,0,2,0,2,0,5,0,0,19,EL
a5d101a9,8,3,5,2,1,4,15,11,17,6,11,13,21,25,0,19,EL
a5e16eba,16,8,11,5,0,12,19,7,13,8,5,16,32,36,0,19,EL
a5e96539,4,2,3,1,0,3,4,1,2,0,2,4,8,5,1,19,EL
a5f458d9,5,3,3,2,0,2,4,2,0,0,0,0,5,1,0,19,EL
a637251f,4,2,3,0,1,2,3,1,0,0,0,4,8,0,0,19,EL
a64b4786,3,3,2,1,0,2,3,1,0,0,0,2,5,3,0,19,EL
a6951bf8,6,4,3,3,0,2,4,2,7,3,4,13,19,9,1,19,EL
a69cf944,10,6,4,4,2,6,13,7,4,0,4,2,12,6,0,19,EL
a6b9bd00,0,0,0,0,0,0,1,1,0,0,0,0,0,0,0,19,EL
a6de370d,11,8,3,7,1,5,13,8,8,2,6,3,14,3,0,19,EL
a70b8345,0,0,0,0,0,0,0,0,0,0,0,0,0,2,0,19,EL
a801669e,5,3,0,2,3,2,4,2,6,0,6,7,12,2,0,19,EL
a81ed730,13,7,4,9,0,4,13,9,10,1,9,6,19,7,0,19,EL
a8c0acb7,12,7,9,3,0,6,7,1,4,0,4,6,18,8,1,19,EL
a8c62306,0,0,0,0,0,0,0,0,1,0,1,0,0,2,0,19,EL
a8f41212,4,4,2,2,0,1,4,3,2,0,2,1,5,2,0,19,EL
a96e5dc0,3,2,3,0,0,1,1,0,1,0,1,1,4,2,0,19,EL
a98a9189,0,0,0,0,0,0,0,0,0,0,0,0,0,0,0,19,EL
a9dc785c,0,0,0,0,0,0,0,0,0,0,0,0,0,2,0,19,EL
aa1ecac3,10,5,5,4,1,2,5,3,4,0,4,6,16,2,0,19,EL
aa21406e,0,0,0,0,0,0,0,0,0,0,0,0,0,0,0,19,EL
aa5fd980,1,1,0,1,0,0,1,1,0,0,0,1,2,0,0,19,EL
aad9c3f3,3,3,1,1,1,0,8,8,0,0,0,0,3,1,0,19,EL
aae023c4,0,0,0,0,0,0,0,0,0,0,0,0,0,0,0,19,EL
aaee68f1,5,3,0,3,2,0,2,2,4,0,4,1,6,1,0,19,EL
aaf0fd15,1,0,0,1,0,0,0,0,0,0,0,0,1,0,0,19,EL
ab77f2d9,2,0,0,1,1,2,6,4,6,2,4,2,4,2,0,19,EL
abcfaa50,4,2,1,3,0,1,2,1,3,0,3,3,7,0,0,19,EL
ac1f056e,0,0,0,0,0,0,0,0,1,0,1,0,0,0,0,19,EL
ac290817,1,1,1,0,0,1,4,3,2,0,2,2,3,1,0,19,EL
ac3fb1be,1,1,1,0,0,0,2,2,6,5,1,2,3,26,0,19,EL
ac73ec79,14,8,10,4,0,4,6,2,1,0,1,4,18,7,0,19,EL
ac7d7378,1,1,0,1,0,0,1,1,2,0,2,0,1,9,0,19,EL
ac7e640b,2,1,0,2,0,0,0,0,0,0,0,2,4,5,0,19,EL
ad10eae0,2,2,2,0,0,2,3,1,1,1,0,3,5,0,0,19,EL
ad1d334f,16,8,4,9,3,5,8,3,5,0,5,6,22,5,0,19,EL
ad1ffcfd,3,2,2,1,0,1,3,2,1,0,1,2,5,5,0,19,EL
ad3389d5,0,0,0,0,0,0,0,0,0,0,0,1,1,4,0,19,EL
ad6295d4,0,0,0,0,0,0,1,1,1,0,1,2,2,1,0,19,EL
ae0f7da7,7,3,2,5,0,4,9,5,1,0,1,4,11,3,0,19,EL
ae44e8e2,10,3,3,5,2,2,9,7,5,0,5,8,18,18,0,19,EL
aec63b70,0,0,0,0,0,0,1,1,1,0,1,0,0,3,0,19,EL
af3ddb2e,0,0,0,0,0,0,0,0,0,0,0,0,0,0,0,19,EL
af43f64f,4,4,4,0,0,1,1,0,6,3,3,8,12,16,0,19,EL
af686bed,3,2,0,0,3,0,1,1,1,0,1,0,3,0,0,19,EL
af7e69d1,8,6,5,3,0,5,8,3,7,1,6,13,21,18,1,19,EL
af8ccfb1,2,1,0,1,1,2,4,2,4,0,4,5,7,4,0,19,EL
af8e4246,8,7,3,3,2,2,11,9,7,4,3,13,21,3,0,19,EL
afbf187b,0,0,0,0,0,0,2,2,7,2,5,9,9,13,0,19,EL
b0547a87,1,1,1,0,0,0,2,2,1,0,1,1,2,1,0,19,EL
b05e2dbd,6,1,2,4,0,4,10,6,3,0,3,3,9,8,0,19,EL
b0616e3d,7,5,5,0,2,4,6,2,3,0,3,3,10,7,0,19,EL
b0edd538,5,2,1,2,2,1,7,6,7,1,6,1,6,0,0,19,EL
b1313ec4,7,6,1,5,1,3,6,3,9,1,8,5,12,3,0,19,EL
b148f34c,4,3,1,3,0,2,5,3,2,0,2,2,6,6,0,19,EL
b14d0c5d,13,11,6,6,1,6,9,3,11,2,9,10,23,25,0,19,EL
b15780e3,0,0,0,0,0,0,0,0,0,0,0,0,0,3,1,19,EL
b182a240,10,5,6,1,3,2,8,6,4,0,4,7,17,2,0,19,EL
b1b99435,6,3,3,3,0,4,5,1,1,0,1,1,7,0,0,19,EL
b1cd37e6,20,14,8,10,2,11,20,9,21,2,19,15,35,14,0,19,EL
b1deecf8,13,8,9,4,0,6,6,0,4,2,2,4,17,15,0,19,EL
b1f4086c,11,9,6,3,2,3,6,3,4,0,4,4,15,10,0,19,EL
b220064a,4,2,1,3,0,0,3,3,0,0,0,2,6,2,0,19,EL
b2484b77,6,5,1,1,4,2,6,4,4,1,3,1,7,5,0,19,EL
b2d0ec1b,4,2,1,2,1,1,4,3,3,0,3,1,5,0,0,19,EL
b33e0095,4,2,0,2,2,1,1,0,2,0,2,0,4,0,0,19,EL
b352cfa6,1,1,0,1,0,0,0,0,0,0,0,1,2,0,0,19,EL
b35db3f6,0,0,0,0,0,0,2,2,1,0,1,1,1,1,0,19,EL
b36b3f96,0,0,0,0,0,0,0,0,0,0,0,0,0,0,0,19,EL
b387af71,8,5,4,3,1,7,9,2,3,1,2,5,13,15,0,19,EL
b3a712de,18,12,7,10,1,9,31,22,15,1,14,13,31,6,0,19,EL
b3dc6eca,7,3,4,3,0,3,5,2,8,3,5,20,27,40,1,19,EL
b3e4a674,2,2,2,0,0,2,2,0,1,0,1,3,5,6,0,19,EL
b4819112,29,20,8,18,3,8,17,9,11,3,8,10,39,11,0,19,EL
b5365398,3,1,0,3,0,1,1,0,3,1,2,0,3,3,0,19,EL
b5920350,0,0,0,0,0,0,0,0,1,0,1,0,0,0,0,19,EL
b5f63410,1,0,0,1,0,0,1,1,3,0,3,0,1,0,0,19,EL
b675e328,0,0,0,0,0,0,2,2,0,0,0,0,0,0,0,19,EL
b682dcf6,19,11,15,4,0,10,17,7,12,8,4,11,30,39,0,19,EL
b684a484,4,4,1,2,1,0,0,0,1,0,1,1,5,0,0,19,EL
b686f4c0,2,0,1,1,0,0,0,0,4,0,4,3,5,1,0,19,EL
b6972deb,2,1,1,1,0,2,5,3,6,3,3,3,5,7,0,19,EL
b69c4388,8,4,5,3,0,2,5,3,7,4,3,6,14,20,0,19,EL
b6b2b820,3,3,1,2,0,1,1,0,4,0,4,2,5,2,0,19,EL
b6ccdcda,0,0,0,0,0,0,0,0,0,0,0,0,0,0,0,19,EL
b737f944,0,0,0,0,0,0,0,0,0,0,0,0,0,1,0,19,EL
b742cc0d,15,9,8,7,0,5,8,3,5,2,3,15,30,12,0,19,EL
b75af9ce,2,1,1,1,0,2,3,1,0,0,0,2,4,0,0,19,EL
b7705481,7,4,3,4,0,4,5,1,5,0,5,11,18,11,0,19,EL
b7ca5c51,4,4,2,2,0,2,4,2,8,7,1,18,22,15,0,19,EL
b825a650,7,6,2,3,2,3,5,2,4,0,4,3,10,3,0,19,EL
b82880c6,9,4,6,3,0,6,7,1,6,2,4,18,27,25,0,19,EL
b8441408,15,11,9,5,1,7,11,4,8,3,5,8,23,9,0,19,EL
b8798a46,0,0,0,0,0,0,0,0,0,0,0,0,0,0,0,19,EL
b87a2715,4,2,3,1,0,3,9,6,3,0,3,3,7,3,0,19,EL
b8814868,10,7,3,7,0,3,8,5,2,0,2,7,17,8,0,19,EL
b8a642fc,8,4,5,1,2,4,8,4,5,0,5,1,9,0,0,19,EL
b8a6bf56,6,5,4,2,0,4,4,0,1,1,0,3,9,5,0,19,EL
b8ae831b,3,3,2,1,0,0,1,1,3,1,2,8,11,11,1,19,EL
b8c1de25,5,2,3,2,0,3,4,1,3,1,2,1,6,2,0,19,EL
b8d22478,7,6,3,1,3,2,5,3,1,0,1,1,8,2,0,19,EL
b921a3aa,0,0,0,0,0,0,0,0,1,0,1,0,0,0,0,19,EL
b92edde2,8,6,5,3,0,4,4,0,4,0,4,4,12,4,0,19,EL
b956af7d,3,1,0,1,2,0,2,2,2,0,2,2,5,5,0,19,EL
b96b595c,15,11,10,4,1,1,4,3,17,12,5,23,38,41,0,19,EL
b9814dcc,0,0,0,0,0,0,2,2,0,0,0,1,1,0,0,19,EL
b9ec784d,1,1,1,0,0,0,0,0,0,0,0,1,2,0,0,19,EL
b9fbae28,14,9,6,5,3,6,14,8,11,4,7,8,22,3,0,19,EL
ba06950a,3,1,1,2,0,2,3,1,3,3,0,4,7,26,1,19,EL
ba115a40,13,9,3,7,3,6,12,6,5,1,4,2,15,6,0,19,EL
ba3378a5,5,4,1,4,0,0,7,7,4,0,4,2,7,7,0,19,EL
ba3d3bea,8,7,4,3,1,4,10,6,4,0,4,6,14,11,0,19,EL
ba6e52b0,5,3,4,0,1,2,3,1,3,2,1,5,10,20,0,19,EL
ba7673a6,0,0,0,0,0,0,2,2,1,0,1,0,0,0,0,19,EL
baa82726,2,2,1,1,0,0,1,1,0,0,0,0,2,0,0,19,EL
bab077a4,1,1,0,1,0,0,0,0,2,0,2,0,1,5,0,19,EL
bb17ccd0,12,9,9,3,0,11,17,6,10,3,7,17,29,26,0,19,EL
bb19da7c,1,1,1,0,0,1,1,0,1,0,1,1,2,1,0,19,EL
bb300266,0,0,0,0,0,0,0,0,0,0,0,0,0,0,0,19,EL
bb6ab7af,1,1,0,0,1,1,4,3,1,0,1,0,1,0,0,19,EL
bb6c6331,0,0,0,0,0,0,0,0,2,0,2,0,0,2,0,19,EL
bbb496b5,3,1,1,0,2,1,2,1,2,1,1,0,3,1,0,19,EL
bc1ef1f4,1,1,1,0,0,0,0,0,1,0,1,3,4,4,0,19,EL
bc5b5be5,1,0,1,0,0,0,2,2,3,0,3,0,1,1,0,19,EL
bc647827,0,0,0,0,0,0,1,1,1,1,0,2,2,1,0,19,EL
bc6f5f06,8,6,4,4,0,2,6,4,6,2,4,12,20,30,0,19,EL
bc7dc64d,1,1,0,1,0,0,0,0,2,0,2,0,1,0,0,19,EL
bd142efb,5,3,3,2,0,3,4,1,4,1,3,2,7,7,0,19,EL
bdf8165d,7,4,1,6,0,1,9,8,6,0,6,2,9,2,0,19,EL
be42a291,18,8,4,7,7,5,13,8,14,0,14,5,23,1,0,19,EL
be765073,11,5,10,1,0,6,12,6,14,2,12,13,24,12,0,19,EL
bea81d41,0,0,0,0,0,0,0,0,0,0,0,0,0,2,0,19,EL
beb6c168,1,1,0,1,0,1,1,0,0,0,0,1,2,0,0,19,EL
bee0bab1,5,3,3,0,2,4,8,4,3,0,3,1,6,1,0,19,EL
beec76cc,4,3,1,3,0,2,3,1,4,1,3,5,9,1,0,19,EL
bf12926c,1,1,0,1,0,0,0,0,3,0,3,0,1,0,0,19,EL
bf309d24,7,5,3,4,0,4,6,2,3,2,1,3,10,3,0,19,EL
bf721ea0,0,0,0,0,0,0,0,0,0,0,0,0,0,0,0,19,EL
bf97c188,7,3,1,6,0,2,7,5,3,0,3,6,13,15,0,19,EL
bfae110f,1,1,0,1,0,0,0,0,1,0,1,0,1,0,0,19,EL
bfc5768b,6,4,2,3,1,2,4,2,5,1,4,3,9,4,0,19,EL
bfdb33aa,4,3,3,1,0,1,2,1,3,0,3,2,6,1,0,19,EL
c01c66d9,4,4,4,0,0,1,5,4,4,1,3,9,13,10,0,19,EL
c08fc464,12,8,2,5,5,3,7,4,3,1,2,2,14,2,0,19,EL
c0c7ff58,10,6,6,4,0,4,13,9,6,0,6,1,11,10,1,19,EL
c0e27d1a,5,4,3,2,0,2,4,2,11,9,2,5,10,26,0,19,EL
c1b7847c,27,18,12,14,1,6,17,11,21,0,21,12,39,5,0,19,EL
c204f844,2,0,1,1,0,1,1,0,3,2,1,0,2,0,0,19,EL
c24544c7,2,0,1,1,0,0,2,2,2,0,2,1,3,1,0,19,EL
c2c29554,23,12,13,6,4,13,39,26,16,3,13,28,51,7,1,19,EL
c2dfedeb,3,2,0,3,0,1,1,0,1,0,1,1,4,0,0,19,EL
c316607a,9,7,7,2,0,6,8,2,7,2,5,2,11,11,0,19,EL
c35363f2,11,9,5,3,3,3,10,7,3,2,1,2,13,3,0,19,EL
c3b6fa1e,15,9,8,7,0,5,9,4,6,1,5,10,25,6,0,19,EL
c43e5e7e,2,1,1,0,1,0,1,1,1,1,0,0,2,1,0,19,EL
c44a1d58,4,2,1,3,0,3,12,9,3,1,2,3,7,4,0,19,EL
c4527123,0,0,0,0,0,0,0,0,0,0,0,1,1,0,0,19,EL
c455a2b2,9,7,1,6,2,4,11,7,11,0,11,15,24,5,0,19,EL
c459a650,12,6,7,5,0,9,11,2,8,1,7,8,20,11,1,19,EL
c50281a0,8,6,2,5,1,3,6,3,3,0,3,8,16,3,0,19,EL
c52b28d0,0,0,0,0,0,0,0,0,0,0,0,0,0,1,0,19,EL
c5adc293,2,2,2,0,0,1,3,2,2,0,2,2,4,1,0,19,EL
c603ad6a,8,5,2,4,2,1,11,10,6,0,6,12,20,8,0,19,EL
c64c254c,1,1,1,0,0,0,0,0,0,0,0,0,1,0,0,19,EL
c6500a29,3,1,0,2,1,1,3,2,1,0,1,1,4,1,0,19,EL
c650629d,4,2,2,1,1,0,1,1,2,0,2,2,6,2,0,19,EL
c67b8590,6,1,3,2,1,1,4,3,0,0,0,6,12,3,0,19,EL
c693347d,2,2,0,1,1,1,1,0,0,0,0,0,2,4,0,19,EL
c6ac6579,1,1,0,1,0,0,0,0,1,0,1,0,1,0,0,19,EL
c6dd017b,8,3,3,5,0,2,7,5,2,0,2,8,16,4,0,19,EL
c6e7789b,2,1,2,0,0,0,0,0,0,0,0,0,2,2,0,19,EL
c71e97ba,15,10,7,7,1,7,13,6,3,0,3,10,25,9,0,19,EL
c75b6a02,6,4,2,4,0,0,0,0,3,0,3,3,9,0,0,19,EL
c78b352d,2,2,1,1,0,2,3,1,0,0,0,1,3,1,0,19,EL
c7e9eefb,4,3,2,1,1,2,4,2,3,2,1,0,4,2,0,19,EL
c80c8364,0,0,0,0,0,0,3,3,0,0,0,1,1,0,0,19,EL
c8a88acd,0,0,0,0,0,0,0,0,0,0,0,0,0,1,1,19,EL
c8c02ac7,11,7,5,4,2,6,7,1,4,1,3,6,17,15,0,19,EL
c906ce0f,4,4,4,0,0,1,1,0,3,1,2,7,11,25,0,19,EL
c90b2e8f,5,4,4,0,1,3,6,3,5,1,4,13,18,19,1,19,EL
c9bdb329,8,4,4,4,0,1,6,5,4,0,4,6,14,11,0,19,EL
ca45605e,0,0,0,0,0,0,3,3,1,0,1,1,1,0,0,19,EL
ca8033cb,7,4,3,4,0,1,1,0,3,0,3,2,9,9,0,19,EL
ca9da30f,11,6,3,8,0,4,9,5,8,1,7,9,20,5,0,19,EL
cbb8620f,10,6,4,5,1,4,13,9,7,1,6,3,13,15,0,19,EL
cbec1196,10,9,6,3,1,3,9,6,9,1,8,3,13,4,0,19,EL
cc41eec1,6,3,1,4,1,4,5,1,3,1,2,5,11,10,0,19,EL
cc700722,26,15,14,11,1,11,21,10,8,0,8,3,29,0,2,19,EL
cc77354e,7,6,5,2,0,3,4,1,3,1,2,5,12,13,0,19,EL
cc89c822,2,0,2,0,0,1,1,0,0,0,0,0,2,1,0,19,EL
cce181df,7,4,4,2,1,2,7,5,3,0,3,7,14,4,0,19,EL
ccf5926f,1,1,0,1,0,0,0,0,0,0,0,0,1,0,0,19,EL
cd0fa27b,2,1,1,1,0,2,4,2,3,0,3,4,6,1,0,19,EL
cd1b2304,0,0,0,0,0,0,0,0,0,0,0,0,0,0,1,19,EL
cda08080,14,8,11,2,1,4,8,4,3,2,1,9,23,26,0,19,EL
cda0b317,2,2,2,0,0,2,2,0,0,0,0,0,2,4,1,19,EL
ce17b5eb,0,0,0,0,0,0,0,0,0,0,0,1,1,3,3,19,EL
ce492295,2,0,2,0,0,0,3,3,7,5,2,10,12,26,0,19,EL
ce5143da,5,2,0,4,1,4,4,0,6,1,5,1,6,3,0,19,EL
ce538b0b,12,10,10,1,1,6,19,13,9,2,7,10,22,6,0,19,EL
ce9e8024,3,2,2,1,0,0,0,0,5,4,1,3,6,8,0,19,EL
cea0df32,3,3,2,1,0,0,4,4,4,1,3,1,4,3,0,19,EL
ceb30355,2,1,0,1,1,0,2,2,0,0,0,0,2,1,0,19,EL
cf007308,14,9,7,5,2,4,13,9,5,0,5,9,23,6,0,19,EL
cf182add,1,0,0,1,0,0,0,0,1,1,0,2,3,6,0,19,EL
d02e0cab,1,1,1,0,0,1,5,4,2,0,2,0,1,0,0,19,EL
d04d34c4,6,5,3,3,0,3,4,1,3,0,3,4,10,1,0,19,EL
d06ae2ba,1,0,0,1,0,0,2,2,2,0,2,0,1,2,0,19,EL
d072a976,1,0,0,1,0,0,0,0,2,1,1,0,1,3,0,19,EL
d0a01d27,5,2,2,3,0,5,5,0,3,1,2,4,9,1,0,19,EL
d0b6129f,8,6,2,5,1,2,4,2,5,2,3,8,16,1,0,19,EL
d0d8dd44,1,0,1,0,0,0,0,0,3,2,1,5,6,17,1,19,EL
d14229f3,1,1,1,0,0,0,1,1,4,0,4,0,1,3,0,19,EL
d1675302,6,3,3,3,0,3,4,1,3,0,3,4,10,13,0,19,EL
d1992a3b,1,0,1,0,0,0,3,3,0,0,0,1,2,10,0,19,EL
d1fea02e,15,9,13,2,0,7,8,1,12,12,0,12,27,31,0,19,EL
d2110326,6,5,5,1,0,5,6,1,9,6,3,8,14,25,0,19,EL
d2131e09,4,3,3,1,0,1,5,4,3,0,3,2,6,1,0,19,EL
d2416c2e,0,0,0,0,0,0,1,1,1,0,1,0,0,3,0,19,EL
d248cd8f,16,11,11,5,0,5,7,2,8,3,5,9,25,13,0,19,EL
d2795011,0,0,0,0,0,0,1,1,0,0,0,0,0,0,0,19,EL
d28b8f40,4,2,3,1,0,2,3,1,4,3,1,3,7,6,1,19,EL
d2a802b8,5,3,5,0,0,3,10,7,6,4,2,4,9,5,0,19,EL
d3013717,12,5,6,6,0,6,13,7,6,1,5,9,21,6,0,19,EL
d3272fba,0,0,0,0,0,0,0,0,0,0,0,0,0,0,0,19,EL
d3bd981b,3,2,2,1,0,0,1,1,1,1,0,7,10,7,0,19,EL
d3ce9f1f,2,1,1,1,0,1,2,1,0,0,0,0,2,3,0,19,EL
d3ec34cf,0,0,0,0,0,0,0,0,0,0,0,0,0,0,0,19,EL
d4222f7b,12,8,7,4,1,6,11,5,5,3,2,10,22,19,0,19,EL
d4232ba9,3,3,0,2,1,0,6,6,2,0,2,0,3,1,0,19,EL
d4535821,6,3,2,4,0,2,3,1,2,0,2,2,8,13,0,19,EL
d49f80d7,1,0,1,0,0,1,5,4,4,3,1,4,5,16,1,19,EL
d4cb83cc,14,5,8,5,1,4,10,6,8,3,5,20,34,29,0,19,EL
d4e93bab,11,8,5,5,1,3,9,6,5,2,3,8,19,7,0,19,EL
d4f46475,3,3,3,0,0,1,3,2,4,2,2,8,11,11,1,19,EL
d5575935,11,8,3,6,2,3,12,9,2,0,2,4,15,1,0,19,EL
d57d680c,1,0,1,0,0,1,3,2,2,2,0,0,1,9,0,19,EL
d5dd5f1f,6,3,1,2,3,0,6,6,12,2,10,3,9,6,0,19,EL
d61b3354,4,1,4,0,0,3,3,0,2,1,1,10,14,14,0,19,EL
d637fc22,4,2,2,2,0,2,3,1,1,0,1,2,6,1,0,19,EL
d63e2912,4,3,1,2,1,2,2,0,1,0,1,10,14,5,0,19,EL
d6a889ea,3,2,1,1,1,1,2,1,1,0,1,1,4,1,0,19,EL
d6d8582b,0,0,0,0,0,0,0,0,2,0,2,0,0,0,0,19,EL
d6f5490e,1,0,1,0,0,0,0,0,0,0,0,0,1,0,0,19,EL
d717630e,1,0,0,0,1,0,2,2,1,0,1,0,1,0,0,19,EL
d72f8d9e,12,8,9,3,0,6,7,1,9,3,6,15,27,31,0,19,EL
d7398ac3,9,5,6,2,1,4,11,7,5,0,5,5,14,2,0,19,EL
d7553721,22,15,9,10,3,10,13,3,2,0,2,9,31,2,0,19,EL
d75cf9bf,0,0,0,0,0,0,2,2,2,0,2,0,0,0,0,19,EL
d75f3980,9,7,4,4,1,6,10,4,4,2,2,9,18,8,0,19,EL
d79a8c87,4,3,4,0,0,2,2,0,5,3,2,2,6,14,1,19,EL
d820a7c8,2,1,0,1,1,0,0,0,3,0,3,1,3,2,0,19,EL
d83bbc54,14,9,5,6,3,4,8,4,4,1,3,9,23,9,0,19,EL
d83f09ff,7,4,4,1,2,1,2,1,3,0,3,3,10,3,0,19,EL
d8988c46,0,0,0,0,0,0,0,0,1,0,1,0,0,0,0,19,EL
d8c679be,6,6,2,4,0,3,7,4,7,2,5,2,8,2,0,19,EL
d8feae4a,17,12,14,3,0,10,18,8,9,4,5,10,27,45,1,19,EL
d94653be,4,2,1,2,1,0,1,1,1,0,1,1,5,3,0,19,EL
d97b252e,2,1,2,0,0,1,1,0,0,0,0,0,2,4,0,19,EL
d97cccc9,7,3,2,5,0,2,2,0,3,0,3,4,11,2,0,19,EL
d995ed27,2,1,1,1,0,0,2,2,1,0,1,4,6,0,0,19,EL
da09d0c3,13,10,8,5,0,2,7,5,8,2,6,5,18,4,0,19,EL
da121b3a,4,2,2,1,1,2,3,1,3,2,1,8,12,9,0,19,EL
da270297,2,1,1,1,0,1,1,0,1,1,0,4,6,3,0,19,EL
da3bf1b3,13,9,7,5,1,5,17,12,11,3,8,8,21,8,1,19,EL
da617483,0,0,0,0,0,0,0,0,4,2,2,7,7,13,0,19,EL
da6cb94b,8,4,6,2,0,2,4,2,12,9,3,6,14,24,0,19,EL
da974c7b,5,5,5,0,0,5,6,1,20,9,11,5,10,26,0,19,EL
dab75831,1,0,0,0,1,0,1,1,0,0,0,1,2,0,0,19,EL
dade14fe,3,1,2,1,0,1,3,2,0,0,0,1,4,0,0,19,EL
dae8623e,4,2,2,1,1,1,3,2,2,0,2,1,5,2,0,19,EL
db1aced4,4,2,4,0,0,3,4,1,8,5,3,12,16,31,0,19,EL
db265666,3,1,0,1,2,1,4,3,3,0,3,0,3,0,0,19,EL
db3cb6ee,8,5,7,1,0,6,7,1,9,6,3,14,22,58,1,19,EL
dba67bc4,12,8,8,3,1,6,13,7,15,1,14,15,27,9,0,19,EL
dbd3a428,1,0,0,1,0,0,1,1,1,0,1,4,5,0,0,19,EL
dc29b608,1,1,1,0,0,0,0,0,0,0,0,0,1,3,0,19,EL
dc366c36,0,0,0,0,0,0,0,0,0,0,0,1,1,4,0,19,EL
dc3fa3b5,2,1,0,1,1,1,3,2,4,0,4,3,5,0,1,19,EL
dc415e39,5,3,0,5,0,1,3,2,5,0,5,4,9,2,0,19,EL
dc4511f3,0,0,0,0,0,0,0,0,0,0,0,1,1,3,0,19,EL
dc52c72f,14,4,7,4,3,6,14,8,4,0,4,12,26,47,1,19,EL
dc62b55d,13,8,5,4,4,3,11,8,15,0,15,1,14,7,0,19,EL
dc90cfbe,1,1,0,1,0,0,4,4,2,0,2,2,3,3,0,19,EL
dca7b0fb,0,0,0,0,0,0,0,0,0,0,0,0,0,0,0,19,EL
dd0daf32,15,7,1,9,5,4,16,12,10,1,9,11,26,8,0,19,EL
dd2044f4,9,6,9,0,0,8,9,1,7,0,7,4,13,9,0,19,EL
dda3969e,1,0,0,1,0,1,1,0,0,0,0,0,1,2,0,19,EL
de4517dd,13,7,9,3,1,9,15,6,4,0,4,7,20,11,0,19,EL
dee86451,11,6,1,9,1,3,7,4,5,2,3,4,15,3,0,19,EL
def6943f,0,0,0,0,0,0,1,1,0,0,0,2,2,0,0,19,EL
defb905a,5,3,5,0,0,4,7,3,10,9,1,11,16,31,0,19,EL
df525574,5,2,3,2,0,2,3,1,1,1,0,7,12,15,0,19,EL
df746364,0,0,0,0,0,0,0,0,0,0,0,0,0,0,0,19,EL
df791bca,0,0,0,0,0,0,1,1,0,0,0,0,0,0,0,19,EL
df8b52a5,0,0,0,0,0,0,0,0,0,0,0,1,1,0,0,19,EL
dff153a4,10,7,6,4,0,2,11,9,12,4,8,6,16,9,0,19,EL
e0238966,0,0,0,0,0,0,0,0,0,0,0,0,0,1,0,19,EL
e03c2d97,15,11,8,4,3,4,9,5,13,4,9,7,22,31,0,19,EL
e040aecf,7,2,1,6,0,3,6,3,1,0,1,1,8,3,0,19,EL
e054ee4e,0,0,0,0,0,0,0,0,0,0,0,0,0,2,0,19,EL
e09436fb,0,0,0,0,0,0,0,0,0,0,0,1,1,1,0,19,EL
e0a1c004,9,6,4,5,0,6,14,8,7,1,6,10,19,12,0,19,EL
e0bc6fdc,15,12,5,8,2,7,13,6,8,2,6,15,30,19,0,19,EL
e0fd942a,13,12,5,6,2,1,5,4,1,0,1,10,23,6,0,19,EL
e12b0b5b,20,11,8,6,6,6,26,20,9,1,8,16,36,12,0,19,EL
e12d7851,4,3,1,3,0,2,2,0,6,2,4,5,9,14,0,19,EL
e1550a44,16,13,9,6,1,4,17,13,9,4,5,13,29,8,0,19,EL
e16dd48e,5,2,2,2,1,2,3,1,1,0,1,2,7,3,0,19,EL
e18098de,9,5,5,4,0,1,6,5,5,1,4,11,20,11,0,19,EL
e1bbb68d,1,0,0,1,0,0,0,0,1,1,0,1,2,0,0,19,EL
e1deea75,5,2,4,1,0,1,4,3,7,2,5,8,13,9,0,19,EL
e204ec12,2,2,0,2,0,1,6,5,2,0,2,1,3,0,0,19,EL
e248e62f,1,0,0,1,0,0,1,1,1,1,0,2,3,0,0,19,EL
e26c4233,4,3,2,1,1,3,4,1,3,2,1,7,11,6,0,19,EL
e26f559f,3,3,1,2,0,3,4,1,4,0,4,1,4,3,0,19,EL
e280527c,14,5,7,6,1,1,3,2,2,0,2,2,16,1,0,19,EL
e2b384d2,0,0,0,0,0,0,0,0,0,0,0,0,0,0,0,19,EL
e2bf2abc,4,4,1,3,0,2,3,1,4,1,3,1,5,0,0,19,EL
e2dde94c,16,10,6,6,4,9,14,5,6,0,6,8,24,4,0,19,EL
e2e9c250,13,11,5,6,2,8,12,4,3,1,2,1,14,4,0,19,EL
e2f9bb5f,2,2,1,1,0,2,2,0,0,0,0,0,2,0,0,19,EL
e304acd5,6,2,1,5,0,5,10,5,7,1,6,3,9,7,0,19,EL
e34e086c,9,3,3,4,2,1,2,1,2,0,2,1,10,1,0,19,EL
e358587b,0,0,0,0,0,0,0,0,0,0,0,0,0,1,2,19,EL
e373f1ec,4,4,1,3,0,2,4,2,0,0,0,4,8,4,0,19,EL
e3a5814e,22,13,13,8,1,9,21,12,13,1,12,13,35,16,1,19,EL
e3e32fbb,20,12,13,5,2,8,14,6,2,1,1,18,38,13,0,19,EL
e45ee4bc,4,1,3,1,0,1,3,2,2,0,2,2,6,3,1,19,EL
e4a26a91,4,3,2,2,0,1,5,4,0,0,0,5,9,6,0,19,EL
e4c35d02,0,0,0,0,0,0,1,1,0,0,0,1,1,1,0,19,EL
e556a911,13,8,8,5,0,5,11,6,10,7,3,6,19,18,0,19,EL
e5cd9da6,5,4,1,3,1,3,6,3,2,1,1,5,10,6,0,19,EL
e61b8aee,15,10,4,8,3,11,18,7,7,3,4,8,23,7,0,19,EL
e61bdd69,5,3,1,4,0,4,6,2,8,0,8,5,10,2,0,19,EL
e61d33f1,1,1,1,0,0,0,0,0,0,0,0,0,1,4,0,19,EL
e652624a,1,1,0,1,0,0,0,0,0,0,0,1,2,0,0,19,EL
e65dd8dc,1,0,1,0,0,1,2,1,0,0,0,1,2,4,3,19,EL
e66e4ddc,12,10,5,6,1,4,14,10,8,1,7,8,20,10,0,19,EL
e6bc67d7,7,3,3,3,1,3,12,9,5,0,5,2,9,1,0,19,EL
e6dda1c7,5,3,2,3,0,2,2,0,4,1,3,6,11,22,0,19,EL
e707e3a7,11,8,4,5,2,5,10,5,7,3,4,14,25,7,0,19,EL
e717705a,12,9,1,9,2,2,6,4,7,1,6,7,19,8,0,19,EL
e726e11e,2,1,0,2,0,2,4,2,3,1,2,0,2,2,0,19,EL
e73659d3,9,8,4,5,0,4,6,2,9,0,9,3,12,5,0,19,EL
e7af9060,0,0,0,0,0,0,2,2,2,0,2,0,0,3,0,19,EL
e7ec3c71,3,3,2,1,0,2,8,6,5,0,5,10,13,3,0,19,EL
e7ef333b,7,3,4,3,0,6,7,1,6,5,1,8,15,25,0,19,EL
e81f0356,11,10,7,4,0,6,8,2,8,5,3,9,20,20,0,19,EL
e82d2807,0,0,0,0,0,0,0,0,0,0,0,0,0,0,0,19,EL
e85ec097,3,2,1,2,0,0,3,3,2,0,2,0,3,0,0,19,EL
e8c930bb,5,3,1,2,2,2,6,4,3,0,3,4,9,1,0,19,EL
e8ed3abc,2,2,0,0,2,2,2,0,0,0,0,0,2,0,0,19,EL
e90dc1d5,3,1,3,0,0,1,1,0,2,0,2,1,4,0,0,19,EL
e9356a25,1,0,1,0,0,1,2,1,0,0,0,0,1,1,0,19,EL
e94d79e3,3,2,1,2,0,1,3,2,1,0,1,2,5,4,0,19,EL
e9517008,13,8,11,2,0,6,11,5,9,4,5,12,25,29,0,19,EL
e97fd090,9,8,2,5,2,4,8,4,8,1,7,2,11,3,0,19,EL
ea0ff634,3,2,1,1,1,0,0,0,2,1,1,2,5,1,0,19,EL
ea6a7ab4,5,3,2,2,1,0,8,8,0,0,0,1,6,0,0,19,EL
eac044ad,13,9,3,6,4,2,11,9,7,1,6,9,22,7,0,19,EL
eac8cdb6,2,2,1,1,0,1,2,1,3,1,2,4,6,8,1,19,EL
ead51916,7,2,4,3,0,1,4,3,5,1,4,4,11,4,1,19,EL
ead960f2,19,16,7,8,4,6,11,5,6,0,6,11,30,0,0,19,EL
eb2b33aa,0,0,0,0,0,0,0,0,0,0,0,0,0,0,0,19,EL
eb2fe5b6,6,5,2,3,1,1,4,3,0,0,0,0,6,2,0,19,EL
eb3f56e5,2,1,1,0,1,0,1,1,0,0,0,3,5,7,0,19,EL
eb8b2a35,10,6,4,6,0,5,12,7,2,0,2,6,16,2,0,19,EL
ebc06041,8,5,5,3,0,3,5,2,1,1,0,6,14,11,0,19,EL
ebc49727,5,4,2,1,2,2,6,4,6,0,6,0,5,1,0,19,EL
ebca82e8,10,5,7,2,1,4,5,1,5,5,0,16,26,20,0,19,EL
ebdc9c7e,8,7,7,1,0,7,8,1,6,3,3,13,21,23,2,19,EL
ec30b9c8,5,3,1,4,0,2,2,0,1,0,1,3,8,2,0,19,EL
ec3efd7f,3,3,1,1,1,1,6,5,0,0,0,0,3,1,0,19,EL
ecb68eea,18,13,5,12,1,7,18,11,13,2,11,19,37,12,0,19,EL
ed54971a,6,4,3,3,0,2,4,2,10,7,3,9,15,8,0,19,EL
ed560575,11,8,5,5,1,2,8,6,3,1,2,5,16,12,0,19,EL
ed5886d2,11,6,4,4,3,4,6,2,9,4,5,6,17,9,1,19,EL
ed90babd,2,2,1,1,0,0,2,2,0,0,0,1,3,0,0,19,EL
eda890e3,1,0,1,0,0,0,0,0,2,2,0,0,1,2,0,19,EL
edd20aef,11,8,9,2,0,7,13,6,4,1,3,8,19,20,0,19,EL
edd38473,9,7,2,5,2,5,11,6,7,2,5,7,16,11,0,19,EL
eddcbbc4,3,2,2,1,0,1,4,3,5,0,5,8,11,5,0,19,EL
ee251371,5,3,2,3,0,0,6,6,5,0,5,0,5,1,0,19,EL
ee3519f5,0,0,0,0,0,0,0,0,0,0,0,1,1,0,0,19,EL
ee926a02,15,7,7,8,0,6,10,4,6,0,6,4,19,8,0,19,EL
ee950928,24,16,16,3,5,11,23,12,11,0,11,7,31,11,0,19,EL
eeb032db,0,0,0,0,0,0,0,0,0,0,0,1,1,0,0,19,EL
eec32585,2,1,0,1,1,0,0,0,0,0,0,0,2,0,0,19,EL
ef13f203,11,8,8,3,0,6,12,6,6,4,2,15,26,42,1,19,EL
ef2e5e1a,8,4,0,7,1,0,3,3,9,1,8,7,15,5,0,19,EL
ef322658,5,3,1,1,3,4,8,4,4,0,4,3,8,2,0,19,EL
ef5b337e,6,5,3,3,0,2,3,1,6,1,5,2,8,1,0,19,EL
ef619b0b,9,5,2,4,3,0,4,4,6,0,6,7,16,1,0,19,EL
ef88f778,3,2,0,3,0,0,5,5,1,0,1,0,3,0,0,19,EL
ef8cafeb,3,0,1,2,0,3,3,0,2,1,1,4,7,19,0,19,EL
ef8f266e,1,0,0,1,0,0,0,0,0,0,0,0,1,0,0,19,EL
ef9c1c95,26,19,12,13,1,9,19,10,11,3,8,10,36,14,0,19,EL
efc33b33,3,3,3,0,0,2,3,1,1,1,0,1,4,13,0,19,EL
f08a8947,6,6,5,0,1,2,4,2,6,5,1,17,23,37,0,19,EL
f0e3b343,2,1,0,0,2,0,2,2,3,0,3,0,2,2,0,19,EL
f15b778f,21,16,10,6,5,8,14,6,5,1,4,6,27,6,0,19,EL
f1eee8b3,2,0,1,1,0,1,1,0,0,0,0,0,2,0,0,19,EL
f2428fd4,9,7,7,2,0,7,13,6,3,0,3,8,17,9,1,19,EL
f26e3c59,13,8,7,5,1,7,11,4,4,1,3,4,17,7,0,19,EL
f27680d9,3,2,1,2,0,1,2,1,3,2,1,1,4,3,0,19,EL
f294b8cc,0,0,0,0,0,0,1,1,0,0,0,1,1,0,0,19,EL
f2d063ec,4,3,2,2,0,2,6,4,2,0,2,2,6,4,0,19,EL
f2eaebe9,3,1,1,1,1,0,0,0,2,1,1,1,4,1,0,19,EL
f301f363,14,5,6,5,3,6,11,5,8,0,8,4,18,3,0,19,EL
f315ca93,13,6,8,4,1,6,7,1,2,0,2,6,19,4,0,19,EL
f346787e,15,8,8,5,2,8,11,3,8,0,8,8,23,12,0,19,EL
f373db50,22,15,18,4,0,7,12,5,10,3,7,20,42,36,0,19,EL
f3a97d02,0,0,0,0,0,0,0,0,0,0,0,1,1,3,1,19,EL
f4021366,10,3,9,1,0,5,8,3,10,7,3,5,15,38,1,19,EL
f4290206,7,4,4,3,0,4,5,1,4,0,4,4,11,9,0,19,EL
f45eb18d,16,9,3,10,3,4,9,5,8,1,7,9,25,3,0,19,EL
f47009ce,2,2,2,0,0,1,2,1,1,0,1,2,4,2,0,19,EL
f4b852b5,5,4,3,2,0,3,11,8,6,2,4,6,11,21,0,19,EL
f50a668a,3,1,1,2,0,0,0,0,3,2,1,2,5,9,0,19,EL
f553b2b3,1,1,0,1,0,0,0,0,1,0,1,1,2,1,0,19,EL
f5eedf74,7,5,5,1,1,2,5,3,3,0,3,2,9,0,0,19,EL
f5efb153,8,4,7,0,1,4,10,6,10,6,4,14,22,33,0,19,EL
f631c17f,1,0,1,0,0,0,1,1,4,0,4,0,1,0,0,19,EL
f6c579bd,1,1,1,0,0,1,2,1,1,0,1,1,2,0,0,19,EL
f7036e1c,0,0,0,0,0,0,0,0,1,0,1,0,0,3,0,19,EL
f70e46e6,0,0,0,0,0,0,0,0,0,0,0,0,0,1,0,19,EL
f7223718,1,0,1,0,0,1,2,1,1,0,1,0,1,1,0,19,EL
f7288611,6,5,3,3,0,1,4,3,7,3,4,16,22,4,0,19,EL
f73abe54,2,1,0,1,1,1,3,2,2,0,2,0,2,1,0,19,EL
f7e87032,6,5,2,3,1,2,15,13,8,0,8,9,15,12,0,19,EL
f80f8e10,2,2,1,1,0,1,1,0,1,0,1,0,2,1,0,19,EL
f820504e,2,2,1,1,0,0,0,0,1,0,1,4,6,9,0,19,EL
f8280175,3,3,1,2,0,0,1,1,1,1,0,5,8,1,0,19,EL
f833a830,11,9,4,6,1,5,12,7,7,0,7,2,13,2,0,19,EL
f83c8d6c,2,1,0,2,0,0,4,4,1,0,1,1,3,7,0,19,EL
f93c876b,3,2,0,3,0,0,2,2,3,0,3,4,7,8,2,19,EL
f94eb380,18,13,9,6,3,3,8,5,3,0,3,4,22,3,0,19,EL
f95cb908,2,1,1,1,0,1,2,1,2,1,1,0,2,6,0,19,EL
f99b71de,2,1,1,1,0,1,3,2,1,0,1,2,4,2,0,19,EL
f9acca3a,20,13,11,6,3,13,19,6,6,1,5,9,29,10,0,19,EL
f9bd541e,9,8,5,4,0,2,10,8,6,0,6,5,14,6,0,19,EL
fa14dd4f,13,10,6,6,1,4,10,6,7,0,7,2,15,4,1,19,EL
fa73ccc7,7,2,1,6,0,3,8,5,5,1,4,4,11,1,0,19,EL
fa937f7a,15,9,5,8,2,5,9,4,8,1,7,7,22,1,1,19,EL
faa1b07d,16,7,15,1,0,8,9,1,3,2,1,7,23,27,0,19,EL
fad3e13e,1,1,0,1,0,1,2,1,1,1,0,0,1,0,0,19,EL
fae880d5,4,2,1,2,1,2,5,3,0,0,0,5,9,6,0,19,EL
fb054320,5,2,0,3,2,1,6,5,1,0,1,3,8,2,0,19,EL
fb2c533b,7,2,1,6,0,2,8,6,3,1,2,0,7,5,0,19,EL
fb517645,0,0,0,0,0,0,1,1,0,0,0,0,0,0,0,19,EL
fb5d47b3,18,12,6,8,4,9,13,4,10,2,8,16,34,24,0,19,EL
fbbb9269,6,3,5,1,0,3,5,2,3,0,3,4,10,14,0,19,EL
fbd6378b,7,7,2,5,0,1,1,0,6,5,1,10,17,7,1,19,EL
fc1cf07a,19,13,9,10,0,10,14,4,13,7,6,29,48,48,0,19,EL
fcda82c7,6,5,5,0,1,5,8,3,10,6,4,13,19,35,0,19,EL
fce2302c,10,9,9,1,0,5,6,1,12,1,11,13,23,19,0,19,EL
fd14b16c,7,3,6,1,0,5,8,3,3,1,2,4,11,13,1,19,EL
fdf3cb77,8,6,2,5,1,3,17,14,5,0,5,12,20,18,0,19,EL
feb5d3ab,6,5,5,1,0,4,5,1,6,1,5,4,10,7,0,19,EL
fec5accc,1,1,0,1,0,0,0,0,0,0,0,0,1,2,0,19,EL
fed17f5a,11,7,3,5,3,8,19,11,7,3,4,5,16,4,0,19,EL
fed7cb61,4,4,0,4,0,1,5,4,7,0,7,4,8,2,0,19,EL
ff579c7e,6,3,2,1,3,4,6,2,2,0,2,3,9,3,0,19,EL
ff764de3,7,4,4,2,1,1,8,7,4,0,4,4,11,1,0,19,EL
ff98492b,5,3,2,2,1,1,3,2,10,0,10,5,10,3,1,19,EL
ffec9769,3,0,0,2,1,1,5,4,4,1,3,0,3,4,0,19,EL
ffed43e3,0,0,0,0,0,0,1,1,5,4,1,0,0,6,0,19,EL
000b3da6,2,0,0,2,0,0,0,0,1,0,1,2,4,2,0,19,SPA
003a5c72,43,25,19,19,5,15,48,33,27,6,21,21,64,35,0,19,SPA
00b28772,77,45,21,51,5,21,61,40,60,15,45,71,148,33,0,19,SPA
011d8c56,1,1,1,0,0,1,2,1,0,0,0,1,2,9,2,19,SPA
014b57f5,0,0,0,0,0,0,0,0,0,0,0,0,0,0,0,19,SPA
01eb744d,38,19,19,12,7,10,53,43,28,5,23,17,55,20,0,19,SPA
02319ad7,30,21,8,14,8,7,26,19,14,0,14,17,47,27,0,19,SPA
02c15616,16,12,7,7,2,8,18,10,8,0,8,7,23,12,0,19,SPA
02ef8778,8,3,0,7,1,0,12,12,18,4,14,9,17,45,0,19,SPA
036bba5f,96,54,50,40,6,32,89,57,59,10,49,38,134,52,1,19,SPA
04965583,13,11,5,5,3,5,14,9,5,0,5,4,17,12,0,19,SPA
04a65a8f,2,2,0,1,1,2,3,1,3,0,3,1,3,2,0,19,SPA
04ac8285,0,0,0,0,0,0,0,0,0,0,0,0,0,3,2,19,SPA
04e17fd5,16,8,6,5,5,4,24,20,18,3,15,6,22,23,0,19,SPA
05a4465d,83,48,29,40,14,24,77,53,42,7,35,23,106,67,0,19,SPA
06efa9dc,3,3,3,0,0,2,2,0,0,0,0,1,4,5,0,19,SPA
070a3904,60,35,23,32,5,25,69,44,18,3,15,22,82,30,0,19,SPA
07750704,0,0,0,0,0,0,3,3,1,1,0,2,2,0,0,19,SPA
08511d65,41,32,25,12,4,22,39,17,29,15,14,37,78,90,2,19,SPA
0959c2a2,12,8,3,7,2,5,11,6,10,2,8,21,33,10,0,19,SPA
09a9e921,4,2,1,2,1,0,5,5,4,0,4,8,12,5,0,19,SPA
0a0cc13c,4,2,2,1,1,2,8,6,4,0,4,2,6,6,0,19,SPA
0a447501,8,6,0,5,3,1,6,5,8,2,6,3,11,4,0,19,SPA
0ac94a23,46,32,15,22,9,17,37,20,35,3,32,15,61,16,0,19,SPA
0ae4e09a,8,6,1,4,3,1,19,18,14,1,13,4,12,9,0,19,SPA
0b90bb97,17,10,1,15,1,3,25,22,19,2,17,4,21,20,0,19,SPA
0c2ac3cb,8,6,2,3,3,2,2,0,5,1,4,1,9,2,0,19,SPA
0c3f7197,7,4,1,3,3,2,7,5,5,0,5,3,10,1,0,19,SPA
0ef89a37,16,11,1,6,9,7,22,15,21,2,19,12,28,8,0,19,SPA
0f0aa5b4,49,27,41,8,0,20,29,9,23,11,12,37,86,159,3,19,SPA
0f134faf,4,2,2,2,0,2,9,7,2,0,2,4,8,1,0,19,SPA
1001ae82,22,8,8,7,7,7,18,11,14,2,12,8,30,11,0,19,SPA
112521d1,14,9,11,2,1,7,14,7,10,4,6,8,22,27,0,19,SPA
1163de29,4,3,2,2,0,0,6,6,4,0,4,1,5,7,0,19,SPA
1232e1dc,11,8,6,4,1,4,7,3,2,2,0,10,21,16,0,19,SPA
129af0db,20,14,2,7,11,3,10,7,7,0,7,5,25,13,0,19,SPA
129dd8e7,0,0,0,0,0,0,0,0,0,0,0,1,1,3,0,19,SPA
12c50af5,0,0,0,0,0,0,0,0,1,0,1,0,0,0,0,19,SPA
13b0c150,2,2,2,0,0,1,1,0,5,5,0,4,6,10,0,19,SPA
13e0eb29,4,3,0,3,1,2,5,3,1,0,1,0,4,2,0,19,SPA
148d4105,9,4,4,4,1,4,7,3,3,1,2,5,14,4,0,19,SPA
1512328c,42,18,21,15,6,18,50,32,20,1,19,14,56,17,0,19,SPA
1519a888,1,0,0,0,1,0,0,0,0,0,0,0,1,0,0,19,SPA
1633fc8a,48,25,32,15,1,24,45,21,31,15,16,57,105,138,0,19,SPA
167c1bb0,3,1,3,0,0,2,3,1,5,1,4,5,8,27,0,19,SPA
16e9d0ea,63,40,41,18,4,29,53,24,35,9,26,41,104,97,0,19,SPA
174651c8,2,2,1,1,0,0,1,1,1,1,0,3,5,3,0,19,SPA
174f09a6,1,0,0,1,0,1,2,1,4,4,0,5,6,25,0,19,SPA
17a1299d,0,0,0,0,0,0,0,0,0,0,0,0,0,0,0,19,SPA
17d9e354,1,1,1,0,0,1,3,2,1,0,1,2,3,1,2,19,SPA
1840e36d,0,0,0,0,0,0,2,2,0,0,0,2,2,5,0,19,SPA
18dc8533,2,2,0,1,1,1,4,3,4,2,2,4,6,2,0,19,SPA
19709006,46,25,26,15,5,16,58,42,12,2,10,16,62,16,0,19,SPA
19b776e9,22,14,8,10,4,6,14,8,17,2,15,3,25,14,0,19,SPA
1a1609ab,1,1,1,0,0,1,1,0,0,0,0,0,1,1,0,19,SPA
1a317a1b,29,18,15,11,3,17,24,7,19,6,13,17,46,63,2,19,SPA
1b17ed86,50,32,26,18,6,17,50,33,42,8,34,26,76,34,2,19,SPA
1bda5842,33,24,8,15,10,12,43,31,16,1,15,8,41,5,0,19,SPA
1d1691ad,28,25,13,11,4,14,18,4,11,1,10,11,39,17,1,19,SPA
1d5f96d9,1,1,0,0,1,1,1,0,1,0,1,0,1,4,0,19,SPA
1daec722,49,37,13,21,15,10,23,13,36,3,33,20,69,24,0,19,SPA
1e1bea09,0,0,0,0,0,0,1,1,1,0,1,3,3,1,0,19,SPA
1f079188,63,46,24,27,12,24,53,29,37,9,28,35,98,57,0,19,SPA
1f54ed90,46,33,37,8,1,29,39,10,32,18,14,29,75,165,4,19,SPA
1fb1c435,21,10,6,9,6,3,17,14,17,1,16,3,24,18,0,19,SPA
1fe0492d,72,35,45,20,7,34,64,30,46,12,34,57,129,130,1,19,SPA
1fe67e86,10,6,7,1,2,5,8,3,6,2,4,2,12,21,0,19,SPA
200e89e1,7,2,2,0,5,2,8,6,8,0,8,4,11,1,0,19,SPA
20b9f052,0,0,0,0,0,0,2,2,1,0,1,2,2,17,2,19,SPA
220c11f1,23,13,7,13,3,5,20,15,13,1,12,4,27,39,0,19,SPA
228b0d9d,13,8,11,2,0,10,19,9,19,9,10,7,20,26,0,19,SPA
2306bfde,11,7,2,9,0,4,17,13,14,6,8,21,32,9,0,19,SPA
23fffc06,0,0,0,0,0,0,2,2,0,0,0,0,0,0,0,19,SPA
240d3a0b,56,34,21,32,3,24,63,39,28,8,20,49,105,46,1,19,SPA
244f57b9,20,14,6,7,7,7,37,30,18,0,18,22,42,12,2,19,SPA
248c409d,7,6,3,3,1,2,3,1,2,1,1,3,10,9,0,19,SPA
24f59bb2,38,25,16,14,8,10,24,14,27,2,25,23,61,48,0,19,SPA
253a06b9,18,10,7,7,4,4,26,22,21,2,19,13,31,22,0,19,SPA
25c72b36,3,3,2,0,1,2,4,2,7,1,6,1,4,4,0,19,SPA
2683eda7,2,1,0,2,0,0,7,7,5,1,4,6,8,4,0,19,SPA
26f2473f,1,0,1,0,0,1,1,0,0,0,0,1,2,7,0,19,SPA
274ab13c,4,4,3,1,0,2,2,0,4,2,2,8,12,8,0,19,SPA
27a013f7,42,22,32,9,1,18,22,4,32,21,11,35,77,153,1,19,SPA
27d0a506,51,31,28,16,7,32,80,48,36,2,34,39,90,60,1,19,SPA
293211e1,4,2,1,1,2,1,7,6,2,1,1,0,4,4,0,19,SPA
2946f9a1,26,19,14,7,5,11,22,11,19,7,12,32,58,65,1,19,SPA
2973d8ff,1,1,0,1,0,0,3,3,5,2,3,0,1,3,0,19,SPA
29b61deb,83,46,34,38,11,30,82,52,48,12,36,35,118,39,0,19,SPA
29e48848,16,11,8,6,2,6,13,7,5,1,4,4,20,10,1,19,SPA
2a0c8ba4,63,40,16,38,9,28,80,52,38,4,34,32,95,18,1,19,SPA
2a8c9f98,0,0,0,0,0,0,1,1,1,0,1,1,1,2,0,19,SPA
2b15a82a,11,6,5,5,1,6,7,1,6,3,3,9,20,8,0,19,SPA
2bee98fd,18,10,4,11,3,3,16,13,6,1,5,10,28,4,0,19,SPA
2e23c66b,4,3,0,0,4,0,3,3,5,0,5,1,5,7,0,19,SPA
2e8fc160,6,3,5,1,0,4,8,4,2,0,2,3,9,9,0,19,SPA
2ef16f06,16,10,11,2,3,2,18,16,4,0,4,2,18,1,0,19,SPA
3024e383,66,46,36,23,7,31,56,25,24,5,19,41,107,113,1,19,SPA
3061e1ec,0,0,0,0,0,0,0,0,0,0,0,0,0,0,0,19,SPA
30672832,3,3,3,0,0,2,2,0,2,0,2,3,6,0,0,19,SPA
307fcd26,1,0,1,0,0,1,1,0,0,0,0,0,1,4,1,19,SPA
31223bcf,15,8,5,6,4,6,21,15,10,1,9,17,32,9,0,19,SPA
32974271,20,12,1,11,8,2,13,11,12,0,12,5,25,17,0,19,SPA
32c0491f,32,23,25,7,0,13,26,13,27,7,20,27,59,64,1,19,SPA
335039a2,7,6,1,5,1,0,5,5,4,1,3,2,9,1,0,19,SPA
3353737a,25,14,15,9,1,10,21,11,13,3,10,20,45,41,1,19,SPA
335fa267,28,20,15,9,4,16,24,8,18,3,15,43,71,31,0,19,SPA
355c883a,45,29,32,10,3,28,46,18,33,11,22,27,72,65,1,19,SPA
35f6db55,22,14,11,5,6,8,27,19,17,0,17,8,30,14,0,19,SPA
36d5469c,15,9,6,5,4,8,19,11,9,1,8,9,24,5,0,19,SPA
375a669e,3,2,2,0,1,1,3,2,2,0,2,2,5,2,0,19,SPA
379652be,17,8,7,6,4,10,26,16,17,1,16,13,30,9,0,19,SPA
37e103f8,6,4,1,2,3,3,6,3,6,1,5,3,9,4,0,19,SPA
37f1cf47,43,27,32,8,3,13,27,14,20,2,18,30,73,47,0,19,SPA
37f96552,8,4,2,4,2,0,5,5,4,0,4,4,12,1,0,19,SPA
38699c72,6,5,3,3,0,0,6,6,7,1,6,0,6,6,0,19,SPA
3902e91b,26,23,5,19,2,11,48,37,14,4,10,2,28,23,0,19,SPA
3aa4a3be,18,12,4,11,3,6,27,21,24,1,23,6,24,18,0,19,SPA
3c05c659,15,8,4,8,3,5,14,9,13,0,13,8,23,5,0,19,SPA
3c7bc9bd,71,42,27,40,4,32,80,48,35,8,27,40,111,34,1,19,SPA
3cb6f224,12,5,1,7,4,2,7,5,7,1,6,1,13,1,0,19,SPA
3d7e48ce,2,0,0,2,0,0,4,4,2,0,2,0,2,3,0,19,SPA
3e1858af,1,0,1,0,0,1,1,0,0,0,0,0,1,0,0,19,SPA
3e4f735d,41,26,22,17,2,27,45,18,33,7,26,43,84,75,1,19,SPA
3e5a168c,0,0,0,0,0,0,2,2,2,0,2,1,1,2,0,19,SPA
3e96f3e7,8,4,5,3,0,5,6,1,10,4,6,5,13,18,1,19,SPA
3ecc11d8,55,30,39,14,2,19,33,14,35,16,19,63,118,149,1,19,SPA
3ee0dd59,1,0,0,1,0,0,1,1,0,0,0,0,1,0,0,19,SPA
3eed9821,8,5,3,4,1,4,6,2,10,8,2,18,26,28,2,19,SPA
3ef0fa48,5,3,3,1,1,3,4,1,1,0,1,1,6,1,0,19,SPA
3effaa34,8,5,1,4,3,1,11,10,17,1,16,3,11,32,0,19,SPA
3f10bd22,28,21,15,11,2,16,24,8,23,5,18,29,57,62,0,19,SPA
3f79a1c8,49,28,11,35,3,19,46,27,37,2,35,21,70,21,0,19,SPA
3fc45c73,53,26,36,16,1,23,37,14,24,14,10,69,122,144,0,19,SPA
407feb71,9,7,5,4,0,3,8,5,2,0,2,0,9,0,0,19,SPA
418f8f61,60,38,25,31,4,18,73,55,40,4,36,43,103,30,1,19,SPA
41b3069f,51,31,33,18,0,23,38,15,55,31,24,55,106,170,0,19,SPA
41c12f75,24,17,11,8,5,10,18,8,25,2,23,10,34,22,0,19,SPA
42276181,14,9,4,6,4,1,6,5,12,2,10,5,19,3,0,19,SPA
4242011c,20,14,16,4,0,8,17,9,46,31,15,40,60,197,5,19,SPA
42dcf26d,49,35,33,14,2,25,35,10,34,24,10,37,86,177,2,19,SPA
43f71e77,12,9,1,4,7,2,15,13,22,0,22,7,19,26,1,19,SPA
4442fbcd,25,18,12,9,4,9,24,15,15,5,10,10,35,17,0,19,SPA
44e07fac,1,1,0,0,1,1,1,0,0,0,0,0,1,1,0,19,SPA
45af8a54,12,8,3,5,4,2,24,22,16,1,15,14,26,7,0,19,SPA
45e17712,29,12,10,14,5,11,22,11,23,2,21,20,49,38,0,19,SPA
45e304c8,6,6,4,2,0,1,3,2,4,0,4,0,6,2,1,19,SPA
4601e194,42,22,20,15,7,20,48,28,24,6,18,60,102,76,1,19,SPA
46166b49,1,1,0,1,0,0,3,3,1,0,1,0,1,0,0,19,SPA
467bae22,51,37,21,21,9,23,66,43,25,2,23,23,74,27,1,19,SPA
46e07328,1,1,1,0,0,0,3,3,0,0,0,2,3,1,0,19,SPA
4737cebe,11,8,5,2,4,3,13,10,7,0,7,6,17,6,0,19,SPA
474ecac8,25,15,22,3,0,15,19,4,21,12,9,20,45,77,0,19,SPA
487d9b09,14,8,9,4,1,2,12,10,15,4,11,5,19,30,2,19,SPA
48b3dd60,15,10,5,6,4,6,13,7,8,0,8,9,24,9,1,19,SPA
48e89655,21,15,8,10,3,8,16,8,15,0,15,2,23,8,0,19,SPA
4958bfb2,40,24,17,15,8,18,41,23,31,7,24,26,66,35,0,19,SPA
49ea92be,37,23,15,17,5,14,47,33,27,0,27,17,54,13,0,19,SPA
4a478107,21,15,6,10,5,8,49,41,22,1,21,12,33,17,0,19,SPA
4a537185,7,4,3,3,1,2,8,6,8,0,8,1,8,1,0,19,SPA
4a895384,47,23,32,12,3,26,47,21,38,25,13,39,86,163,3,19,SPA
4accb7e0,32,16,15,13,4,10,26,16,17,4,13,13,45,19,0,19,SPA
4acd733a,20,15,13,6,1,10,17,7,15,1,14,8,28,10,0,19,SPA
4b5e7e90,23,10,14,9,0,8,15,7,2,0,2,12,35,40,0,19,SPA
4b803b3c,12,9,8,2,2,3,6,3,6,0,6,7,19,16,0,19,SPA
4c2e9442,6,4,1,4,1,1,12,11,3,0,3,2,8,43,0,19,SPA
4c5b14d2,10,4,4,2,4,3,7,4,13,2,11,14,24,31,1,19,SPA
4cee5954,29,18,19,8,2,14,18,4,13,6,7,8,37,18,0,19,SPA
4d224fe8,86,52,44,35,7,38,94,56,52,12,40,41,127,56,3,19,SPA
4db76f57,49,34,27,17,5,15,28,13,18,6,12,37,86,49,1,19,SPA
4dbd0916,38,21,23,11,4,19,42,23,26,1,25,22,60,7,1,19,SPA
4f28a6ff,47,29,26,19,2,22,36,14,30,20,10,21,68,70,0,19,SPA
4ffb647d,15,9,12,3,0,6,11,5,4,3,1,22,37,48,0,19,SPA
5083a734,48,24,18,25,5,23,43,20,13,1,12,14,62,32,0,19,SPA
51c30111,18,13,7,9,2,5,11,6,11,7,4,11,29,11,1,19,SPA
51e3954c,47,32,34,13,0,21,30,9,16,7,9,30,77,73,2,19,SPA
525f9bf4,0,0,0,0,0,0,0,0,2,1,1,0,0,2,0,19,SPA
529f49ab,66,42,32,25,9,21,49,28,26,5,21,49,115,22,2,19,SPA
54073b28,30,21,14,13,3,6,24,18,14,2,12,14,44,14,0,19,SPA
545e2f01,25,13,21,4,0,10,15,5,12,6,6,18,43,58,1,19,SPA
549c6ba7,2,2,1,0,1,1,2,1,0,0,0,0,2,2,0,19,SPA
55126f3b,84,46,41,32,11,34,86,52,25,5,20,31,115,37,1,19,SPA
5512b1a9,0,0,0,0,0,0,0,0,0,0,0,1,1,1,0,19,SPA
555f3a0b,38,24,29,7,2,21,39,18,34,25,9,37,75,175,2,19,SPA
581c5276,1,1,1,0,0,1,3,2,0,0,0,0,1,8,1,19,SPA
5890cef1,9,8,2,5,2,6,7,1,1,0,1,7,16,17,1,19,SPA
58afe001,59,33,18,37,4,23,76,53,44,9,35,30,89,36,0,19,SPA
59b7d823,5,2,3,2,0,2,7,5,4,0,4,4,9,11,0,19,SPA
59d53e8a,51,28,25,16,10,23,41,18,15,1,14,21,72,47,4,19,SPA
59d93937,7,6,5,2,0,3,15,12,5,0,5,3,10,2,1,19,SPA
5a626448,42,28,15,25,2,11,46,35,27,3,24,28,70,27,0,19,SPA
5ab0ea87,90,60,35,45,10,41,89,48,43,8,35,54,144,22,1,19,SPA
5ae499d0,56,35,29,25,2,22,61,39,30,5,25,30,86,45,2,19,SPA
5b1bf5e3,12,7,5,5,2,2,10,8,4,1,3,9,21,9,0,19,SPA
5c4dc0ff,2,1,1,1,0,0,3,3,2,0,2,0,2,2,0,19,SPA
5c7845f6,61,35,32,24,5,22,54,32,30,6,24,45,106,60,0,19,SPA
5ca20b7a,36,27,23,10,3,15,32,17,19,3,16,38,74,72,0,19,SPA
5ce0b5ba,39,24,22,14,3,21,51,30,36,9,27,31,70,46,1,19,SPA
5ceba7fc,11,8,1,6,4,2,14,12,8,0,8,11,22,9,1,19,SPA
5d311e8d,16,9,12,4,0,9,17,8,34,19,15,31,47,73,0,19,SPA
5dcf3e90,0,0,0,0,0,0,1,1,0,0,0,1,1,1,1,19,SPA
5efb80d5,49,32,38,9,2,20,34,14,29,7,22,47,96,106,1,19,SPA
5f186f5c,5,3,0,5,0,0,1,1,0,0,0,1,6,0,0,19,SPA
5f3eaaf5,14,8,10,2,2,5,9,4,10,1,9,12,26,14,0,19,SPA
5fa714d5,4,3,0,3,1,3,4,1,0,0,0,1,5,2,0,19,SPA
6025fab1,49,30,11,25,13,14,48,34,20,3,17,31,80,7,1,19,SPA
603116a7,34,19,17,12,5,15,39,24,19,2,17,17,51,21,0,19,SPA
60359288,1,0,1,0,0,0,0,0,0,0,0,0,1,4,0,19,SPA
608f2092,1,1,1,0,0,0,0,0,0,0,0,0,1,0,0,19,SPA
61220da2,65,45,31,29,5,27,86,59,51,7,44,48,113,46,1,19,SPA
61bb7498,0,0,0,0,0,0,0,0,0,0,0,0,0,0,1,19,SPA
61bd33d0,13,8,6,6,1,8,25,17,8,0,8,5,18,4,0,19,SPA
625c144a,2,1,2,0,0,1,3,2,1,0,1,1,3,12,6,19,SPA
636eae97,51,32,24,18,9,20,47,27,15,0,15,12,63,10,0,19,SPA
63f04c6c,59,44,34,19,6,22,62,40,33,7,26,29,88,55,0,19,SPA
6434f10d,103,70,45,50,8,39,75,36,35,11,24,41,144,68,0,19,SPA
6435143e,3,2,0,2,1,2,4,2,3,0,3,1,4,0,0,19,SPA
64e8ed6d,9,4,1,6,2,5,16,11,10,1,9,5,14,5,0,19,SPA
65d62814,0,0,0,0,0,0,0,0,0,0,0,0,0,0,0,19,SPA
6763373d,0,0,0,0,0,0,1,1,0,0,0,1,1,0,0,19,SPA
67cdbc0e,78,44,32,37,9,30,69,39,46,5,41,29,107,23,1,19,SPA
6853490f,3,2,0,1,2,2,3,1,7,0,7,1,4,1,0,19,SPA
6922f806,20,13,3,11,6,1,24,23,34,7,27,7,27,53,0,19,SPA
697295b1,4,3,2,0,2,1,5,4,6,2,4,8,12,22,0,19,SPA
69cbc8b6,47,26,28,17,2,24,41,17,29,16,13,52,99,216,2,19,SPA
6a99e0b1,27,18,9,7,11,5,22,17,22,1,21,7,34,33,0,19,SPA
6b5ea2f4,1,1,1,0,0,0,2,2,1,0,1,2,3,0,0,19,SPA
6c811eb7,7,4,0,6,1,2,8,6,4,0,4,2,9,0,0,19,SPA
6cbf8d0d,1,1,1,0,0,1,1,0,0,0,0,0,1,0,0,19,SPA
6ce1f46f,51,35,18,24,9,14,57,43,25,4,21,14,65,13,1,19,SPA
6d8f8441,44,27,24,17,3,26,56,30,18,8,10,40,84,54,1,19,SPA
6dce77a5,2,2,1,1,0,1,1,0,0,0,0,6,8,2,0,19,SPA
6f51e382,0,0,0,0,0,0,3,3,0,0,0,2,2,5,2,19,SPA
6f5f82c0,16,9,10,5,1,8,13,5,5,1,4,4,20,20,1,19,SPA
6f7d826d,34,19,13,20,1,9,38,29,19,7,12,21,55,26,0,19,SPA
6fd1ba62,17,10,4,6,7,3,23,20,10,1,9,12,29,5,0,19,SPA
70438d35,16,10,11,4,1,9,16,7,9,4,5,12,28,46,1,19,SPA
70d74ece,24,11,2,11,11,2,17,15,16,1,15,8,32,25,0,19,SPA
7106f0a0,37,23,17,17,3,15,28,13,10,3,7,14,51,17,2,19,SPA
7111d552,10,6,3,6,1,3,16,13,6,1,5,7,17,1,0,19,SPA
71b47ab9,22,13,6,10,6,6,18,12,23,2,21,9,31,21,0,19,SPA
72a99e38,32,20,18,9,5,17,35,18,19,0,19,16,48,17,1,19,SPA
72b07a9c,51,38,35,15,1,22,48,26,31,18,13,46,97,173,2,19,SPA
72b92c4e,12,6,7,5,0,4,11,7,2,0,2,4,16,15,0,19,SPA
7329018e,66,40,14,44,8,14,34,20,21,1,20,37,103,27,0,19,SPA
73683fa9,0,0,0,0,0,0,0,0,0,0,0,2,2,9,3,19,SPA
7460ca0d,73,42,41,24,8,31,90,59,41,7,34,46,119,26,2,19,SPA
74e0a984,52,34,22,27,3,16,33,17,30,11,19,34,86,54,1,19,SPA
75645f0e,23,14,7,8,8,5,24,19,14,6,8,7,30,41,0,19,SPA
75751c99,0,0,0,0,0,0,1,1,0,0,0,2,2,10,0,19,SPA
7958dc65,19,13,6,11,2,5,22,17,9,1,8,5,24,5,0,19,SPA
7b309e55,7,5,4,3,0,5,8,3,6,1,5,6,13,10,0,19,SPA
7b456af7,0,0,0,0,0,0,1,1,0,0,0,0,0,9,6,19,SPA
7b5ab7f2,6,4,4,1,1,1,5,4,0,0,0,1,7,0,0,19,SPA
7c388b20,63,45,23,28,12,14,48,34,19,3,16,22,85,28,1,19,SPA
7c4243d4,46,27,16,22,8,15,38,23,16,0,16,14,60,12,4,19,SPA
7c689c48,0,0,0,0,0,0,0,0,1,0,1,1,1,1,0,19,SPA
7cefa219,14,9,12,2,0,7,22,15,22,2,20,17,31,41,0,19,SPA
7dcf86f6,16,11,4,8,4,4,20,16,14,0,14,16,32,5,0,19,SPA
7eb97a8e,0,0,0,0,0,0,0,0,0,0,0,0,0,0,0,19,SPA
7f203b54,27,19,16,9,2,13,19,6,19,11,8,19,46,83,0,19,SPA
7f4c7c9f,73,55,49,17,7,34,53,19,34,11,23,44,117,65,1,19,SPA
7f8fb807,3,2,0,1,2,0,2,2,1,0,1,2,5,3,0,19,SPA
808d48f3,33,21,26,5,2,20,33,13,12,3,9,21,54,61,0,19,SPA
808df563,6,5,1,4,1,3,7,4,1,0,1,4,10,3,0,19,SPA
81069528,48,31,22,16,10,21,44,23,19,7,12,22,70,68,0,19,SPA
81f0781e,22,12,2,15,5,8,27,19,23,9,14,9,31,39,0,19,SPA
82927de4,49,26,14,26,9,15,54,39,32,4,28,24,73,19,0,19,SPA
82e9b89d,21,15,3,13,5,3,19,16,17,2,15,8,29,32,0,19,SPA
833fb62e,19,10,7,10,2,4,11,7,12,1,11,9,28,3,0,19,SPA
84399660,21,12,7,11,3,8,22,14,12,0,12,16,37,13,0,19,SPA
8455ad90,2,0,1,1,0,1,3,2,0,0,0,1,3,0,0,19,SPA
84fb6aff,10,4,5,4,1,6,12,6,5,2,3,8,18,17,0,19,SPA
850c0a0d,31,24,25,5,1,17,27,10,12,5,7,46,77,92,2,19,SPA
857cb4f3,11,8,7,4,0,5,9,4,11,6,5,10,21,18,0,19,SPA
85dace26,1,0,0,1,0,0,1,1,3,0,3,0,1,2,0,19,SPA
8696bc90,20,13,6,8,6,3,10,7,16,0,16,6,26,10,0,19,SPA
873619c6,1,0,1,0,0,1,1,0,0,0,0,0,1,0,0,19,SPA
875898c7,17,11,15,2,0,12,17,5,17,11,6,11,28,58,3,19,SPA
87882adc,2,1,2,0,0,0,3,3,0,0,0,2,4,0,0,19,SPA
88050721,7,5,3,2,2,2,12,10,10,3,7,1,8,2,0,19,SPA
8875b8c9,0,0,0,0,0,0,0,0,0,0,0,0,0,4,0,19,SPA
88d91621,34,25,12,20,2,13,23,10,9,4,5,17,51,43,0,19,SPA
88f130ed,7,2,4,3,0,5,6,1,1,0,1,3,10,8,0,19,SPA
89151b16,38,23,31,6,1,16,28,12,19,8,11,31,69,94,2,19,SPA
896b5df2,1,0,0,1,0,0,0,0,0,0,0,1,2,0,0,19,SPA
8970907e,36,22,13,19,4,11,64,53,27,1,26,24,60,14,2,19,SPA
89cbc961,41,29,30,9,2,19,44,25,36,24,12,42,83,149,2,19,SPA
89f951b5,30,24,10,14,6,12,37,25,32,8,24,51,81,33,0,19,SPA
8b0b02c9,5,4,1,2,2,0,8,8,8,3,5,3,8,3,0,19,SPA
8b8a56ce,29,19,25,3,1,9,16,7,41,34,7,27,56,136,0,19,SPA
8c3c640c,36,20,15,15,6,12,49,37,54,3,51,14,50,26,0,19,SPA
8c44e37b,16,7,4,9,3,2,24,22,16,5,11,4,20,10,0,19,SPA
8cfc2f69,16,7,1,6,9,6,26,20,15,1,14,8,24,8,0,19,SPA
8d2ad5c0,5,5,3,2,0,3,11,8,8,0,8,1,6,2,0,19,SPA
8d957256,0,0,0,0,0,0,0,0,0,0,0,0,0,1,0,19,SPA
8db394aa,57,35,44,12,1,32,45,13,25,11,14,47,104,143,1,19,SPA
8e010ff4,26,16,6,15,5,9,29,20,14,0,14,17,43,9,0,19,SPA
8e088e04,6,4,4,1,1,1,5,4,9,3,6,6,12,13,0,19,SPA
8e48dc61,3,1,0,3,0,2,6,4,1,0,1,1,4,0,0,19,SPA
8ef81d2d,38,25,18,19,1,11,25,14,21,4,17,31,69,31,0,19,SPA
8f898ba8,25,14,4,12,9,6,19,13,12,1,11,8,33,25,0,19,SPA
8f8c6934,1,0,1,0,0,1,2,1,2,0,2,1,2,15,6,19,SPA
8fae77ea,1,1,1,0,0,0,0,0,1,0,1,1,2,3,3,19,SPA
9038c2a1,44,25,22,11,11,20,71,51,25,4,21,46,90,27,0,19,SPA
90bbd822,22,19,11,7,4,4,25,21,24,0,24,19,41,30,0,19,SPA
9109185e,0,0,0,0,0,0,2,2,0,0,0,0,0,11,2,19,SPA
9127f9ce,17,12,7,9,1,6,16,10,14,2,12,14,31,25,0,19,SPA
9260926b,27,20,9,15,3,2,9,7,7,4,3,11,38,24,0,19,SPA
92b4a127,37,26,28,7,2,17,27,10,31,11,20,33,70,102,1,19,SPA
92d38e6c,57,32,38,18,1,27,47,20,32,15,17,65,122,155,1,19,SPA
933e8c8a,25,17,17,6,2,15,30,15,20,9,11,25,50,88,2,19,SPA
942b4f90,18,16,3,11,4,2,12,10,18,0,18,11,29,2,0,19,SPA
958bba56,67,35,20,38,9,25,57,32,22,9,13,14,81,24,1,19,SPA
960fb42d,38,28,25,13,0,14,28,14,7,2,5,45,83,69,1,19,SPA
963829d0,46,35,18,23,5,20,57,37,17,6,11,16,62,17,0,19,SPA
967f34d3,1,0,1,0,0,1,2,1,1,0,1,2,3,13,2,19,SPA
9744ff80,30,15,6,15,9,6,47,41,30,3,27,22,52,20,0,19,SPA
97572117,32,24,20,10,2,12,17,5,7,2,5,20,52,35,0,19,SPA
97852360,0,0,0,0,0,0,1,1,0,0,0,1,1,23,0,19,SPA
978cd030,63,42,40,19,4,32,51,19,39,18,21,50,113,158,0,19,SPA
98554bfd,7,4,3,4,0,5,10,5,3,1,2,6,13,1,0,19,SPA
9970da54,0,0,0,0,0,0,0,0,0,0,0,0,0,4,1,19,SPA
999908af,46,30,23,19,4,12,36,24,37,9,28,16,62,19,2,19,SPA
99bebd12,4,1,0,3,1,0,4,4,4,0,4,1,5,6,0,19,SPA
9a64e67e,5,2,2,3,0,1,3,2,3,0,3,4,9,13,1,19,SPA
9ab48bde,32,19,17,8,7,12,32,20,18,0,18,13,45,20,0,19,SPA
9b337c7c,19,10,8,8,3,8,24,16,8,2,6,9,28,13,2,19,SPA
9ba48d64,20,12,13,5,2,9,16,7,9,4,5,19,39,37,0,19,SPA
9d2a3d5f,20,11,12,5,3,10,28,18,18,1,17,10,30,25,0,19,SPA
9e098912,2,2,2,0,0,0,1,1,0,0,0,0,2,3,0,19,SPA
9e1035f8,15,8,4,8,3,5,11,6,10,1,9,10,25,9,0,19,SPA
9f0ea33f,0,0,0,0,0,0,1,1,0,0,0,3,3,26,2,19,SPA
9f323c71,60,32,34,17,9,29,62,33,29,4,25,27,87,62,0,19,SPA
9f8e9423,33,18,25,7,1,15,19,4,21,9,12,32,65,141,1,19,SPA
a01c3d54,1,0,1,0,0,1,1,0,0,0,0,1,2,10,1,19,SPA
a0255c67,21,11,9,9,3,7,19,12,7,3,4,5,26,9,0,19,SPA
a03c82b2,22,14,15,5,2,7,10,3,11,5,6,31,53,79,0,19,SPA
a0b4bb3e,29,14,14,8,7,14,34,20,9,1,8,6,35,3,0,19,SPA
a10361d2,37,19,17,20,0,13,36,23,21,6,15,21,58,18,0,19,SPA
a190d597,4,1,0,4,0,1,8,7,5,0,5,2,6,6,0,19,SPA
a230ebcc,0,0,0,0,0,0,1,1,0,0,0,0,0,0,0,19,SPA
a25250f8,64,28,30,31,3,34,83,49,34,5,29,35,99,36,1,19,SPA
a2609621,18,10,9,5,4,6,10,4,19,13,6,26,44,112,1,19,SPA
a4971d84,54,34,43,11,0,26,43,17,27,11,16,74,128,154,3,19,SPA
a4b00319,61,39,36,23,2,34,59,25,22,1,21,19,80,52,1,19,SPA
a58bb1e1,16,8,5,7,4,6,20,14,19,3,16,11,27,13,0,19,SPA
a60823a4,5,3,5,0,0,3,7,4,8,3,5,8,13,7,0,19,SPA
a6154613,18,11,1,6,11,4,10,6,12,4,8,8,26,24,0,19,SPA
a685f013,5,3,4,1,0,3,6,3,6,2,4,7,12,21,0,19,SPA
a6951bf8,46,31,25,14,7,17,35,18,21,5,16,49,95,29,1,19,SPA
a6de370d,44,30,19,18,7,11,53,42,34,3,31,9,53,8,1,19,SPA
a7f00c8c,14,10,9,5,0,10,17,7,6,1,5,16,30,17,0,19,SPA
a8f21b9f,0,0,0,0,0,0,0,0,1,0,1,0,0,0,0,19,SPA
a8fbae1d,49,39,33,16,0,28,44,16,25,10,15,36,85,116,0,19,SPA
a9dc785c,2,0,2,0,0,2,3,1,0,0,0,1,3,9,3,19,SPA
aa0ac32d,12,5,7,5,0,4,7,3,7,7,0,13,25,34,0,19,SPA
aa386464,3,3,1,1,1,0,3,3,2,0,2,1,4,0,0,19,SPA
ac295d9e,0,0,0,0,0,0,0,0,0,0,0,2,2,11,3,19,SPA
ac3fb1be,20,17,15,3,2,9,18,9,30,23,7,16,36,140,0,19,SPA
ac454a4f,22,16,9,13,0,6,25,19,15,2,13,13,35,13,0,19,SPA
ad178594,23,14,20,3,0,13,21,8,20,9,11,20,43,60,1,19,SPA
ad1ffcfd,31,18,22,5,4,14,37,23,25,7,18,22,53,41,1,19,SPA
ad4d0985,45,30,21,17,7,14,67,53,17,2,15,25,70,25,0,19,SPA
ad6295d4,8,2,0,7,1,2,6,4,8,2,6,1,9,10,0,19,SPA
adfc9123,42,27,25,17,0,24,37,13,41,27,14,36,78,154,5,19,SPA
aec0fb6f,6,3,3,2,1,0,6,6,3,1,2,7,13,4,0,19,SPA
b037bd4f,47,24,14,25,8,19,59,40,18,1,17,24,71,11,0,19,SPA
b05e2dbd,83,59,56,20,7,46,80,34,48,6,42,43,126,105,1,19,SPA
b0616e3d,43,29,20,18,5,18,35,17,22,4,18,24,67,52,0,19,SPA
b0c71810,35,21,18,11,6,15,47,32,24,0,24,10,45,12,0,19,SPA
b0fce72c,50,32,27,15,8,20,82,62,42,4,38,39,89,26,0,19,SPA
b14d0c5d,48,29,33,12,3,18,34,16,21,8,13,41,89,57,0,19,SPA
b182a240,35,25,23,9,3,15,22,7,19,3,16,25,60,22,1,19,SPA
b18a3023,13,9,8,4,1,7,12,5,8,3,5,5,18,24,1,19,SPA
b19db005,23,15,4,13,6,6,18,12,13,0,13,5,28,4,0,19,SPA
b233e8e4,4,3,2,2,0,1,5,4,1,0,1,2,6,11,1,19,SPA
b2d0ec1b,3,2,1,1,1,1,2,1,2,0,2,0,3,1,0,19,SPA
b39a793e,5,2,0,4,1,1,3,2,3,0,3,0,5,5,0,19,SPA
b3dc6eca,28,19,20,6,2,13,18,5,28,16,12,38,66,67,1,19,SPA
b418dbd4,61,41,13,37,11,22,68,46,56,1,55,21,82,39,0,19,SPA
b5bdf144,1,1,1,0,0,1,2,1,1,0,1,1,2,15,2,19,SPA
b6b2b820,12,11,4,8,0,5,9,4,4,0,4,8,20,1,0,19,SPA
b6e50615,46,31,26,11,9,23,46,23,34,9,25,42,88,82,0,19,SPA
b742cc0d,86,55,55,26,5,41,76,35,46,21,25,60,146,132,2,19,SPA
b7c99b9b,47,34,37,10,0,24,33,9,42,19,23,53,100,232,0,19,SPA
b7ca5c51,29,16,20,6,3,14,28,14,37,21,16,70,99,162,1,19,SPA
b7f2edff,13,8,8,5,0,4,7,3,1,0,1,7,20,13,0,19,SPA
b86a64b2,16,9,14,1,1,8,16,8,9,7,2,17,33,45,0,19,SPA
b86fe156,14,7,6,7,1,5,12,7,12,3,9,8,22,6,0,19,SPA
b8a642fc,19,11,7,10,2,9,31,22,11,2,9,10,29,2,0,19,SPA
b8c1de25,8,4,2,5,1,1,15,14,10,4,6,5,13,12,0,19,SPA
b92b456a,7,5,2,1,4,2,6,4,7,0,7,1,8,3,0,19,SPA
ba5004e1,96,62,43,41,12,53,120,67,47,6,41,46,142,57,2,19,SPA
ba5a9545,2,1,0,2,0,0,5,5,2,0,2,2,4,0,0,19,SPA
ba71d071,32,23,23,9,0,15,23,8,21,18,3,36,68,120,0,19,SPA
bad38a94,67,31,33,26,8,31,58,27,41,12,29,53,120,94,1,19,SPA
baf5665c,0,0,0,0,0,0,3,3,1,0,1,1,1,2,0,19,SPA
bb4b1242,27,17,3,11,13,7,30,23,11,1,10,6,33,14,0,19,SPA
bba30585,26,15,16,8,2,17,29,12,27,15,12,26,52,83,2,19,SPA
bbfaeda4,7,5,3,3,1,4,4,0,3,2,1,1,8,7,0,19,SPA
bc39454c,0,0,0,0,0,0,0,0,0,0,0,0,0,0,0,19,SPA
bc6f5f06,49,38,33,12,4,18,28,10,30,20,10,40,89,135,1,19,SPA
bca21ef3,0,0,0,0,0,0,0,0,0,0,0,1,1,12,1,19,SPA
bdef8cdb,0,0,0,0,0,0,0,0,0,0,0,0,0,0,0,19,SPA
be170419,15,11,11,4,0,7,11,4,20,12,8,28,43,60,2,19,SPA
be3a0121,13,6,12,1,0,8,14,6,24,11,13,16,29,80,1,19,SPA
bf12926c,4,4,0,3,1,1,1,0,2,0,2,1,5,2,0,19,SPA
bf97c188,35,23,21,12,2,18,36,18,24,12,12,26,61,75,1,19,SPA
bfb15d99,0,0,0,0,0,0,0,0,0,0,0,0,0,0,0,19,SPA
c00097d2,41,29,33,6,2,24,48,24,52,36,16,51,92,129,2,19,SPA
c05dfb74,29,20,10,14,5,6,29,23,17,3,14,12,41,6,0,19,SPA
c0617e2b,32,21,9,16,7,11,31,20,26,1,25,15,47,6,0,19,SPA
c0b1a6da,0,0,0,0,0,0,0,0,0,0,0,0,0,2,0,19,SPA
c14bc029,83,56,35,41,7,32,81,49,57,10,47,42,125,86,1,19,SPA
c2111b45,6,5,4,2,0,5,6,1,4,4,0,7,13,12,0,19,SPA
c3ee18ef,35,25,20,14,1,17,20,3,17,9,8,14,49,49,0,19,SPA
c49afee6,5,1,1,2,2,0,2,2,2,0,2,3,8,1,0,19,SPA
c4b8bcf4,7,5,1,3,3,2,13,11,14,1,13,4,11,14,0,19,SPA
c4dce677,1,1,1,0,0,1,3,2,1,0,1,0,1,0,0,19,SPA
c67cd65c,28,18,19,8,1,16,26,10,25,21,4,21,49,98,0,19,SPA
c7429db3,2,2,1,1,0,0,1,1,3,0,3,0,2,0,0,19,SPA
c818c4d9,0,0,0,0,0,0,0,0,0,0,0,0,0,0,0,19,SPA
c8764028,4,3,2,2,0,2,2,0,1,0,1,0,4,1,0,19,SPA
c904f3d5,20,16,14,6,0,12,16,4,15,9,6,16,36,35,2,19,SPA
c90977db,44,21,14,16,14,9,42,33,17,0,17,19,63,4,0,19,SPA
c93231dc,33,19,15,16,2,6,14,8,14,1,13,11,44,25,1,19,SPA
c9cb972b,0,0,0,0,0,0,1,1,0,0,0,0,0,1,0,19,SPA
c9e39d91,61,31,23,29,9,14,53,39,32,3,29,24,85,24,0,19,SPA
cac2537b,70,43,30,34,6,28,87,59,35,3,32,31,101,36,1,19,SPA
cacadf4f,52,38,38,12,2,21,31,10,22,2,20,19,71,60,1,19,SPA
cb574619,73,41,41,27,5,27,52,25,44,13,31,50,123,135,1,19,SPA
ccaa5728,4,2,3,1,0,1,6,5,2,0,2,1,5,8,1,19,SPA
cce181df,47,33,18,23,6,12,27,15,20,7,13,27,74,22,2,19,SPA
cda0b317,1,0,1,0,0,1,1,0,0,0,0,0,1,5,1,19,SPA
cfd8d664,35,22,27,5,3,24,38,14,13,5,8,19,54,36,1,19,SPA
d04b94db,38,27,23,12,3,12,18,6,23,7,16,22,60,26,0,19,SPA
d080ed5e,50,28,19,25,6,14,52,38,37,2,35,29,79,37,1,19,SPA
d0d79694,6,4,3,3,0,3,7,4,4,2,2,6,12,21,0,19,SPA
d1491e00,13,8,6,4,3,2,11,9,3,0,3,4,17,7,0,19,SPA
d2110326,14,8,10,4,0,5,10,5,24,16,8,20,34,94,1,19,SPA
d2ac648c,7,3,2,4,1,3,6,3,2,0,2,3,10,4,0,19,SPA
d2be40f2,23,13,10,11,2,17,23,6,10,5,5,18,41,65,2,19,SPA
d2fa73e7,0,0,0,0,0,0,0,0,0,0,0,0,0,0,0,19,SPA
d3298c99,6,3,2,2,2,1,6,5,3,0,3,7,13,3,1,19,SPA
d4931a5a,6,4,2,4,0,1,3,2,1,0,1,2,8,2,0,19,SPA
d4c9725f,54,33,30,15,9,28,44,16,21,5,16,33,87,42,3,19,SPA
d4ef9ac5,17,13,12,3,2,10,21,11,20,5,15,14,31,42,0,19,SPA
d4f46475,7,4,4,3,0,3,4,1,4,4,0,7,14,17,1,19,SPA
d66b9872,7,4,2,2,3,4,7,3,10,0,10,4,11,2,0,19,SPA
d70a2141,54,31,34,19,1,24,42,18,31,10,21,43,97,133,1,19,SPA
d70a3661,0,0,0,0,0,0,2,2,0,0,0,1,1,2,0,19,SPA
d70ce98e,12,7,5,3,4,1,17,16,10,0,10,3,15,1,0,19,SPA
d717630e,15,6,4,10,1,5,11,6,9,1,8,10,25,6,2,19,SPA
d7553721,52,31,16,28,8,9,35,26,24,1,23,17,69,8,0,19,SPA
d79afcfc,16,6,9,5,2,4,12,8,15,0,15,6,22,3,0,19,SPA
d83bbc54,35,25,9,19,7,20,42,22,23,4,19,34,69,49,0,19,SPA
d83f09ff,21,14,11,9,1,6,14,8,9,2,7,12,33,17,0,19,SPA
d8712bf9,19,9,10,4,5,9,19,10,17,1,16,10,29,16,1,19,SPA
d87e2cae,5,3,1,3,1,2,7,5,11,5,6,1,6,27,0,19,SPA
d9764034,46,26,34,12,0,26,38,12,35,19,16,40,86,133,2,19,SPA
d9bda115,27,16,9,15,3,8,22,14,19,4,15,24,51,26,1,19,SPA
da27e268,71,45,36,26,9,28,70,42,43,21,22,36,107,60,3,19,SPA
db750822,17,13,8,6,3,6,19,13,8,1,7,10,27,6,0,19,SPA
db8f0eba,54,26,20,24,10,22,61,39,38,2,36,29,83,22,0,19,SPA
dbe519cf,35,21,16,15,4,18,42,24,21,8,13,18,53,31,0,19,SPA
ddd5348b,0,0,0,0,0,0,0,0,0,0,0,0,0,0,0,19,SPA
de7d40d6,55,30,40,13,2,28,46,18,27,6,21,35,90,63,1,19,SPA
debc6b55,5,3,0,3,2,0,3,3,8,1,7,5,10,4,0,19,SPA
dee86451,45,27,20,21,4,16,29,13,8,0,8,12,57,30,0,19,SPA
def69cd0,5,2,1,4,0,2,7,5,3,2,1,2,7,3,0,19,SPA
df69b544,31,19,8,13,10,8,28,20,18,1,17,12,43,21,0,19,SPA
df8b52a5,9,7,6,1,2,3,10,7,6,0,6,7,16,12,0,19,SPA
e1cbb531,30,19,10,17,3,9,32,23,15,1,14,26,56,18,1,19,SPA
e1cea3f7,13,10,8,3,2,6,27,21,14,3,11,5,18,13,0,19,SPA
e1deea75,35,18,23,11,1,12,20,8,19,12,7,31,66,104,1,19,SPA
e208bcc8,13,7,3,7,3,4,15,11,10,2,8,3,16,3,1,19,SPA
e29d1111,110,66,73,30,7,67,100,33,43,10,33,45,155,113,2,19,SPA
e2e9c250,69,34,32,26,11,24,69,45,35,6,29,28,97,17,1,19,SPA
e3993b65,3,3,2,0,1,0,4,4,2,0,2,1,4,1,0,19,SPA
e3fabb0a,13,6,5,6,2,5,16,11,9,0,9,7,20,7,0,19,SPA
e49ce451,61,39,31,28,2,28,45,17,32,11,21,37,98,53,2,19,SPA
e4b8c5b6,3,2,1,2,0,0,0,0,3,1,2,1,4,10,0,19,SPA
e4ed2628,66,36,33,25,8,32,58,26,18,3,15,44,110,47,0,19,SPA
e54bd0a2,64,41,23,36,5,18,46,28,15,4,11,41,105,43,1,19,SPA
e6bc67d7,31,13,16,12,3,14,43,29,15,0,15,7,38,1,0,19,SPA
e7ab4179,22,13,19,3,0,12,29,17,29,14,15,29,51,69,0,19,SPA
e7f4603c,39,27,17,15,7,22,44,22,23,2,21,38,77,17,0,19,SPA
e82d2807,3,1,1,1,1,1,3,2,1,0,1,0,3,0,0,19,SPA
e897d8ba,7,4,1,2,4,1,5,4,18,0,18,4,11,6,0,19,SPA
e98f3a6a,0,0,0,0,0,0,2,2,0,0,0,2,2,5,0,19,SPA
e9fbcc21,0,0,0,0,0,0,0,0,0,0,0,0,0,0,0,19,SPA
ea6a7ab4,6,5,1,2,3,1,5,4,1,0,1,1,7,0,0,19,SPA
eb2fe5b6,0,0,0,0,0,0,6,6,3,0,3,0,0,1,0,19,SPA
ecada4fc,0,0,0,0,0,0,0,0,0,0,0,1,1,5,0,19,SPA
ecd8c01e,51,33,26,16,9,23,81,58,29,0,29,21,72,19,1,19,SPA
ed239245,14,10,6,7,1,6,23,17,22,7,15,15,29,48,1,19,SPA
ed5c5fa3,23,17,8,12,3,13,31,18,19,2,17,19,42,15,1,19,SPA
ee8508c0,1,0,1,0,0,1,1,0,0,0,0,1,2,13,1,19,SPA
ee923664,6,5,5,0,1,4,7,3,8,3,5,2,8,9,0,19,SPA
ef322658,24,15,9,12,3,11,47,36,27,1,26,28,52,28,1,19,SPA
f03f284b,27,18,15,10,2,10,22,12,18,12,6,28,55,65,2,19,SPA
f090a37a,3,3,0,2,1,2,3,1,0,0,0,0,3,1,0,19,SPA
f0da930c,26,15,20,6,0,13,26,13,27,14,13,44,70,128,2,19,SPA
f11fe861,23,10,14,8,1,9,18,9,13,6,7,22,45,110,0,19,SPA
f1887f53,3,1,1,2,0,2,3,1,0,0,0,3,6,1,0,19,SPA
f1bed920,21,11,14,6,1,9,17,8,13,3,10,8,29,15,0,19,SPA
f2308b33,51,38,30,17,4,23,52,29,23,2,21,29,80,86,0,19,SPA
f2a68b97,28,15,18,8,2,19,33,14,12,2,10,23,51,36,0,19,SPA
f3112790,41,31,25,14,2,17,33,16,31,13,18,53,94,110,2,19,SPA
f3b1d9a2,20,13,7,11,2,6,27,21,17,0,17,10,30,12,0,19,SPA
f4b7f2ec,0,0,0,0,0,0,0,0,0,0,0,0,0,0,0,19,SPA
f4ec4fd0,3,2,0,1,2,0,1,1,1,0,1,1,4,4,0,19,SPA
f6798fc3,0,0,0,0,0,0,2,2,0,0,0,1,1,7,2,19,SPA
f69d934e,15,8,10,4,1,9,15,6,6,1,5,6,21,24,1,19,SPA
f6ac68c1,11,10,9,2,0,7,12,5,13,9,4,22,33,67,0,19,SPA
f7dc2ae5,47,29,31,14,2,26,41,15,23,7,16,39,86,150,0,19,SPA
f8eca1b6,17,10,3,4,10,4,24,20,17,4,13,2,19,18,0,19,SPA
fa937f7a,71,50,32,35,4,20,70,50,26,5,21,28,99,28,0,19,SPA
fb5d47b3,62,43,39,17,6,29,49,20,48,11,37,42,104,91,0,19,SPA
fbd6378b,52,34,27,20,5,12,29,17,39,23,16,41,93,71,2,19,SPA
fc4f85b1,52,30,33,19,0,20,42,22,22,9,13,45,97,141,2,19,SPA
fc647b34,57,41,21,25,11,8,33,25,24,2,22,18,75,15,0,19,SPA
fc70e345,0,0,0,0,0,0,1,1,0,0,0,0,0,8,1,19,SPA
fc8b614b,13,10,4,5,4,4,25,21,7,1,6,4,17,6,0,19,SPA
fd47b4f2,8,5,5,3,0,5,7,2,9,7,2,7,15,30,0,19,SPA
fd51b456,43,26,11,21,11,15,41,26,16,1,15,12,55,11,0,19,SPA
fd771f95,5,3,0,0,5,0,4,4,9,0,9,3,8,4,0,19,SPA
fd9c4805,4,3,4,0,0,0,9,9,5,0,5,3,7,3,0,19,SPA
fdd60087,48,32,31,16,1,20,31,11,14,2,12,34,82,43,0,19,SPA
fed17f5a,41,28,15,23,3,16,65,49,46,6,40,19,60,37,0,19,SPA
ffad706e,63,40,37,22,4,28,60,32,27,5,22,40,103,90,0,19,SPA
005ca692,7,2,3,4,0,3,18,15,5,1,4,9,16,7,2,19,CL
00672021,4,1,2,2,0,1,2,1,5,2,3,1,5,0,1,19,CL
0174ba21,0,0,0,0,0,0,0,0,0,0,0,0,0,0,0,19,CL
0193a8bf,7,1,2,3,2,0,4,4,1,0,1,3,10,4,0,19,CL
01a49bd2,1,1,1,0,0,0,0,0,0,0,0,0,1,0,0,19,CL
01b8a2b2,0,0,0,0,0,0,1,1,0,0,0,0,0,6,0,19,CL
01c3aff5,7,4,4,3,0,3,8,5,6,2,4,13,20,6,0,19,CL
01e5f06e,0,0,0,0,0,0,0,0,0,0,0,0,0,0,0,19,CL
01eb744d,10,6,3,4,3,2,8,6,5,0,5,6,16,2,0,19,CL
02c15616,4,4,1,3,0,3,6,3,0,0,0,1,5,1,0,19,CL
032f894e,1,0,0,1,0,0,1,1,0,0,0,1,2,1,1,19,CL
0331786b,0,0,0,0,0,0,0,0,1,0,1,1,1,5,0,19,CL
0375723e,0,0,0,0,0,0,0,0,0,0,0,0,0,0,0,19,CL
03bd0bf4,8,2,3,5,0,5,5,0,7,7,0,5,13,23,0,19,CL
03df04ff,0,0,0,0,0,0,1,1,0,0,0,1,1,3,0,19,CL
042d286e,4,3,2,1,1,0,4,4,4,0,4,0,4,3,0,19,CL
042e8a49,1,1,1,0,0,1,5,4,2,0,2,1,2,0,0,19,CL
048a1cbc,5,3,3,2,0,1,1,0,4,0,4,7,12,1,0,19,CL
04ac8285,0,0,0,0,0,0,0,0,0,0,0,0,0,0,0,19,CL
0534149c,0,0,0,0,0,0,1,1,0,0,0,0,0,0,0,19,CL
05439de2,9,6,1,7,1,4,13,9,8,3,5,16,25,23,1,19,CL
05a84d52,8,6,2,3,3,2,3,1,10,2,8,2,10,7,0,19,CL
05d548d8,22,16,12,8,2,8,13,5,5,2,3,11,33,22,1,19,CL
061e8e23,2,2,0,1,1,1,1,0,1,0,1,2,4,0,0,19,CL
06df8256,2,2,2,0,0,2,2,0,4,2,2,0,2,10,1,19,CL
075fe5a3,1,1,1,0,0,1,3,2,2,0,2,5,6,11,1,19,CL
07750704,3,2,1,2,0,2,5,3,3,0,3,4,7,4,0,19,CL
07ab6542,1,1,0,1,0,0,0,0,1,0,1,2,3,0,0,19,CL
08511d65,10,8,10,0,0,7,9,2,3,1,2,13,23,13,0,19,CL
089550f5,8,5,4,4,0,1,3,2,6,2,4,8,16,18,2,19,CL
08aa17d0,3,2,1,1,1,2,3,1,2,1,1,8,11,7,0,19,CL
09586899,2,0,1,1,0,2,11,9,2,0,2,2,4,0,0,19,CL
0959c2a2,5,5,3,2,0,4,8,4,3,0,3,5,10,2,0,19,CL
099b9c78,0,0,0,0,0,0,0,0,0,0,0,0,0,0,0,19,CL
0a6dbbf7,8,2,8,0,0,1,2,1,13,6,7,6,14,34,0,19,CL
0a89e877,4,3,1,2,1,1,3,2,6,0,6,4,8,3,0,19,CL
0ab1f153,10,6,5,2,3,4,10,6,1,0,1,3,13,1,0,19,CL
0ac94a23,3,1,0,3,0,1,6,5,2,0,2,2,5,0,1,19,CL
0acf0e1c,3,2,1,1,1,0,3,3,1,0,1,1,4,0,0,19,CL
0aeeed3f,8,4,2,5,1,4,7,3,3,0,3,6,14,4,0,19,CL
0b4f388a,4,2,0,4,0,0,4,4,5,0,5,1,5,0,0,19,CL
0b5a292a,8,7,3,5,0,3,8,5,9,1,8,7,15,23,2,19,CL
0b90bb97,1,1,1,0,0,0,4,4,2,0,2,0,1,2,0,19,CL
0c2ac3cb,2,2,0,1,1,1,1,0,2,0,2,0,2,0,0,19,CL
0d10333c,6,4,2,4,0,1,4,3,0,0,0,8,14,1,0,19,CL
0d267745,9,4,4,5,0,7,9,2,4,3,1,6,15,25,1,19,CL
0d82903c,16,8,12,2,2,8,14,6,10,4,6,11,27,19,0,19,CL
0e100630,16,10,12,4,0,9,11,2,9,2,7,1,17,7,1,19,CL
0e21fc3c,2,1,1,0,1,2,7,5,1,0,1,2,4,0,0,19,CL
0e61c46b,1,0,1,0,0,0,1,1,0,0,0,0,1,1,0,19,CL
0e6bc38c,1,1,1,0,0,0,0,0,0,0,0,0,1,0,0,19,CL
0ef89a37,6,3,1,3,2,5,15,10,10,1,9,10,16,1,0,19,CL
0f5e0b8a,7,5,3,4,0,4,9,5,6,1,5,2,9,10,0,19,CL
0f888175,3,1,1,1,1,2,2,0,0,0,0,2,5,2,0,19,CL
101da2b5,13,9,3,9,1,3,9,6,11,7,4,19,32,17,1,19,CL
106bca06,4,1,2,2,0,3,7,4,4,0,4,5,9,3,0,19,CL
111c3236,2,1,1,1,0,1,6,5,4,1,3,5,7,4,1,19,CL
116c35df,5,1,2,1,2,0,1,1,2,0,2,0,5,3,0,19,CL
119b9a8e,12,9,7,4,1,4,8,4,4,3,1,16,28,37,3,19,CL
11b9265b,1,0,1,0,0,0,0,0,0,0,0,0,1,0,0,19,CL
11fd2b75,4,3,0,3,1,1,4,3,6,1,5,2,6,4,0,19,CL
129af0db,1,1,1,0,0,0,0,0,3,0,3,1,2,0,0,19,CL
12c50af5,0,0,0,0,0,0,0,0,0,0,0,0,0,0,0,19,CL
12e6d21a,6,1,3,1,2,1,1,0,1,0,1,0,6,1,0,19,CL
13ac19de,8,6,3,3,2,1,3,2,5,1,4,2,10,1,0,19,CL
13c44fc5,0,0,0,0,0,0,0,0,0,0,0,0,0,2,0,19,CL
1432d037,1,1,0,1,0,1,1,0,1,0,1,0,1,0,0,19,CL
1453e3cf,0,0,0,0,0,0,0,0,0,0,0,0,0,0,0,19,CL
1467af0d,25,16,8,12,5,9,20,11,10,3,7,5,30,5,0,19,CL
149895bf,7,4,3,4,0,0,1,1,6,0,6,0,7,1,0,19,CL
14b8fcdf,2,1,1,1,0,1,2,1,5,4,1,6,8,11,1,19,CL
14e8e9d7,1,1,1,0,0,0,0,0,0,0,0,0,1,3,0,19,CL
15eb04ec,9,8,3,5,1,3,16,13,6,2,4,7,16,7,0,19,CL
163bbd4a,3,2,1,2,0,0,2,2,2,0,2,1,4,3,0,19,CL
16657b95,16,8,3,11,2,4,15,11,11,2,9,7,23,6,0,19,CL
16b9d5cf,2,2,1,1,0,1,2,1,3,2,1,5,7,23,0,19,CL
1840e36d,0,0,0,0,0,0,0,0,0,0,0,0,0,2,1,19,CL
1880614f,2,2,2,0,0,0,2,2,3,0,3,3,5,0,0,19,CL
19053e31,2,0,0,2,0,1,5,4,2,0,2,1,3,0,0,19,CL
1971591f,0,0,0,0,0,0,0,0,1,0,1,0,0,0,0,19,CL
19cda00b,6,4,4,2,0,2,11,9,5,1,4,6,12,6,1,19,CL
19e4dca5,11,9,6,5,0,1,3,2,7,4,3,9,20,28,0,19,CL
19e4eab9,11,8,9,1,1,5,12,7,9,6,3,10,21,25,0,19,CL
1a2935f6,3,3,2,1,0,3,3,0,2,1,1,1,4,11,0,19,CL
1a6b7ea4,16,8,11,5,0,5,13,8,7,3,4,9,25,16,0,19,CL
1a6f2a66,0,0,0,0,0,0,1,1,0,0,0,1,1,0,0,19,CL
1a992676,4,4,1,1,2,1,5,4,1,0,1,1,5,1,0,19,CL
1adcf39e,10,5,7,3,0,4,7,3,6,1,5,13,23,15,1,19,CL
1b7ec703,0,0,0,0,0,0,0,0,1,1,0,1,1,0,0,19,CL
1bacc518,27,16,14,11,2,12,30,18,12,3,9,19,46,22,2,19,CL
1bebde9d,0,0,0,0,0,0,0,0,0,0,0,0,0,1,0,19,CL
1bf33a9a,6,5,2,3,1,1,6,5,4,0,4,3,9,3,0,19,CL
1d1691ad,5,5,5,0,0,4,4,0,3,2,1,1,6,2,0,19,CL
1d8e9add,4,1,4,0,0,4,5,1,6,4,2,3,7,15,1,19,CL
1ddbb0da,0,0,0,0,0,0,1,1,0,0,0,1,1,7,0,19,CL
1e26e376,0,0,0,0,0,0,0,0,0,0,0,0,0,2,0,19,CL
1e43fad8,0,0,0,0,0,0,1,1,0,0,0,0,0,1,2,19,CL
1f9328da,3,0,0,3,0,0,4,4,2,0,2,1,4,2,0,19,CL
1fb1c435,1,0,0,1,0,0,3,3,1,0,1,1,2,2,0,19,CL
21512407,17,10,11,5,1,8,15,7,7,1,6,11,28,11,1,19,CL
21a66f6a,9,6,0,7,2,1,3,2,4,1,3,2,11,7,0,19,CL
2319ebe3,7,5,4,3,0,1,5,4,6,2,4,6,13,9,0,19,CL
2327c29e,3,2,1,1,1,0,0,0,2,0,2,0,3,2,0,19,CL
2475dcc6,12,7,3,4,5,2,16,14,15,1,14,6,18,6,0,19,CL
24b98f95,1,1,1,0,0,0,1,1,0,0,0,2,3,1,0,19,CL
24fc70d3,7,3,6,1,0,5,6,1,7,6,1,10,17,17,0,19,CL
2696b6a9,1,1,1,0,0,0,1,1,0,0,0,0,1,1,0,19,CL
2784f898,23,14,15,7,1,11,16,5,10,4,6,17,40,43,1,19,CL
27f0fcda,0,0,0,0,0,0,1,1,2,0,2,1,1,3,0,19,CL
28b1f3ce,20,13,7,9,4,6,15,9,10,0,10,5,25,5,1,19,CL
28eea0fc,11,5,8,2,1,2,11,9,14,4,10,13,24,21,0,19,CL
292a652a,5,3,5,0,0,3,4,1,9,5,4,13,18,14,1,19,CL
2946f9a1,11,8,9,2,0,7,12,5,7,2,5,12,23,13,0,19,CL
29733c72,4,2,2,0,2,2,6,4,2,0,2,0,4,4,0,19,CL
2973d8ff,3,2,0,2,1,0,1,1,3,0,3,1,4,1,0,19,CL
29c02c9f,1,1,1,0,0,0,0,0,0,0,0,0,1,0,0,19,CL
2a8683b9,9,6,5,4,0,4,7,3,8,5,3,6,15,7,0,19,CL
2acd49b9,20,16,11,8,1,7,15,8,2,1,1,10,30,5,0,19,CL
2b114be3,6,5,0,4,2,1,6,5,3,1,2,2,8,2,0,19,CL
2b5527c4,4,1,2,2,0,2,5,3,0,0,0,0,4,4,0,19,CL
2b622f01,12,7,3,6,3,4,7,3,8,0,8,7,19,1,0,19,CL
2b8360f1,2,2,1,1,0,2,3,1,0,0,0,0,2,2,0,19,CL
2bcc6d52,0,0,0,0,0,0,2,2,2,0,2,0,0,0,0,19,CL
2c0f8e9e,3,3,1,1,1,0,2,2,5,2,3,1,4,0,0,19,CL
2c20f2fb,0,0,0,0,0,0,1,1,2,2,0,0,0,4,0,19,CL
2c44a35d,3,2,2,0,1,1,3,2,2,0,2,4,7,4,0,19,CL
2d24d7a2,0,0,0,0,0,0,0,0,0,0,0,0,0,0,0,19,CL
2d3f7367,0,0,0,0,0,0,0,0,0,0,0,0,0,0,0,19,CL
2d61d13a,17,9,7,10,0,7,10,3,3,2,1,13,30,12,1,19,CL
2db2fd7b,7,5,1,4,2,4,5,1,4,3,1,10,17,17,0,19,CL
2e06f387,1,0,0,1,0,1,3,2,1,1,0,1,2,6,0,19,CL
2e4f5f03,30,14,18,9,3,19,28,9,13,2,11,7,37,25,1,19,CL
2e7ff968,0,0,0,0,0,0,0,0,0,0,0,0,0,0,0,19,CL
2f3452eb,4,3,3,1,0,2,3,1,0,0,0,1,5,4,0,19,CL
2f557579,1,1,0,0,1,0,4,4,1,0,1,1,2,0,0,19,CL
2f7acede,16,8,1,13,2,8,11,3,8,3,5,7,23,6,1,19,CL
2f895007,0,0,0,0,0,0,1,1,0,0,0,0,0,0,0,19,CL
2f90f6b8,24,14,9,11,4,14,24,10,15,1,14,9,33,13,0,19,CL
2f965a72,0,0,0,0,0,0,0,0,0,0,0,0,0,2,0,19,CL
30223b33,0,0,0,0,0,0,0,0,0,0,0,0,0,0,0,19,CL
30941e96,7,4,4,2,1,5,9,4,11,7,4,10,17,26,0,19,CL
30f5ffa9,24,18,19,5,0,14,22,8,3,2,1,2,26,25,0,19,CL
314f2124,3,2,3,0,0,0,0,0,2,1,1,3,6,7,0,19,CL
3189f61a,18,8,8,9,1,5,13,8,4,2,2,5,23,8,0,19,CL
31c69ef1,7,6,3,4,0,4,5,1,4,3,1,8,15,17,1,19,CL
321f83a2,0,0,0,0,0,0,1,1,3,0,3,1,1,1,0,19,CL
32c0491f,10,7,7,3,0,5,6,1,3,1,2,4,14,9,0,19,CL
3353737a,7,6,4,3,0,5,7,2,4,2,2,10,17,8,0,19,CL
335fa267,14,9,8,5,1,7,10,3,4,0,4,12,26,13,0,19,CL
33b8d077,17,7,12,5,0,2,12,10,10,2,8,9,26,6,0,19,CL
346d51d9,10,6,3,6,1,5,7,2,2,0,2,3,13,3,0,19,CL
34c3b935,0,0,0,0,0,0,0,0,0,0,0,0,0,2,0,19,CL
34e38ddf,0,0,0,0,0,0,0,0,0,0,0,0,0,2,0,19,CL
356c9002,0,0,0,0,0,0,2,2,3,0,3,0,0,4,0,19,CL
3626daea,1,1,0,0,1,0,0,0,1,0,1,0,1,0,0,19,CL
36a3ff67,16,8,3,8,5,3,7,4,8,1,7,11,27,7,0,19,CL
3708e9fa,6,6,4,2,0,0,0,0,1,0,1,4,10,1,0,19,CL
375622c5,0,0,0,0,0,0,1,1,0,0,0,0,0,0,0,19,CL
37f606f0,1,0,0,1,0,1,1,0,2,0,2,0,1,0,0,19,CL
38ac43d3,0,0,0,0,0,0,2,2,1,0,1,0,0,1,0,19,CL
392a7aea,16,9,5,9,2,2,14,12,3,0,3,4,20,4,0,19,CL
39769cff,0,0,0,0,0,0,0,0,0,0,0,0,0,0,0,19,CL
3984a078,2,2,0,2,0,2,2,0,1,0,1,1,3,1,0,19,CL
3b15ef2d,2,2,2,0,0,1,1,0,0,0,0,2,4,2,0,19,CL
3b61c9ec,3,3,2,1,0,1,1,0,0,0,0,0,3,1,0,19,CL
3b8674e6,15,11,8,6,1,2,9,7,10,2,8,9,24,7,1,19,CL
3b9858f5,3,2,3,0,0,1,4,3,3,2,1,12,15,21,0,19,CL
3bb7b8b4,0,0,0,0,0,0,0,0,0,0,0,2,2,1,1,19,CL
3bb7f478,2,1,1,0,1,0,3,3,2,0,2,0,2,8,0,19,CL
3c6089ab,9,6,2,6,1,0,6,6,9,1,8,5,14,3,0,19,CL
3cefcaef,7,5,5,1,1,3,6,3,4,1,3,9,16,18,0,19,CL
3d50bcdb,0,0,0,0,0,0,0,0,0,0,0,0,0,0,0,19,CL
3e96f3e7,0,0,0,0,0,0,1,1,0,0,0,0,0,11,1,19,CL
3eb22ec9,15,6,5,7,3,4,14,10,4,1,3,8,23,2,0,19,CL
3eed9821,1,1,0,1,0,0,0,0,2,1,1,0,1,0,0,19,CL
3ef0fa48,0,0,0,0,0,0,0,0,1,0,1,0,0,1,0,19,CL
3f65d5ce,0,0,0,0,0,0,0,0,0,0,0,0,0,1,0,19,CL
41df88b8,0,0,0,0,0,0,0,0,0,0,0,0,0,0,0,19,CL
41f32541,8,6,1,5,2,3,6,3,4,2,2,6,14,8,0,19,CL
42276181,0,0,0,0,0,0,0,0,0,0,0,1,1,0,0,19,CL
42ec696a,0,0,0,0,0,0,0,0,0,0,0,0,0,0,1,19,CL
42fd9c7f,1,0,0,1,0,0,3,3,0,0,0,1,2,0,0,19,CL
433dc9a2,12,8,5,7,0,3,8,5,4,1,3,10,22,24,0,19,CL
436a9dd0,7,2,3,2,2,0,3,3,4,1,3,2,9,3,0,19,CL
43a166b4,0,0,0,0,0,0,1,1,1,0,1,1,1,0,0,19,CL
43b78598,2,1,1,1,0,0,0,0,2,0,2,2,4,9,0,19,CL
43cd8b69,0,0,0,0,0,0,0,0,0,0,0,2,2,2,0,19,CL
44781702,8,4,5,2,1,4,10,6,11,3,8,10,18,20,0,19,CL
44ac04e9,15,8,6,8,1,5,17,12,7,2,5,4,19,7,0,19,CL
44eb9093,11,6,6,5,0,3,9,6,1,0,1,6,17,4,0,19,CL
4515f00d,2,1,2,0,0,2,2,0,1,0,1,1,3,0,0,19,CL
45af8a54,2,2,1,1,0,0,2,2,0,0,0,5,7,1,0,19,CL
4601e194,11,8,6,4,1,5,13,8,11,5,6,17,28,30,2,19,CL
46a8347f,1,0,1,0,0,1,1,0,0,0,0,3,4,5,0,19,CL
47064058,0,0,0,0,0,0,1,1,0,0,0,0,0,2,0,19,CL
47af88b8,9,7,8,1,0,5,6,1,17,8,9,11,20,37,1,19,CL
47fd5136,1,1,0,1,0,0,1,1,6,5,1,6,7,16,0,19,CL
481c9ece,9,5,8,1,0,5,12,7,13,7,6,8,17,37,0,19,CL
4887118d,0,0,0,0,0,0,1,1,1,0,1,1,1,0,0,19,CL
48a2b92a,3,1,1,2,0,1,1,0,0,0,0,0,3,1,0,19,CL
48b28bfd,2,0,1,1,0,0,2,2,2,0,2,3,5,1,1,19,CL
48b3dd60,12,11,2,7,3,3,6,3,4,2,2,2,14,3,1,19,CL
49296448,11,6,7,2,2,4,9,5,9,2,7,12,23,8,0,19,CL
493924a7,20,12,16,4,0,9,16,7,7,2,5,3,23,9,0,19,CL
4958bfb2,9,6,5,4,0,3,6,3,4,3,1,8,17,10,2,19,CL
497228f9,11,6,8,3,0,5,7,2,4,0,4,10,21,13,0,19,CL
4a5a45c7,7,4,2,5,0,1,11,10,8,0,8,5,12,4,0,19,CL
4a6914ff,0,0,0,0,0,0,1,1,0,0,0,0,0,0,0,19,CL
4b6960d2,7,3,1,4,2,2,4,2,6,1,5,5,12,10,0,19,CL
4b803b3c,3,3,3,0,0,1,1,0,1,0,1,10,13,17,0,19,CL
4bd414c1,2,1,1,1,0,0,0,0,5,5,0,8,10,29,0,19,CL
4c370d81,12,8,2,6,4,3,16,13,11,0,11,2,14,3,1,19,CL
4c3a6744,8,6,2,3,3,4,5,1,4,1,3,2,10,2,0,19,CL
4c45cdc2,0,0,0,0,0,0,2,2,1,0,1,1,1,2,0,19,CL
4c5b714f,13,7,4,9,0,3,6,3,5,0,5,3,16,3,0,19,CL
4c6facae,12,6,5,6,1,4,8,4,7,2,5,9,21,10,0,19,CL
4cc82fe1,13,10,10,1,2,6,8,2,8,4,4,12,25,47,0,19,CL
4d034881,4,3,0,2,2,0,6,6,2,0,2,2,6,1,0,19,CL
4d224fe8,14,9,8,5,1,5,14,9,15,6,9,13,27,8,0,19,CL
4d3e9033,0,0,0,0,0,0,1,1,0,0,0,0,0,0,0,19,CL
4d982baf,3,3,2,0,1,2,4,2,4,1,3,1,4,1,0,19,CL
4dbd0916,8,4,1,7,0,2,7,5,6,1,5,3,11,4,0,19,CL
4dbdf7f7,7,3,3,3,1,4,8,4,4,1,3,4,11,6,0,19,CL
4dedd469,5,4,3,2,0,2,4,2,5,4,1,6,11,26,1,19,CL
4e133a88,1,1,1,0,0,0,0,0,6,1,5,1,2,4,0,19,CL
4e204552,2,1,0,2,0,0,3,3,0,0,0,3,5,1,0,19,CL
4e358a2d,9,7,6,2,1,4,8,4,10,8,2,8,17,26,1,19,CL
4f1e6a0b,10,7,1,6,3,5,14,9,13,0,13,3,13,3,0,19,CL
4f28a6ff,28,19,16,12,0,13,19,6,17,11,6,8,36,40,1,19,CL
4fa7cb9b,1,1,1,0,0,0,1,1,3,0,3,1,2,2,0,19,CL
5042e5c2,0,0,0,0,0,0,2,2,0,0,0,2,2,0,0,19,CL
5064d4c1,4,2,2,0,2,1,2,1,1,0,1,1,5,5,0,19,CL
509a4ccb,1,0,1,0,0,0,0,0,0,0,0,0,1,0,0,19,CL
50c1ff86,7,3,6,1,0,3,4,1,6,1,5,11,18,14,0,19,CL
50ccf47d,10,8,3,5,2,4,11,7,4,1,3,13,23,23,0,19,CL
50dc94ce,26,17,4,17,5,8,16,8,14,1,13,14,40,8,0,19,CL
5148dcc5,1,1,0,1,0,1,2,1,4,0,4,2,3,1,0,19,CL
51a3c4c8,13,8,10,2,1,7,11,4,9,6,3,21,34,61,0,19,CL
51a56075,0,0,0,0,0,0,0,0,3,1,2,2,2,1,0,19,CL
51cf8561,8,7,2,4,2,3,6,3,6,1,5,11,19,9,0,19,CL
51dbeea9,10,7,6,4,0,4,12,8,7,2,5,5,15,13,1,19,CL
526541e5,1,1,1,0,0,0,2,2,6,2,4,2,3,25,0,19,CL
5271c8f1,6,5,3,2,1,3,5,2,0,0,0,1,7,1,0,19,CL
527f063d,0,0,0,0,0,0,2,2,3,0,3,4,4,4,0,19,CL
529f49ab,8,6,2,3,3,2,9,7,5,3,2,11,19,5,0,19,CL
52ec54d0,7,5,4,2,1,2,5,3,11,9,2,12,19,27,0,19,CL
532d2690,3,2,2,1,0,2,9,7,3,2,1,7,10,6,0,19,CL
53e07d0b,3,1,1,1,1,0,1,1,2,1,1,0,3,1,0,19,CL
549c6ba7,1,1,0,0,1,1,1,0,0,0,0,0,1,1,0,19,CL
54b4dc4e,7,4,3,4,0,0,10,10,7,1,6,4,11,2,0,19,CL
54e4866f,1,0,1,0,0,0,1,1,0,0,0,0,1,0,0,19,CL
54f2d108,2,1,2,0,0,1,3,2,1,0,1,0,2,1,0,19,CL
55126f3b,14,6,6,7,1,8,22,14,4,0,4,7,21,9,0,19,CL
555d5edd,3,1,3,0,0,1,2,1,0,0,0,1,4,0,0,19,CL
55abe554,15,12,9,3,3,6,10,4,2,0,2,3,18,5,0,19,CL
5631b735,8,6,6,2,0,3,13,10,9,0,9,16,24,10,0,19,CL
56b5d64e,8,6,6,0,2,2,7,5,5,0,5,6,14,2,0,19,CL
56f7a928,14,9,6,6,2,5,12,7,7,2,5,10,24,7,1,19,CL
580d52dd,12,7,2,7,3,3,6,3,6,1,5,7,19,15,1,19,CL
5832ebfe,5,4,1,4,0,2,4,2,3,2,1,9,14,18,0,19,CL
58a160e1,0,0,0,0,0,0,2,2,0,0,0,0,0,0,0,19,CL
58a9a4d9,12,7,6,4,2,7,16,9,6,1,5,6,18,2,0,19,CL
58ce23e5,2,1,0,2,0,1,6,5,0,0,0,1,3,0,0,19,CL
58eee997,0,0,0,0,0,0,0,0,0,0,0,1,1,0,0,19,CL
591477c9,5,5,3,2,0,0,2,2,6,6,0,4,9,21,0,19,CL
5939baa2,22,13,13,8,1,13,16,3,9,1,8,11,33,9,0,19,CL
5a2cb25d,4,2,3,1,0,4,5,1,6,1,5,4,8,6,0,19,CL
5ab0ea87,41,21,14,25,2,14,31,17,14,3,11,15,56,11,1,19,CL
5afafbfe,0,0,0,0,0,0,0,0,0,0,0,0,0,1,0,19,CL
5b54bf3b,2,1,0,2,0,0,2,2,5,1,4,3,5,8,0,19,CL
5c2b4f07,8,6,4,4,0,1,7,6,8,1,7,9,17,14,0,19,CL
5c4dc0ff,0,0,0,0,0,0,0,0,2,0,2,0,0,2,0,19,CL
5cb1d026,15,11,9,6,0,6,18,12,7,3,4,17,32,20,0,19,CL
5cdddffa,19,11,8,10,1,6,10,4,6,2,4,12,31,7,0,19,CL
5d0d1ec7,7,7,2,4,1,2,3,1,4,3,1,10,17,17,0,19,CL
5d4f7d61,2,1,1,1,0,0,2,2,1,1,0,1,3,3,0,19,CL
5d5219b1,2,2,0,1,1,1,4,3,4,0,4,2,4,0,1,19,CL
5dfc6ad5,11,9,5,6,0,5,9,4,8,2,6,7,18,6,0,19,CL
5e1028e5,15,8,7,6,2,7,13,6,7,0,7,2,17,1,0,19,CL
5e861944,5,4,3,1,1,1,10,9,1,0,1,3,8,2,0,19,CL
5e8936be,0,0,0,0,0,0,0,0,0,0,0,1,1,0,1,19,CL
5eae500a,3,1,1,1,1,2,4,2,1,0,1,0,3,5,0,19,CL
5eecec3d,5,3,2,3,0,3,3,0,6,3,3,7,12,13,0,19,CL
5f424f35,5,5,2,3,0,2,7,5,4,0,4,7,12,4,0,19,CL
6025fab1,8,4,3,4,1,4,12,8,1,0,1,7,15,0,0,19,CL
603116a7,4,4,2,1,1,2,6,4,5,0,5,2,6,5,0,19,CL
60359288,2,1,2,0,0,2,3,1,2,1,1,0,2,8,0,19,CL
603cb947,1,0,0,1,0,0,4,4,1,0,1,2,3,2,0,19,CL
615c4d8f,3,2,3,0,0,0,7,7,1,0,1,1,4,1,0,19,CL
6190474d,0,0,0,0,0,0,0,0,0,0,0,1,1,0,0,19,CL
61b0b44d,1,0,1,0,0,0,2,2,0,0,0,0,1,0,0,19,CL
61f63784,11,7,10,1,0,7,10,3,5,3,2,11,22,31,0,19,CL
6228469d,8,1,5,3,0,3,14,11,11,4,7,6,14,8,0,19,CL
63d17038,0,0,0,0,0,0,0,0,0,0,0,0,0,1,0,19,CL
6421ec64,1,0,0,0,1,0,2,2,3,0,3,1,2,2,0,19,CL
6434f10d,9,7,3,4,2,4,7,3,9,4,5,12,21,12,0,19,CL
66116290,2,2,0,1,1,0,2,2,1,0,1,0,2,2,0,19,CL
6622454d,28,17,7,14,7,10,33,23,14,1,13,14,42,6,0,19,CL
6639e500,2,1,0,1,1,1,3,2,3,0,3,1,3,1,0,19,CL
67b3d74b,16,11,10,6,0,6,13,7,15,3,12,14,30,22,0,19,CL
67cdbc0e,25,12,13,10,2,5,13,8,8,1,7,10,35,5,0,19,CL
6822ea0c,2,1,1,1,0,1,2,1,0,0,0,2,4,3,0,19,CL
6853490f,0,0,0,0,0,0,0,0,0,0,0,0,0,0,0,19,CL
691bef82,23,11,12,9,2,9,19,10,22,10,12,20,43,45,0,19,CL
691f64f5,1,0,1,0,0,1,2,1,2,0,2,0,1,1,0,19,CL
69384e5d,5,3,2,3,0,0,4,4,2,2,0,2,7,2,0,19,CL
6938d79b,8,4,4,4,0,2,4,2,6,3,3,6,14,9,1,19,CL
6941883f,2,1,1,1,0,2,5,3,1,1,0,1,3,2,0,19,CL
69960ac3,2,2,1,1,0,0,3,3,1,1,0,8,10,14,0,19,CL
6a189491,0,0,0,0,0,0,0,0,0,0,0,0,0,0,0,19,CL
6a829019,14,10,7,6,1,7,14,7,9,4,5,11,25,21,0,19,CL
6bd05d38,0,0,0,0,0,0,0,0,0,0,0,0,0,0,2,19,CL
6c7762c3,1,1,0,1,0,1,3,2,2,0,2,5,6,0,1,19,CL
6c811eb7,2,2,2,0,0,0,3,3,0,0,0,0,2,1,0,19,CL
6cafd68d,1,0,1,0,0,1,3,2,5,2,3,2,3,5,0,19,CL
6ce1f46f,17,10,3,9,5,5,22,17,4,2,2,9,26,3,4,19,CL
6ceef869,5,4,3,2,0,3,5,2,3,3,0,3,8,14,0,19,CL
6e5497ca,3,1,3,0,0,0,0,0,0,0,0,0,3,0,0,19,CL
6e592fa4,14,12,8,4,2,3,8,5,7,1,6,8,22,22,0,19,CL
6ec6fde0,7,4,6,1,0,3,4,1,4,2,2,1,8,3,1,19,CL
6f51e382,0,0,0,0,0,0,0,0,0,0,0,0,0,3,3,19,CL
6f639ec7,2,2,2,0,0,1,5,4,3,0,3,2,4,4,0,19,CL
6fdac234,9,6,6,3,0,3,8,5,3,0,3,4,13,10,0,19,CL
6fe90922,10,6,4,5,1,5,11,6,10,1,9,11,21,16,0,19,CL
70cf63ca,14,8,5,9,0,7,13,6,3,0,3,4,18,7,0,19,CL
70d74ece,2,2,0,1,1,0,1,1,1,0,1,2,4,8,0,19,CL
70d8e84c,0,0,0,0,0,0,0,0,0,0,0,0,0,0,0,19,CL
7111d552,6,4,3,2,1,2,3,1,2,0,2,0,6,0,0,19,CL
715bf047,6,4,4,2,0,2,4,2,7,0,7,5,11,4,0,19,CL
716e7308,0,0,0,0,0,0,0,0,0,0,0,0,0,0,0,19,CL
71ec39ef,21,13,8,13,0,7,21,14,10,3,7,4,25,10,0,19,CL
7230b807,2,1,2,0,0,0,1,1,1,0,1,1,3,0,0,19,CL
7272a72a,7,6,2,3,2,2,3,1,3,1,2,2,9,4,0,19,CL
73000a79,4,2,2,1,1,2,3,1,2,0,2,0,4,3,0,19,CL
731e29b8,1,0,0,0,1,0,0,0,0,0,0,0,1,0,0,19,CL
732b0cf9,0,0,0,0,0,0,0,0,0,0,0,1,1,0,0,19,CL
733e7ad8,5,3,5,0,0,2,3,1,3,1,2,5,10,9,0,19,CL
73d6a176,0,0,0,0,0,0,1,1,0,0,0,0,0,0,0,19,CL
74419746,0,0,0,0,0,0,1,1,1,0,1,1,1,2,0,19,CL
7460ca0d,7,4,4,2,1,4,9,5,7,0,7,2,9,1,0,19,CL
746fec7d,1,0,1,0,0,0,0,0,1,0,1,0,1,0,0,19,CL
74bafc9c,7,3,5,2,0,4,8,4,0,0,0,1,8,0,0,19,CL
77d7c96f,12,9,3,8,1,5,5,0,5,0,5,4,16,7,0,19,CL
77e84962,9,6,4,4,1,1,5,4,6,1,5,10,19,3,0,19,CL
78841da9,6,2,2,3,1,2,12,10,2,0,2,6,12,4,0,19,CL
79019bf4,13,8,12,1,0,6,16,10,12,5,7,7,20,22,0,19,CL
79083382,3,2,3,0,0,2,2,0,4,1,3,2,5,13,0,19,CL
791abba1,7,5,6,1,0,2,7,5,9,5,4,12,19,23,1,19,CL
79370f8c,1,1,1,0,0,1,5,4,2,0,2,0,1,3,0,19,CL
79c90e45,10,7,5,5,0,5,10,5,6,2,4,4,14,22,0,19,CL
7a11550b,8,1,6,1,1,3,8,5,1,0,1,6,14,14,0,19,CL
7a20d90a,2,0,2,0,0,1,3,2,3,1,2,3,5,4,0,19,CL
7a2e46a8,0,0,0,0,0,0,0,0,0,0,0,1,1,2,1,19,CL
7aac47fe,6,4,6,0,0,5,9,4,2,2,0,5,11,4,0,19,CL
7b18b6db,6,6,5,1,0,2,4,2,5,4,1,11,17,15,1,19,CL
7b4c1f6e,2,2,1,0,1,0,1,1,1,1,0,0,2,0,0,19,CL
7b9ecf02,0,0,0,0,0,0,0,0,0,0,0,0,0,0,0,19,CL
7ba6d84e,1,0,1,0,0,1,1,0,0,0,0,0,1,1,1,19,CL
7bcc0708,3,1,2,1,0,1,2,1,0,0,0,0,3,0,0,19,CL
7c0000fd,2,1,1,1,0,2,3,1,0,0,0,1,3,2,0,19,CL
7c1a0c67,13,10,9,3,1,10,14,4,5,2,3,13,26,21,0,19,CL
7c9fa389,0,0,0,0,0,0,0,0,2,1,1,1,1,3,0,19,CL
7cab69b5,5,4,4,1,0,0,2,2,2,0,2,6,11,20,0,19,CL
7d9397f8,3,2,1,2,0,1,2,1,0,0,0,0,3,0,0,19,CL
7ec7738e,5,3,2,2,1,4,9,5,4,1,3,1,6,8,0,19,CL
7f3b388c,27,21,9,17,1,12,34,22,5,0,5,12,39,15,0,19,CL
7f609bfc,5,4,3,1,1,1,3,2,4,1,3,1,6,1,1,19,CL
7f97771d,18,9,7,9,2,3,7,4,7,2,5,20,38,10,0,19,CL
7fb301af,0,0,0,0,0,0,0,0,0,0,0,0,0,0,0,19,CL
807e869a,7,4,3,3,1,5,8,3,3,0,3,2,9,4,0,19,CL
80f36c88,8,4,4,4,0,2,8,6,0,0,0,5,13,3,0,19,CL
8104e41e,0,0,0,0,0,0,0,0,0,0,0,0,0,0,0,19,CL
810e3c74,4,2,1,2,1,1,6,5,7,0,7,0,4,0,0,19,CL
816192f0,8,4,7,1,0,2,3,1,2,1,1,1,9,4,0,19,CL
819b3158,9,6,1,7,1,4,13,9,5,0,5,8,17,5,0,19,CL
824bd41a,8,4,8,0,0,2,6,4,6,6,0,10,18,28,0,19,CL
82b1198a,2,1,2,0,0,2,2,0,0,0,0,0,2,4,0,19,CL
82dbf623,2,0,0,1,1,1,4,3,0,0,0,0,2,10,0,19,CL
8387afe6,6,5,3,2,1,2,4,2,3,1,2,8,14,6,0,19,CL
8454388c,2,1,0,0,2,2,3,1,4,1,3,6,8,3,0,19,CL
85613cf0,1,1,0,1,0,0,2,2,2,0,2,1,2,2,0,19,CL
85686f86,1,0,1,0,0,0,1,1,0,0,0,0,1,0,0,19,CL
862fa9fb,1,0,1,0,0,0,1,1,3,2,1,4,5,19,0,19,CL
8637e09a,0,0,0,0,0,0,0,0,0,0,0,0,0,2,0,19,CL
8652a85c,1,0,1,0,0,0,1,1,2,0,2,1,2,3,0,19,CL
867239d3,5,2,2,3,0,0,6,6,12,2,10,6,11,5,0,19,CL
8696bc90,0,0,0,0,0,0,0,0,0,0,0,0,0,1,0,19,CL
86dd16a8,9,5,8,1,0,5,7,2,3,0,3,6,15,13,0,19,CL
86dd77d1,4,1,1,2,1,1,4,3,8,2,6,6,10,15,1,19,CL
86e7deaf,7,4,4,3,0,1,3,2,12,6,6,11,18,47,0,19,CL
873ce3a2,5,4,1,3,1,1,4,3,4,0,4,0,5,2,0,19,CL
874d7a32,20,14,10,9,1,8,14,6,15,2,13,6,26,4,0,19,CL
87575fd9,11,6,4,7,0,4,8,4,5,0,5,5,16,11,0,19,CL
8778c910,0,0,0,0,0,0,1,1,0,0,0,0,0,4,1,19,CL
8794e251,8,4,4,4,0,2,2,0,5,0,5,3,11,4,0,19,CL
881ef58c,1,0,0,0,1,0,1,1,0,0,0,0,1,0,0,19,CL
88a359d4,1,1,0,1,0,1,4,3,1,0,1,1,2,0,0,19,CL
88a9ea33,8,4,3,4,1,1,11,10,6,1,5,4,12,1,0,19,CL
88c89891,6,5,3,3,0,4,7,3,2,0,2,7,13,13,0,19,CL
88e357ef,14,8,6,4,4,4,14,10,9,2,7,6,20,2,0,19,CL
892d5bb1,9,5,1,7,1,3,9,6,8,1,7,1,10,10,0,19,CL
89565ac5,4,2,3,1,0,1,1,0,5,2,3,2,6,7,0,19,CL
89ac64a6,13,7,8,4,1,4,5,1,3,1,2,9,22,15,0,19,CL
89b2c8a9,2,0,1,0,1,1,7,6,1,0,1,0,2,1,0,19,CL
89d10e53,11,6,4,6,1,6,10,4,7,3,4,7,18,16,0,19,CL
89f951b5,9,4,3,5,1,3,9,6,19,3,16,19,28,8,1,19,CL
8a7a5ad7,1,1,0,0,1,1,2,1,1,0,1,1,2,9,0,19,CL
8aafd64f,2,2,1,1,0,1,1,0,1,0,1,0,2,0,0,19,CL
8b788c01,4,3,1,3,0,2,2,0,4,0,4,1,5,4,0,19,CL
8d3d3b0a,1,0,0,1,0,0,1,1,1,0,1,0,1,0,0,19,CL
8d78e732,2,1,0,2,0,0,4,4,8,0,8,6,8,5,0,19,CL
8e088e04,0,0,0,0,0,0,0,0,0,0,0,2,2,0,0,19,CL
8e34b9f5,7,4,6,1,0,3,4,1,3,2,1,3,10,24,0,19,CL
8f62b6ee,0,0,0,0,0,0,0,0,0,0,0,0,0,2,1,19,CL
8f696594,0,0,0,0,0,0,2,2,3,1,2,1,1,0,0,19,CL
8fd9996f,14,8,6,8,0,5,12,7,11,7,4,14,28,13,0,19,CL
90d7dda6,7,1,3,3,1,2,6,4,3,0,3,6,13,2,0,19,CL
9139bb12,1,1,0,1,0,0,3,3,1,0,1,2,3,0,0,19,CL
92e7e919,14,8,7,5,2,5,24,19,13,1,12,5,19,8,0,19,CL
935e6b8f,18,15,3,12,3,6,15,9,9,0,9,13,31,10,0,19,CL
93a50d2c,3,1,3,0,0,3,9,6,4,2,2,3,6,4,0,19,CL
947e036f,2,1,1,0,1,1,4,3,4,1,3,1,3,1,0,19,CL
94b2001f,0,0,0,0,0,0,0,0,1,0,1,2,2,2,0,19,CL
95a24690,1,0,0,1,0,1,2,1,1,0,1,0,1,0,0,19,CL
96094cbc,2,2,0,2,0,0,3,3,5,0,5,2,4,1,0,19,CL
960acc0a,13,10,6,4,3,6,10,4,7,2,5,2,15,7,0,19,CL
96b03fe2,8,4,4,4,0,2,4,2,5,1,4,4,12,36,0,19,CL
980522ec,9,5,2,3,4,4,9,5,14,2,12,12,21,10,0,19,CL
984a5a64,0,0,0,0,0,0,2,2,2,1,1,0,0,0,1,19,CL
9907b1c8,5,3,0,3,2,2,6,4,3,0,3,1,6,0,0,19,CL
99813635,0,0,0,0,0,0,2,2,0,0,0,2,2,0,0,19,CL
99de6b6f,1,0,1,0,0,1,2,1,0,0,0,1,2,5,1,19,CL
9a1f2e1c,9,3,7,1,1,4,11,7,5,0,5,11,20,12,1,19,CL
9ae9eaea,1,1,1,0,0,1,4,3,2,2,0,8,9,5,0,19,CL
9bcd6455,0,0,0,0,0,0,1,1,1,0,1,0,0,0,0,19,CL
9c94165b,15,10,8,7,0,9,12,3,11,1,10,9,24,18,0,19,CL
9d12e142,0,0,0,0,0,0,0,0,0,0,0,0,0,2,0,19,CL
9d60028d,4,3,1,3,0,1,6,5,1,0,1,2,6,2,0,19,CL
9e1035f8,2,1,1,1,0,0,0,0,0,0,0,0,2,2,0,19,CL
9efa1d25,15,6,2,8,5,4,10,6,1,0,1,3,18,4,0,19,CL
9f84febe,3,2,2,1,0,2,3,1,1,1,0,1,4,3,2,19,CL
9f8e9423,3,2,1,1,1,0,1,1,10,2,8,6,9,11,0,19,CL
a022e78c,5,4,2,1,2,0,9,9,1,0,1,4,9,1,0,19,CL
a0b4bb3e,4,4,2,2,0,2,5,3,1,0,1,2,6,0,0,19,CL
a1232f4e,5,3,1,4,0,3,5,2,2,0,2,5,10,18,0,19,CL
a190d597,0,0,0,0,0,0,1,1,0,0,0,1,1,2,0,19,CL
a1c5b23e,1,0,0,1,0,1,1,0,2,0,2,2,3,1,0,19,CL
a1d5bd30,8,6,2,2,4,2,9,7,8,0,8,2,10,10,0,19,CL
a29b1131,4,3,1,2,1,2,5,3,1,0,1,3,7,2,0,19,CL
a2abe631,0,0,0,0,0,0,0,0,0,0,0,0,0,2,1,19,CL
a33a0dc0,5,2,1,3,1,1,5,4,3,0,3,1,6,4,0,19,CL
a382462b,3,1,0,2,1,1,4,3,2,1,1,3,6,0,0,19,CL
a3b0ed18,0,0,0,0,0,0,0,0,0,0,0,0,0,4,2,19,CL
a3ddb1b9,10,6,2,5,3,0,13,13,7,1,6,5,15,4,0,19,CL
a40d5a0c,3,3,2,0,1,2,3,1,3,0,3,3,6,0,0,19,CL
a45eac1f,0,0,0,0,0,0,1,1,2,0,2,1,1,3,0,19,CL
a4effc55,4,2,1,3,0,1,3,2,5,4,1,3,7,16,2,19,CL
a5296e55,0,0,0,0,0,0,0,0,0,0,0,0,0,1,0,19,CL
a5549ec1,1,1,1,0,0,1,1,0,0,0,0,0,1,2,0,19,CL
a58bb1e1,2,0,1,1,0,1,5,4,2,0,2,5,7,2,0,19,CL
a5db0bec,17,8,9,8,0,6,17,11,8,4,4,7,24,13,0,19,CL
a6154613,7,4,0,3,4,3,13,10,3,0,3,1,8,9,0,19,CL
a65ce836,4,1,0,3,1,2,6,4,5,1,4,8,12,8,0,19,CL
a6951bf8,7,5,3,4,0,3,7,4,1,1,0,10,17,5,0,19,CL
a69e4806,8,5,3,1,4,1,17,16,11,1,10,4,12,4,0,19,CL
a7a9d95a,2,2,0,2,0,0,2,2,3,0,3,3,5,1,0,19,CL
a8327abd,7,4,4,3,0,2,5,3,3,1,2,11,18,5,0,19,CL
a8542814,14,10,6,8,0,2,10,8,13,1,12,7,21,7,0,19,CL
a8741470,2,1,2,0,0,0,0,0,1,0,1,6,8,7,0,19,CL
a9aa0d1d,7,6,3,3,1,2,10,8,10,0,10,11,18,2,0,19,CL
a9dc785c,0,0,0,0,0,0,0,0,0,0,0,0,0,1,2,19,CL
aa8e289e,14,7,6,6,2,2,10,8,9,2,7,4,18,9,0,19,CL
aae44006,0,0,0,0,0,0,0,0,0,0,0,0,0,0,0,19,CL
ab6928f2,3,2,1,2,0,1,2,1,2,0,2,2,5,8,0,19,CL
abb3bb95,8,5,4,4,0,3,9,6,11,4,7,7,15,13,0,19,CL
abe66106,11,5,3,6,2,2,5,3,7,0,7,2,13,2,0,19,CL
ac1f056e,1,1,0,1,0,0,1,1,0,0,0,0,1,1,0,19,CL
ac3fb1be,2,2,2,0,0,2,2,0,5,5,0,7,9,14,0,19,CL
ac861941,3,3,1,1,1,2,4,2,5,1,4,4,7,9,0,19,CL
ad10eae0,4,3,3,1,0,4,7,3,5,1,4,6,10,13,0,19,CL
ad6df2d5,18,10,10,6,2,7,27,20,10,1,9,16,34,6,0,19,CL
adfc9123,12,8,7,5,0,4,8,4,13,9,4,12,24,56,1,19,CL
ae4e2852,4,2,1,1,2,2,3,1,0,0,0,6,10,6,0,19,CL
aeed5c06,1,0,0,1,0,0,0,0,0,0,0,0,1,0,0,19,CL
aef6e670,15,8,8,6,1,4,7,3,2,1,1,12,27,17,0,19,CL
afa0d4e0,8,5,1,7,0,0,2,2,3,1,2,4,12,7,0,19,CL
afb0c500,0,0,0,0,0,0,0,0,0,0,0,0,0,1,0,19,CL
b05e2dbd,9,6,8,1,0,7,9,2,3,1,2,5,14,14,0,19,CL
b1062a37,3,0,3,0,0,1,2,1,2,2,0,7,10,30,0,19,CL
b19db005,2,1,0,1,1,1,3,2,2,0,2,1,3,0,0,19,CL
b1f4086c,25,17,15,8,2,16,24,8,2,0,2,7,32,14,0,19,CL
b20f5a66,10,8,10,0,0,5,7,2,12,5,7,8,18,23,0,19,CL
b217ef29,13,8,9,3,1,8,14,6,10,3,7,14,27,38,0,19,CL
b233e8e4,1,0,1,0,0,0,0,0,1,1,0,3,4,3,0,19,CL
b2db927b,0,0,0,0,0,0,0,0,0,0,0,0,0,1,0,19,CL
b3325a30,15,11,5,9,1,7,13,6,7,0,7,6,21,0,0,19,CL
b400bde0,10,4,4,2,4,4,16,12,6,0,6,7,17,5,0,19,CL
b4825073,2,1,0,2,0,0,1,1,0,0,0,3,5,1,0,19,CL
b65c42cf,3,1,2,1,0,1,3,2,2,0,2,2,5,9,0,19,CL
b66315ae,2,1,1,1,0,0,2,2,5,0,5,1,3,6,0,19,CL
b6964eb6,12,8,10,1,1,7,9,2,11,8,3,9,21,40,0,19,CL
b6a6e0a7,2,1,0,1,1,0,0,0,1,0,1,0,2,1,0,19,CL
b6b2b820,1,0,1,0,0,0,1,1,1,0,1,0,1,0,0,19,CL
b74277a0,37,24,18,16,3,19,29,10,15,2,13,21,58,18,1,19,CL
b7ca5c51,8,7,5,3,0,2,4,2,11,5,6,9,17,23,0,19,CL
b7e7937d,0,0,0,0,0,0,0,0,0,0,0,1,1,0,0,19,CL
b853e0ad,11,7,8,3,0,5,18,13,10,2,8,5,16,5,0,19,CL
ba23a904,12,3,6,6,0,4,8,4,7,7,0,18,30,33,0,19,CL
bafcf742,7,6,6,1,0,4,13,9,6,5,1,13,20,13,0,19,CL
bd4f5f94,3,1,3,0,0,0,2,2,5,1,4,5,8,11,0,19,CL
bd6351cd,15,10,8,7,0,8,15,7,3,0,3,6,21,12,0,19,CL
be927d03,11,5,5,6,0,5,6,1,4,2,2,7,18,16,0,19,CL
beb391dd,6,2,5,0,1,3,3,0,2,1,1,1,7,1,0,19,CL
bece776f,12,5,5,6,1,1,5,4,7,0,7,3,15,1,0,19,CL
beda9675,0,0,0,0,0,0,0,0,0,0,0,0,0,0,0,19,CL
bef09ca8,0,0,0,0,0,0,1,1,0,0,0,0,0,0,0,19,CL
bfae110f,2,1,1,0,1,1,1,0,2,0,2,0,2,5,0,19,CL
c0617e2b,0,0,0,0,0,0,0,0,5,0,5,1,1,1,0,19,CL
c0c7ff58,11,9,4,6,1,5,8,3,4,1,3,7,18,7,0,19,CL
c0cddebe,15,10,5,8,2,4,9,5,9,2,7,11,26,8,0,19,CL
c14bc029,13,6,4,6,3,3,15,12,9,1,8,12,25,10,1,19,CL
c17bfb65,11,7,5,4,2,6,10,4,5,1,4,4,15,2,0,19,CL
c2111b45,1,1,1,0,0,1,1,0,2,1,1,3,4,4,0,19,CL
c24544c7,12,6,7,5,0,2,6,4,10,1,9,7,19,9,0,19,CL
c2e41cfb,0,0,0,0,0,0,0,0,0,0,0,0,0,0,1,19,CL
c3a8bcd8,22,7,10,11,1,11,25,14,8,1,7,16,38,13,0,19,CL
c3ee18ef,7,3,4,3,0,3,3,0,2,1,1,6,13,19,0,19,CL
c43e5e7e,4,1,1,3,0,0,9,9,6,1,5,2,6,5,0,19,CL
c46fa34c,5,2,2,3,0,2,8,6,3,0,3,0,5,10,0,19,CL
c47541e0,6,3,3,2,1,3,3,0,4,1,3,2,8,4,0,19,CL
c4987edc,0,0,0,0,0,0,0,0,1,0,1,1,1,6,0,19,CL
c5adc293,1,1,1,0,0,0,0,0,0,0,0,0,1,0,0,19,CL
c5bdb6e3,4,1,2,0,2,1,5,4,3,0,3,1,5,1,0,19,CL
c5fd13e9,5,3,5,0,0,2,2,0,2,2,0,4,9,10,0,19,CL
c6056d58,11,6,8,3,0,4,5,1,2,1,1,7,18,32,0,19,CL
c67cd65c,2,2,1,1,0,1,4,3,3,0,3,4,6,8,0,19,CL
c691bfe2,20,14,9,9,2,2,8,6,10,2,8,5,25,5,1,19,CL
c707411f,9,8,5,4,0,2,6,4,12,9,3,10,19,30,1,19,CL
c7526c18,15,8,6,7,2,5,9,4,7,2,5,5,20,12,0,19,CL
c7842dab,2,1,1,0,1,2,6,4,0,0,0,1,3,1,0,19,CL
c886b062,1,1,0,1,0,1,2,1,2,1,1,3,4,7,0,19,CL
c8bfb695,1,0,0,1,0,0,0,0,2,2,0,0,1,16,0,19,CL
c8c60119,0,0,0,0,0,0,0,0,0,0,0,2,2,2,0,19,CL
c8e65157,8,4,8,0,0,5,7,2,10,6,4,13,21,47,0,19,CL
c906ce0f,7,5,6,1,0,3,7,4,2,1,1,3,10,7,1,19,CL
c952f633,6,3,4,1,1,1,2,1,3,0,3,2,8,4,0,19,CL
c9cb972b,0,0,0,0,0,0,0,0,0,0,0,0,0,1,0,19,CL
c9e99e49,4,4,3,1,0,1,4,3,6,1,5,3,7,1,0,19,CL
ca3e2783,0,0,0,0,0,0,0,0,0,0,0,0,0,0,0,19,CL
cbbfa2e7,1,1,0,1,0,0,1,1,1,1,0,0,1,1,0,19,CL
cc1a0c57,0,0,0,0,0,0,1,1,0,0,0,0,0,2,2,19,CL
cc700722,39,22,15,24,0,11,34,23,6,0,6,5,44,4,1,19,CL
cc83b74d,4,3,0,4,0,1,5,4,0,0,0,2,6,0,0,19,CL
cc86b9a3,11,7,6,5,0,5,9,4,5,1,4,5,16,1,0,19,CL
ccbbe661,6,5,2,4,0,1,4,3,1,0,1,2,8,6,1,19,CL
ccc66d00,0,0,0,0,0,0,0,0,2,0,2,1,1,0,0,19,CL
ccd88b8e,7,4,7,0,0,1,3,2,2,0,2,0,7,2,0,19,CL
cce181df,16,10,10,5,1,9,16,7,8,3,5,13,29,11,0,19,CL
cd1acf9d,21,10,11,6,4,13,19,6,8,1,7,18,39,22,1,19,CL
cd1b2304,0,0,0,0,0,0,0,0,0,0,0,0,0,0,0,19,CL
ce9e8024,6,4,4,2,0,1,1,0,4,2,2,8,14,12,0,19,CL
cea4ee8f,9,5,3,4,2,3,11,8,5,1,4,6,15,7,0,19,CL
cf182add,17,12,11,5,1,4,9,5,8,3,5,7,24,17,0,19,CL
cf8ef0a1,4,1,2,1,1,0,1,1,3,0,3,1,5,4,0,19,CL
cfd8d664,12,10,9,3,0,10,11,1,7,1,6,11,23,10,0,19,CL
cff7dcb0,8,5,3,4,1,1,8,7,4,2,2,0,8,12,0,19,CL
d003e213,15,10,10,5,0,6,13,7,1,0,1,5,20,8,0,19,CL
d02e0cab,4,1,1,3,0,2,7,5,3,1,2,4,8,1,0,19,CL
d04b94db,16,12,7,8,1,9,14,5,8,0,8,6,22,10,2,19,CL
d072a976,8,5,5,3,0,2,6,4,6,4,2,7,15,18,0,19,CL
d0d79694,0,0,0,0,0,0,1,1,1,1,0,1,1,6,0,19,CL
d0d8dd44,6,3,4,2,0,4,4,0,8,6,2,7,13,18,1,19,CL
d1273f09,20,17,9,9,2,5,20,15,16,2,14,11,31,18,0,19,CL
d1661819,2,2,2,0,0,0,1,1,0,0,0,1,3,5,0,19,CL
d2110326,8,5,7,0,1,3,3,0,4,3,1,5,13,12,0,19,CL
d2448564,4,1,4,0,0,2,3,1,5,0,5,3,7,0,0,19,CL
d28b8f40,7,4,6,1,0,4,7,3,9,2,7,15,22,34,0,19,CL
d2bff301,3,1,2,1,0,1,2,1,1,1,0,3,6,7,0,19,CL
d3272fba,1,1,0,1,0,0,1,1,0,0,0,2,3,0,0,19,CL
d38174c3,0,0,0,0,0,0,0,0,0,0,0,0,0,0,0,19,CL
d3aaad90,4,2,3,1,0,1,4,3,0,0,0,3,7,3,0,19,CL
d4931a5a,0,0,0,0,0,0,1,1,1,0,1,0,0,2,0,19,CL
d49f3e6b,2,1,2,0,0,1,5,4,1,0,1,2,4,1,0,19,CL
d4aa40b8,4,2,3,1,0,2,6,4,9,0,9,8,12,17,0,19,CL
d5980989,1,0,0,1,0,0,1,1,1,0,1,0,1,0,0,19,CL
d5c04323,10,9,6,3,1,4,7,3,7,6,1,7,17,12,1,19,CL
d5f2f82b,11,6,3,7,1,2,5,3,7,2,5,11,22,14,0,19,CL
d6e53a3a,16,12,11,3,2,5,13,8,12,8,4,15,31,49,0,19,CL
d70ce98e,10,10,1,4,5,3,7,4,6,0,6,3,13,0,0,19,CL
d7c09951,9,4,5,2,2,3,8,5,7,2,5,10,19,9,0,19,CL
d83bbc54,4,2,3,1,0,3,7,4,1,1,0,4,8,3,0,19,CL
d849ef0f,5,2,4,1,0,3,5,2,3,0,3,7,12,3,0,19,CL
d8b97bb3,1,0,1,0,0,0,0,0,1,0,1,2,3,2,0,19,CL
d93c2511,9,6,7,2,0,0,1,1,3,0,3,3,12,3,0,19,CL
d9565625,4,2,1,3,0,1,6,5,3,1,2,2,6,10,0,19,CL
d9a5d930,2,2,2,0,0,1,8,7,3,0,3,1,3,4,0,19,CL
d9d43555,1,0,1,0,0,0,0,0,0,0,0,0,1,0,0,19,CL
da59a197,0,0,0,0,0,0,0,0,0,0,0,0,0,0,0,19,CL
da7b447d,11,7,8,3,0,3,7,4,5,4,1,11,22,26,0,19,CL
da974c7b,14,9,9,5,0,7,10,3,10,7,3,12,26,24,0,19,CL
dab0da1c,1,1,1,0,0,1,2,1,2,0,2,1,2,0,0,19,CL
dad4b285,14,8,10,4,0,8,11,3,5,2,3,9,23,6,0,19,CL
db4ed67b,4,2,1,3,0,2,12,10,4,0,4,7,11,2,1,19,CL
db750822,1,1,0,1,0,0,1,1,0,0,0,2,3,2,0,19,CL
dbf053da,4,3,0,4,0,1,2,1,7,0,7,1,5,2,0,19,CL
dc62fbee,7,6,3,2,2,3,9,6,3,0,3,3,10,0,0,19,CL
de40e38c,3,2,3,0,0,2,4,2,5,1,4,3,6,6,0,19,CL
de5b5570,22,8,14,8,0,9,17,8,12,0,12,15,37,10,0,19,CL
dea698d9,3,3,1,2,0,0,7,7,2,1,1,3,6,6,0,19,CL
dead55e5,9,8,6,1,2,1,3,2,3,0,3,1,10,1,0,19,CL
def899bd,4,2,1,3,0,0,4,4,6,5,1,7,11,12,0,19,CL
df69b544,9,7,6,1,2,3,10,7,3,0,3,4,13,7,0,19,CL
dff153a4,1,1,1,0,0,0,1,1,1,0,1,0,1,0,0,19,CL
e06683ca,12,8,4,7,1,3,3,0,9,7,2,10,22,58,2,19,CL
e0900238,7,3,4,3,0,2,5,3,10,1,9,4,11,6,0,19,CL
e0921a4f,6,3,0,4,2,1,4,3,9,0,9,2,8,2,1,19,CL
e0991c04,1,1,1,0,0,1,4,3,0,0,0,0,1,2,0,19,CL
e0d3e18d,12,6,7,4,1,4,6,2,4,1,3,3,15,4,0,19,CL
e162b013,4,2,4,0,0,1,2,1,2,1,1,4,8,14,0,19,CL
e16dd48e,1,0,1,0,0,1,1,0,2,1,1,2,3,5,0,19,CL
e204ec12,6,5,0,6,0,0,5,5,6,1,5,2,8,1,0,19,CL
e26f559f,4,1,3,1,0,3,6,3,1,0,1,2,6,3,0,19,CL
e2716bd0,11,6,2,6,3,1,6,5,8,0,8,7,18,4,0,19,CL
e288d4b3,15,9,8,6,1,3,11,8,9,1,8,9,24,12,0,19,CL
e2dde94c,10,6,3,5,2,4,6,2,5,1,4,2,12,3,0,19,CL
e33c06cf,6,5,3,3,0,2,3,1,9,3,6,9,15,19,0,19,CL
e342ad68,11,3,2,1,8,4,8,4,3,0,3,4,15,1,1,19,CL
e38f1636,4,2,3,1,0,1,3,2,10,9,1,6,10,37,0,19,CL
e3d0b0c4,10,4,7,3,0,2,6,4,8,7,1,18,28,56,0,19,CL
e4086af3,3,3,1,1,1,2,2,0,3,0,3,0,3,3,0,19,CL
e40d028b,0,0,0,0,0,0,1,1,0,0,0,1,1,1,1,19,CL
e42d61c7,9,7,5,4,0,5,14,9,7,1,6,4,13,3,0,19,CL
e46012d4,3,2,2,0,1,0,5,5,6,1,5,2,5,1,0,19,CL
e4ed2628,11,10,8,2,1,6,8,2,7,0,7,16,27,3,1,19,CL
e50623a0,1,1,0,1,0,1,1,0,0,0,0,2,3,2,0,19,CL
e6ad16b2,12,9,5,5,2,5,15,10,1,0,1,4,16,8,0,19,CL
e6bc67d7,5,1,0,2,3,2,5,3,3,0,3,2,7,0,0,19,CL
e73c9bb2,12,7,7,4,1,3,11,8,12,5,7,16,28,32,0,19,CL
e7986081,2,2,0,2,0,0,0,0,4,1,3,1,3,3,0,19,CL
e7d59f4f,1,1,1,0,0,1,2,1,0,0,0,2,3,0,0,19,CL
e7ee38c3,0,0,0,0,0,0,0,0,0,0,0,0,0,2,0,19,CL
e85fb9b8,8,6,7,1,0,6,9,3,8,6,2,10,18,36,1,19,CL
e90dc1d5,6,4,0,2,4,1,1,0,4,0,4,2,8,0,0,19,CL
e97150c0,1,1,0,1,0,0,0,0,0,0,0,0,1,7,0,19,CL
e9c0c1b2,0,0,0,0,0,0,0,0,0,0,0,0,0,4,3,19,CL
ead61f73,2,1,2,0,0,0,0,0,5,2,3,4,6,1,0,19,CL
eb58eef0,12,6,4,4,4,4,9,5,7,1,6,2,14,4,0,19,CL
eb7822d7,13,7,8,5,0,7,13,6,13,5,8,7,20,10,1,19,CL
eba1e557,4,3,2,1,1,1,1,0,3,0,3,5,9,3,0,19,CL
ebc56869,0,0,0,0,0,0,0,0,0,0,0,0,0,0,0,19,CL
ecada4fc,0,0,0,0,0,0,0,0,0,0,0,0,0,0,0,19,CL
ed1e53f3,1,1,1,0,0,0,6,6,1,0,1,0,1,2,0,19,CL
ed87a229,0,0,0,0,0,0,2,2,1,0,1,0,0,0,0,19,CL
ed90babd,0,0,0,0,0,0,1,1,1,0,1,0,0,0,0,19,CL
eda40760,4,1,3,1,0,1,4,3,6,0,6,4,8,20,0,19,CL
ee3519f5,14,11,5,8,1,6,18,12,9,5,4,6,20,6,0,19,CL
ee8508c0,0,0,0,0,0,0,0,0,0,0,0,0,0,1,0,19,CL
ee93c1a9,4,2,2,1,1,3,3,0,9,0,9,5,9,6,0,19,CL
eed332df,5,2,1,4,0,0,1,1,2,0,2,3,8,6,0,19,CL
f00de885,1,0,1,0,0,1,1,0,0,0,0,0,1,3,0,19,CL
f0661424,36,20,9,20,7,14,27,13,17,3,14,20,56,27,1,19,CL
f08490a6,0,0,0,0,0,0,0,0,0,0,0,1,1,2,0,19,CL
f0da930c,5,3,3,2,0,3,4,1,4,3,1,7,12,29,0,19,CL
f0fc9d0e,3,2,1,2,0,1,1,0,2,0,2,0,3,0,0,19,CL
f209b81e,3,2,3,0,0,0,6,6,4,0,4,1,4,3,0,19,CL
f25c8e3a,13,8,3,9,1,7,13,6,4,1,3,5,18,3,0,19,CL
f2d063ec,11,9,4,7,0,5,14,9,10,1,9,5,16,11,0,19,CL
f35430a4,20,16,17,3,0,10,15,5,3,3,0,12,32,27,1,19,CL
f36c432f,0,0,0,0,0,0,0,0,0,0,0,0,0,0,0,19,CL
f4eb377b,0,0,0,0,0,0,0,0,0,0,0,1,1,1,1,19,CL
f5b6fb78,11,7,4,2,5,0,4,4,8,1,7,7,18,23,0,19,CL
f5deef4c,4,3,1,3,0,3,7,4,6,3,3,9,13,31,0,19,CL
f61c7c4e,7,4,3,3,1,3,12,9,5,0,5,7,14,1,0,19,CL
f6ac68c1,1,1,0,1,0,1,1,0,2,1,1,0,1,1,0,19,CL
f6db3bd5,0,0,0,0,0,0,1,1,0,0,0,0,0,0,0,19,CL
f7036e1c,1,0,0,1,0,0,1,1,5,1,4,0,1,0,0,19,CL
f76d7a41,1,0,0,1,0,1,2,1,0,0,0,0,1,1,1,19,CL
f7b10c66,0,0,0,0,0,0,0,0,0,0,0,0,0,1,1,19,CL
f7d50789,11,7,11,0,0,6,15,9,17,12,5,12,23,44,2,19,CL
f7ee69fb,4,0,1,3,0,4,4,0,3,0,3,2,6,0,0,19,CL
f956479d,1,0,0,1,0,0,0,0,0,0,0,0,1,1,0,19,CL
f99fe221,8,4,7,1,0,6,9,3,4,1,3,9,17,6,0,19,CL
f9c927de,9,5,3,6,0,6,12,6,5,1,4,1,10,3,0,19,CL
fa274d97,11,6,5,4,2,5,7,2,3,1,2,6,17,6,2,19,CL
fa661778,9,9,1,8,0,1,2,1,1,0,1,3,12,7,0,19,CL
fb517645,1,0,1,0,0,1,1,0,1,0,1,0,1,0,0,19,CL
fb938d24,15,12,6,6,3,6,10,4,7,1,6,8,23,1,0,19,CL
fbb23472,10,6,4,5,1,6,20,14,5,1,4,8,18,5,0,19,CL
fbffc4b1,2,1,1,1,0,0,1,1,4,2,2,1,3,5,0,19,CL
fc4f85b1,3,2,1,2,0,0,3,3,4,3,1,9,12,21,0,19,CL
fc62f087,12,8,5,6,1,5,7,2,10,5,5,8,20,21,0,19,CL
fd4ee68b,8,8,3,5,0,5,9,4,9,6,3,3,11,3,0,19,CL
fd51b456,12,10,3,6,3,5,7,2,4,0,4,1,13,2,0,19,CL
fdd60087,9,5,9,0,0,5,8,3,0,0,0,2,11,17,0,19,CL
fe2d2289,0,0,0,0,0,0,1,1,0,0,0,0,0,0,0,19,CL
fe2db476,13,8,7,3,3,8,17,9,7,2,5,10,23,10,0,19,CL
fe641c1a,6,5,3,3,0,3,6,3,6,2,4,8,14,7,0,19,CL
fed17f5a,14,11,8,4,2,6,8,2,4,1,3,1,15,2,0,19,CL
ff0ab48c,2,0,1,1,0,1,4,3,6,3,3,6,8,10,0,19,CL
ff182fdc,5,4,2,1,2,2,3,1,1,0,1,1,6,1,0,19,CL
ffbbc83b,14,5,12,2,0,5,16,11,4,1,3,11,25,4,0,19,CL
0000acda,30,19,8,15,7,14,41,27,16,3,13,9,39,27,1,19,ITA
00528660,15,13,6,6,3,4,9,5,10,3,7,8,23,31,1,19,ITA
008a6e6d,9,8,5,3,1,5,11,6,19,13,6,10,19,68,1,19,ITA
00b0bb87,17,11,13,2,2,5,14,9,14,6,8,12,29,37,0,19,ITA
01b8a2b2,2,1,2,0,0,1,1,0,0,0,0,1,3,8,2,19,ITA
01efac19,9,6,4,5,0,2,11,9,4,0,4,2,11,2,0,19,ITA
023937a9,47,34,31,15,1,19,48,29,31,11,20,39,86,56,1,19,ITA
02b2937c,2,2,0,2,0,1,3,2,3,1,2,3,5,5,0,19,ITA
02caf6e0,29,17,16,10,3,13,24,11,26,5,21,20,49,51,1,19,ITA
02febfdc,42,27,30,8,4,16,27,11,23,10,13,30,72,41,0,19,ITA
0375723e,16,11,5,9,2,8,16,8,6,0,6,4,20,3,0,19,ITA
03760df0,0,0,0,0,0,0,0,0,0,0,0,0,0,5,2,19,ITA
03f946ed,15,6,5,5,5,2,9,7,23,8,15,4,19,15,0,19,ITA
0412b9cd,0,0,0,0,0,0,0,0,0,0,0,0,0,0,0,19,ITA
048877f5,1,1,1,0,0,1,2,1,0,0,0,3,4,10,1,19,ITA
0497a545,1,0,0,1,0,0,0,0,0,0,0,0,1,0,0,19,ITA
05e19d6a,42,27,16,20,6,18,38,20,35,10,25,27,69,53,2,19,ITA
06050480,1,1,1,0,0,1,2,1,1,1,0,3,4,6,0,19,ITA
060606ec,55,34,34,15,6,29,49,20,24,2,22,9,64,50,1,19,ITA
07767f42,52,33,29,22,1,22,49,27,18,5,13,24,76,38,2,19,ITA
07abb358,36,23,17,12,7,12,24,12,26,5,21,23,59,33,0,19,ITA
07ea0ef2,14,9,6,8,0,7,13,6,14,4,10,10,24,13,0,19,ITA
07f55871,0,0,0,0,0,0,0,0,0,0,0,0,0,0,0,19,ITA
0821331c,67,40,46,21,0,27,40,13,51,35,16,57,124,162,2,19,ITA
0830a4f9,2,2,1,1,0,0,2,2,2,1,1,0,2,3,0,19,ITA
085e71a7,0,0,0,0,0,0,1,1,0,0,0,0,0,9,1,19,ITA
089550f5,44,26,22,14,8,29,51,22,21,4,17,40,84,46,1,19,ITA
08aa9cd1,14,6,6,5,3,4,20,16,16,3,13,5,19,17,0,19,ITA
08f5afaa,1,1,1,0,0,1,2,1,0,0,0,1,2,13,3,19,ITA
091795f2,0,0,0,0,0,0,0,0,0,0,0,0,0,0,0,19,ITA
09538fdb,6,1,0,3,3,2,12,10,20,2,18,8,14,35,0,19,ITA
098139eb,11,9,3,6,2,3,6,3,2,1,1,7,18,3,0,19,ITA
0a3065c8,30,18,19,7,4,13,36,23,18,1,17,23,53,49,0,19,ITA
0a447501,6,3,1,1,4,0,1,1,8,0,8,4,10,3,0,19,ITA
0ab1f153,20,15,6,9,5,5,23,18,14,3,11,18,38,11,0,19,ITA
0acda699,0,0,0,0,0,0,0,0,0,0,0,0,0,2,0,19,ITA
0b5a292a,24,18,9,12,3,14,25,11,15,3,12,21,45,38,0,19,ITA
0cd0e21b,4,3,2,1,1,3,5,2,3,0,3,5,9,2,0,19,ITA
0d077b88,51,28,23,21,7,15,46,31,28,5,23,33,84,32,0,19,ITA
0d82903c,68,45,28,33,7,21,36,15,32,8,24,38,106,71,0,19,ITA
0e21fc3c,22,19,9,10,3,8,30,22,11,1,10,16,38,27,2,19,ITA
0f933743,11,8,8,3,0,4,6,2,1,1,0,4,15,27,0,19,ITA
1079c685,3,2,2,1,0,0,7,7,7,1,6,2,5,4,0,19,ITA
10dc46f0,0,0,0,0,0,0,2,2,0,0,0,2,2,21,1,19,ITA
10e25802,46,29,14,20,12,20,44,24,18,2,16,16,62,12,0,19,ITA
10e7f486,55,38,35,13,7,30,55,25,32,7,25,37,92,109,1,19,ITA
117beb8f,13,7,12,1,0,5,9,4,15,11,4,12,25,42,0,19,ITA
1253a12e,28,16,20,7,1,17,30,13,17,9,8,19,47,96,0,19,ITA
12851227,5,4,4,1,0,5,7,2,0,0,0,1,6,5,0,19,ITA
130a7a3f,15,10,10,2,3,4,25,21,16,0,16,8,23,11,0,19,ITA
13c8e5f6,0,0,0,0,0,0,1,1,1,0,1,0,0,0,0,19,ITA
13d820de,11,7,8,2,1,7,11,4,6,3,3,7,18,38,0,19,ITA
144607cc,35,20,19,13,3,13,41,28,30,3,27,20,55,52,0,19,ITA
149c5f5d,7,5,5,2,0,2,8,6,3,1,2,2,9,13,0,19,ITA
14b8fcdf,8,5,5,3,0,2,5,3,19,14,5,16,24,51,1,19,ITA
157d29b6,24,13,5,15,4,5,21,16,14,2,12,1,25,9,0,19,ITA
15d0c248,27,18,20,7,0,13,20,7,27,15,12,26,53,57,1,19,ITA
162efffd,53,33,21,27,5,13,42,29,35,2,33,32,85,28,0,19,ITA
16657b95,63,34,21,35,7,19,49,30,37,5,32,29,92,48,0,19,ITA
16b9d5cf,20,13,14,6,0,6,12,6,16,10,6,28,48,56,1,19,ITA
173061c0,69,45,52,15,2,33,68,35,60,33,27,66,135,213,2,19,ITA
17f3620a,17,10,4,6,7,4,25,21,25,5,20,4,21,34,0,19,ITA
1880614f,6,3,3,3,0,2,11,9,7,0,7,13,19,5,0,19,ITA
18f9dbd0,26,14,17,6,3,14,20,6,14,3,11,10,36,39,1,19,ITA
197640fd,61,39,30,22,9,32,57,25,32,6,26,28,89,50,0,19,ITA
1ab0b878,1,0,1,0,0,0,0,0,3,0,3,3,4,0,0,19,ITA
1ad1f50d,4,2,0,2,2,0,3,3,6,0,6,1,5,4,0,19,ITA
1b82f8df,34,18,12,20,2,13,42,29,11,1,10,18,52,12,0,19,ITA
1c50f354,14,8,5,7,2,6,31,25,21,2,19,16,30,10,2,19,ITA
1c529186,34,19,16,13,5,14,22,8,19,6,13,18,52,50,0,19,ITA
1c8c5aed,15,10,7,7,1,3,9,6,11,4,7,15,30,43,0,19,ITA
1cac99dc,30,20,10,13,7,8,23,15,19,3,16,15,45,11,0,19,ITA
1cadaf34,2,2,0,1,1,1,1,0,1,0,1,0,2,0,0,19,ITA
1ea5f91c,7,4,5,2,0,4,15,11,18,2,16,9,16,16,0,19,ITA
1f9328da,35,26,7,20,8,10,24,14,17,2,15,8,43,5,0,19,ITA
1fca9171,10,6,3,4,3,4,7,3,12,1,11,5,15,5,0,19,ITA
2114abf9,33,15,12,10,11,8,50,42,28,4,24,8,41,16,0,19,ITA
2146785a,79,51,58,16,5,37,67,30,33,1,32,32,111,78,1,19,ITA
2258c078,6,5,2,3,1,3,8,5,6,3,3,8,14,2,0,19,ITA
228f73ae,11,6,3,6,2,3,6,3,7,0,7,2,13,0,0,19,ITA
230a2fac,66,43,38,23,5,24,44,20,34,13,21,36,102,93,3,19,ITA
2334478a,4,3,0,3,1,2,9,7,3,1,2,3,7,2,0,19,ITA
246d153b,54,36,32,20,2,23,48,25,30,3,27,39,93,59,2,19,ITA
259deea9,0,0,0,0,0,0,0,0,0,0,0,0,0,0,0,19,ITA
2648e18f,0,0,0,0,0,0,1,1,0,0,0,0,0,0,0,19,ITA
269b4638,5,3,2,2,1,1,3,2,3,1,2,0,5,4,0,19,ITA
277da414,0,0,0,0,0,0,1,1,0,0,0,0,0,4,0,19,ITA
27f0ddef,42,26,25,13,4,19,23,4,27,16,11,14,56,84,0,19,ITA
28237d7e,1,1,0,0,1,0,0,0,0,0,0,0,1,0,0,19,ITA
283699b4,18,12,10,6,2,5,14,9,18,13,5,12,30,55,1,19,ITA
2876eaa3,0,0,0,0,0,0,2,2,2,2,0,2,2,11,0,19,ITA
2a1beb34,102,57,32,61,9,34,94,60,48,9,39,53,155,49,1,19,ITA
2a82aa85,3,1,3,0,0,0,0,0,3,1,2,0,3,0,0,19,ITA
2b28ba9f,26,16,9,13,4,16,38,22,18,0,18,17,43,8,1,19,ITA
2b71b88a,10,8,6,3,1,5,6,1,11,3,8,11,21,42,0,19,ITA
2c38b327,9,4,3,4,2,2,6,4,2,0,2,7,16,6,0,19,ITA
2c851997,38,22,12,18,8,11,31,20,28,4,24,8,46,27,0,19,ITA
2d3f7367,0,0,0,0,0,0,0,0,0,0,0,0,0,0,0,19,ITA
2d970560,63,46,32,26,5,37,54,17,41,3,38,38,101,60,0,19,ITA
2ead2809,2,1,2,0,0,1,5,4,2,0,2,1,3,2,0,19,ITA
2ec0f902,17,13,5,9,3,1,10,9,20,2,18,8,25,26,0,19,ITA
2f3452eb,40,28,22,15,3,25,49,24,11,3,8,24,64,51,0,19,ITA
2f557579,14,4,5,6,3,6,18,12,7,0,7,8,22,3,0,19,ITA
2f7407fa,1,1,0,1,0,1,2,1,1,0,1,0,1,0,0,19,ITA
30144daa,0,0,0,0,0,0,0,0,1,0,1,0,0,0,0,19,ITA
30223b33,0,0,0,0,0,0,0,0,0,0,0,0,0,6,1,19,ITA
30f5ffa9,64,37,46,17,1,38,60,22,48,29,19,27,91,138,0,19,ITA
314f2124,11,7,7,4,0,4,8,4,11,7,4,14,25,48,2,19,ITA
3300c14c,3,2,1,2,0,2,3,1,2,1,1,1,4,5,1,19,ITA
331c0a43,58,43,31,22,5,25,49,24,44,11,33,46,104,46,0,19,ITA
339c6ed4,1,0,0,1,0,1,3,2,2,1,1,0,1,4,0,19,ITA
339fe0e8,1,1,1,0,0,1,1,0,0,0,0,1,2,8,1,19,ITA
33b8d077,101,70,47,40,14,31,86,55,45,8,37,44,145,32,3,19,ITA
343c0d52,43,27,10,23,10,7,29,22,26,2,24,4,47,14,0,19,ITA
343f753a,1,1,1,0,0,1,2,1,0,0,0,3,4,21,3,19,ITA
34bb6fbd,46,27,22,17,7,22,40,18,18,3,15,34,80,60,0,19,ITA
3535098b,13,5,6,5,2,6,10,4,11,5,6,13,26,30,0,19,ITA
356c9002,1,1,0,1,0,1,8,7,0,0,0,4,5,9,0,19,ITA
35dd6d80,111,75,64,36,11,57,83,26,40,11,29,70,181,142,0,19,ITA
3626daea,9,4,4,2,3,4,8,4,5,0,5,3,12,7,0,19,ITA
3799e138,11,6,5,5,1,4,7,3,9,1,8,3,14,7,2,19,ITA
384dd218,3,1,3,0,0,3,5,2,4,2,2,0,3,7,0,19,ITA
38ac43d3,10,9,6,2,2,5,9,4,8,3,5,5,15,6,0,19,ITA
3b15ef2d,7,6,6,1,0,3,5,2,10,5,5,16,23,18,0,19,ITA
3b333ac3,43,31,19,19,5,17,34,17,29,5,24,23,66,47,1,19,ITA
3b387cc7,0,0,0,0,0,0,0,0,0,0,0,0,0,0,0,19,ITA
3b61c9ec,29,20,17,11,1,15,27,12,15,4,11,21,50,24,0,19,ITA
3b8674e6,53,34,22,29,2,18,39,21,20,8,12,43,96,42,1,19,ITA
3bb625ac,36,24,17,16,3,14,36,22,31,6,25,26,62,31,0,19,ITA
3bb7af3b,12,6,2,6,4,3,12,9,5,1,4,4,16,10,0,19,ITA
3bb7f478,13,7,3,5,5,4,16,12,10,1,9,0,13,36,1,19,ITA
3c1e4e84,16,7,7,6,3,6,9,3,5,0,5,3,19,1,2,19,ITA
3d50bcdb,0,0,0,0,0,0,1,1,1,0,1,2,2,1,0,19,ITA
3d936ba9,33,15,22,10,1,16,36,20,19,14,5,24,57,78,2,19,ITA
3ead85f9,34,19,26,6,2,16,19,3,48,32,16,37,71,173,1,19,ITA
40f0ed6c,13,11,4,5,4,7,17,10,19,4,15,16,29,25,1,19,ITA
4133cfcf,1,1,1,0,0,0,0,0,2,0,2,0,1,4,0,19,ITA
41bd99ea,0,0,0,0,0,0,1,1,0,0,0,0,0,4,2,19,ITA
41ff002d,4,3,2,1,1,1,3,2,1,0,1,0,4,2,0,19,ITA
422ec08a,7,3,2,5,0,2,10,8,8,2,6,3,10,25,1,19,ITA
42b1a58a,2,1,2,0,0,1,2,1,3,1,2,0,2,2,0,19,ITA
434b8c73,2,0,0,1,1,1,5,4,6,1,5,3,5,5,0,19,ITA
438dfc6a,26,14,13,10,3,15,25,10,20,4,16,17,43,59,0,19,ITA
43a1bea5,28,19,15,6,7,10,26,16,11,3,8,17,45,7,0,19,ITA
43a2e16c,11,9,5,1,5,1,10,9,14,0,14,5,16,5,0,19,ITA
43b78598,9,8,2,2,5,1,6,5,4,1,3,3,12,20,1,19,ITA
440c84ed,13,8,3,8,2,3,16,13,14,0,14,3,16,2,0,19,ITA
4431aed2,12,6,4,3,5,4,9,5,18,1,17,1,13,8,0,19,ITA
44510fde,1,1,0,0,1,0,1,1,1,0,1,0,1,1,0,19,ITA
44ac04e9,50,39,18,23,9,26,53,27,38,9,29,17,67,22,0,19,ITA
44eb9093,69,40,34,27,8,24,57,33,25,8,17,27,96,39,0,19,ITA
455a2b79,19,12,5,10,4,8,25,17,14,1,13,10,29,16,0,19,ITA
45b9b619,21,13,6,12,3,5,18,13,14,3,11,2,23,7,0,19,ITA
4611e028,65,36,35,23,7,22,73,51,35,5,30,50,115,54,1,19,ITA
46a8347f,20,14,8,6,6,9,14,5,5,1,4,11,31,27,1,19,ITA
46f5c54d,75,44,46,25,4,29,56,27,34,22,12,55,130,144,0,19,ITA
47a500ae,26,17,18,8,0,15,20,5,23,15,8,35,61,114,0,19,ITA
4a56052c,64,40,22,31,11,21,52,31,33,7,26,46,110,54,2,19,ITA
4a5a45c7,39,23,16,18,5,10,30,20,20,2,18,12,51,21,0,19,ITA
4b029b31,43,28,34,7,2,19,32,13,29,16,13,57,100,119,0,19,ITA
4bd414c1,16,8,12,4,0,8,15,7,19,16,3,20,36,90,1,19,ITA
4c3a6744,28,27,12,9,7,10,23,13,17,0,17,7,35,12,0,19,ITA
4c62d0c8,0,0,0,0,0,0,0,0,0,0,0,0,0,3,2,19,ITA
4c78b5ed,91,54,40,46,5,38,79,41,27,11,16,52,143,43,3,19,ITA
4cc93246,5,1,2,1,2,1,11,10,9,1,8,2,7,19,0,19,ITA
4d3ab428,1,1,0,1,0,1,1,0,0,0,0,0,1,3,0,19,ITA
4dba2a97,42,25,25,15,2,9,26,17,19,2,17,18,60,39,0,19,ITA
4e219ad2,28,18,10,14,4,10,41,31,26,1,25,16,44,3,0,19,ITA
4e358a2d,28,20,14,11,3,12,25,13,45,33,12,53,81,171,2,19,ITA
4e6dbac4,44,28,17,21,6,23,60,37,28,4,24,27,71,48,0,19,ITA
4e7db402,0,0,0,0,0,0,0,0,0,0,0,1,1,16,4,19,ITA
4f2908e5,23,14,15,5,3,13,16,3,8,3,5,23,46,70,0,19,ITA
4fa7cb9b,10,8,2,8,0,4,9,5,8,0,8,4,14,2,0,19,ITA
4fac8f81,7,6,4,3,0,6,9,3,3,1,2,3,10,12,0,19,ITA
509a4ccb,10,6,4,2,4,2,9,7,8,0,8,3,13,1,0,19,ITA
5128bde4,28,17,13,8,7,14,31,17,21,6,15,20,48,33,0,19,ITA
514f0896,0,0,0,0,0,0,0,0,0,0,0,0,0,0,0,19,ITA
528492ea,33,21,15,15,3,19,48,29,20,6,14,15,48,18,0,19,ITA
5294a83f,53,22,15,29,9,21,55,34,23,3,20,10,63,10,0,19,ITA
52ec54d0,18,9,11,6,1,10,13,3,32,21,11,38,56,88,3,19,ITA
5313ed43,25,13,14,10,1,6,36,30,20,7,13,29,54,18,3,19,ITA
532d2690,16,10,6,7,3,3,14,11,18,12,6,26,42,33,0,19,ITA
539230cf,2,2,1,1,0,0,1,1,1,0,1,0,2,3,0,19,ITA
53a0e358,38,21,16,9,13,15,73,58,31,2,29,27,65,24,0,19,ITA
53de807a,43,27,24,15,4,25,38,13,20,14,6,42,85,85,1,19,ITA
548902cc,26,19,12,11,3,17,45,28,7,0,7,11,37,31,0,19,ITA
54ab361e,1,1,0,0,1,0,1,1,2,0,2,0,1,5,0,19,ITA
54c356b0,27,17,9,15,3,6,14,8,17,8,9,31,58,37,0,19,ITA
54e0c0cc,1,1,0,1,0,1,1,0,0,0,0,0,1,0,0,19,ITA
54e53b7e,15,9,4,9,2,5,12,7,7,0,7,4,19,3,0,19,ITA
550985aa,0,0,0,0,0,0,0,0,1,0,1,0,0,1,0,19,ITA
55667895,30,21,21,9,0,13,20,7,14,6,8,24,54,65,1,19,ITA
56400c01,33,17,22,8,3,18,31,13,36,23,13,23,56,108,0,19,ITA
56b2957b,18,11,8,8,2,8,23,15,20,4,16,17,35,6,0,19,ITA
570bb4b9,67,38,26,32,9,27,72,45,29,4,25,30,97,17,0,19,ITA
5710a281,60,33,31,25,4,20,45,25,19,3,16,22,82,21,1,19,ITA
58027adc,16,12,6,9,1,7,12,5,8,2,6,6,22,18,0,19,ITA
585a73a8,15,8,11,4,0,4,7,3,36,28,8,29,44,210,0,19,ITA
58d97e77,2,1,0,0,2,0,3,3,4,2,2,4,6,7,0,19,ITA
58e933d2,31,22,8,16,7,2,13,11,23,3,20,25,56,28,0,19,ITA
59a3efba,2,2,0,2,0,0,0,0,0,0,0,0,2,0,0,19,ITA
59bf127b,69,43,22,40,7,26,62,36,34,5,29,50,119,42,2,19,ITA
5aa53281,40,30,22,17,1,16,29,13,19,4,15,48,88,77,1,19,ITA
5aaef9ef,51,32,17,29,5,19,53,34,27,7,20,17,68,37,1,19,ITA
5bd72174,13,9,2,4,7,3,10,7,11,1,10,2,15,11,0,19,ITA
5bdd44d8,0,0,0,0,0,0,0,0,0,0,0,0,0,0,0,19,ITA
5cec2c74,46,21,13,22,11,23,46,23,46,6,40,29,75,26,0,19,ITA
5d4f7d61,11,5,3,5,3,1,19,18,19,2,17,3,14,15,1,19,ITA
5df4ef30,8,8,2,3,3,5,11,6,4,1,3,8,16,21,0,19,ITA
5e861944,18,7,9,4,5,8,30,22,18,0,18,14,32,10,1,19,ITA
5eb72339,34,25,12,18,4,14,33,19,18,5,13,14,48,54,0,19,ITA
5efc5389,14,8,8,3,3,6,11,5,18,3,15,19,33,33,0,19,ITA
5fd5ed86,3,1,1,2,0,1,2,1,4,1,3,8,11,9,0,19,ITA
601ef102,13,7,4,5,4,2,8,6,6,1,5,0,13,16,1,19,ITA
605873e1,26,21,11,12,3,10,20,10,13,3,10,39,65,50,0,19,ITA
614c38fb,22,15,9,11,2,7,17,10,12,1,11,14,36,15,0,19,ITA
616aea37,53,33,37,15,1,26,46,20,44,31,13,34,87,101,2,19,ITA
618ab91f,0,0,0,0,0,0,0,0,0,0,0,0,0,0,0,19,ITA
61b3978f,46,30,27,15,4,24,51,27,22,7,15,31,77,76,0,19,ITA
6213fd82,2,0,1,0,1,0,1,1,0,0,0,3,5,0,0,19,ITA
62437b4f,65,40,25,30,10,15,43,28,28,3,25,29,94,34,0,19,ITA
63071a3f,62,43,50,11,1,27,47,20,40,26,14,37,99,178,3,19,ITA
635b0bae,14,7,5,5,4,8,25,17,16,8,8,9,23,48,0,19,ITA
6378443d,3,1,2,1,0,0,3,3,3,3,0,7,10,18,0,19,ITA
644faf10,8,4,2,6,0,2,6,4,0,0,0,5,13,0,0,19,ITA
649b01d8,4,3,4,0,0,3,3,0,0,0,0,1,5,21,4,19,ITA
64cd167d,58,38,37,19,2,25,42,17,32,13,19,64,122,107,1,19,ITA
65e4dede,6,3,5,1,0,2,4,2,2,1,1,12,18,19,1,19,ITA
67f649be,0,0,0,0,0,0,1,1,0,0,0,1,1,11,4,19,ITA
6817095b,0,0,0,0,0,0,0,0,0,0,0,0,0,0,0,19,ITA
68252d6d,15,7,2,7,6,5,20,15,20,1,19,5,20,2,0,19,ITA
68b78c2a,20,14,15,4,1,6,10,4,31,20,11,14,34,103,0,19,ITA
6928979a,99,65,38,41,20,30,82,52,61,2,59,38,137,27,0,19,ITA
6aafdc27,9,7,5,4,0,7,10,3,5,1,4,13,22,34,0,19,ITA
6b99d135,30,22,18,10,2,9,17,8,8,1,7,11,41,11,1,19,ITA
6c1f7328,20,14,7,7,6,1,13,12,26,2,24,6,26,27,0,19,ITA
6cc97b6a,20,12,7,10,3,2,10,8,8,2,6,8,28,10,0,19,ITA
6e058f06,0,0,0,0,0,0,0,0,0,0,0,0,0,0,0,19,ITA
6e4df551,19,14,5,10,4,6,30,24,21,0,21,16,35,4,0,19,ITA
6eee05f1,32,22,18,12,2,13,29,16,21,11,10,34,66,96,0,19,ITA
6fe90922,34,26,7,20,7,16,51,35,40,4,36,23,57,55,0,19,ITA
714ffae7,1,0,0,0,1,1,2,1,0,0,0,0,1,0,0,19,ITA
71dac2c2,0,0,0,0,0,0,0,0,0,0,0,0,0,1,0,19,ITA
71dc23da,8,4,6,1,1,6,14,8,2,0,2,4,12,22,0,19,ITA
72c803a0,1,1,1,0,0,0,1,1,1,0,1,0,1,2,0,19,ITA
74419746,1,0,1,0,0,1,1,0,0,0,0,0,1,12,1,19,ITA
75374ee7,0,0,0,0,0,0,0,0,1,0,1,0,0,1,0,19,ITA
756959aa,44,27,22,19,3,19,58,39,22,1,21,17,61,12,1,19,ITA
75b86fb3,25,12,20,5,0,6,15,9,26,18,8,22,47,96,0,19,ITA
75e60d75,19,10,3,14,2,5,9,4,10,2,8,8,27,24,1,19,ITA
75efed2e,11,10,3,6,2,6,9,3,3,0,3,1,12,5,0,19,ITA
7602ddf6,0,0,0,0,0,0,0,0,0,0,0,0,0,1,0,19,ITA
7737dee2,0,0,0,0,0,0,0,0,0,0,0,1,1,0,0,19,ITA
77e401c7,0,0,0,0,0,0,0,0,0,0,0,0,0,2,0,19,ITA
780e3631,4,2,0,4,0,2,3,1,2,1,1,0,4,4,0,19,ITA
78841da9,34,18,12,14,8,18,57,39,34,5,29,22,56,11,0,19,ITA
788b31e2,29,21,15,13,1,11,21,10,13,5,8,25,54,12,2,19,ITA
79083382,37,29,30,5,2,17,30,13,20,12,8,16,53,41,0,19,ITA
79443529,0,0,0,0,0,0,0,0,2,0,2,0,0,4,0,19,ITA
7a20d90a,8,4,4,4,0,5,8,3,13,6,7,24,32,45,0,19,ITA
7afb1573,4,2,3,1,0,1,4,3,0,0,0,3,7,0,0,19,ITA
7b536033,18,13,1,11,6,1,17,16,10,2,8,5,23,20,0,19,ITA
7b5f516f,0,0,0,0,0,0,0,0,0,0,0,0,0,0,0,19,ITA
7ba2eaa9,0,0,0,0,0,0,0,0,1,0,1,0,0,0,0,19,ITA
7c0000fd,1,1,0,1,0,1,2,1,2,2,0,4,5,10,0,19,ITA
7d3cbc67,53,33,19,24,10,24,54,30,34,1,33,28,81,24,1,19,ITA
7d50454d,40,24,28,11,1,13,22,9,34,24,10,20,60,111,2,19,ITA
7d86864c,16,13,7,9,0,5,16,11,2,0,2,4,20,9,0,19,ITA
7e81a17d,4,2,2,2,0,2,8,6,8,2,6,1,5,4,0,19,ITA
7eb97a8e,29,17,9,14,6,9,27,18,13,1,12,9,38,4,0,19,ITA
7ed4921e,31,15,21,9,1,13,24,11,53,41,12,40,71,200,2,19,ITA
7f267d66,19,11,5,13,1,7,23,16,29,4,25,17,36,18,0,19,ITA
7f50c23b,0,0,0,0,0,0,0,0,0,0,0,1,1,0,0,19,ITA
7f622eef,24,16,11,8,5,10,23,13,14,4,10,19,43,13,2,19,ITA
7f78ad23,57,32,34,21,2,32,39,7,25,5,20,38,95,98,0,19,ITA
7fd58fe3,71,43,37,27,7,32,76,44,27,3,24,49,120,58,1,19,ITA
806f7a26,0,0,0,0,0,0,0,0,0,0,0,0,0,0,0,19,ITA
81255c03,17,12,4,8,5,4,11,7,14,5,9,6,23,14,0,19,ITA
817c6964,38,23,21,14,3,14,41,27,35,12,23,24,62,32,0,19,ITA
822a7761,5,4,1,2,2,2,6,4,8,2,6,6,11,5,0,19,ITA
82b1198a,1,0,1,0,0,1,1,0,0,0,0,0,1,7,1,19,ITA
82efe6fa,0,0,0,0,0,0,0,0,0,0,0,0,0,1,0,19,ITA
839c14e1,8,6,2,4,2,4,7,3,4,1,3,2,10,3,0,19,ITA
83e4643e,6,4,1,1,4,2,11,9,15,4,11,5,11,8,0,19,ITA
84594618,14,9,10,4,0,4,8,4,20,12,8,19,33,68,0,19,ITA
854ee61a,40,29,10,16,14,9,21,12,15,0,15,3,43,9,0,19,ITA
85613cf0,19,9,1,8,10,1,20,19,7,2,5,3,22,15,0,19,ITA
85b011bb,0,0,0,0,0,0,0,0,0,0,0,0,0,3,0,19,ITA
85ea4399,0,0,0,0,0,0,1,1,0,0,0,0,0,0,0,19,ITA
86015b20,10,6,5,4,1,0,10,10,5,2,3,5,15,7,0,19,ITA
8650af85,41,23,27,12,2,12,16,4,36,20,16,36,77,97,1,19,ITA
86695068,62,44,30,25,7,27,51,24,33,4,29,36,98,31,0,19,ITA
868c6958,0,0,0,0,0,0,0,0,0,0,0,0,0,0,0,19,ITA
8697c095,4,4,3,0,1,1,4,3,6,1,5,1,5,1,0,19,ITA
878ee034,4,3,1,1,2,3,4,1,8,1,7,2,6,8,0,19,ITA
881ef58c,10,4,4,3,3,4,16,12,7,0,7,3,13,5,0,19,ITA
8827bf46,42,26,22,15,5,12,38,26,46,9,37,16,58,32,0,19,ITA
88895312,60,35,28,23,9,11,39,28,30,4,26,19,79,16,1,19,ITA
88c89891,14,6,8,6,0,8,12,4,11,7,4,15,29,27,0,19,ITA
895ff3ca,15,10,5,8,2,3,17,14,2,0,2,3,18,2,1,19,ITA
89976232,76,50,35,35,6,33,53,20,52,24,28,88,164,149,2,19,ITA
89b2c8a9,19,11,2,7,10,1,21,20,7,0,7,13,32,3,0,19,ITA
8a08491a,8,6,1,5,2,5,13,8,3,0,3,0,8,11,1,19,ITA
8abd0c03,30,23,21,6,3,16,24,8,11,2,9,17,47,38,0,19,ITA
8b66d9cc,0,0,0,0,0,0,0,0,0,0,0,0,0,0,0,19,ITA
8b95acda,18,11,12,6,0,12,13,1,24,16,8,22,40,102,0,19,ITA
8c725b43,56,36,42,13,1,31,51,20,42,30,12,60,116,159,1,19,ITA
8cabdc1e,0,0,0,0,0,0,2,2,0,0,0,1,1,15,6,19,ITA
8cc29864,31,22,19,9,3,15,19,4,27,21,6,24,55,92,0,19,ITA
8cea6319,36,25,21,13,2,16,32,16,29,18,11,17,53,88,1,19,ITA
8d8178ac,24,13,8,12,4,4,34,30,35,0,35,5,29,13,0,19,ITA
8e45910b,35,25,23,9,3,15,31,16,24,4,20,13,48,48,0,19,ITA
8e809937,0,0,0,0,0,0,0,0,0,0,0,0,0,0,0,19,ITA
8f866fe8,5,2,1,3,1,3,11,8,6,1,5,4,9,4,0,19,ITA
8fef5412,9,5,3,4,2,2,9,7,4,0,4,15,24,12,1,19,ITA
905a4f61,4,3,1,2,1,2,2,0,0,0,0,1,5,0,0,19,ITA
9085dd7c,46,29,20,16,10,13,43,30,28,2,26,15,61,38,0,19,ITA
90b70194,53,27,27,23,3,20,68,48,25,1,24,30,83,24,2,19,ITA
91899ca8,41,22,30,8,3,19,27,8,26,19,7,29,70,114,0,19,ITA
921f6058,49,31,31,15,3,23,38,15,34,17,17,68,117,79,0,19,ITA
92948398,21,13,10,10,1,4,17,13,29,13,16,34,55,31,1,19,ITA
92b4758e,47,33,27,18,2,19,25,6,18,9,9,34,81,96,0,19,ITA
92d83c27,22,11,14,7,1,11,25,14,25,6,19,11,33,16,2,19,ITA
93390969,9,4,2,5,2,5,9,4,6,3,3,4,13,33,0,19,ITA
933d3b51,37,23,27,9,1,12,20,8,26,19,7,24,61,72,1,19,ITA
93b891d1,16,12,4,6,6,1,8,7,9,2,7,5,21,5,0,19,ITA
93cf32a8,45,29,34,10,1,15,25,10,42,28,14,70,115,174,2,19,ITA
9413b19f,0,0,0,0,0,0,0,0,0,0,0,0,0,3,1,19,ITA
94230890,3,2,2,1,0,0,0,0,0,0,0,3,6,3,0,19,ITA
94816803,1,1,0,1,0,1,1,0,0,0,0,0,1,0,0,19,ITA
952a03fe,16,11,10,6,0,4,14,10,30,22,8,13,29,125,0,19,ITA
958a601f,29,18,17,8,4,16,32,16,15,4,11,24,53,41,1,19,ITA
9592289a,20,9,3,12,5,1,8,7,12,1,11,4,24,9,0,19,ITA
96960855,20,11,12,4,4,9,23,14,8,1,7,6,26,15,1,19,ITA
970b8574,22,7,10,8,4,10,20,10,13,6,7,15,37,27,0,19,ITA
97e2aa67,2,2,0,1,1,1,2,1,2,0,2,0,2,1,0,19,ITA
9866afec,3,1,2,1,0,0,2,2,0,0,0,0,3,0,0,19,ITA
98d2c2c4,84,45,34,34,16,30,70,40,62,12,50,38,122,45,0,19,ITA
98e958af,16,9,8,7,1,5,16,11,13,3,10,13,29,14,0,19,ITA
9907b1c8,35,21,7,18,10,7,37,30,14,0,14,13,48,8,0,19,ITA
997fff07,8,6,5,2,1,2,5,3,7,3,4,13,21,30,0,19,ITA
9a560ebe,7,6,3,4,0,0,2,2,8,6,2,7,14,39,1,19,ITA
9b30df1e,17,10,12,5,0,6,14,8,27,19,8,27,44,143,1,19,ITA
9b6f7fd5,18,9,9,8,1,7,24,17,12,0,12,4,22,11,2,19,ITA
9be4ee80,1,0,0,0,1,0,1,1,0,0,0,0,1,1,0,19,ITA
9d4c45d6,36,23,14,15,7,9,32,23,30,2,28,9,45,12,0,19,ITA
9e1577aa,52,33,31,17,4,18,38,20,40,17,23,44,96,113,0,19,ITA
9f84febe,9,6,3,5,1,5,11,6,4,2,2,12,21,12,1,19,ITA
9fa26bc2,0,0,0,0,0,0,0,0,0,0,0,0,0,1,0,19,ITA
a111cf41,0,0,0,0,0,0,1,1,0,0,0,0,0,10,4,19,ITA
a1216563,6,1,2,2,2,2,6,4,3,0,3,3,9,3,0,19,ITA
a1bedc05,2,1,1,0,1,1,1,0,1,0,1,0,2,1,0,19,ITA
a1c7b425,4,2,2,1,1,2,5,3,5,0,5,3,7,4,0,19,ITA
a39b9ef6,8,5,1,3,4,2,3,1,4,1,3,1,9,5,0,19,ITA
a3d94a58,61,35,38,18,5,27,40,13,49,27,22,37,98,128,1,19,ITA
a40d5a0c,14,12,5,5,4,6,19,13,4,0,4,4,18,2,0,19,ITA
a440d8ca,1,1,1,0,0,0,1,1,1,0,1,4,5,5,0,19,ITA
a4fe8cda,9,5,0,3,6,2,16,14,13,2,11,7,16,13,0,19,ITA
a5296e55,41,25,11,20,10,13,34,21,30,4,26,20,61,18,0,19,ITA
a64cbd35,64,36,40,17,7,19,53,34,40,13,27,36,100,50,1,19,ITA
a65ce836,64,38,28,27,9,24,40,16,43,13,30,28,92,36,2,19,ITA
a6e316c1,3,0,3,0,0,2,3,1,1,0,1,2,5,8,0,19,ITA
a6fc1a22,0,0,0,0,0,0,0,0,0,0,0,0,0,0,0,19,ITA
a74d2999,3,1,0,2,1,0,2,2,0,0,0,0,3,0,0,19,ITA
a8a874f1,44,28,19,15,10,13,29,16,21,3,18,27,71,33,1,19,ITA
aa51343f,17,7,8,4,5,6,15,9,17,0,17,4,21,10,0,19,ITA
aa5a409a,46,27,25,19,2,16,54,38,45,10,35,32,78,28,1,19,ITA
ab1ca213,31,20,14,13,4,9,26,17,12,1,11,13,44,21,0,19,ITA
ab4449d6,0,0,0,0,0,0,0,0,0,0,0,3,3,12,4,19,ITA
ac4003af,1,0,1,0,0,1,1,0,1,0,1,0,1,8,2,19,ITA
acdad0aa,7,6,2,4,1,1,4,3,2,1,1,3,10,3,0,19,ITA
ad6df2d5,41,20,15,18,8,16,59,43,34,6,28,36,77,19,2,19,ITA
ae4e2852,40,28,24,14,2,17,28,11,18,6,12,26,66,58,1,19,ITA
ae64d449,54,33,27,22,5,28,63,35,28,5,23,26,80,41,0,19,ITA
ae82fa48,6,5,3,2,1,2,4,2,6,1,5,4,10,1,0,19,ITA
af45e954,1,1,0,0,1,0,3,3,1,0,1,0,1,1,0,19,ITA
afa0d4e0,34,25,13,15,6,9,18,9,17,5,12,13,47,22,0,19,ITA
afe31d55,0,0,0,0,0,0,0,0,2,0,2,0,0,0,0,19,ITA
b0243215,19,12,12,5,2,5,14,9,14,7,7,18,37,47,0,19,ITA
b09a3ecc,8,6,2,5,1,3,7,4,4,0,4,3,11,9,0,19,ITA
b0f7e36c,46,27,8,17,21,10,40,30,24,1,23,10,56,12,0,19,ITA
b136c945,2,1,0,2,0,0,2,2,2,1,1,0,2,0,0,19,ITA
b1deecf8,23,16,15,7,1,9,10,1,18,15,3,8,31,59,0,19,ITA
b32e8c5f,4,2,1,2,1,0,3,3,4,0,4,0,4,1,0,19,ITA
b3fd7075,65,47,30,28,7,24,67,43,36,5,31,35,100,13,2,19,ITA
b5bf1770,30,19,20,10,0,13,18,5,25,17,8,26,56,69,0,19,ITA
b5cae4e6,13,9,3,5,5,1,2,1,2,0,2,1,14,0,0,19,ITA
b6667741,2,1,0,2,0,0,1,1,0,0,0,0,2,0,0,19,ITA
b6b2b820,12,9,3,7,2,5,11,6,8,2,6,5,17,1,0,19,ITA
b6ca47a2,31,17,22,5,4,17,26,9,29,24,5,21,52,165,0,19,ITA
b70bde8f,36,20,15,18,3,6,30,24,36,7,29,33,69,17,0,19,ITA
b7a5bc86,63,43,37,18,8,25,54,29,48,4,44,54,117,83,2,19,ITA
b8673e18,3,1,3,0,0,2,2,0,5,3,2,4,7,20,0,19,ITA
b871bf55,16,9,15,1,0,10,17,7,8,5,3,18,34,29,0,19,ITA
b96b595c,40,30,22,13,5,12,16,4,50,32,18,61,101,169,1,19,ITA
ba3d3bea,12,7,4,5,3,2,9,7,3,0,3,7,19,6,0,19,ITA
bbafc0c4,50,26,19,21,10,15,30,15,21,4,17,15,65,31,0,19,ITA
bd6351cd,43,28,18,18,7,27,49,22,14,4,10,15,58,48,0,19,ITA
bd84fc61,43,27,18,21,4,13,38,25,17,5,12,22,65,25,1,19,ITA
bdd0692f,10,4,5,5,0,5,11,6,6,0,6,7,17,6,0,19,ITA
be5e1c4c,2,1,0,1,1,1,4,3,0,0,0,0,2,0,0,19,ITA
be6c1ccc,0,0,0,0,0,0,0,0,2,0,2,0,0,2,0,19,ITA
bee704fc,59,40,36,21,2,17,33,16,39,21,18,48,107,143,0,19,ITA
bef22bc4,3,2,0,2,1,2,4,2,1,0,1,0,3,1,0,19,ITA
bf309d24,12,4,1,9,2,4,5,1,6,0,6,11,23,12,0,19,ITA
c010b898,30,14,21,9,0,8,21,13,29,15,14,65,95,129,0,19,ITA
c01c66d9,22,17,16,4,2,17,27,10,16,8,8,7,29,49,1,19,ITA
c0c7ff58,54,33,22,25,7,20,46,26,23,4,19,21,75,29,2,19,ITA
c0cddebe,59,33,25,21,13,20,36,16,33,8,25,26,85,21,1,19,ITA
c1bcb2df,1,1,0,0,1,0,0,0,0,0,0,0,1,0,0,19,ITA
c1c2c925,45,27,22,19,4,16,30,14,23,9,14,31,76,41,0,19,ITA
c1d18f10,16,10,9,7,0,7,17,10,14,8,6,14,30,60,2,19,ITA
c316607a,2,1,1,1,0,0,2,2,2,2,0,1,3,2,0,19,ITA
c414df9d,33,19,13,14,6,13,29,16,23,0,23,19,52,17,1,19,ITA
c4efe2b4,1,1,1,0,0,0,0,0,0,0,0,0,1,0,0,19,ITA
c4f573f4,0,0,0,0,0,0,0,0,0,0,0,0,0,1,0,19,ITA
c53083ad,10,6,1,8,1,1,6,5,11,6,5,10,20,21,0,19,ITA
c56dc39e,27,17,15,9,3,16,24,8,28,10,18,33,60,54,1,19,ITA
c5adc293,9,7,3,5,1,8,9,1,6,2,4,8,17,17,0,19,ITA
c6e8cf1f,21,11,5,11,5,5,16,11,13,4,9,12,33,11,0,19,ITA
c707411f,32,24,23,8,1,17,26,9,34,25,9,50,82,117,2,19,ITA
c710f7d5,20,15,12,7,1,8,14,6,4,2,2,5,25,9,0,19,ITA
c7259b83,66,35,25,34,7,24,69,45,49,9,40,43,109,59,0,19,ITA
c7526c18,66,45,24,36,6,21,34,13,40,24,16,27,93,55,2,19,ITA
c77be0cf,20,14,15,2,3,11,19,8,10,5,5,14,34,55,1,19,ITA
c8a88acd,0,0,0,0,0,0,1,1,0,0,0,0,0,1,0,19,ITA
c8c0dccd,1,1,0,1,0,0,1,1,2,0,2,1,2,2,0,19,ITA
cc700722,106,70,39,55,12,36,107,71,55,13,42,36,142,28,0,19,ITA
cce9f582,11,9,9,2,0,6,15,9,17,13,4,16,27,99,1,19,ITA
cd0fa27b,52,31,27,16,9,23,46,23,27,5,22,28,80,19,0,19,ITA
cdf65d12,29,18,25,3,1,15,21,6,22,12,10,24,53,39,0,19,ITA
ce1806be,28,13,11,14,3,9,18,9,10,0,10,10,38,4,0,19,ITA
ce30bfc8,23,14,13,8,2,10,27,17,21,3,18,16,39,19,0,19,ITA
ce5b170a,4,2,1,3,0,1,2,1,3,1,2,1,5,4,0,19,ITA
cecbce23,0,0,0,0,0,0,1,1,0,0,0,1,1,14,1,19,ITA
cedb3e36,67,38,23,31,13,16,57,41,40,5,35,27,94,30,0,19,ITA
cf961d8d,5,3,3,2,0,1,2,1,2,2,0,2,7,14,0,19,ITA
cfbf9881,48,32,30,16,2,19,32,13,21,12,9,19,67,66,1,19,ITA
d023d70f,72,48,26,32,14,15,69,54,39,4,35,25,97,17,0,19,ITA
d0643f8f,2,2,2,0,0,0,2,2,0,0,0,1,3,1,0,19,ITA
d0d8dd44,25,16,14,10,1,8,15,7,32,23,9,25,50,95,1,19,ITA
d0dbca9f,10,8,4,6,0,5,7,2,7,4,3,9,19,26,0,19,ITA
d183e9d6,83,59,42,25,16,41,54,13,50,22,28,41,124,99,0,19,ITA
d37b0350,32,21,6,17,9,6,16,10,12,3,9,7,39,26,0,19,ITA
d3aaad90,27,14,14,8,5,9,24,15,11,2,9,20,47,9,0,19,ITA
d3d758d8,65,38,25,34,6,18,44,26,29,12,17,18,83,26,0,19,ITA
d3de9af0,9,5,3,2,4,1,9,8,26,6,20,4,13,25,0,19,ITA
d417b306,11,4,2,9,0,2,9,7,2,0,2,3,14,4,0,19,ITA
d4535821,32,15,14,14,4,16,25,9,25,4,21,24,56,36,0,19,ITA
d541e703,34,21,16,15,3,19,27,8,28,17,11,30,64,99,1,19,ITA
d5575935,8,5,1,6,1,4,6,2,6,0,6,4,12,3,0,19,ITA
d61b3354,17,13,11,6,0,8,17,9,13,7,6,30,47,60,2,19,ITA
d6a889ea,43,31,23,14,6,23,36,13,18,4,14,44,87,67,0,19,ITA
d705ba44,33,22,8,15,10,6,30,24,36,5,31,15,48,23,0,19,ITA
d711d04f,14,10,0,10,4,2,8,6,7,0,7,1,15,3,0,19,ITA
d7403bd5,27,9,9,12,6,4,11,7,11,1,10,12,39,16,0,19,ITA
d7d32194,3,2,2,0,1,0,0,0,4,0,4,0,3,6,0,19,ITA
d9624b51,13,10,8,3,2,5,9,4,12,8,4,21,34,40,0,19,ITA
d97f2e8d,74,43,37,32,5,34,67,33,42,16,26,35,109,99,3,19,ITA
d995ed27,6,2,2,4,0,2,7,5,3,0,3,7,13,8,0,19,ITA
da5a981b,38,23,20,14,4,23,41,18,11,3,8,20,58,47,2,19,ITA
da974c7b,61,40,37,22,2,19,36,17,55,33,22,40,101,144,0,19,ITA
db092d3b,94,57,43,41,10,32,75,43,38,9,29,57,151,34,0,19,ITA
dbe5a587,2,1,2,0,0,1,2,1,2,1,1,3,5,10,1,19,ITA
dc1c2fce,31,20,12,17,2,14,34,20,20,1,19,8,39,14,0,19,ITA
dc61b402,5,2,3,1,1,2,3,1,4,1,3,6,11,7,0,19,ITA
dd52d069,0,0,0,0,0,0,0,0,0,0,0,0,0,0,0,19,ITA
dd7febd8,0,0,0,0,0,0,0,0,0,0,0,0,0,0,0,19,ITA
de045b15,28,24,21,7,0,18,28,10,31,24,7,34,62,139,1,19,ITA
dea698d9,10,7,5,4,1,1,11,10,7,2,5,6,16,32,0,19,ITA
df0a4c90,4,2,1,2,1,2,5,3,2,0,2,10,14,16,0,19,ITA
df301450,13,5,1,5,7,1,7,6,6,2,4,2,15,6,0,19,ITA
df3cda47,3,3,0,2,1,1,3,2,1,0,1,0,3,0,0,19,ITA
df85d472,18,10,6,8,4,2,23,21,20,2,18,9,27,30,0,19,ITA
dfb933e0,11,6,3,6,2,3,12,9,7,1,6,2,13,8,1,19,ITA
e0314d87,28,14,13,15,0,17,29,12,21,6,15,44,72,49,0,19,ITA
e0921a4f,17,8,3,9,5,7,23,16,20,2,18,14,31,1,0,19,ITA
e14ec482,40,24,16,18,6,9,39,30,23,2,21,14,54,25,1,19,ITA
e1b0a70d,0,0,0,0,0,0,0,0,0,0,0,1,1,5,1,19,ITA
e288d4b3,38,21,22,11,5,17,37,20,27,5,22,46,84,58,0,19,ITA
e327bd76,43,25,22,15,6,22,51,29,20,5,15,23,66,45,1,19,ITA
e33f36d5,50,35,34,13,3,25,33,8,44,27,17,29,79,126,0,19,ITA
e34fc66d,40,27,31,8,1,19,31,12,30,15,15,35,75,147,1,19,ITA
e358587b,0,0,0,0,0,0,0,0,0,0,0,0,0,1,0,19,ITA
e3cceee6,24,16,23,1,0,10,13,3,16,11,5,19,43,80,0,19,ITA
e468c053,19,12,11,5,3,5,13,8,7,0,7,10,29,2,0,19,ITA
e50613bd,0,0,0,0,0,0,0,0,0,0,0,0,0,0,0,19,ITA
e599253a,32,19,9,13,10,7,29,22,19,4,15,12,44,14,1,19,ITA
e5b98a70,25,13,8,13,4,8,23,15,19,4,15,19,44,17,1,19,ITA
e5bf73f3,9,5,5,3,1,4,6,2,4,0,4,0,9,2,0,19,ITA
e5cd9da6,4,4,2,0,2,2,3,1,0,0,0,1,5,9,0,19,ITA
e6ad16b2,7,5,2,4,1,0,11,11,8,1,7,12,19,14,1,19,ITA
e74f0e59,15,11,8,5,2,7,24,17,53,3,50,22,37,69,2,19,ITA
e7ee38c3,0,0,0,0,0,0,1,1,1,0,1,0,0,10,4,19,ITA
e85fb9b8,24,13,20,2,2,5,8,3,22,15,7,30,54,96,1,19,ITA
e8c930bb,33,20,10,19,4,16,37,21,27,9,18,33,66,20,1,19,ITA
e921b9db,1,1,1,0,0,0,1,1,1,0,1,3,4,2,0,19,ITA
e94d79e3,11,5,9,1,1,8,10,2,10,3,7,4,15,26,1,19,ITA
ea06dd97,65,45,22,34,9,16,44,28,30,6,24,34,99,32,0,19,ITA
ea164f99,18,13,9,8,1,9,33,24,22,10,12,23,41,33,0,19,ITA
eb2fe5b6,19,11,4,13,2,6,18,12,10,0,10,3,22,1,0,19,ITA
eb823875,0,0,0,0,0,0,0,0,0,0,0,0,0,0,0,19,ITA
ec5dae45,8,4,4,3,1,0,6,6,4,0,4,10,18,0,0,19,ITA
eccbe56a,17,13,2,11,4,5,22,17,20,1,19,8,25,8,1,19,ITA
ed5886d2,68,45,24,37,7,18,56,38,48,11,37,28,96,56,0,19,ITA
ed6ea4d9,7,6,4,3,0,0,4,4,6,0,6,2,9,8,0,19,ITA
ed90babd,5,2,0,3,2,2,11,9,6,0,6,2,7,0,1,19,ITA
eda40760,38,26,22,10,6,21,34,13,23,15,8,41,79,82,2,19,ITA
edd6c8e9,24,16,6,13,5,9,14,5,24,5,19,18,42,66,0,19,ITA
ee4f2f3b,14,8,6,4,4,2,15,13,32,1,31,8,22,17,0,19,ITA
ee833569,0,0,0,0,0,0,2,2,0,0,0,0,0,5,3,19,ITA
ee93c1a9,14,8,5,6,3,7,18,11,9,0,9,6,20,10,0,19,ITA
ef2e5e1a,2,2,1,0,1,0,1,1,5,0,5,2,4,2,0,19,ITA
ef5b337e,14,10,7,7,0,3,9,6,17,0,17,12,26,28,0,19,ITA
f0021247,28,16,9,15,4,9,31,22,14,0,14,6,34,4,1,19,ITA
f02dde20,0,0,0,0,0,0,0,0,0,0,0,1,1,3,0,19,ITA
f058ed1f,0,0,0,0,0,0,0,0,0,0,0,0,0,0,0,19,ITA
f0f7f62f,2,2,2,0,0,1,2,1,0,0,0,0,2,3,2,19,ITA
f1675fdd,2,1,1,1,0,2,4,2,0,0,0,2,4,1,0,19,ITA
f1cfc209,75,44,25,41,9,31,68,37,35,5,30,42,117,71,1,19,ITA
f1f1f238,18,13,13,3,2,9,16,7,9,7,2,18,36,34,0,19,ITA
f201798c,2,0,1,1,0,0,2,2,1,0,1,1,3,0,0,19,ITA
f26e3c59,26,13,14,7,5,13,22,9,23,3,20,8,34,12,0,19,ITA
f2c1300a,64,42,38,25,1,17,27,10,28,13,15,74,138,141,2,19,ITA
f45f9427,33,24,18,14,1,12,21,9,9,3,6,8,41,20,0,19,ITA
f4ec4fd0,5,4,0,4,1,1,4,3,7,3,4,3,8,13,0,19,ITA
f503ea63,61,39,16,38,7,37,68,31,42,12,30,53,114,62,1,19,ITA
f54dfca8,14,11,4,8,2,6,15,9,8,3,5,12,26,12,0,19,ITA
f554e29b,0,0,0,0,0,0,1,1,0,0,0,2,2,19,1,19,ITA
f6a06749,0,0,0,0,0,0,0,0,0,0,0,0,0,0,0,19,ITA
f7036e1c,6,5,0,2,4,2,6,4,16,0,16,3,9,7,0,19,ITA
f7223718,19,11,8,8,3,8,15,7,14,7,7,12,31,29,1,19,ITA
f794b426,0,0,0,0,0,0,0,0,0,0,0,0,0,1,0,19,ITA
f91e81c9,42,20,24,14,4,22,44,22,27,8,19,26,68,98,1,19,ITA
fb2c533b,22,15,9,12,1,7,32,25,14,2,12,19,41,12,1,19,ITA
fb77bfef,40,24,31,8,1,15,33,18,38,21,17,36,76,79,0,19,ITA
fba81826,33,20,19,9,5,15,23,8,9,3,6,20,53,43,0,19,ITA
fcd20025,1,1,1,0,0,1,2,1,3,2,1,0,1,1,0,19,ITA
fe012aca,7,4,5,1,1,4,14,10,19,0,19,2,9,4,0,19,ITA
fe0b8f0e,4,0,1,2,1,1,1,0,2,0,2,1,5,2,0,19,ITA
fe154b26,10,4,3,5,2,3,10,7,4,0,4,6,16,2,0,19,ITA
fed5f993,40,26,29,11,0,20,30,10,52,39,13,37,77,182,3,19,ITA
ff800ed8,35,22,19,11,5,21,34,13,25,5,20,32,67,89,0,19,ITA
0118c54c,56,30,38,14,4,24,46,22,20,10,10,47,103,63,0,19,FRA
03bd0bf4,5,3,4,1,0,2,4,2,5,2,3,5,10,23,0,19,FRA
0515a4cb,40,24,28,12,0,24,38,14,19,10,9,50,90,140,5,19,FRA
0557ff4f,29,20,13,13,3,6,17,11,17,2,15,15,44,25,1,19,FRA
05816e19,29,13,11,12,6,13,46,33,23,3,20,22,51,18,0,19,FRA
0589c701,0,0,0,0,0,0,1,1,0,0,0,0,0,0,0,19,FRA
0630eb63,8,5,1,5,2,5,16,11,3,0,3,5,13,4,0,19,FRA
0670ee51,1,0,1,0,0,1,1,0,1,0,1,0,1,0,0,19,FRA
06c48679,52,28,30,21,1,28,52,24,40,15,25,45,97,82,3,19,FRA
06df8256,25,18,18,7,0,17,25,8,12,5,7,21,46,79,2,19,FRA
06f33dc8,20,14,10,8,2,8,13,5,5,0,5,4,24,28,1,19,FRA
07a821e4,13,7,3,8,2,5,9,4,3,1,2,3,16,1,1,19,FRA
08082af0,31,21,23,8,0,14,22,8,16,11,5,38,69,83,1,19,FRA
083525e5,1,1,1,0,0,0,0,0,4,2,2,0,1,11,0,19,FRA
095e4199,8,6,3,2,3,0,10,10,3,0,3,2,10,3,1,19,FRA
0984c5d5,20,12,7,10,3,5,15,10,9,1,8,6,26,11,0,19,FRA
09f24df6,1,1,0,1,0,0,0,0,1,0,1,0,1,0,0,19,FRA
0a63446f,10,5,6,1,3,3,4,1,3,1,2,9,19,30,0,19,FRA
0a89e877,58,39,32,22,4,16,38,22,18,0,18,35,93,45,0,19,FRA
0aa874f4,118,71,61,50,7,43,102,59,44,16,28,58,176,65,1,19,FRA
0b0cbe5b,52,32,21,22,9,13,61,48,24,3,21,20,72,16,0,19,FRA
0b4d8274,30,19,6,18,6,12,32,20,12,1,11,9,39,7,0,19,FRA
0bd57eb0,0,0,0,0,0,0,0,0,0,0,0,0,0,0,0,19,FRA
0be95d34,36,20,15,13,8,13,37,24,19,0,19,20,56,7,1,19,FRA
0c291a1a,20,11,7,10,3,10,23,13,11,0,11,9,29,18,0,19,FRA
0d2158d5,52,28,15,31,6,21,58,37,28,5,23,40,92,32,0,19,FRA
0e12089d,0,0,0,0,0,0,0,0,0,0,0,0,0,3,1,19,FRA
0e6bc38c,9,4,3,2,4,2,9,7,7,0,7,3,12,4,0,19,FRA
0eb03d5b,26,21,21,5,0,13,19,6,23,12,11,36,62,105,0,19,FRA
0ee664db,0,0,0,0,0,0,0,0,0,0,0,0,0,0,0,19,FRA
0eeafda5,18,7,15,3,0,8,10,2,8,6,2,11,29,25,0,19,FRA
0f4c0bad,1,0,0,1,0,0,0,0,0,0,0,0,1,0,0,19,FRA
0f52f925,49,28,26,15,8,20,53,33,39,3,36,29,78,62,1,19,FRA
0f8418aa,60,41,23,34,3,23,55,32,37,3,34,34,94,39,1,19,FRA
0fb21da9,12,9,10,1,1,5,7,2,4,3,1,6,18,13,0,19,FRA
0fe7f7bc,0,0,0,0,0,0,0,0,0,0,0,0,0,0,0,19,FRA
1040e783,10,6,9,1,0,6,11,5,3,0,3,8,18,13,0,19,FRA
10650926,28,15,15,12,1,11,20,9,17,7,10,10,38,37,0,19,FRA
11ced928,4,2,0,2,2,2,4,2,3,0,3,3,7,15,0,19,FRA
132a82f1,7,6,5,2,0,6,13,7,1,0,1,4,11,9,0,19,FRA
132bb875,0,0,0,0,0,0,0,0,0,0,0,0,0,7,0,19,FRA
1467af0d,72,42,25,39,8,36,81,45,26,1,25,18,90,8,2,19,FRA
148e136f,88,51,31,38,19,30,87,57,39,1,38,19,107,5,3,19,FRA
15e1afd5,4,3,4,0,0,1,2,1,0,0,0,6,10,15,0,19,FRA
15e99107,1,1,0,1,0,1,1,0,2,0,2,2,3,0,0,19,FRA
16324e1d,46,27,36,10,0,27,50,23,51,38,13,70,116,184,1,19,FRA
166a981d,7,2,1,5,1,4,11,7,6,1,5,9,16,11,1,19,FRA
16714a62,31,22,20,11,0,16,28,12,26,11,15,31,62,101,0,19,FRA
167d5018,47,33,26,20,1,16,22,6,37,24,13,39,86,136,2,19,FRA
171bf11d,1,1,0,0,1,1,2,1,0,0,0,0,1,0,0,19,FRA
176674ab,9,4,5,2,2,4,9,5,4,0,4,2,11,2,0,19,FRA
17f29fb0,0,0,0,0,0,0,0,0,0,0,0,0,0,0,0,19,FRA
19053e31,12,7,3,6,3,1,15,14,6,0,6,8,20,6,0,19,FRA
19a12bed,29,21,22,5,2,16,19,3,6,1,5,14,43,41,0,19,FRA
19cda00b,29,17,12,10,7,10,42,32,24,1,23,16,45,4,0,19,FRA
19f8e480,74,50,46,20,8,27,55,28,22,3,19,17,91,70,1,19,FRA
1a4b9094,67,48,27,27,13,26,42,16,28,3,25,39,106,56,1,19,FRA
1a6f2a66,2,1,1,0,1,1,4,3,4,0,4,3,5,1,0,19,FRA
1a992676,41,22,11,19,11,16,43,27,20,1,19,15,56,2,1,19,FRA
1ad8cb67,51,34,34,17,0,30,49,19,37,23,14,52,103,132,1,19,FRA
1b82f8df,38,21,14,23,1,18,43,25,22,10,12,32,70,26,1,19,FRA
1bfb6fef,15,7,5,9,1,10,14,4,15,3,12,11,26,29,0,19,FRA
1c344204,47,31,36,11,0,21,39,18,45,32,13,52,99,136,4,19,FRA
1d2d5cc8,0,0,0,0,0,0,3,3,0,0,0,1,1,7,4,19,FRA
1ec7e1c5,41,25,31,9,1,18,24,6,42,36,6,39,80,152,0,19,FRA
1ef37668,49,28,28,18,3,25,33,8,21,13,8,17,66,56,0,19,FRA
1f8c7aa9,13,5,2,7,4,3,8,5,8,1,7,8,21,13,0,19,FRA
20094685,46,24,17,23,6,19,53,34,10,2,8,20,66,8,0,19,FRA
2054d037,16,10,3,8,5,2,11,9,19,3,16,8,24,14,0,19,FRA
20730eae,5,2,0,4,1,2,15,13,13,4,9,4,9,12,0,19,FRA
20e73fac,55,35,23,21,11,20,67,47,44,5,39,32,87,34,1,19,FRA
22721b88,74,50,34,26,14,35,56,21,24,8,16,46,120,93,4,19,FRA
22a62523,0,0,0,0,0,0,0,0,0,0,0,0,0,0,0,19,FRA
22bfb57e,10,8,3,6,1,1,5,4,5,1,4,9,19,5,0,19,FRA
23593121,12,8,2,8,2,2,15,13,5,1,4,6,18,0,0,19,FRA
2384dbed,0,0,0,0,0,0,0,0,0,0,0,0,0,0,0,19,FRA
23c63b7f,3,1,0,2,1,0,7,7,2,0,2,1,4,7,0,19,FRA
242b350c,1,0,0,0,1,0,0,0,0,0,0,0,1,0,0,19,FRA
2434f24a,2,0,2,0,0,2,2,0,0,0,0,0,2,14,3,19,FRA
243f4a0b,127,74,59,64,4,49,109,60,45,11,34,43,170,54,1,19,FRA
244bc2c8,12,6,3,8,1,5,11,6,4,2,2,4,16,9,0,19,FRA
247accfd,38,26,18,16,4,18,27,9,40,21,19,44,82,102,0,19,FRA
249cdcff,0,0,0,0,0,0,0,0,1,0,1,0,0,1,0,19,FRA
24eb7ed6,15,7,7,7,1,6,15,9,14,2,12,5,20,3,0,19,FRA
2515040a,26,14,21,5,0,13,19,6,26,21,5,32,58,119,1,19,FRA
26383ea5,1,1,1,0,0,1,1,0,0,0,0,0,1,1,0,19,FRA
26777636,7,2,2,3,2,3,9,6,3,0,3,2,9,0,0,19,FRA
2677a1de,41,26,8,14,19,17,49,32,27,2,25,11,52,5,0,19,FRA
26975a92,1,0,1,0,0,1,1,0,0,0,0,1,2,31,1,19,FRA
275e2c51,35,26,25,10,0,14,19,5,31,24,7,29,64,133,1,19,FRA
276cce2e,61,35,31,22,8,29,54,25,48,13,35,40,101,92,1,19,FRA
279ddf6a,106,61,56,39,11,28,72,44,44,12,32,72,178,39,1,19,FRA
28129034,16,9,7,6,3,8,14,6,13,8,5,16,32,35,0,19,FRA
288e1e13,17,12,8,9,0,8,19,11,20,11,9,14,31,59,1,19,FRA
28a65a2c,1,0,1,0,0,1,1,0,0,0,0,0,1,2,0,19,FRA
28dabd43,1,1,1,0,0,1,2,1,0,0,0,1,2,20,1,19,FRA
29c02c9f,24,12,10,12,2,13,19,6,10,0,10,9,33,10,1,19,FRA
29d8ad3f,26,15,22,3,1,13,23,10,28,22,6,32,58,173,2,19,FRA
29ef0f49,6,4,1,4,1,1,4,3,5,3,2,1,7,10,0,19,FRA
2a657da0,59,28,29,24,6,18,63,45,28,0,28,20,79,14,0,19,FRA
2b16cb1a,12,6,1,7,4,2,14,12,11,0,11,4,16,3,0,19,FRA
2b9fdeea,42,23,10,21,11,16,35,19,19,1,18,8,50,4,0,19,FRA
2c92d3c0,18,13,5,7,6,3,16,13,14,2,12,12,30,13,0,19,FRA
2d22cea7,0,0,0,0,0,0,0,0,0,0,0,0,0,0,0,19,FRA
2e0367a6,56,33,24,19,13,15,46,31,18,0,18,11,67,9,0,19,FRA
2e52206e,17,12,5,7,5,6,19,13,15,3,12,12,29,14,0,19,FRA
2ef637bd,18,13,11,6,1,10,18,8,4,2,2,21,39,27,0,19,FRA
2f8f43f3,15,8,8,4,3,4,11,7,1,0,1,6,21,1,0,19,FRA
2f965a72,1,1,1,0,0,1,1,0,0,0,0,0,1,4,1,19,FRA
2fa2a875,1,0,1,0,0,1,3,2,0,0,0,5,6,24,3,19,FRA
3010aefb,39,23,20,10,9,16,33,17,24,0,24,23,62,14,0,19,FRA
30395d3b,32,19,14,15,3,5,19,14,12,0,12,19,51,4,0,19,FRA
3067cbef,11,6,10,1,0,5,6,1,13,9,4,6,17,44,0,19,FRA
3071a619,11,9,0,6,5,4,14,10,6,2,4,4,15,21,0,19,FRA
31a62dc7,90,59,40,39,11,36,89,53,34,5,29,34,124,89,1,19,FRA
32c2d95f,60,33,48,11,1,30,40,10,44,24,20,65,125,196,0,19,FRA
33508c78,14,10,5,5,4,8,28,20,12,3,9,9,23,5,1,19,FRA
33887998,0,0,0,0,0,0,1,1,1,0,1,2,2,16,3,19,FRA
3681cfff,72,52,51,19,2,40,50,10,39,16,23,61,133,158,2,19,FRA
3708e9fa,36,17,3,20,13,10,44,34,34,3,31,22,58,12,0,19,FRA
375622c5,57,34,25,24,8,27,66,39,31,4,27,16,73,12,1,19,FRA
3767b3b7,25,17,15,8,2,12,21,9,12,4,8,15,40,40,0,19,FRA
378825c7,69,48,42,19,8,40,58,18,24,10,14,41,110,98,0,19,FRA
380a15e2,0,0,0,0,0,0,0,0,0,0,0,0,0,0,0,19,FRA
392d98fc,2,2,1,0,1,0,0,0,0,0,0,0,2,1,0,19,FRA
397ba086,0,0,0,0,0,0,1,1,0,0,0,0,0,0,0,19,FRA
39901146,1,0,0,0,1,0,3,3,6,1,5,0,1,2,0,19,FRA
3acddfdd,0,0,0,0,0,0,2,2,1,1,0,0,0,1,0,19,FRA
3befc2b6,57,40,18,36,3,20,44,24,22,6,16,29,86,43,1,19,FRA
3cefcaef,44,28,25,14,5,14,17,3,22,5,17,34,78,53,2,19,FRA
3d3b0206,8,3,6,2,0,2,6,4,1,0,1,3,11,3,0,19,FRA
3dd738a1,88,51,40,33,15,39,69,30,23,3,20,37,125,50,1,19,FRA
3e092724,40,20,16,21,3,15,43,28,20,5,15,11,51,15,0,19,FRA
3e87d087,18,13,10,7,1,11,17,6,14,4,10,28,46,49,1,19,FRA
3eaf8817,11,10,2,8,1,0,8,8,5,1,4,0,11,14,0,19,FRA
3ef0fa48,20,12,8,7,5,13,32,19,9,1,8,8,28,7,0,19,FRA
3f5b4635,75,45,46,26,3,38,65,27,35,15,20,67,142,106,1,19,FRA
403f5d20,20,12,14,4,2,9,20,11,12,1,11,17,37,37,0,19,FRA
41e7ef1c,19,11,6,5,8,6,16,10,10,2,8,10,29,16,0,19,FRA
4207e578,20,12,8,6,6,3,15,12,11,0,11,4,24,19,0,19,FRA
42c8ede1,1,1,0,1,0,0,0,0,0,0,0,0,1,0,0,19,FRA
42e8eba2,10,5,6,4,0,4,8,4,1,0,1,0,10,0,0,19,FRA
42eaa028,25,14,7,12,6,8,30,22,24,2,22,6,31,4,0,19,FRA
42fd9c7f,8,4,2,1,5,1,6,5,2,0,2,5,13,2,0,19,FRA
4315f30d,59,36,38,17,4,31,57,26,29,12,17,68,127,107,2,19,FRA
433dc9a2,47,32,22,19,6,22,46,24,19,5,14,20,67,41,1,19,FRA
43af5b1b,0,0,0,0,0,0,0,0,0,0,0,0,0,0,0,19,FRA
43e7a164,48,37,33,13,2,23,43,20,56,31,25,83,131,183,3,19,FRA
44f8c299,41,28,21,18,2,20,41,21,10,0,10,11,52,7,0,19,FRA
450e277f,26,18,24,2,0,12,24,12,37,29,8,20,46,164,2,19,FRA
462475ed,17,13,1,10,6,4,9,5,5,0,5,5,22,9,0,19,FRA
46291841,24,14,14,10,0,9,30,21,12,2,10,17,41,11,0,19,FRA
468fdbad,46,28,23,18,5,17,33,16,30,12,18,30,76,42,0,19,FRA
46907171,22,13,6,13,3,7,28,21,9,0,9,7,29,7,0,19,FRA
469d3d84,4,4,2,1,1,2,2,0,1,0,1,0,4,1,0,19,FRA
46d50339,29,21,12,13,4,16,27,11,21,5,16,14,43,32,0,19,FRA
4749367a,6,4,3,3,0,4,9,5,4,2,2,5,11,8,0,19,FRA
475583ff,43,29,30,10,3,23,48,25,24,6,18,22,65,50,0,19,FRA
47af88b8,33,21,22,11,0,16,24,8,36,32,4,26,59,122,1,19,FRA
4887118d,3,0,0,1,2,3,6,3,1,0,1,1,4,5,0,19,FRA
48b28bfd,20,11,6,11,3,8,16,8,7,0,7,17,37,12,0,19,FRA
49000148,25,18,15,7,3,11,21,10,14,1,13,9,34,6,0,19,FRA
4914ed4a,19,10,13,6,0,6,17,11,15,3,12,14,33,60,1,19,FRA
4a57580c,46,25,23,16,7,20,36,16,22,4,18,14,60,28,0,19,FRA
4b96c347,38,22,18,13,7,12,31,19,21,3,18,28,66,15,0,19,FRA
4be0b467,17,12,3,9,5,4,10,6,14,0,14,1,18,9,0,19,FRA
4bf69118,65,41,34,27,4,33,70,37,28,4,24,78,143,56,0,19,FRA
4c5b714f,50,34,27,12,11,26,48,22,25,9,16,30,80,51,0,19,FRA
4c700f46,30,16,18,10,2,18,34,16,14,6,8,19,49,29,0,19,FRA
4d1666ff,48,31,37,11,0,27,41,14,44,23,21,50,98,193,7,19,FRA
4d3e9033,0,0,0,0,0,0,0,0,0,0,0,0,0,3,0,19,FRA
4db2157a,44,26,12,23,9,13,35,22,24,7,17,19,63,29,0,19,FRA
4e7bfc23,29,16,16,10,3,9,36,27,13,2,11,6,35,8,0,19,FRA
4f255115,24,12,10,14,0,7,18,11,11,5,6,21,45,14,0,19,FRA
4fdf1fd9,11,8,6,5,0,6,16,10,30,24,6,44,55,181,3,19,FRA
5046b7d4,15,7,0,10,5,3,21,18,35,3,32,8,23,5,0,19,FRA
5113d9a7,11,6,9,2,0,7,16,9,13,9,4,7,18,37,0,19,FRA
51450467,0,0,0,0,0,0,0,0,0,0,0,1,1,0,0,19,FRA
5148dcc5,23,13,5,13,5,9,23,14,17,2,15,6,29,14,0,19,FRA
516dc25b,34,26,11,20,3,18,44,26,21,5,16,19,53,28,1,19,FRA
51c30111,19,14,11,7,1,8,18,10,22,8,14,18,37,7,1,19,FRA
51dbeea9,64,43,27,31,6,31,55,24,32,17,15,31,95,69,1,19,FRA
527f063d,11,8,1,4,6,3,13,10,11,2,9,6,17,16,0,19,FRA
5314e067,81,44,44,31,6,36,63,27,15,4,11,46,127,57,0,19,FRA
53283127,4,2,2,2,0,3,5,2,1,0,1,4,8,5,0,19,FRA
542cc80f,53,33,32,16,5,24,43,19,22,2,20,22,75,23,1,19,FRA
56f7a928,45,24,17,23,5,24,47,23,20,3,17,18,63,22,0,19,FRA
574aa9ec,3,1,1,2,0,0,0,0,1,1,0,2,5,9,2,19,FRA
57c433c8,2,1,0,0,2,0,0,0,0,0,0,0,2,0,0,19,FRA
57e3f0c7,27,10,6,15,6,8,35,27,33,0,33,13,40,11,1,19,FRA
58ae47b2,11,9,2,8,1,5,22,17,14,0,14,8,19,8,0,19,FRA
5b54bf3b,11,5,4,4,3,3,8,5,7,1,6,3,14,7,0,19,FRA
5b5724d2,25,12,16,7,2,11,16,5,19,5,14,32,57,51,0,19,FRA
5c2da10f,2,1,0,2,0,0,3,3,3,1,2,2,4,17,1,19,FRA
5c4dc0ff,0,0,0,0,0,0,0,0,0,0,0,1,1,0,0,19,FRA
5cdddffa,66,43,21,35,10,22,54,32,29,9,20,30,96,13,3,19,FRA
5d42d487,5,1,2,2,1,3,6,3,3,0,3,1,6,5,0,19,FRA
5d59e0df,7,5,0,2,5,1,8,7,8,1,7,2,9,20,0,19,FRA
5d8d7454,98,67,59,29,10,41,83,42,49,21,28,78,176,121,2,19,FRA
5e22e2a4,118,60,48,63,7,51,106,55,41,4,37,57,175,57,2,19,FRA
5ee6e943,0,0,0,0,0,0,2,2,0,0,0,2,2,8,3,19,FRA
5f4ce4b6,30,17,11,12,7,14,25,11,10,0,10,9,39,6,0,19,FRA
6043997c,6,3,5,1,0,4,9,5,8,4,4,4,10,17,0,19,FRA
60d90c55,1,0,1,0,0,0,1,1,0,0,0,1,2,12,4,19,FRA
61590953,20,14,8,10,2,6,13,7,10,1,9,18,38,20,1,19,FRA
6191093d,62,38,22,32,8,20,43,23,44,7,37,26,88,14,0,19,FRA
62a54183,0,0,0,0,0,0,0,0,0,0,0,0,0,0,0,19,FRA
63a10528,3,3,2,1,0,1,4,3,2,1,1,0,3,3,0,19,FRA
6421dd73,42,28,20,11,11,13,40,27,29,1,28,33,75,13,0,19,FRA
6453830e,0,0,0,0,0,0,0,0,0,0,0,0,0,0,0,19,FRA
6481421d,28,13,13,13,2,11,39,28,7,2,5,7,35,13,0,19,FRA
64ba07c0,13,8,10,2,1,9,10,1,3,1,2,3,16,18,0,19,FRA
65391fa7,2,1,1,1,0,0,0,0,2,1,1,0,2,8,0,19,FRA
66116290,34,15,6,16,12,8,27,19,11,6,5,3,37,23,2,19,FRA
6644712a,0,0,0,0,0,0,1,1,0,0,0,0,0,0,0,19,FRA
6690ef25,71,42,56,13,2,31,47,16,42,22,20,48,119,73,1,19,FRA
677ee102,33,19,15,15,3,17,32,15,16,4,12,24,57,55,0,19,FRA
67ac5bb8,18,11,13,4,1,4,7,3,14,6,8,19,37,60,2,19,FRA
67b7357e,13,7,10,3,0,3,8,5,8,2,6,11,24,20,0,19,FRA
68a87d66,7,2,2,5,0,2,5,3,5,0,5,2,9,2,0,19,FRA
69384e5d,14,9,3,10,1,4,21,17,8,0,8,5,19,1,1,19,FRA
698b37b8,1,0,0,1,0,0,0,0,0,0,0,0,1,0,0,19,FRA
6a189491,11,8,8,3,0,7,11,4,3,2,1,7,18,18,0,19,FRA
6a827d8e,68,44,34,25,9,34,67,33,38,8,30,56,124,42,0,19,FRA
6b200d45,53,36,34,17,2,20,33,13,37,24,13,44,97,118,2,19,FRA
6b2c894b,45,28,31,10,4,24,40,16,18,4,14,40,85,55,1,19,FRA
6b9f2f3e,12,7,8,2,2,1,4,3,2,2,0,4,16,27,0,19,FRA
6bca20fe,25,14,8,15,2,10,21,11,7,0,7,11,36,7,0,19,FRA
6bde367b,95,58,35,52,8,43,116,73,32,15,17,64,159,53,2,19,FRA
6c6ecdd4,16,11,6,9,1,5,13,8,7,1,6,10,26,14,1,19,FRA
6c8ddd52,0,0,0,0,0,0,0,0,0,0,0,0,0,0,0,19,FRA
6c9642ae,14,8,10,4,0,6,9,3,4,1,3,10,24,4,2,19,FRA
6ca88b2a,38,22,22,10,6,17,22,5,18,4,14,27,65,74,0,19,FRA
6e2c94ad,9,6,0,3,6,2,4,2,3,0,3,5,14,1,0,19,FRA
6e5b5a45,81,55,46,31,4,34,75,41,37,14,23,87,168,110,1,19,FRA
6e7f1353,70,47,27,35,8,21,77,56,40,1,39,42,112,8,1,19,FRA
6ed1a2a2,37,26,14,17,6,15,49,34,16,1,15,15,52,5,0,19,FRA
6f8cd6d0,45,28,23,15,7,20,43,23,24,1,23,10,55,14,0,19,FRA
6fb7edd3,0,0,0,0,0,0,1,1,0,0,0,0,0,0,0,19,FRA
6fbde63a,1,1,0,1,0,1,1,0,0,0,0,1,2,1,0,19,FRA
6fea4e00,2,2,2,0,0,1,1,0,1,0,1,1,3,4,0,19,FRA
6ff8ef56,25,12,4,16,5,6,11,5,4,0,4,2,27,8,0,19,FRA
706a60e1,12,8,5,5,2,2,4,2,5,0,5,1,13,5,0,19,FRA
71ec39ef,74,38,33,34,7,25,59,34,30,13,17,26,100,27,0,19,FRA
743fdcd3,8,7,3,5,0,2,6,4,2,1,1,3,11,10,0,19,FRA
745ca0a3,1,0,0,1,0,0,1,1,0,0,0,1,2,1,1,19,FRA
74dc806c,15,7,4,8,3,7,16,9,9,0,9,4,19,0,0,19,FRA
76806215,0,0,0,0,0,0,2,2,0,0,0,0,0,1,1,19,FRA
76c131da,2,1,0,0,2,1,1,0,2,0,2,0,2,0,0,19,FRA
770d7eb8,78,45,48,23,7,30,53,23,26,9,17,28,106,62,2,19,FRA
775185ae,14,10,6,6,2,5,9,4,8,0,8,7,21,5,0,19,FRA
7768df30,33,20,23,10,0,14,22,8,33,23,10,34,67,105,2,19,FRA
779847d6,77,48,60,17,0,40,69,29,30,14,16,34,111,114,0,19,FRA
77cf6852,55,35,34,14,7,32,65,33,27,12,15,23,78,94,4,19,FRA
77d7c96f,30,23,11,16,3,13,19,6,13,5,8,18,48,29,0,19,FRA
77f278a0,7,4,2,3,2,3,3,0,2,0,2,2,9,0,0,19,FRA
79135368,65,32,22,33,10,25,66,41,27,6,21,29,94,19,2,19,FRA
79584585,2,1,0,2,0,0,1,1,0,0,0,2,4,3,0,19,FRA
7961f7aa,7,4,3,2,2,0,12,12,16,0,16,8,15,8,0,19,FRA
796b1c41,20,14,5,11,4,8,27,19,9,1,8,20,40,4,0,19,FRA
797f6070,3,1,1,0,2,0,0,0,0,0,0,0,3,0,0,19,FRA
79b2399c,51,31,23,22,6,19,54,35,23,2,21,38,89,49,0,19,FRA
7a137df4,0,0,0,0,0,0,0,0,0,0,0,0,0,0,0,19,FRA
7add56e1,1,1,1,0,0,0,0,0,1,0,1,0,1,2,0,19,FRA
7b075c75,14,11,12,2,0,4,6,2,21,18,3,21,35,92,1,19,FRA
7b9a86e6,8,6,2,4,2,2,8,6,1,0,1,3,11,2,0,19,FRA
7b9a9e25,14,12,4,4,6,4,11,7,13,2,11,5,19,9,0,19,FRA
7b9c2d84,23,15,8,12,3,8,18,10,13,2,11,4,27,4,0,19,FRA
7c2965bb,33,22,10,17,6,9,22,13,17,1,16,8,41,10,0,19,FRA
7c56da38,21,16,8,10,3,7,16,9,12,2,10,9,30,7,1,19,FRA
7c6d6c96,31,18,25,5,1,12,22,10,36,27,9,46,77,127,6,19,FRA
7cab69b5,54,38,34,19,1,29,46,17,29,17,12,25,79,121,1,19,FRA
7cdda3bf,40,18,6,16,18,13,31,18,18,2,16,6,46,27,0,19,FRA
7cf431a5,26,17,13,10,3,12,35,23,14,1,13,10,36,7,1,19,FRA
7d937aa1,34,16,17,12,5,16,58,42,15,3,12,15,49,13,0,19,FRA
7d9b37bf,9,6,3,6,0,2,8,6,8,0,8,2,11,5,0,19,FRA
7e82a78f,36,20,8,20,8,13,51,38,32,1,31,23,59,7,0,19,FRA
7f622eef,6,4,3,3,0,2,4,2,2,0,2,1,7,7,1,19,FRA
7fb301af,5,4,3,2,0,3,6,3,1,0,1,3,8,3,0,19,FRA
7fecbcdb,51,29,31,14,6,24,44,20,20,4,16,37,88,86,0,19,FRA
7ffaf233,11,8,1,6,4,0,8,8,2,1,1,2,13,4,1,19,FRA
80556f08,32,16,5,21,6,11,31,20,13,1,12,9,41,22,1,19,FRA
813aae2f,9,4,4,3,2,4,8,4,7,0,7,4,13,2,0,19,FRA
81d3318f,29,18,6,17,6,11,30,19,27,0,27,17,46,6,1,19,FRA
821233cc,44,23,36,7,1,20,39,19,14,6,8,38,82,107,3,19,FRA
822d51d7,28,20,5,20,3,9,27,18,7,0,7,11,39,8,0,19,FRA
82671804,72,43,49,18,5,30,66,36,26,12,14,34,106,61,0,19,FRA
8325870c,12,10,10,1,1,6,8,2,4,1,3,6,18,25,0,19,FRA
834b5c4c,0,0,0,0,0,0,1,1,0,0,0,1,1,24,1,19,FRA
8417953b,0,0,0,0,0,0,0,0,0,0,0,0,0,0,1,19,FRA
84549a07,20,11,8,8,4,6,17,11,8,0,8,5,25,5,0,19,FRA
84d94b91,76,47,38,33,5,26,63,37,46,17,29,36,112,77,1,19,FRA
854a2041,0,0,0,0,0,0,1,1,0,0,0,1,1,1,0,19,FRA
8577e60a,0,0,0,0,0,0,0,0,0,0,0,0,0,2,0,19,FRA
86574238,4,2,0,4,0,2,4,2,0,0,0,0,4,0,0,19,FRA
86df8ac0,0,0,0,0,0,0,0,0,0,0,0,0,0,0,0,19,FRA
86e7deaf,16,13,7,8,1,6,11,5,28,20,8,32,48,99,1,19,FRA
872cd68c,1,0,1,0,0,0,1,1,0,0,0,1,2,0,0,19,FRA
873ce3a2,1,0,0,1,0,0,5,5,6,2,4,2,3,2,1,19,FRA
8746d5d0,36,23,22,10,4,16,34,18,15,5,10,31,67,40,0,19,FRA
8794e251,35,20,13,17,5,9,12,3,9,2,7,10,45,20,0,19,FRA
8802c1d5,11,5,5,5,1,5,13,8,8,1,7,8,19,2,1,19,FRA
885b7aa7,16,11,3,13,0,5,13,8,15,3,12,15,31,6,1,19,FRA
8870154f,0,0,0,0,0,0,1,1,1,0,1,0,0,16,1,19,FRA
88f130ed,21,18,19,2,0,11,13,2,14,5,9,14,35,62,2,19,FRA
8a2248b4,1,0,1,0,0,1,2,1,0,0,0,2,3,6,2,19,FRA
8b28686a,24,13,16,8,0,11,24,13,22,14,8,21,45,56,0,19,FRA
8b298f56,44,27,7,33,4,21,61,40,28,4,24,29,73,34,1,19,FRA
8b529245,4,1,1,2,1,0,1,1,7,0,7,1,5,2,0,19,FRA
8b66d9cc,7,3,1,4,2,1,13,12,9,0,9,6,13,3,0,19,FRA
8c2c48a9,0,0,0,0,0,0,1,1,0,0,0,0,0,0,0,19,FRA
8c955557,10,4,0,3,7,5,12,7,2,0,2,2,12,1,0,19,FRA
8ca253a3,18,11,7,9,2,1,14,13,11,2,9,10,28,21,0,19,FRA
8da74c05,74,44,32,31,11,39,92,53,53,12,41,56,130,59,1,19,FRA
8dbff17c,14,9,12,2,0,8,12,4,14,14,0,18,32,52,3,19,FRA
8eec784d,0,0,0,0,0,0,0,0,0,0,0,0,0,0,0,19,FRA
8f325097,19,15,14,5,0,4,10,6,13,10,3,23,42,37,1,19,FRA
8f4d116f,95,58,42,43,10,33,89,56,35,8,27,59,154,50,0,19,FRA
8f534f8e,0,0,0,0,0,0,3,3,2,2,0,3,3,5,0,19,FRA
8f696594,12,9,0,7,5,5,21,16,16,2,14,9,21,1,0,19,FRA
8fa8f8d2,2,0,2,0,0,2,6,4,0,0,0,1,3,7,2,19,FRA
8ff07990,6,3,1,4,1,3,11,8,17,3,14,4,10,14,0,19,FRA
8ff4872e,37,24,22,14,1,16,28,12,18,5,13,24,61,30,0,19,FRA
9001138b,12,5,1,9,2,1,11,10,8,2,6,4,16,3,0,19,FRA
909222de,39,27,10,19,10,10,38,28,24,1,23,14,53,9,0,19,FRA
90eb507d,91,52,55,23,13,42,69,27,30,4,26,49,140,80,1,19,FRA
90f87966,27,15,15,9,3,17,24,7,33,26,7,37,64,153,1,19,FRA
90fcf472,25,18,6,11,8,5,20,15,9,0,9,9,34,9,0,19,FRA
91e58f66,32,19,17,13,2,13,33,20,14,5,9,23,55,23,0,19,FRA
91f2da4c,53,30,23,21,9,20,49,29,22,1,21,22,75,12,0,19,FRA
92232aad,43,26,25,13,5,22,37,15,17,7,10,47,90,64,0,19,FRA
923f4dda,7,5,1,5,1,0,4,4,7,0,7,4,11,14,0,19,FRA
92b1763b,2,1,2,0,0,2,2,0,2,0,2,0,2,0,0,19,FRA
92b56413,27,15,11,10,6,7,24,17,16,3,13,11,38,5,0,19,FRA
92cd4bef,6,3,4,2,0,1,1,0,1,0,1,0,6,0,0,19,FRA
933d3b51,1,1,1,0,0,0,0,0,1,1,0,1,2,3,0,19,FRA
934a0957,1,1,0,1,0,0,1,1,1,0,1,0,1,0,0,19,FRA
93c942fb,0,0,0,0,0,0,0,0,0,0,0,0,0,0,0,19,FRA
9453d2f4,12,6,1,8,3,2,9,7,6,0,6,2,14,6,0,19,FRA
94f8d10c,22,16,14,8,0,14,18,4,15,9,6,20,42,86,2,19,FRA
950ff24d,1,0,1,0,0,1,1,0,0,0,0,0,1,1,0,19,FRA
972aeb2a,32,20,28,4,0,16,24,8,11,10,1,28,60,44,2,19,FRA
97b87472,3,2,3,0,0,3,4,1,0,0,0,2,5,5,0,19,FRA
97fb4608,11,6,7,2,2,5,8,3,6,2,4,5,16,16,0,19,FRA
9836e892,0,0,0,0,0,0,0,0,0,0,0,0,0,0,0,19,FRA
9980269a,15,7,1,10,4,4,11,7,8,1,7,4,19,22,0,19,FRA
9a1f2e1c,31,19,14,12,5,17,24,7,19,2,17,15,46,30,2,19,FRA
9a506145,22,14,7,12,3,11,19,8,7,4,3,21,43,32,0,19,FRA
9ae9eaea,25,16,17,7,1,12,15,3,9,3,6,30,55,42,0,19,FRA
9b398aea,2,2,1,1,0,0,1,1,0,0,0,0,2,1,0,19,FRA
9b6d9b53,44,25,22,19,3,16,31,15,25,4,21,32,76,45,1,19,FRA
9daeac61,11,7,9,2,0,6,10,4,6,1,5,4,15,20,0,19,FRA
9dafff2a,20,13,5,13,2,5,13,8,5,1,4,9,29,8,0,19,FRA
9dd5da03,31,21,20,9,2,15,29,14,9,3,6,21,52,66,0,19,FRA
9e27e5de,59,33,22,34,3,24,57,33,30,10,20,29,88,42,0,19,FRA
9f29c204,14,9,10,3,1,5,15,10,8,2,6,12,26,26,0,19,FRA
9f6325f9,2,1,1,0,1,1,1,0,0,0,0,1,3,7,0,19,FRA
9f90c06b,6,3,5,0,1,2,5,3,6,2,4,7,13,28,1,19,FRA
9fc0f253,12,11,11,1,0,7,9,2,11,7,4,12,24,41,1,19,FRA
a0434482,39,27,17,17,5,9,39,30,29,4,25,23,62,23,1,19,FRA
a08b974a,80,54,37,33,10,34,80,46,40,5,35,29,109,30,0,19,FRA
a0f9b535,58,35,33,16,9,23,59,36,29,2,27,28,86,15,0,19,FRA
a1d04509,14,7,7,4,3,3,8,5,14,3,11,9,23,17,0,19,FRA
a44d3a3c,1,1,0,0,1,0,0,0,0,0,0,0,1,0,0,19,FRA
a4527d33,0,0,0,0,0,0,0,0,0,0,0,0,0,0,0,19,FRA
a46472d0,21,16,9,9,3,6,9,3,18,13,5,33,54,66,3,19,FRA
a4b1028a,61,33,32,27,2,36,71,35,39,11,28,44,105,82,0,19,FRA
a4c3f7af,51,33,27,16,8,15,45,30,33,7,26,29,80,23,1,19,FRA
a56bd2ee,0,0,0,0,0,0,1,1,0,0,0,0,0,4,1,19,FRA
a5db0bec,63,38,28,25,10,17,61,44,33,6,27,32,95,25,3,19,FRA
a6138e4a,37,25,18,17,2,15,40,25,19,3,16,18,55,28,1,19,FRA
a634b9d2,12,8,5,6,1,3,9,6,8,1,7,5,17,13,0,19,FRA
a671316d,0,0,0,0,0,0,0,0,1,1,0,0,0,1,0,19,FRA
a7e4760c,12,6,7,5,0,5,10,5,5,0,5,8,20,9,0,19,FRA
a8797cf1,3,2,0,1,2,2,8,6,0,0,0,2,5,5,0,19,FRA
a8b4a643,4,1,4,0,0,1,4,3,8,1,7,5,9,16,0,19,FRA
aa21406e,0,0,0,0,0,0,0,0,0,0,0,0,0,1,0,19,FRA
ab096c6f,34,22,21,10,3,20,45,25,25,11,14,53,87,118,2,19,FRA
acde3581,5,2,1,2,2,1,3,2,3,0,3,2,7,1,0,19,FRA
ad82197c,2,1,1,1,0,1,2,1,2,1,1,2,4,16,0,19,FRA
ae59b359,20,15,9,11,0,10,18,8,9,3,6,7,27,5,0,19,FRA
ae6941ec,11,6,9,2,0,6,8,2,2,0,2,4,15,10,0,19,FRA
ae82fa48,1,1,0,1,0,0,2,2,2,0,2,0,1,0,0,19,FRA
aeed036d,0,0,0,0,0,0,0,0,0,0,0,0,0,0,0,19,FRA
aeed5c06,14,8,7,2,5,2,11,9,7,1,6,12,26,6,0,19,FRA
aef6e670,55,34,26,25,4,24,40,16,17,10,7,30,85,48,5,19,FRA
af0c835b,35,20,16,11,8,12,34,22,17,2,15,9,44,17,0,19,FRA
b0547a87,28,19,10,15,3,8,29,21,23,1,22,10,38,21,1,19,FRA
b056e3da,0,0,0,0,0,0,0,0,0,0,0,2,2,20,0,19,FRA
b1adaefa,8,6,8,0,0,3,4,1,5,3,2,0,8,9,0,19,FRA
b2459674,0,0,0,0,0,0,0,0,0,0,0,0,0,0,0,19,FRA
b2bd0f6c,29,19,7,17,5,13,39,26,24,1,23,41,70,18,0,19,FRA
b4a014b1,58,34,43,14,1,26,33,7,44,31,13,50,108,186,1,19,FRA
b4c816a9,0,0,0,0,0,0,1,1,3,0,3,0,0,4,0,19,FRA
b666421b,27,11,19,8,0,9,24,15,27,16,11,42,69,120,2,19,FRA
b66d1d8a,19,16,13,6,0,7,11,4,15,7,8,21,40,47,0,19,FRA
b684a484,6,2,0,3,3,2,4,2,7,2,5,4,10,5,0,19,FRA
b6dac747,60,38,16,41,3,24,43,19,26,3,23,29,89,19,0,19,FRA
b7e7937d,1,0,1,0,0,1,1,0,0,0,0,0,1,16,0,19,FRA
b8d22478,27,18,15,7,5,4,11,7,11,3,8,8,35,4,1,19,FRA
b92edde2,48,35,34,12,2,31,62,31,24,5,19,29,77,79,0,19,FRA
b931d9d1,48,32,34,12,2,19,26,7,15,4,11,7,55,22,0,19,FRA
b99bec05,54,36,30,24,0,28,53,25,36,10,26,39,93,77,0,19,FRA
bb4a42be,9,5,1,7,1,1,7,6,6,0,6,8,17,4,0,19,FRA
bc0bfc64,2,1,1,1,0,0,1,1,1,0,1,0,2,0,0,19,FRA
bc270726,1,1,1,0,0,0,1,1,0,0,0,1,2,7,3,19,FRA
bc7b4580,53,34,25,27,1,26,53,27,18,4,14,18,71,27,0,19,FRA
bcc81786,68,45,54,12,2,20,30,10,36,13,23,36,104,113,1,19,FRA
bced0375,102,66,50,44,8,32,63,31,52,20,32,29,131,49,2,19,FRA
bcf1b2e9,0,0,0,0,0,0,3,3,0,0,0,1,1,14,2,19,FRA
bd4f5f94,7,5,7,0,0,6,6,0,1,0,1,7,14,21,0,19,FRA
bdedd861,15,5,3,9,3,4,9,5,8,1,7,10,25,11,0,19,FRA
beae3a73,76,49,41,22,13,32,76,44,43,7,36,27,103,79,0,19,FRA
beb391dd,14,11,4,7,3,1,11,10,10,0,10,5,19,8,0,19,FRA
bece776f,51,31,16,19,16,13,38,25,42,0,42,7,58,3,0,19,FRA
bfcef334,37,21,23,11,3,15,25,10,13,3,10,23,60,46,1,19,FRA
bfdb33aa,35,24,16,15,4,17,34,17,17,2,15,14,49,4,0,19,FRA
c0b3669f,2,0,1,1,0,0,1,1,2,0,2,0,2,2,0,19,FRA
c20bdcd7,3,2,1,2,0,2,3,1,1,0,1,1,4,0,0,19,FRA
c2211709,105,58,31,64,10,43,91,48,60,7,53,60,165,41,0,19,FRA
c252c705,0,0,0,0,0,0,0,0,0,0,0,0,0,0,0,19,FRA
c26a3918,98,65,64,23,11,33,62,29,41,10,31,44,142,87,0,19,FRA
c27dfb82,22,15,12,8,2,7,22,15,21,2,19,10,32,17,0,19,FRA
c39d9657,1,0,1,0,0,1,2,1,9,4,5,7,8,25,1,19,FRA
c3e4ecbb,33,18,23,6,4,16,25,9,11,8,3,46,79,107,0,19,FRA
c4527123,2,0,1,1,0,0,1,1,2,1,1,1,3,2,0,19,FRA
c46fa34c,58,29,23,30,5,26,57,31,30,7,23,34,92,25,2,19,FRA
c47541e0,36,22,19,13,4,12,26,14,23,5,18,15,51,18,0,19,FRA
c4bbea9f,33,13,28,5,0,12,30,18,31,15,16,66,99,198,2,19,FRA
c58270f8,0,0,0,0,0,0,2,2,0,0,0,0,0,3,0,19,FRA
c5a500ca,58,35,34,19,5,24,70,46,53,9,44,18,76,41,0,19,FRA
c6056d58,32,23,26,5,1,16,32,16,25,17,8,61,93,200,1,19,FRA
c650629d,25,12,2,19,4,6,19,13,14,0,14,9,34,4,0,19,FRA
c693347d,4,1,1,3,0,1,4,3,4,1,3,1,5,21,0,19,FRA
c69ef855,77,45,33,36,8,35,89,54,39,14,25,33,110,48,1,19,FRA
c6ac6579,0,0,0,0,0,0,3,3,0,0,0,0,0,5,0,19,FRA
c6e5d20f,85,47,42,41,2,39,71,32,44,11,33,68,153,49,0,19,FRA
c76577a0,6,3,1,2,3,1,8,7,4,0,4,1,7,2,0,19,FRA
c76b7567,54,27,18,23,13,21,66,45,29,5,24,18,72,12,1,19,FRA
c801616a,42,27,13,26,3,19,62,43,13,2,11,23,65,24,0,19,FRA
c8090cb3,37,21,16,19,2,15,43,28,17,4,13,22,59,15,0,19,FRA
c8c02ac7,19,13,12,7,0,10,26,16,14,5,9,18,37,35,1,19,FRA
c8c60119,13,6,6,7,0,3,10,7,3,1,2,11,24,12,0,19,FRA
c977ef13,0,0,0,0,0,0,0,0,0,0,0,0,0,0,0,19,FRA
c9e99e49,42,22,16,23,3,13,38,25,18,5,13,8,50,11,0,19,FRA
cac76a72,2,2,2,0,0,2,4,2,0,0,0,0,2,18,3,19,FRA
cb9ec45d,3,2,2,1,0,2,3,1,0,0,0,3,6,7,0,19,FRA
cc77354e,67,39,38,24,5,32,49,17,24,13,11,45,112,95,2,19,FRA
ccb1c3af,1,1,0,1,0,0,3,3,0,0,0,0,1,0,0,19,FRA
ccee698e,12,10,4,6,2,7,16,9,5,0,5,8,20,10,0,19,FRA
ce492295,23,12,18,5,0,12,18,6,26,18,8,30,53,125,0,19,FRA
ce84946a,1,1,0,1,0,1,2,1,0,0,0,0,1,2,0,19,FRA
cfd41fad,0,0,0,0,0,0,3,3,0,0,0,0,0,1,0,19,FRA
cfd8dde3,21,12,7,9,5,4,11,7,1,0,1,6,27,9,0,19,FRA
d14229f3,11,7,3,5,3,2,9,7,14,0,14,5,16,8,0,19,FRA
d21e361a,8,4,3,4,1,3,12,9,2,0,2,5,13,1,0,19,FRA
d2448564,21,13,9,8,4,5,17,12,13,0,13,2,23,5,1,19,FRA
d29202c2,1,1,1,0,0,1,3,2,2,0,2,0,1,1,0,19,FRA
d2aa8ac0,41,29,12,27,2,17,44,27,37,10,27,37,78,35,0,19,FRA
d33c706e,34,20,7,20,7,8,34,26,28,7,21,4,38,7,0,19,FRA
d3ce9f1f,4,3,3,1,0,0,0,0,1,0,1,2,6,1,0,19,FRA
d4133fa1,72,40,22,48,2,29,72,43,42,12,30,74,146,86,5,19,FRA
d504b3e1,40,22,18,19,3,16,39,23,20,0,20,19,59,10,0,19,FRA
d512db65,1,1,0,1,0,1,2,1,1,0,1,1,2,1,0,19,FRA
d520120b,15,9,1,7,7,3,9,6,17,3,14,13,28,51,0,19,FRA
d5f2f82b,65,41,34,28,3,31,52,21,30,13,17,44,109,84,1,19,FRA
d63e2912,59,41,30,23,6,29,54,25,25,10,15,37,96,77,0,19,FRA
d6f88a1d,50,31,19,26,5,30,62,32,15,2,13,16,66,23,0,19,FRA
d7553721,1,1,0,0,1,0,1,1,0,0,0,0,1,0,0,19,FRA
d7bf3d19,52,33,20,28,4,25,67,42,45,13,32,47,99,35,0,19,FRA
d880dc16,4,4,2,2,0,3,4,1,1,0,1,1,5,6,0,19,FRA
d8b97bb3,6,4,4,1,1,2,6,4,5,2,3,2,8,5,0,19,FRA
d8fc044e,1,0,0,1,0,1,2,1,2,0,2,1,2,0,0,19,FRA
d9a66c60,9,5,4,2,3,1,15,14,7,1,6,3,12,14,1,19,FRA
dc366c36,0,0,0,0,0,0,1,1,0,0,0,0,0,26,4,19,FRA
dc709ab5,22,13,13,9,0,11,16,5,17,11,6,14,36,70,0,19,FRA
dcf7cf44,9,5,4,5,0,4,13,9,4,1,3,7,16,4,0,19,FRA
dd73120f,2,2,0,2,0,1,2,1,1,0,1,1,3,0,0,19,FRA
de40e38c,4,3,4,0,0,1,3,2,0,0,0,3,7,2,0,19,FRA
de488e56,40,20,22,16,2,23,34,11,16,3,13,19,59,46,0,19,FRA
df819670,11,9,5,5,1,3,7,4,6,2,4,4,15,10,1,19,FRA
dff153a4,34,19,16,15,3,13,30,17,17,5,12,14,48,20,2,19,FRA
e067808c,5,3,0,4,1,3,8,5,3,0,3,1,6,6,0,19,FRA
e110ea4b,1,1,0,1,0,0,1,1,1,0,1,0,1,3,0,19,FRA
e162b013,44,33,25,15,4,21,35,14,13,2,11,19,63,29,0,19,FRA
e1df6989,2,0,1,1,0,1,1,0,1,0,1,0,2,1,0,19,FRA
e2f9bb5f,7,5,3,4,0,3,7,4,5,1,4,5,12,0,0,19,FRA
e3d0b0c4,48,33,29,17,2,19,24,5,30,22,8,62,110,152,2,19,FRA
e3e05edf,44,21,23,16,5,20,38,18,26,6,20,38,82,60,0,19,FRA
e4086af3,26,20,17,8,1,18,21,3,21,3,18,16,42,37,2,19,FRA
e40d028b,0,0,0,0,0,0,1,1,0,0,0,0,0,5,0,19,FRA
e493cff8,1,1,1,0,0,0,1,1,0,0,0,0,1,1,0,19,FRA
e4a26a91,17,9,5,12,0,10,20,10,7,3,4,3,20,17,1,19,FRA
e50623a0,5,4,1,4,0,3,5,2,1,1,0,5,10,8,1,19,FRA
e53ab10b,2,2,1,1,0,1,4,3,3,0,3,0,2,6,0,19,FRA
e54a9890,55,30,35,15,5,23,39,16,24,5,19,23,78,81,1,19,FRA
e562a02e,1,1,0,1,0,1,2,1,1,0,1,1,2,0,0,19,FRA
e6777e6b,23,16,20,3,0,12,24,12,41,31,10,46,69,146,2,19,FRA
e68f2cb4,29,18,10,12,7,14,38,24,18,0,18,17,46,12,0,19,FRA
e6eadfb8,67,38,45,19,3,41,65,24,31,3,28,39,106,52,1,19,FRA
e7986081,12,4,0,8,4,4,14,10,15,2,13,2,14,13,0,19,FRA
e8a65bc8,0,0,0,0,0,0,2,2,0,0,0,0,0,0,0,19,FRA
e8b5ad37,1,0,1,0,0,0,0,0,0,0,0,2,3,3,0,19,FRA
e90af77c,33,23,11,9,13,8,33,25,14,2,12,8,41,7,0,19,FRA
e97150c0,16,10,11,5,0,9,13,4,18,14,4,18,34,45,1,19,FRA
ea02beaf,51,32,25,18,8,20,45,25,29,5,24,42,93,34,0,19,FRA
ea0aa7e0,14,9,8,5,1,6,10,4,11,3,8,9,23,6,0,19,FRA
ea0ff634,38,25,8,22,8,8,33,25,20,5,15,6,44,30,0,19,FRA
ea540835,24,12,11,12,1,7,15,8,16,3,13,17,41,26,1,19,FRA
eb78322b,0,0,0,0,0,0,0,0,3,2,1,1,1,2,0,19,FRA
eba1e557,2,2,2,0,0,2,5,3,0,0,0,2,4,1,0,19,FRA
ec400194,51,25,38,11,2,24,43,19,33,8,25,45,96,93,2,19,FRA
ed0c3318,21,13,6,12,3,5,10,5,11,0,11,6,27,26,0,19,FRA
ed45c4a5,86,54,24,46,16,26,65,39,46,6,40,33,119,19,0,19,FRA
edd1466a,44,31,29,12,3,23,36,13,17,3,14,25,69,71,0,19,FRA
ef2e5e1a,76,40,21,47,8,20,52,32,24,6,18,24,100,26,0,19,FRA
ef7cd87a,48,31,14,28,6,19,56,37,25,10,15,47,95,29,1,19,FRA
ef9c1c95,101,60,39,50,12,33,85,52,40,6,34,54,155,58,0,19,FRA
f00de885,1,0,1,0,0,1,3,2,3,0,3,2,3,16,3,19,FRA
f09a8b75,34,22,8,13,13,15,38,23,14,2,12,11,45,16,1,19,FRA
f10983ae,19,8,13,5,1,10,17,7,14,0,14,10,29,19,1,19,FRA
f18d7ab2,5,5,3,2,0,1,4,3,0,0,0,3,8,3,0,19,FRA
f1b2365a,25,15,14,11,0,10,32,22,33,8,25,25,50,61,0,19,FRA
f3085377,3,1,2,1,0,0,4,4,1,0,1,3,6,1,0,19,FRA
f323d995,35,24,23,10,2,12,32,20,39,27,12,41,76,203,4,19,FRA
f3600c02,59,31,25,27,7,18,57,39,20,2,18,21,80,30,4,19,FRA
f3642ba8,15,11,3,11,1,3,10,7,3,0,3,2,17,10,0,19,FRA
f36c432f,2,1,1,1,0,1,3,2,1,0,1,1,3,3,0,19,FRA
f4319ee8,2,1,0,2,0,0,6,6,2,1,1,2,4,1,0,19,FRA
f449640d,93,66,52,35,6,41,72,31,45,9,36,55,148,80,4,19,FRA
f4bc42b1,30,19,13,10,7,20,45,25,29,1,28,16,46,11,0,19,FRA
f5044e54,74,46,31,36,7,25,62,37,44,8,36,36,110,37,0,19,FRA
f54d2149,3,3,1,2,0,1,7,6,1,0,1,1,4,2,0,19,FRA
f6db3bd5,0,0,0,0,0,0,1,1,0,0,0,0,0,6,2,19,FRA
f7691f63,33,18,20,9,4,21,45,24,11,2,9,18,51,22,0,19,FRA
f7b1d4e0,33,17,14,15,4,13,32,19,15,2,13,7,40,13,0,19,FRA
f83c8d6c,14,8,2,10,2,4,24,20,14,6,8,4,18,29,0,19,FRA
f86ca403,18,14,6,8,4,4,14,10,9,0,9,8,26,6,0,19,FRA
fa18c72e,23,17,8,9,6,9,24,15,6,1,5,3,26,4,0,19,FRA
fbbb9269,46,32,32,12,2,25,46,21,19,2,17,26,72,42,0,19,FRA
fbf76716,9,6,1,7,1,2,5,3,4,0,4,2,11,1,0,19,FRA
fca455cc,9,6,3,4,2,4,9,5,2,1,1,0,9,2,0,19,FRA
fcb38f57,0,0,0,0,0,0,0,0,1,0,1,0,0,12,1,19,FRA
fcbcbd94,10,8,3,3,4,2,12,10,14,3,11,5,15,15,0,19,FRA
fd2bc67d,54,40,36,16,2,24,41,17,56,30,26,38,92,156,2,19,FRA
fe006f82,1,1,0,1,0,1,2,1,0,0,0,1,2,1,1,19,FRA
ff0ab48c,51,22,25,21,5,20,35,15,30,10,20,22,73,61,1,19,FRA
ff3a6a60,3,2,0,3,0,3,9,6,1,0,1,0,3,0,0,19,FRA
00242715,35,22,29,6,0,16,29,13,40,26,14,40,75,124,4,20,GER
00242b75,38,21,16,19,3,14,29,15,18,3,15,9,47,18,1,20,GER
00844823,27,15,19,6,2,11,26,15,37,19,18,49,76,85,0,20,GER
009a4f60,7,5,2,1,4,3,6,3,5,3,2,5,12,9,0,20,GER
01834aa0,37,24,24,12,1,20,39,19,32,12,20,42,79,99,0,20,GER
01c3aff5,38,20,17,16,5,13,40,27,38,12,26,46,84,39,0,20,GER
028e70b9,5,2,0,2,3,2,4,2,2,0,2,1,6,0,0,20,GER
032f894e,0,0,0,0,0,0,0,0,0,0,0,0,0,0,0,20,GER
042e8a49,19,11,6,7,6,12,27,15,9,0,9,4,23,3,0,20,GER
048a1cbc,44,24,18,21,5,20,32,12,27,3,24,42,86,26,0,20,GER
05439de2,30,17,14,15,1,16,25,9,19,10,9,29,59,40,0,20,GER
054849d2,19,12,12,7,0,9,18,9,6,2,4,14,33,27,0,20,GER
056d2d95,71,41,35,32,4,32,54,22,31,10,21,51,122,88,1,20,GER
05d548d8,57,30,30,26,1,20,38,18,41,18,23,59,116,110,1,20,GER
05f99a4a,9,4,2,5,2,3,8,5,6,1,5,0,9,1,0,20,GER
070ec0b1,53,34,29,17,7,23,48,25,42,13,29,67,120,88,2,20,GER
080440a4,66,51,33,30,3,28,57,29,41,21,20,36,102,96,0,20,GER
08593525,37,18,14,17,6,12,34,22,25,8,17,40,77,27,1,20,GER
088ca1bd,42,27,19,19,4,19,37,18,23,8,15,35,77,84,0,20,GER
096a77c4,4,3,1,1,2,1,7,6,1,0,1,1,5,3,0,20,GER
099e666f,49,29,24,19,6,26,51,25,45,10,35,26,75,79,0,20,GER
0a1cb833,1,0,1,0,0,1,2,1,1,0,1,5,6,11,3,20,GER
0a3d6d2b,0,0,0,0,0,0,0,0,0,0,0,0,0,1,0,20,GER
0a3f6cde,25,16,13,9,3,9,33,24,29,2,27,15,40,14,0,20,GER
0b4f388a,22,11,2,15,5,4,15,11,12,1,11,8,30,5,0,20,GER
0c61c77c,25,18,13,8,4,10,28,18,22,4,18,10,35,14,0,20,GER
0cc5f4a5,0,0,0,0,0,0,0,0,0,0,0,0,0,0,0,20,GER
0d55d942,0,0,0,0,0,0,0,0,2,0,2,1,1,8,3,20,GER
0db5d2c8,4,3,3,1,0,2,4,2,7,3,4,13,17,33,0,20,GER
0e0102eb,1,1,1,0,0,0,0,0,1,0,1,1,2,0,0,20,GER
0e4fef6e,12,7,6,6,0,8,16,8,2,1,1,8,20,3,0,20,GER
0ef89a37,21,15,1,13,7,2,13,11,9,2,7,6,27,0,0,20,GER
0fbb73c2,42,25,30,8,4,22,48,26,25,10,15,19,61,49,1,20,GER
0fbecd11,44,35,15,25,4,18,53,35,31,11,20,30,74,16,0,20,GER
1025db8e,28,16,22,5,1,12,21,9,15,8,7,37,65,97,0,20,GER
106bca06,29,16,11,10,8,12,33,21,17,1,16,26,55,8,0,20,GER
10b9fa99,5,4,3,2,0,1,1,0,3,1,2,1,6,3,0,20,GER
1151fb6e,0,0,0,0,0,0,0,0,0,0,0,0,0,0,0,20,GER
11fd2b75,42,23,17,22,3,21,57,36,46,14,32,62,104,40,0,20,GER
1238a3f9,8,3,3,3,2,4,9,5,8,1,7,1,9,13,0,20,GER
13203c45,48,29,26,18,4,15,29,14,33,5,28,30,78,58,0,20,GER
140afefb,3,2,3,0,0,1,1,0,1,0,1,1,4,1,0,20,GER
14a7af33,23,17,16,5,2,9,16,7,13,7,6,14,37,50,1,20,GER
15b287da,29,20,7,17,5,8,42,34,16,1,15,10,39,6,0,20,GER
15fd5593,55,43,19,23,13,19,57,38,46,18,28,38,93,45,2,20,GER
16b4260e,0,0,0,0,0,0,1,1,0,0,0,0,0,0,0,20,GER
16daec92,19,11,7,8,4,6,25,19,26,2,24,15,34,6,0,20,GER
17376543,1,0,1,0,0,1,4,3,0,0,0,2,3,26,4,20,GER
1748c9f7,4,2,2,2,0,0,1,1,0,0,0,0,4,1,0,20,GER
17611373,11,5,2,7,2,3,18,15,12,0,12,2,13,33,0,20,GER
17780d2b,9,6,5,4,0,3,8,5,8,4,4,11,20,5,0,20,GER
17f3620a,5,4,1,1,3,0,11,11,7,0,7,5,10,3,0,20,GER
1a1033a1,35,22,12,17,6,10,38,28,31,1,30,9,44,9,0,20,GER
1ae836b1,16,12,9,5,2,5,13,8,7,0,7,3,19,4,0,20,GER
1b278bf5,8,5,6,2,0,2,10,8,5,2,3,2,10,5,0,20,GER
1bcca8b8,1,1,0,1,0,1,7,6,2,0,2,1,2,0,0,20,GER
1c08a3c8,16,8,7,8,1,10,19,9,18,3,15,7,23,16,2,20,GER
1c96ad85,8,6,2,5,1,5,6,1,3,1,2,1,9,5,0,20,GER
1cbe4984,21,16,11,9,1,10,13,3,12,2,10,9,30,11,0,20,GER
1d1691ad,2,2,1,0,1,2,3,1,1,0,1,1,3,2,0,20,GER
1d8e9add,21,15,12,9,0,11,25,14,27,18,9,33,54,89,2,20,GER
1e274a0a,14,12,3,5,6,3,20,17,13,2,11,7,21,7,0,20,GER
1f44ac21,4,2,1,0,3,0,4,4,7,4,3,4,8,4,0,20,GER
1fda91b3,2,1,2,0,0,2,2,0,0,0,0,0,2,3,0,20,GER
1fdec858,11,6,4,4,3,5,18,13,11,1,10,3,14,9,0,20,GER
20030c06,20,12,13,7,0,12,20,8,14,3,11,16,36,52,1,20,GER
2042d931,1,0,1,0,0,0,2,2,2,0,2,0,1,1,0,20,GER
217c93a1,4,4,2,2,0,1,4,3,2,1,1,0,4,0,0,20,GER
2200181e,38,25,26,11,1,20,37,17,28,15,13,45,83,72,1,20,GER
226ddf9d,0,0,0,0,0,0,0,0,0,0,0,0,0,0,0,20,GER
22919e97,11,7,3,6,2,3,21,18,8,1,7,2,13,4,0,20,GER
229cd98a,3,0,0,2,1,1,10,9,0,0,0,0,3,3,0,20,GER
23a10591,0,0,0,0,0,0,0,0,0,0,0,0,0,0,0,20,GER
25ab9c9c,28,16,17,9,2,15,24,9,23,13,10,22,50,80,1,20,GER
271b8617,20,14,5,7,8,9,28,19,16,1,15,16,36,16,0,20,GER
27d2618c,4,1,4,0,0,2,3,1,0,0,0,1,5,11,3,20,GER
289b90cd,0,0,0,0,0,0,1,1,0,0,0,0,0,9,4,20,GER
28eaa0f3,20,11,9,10,1,11,21,10,8,1,7,4,24,10,1,20,GER
2903a856,43,27,22,12,9,22,76,54,28,3,25,18,61,14,0,20,GER
2979c05a,24,14,14,6,4,15,37,22,21,1,20,6,30,8,0,20,GER
2a29eb9b,1,1,0,1,0,1,5,4,2,0,2,1,2,6,0,20,GER
2a6cd437,14,9,11,2,1,9,10,1,11,7,4,19,33,21,1,20,GER
2b09d998,22,15,13,8,1,12,25,13,16,1,15,14,36,14,0,20,GER
2b53f7a5,11,7,5,5,1,3,11,8,9,0,9,6,17,1,0,20,GER
2bcc6d52,7,3,0,5,2,4,15,11,12,3,9,4,11,10,0,20,GER
2c0558b8,0,0,0,0,0,0,0,0,0,0,0,0,0,0,0,20,GER
2d61d13a,37,23,28,9,0,14,21,7,33,19,14,37,74,97,0,20,GER
2db2fd7b,21,14,9,12,0,11,22,11,15,11,4,33,54,58,1,20,GER
2e7ff968,0,0,0,0,0,0,0,0,0,0,0,0,0,0,0,20,GER
2f3e911a,29,15,17,8,4,9,22,13,11,5,6,30,59,36,0,20,GER
2ff76adc,11,5,9,2,0,7,12,5,10,1,9,3,14,11,0,20,GER
302527b2,11,4,10,1,0,6,13,7,24,17,7,28,39,86,0,20,GER
30941e96,15,9,7,5,3,5,15,10,14,1,13,19,34,24,0,20,GER
30c220c3,41,29,20,17,4,18,30,12,19,2,17,24,65,22,1,20,GER
316162b6,21,12,7,11,3,5,16,11,12,1,11,15,36,7,0,20,GER
33144cc5,10,3,3,2,5,3,13,10,4,0,4,5,15,1,0,20,GER
33340bd6,0,0,0,0,0,0,0,0,0,0,0,0,0,2,1,20,GER
3376a776,16,10,10,6,0,3,6,3,23,15,8,18,34,44,0,20,GER
33a95e0a,69,43,44,21,4,37,62,25,53,19,34,70,139,91,1,20,GER
33b554b7,33,19,15,17,1,16,49,33,22,5,17,17,50,24,0,20,GER
346d51d9,16,9,12,3,1,9,16,7,10,0,10,8,24,21,0,20,GER
3489184e,1,1,1,0,0,1,2,1,0,0,0,0,1,1,0,20,GER
34a0f5ff,15,8,11,1,3,5,13,8,20,0,20,18,33,10,0,20,GER
34b306a1,48,22,30,18,0,16,50,34,22,9,13,56,104,90,0,20,GER
34b54da7,33,21,23,10,0,15,24,9,20,11,9,27,60,48,0,20,GER
34e12499,6,3,4,2,0,2,5,3,7,5,2,3,9,20,1,20,GER
34e4343c,10,5,1,5,4,1,10,9,5,3,2,0,10,19,0,20,GER
3588d4fe,0,0,0,0,0,0,0,0,0,0,0,0,0,2,0,20,GER
364445b2,19,12,10,9,0,5,13,8,16,7,9,32,51,57,0,20,GER
36a3ff67,26,16,5,11,10,3,19,16,17,2,15,9,35,11,0,20,GER
36a59ba4,42,23,13,22,7,12,54,42,24,4,20,27,69,8,0,20,GER
3745e8bd,2,2,0,1,1,1,3,2,2,0,2,1,3,1,0,20,GER
378825c7,33,17,17,12,4,18,31,13,24,4,20,38,71,49,0,20,GER
37c213cf,1,1,0,1,0,0,0,0,0,0,0,0,1,0,0,20,GER
37f606f0,12,5,4,6,2,2,16,14,9,2,7,6,18,4,0,20,GER
384d58d9,49,30,23,23,3,20,39,19,39,12,27,37,86,31,1,20,GER
3861d9cc,0,0,0,0,0,0,0,0,0,0,0,0,0,0,0,20,GER
3a233281,6,3,1,5,0,6,16,10,9,0,9,8,14,3,0,20,GER
3acad81a,11,6,5,6,0,5,10,5,14,8,6,12,23,17,0,20,GER
3bb625ac,33,20,12,15,6,15,33,18,17,9,8,32,65,47,1,20,GER
3c6089ab,45,27,7,26,12,22,69,47,27,3,24,12,57,8,0,20,GER
3cd9e95a,0,0,0,0,0,0,5,5,0,0,0,2,2,15,1,20,GER
3eb0f2df,50,27,14,31,5,11,48,37,44,7,37,27,77,19,2,20,GER
3eeb80e0,3,1,2,1,0,2,7,5,7,1,6,1,4,3,0,20,GER
3effaa34,7,2,0,5,2,2,14,12,9,0,9,8,15,4,0,20,GER
3f65898c,36,27,23,10,3,17,35,18,26,9,17,63,99,81,0,20,GER
3f7cd8f1,15,12,8,5,2,6,23,17,8,2,6,16,31,15,0,20,GER
3faa1780,9,4,3,5,1,3,6,3,5,0,5,5,14,3,0,20,GER
4114f306,10,6,4,5,1,6,16,10,14,4,10,6,16,15,0,20,GER
420c18a1,0,0,0,0,0,0,1,1,0,0,0,1,1,11,6,20,GER
42130443,0,0,0,0,0,0,0,0,0,0,0,0,0,5,4,20,GER
431c837b,69,39,30,35,4,30,61,31,33,6,27,32,101,50,2,20,GER
437f2b00,32,17,15,16,1,10,37,27,25,1,24,8,40,13,0,20,GER
441197b8,27,13,13,11,3,15,28,13,28,6,22,29,56,57,0,20,GER
442b56fa,54,31,25,22,7,26,53,27,45,7,38,42,96,57,0,20,GER
45954ec7,21,10,14,5,2,7,12,5,13,4,9,32,53,49,2,20,GER
45a03961,34,22,15,10,9,16,28,12,28,10,18,52,86,60,0,20,GER
45f6f52b,0,0,0,0,0,0,0,0,0,0,0,0,0,1,0,20,GER
47064058,0,0,0,0,0,0,0,0,1,0,1,3,3,15,0,20,GER
48035304,45,27,37,8,0,19,38,19,32,15,17,62,107,112,0,20,GER
482b70ad,4,2,1,3,0,2,9,7,5,3,2,1,5,4,0,20,GER
4830e0af,20,16,6,11,3,9,27,18,9,2,7,8,28,18,1,20,GER
49296448,52,29,21,20,11,22,55,33,38,9,29,29,81,29,0,20,GER
493924a7,69,48,39,24,6,35,54,19,33,10,23,23,92,53,0,20,GER
4942dad3,2,0,0,0,2,0,1,1,1,1,0,0,2,3,0,20,GER
496aeede,45,29,19,21,5,19,49,30,22,3,19,14,59,19,0,20,GER
49fe9070,20,9,6,7,7,3,16,13,16,0,16,5,25,2,0,20,GER
49ffe0f2,9,6,7,1,1,3,6,3,3,2,1,0,9,2,0,20,GER
4aea5077,51,30,25,19,7,24,54,30,38,7,31,29,80,71,0,20,GER
4b6dd263,8,5,3,4,1,4,12,8,3,0,3,2,10,4,0,20,GER
4ba886c6,1,0,0,1,0,0,1,1,0,0,0,0,1,0,0,20,GER
4bd00a50,6,3,4,2,0,1,4,3,2,0,2,2,8,2,0,20,GER
4c6facae,56,33,26,17,13,16,47,31,15,3,12,30,86,9,0,20,GER
4d50454e,17,9,7,9,1,7,27,20,12,0,12,8,25,4,0,20,GER
4d7faad1,17,9,9,6,2,8,15,7,6,3,3,3,20,13,1,20,GER
4e204552,3,2,3,0,0,3,8,5,3,0,3,3,6,1,0,20,GER
4e3a947f,1,0,1,0,0,1,1,0,1,1,0,0,1,0,0,20,GER
4f16405e,2,2,1,1,0,1,3,2,3,0,3,3,5,6,0,20,GER
50871bcc,40,27,17,14,9,12,50,38,29,0,29,13,53,2,1,20,GER
50e6dc35,2,2,0,2,0,0,6,6,3,2,1,1,3,11,0,20,GER
53070b63,4,3,3,1,0,1,2,1,5,1,4,1,5,0,0,20,GER
536cebe5,1,0,0,1,0,0,0,0,0,0,0,0,1,1,0,20,GER
53e07d0b,8,4,0,6,2,1,11,10,9,0,9,2,10,14,0,20,GER
541127d5,12,10,5,4,3,5,14,9,8,1,7,7,19,5,0,20,GER
543ddcaf,10,9,3,6,1,5,9,4,6,1,5,3,13,8,0,20,GER
54b4dc4e,35,19,10,21,4,12,31,19,19,5,14,22,57,7,1,20,GER
54b6ee79,2,1,0,1,1,0,1,1,2,0,2,2,4,2,0,20,GER
54e4866f,15,10,9,3,3,6,25,19,13,1,12,14,29,18,1,20,GER
55557b25,4,1,3,1,0,1,3,2,4,1,3,4,8,4,0,20,GER
555d5edd,26,16,7,15,4,16,34,18,12,2,10,14,40,8,1,20,GER
56413b1f,56,37,19,29,8,27,74,47,27,6,21,22,78,21,1,20,GER
565bf0da,21,14,16,4,1,15,32,17,27,11,16,25,46,61,1,20,GER
5722eced,2,1,0,2,0,1,9,8,1,1,0,3,5,0,0,20,GER
582a5247,4,2,3,0,1,2,6,4,3,1,2,2,6,0,0,20,GER
58ce23e5,4,4,2,1,1,0,16,16,10,0,10,10,14,4,0,20,GER
5939baa2,31,19,14,15,2,11,21,10,16,6,10,12,43,28,1,20,GER
59e4b92e,60,36,21,35,4,18,45,27,47,12,35,48,108,62,0,20,GER
5c4bf6ba,1,1,1,0,0,1,1,0,0,0,0,0,1,11,0,20,GER
5d4f7d61,7,3,1,3,3,2,9,7,8,2,6,2,9,17,0,20,GER
5d8e331f,65,40,31,28,6,22,64,42,58,18,40,71,136,59,3,20,GER
5db45ee5,5,2,0,1,4,1,2,1,2,0,2,0,5,0,0,20,GER
5ddb8f9f,26,17,14,8,4,6,16,10,16,1,15,15,41,26,0,20,GER
5dfc6ad5,28,20,10,17,1,14,33,19,26,7,19,31,59,19,1,20,GER
5ed9b537,11,6,10,1,0,2,7,5,9,4,5,5,16,35,1,20,GER
5fd5e542,7,3,2,4,1,4,10,6,4,0,4,5,12,3,0,20,GER
603cb947,2,1,1,0,1,1,7,6,6,0,6,3,5,4,0,20,GER
607d64c6,1,0,1,0,0,0,3,3,1,0,1,1,2,1,0,20,GER
60dfc525,0,0,0,0,0,0,0,0,0,0,0,0,0,0,0,20,GER
610aa1e9,33,24,27,6,0,22,41,19,20,9,11,12,45,67,0,20,GER
612cb8d3,0,0,0,0,0,0,0,0,1,1,0,0,0,0,0,20,GER
61fc9685,4,2,1,2,1,1,3,2,0,0,0,1,5,1,0,20,GER
625e41b1,15,9,0,9,6,1,13,12,12,2,10,6,21,2,0,20,GER
626fab5f,43,25,23,16,4,21,29,8,23,9,14,20,63,26,0,20,GER
62ab9184,28,18,7,15,6,8,21,13,11,3,8,12,40,9,0,20,GER
62ba5881,0,0,0,0,0,0,0,0,0,0,0,1,1,0,0,20,GER
635f2732,63,33,21,31,11,20,57,37,38,1,37,26,89,6,0,20,GER
64ba07c0,16,10,9,6,1,7,13,6,7,0,7,8,24,31,1,20,GER
64f69877,16,6,5,6,5,5,16,11,14,2,12,5,21,7,0,20,GER
652d4c37,9,4,4,3,2,1,9,8,9,3,6,4,13,2,1,20,GER
66385c46,28,19,13,12,3,12,35,23,27,1,26,9,37,14,2,20,GER
664590fa,15,10,6,8,1,4,13,9,9,1,8,9,24,12,0,20,GER
677da306,43,26,30,12,1,19,29,10,40,30,10,36,79,125,2,20,GER
69374ff5,42,21,15,21,6,18,42,24,37,4,33,20,62,16,1,20,GER
699fb8db,47,30,40,6,1,17,43,26,38,25,13,41,88,131,1,20,GER
6bba916f,2,0,1,1,0,0,1,1,3,0,3,3,5,0,0,20,GER
6bd5cd5d,29,14,24,5,0,17,30,13,19,11,8,27,56,77,1,20,GER
6c6a3300,21,14,13,6,2,9,33,24,15,2,13,6,27,16,1,20,GER
6cafd68d,4,1,3,1,0,3,7,4,17,12,5,13,17,45,0,20,GER
6cb0211b,1,1,1,0,0,0,0,0,0,0,0,0,1,0,0,20,GER
6cc47ae1,5,4,0,4,1,1,4,3,1,0,1,0,5,3,0,20,GER
6ec6fde0,24,16,20,4,0,13,24,11,21,11,10,13,37,48,0,20,GER
6ecbddf6,32,16,18,7,7,8,36,28,26,1,25,26,58,35,0,20,GER
6f8cd6d0,26,18,7,8,11,11,29,18,20,1,19,12,38,18,0,20,GER
6fd8a334,18,11,11,6,1,10,21,11,9,3,6,15,33,39,0,20,GER
6fe90922,16,12,5,6,5,8,33,25,14,3,11,4,20,8,0,20,GER
70678132,19,14,9,8,2,11,29,18,13,3,10,12,31,9,0,20,GER
70dcf94d,26,18,8,14,4,12,45,33,25,4,21,25,51,23,0,20,GER
7124239e,0,0,0,0,0,0,0,0,0,0,0,0,0,0,0,20,GER
7242b495,46,31,31,11,4,22,45,23,23,6,17,27,73,55,1,20,GER
73000a79,20,16,11,6,3,8,24,16,12,3,9,10,30,16,0,20,GER
7391c2d9,21,16,11,9,1,11,24,13,22,7,15,13,34,33,0,20,GER
74c7c2db,25,17,15,7,3,11,32,21,27,5,22,11,36,8,0,20,GER
74d70fb5,3,2,3,0,0,2,4,2,5,3,2,3,6,11,1,20,GER
76b2817e,79,53,44,30,5,33,53,20,28,8,20,39,118,79,1,20,GER
76e5da9d,5,3,2,2,1,2,4,2,4,1,3,2,7,3,0,20,GER
77e84962,45,26,17,23,5,12,33,21,12,3,9,45,90,13,1,20,GER
78b9e99c,0,0,0,0,0,0,0,0,0,0,0,0,0,0,0,20,GER
791abba1,16,9,12,4,0,11,19,8,19,7,12,21,37,50,0,20,GER
791af558,0,0,0,0,0,0,2,2,2,0,2,0,0,0,0,20,GER
792ffa71,0,0,0,0,0,0,0,0,0,0,0,0,0,0,0,20,GER
7961f7aa,7,4,2,3,2,1,10,9,5,1,4,7,14,14,0,20,GER
79c90e45,32,22,17,13,2,13,30,17,29,7,22,27,59,55,1,20,GER
79ca3e23,6,4,1,2,3,1,10,9,3,1,2,5,11,5,0,20,GER
7aac47fe,7,3,5,2,0,4,11,7,14,8,6,25,32,64,2,20,GER
7bd5b8fd,0,0,0,0,0,0,0,0,0,0,0,0,0,0,0,20,GER
7bf8ad6c,4,4,1,2,1,0,2,2,5,0,5,2,6,0,0,20,GER
7c104bb7,6,4,3,1,2,1,1,0,3,0,3,1,7,0,1,20,GER
7c3ed041,2,1,1,1,0,2,2,0,0,0,0,4,6,3,0,20,GER
7c473e12,24,18,17,5,2,4,12,8,39,32,7,62,86,158,1,20,GER
7c56da38,21,13,4,11,6,9,33,24,25,2,23,20,41,8,0,20,GER
7ca196eb,2,1,0,2,0,0,1,1,1,0,1,0,2,2,0,20,GER
7cd6badb,27,16,4,15,8,10,28,18,18,2,16,10,37,7,0,20,GER
7d3e7da6,0,0,0,0,0,0,0,0,0,0,0,0,0,0,0,20,GER
7d841904,0,0,0,0,0,0,1,1,1,0,1,0,0,0,0,20,GER
7f609bfc,63,34,35,27,1,35,63,28,57,25,32,40,103,101,1,20,GER
7f97771d,16,12,9,7,0,9,11,2,9,8,1,18,34,30,0,20,GER
7fa4e703,6,2,1,5,0,1,4,3,3,0,3,0,6,2,0,20,GER
7fe12375,1,0,1,0,0,1,2,1,0,0,0,0,1,5,1,20,GER
809940aa,34,25,12,19,3,8,32,24,11,5,6,26,60,11,0,20,GER
80f36c88,73,49,31,29,13,28,75,47,26,5,21,27,100,38,0,20,GER
821233cc,30,18,12,16,2,8,32,24,21,8,13,34,64,89,0,20,GER
826e8b63,42,29,22,16,4,20,45,25,19,4,15,26,68,50,0,20,GER
834d0be5,6,3,0,4,2,1,8,7,12,2,10,1,7,9,0,20,GER
8494acc4,26,16,19,7,0,13,29,16,14,4,10,26,52,47,0,20,GER
8593f88c,25,11,17,7,1,12,35,23,29,13,16,14,39,40,0,20,GER
861e0116,10,3,7,2,1,4,10,6,10,3,7,2,12,17,0,20,GER
863ff1ee,8,5,4,3,1,3,13,10,14,3,11,2,10,14,0,20,GER
864db10a,8,5,3,5,0,6,12,6,5,1,4,7,15,22,0,20,GER
867501bf,18,9,4,9,5,7,24,17,11,1,10,7,25,1,0,20,GER
86e119e0,42,24,15,23,4,16,62,46,25,6,19,25,67,35,0,20,GER
8778c910,2,1,1,0,1,2,4,2,0,0,0,0,2,15,4,20,GER
88d4144a,61,38,31,25,5,26,54,28,38,6,32,53,114,64,0,20,GER
88e357ef,36,16,4,19,13,9,29,20,17,0,17,16,52,2,1,20,GER
88f130ed,15,10,10,5,0,8,9,1,2,0,2,15,30,24,0,20,GER
8954fddc,32,21,22,8,2,14,33,19,17,5,12,18,50,39,0,20,GER
89565ac5,2,1,1,1,0,1,1,0,0,0,0,1,3,2,0,20,GER
89ac64a6,38,21,23,14,1,12,20,8,20,11,9,30,68,61,2,20,GER
8a080a61,43,22,21,17,5,17,58,41,34,6,28,14,57,20,1,20,GER
8b6e0db2,7,4,2,4,1,2,8,6,8,5,3,5,12,10,1,20,GER
8b8e759d,56,34,21,30,5,19,63,44,43,9,34,22,78,69,0,20,GER
8d78e732,18,9,3,9,6,3,15,12,13,1,12,7,25,13,0,20,GER
8e235926,10,7,0,8,2,0,13,13,13,2,11,5,15,17,0,20,GER
8e58987d,30,18,13,17,0,7,21,14,11,3,8,16,46,9,2,20,GER
8eb55dbb,2,1,2,0,0,1,3,2,1,0,1,0,2,1,0,20,GER
8f056768,47,29,13,30,4,14,44,30,16,2,14,17,64,12,0,20,GER
8f0f2230,11,5,2,5,4,4,9,5,9,4,5,2,13,7,0,20,GER
8ff2354e,46,31,27,17,2,28,58,30,37,11,26,46,92,72,2,20,GER
90339309,46,25,34,10,2,14,34,20,35,19,16,52,98,86,1,20,GER
912e63b5,11,6,5,5,1,5,10,5,3,1,2,3,14,0,0,20,GER
92432bc6,26,16,7,17,2,10,24,14,14,2,12,8,34,10,1,20,GER
924f9191,14,11,6,6,2,7,19,12,10,2,8,14,28,9,0,20,GER
92948149,44,31,26,16,2,20,30,10,16,4,12,27,71,61,1,20,GER
93a50d2c,14,7,12,1,1,9,19,10,16,12,4,25,39,54,0,20,GER
94c18565,21,13,12,6,3,15,33,18,26,2,24,13,34,11,0,20,GER
95a24690,2,2,1,1,0,0,1,1,0,0,0,0,2,1,0,20,GER
962e54cb,9,5,1,4,4,3,13,10,9,1,8,1,10,11,0,20,GER
9908c518,0,0,0,0,0,0,0,0,0,0,0,0,0,2,0,20,GER
99b1d0e6,23,14,16,5,2,10,22,12,15,7,8,16,39,35,0,20,GER
99b7584f,0,0,0,0,0,0,0,0,0,0,0,0,0,0,0,20,GER
99be8fb5,8,6,4,2,2,1,6,5,0,0,0,3,11,10,0,20,GER
99de6b6f,42,26,33,9,0,23,45,22,18,13,5,30,72,98,2,20,GER
9a2e0ccc,16,10,5,8,3,6,26,20,15,0,15,5,21,3,0,20,GER
9ab16552,28,20,16,9,3,18,39,21,38,10,28,26,54,38,0,20,GER
9af1f9ff,3,1,3,0,0,0,1,1,4,2,2,1,4,4,0,20,GER
9c2394c9,26,22,21,5,0,20,42,22,16,10,6,25,51,92,0,20,GER
9ceb7642,34,17,15,18,1,12,30,18,16,4,12,26,60,55,0,20,GER
9d12e142,2,2,2,0,0,2,3,1,1,0,1,2,4,13,1,20,GER
9efa1d25,10,7,0,6,4,3,12,9,3,0,3,2,12,1,0,20,GER
9f381d8b,9,6,1,5,3,3,13,10,19,1,18,5,14,17,0,20,GER
9f77012e,1,1,0,1,0,1,2,1,0,0,0,0,1,0,0,20,GER
9f979eb2,6,5,2,4,0,1,2,1,13,11,2,14,20,30,0,20,GER
9fec8860,29,12,15,9,5,12,23,11,19,5,14,10,39,29,0,20,GER
a0415710,34,23,18,9,7,10,23,13,25,3,22,24,58,30,0,20,GER
a167537f,48,33,15,21,12,25,55,30,35,2,33,16,64,10,1,20,GER
a2a85828,1,1,0,0,1,0,2,2,2,0,2,3,4,1,0,20,GER
a3ddb1b9,22,14,5,11,6,9,35,26,19,0,19,8,30,3,0,20,GER
a4effc55,16,10,12,4,0,6,8,2,12,8,4,15,31,38,0,20,GER
a4f94a0d,53,28,16,32,5,22,73,51,46,8,38,54,107,50,0,20,GER
a53b661f,27,15,9,13,5,8,23,15,25,4,21,11,38,25,0,20,GER
a5ae8f8e,55,33,36,18,1,33,53,20,25,11,14,26,81,92,1,20,GER
a5ce09f2,2,1,1,1,0,1,2,1,0,0,0,0,2,1,0,20,GER
a5ec3ede,26,10,19,6,1,16,27,11,20,9,11,23,49,60,1,20,GER
a65ce836,19,12,11,7,1,5,12,7,14,6,8,19,38,15,0,20,GER
a70b8345,0,0,0,0,0,0,1,1,0,0,0,0,0,1,0,20,GER
a73c8f95,24,15,17,5,2,15,25,10,9,5,4,9,33,44,0,20,GER
a7813ac4,40,27,13,23,4,15,34,19,16,2,14,14,54,58,0,20,GER
a7a9d95a,2,2,0,2,0,1,5,4,4,1,3,2,4,3,0,20,GER
a8d4428b,11,6,5,4,2,2,12,10,17,1,16,14,25,21,0,20,GER
a92ab7be,0,0,0,0,0,0,1,1,0,0,0,0,0,2,2,20,GER
aad48be9,36,20,24,10,2,9,21,12,27,12,15,21,57,97,2,20,GER
ab5b7dc1,38,22,19,13,6,17,54,37,37,3,34,11,49,20,1,20,GER
ab700320,9,7,6,1,2,1,10,9,5,0,5,7,16,2,1,20,GER
abf0cad0,0,0,0,0,0,0,3,3,2,1,1,1,1,1,0,20,GER
ac73ec79,61,39,39,12,10,25,38,13,26,4,22,47,108,57,0,20,GER
acc7b7ec,9,5,4,4,1,3,12,9,3,1,2,1,10,1,0,20,GER
ad00b1a8,28,17,13,11,4,16,36,20,11,1,10,16,44,27,0,20,GER
ad3389d5,0,0,0,0,0,0,1,1,0,0,0,2,2,19,2,20,GER
ae44e8e2,20,14,5,10,5,1,13,12,7,1,6,4,24,6,0,20,GER
aeaf1bc1,0,0,0,0,0,0,1,1,0,0,0,0,0,0,0,20,GER
aeda1f69,24,16,4,13,7,7,19,12,10,2,8,3,27,5,0,20,GER
aeed5c06,10,8,3,7,0,5,15,10,6,0,6,9,19,4,0,20,GER
afb0c500,0,0,0,0,0,0,0,0,0,0,0,2,2,9,6,20,GER
b0a0698b,43,34,26,16,1,22,45,23,24,13,11,35,78,110,1,20,GER
b1823b08,1,1,1,0,0,0,0,0,1,1,0,0,1,1,0,20,GER
b1cd37e6,59,38,30,20,9,22,59,37,45,2,43,23,82,16,0,20,GER
b3325a30,56,37,16,33,7,18,61,43,39,7,32,24,80,7,0,20,GER
b3b7f5a6,22,10,9,8,5,9,16,7,9,4,5,13,35,21,0,20,GER
b48215cd,6,4,4,2,0,3,8,5,8,1,7,7,13,7,1,20,GER
b4cf5806,20,10,0,12,8,4,19,15,19,3,16,5,25,36,0,20,GER
b4d90315,10,4,6,4,0,4,10,6,7,1,6,1,11,1,0,20,GER
b500b384,14,6,2,9,3,4,15,11,10,0,10,5,19,4,0,20,GER
b50ec54b,15,12,2,9,4,5,14,9,10,1,9,3,18,2,0,20,GER
b69261a0,26,14,16,8,2,12,31,19,27,6,21,20,46,45,0,20,GER
b6a6e0a7,11,10,7,2,2,9,19,10,4,1,3,9,20,12,0,20,GER
b77f44a4,45,31,30,14,1,12,37,25,46,24,22,42,87,110,0,20,GER
b7828a08,0,0,0,0,0,0,2,2,0,0,0,0,0,0,0,20,GER
b797f558,8,6,5,3,0,3,12,9,2,0,2,2,10,2,0,20,GER
b825a650,17,11,7,10,0,7,23,16,7,2,5,16,33,6,0,20,GER
b82880c6,0,0,0,0,0,0,1,1,3,3,0,3,3,5,0,20,GER
b93b7882,3,1,1,2,0,2,3,1,6,0,6,2,5,2,1,20,GER
bb25c778,0,0,0,0,0,0,0,0,0,0,0,1,1,0,0,20,GER
bb8a42fa,42,26,21,20,1,14,46,32,34,11,23,25,67,39,0,20,GER
bbd86530,63,37,37,20,6,26,49,23,46,11,35,43,106,65,0,20,GER
bc249af8,2,2,1,1,0,2,2,0,2,0,2,0,2,1,0,20,GER
bc6bd723,16,7,5,6,5,8,28,20,21,2,19,9,25,7,0,20,GER
bcb2ccd8,0,0,0,0,0,0,0,0,0,0,0,1,1,18,6,20,GER
bd142efb,36,26,23,11,2,18,29,11,25,13,12,27,63,98,2,20,GER
bd527260,8,5,3,5,0,4,12,8,6,1,5,6,14,17,0,20,GER
bd992863,0,0,0,0,0,0,1,1,1,0,1,0,0,0,0,20,GER
be42a291,3,0,0,1,2,1,4,3,0,0,0,0,3,0,0,20,GER
be5e1c4c,13,8,5,7,1,9,20,11,13,2,11,6,19,8,0,20,GER
beb882a8,40,28,20,18,2,15,43,28,37,8,29,36,76,57,0,20,GER
beda9675,11,7,3,6,2,4,15,11,5,0,5,2,13,5,0,20,GER
bee0bab1,19,11,9,7,3,9,28,19,16,0,16,10,29,4,0,20,GER
bf075f6b,17,10,4,9,4,7,20,13,12,2,10,7,24,4,0,20,GER
bf9d9070,3,1,3,0,0,2,4,2,0,0,0,0,3,7,2,20,GER
c18d22f5,14,7,7,3,4,8,20,12,11,4,7,7,21,31,0,20,GER
c1b7847c,91,45,30,46,15,43,102,59,51,8,43,34,125,14,0,20,GER
c2009df3,76,49,37,34,5,24,75,51,44,10,34,46,122,38,1,20,GER
c2211709,74,52,30,37,7,29,77,48,47,9,38,67,141,33,0,20,GER
c3ee18ef,18,9,13,3,2,9,15,6,6,1,5,15,33,17,0,20,GER
c3fd9887,4,3,0,1,3,0,3,3,4,0,4,1,5,15,0,20,GER
c41f7379,0,0,0,0,0,0,0,0,0,0,0,0,0,2,0,20,GER
c46607bf,1,0,0,0,1,0,0,0,0,0,0,4,5,6,0,20,GER
c4e87b8b,15,8,4,5,6,1,17,16,17,4,13,2,17,30,0,20,GER
c50281a0,42,26,17,20,5,19,38,19,32,6,26,24,66,30,0,20,GER
c5224618,7,5,7,0,0,4,6,2,4,1,3,6,13,15,0,20,GER
c5fd13e9,7,2,4,2,1,3,6,3,6,4,2,12,19,41,0,20,GER
c6608135,1,1,1,0,0,1,2,1,0,0,0,1,2,0,0,20,GER
c89e8aae,0,0,0,0,0,0,1,1,0,0,0,0,0,4,0,20,GER
c8c60119,32,19,18,11,3,11,22,11,18,7,11,23,55,54,1,20,GER
c8cfb04d,3,1,1,2,0,2,4,2,0,0,0,3,6,1,0,20,GER
ca618d23,35,15,11,16,8,11,46,35,30,9,21,12,47,38,0,20,GER
ca8033cb,45,26,24,16,5,18,31,13,34,16,18,26,71,101,2,20,GER
cac55e10,0,0,0,0,0,0,0,0,0,0,0,0,0,1,0,20,GER
cbac6ec9,0,0,0,0,0,0,0,0,0,0,0,2,2,3,1,20,GER
cc86b9a3,28,15,7,18,3,10,32,22,18,2,16,24,52,8,0,20,GER
cce7087c,5,4,1,3,1,1,5,4,1,1,0,2,7,4,0,20,GER
cd82452e,15,9,7,5,3,5,21,16,23,5,18,13,28,14,0,20,GER
ce17b5eb,0,0,0,0,0,0,1,1,0,0,0,3,3,5,0,20,GER
ce2c51c0,7,5,5,2,0,4,9,5,7,0,7,8,15,3,0,20,GER
cf623c78,13,6,9,2,2,9,17,8,11,2,9,3,16,11,0,20,GER
d01b9ad6,0,0,0,0,0,0,0,0,0,0,0,1,1,0,0,20,GER
d1273f09,58,37,18,25,15,27,74,47,67,6,61,25,83,39,0,20,GER
d1661819,72,50,42,21,9,36,62,26,35,6,29,37,109,68,0,20,GER
d2416c2e,14,10,2,10,2,4,21,17,12,0,12,4,18,15,0,20,GER
d248cd8f,52,31,37,15,0,23,43,20,31,17,14,43,95,88,1,20,GER
d2c580ce,2,1,1,1,0,0,6,6,3,1,2,4,6,4,0,20,GER
d3112d86,73,45,34,31,8,28,81,53,47,6,41,34,107,50,0,20,GER
d4a2533d,18,8,5,6,7,5,23,18,26,0,26,16,34,4,0,20,GER
d4d0a9ad,55,26,34,14,7,27,59,32,10,3,7,24,79,38,1,20,GER
d5575935,14,9,3,8,3,6,21,15,4,1,3,9,23,8,0,20,GER
d571df78,8,6,2,2,4,3,12,9,6,0,6,2,10,4,0,20,GER
d5980989,8,3,3,4,1,3,10,7,3,0,3,1,9,1,0,20,GER
d6862409,21,13,7,9,5,4,21,17,21,5,16,8,29,38,0,20,GER
d728acae,2,1,2,0,0,2,3,1,6,5,1,0,2,12,0,20,GER
d781d855,70,43,35,24,11,38,58,20,35,6,29,31,101,51,0,20,GER
d8f5dc3d,4,1,0,3,1,1,7,6,1,1,0,3,7,3,0,20,GER
db401046,0,0,0,0,0,0,0,0,0,0,0,0,0,9,1,20,GER
db4ed67b,10,6,4,4,2,6,18,12,8,2,6,8,18,4,0,20,GER
dbf053da,14,11,6,6,2,8,24,16,8,0,8,14,28,6,0,20,GER
dc29b608,0,0,0,0,0,0,0,0,0,0,0,0,0,0,1,20,GER
dc2e4736,1,1,1,0,0,0,0,0,0,0,0,2,3,3,1,20,GER
dc366c36,3,2,3,0,0,3,11,8,1,0,1,1,4,23,3,20,GER
dc3fa3b5,41,18,17,19,5,17,42,25,14,2,12,15,56,14,0,20,GER
dc62b55d,16,7,6,5,5,4,13,9,16,2,14,11,27,1,0,20,GER
dc62fbee,53,29,23,18,12,9,51,42,20,3,17,12,65,14,0,20,GER
dc90cfbe,11,7,1,7,3,3,7,4,6,2,4,5,16,22,0,20,GER
dd669209,25,18,4,14,7,14,39,25,25,2,23,23,48,10,0,20,GER
deee6467,2,1,0,0,2,0,2,2,2,2,0,0,2,0,0,20,GER
df8e7b62,40,23,16,16,8,15,39,24,23,2,21,16,56,20,1,20,GER
dfb6490a,24,11,8,10,6,5,16,11,21,4,17,11,35,8,0,20,GER
e0b113a7,52,27,28,18,6,19,60,41,27,7,20,47,99,36,0,20,GER
e12b0b5b,58,33,27,27,4,17,59,42,32,5,27,34,92,13,0,20,GER
e199d5b0,62,47,26,27,9,31,64,33,41,15,26,43,105,59,0,20,GER
e26fcca3,26,13,15,11,0,11,28,17,13,2,11,16,42,13,0,20,GER
e27da244,38,27,27,9,2,24,49,25,31,12,19,41,79,93,0,20,GER
e27de4fa,29,23,21,8,0,11,28,17,12,1,11,29,58,26,0,20,GER
e280527c,39,25,15,18,6,19,56,37,27,4,23,23,62,25,0,20,GER
e2d34771,0,0,0,0,0,0,0,0,0,0,0,0,0,2,1,20,GER
e33c06cf,10,6,8,2,0,4,5,1,8,6,2,8,18,22,1,20,GER
e42d61c7,60,41,38,14,8,27,64,37,26,2,24,30,90,27,2,20,GER
e5478b87,2,0,0,2,0,0,4,4,4,2,2,2,4,3,0,20,GER
e5649a78,21,15,10,7,4,6,24,18,24,2,22,26,47,7,1,20,GER
e5a35ae9,10,7,3,5,2,2,18,16,11,2,9,4,14,4,0,20,GER
e5cad51e,1,1,0,0,1,0,0,0,1,0,1,0,1,0,0,20,GER
e5f63987,4,3,3,1,0,1,11,10,3,1,2,1,5,3,0,20,GER
e6c15f6e,1,1,1,0,0,1,1,0,0,0,0,1,2,4,0,20,GER
e6c43eec,41,26,17,23,1,10,30,20,35,9,26,45,86,64,2,20,GER
e7199efb,9,4,3,4,2,3,12,9,3,0,3,4,13,5,0,20,GER
e7d22eae,23,12,9,14,0,11,24,13,4,1,3,8,31,11,0,20,GER
e7d59f4f,16,7,8,5,3,6,25,19,13,0,13,7,23,2,1,20,GER
e7fcf289,4,2,0,4,0,2,4,2,4,0,4,2,6,1,0,20,GER
e82adcab,8,7,4,4,0,2,5,3,2,0,2,1,9,0,0,20,GER
e87ad81a,16,14,12,4,0,7,17,10,11,7,4,16,32,39,0,20,GER
e881ed15,6,3,2,3,1,3,13,10,8,1,7,9,15,12,0,20,GER
e8fd2e5b,0,0,0,0,0,0,1,1,0,0,0,0,0,2,0,20,GER
ea003d07,0,0,0,0,0,0,0,0,0,0,0,0,0,0,0,20,GER
ea6bc03a,34,20,20,13,1,11,26,15,30,22,8,45,79,94,4,20,GER
eac044ad,8,5,1,3,4,3,10,7,6,2,4,4,12,1,0,20,GER
ead61f73,14,10,8,6,0,6,18,12,12,4,8,10,24,27,1,20,GER
ecab64a0,50,30,18,29,3,17,41,24,14,3,11,23,73,17,0,20,GER
efd623db,64,43,50,14,0,41,66,25,36,15,21,40,104,138,1,20,GER
f261abcb,33,17,14,14,5,15,43,28,19,7,12,58,91,27,0,20,GER
f26834c7,27,19,6,10,11,5,13,8,20,3,17,7,34,11,0,20,GER
f2dd9a21,28,12,12,15,1,5,24,19,5,0,5,6,34,5,0,20,GER
f35430a4,26,16,17,9,0,14,17,3,28,16,12,22,48,79,0,20,GER
f3722c97,8,3,1,5,2,5,10,5,2,0,2,7,15,7,0,20,GER
f4081572,27,16,10,14,3,11,35,24,15,7,8,37,64,38,0,20,GER
f42456eb,20,15,9,11,0,10,20,10,22,12,10,24,44,63,0,20,GER
f4c7c708,0,0,0,0,0,0,1,1,0,0,0,0,0,0,0,20,GER
f521b80a,34,20,19,14,1,17,31,14,27,22,5,34,68,125,3,20,GER
f69fba57,29,16,5,19,5,3,29,26,10,1,9,6,35,13,1,20,GER
f6bdc830,52,27,36,15,1,17,29,12,40,21,19,40,92,113,1,20,GER
f7aa75bd,18,12,13,4,1,12,17,5,18,7,11,11,29,47,0,20,GER
f820504e,44,26,25,19,0,23,47,24,36,18,18,60,104,123,1,20,GER
f86ad3f5,61,39,42,15,4,29,54,25,29,9,20,34,95,78,0,20,GER
f86cabbd,32,19,21,11,0,18,27,9,33,18,15,31,63,75,0,20,GER
f935709c,1,1,1,0,0,0,0,0,0,0,0,0,1,0,0,20,GER
f93e6e94,19,14,7,9,3,10,28,18,32,6,26,10,29,67,0,20,GER
f972644c,21,16,7,9,5,14,51,37,15,0,15,24,45,17,0,20,GER
f9acca3a,64,42,26,26,12,41,66,25,30,4,26,36,100,36,0,20,GER
f9e7c4ac,11,6,1,9,1,2,7,5,8,2,6,3,14,8,0,20,GER
fa274d97,11,7,3,6,2,8,13,5,14,4,10,9,20,9,0,20,GER
fa661778,19,11,9,7,3,10,27,17,14,1,13,17,36,13,0,20,GER
fbbc8e15,4,3,0,4,0,1,4,3,2,1,1,5,9,4,0,20,GER
fbffc4b1,21,13,12,9,0,11,19,8,17,8,9,19,40,85,2,20,GER
fd53759d,9,6,2,6,1,5,12,7,8,0,8,8,17,6,0,20,GER
fe2db476,45,32,27,16,2,28,50,22,27,11,16,26,71,47,1,20,GER
fe641c1a,22,10,10,11,1,9,15,6,16,7,9,26,48,26,0,20,GER
fe888e39,15,8,3,5,7,6,19,13,6,2,4,8,23,3,1,20,GER
fed7cb61,21,15,5,10,6,6,39,33,22,0,22,2,23,22,0,20,GER
ff182fdc,0,0,0,0,0,0,1,1,0,0,0,0,0,2,0,20,GER
ff45add5,31,15,11,16,4,11,35,24,17,6,11,18,49,37,0,20,GER
ff5ea0bf,2,0,1,1,0,1,2,1,2,2,0,2,4,4,1,20,GER
ff98492b,41,28,30,9,2,26,50,24,26,6,20,20,61,40,0,20,GER
ffbbc83b,59,29,34,24,1,29,61,32,33,6,27,49,108,41,1,20,GER
007b39a5,27,19,13,11,3,9,31,22,12,1,11,19,46,10,0,20,ENG
01226327,47,29,22,15,10,26,58,32,27,12,15,37,84,31,1,20,ENG
016ff750,13,9,11,2,0,11,18,7,2,0,2,3,16,4,0,20,ENG
02b29014,64,30,29,29,6,16,57,41,46,8,38,31,95,32,0,20,ENG
0313a347,18,9,12,6,0,7,16,9,34,24,10,25,43,70,2,20,ENG
03622183,2,2,0,2,0,1,3,2,1,1,0,0,2,0,0,20,ENG
0420d84f,42,31,24,14,4,19,25,6,21,9,12,24,66,43,1,20,ENG
04e195ee,0,0,0,0,0,0,0,0,0,0,0,0,0,0,0,20,ENG
0745b37d,12,6,3,5,4,1,23,22,13,0,13,6,18,7,0,20,ENG
07666c20,0,0,0,0,0,0,0,0,0,0,0,0,0,1,1,20,ENG
07802f7f,42,25,16,16,10,13,67,54,62,4,58,9,51,30,1,20,ENG
08452314,8,4,3,2,3,0,2,2,5,0,5,3,11,2,0,20,ENG
0bad4516,9,6,7,2,0,6,12,6,17,9,8,16,25,37,0,20,ENG
0d267745,28,14,21,6,1,16,33,17,15,9,6,21,49,76,2,20,ENG
0d4ceb32,4,3,0,3,1,3,6,3,7,3,4,1,5,6,0,20,ENG
0df2b165,46,30,18,21,7,21,65,44,18,4,14,33,79,46,1,20,ENG
10072610,0,0,0,0,0,0,0,0,0,0,0,0,0,1,1,20,ENG
101da2b5,50,35,32,16,2,29,48,19,28,16,12,25,75,82,0,20,ENG
111c3236,26,12,10,13,3,9,22,13,12,3,9,15,41,19,1,20,ENG
119b9a8e,13,6,6,7,0,4,9,5,6,5,1,20,33,26,1,20,ENG
1265a93a,36,23,18,14,4,11,29,18,19,8,11,22,58,28,0,20,ENG
12aa7661,26,15,19,7,0,9,28,19,11,4,7,3,29,33,0,20,ENG
1598599e,7,5,4,1,2,4,5,1,4,1,3,6,13,6,0,20,ENG
15ea812b,66,43,47,19,0,31,54,23,63,47,16,63,129,204,4,20,ENG
15ea94de,3,2,1,2,0,0,8,8,6,0,6,1,4,5,1,20,ENG
15f3ec41,10,4,4,5,1,1,7,6,9,0,9,5,15,4,1,20,ENG
16380240,17,8,9,7,1,4,23,19,4,0,4,5,22,1,0,20,ENG
16ceb862,8,3,2,5,1,1,11,10,14,1,13,2,10,13,0,20,ENG
16fa6881,27,16,14,11,2,16,27,11,9,0,9,10,37,4,2,20,ENG
17370b95,27,16,12,9,6,13,17,4,7,3,4,6,33,24,0,20,ENG
17695062,1,1,1,0,0,1,3,2,0,0,0,1,2,2,0,20,ENG
178ae8f8,28,15,16,10,2,12,48,36,17,0,17,9,37,10,2,20,ENG
17d4507a,81,46,48,26,7,42,96,54,27,8,19,35,116,71,3,20,ENG
189cee7b,0,0,0,0,0,0,1,1,0,0,0,1,1,0,0,20,ENG
18b896d6,28,18,19,7,2,16,25,9,15,9,6,16,44,59,1,20,ENG
1900032e,19,12,14,5,0,11,28,17,15,9,6,26,45,99,2,20,ENG
1961b2aa,22,15,7,11,4,8,62,54,20,3,17,7,29,7,0,20,ENG
1a2935f6,13,8,10,3,0,7,12,5,9,6,3,10,23,42,0,20,ENG
1aa84968,85,48,58,20,7,48,81,33,38,15,23,77,162,173,1,20,ENG
1ae30132,49,36,16,24,9,24,37,13,24,11,13,30,79,73,0,20,ENG
1b84dbe1,73,49,49,19,5,33,68,35,39,10,29,42,115,108,0,20,ENG
1bf33a9a,23,11,13,4,6,7,24,17,15,0,15,6,29,11,0,20,ENG
1bf811d4,40,22,24,11,5,18,37,19,16,8,8,26,66,73,0,20,ENG
1c7012b8,116,60,64,48,4,47,98,51,41,9,32,77,193,55,0,20,ENG
1cb49278,38,21,25,12,1,15,21,6,12,8,4,29,67,56,0,20,ENG
1d8c99b0,1,1,0,1,0,1,3,2,1,0,1,3,4,2,0,20,ENG
1e0b6a73,13,9,11,2,0,11,21,10,17,12,5,20,33,71,0,20,ENG
1e43fad8,0,0,0,0,0,0,0,0,0,0,0,0,0,0,0,20,ENG
1ecb65be,13,8,6,5,2,3,15,12,13,0,13,8,21,1,0,20,ENG
1ef37668,54,32,18,29,7,28,69,41,30,4,26,28,82,60,1,20,ENG
1fdec858,5,5,3,2,0,1,3,2,1,0,1,0,5,1,0,20,ENG
20b104bc,47,32,29,16,2,23,50,27,27,6,21,25,72,64,1,20,ENG
21166ff4,60,40,41,18,1,27,46,19,35,19,16,43,103,156,1,20,ENG
21a66f6a,18,12,3,12,3,4,17,13,17,7,10,6,24,30,0,20,ENG
254147d4,27,21,13,9,5,11,21,10,15,1,14,9,36,9,0,20,ENG
2628fd2b,0,0,0,0,0,0,2,2,0,0,0,0,0,9,2,20,ENG
2649ff32,7,4,4,3,0,2,19,17,5,0,5,6,13,5,1,20,ENG
2691c772,10,5,3,5,2,3,9,6,7,2,5,6,16,9,0,20,ENG
2696b6a9,0,0,0,0,0,0,0,0,0,0,0,0,0,0,0,20,ENG
26f6dca8,14,9,6,6,2,7,39,32,9,1,8,10,24,3,0,20,ENG
27c01749,7,6,1,4,2,3,10,7,11,0,11,0,7,3,0,20,ENG
282f75f3,40,24,23,17,0,15,34,19,55,33,22,55,95,125,2,20,ENG
28d596a0,1,1,1,0,0,1,2,1,0,0,0,1,2,7,2,20,ENG
291e3ec3,2,2,1,0,1,2,3,1,4,0,4,0,2,1,0,20,ENG
2928dca2,36,23,30,6,0,15,30,15,22,15,7,28,64,119,2,20,ENG
29733c72,7,3,1,5,1,2,7,5,5,1,4,0,7,2,0,20,ENG
2973d8ff,4,1,2,2,0,0,5,5,1,1,0,0,4,1,0,20,ENG
2acd49b9,39,25,25,12,2,20,48,28,19,4,15,27,66,43,2,20,ENG
2afc7272,27,14,15,9,3,10,47,37,17,5,12,17,44,17,1,20,ENG
2b114be3,0,0,0,0,0,0,0,0,0,0,0,0,0,0,0,20,ENG
2b16cb1a,13,8,7,4,2,4,18,14,5,2,3,9,22,6,0,20,ENG
2b1c4abd,1,0,0,0,1,0,0,0,0,0,0,0,1,0,0,20,ENG
2b622f01,57,33,25,22,10,16,58,42,29,2,27,15,72,27,0,20,ENG
2b91cf8e,20,12,18,2,0,9,15,6,18,14,4,11,31,82,0,20,ENG
2baec6ce,2,2,0,2,0,1,2,1,1,0,1,5,7,5,1,20,ENG
2bd83368,11,7,5,6,0,5,15,10,6,2,4,8,19,4,0,20,ENG
2bed3eab,6,1,4,2,0,5,9,4,2,0,2,18,24,33,0,20,ENG
2ce2508a,61,32,32,25,4,35,84,49,30,7,23,42,103,39,4,20,ENG
2d5f03bf,32,21,26,6,0,21,30,9,22,18,4,19,51,87,2,20,ENG
2e4f5f03,54,31,17,25,12,27,61,34,29,7,22,38,92,72,1,20,ENG
2f7acede,40,24,18,20,2,17,54,37,27,8,19,36,76,32,1,20,ENG
2f90f6b8,16,10,3,10,3,6,26,20,12,3,9,7,23,17,1,20,ENG
2ff964a0,14,8,7,4,3,7,10,3,6,1,5,8,22,3,0,20,ENG
30941e96,5,2,3,1,1,5,7,2,1,0,1,9,14,15,0,20,ENG
312626c1,23,14,15,6,2,10,20,10,38,17,21,42,65,154,1,20,ENG
3189f61a,23,13,14,9,0,7,25,18,9,2,7,19,42,9,1,20,ENG
3233eefd,5,4,3,2,0,1,3,2,5,5,0,4,9,19,0,20,ENG
32f60ed8,0,0,0,0,0,0,0,0,0,0,0,2,2,0,0,20,ENG
3312f911,18,9,10,7,1,6,16,10,11,3,8,13,31,15,0,20,ENG
3515d404,92,48,39,39,14,39,94,55,48,14,34,60,152,75,1,20,ENG
3626f7d9,17,12,13,3,1,9,25,16,15,5,10,26,43,75,3,20,ENG
3631ad41,15,7,10,5,0,9,21,12,6,1,5,7,22,16,0,20,ENG
36c2ca73,1,1,1,0,0,1,1,0,1,0,1,0,1,11,3,20,ENG
3727dd3c,29,19,17,12,0,11,42,31,14,5,9,23,52,38,0,20,ENG
38c7feef,18,9,4,6,8,5,21,16,26,1,25,22,40,10,0,20,ENG
38ceb24a,22,17,7,12,3,6,38,32,16,1,15,9,31,8,0,20,ENG
3935e52e,29,16,18,6,5,12,23,11,14,4,10,25,54,34,1,20,ENG
394854c4,62,43,35,17,10,27,47,20,26,3,23,34,96,83,3,20,ENG
39583cfd,33,16,18,9,6,12,59,47,10,0,10,25,58,6,0,20,ENG
3a24769f,16,9,6,6,4,5,18,13,7,2,5,7,23,7,0,20,ENG
3a949a25,1,1,1,0,0,1,2,1,2,0,2,1,2,17,5,20,ENG
3ae14ed1,38,16,18,15,5,9,44,35,23,2,21,25,63,18,0,20,ENG
3bb7b8b4,2,2,2,0,0,2,5,3,0,0,0,3,5,16,6,20,ENG
3ca7254a,15,7,5,9,1,3,15,12,9,0,9,9,24,1,0,20,ENG
3d50bcdb,6,6,5,1,0,0,0,0,4,0,4,5,11,1,1,20,ENG
3e5e4e63,22,11,18,4,0,8,20,12,32,23,9,44,66,153,1,20,ENG
3e9e06cb,29,18,16,13,0,17,31,14,41,32,9,34,63,116,0,20,ENG
3ea50f67,16,11,7,7,2,5,23,18,13,3,10,8,24,6,1,20,ENG
3eb22ec9,36,18,8,21,7,13,44,31,25,1,24,24,60,13,0,20,ENG
3f072a68,1,0,0,0,1,0,0,0,1,0,1,1,2,0,0,20,ENG
3f2d59fe,17,10,11,5,1,6,12,6,10,6,4,18,35,72,0,20,ENG
3faa1780,15,9,7,5,3,5,17,12,11,0,11,15,30,4,0,20,ENG
3fe6bd8c,27,17,19,7,1,21,27,6,23,9,14,23,50,69,0,20,ENG
4115ce4e,65,38,41,18,6,31,61,30,44,23,21,77,142,198,4,20,ENG
41cc19c2,1,1,1,0,0,0,0,0,1,0,1,1,2,0,0,20,ENG
41fb0f4e,2,0,1,1,0,1,2,1,3,0,3,0,2,0,0,20,ENG
41ff002d,0,0,0,0,0,0,0,0,1,0,1,0,0,0,0,20,ENG
422862ea,30,11,13,13,4,12,27,15,10,4,6,18,48,20,0,20,ENG
43439614,66,37,35,24,7,28,97,69,34,12,22,47,113,40,1,20,ENG
43458538,16,6,4,8,4,4,16,12,20,3,17,8,24,9,0,20,ENG
4357f557,0,0,0,0,0,0,0,0,0,0,0,0,0,0,0,20,ENG
43a166b4,12,9,2,5,5,4,9,5,2,0,2,4,16,5,0,20,ENG
4468ec10,12,6,6,6,0,6,12,6,7,0,7,5,17,4,0,20,ENG
44781702,28,15,13,11,4,7,21,14,28,12,16,22,50,47,0,20,ENG
44bfb6c5,62,33,27,32,3,34,86,52,38,9,29,56,118,34,1,20,ENG
450ab6fc,14,3,10,4,0,4,9,5,23,20,3,28,42,116,1,20,ENG
4535e4bb,1,1,1,0,0,1,4,3,0,0,0,2,3,13,2,20,ENG
45963054,15,12,0,9,6,2,4,2,22,4,18,2,17,22,0,20,ENG
45ab2170,3,1,2,1,0,0,0,0,1,0,1,0,3,0,0,20,ENG
45da6694,14,10,8,6,0,6,13,7,7,2,5,7,21,23,0,20,ENG
45db685d,66,40,24,34,8,35,91,56,30,5,25,64,130,27,2,20,ENG
45e17712,1,0,1,0,0,0,0,0,1,0,1,2,3,2,0,20,ENG
466fb2c5,4,3,4,0,0,3,3,0,0,0,0,0,4,25,1,20,ENG
471f16b3,44,29,20,18,6,14,42,28,32,7,25,38,82,67,2,20,ENG
47369df8,14,8,5,7,2,5,13,8,9,4,5,14,28,18,0,20,ENG
47b7e3af,37,24,9,18,10,6,40,34,36,7,29,23,60,32,1,20,ENG
4806ec67,0,0,0,0,0,0,4,4,0,0,0,3,3,12,6,20,ENG
48a5a5d6,20,15,10,6,4,7,20,13,15,1,14,3,23,8,0,20,ENG
495945ef,54,33,15,32,7,17,48,31,23,11,12,32,86,32,3,20,ENG
4ab53cdb,29,19,4,13,12,8,33,25,33,6,27,5,34,12,0,20,ENG
4b40d9ca,1,1,1,0,0,1,2,1,0,0,0,3,4,15,3,20,ENG
4b511457,55,35,23,30,2,27,75,48,35,13,22,34,89,32,0,20,ENG
4bcf39f6,20,12,1,13,6,9,29,20,24,0,24,4,24,10,0,20,ENG
4c370d81,37,19,8,14,15,10,43,33,34,3,31,7,44,11,1,20,ENG
4c5b714f,83,44,48,25,10,43,72,29,19,3,16,40,123,41,0,20,ENG
4d034881,7,4,0,4,3,1,8,7,9,1,8,3,10,2,0,20,ENG
4e015693,0,0,0,0,0,0,1,1,0,0,0,0,0,1,0,20,ENG
4e9a0555,7,4,2,4,1,5,15,10,15,2,13,4,11,18,0,20,ENG
4f974391,43,26,21,18,4,23,46,23,33,10,23,35,78,75,2,20,ENG
4fb9c88f,4,4,0,1,3,3,4,1,2,0,2,2,6,1,0,20,ENG
4fdf1fd9,11,6,8,2,1,8,13,5,18,17,1,28,39,86,3,20,ENG
507c7bdf,22,12,9,9,4,5,38,33,6,0,6,11,33,16,0,20,ENG
50b51fac,1,0,0,1,0,1,1,0,1,0,1,2,3,1,0,20,ENG
51a19d04,0,0,0,0,0,0,0,0,0,0,0,0,0,1,1,20,ENG
51b41c5c,31,22,13,16,2,8,24,16,13,3,10,21,52,20,1,20,ENG
51cf8561,31,19,16,11,4,17,32,15,9,0,9,17,48,21,1,20,ENG
52105203,8,4,7,1,0,8,14,6,9,7,2,14,22,67,0,20,ENG
52611641,31,16,11,15,5,16,39,23,24,8,16,34,65,24,0,20,ENG
5271c8f1,18,15,7,7,4,9,27,18,10,2,8,16,34,21,3,20,ENG
531a4aa8,20,7,9,7,4,11,19,8,9,1,8,13,33,32,2,20,ENG
5343eb4e,3,2,1,2,0,1,2,1,0,0,0,0,3,0,0,20,ENG
53af52f3,1,1,1,0,0,1,2,1,0,0,0,1,2,4,2,20,ENG
53cad200,86,56,40,32,14,35,69,34,56,21,35,67,153,94,0,20,ENG
5526deb1,0,0,0,0,0,0,1,1,0,0,0,0,0,0,0,20,ENG
552aa16c,39,25,15,18,6,16,60,44,20,5,15,16,55,35,0,20,ENG
558807c0,21,11,9,11,1,8,22,14,27,11,16,18,39,64,1,20,ENG
56f7a928,52,29,17,30,5,24,74,50,43,4,39,22,74,18,0,20,ENG
57df7a11,41,23,24,13,4,23,39,16,19,5,14,14,55,23,0,20,ENG
57e3f0c7,32,17,15,13,4,8,16,8,15,2,13,8,40,5,0,20,ENG
58eee997,17,11,5,6,6,5,20,15,9,0,9,6,23,6,1,20,ENG
59d93937,0,0,0,0,0,0,0,0,0,0,0,0,0,0,0,20,ENG
59e6e5bf,7,5,1,4,2,1,10,9,15,2,13,6,13,36,0,20,ENG
5a4280b1,7,5,6,1,0,4,9,5,9,7,2,4,11,31,0,20,ENG
5a7301ae,68,31,41,19,8,28,67,39,39,12,27,38,106,64,2,20,ENG
5acc4a10,75,40,38,30,7,37,85,48,30,11,19,68,143,61,0,20,ENG
5c2b4f07,93,69,58,27,8,39,69,30,38,6,32,47,140,98,2,20,ENG
5cbd1eb0,5,2,2,2,1,1,7,6,2,0,2,2,7,3,0,20,ENG
5cdddffa,24,16,10,13,1,9,22,13,20,3,17,14,38,7,0,20,ENG
5cec2487,57,29,31,20,6,30,56,26,19,5,14,24,81,40,0,20,ENG
5d8d7454,74,43,48,20,6,36,67,31,33,10,23,49,123,74,2,20,ENG
5e105217,10,5,2,8,0,5,10,5,7,1,6,1,11,2,0,20,ENG
5e74d6c8,21,15,11,6,4,9,29,20,9,4,5,16,37,27,0,20,ENG
5ea8ef20,31,16,14,13,4,14,43,29,21,7,14,29,60,38,2,20,ENG
5eecec3d,16,10,8,7,1,3,5,2,5,3,2,9,25,32,2,20,ENG
5f09991f,43,23,31,10,2,23,50,27,31,9,22,45,88,52,1,20,ENG
5f1d07f6,8,2,5,2,1,7,11,4,6,6,0,7,15,29,0,20,ENG
603e4f0b,1,0,1,0,0,1,1,0,0,0,0,0,1,0,0,20,ENG
615ef733,19,9,10,7,2,10,21,11,11,5,6,13,32,25,1,20,ENG
62437b4f,7,4,4,2,1,3,8,5,2,1,1,3,10,4,0,20,ENG
6250083a,2,2,0,2,0,1,4,3,3,2,1,0,2,0,0,20,ENG
636b64cd,6,4,2,2,2,2,8,6,1,0,1,10,16,6,0,20,ENG
6385ebfb,0,0,0,0,0,0,0,0,0,0,0,0,0,2,0,20,ENG
63d17038,0,0,0,0,0,0,0,0,0,0,0,1,1,4,1,20,ENG
6421ec64,1,0,0,1,0,0,1,1,0,0,0,0,1,0,0,20,ENG
6434f10d,50,30,17,25,8,23,63,40,19,5,14,26,76,35,0,20,ENG
645a3363,0,0,0,0,0,0,0,0,1,0,1,0,0,0,0,20,ENG
64b08de7,82,47,36,36,10,40,76,36,24,5,19,24,106,11,0,20,ENG
653ee42d,73,44,30,37,6,25,75,50,31,11,20,58,131,42,2,20,ENG
6613c819,29,15,13,15,1,10,23,13,7,1,6,22,51,35,0,20,ENG
6639e500,24,13,8,9,7,10,39,29,13,0,13,7,31,7,0,20,ENG
66b76d44,82,39,57,21,4,38,118,80,58,5,53,23,105,32,2,20,ENG
6813ac34,18,10,12,5,1,6,13,7,5,3,2,14,32,21,0,20,ENG
6992791d,10,7,2,3,5,3,8,5,6,0,6,4,14,6,0,20,ENG
6aa3e78b,6,4,2,4,0,3,6,3,0,0,0,3,9,12,0,20,ENG
6adbc307,44,27,30,13,1,24,46,22,38,22,16,31,75,120,2,20,ENG
6b47c5db,128,67,56,61,11,45,91,46,52,6,46,80,208,69,3,20,ENG
6bd603db,4,3,1,1,2,1,2,1,1,0,1,1,5,4,0,20,ENG
6c203af0,49,38,24,22,3,17,40,23,18,2,16,21,70,23,0,20,ENG
6c7762c3,7,3,5,2,0,3,4,1,1,0,1,1,8,3,1,20,ENG
6ca5ec4b,25,17,8,15,2,12,33,21,18,2,16,14,39,10,1,20,ENG
6cc47ae1,0,0,0,0,0,0,0,0,0,0,0,0,0,0,0,20,ENG
6cdd8245,28,15,8,14,6,9,36,27,13,1,12,10,38,15,0,20,ENG
6d5701f2,39,22,25,12,2,18,24,6,20,14,6,28,67,102,1,20,ENG
6e33125f,6,4,3,3,0,4,7,3,7,3,4,2,8,7,0,20,ENG
6eaed4eb,8,2,6,2,0,4,7,3,6,2,4,10,18,15,2,20,ENG
6f7d826d,46,24,25,17,4,19,65,46,42,15,27,36,82,54,1,20,ENG
71ef519e,22,15,9,10,3,3,15,12,20,5,15,14,36,31,1,20,ENG
7314bba4,18,9,14,4,0,6,17,11,13,7,6,21,39,72,0,20,ENG
7399c7a8,10,5,5,5,0,1,6,5,12,5,7,8,18,24,0,20,ENG
74b2cd7e,38,24,20,14,4,18,32,14,50,32,18,27,65,134,1,20,ENG
74e12f1e,35,24,10,20,5,12,62,50,34,12,22,28,63,49,0,20,ENG
75566759,23,18,7,16,0,11,39,28,20,9,11,43,66,72,1,20,ENG
758dd7f0,39,26,27,8,4,24,38,14,14,2,12,18,57,56,0,20,ENG
75a72a99,119,68,65,36,18,53,106,53,38,6,32,49,168,86,0,20,ENG
75f2c59f,20,8,11,7,2,9,28,19,21,0,21,14,34,12,1,20,ENG
76c131da,0,0,0,0,0,0,1,1,0,0,0,0,0,0,0,20,ENG
76dd1480,50,26,15,24,11,19,70,51,30,4,26,37,87,17,1,20,ENG
76eca7e2,0,0,0,0,0,0,0,0,0,0,0,1,1,3,1,20,ENG
76fa5f80,5,2,4,1,0,2,8,6,1,0,1,2,7,12,1,20,ENG
774cf58b,48,30,33,9,6,18,36,18,46,29,17,37,85,97,1,20,ENG
77cf6852,18,12,15,2,1,9,20,11,11,8,3,8,26,45,0,20,ENG
78b8ac63,37,22,6,27,4,11,40,29,25,3,22,15,52,43,0,20,ENG
78e87179,0,0,0,0,0,0,0,0,0,0,0,0,0,0,0,20,ENG
7914b9fe,15,8,11,4,0,7,15,8,34,25,9,18,33,114,1,20,ENG
7956236f,0,0,0,0,0,0,0,0,0,0,0,0,0,1,0,20,ENG
79b0d6a0,0,0,0,0,0,0,2,2,2,0,2,2,2,5,2,20,ENG
79bc4c45,15,10,11,3,1,3,16,13,6,1,5,6,21,7,0,20,ENG
79c0821a,63,38,29,32,2,26,65,39,15,1,14,22,85,16,1,20,ENG
79c84d1c,19,15,7,9,3,4,17,13,6,0,6,16,35,8,0,20,ENG
79ca3e23,18,11,9,6,3,7,16,9,10,2,8,6,24,8,0,20,ENG
7a11550b,23,16,17,6,0,9,20,11,15,8,7,38,61,64,2,20,ENG
7a1f2c08,14,10,4,10,0,7,11,4,7,2,5,17,31,23,1,20,ENG
7a2e46a8,0,0,0,0,0,0,2,2,0,0,0,1,1,13,3,20,ENG
7ba2eaa9,9,4,3,6,0,4,15,11,2,0,2,6,15,4,0,20,ENG
7ba6d84e,0,0,0,0,0,0,0,0,0,0,0,0,0,7,4,20,ENG
7ca9f0f0,8,6,4,4,0,2,5,3,4,0,4,1,9,6,0,20,ENG
7d2d3329,17,8,7,8,2,3,25,22,15,6,9,24,41,13,0,20,ENG
7d41b619,4,2,2,2,0,1,3,2,1,0,1,1,5,5,1,20,ENG
7edfbb8a,29,16,21,8,0,10,15,5,13,7,6,22,51,48,2,20,ENG
7f3b388c,62,35,20,35,7,26,67,41,25,2,23,34,96,19,1,20,ENG
7fcc71d8,3,3,2,0,1,0,2,2,4,1,3,2,5,1,0,20,ENG
7fec31a0,26,10,14,9,3,6,27,21,31,11,20,20,46,26,0,20,ENG
80c31c97,4,1,3,1,0,0,3,3,5,3,2,7,11,19,0,20,ENG
810e3c74,15,8,6,4,5,5,18,13,5,0,5,3,18,0,0,20,ENG
819aa8e7,45,28,14,26,5,8,54,46,33,1,32,14,59,9,1,20,ENG
819b3158,27,16,9,11,7,9,41,32,17,5,12,31,58,13,0,20,ENG
82927de4,46,28,21,18,7,19,64,45,35,1,34,25,71,15,0,20,ENG
82e34b69,19,12,6,10,3,6,29,23,13,1,12,11,30,27,0,20,ENG
8397a50c,15,11,11,3,1,10,13,3,56,48,8,30,45,190,4,20,ENG
839c14e1,53,32,21,30,2,26,44,18,21,4,17,22,75,55,0,20,ENG
83d074ff,9,5,4,3,2,5,9,4,12,0,12,1,10,2,0,20,ENG
849c826a,13,8,5,6,2,5,20,15,3,1,2,6,19,4,0,20,ENG
862a1c15,60,39,32,20,8,19,52,33,25,1,24,31,91,25,0,20,ENG
86695068,33,18,8,21,4,9,29,20,19,1,18,17,50,12,0,20,ENG
867239d3,20,9,8,8,4,8,16,8,12,4,8,7,27,10,2,20,ENG
86dd77d1,28,18,12,15,1,12,29,17,15,6,9,28,56,42,1,20,ENG
87935cf3,7,5,5,1,1,2,5,3,12,5,7,20,27,46,2,20,ENG
8816329f,10,8,5,5,0,5,14,9,19,0,19,5,15,9,0,20,ENG
892d5bb1,28,14,11,9,8,11,38,27,31,1,30,18,46,8,2,20,ENG
89d10e53,39,23,17,18,4,21,41,20,25,10,15,18,57,48,3,20,ENG
89e4b358,41,26,25,15,1,10,24,14,19,16,3,25,66,136,1,20,ENG
8a7ff278,69,42,48,16,5,39,56,17,13,6,7,48,117,93,1,20,ENG
8aa5f52c,20,14,15,4,1,11,30,19,22,7,15,11,31,73,0,20,ENG
8aec0537,36,13,8,21,7,14,39,25,25,3,22,9,45,7,0,20,ENG
8b04d6c1,80,49,34,38,8,39,91,52,44,5,39,46,126,54,2,20,ENG
8b788c01,15,12,1,4,10,1,16,15,18,1,17,5,20,17,0,20,ENG
8b9ebd03,45,27,14,24,7,14,43,29,15,0,15,20,65,7,0,20,ENG
8c44e37b,1,0,0,1,0,0,2,2,1,0,1,0,1,0,1,20,ENG
8d3c902d,67,32,43,20,4,26,48,22,35,11,24,43,110,58,1,20,ENG
8df7a2fb,41,22,25,16,0,17,29,12,42,31,11,42,83,165,2,20,ENG
8f62b6ee,0,0,0,0,0,0,0,0,0,0,0,1,1,3,2,20,ENG
9050ddc4,37,19,29,6,2,18,39,21,20,5,15,17,54,42,1,20,ENG
90f91999,53,35,19,23,11,18,62,44,25,1,24,25,78,18,0,20,ENG
914ab9a1,37,24,26,11,0,17,32,15,31,23,8,36,73,127,0,20,ENG
91c975a0,0,0,0,0,0,0,0,0,0,0,0,0,0,2,0,20,ENG
9228b07c,38,17,12,22,4,17,55,38,12,4,8,35,73,28,0,20,ENG
9260926b,18,11,9,8,1,3,11,8,8,5,3,16,34,55,1,20,ENG
92e7e919,23,15,10,11,2,9,57,48,23,0,23,19,42,18,1,20,ENG
9319781b,8,4,7,1,0,7,10,3,5,2,3,3,11,11,0,20,ENG
9328b835,2,2,2,0,0,2,4,2,0,0,0,1,3,5,3,20,ENG
935e6b8f,63,41,18,33,12,22,55,33,22,4,18,30,93,21,2,20,ENG
9460aaed,16,9,8,7,1,9,25,16,14,4,10,9,25,10,1,20,ENG
9674002f,37,17,8,19,10,9,42,33,25,3,22,16,53,18,0,20,ENG
96bb8cc2,11,9,5,4,2,3,10,7,10,2,8,5,16,8,0,20,ENG
97220da2,0,0,0,0,0,0,0,0,0,0,0,0,0,0,0,20,ENG
97333cf5,32,19,19,11,2,9,38,29,22,4,18,11,43,23,1,20,ENG
980522ec,19,9,10,8,1,7,24,17,10,1,9,12,31,16,0,20,ENG
984a5a64,21,13,13,6,2,11,25,14,14,5,9,17,38,26,2,20,ENG
989d5705,18,10,7,8,3,7,27,20,21,8,13,20,38,20,0,20,ENG
99813635,19,9,7,9,3,6,21,15,7,0,7,5,24,3,0,20,ENG
9a104dee,4,2,2,0,2,0,3,3,1,0,1,0,4,2,0,20,ENG
9a28eba4,33,21,6,14,13,8,23,15,19,3,16,13,46,14,2,20,ENG
9a526299,0,0,0,0,0,0,0,0,0,0,0,0,0,1,0,20,ENG
9a9c05db,41,22,20,18,3,22,33,11,20,6,14,27,68,57,1,20,ENG
9b5ce51a,54,32,17,31,6,22,48,26,28,12,16,57,111,54,1,20,ENG
9c318325,1,0,1,0,0,0,4,4,3,0,3,1,2,0,0,20,ENG
9c94165b,34,18,19,11,4,19,33,14,26,6,20,24,58,56,1,20,ENG
9d107085,1,1,0,1,0,0,1,1,2,0,2,1,2,5,1,20,ENG
9d9a71c1,0,0,0,0,0,0,0,0,0,0,0,0,0,0,0,20,ENG
9dbb75ca,31,16,8,21,2,9,24,15,14,0,14,7,38,15,0,20,ENG
9deaf2c8,1,1,0,1,0,0,3,3,4,0,4,0,1,3,0,20,ENG
9e525177,129,80,71,50,8,64,86,22,46,13,33,66,195,83,0,20,ENG
9f1893b9,46,32,20,21,5,11,47,36,19,1,18,22,68,11,0,20,ENG
9f351459,3,1,2,0,1,2,5,3,1,0,1,3,6,6,0,20,ENG
9f4647e9,29,16,17,10,2,13,44,31,12,1,11,4,33,11,0,20,ENG
9f472354,19,10,5,8,6,7,19,12,12,0,12,4,23,16,0,20,ENG
9f736ed2,2,2,2,0,0,1,1,0,0,0,0,0,2,1,0,20,ENG
9f7c837d,22,14,18,3,1,10,18,8,41,37,4,25,47,152,3,20,ENG
9fbbcf39,55,38,37,15,3,32,46,14,31,16,15,55,110,127,3,20,ENG
a0666d3e,75,47,24,41,10,25,67,42,48,8,40,37,112,28,0,20,ENG
a07579ee,0,0,0,0,0,0,0,0,0,0,0,0,0,1,0,20,ENG
a1232f4e,0,0,0,0,0,0,1,1,3,3,0,4,4,7,1,20,ENG
a179d516,0,0,0,0,0,0,0,0,0,0,0,0,0,3,0,20,ENG
a1d5bd30,13,9,1,6,6,9,23,14,23,0,23,10,23,19,0,20,ENG
a29b1131,10,6,3,6,1,4,12,8,12,0,12,1,11,5,0,20,ENG
a2b105e0,35,19,17,16,2,20,50,30,23,5,18,19,54,20,2,20,ENG
a3b03921,25,16,9,12,4,8,21,13,16,2,14,4,29,11,2,20,ENG
a4ac4b8f,57,33,36,21,0,25,43,18,28,11,17,39,96,108,3,20,ENG
a4fe8cda,4,2,2,1,1,1,5,4,1,1,0,2,6,1,0,20,ENG
a53649b7,7,5,3,4,0,2,6,4,9,0,9,2,9,5,0,20,ENG
a67a09fb,14,9,8,6,0,8,19,11,8,3,5,17,31,33,1,20,ENG
a6de6361,3,2,3,0,0,3,4,1,0,0,0,0,3,6,0,20,ENG
a6e316c1,4,3,1,2,1,2,8,6,3,0,3,7,11,14,0,20,ENG
a712ca2b,27,15,18,9,0,16,25,9,37,21,16,47,74,166,2,20,ENG
a8a3d139,0,0,0,0,0,0,0,0,0,0,0,0,0,0,0,20,ENG
a9142dc3,1,1,0,1,0,1,4,3,0,0,0,4,5,1,0,20,ENG
aa54ec6f,2,1,2,0,0,0,0,0,0,0,0,1,3,10,0,20,ENG
ab070c55,9,5,1,6,2,0,10,10,11,4,7,4,13,28,1,20,ENG
ab13a5aa,1,1,1,0,0,1,2,1,0,0,0,0,1,18,3,20,ENG
ab4b3e35,32,22,12,14,6,13,44,31,22,2,20,16,48,7,0,20,ENG
ab651565,49,29,17,23,9,21,57,36,39,2,37,16,65,16,0,20,ENG
abe66106,24,20,9,13,2,2,21,19,12,3,9,8,32,10,0,20,ENG
ac05f970,13,9,5,4,4,4,14,10,17,2,15,9,22,5,0,20,ENG
ac861941,21,12,10,10,1,10,20,10,14,9,5,21,42,65,0,20,ENG
ad1f61f3,33,19,20,11,2,17,27,10,18,3,15,14,47,13,0,20,ENG
ae0a7ddf,18,13,10,6,2,8,16,8,13,7,6,10,28,20,0,20,ENG
af721f98,4,0,0,2,2,0,0,0,0,0,0,1,5,0,0,20,ENG
b017b770,0,0,0,0,0,0,0,0,1,0,1,1,1,0,0,20,ENG
b0b4fd3e,29,19,12,12,5,13,34,21,33,12,21,22,51,22,1,20,ENG
b0c71810,16,8,6,5,5,6,15,9,17,0,17,4,20,1,0,20,ENG
b105919e,0,0,0,0,0,0,0,0,1,0,1,0,0,0,0,20,ENG
b18095b6,10,6,6,2,2,8,10,2,5,2,3,5,15,14,0,20,ENG
b217ef29,13,9,4,7,2,4,11,7,8,4,4,12,25,38,0,20,ENG
b28bbd58,34,21,12,17,5,15,37,22,18,0,18,15,49,10,1,20,ENG
b2bc3b1f,43,19,18,12,13,12,49,37,22,2,20,18,61,4,0,20,ENG
b2d03887,0,0,0,0,0,0,0,0,0,0,0,0,0,0,0,20,ENG
b2d31e83,67,42,35,27,5,25,53,28,44,20,24,42,109,130,0,20,ENG
b400bde0,27,15,8,10,9,6,28,22,16,2,14,15,42,4,0,20,ENG
b547f08c,0,0,0,0,0,0,0,0,0,0,0,0,0,0,0,20,ENG
b561db50,20,12,6,10,4,3,31,28,26,0,26,16,36,34,1,20,ENG
b581987a,5,3,3,2,0,2,8,6,2,1,1,2,7,24,1,20,ENG
b606638c,20,8,8,9,3,5,21,16,11,3,8,5,25,16,0,20,ENG
b63e789d,36,25,13,14,9,22,64,42,25,3,22,24,60,26,0,20,ENG
b66315ae,17,10,4,5,8,7,25,18,26,1,25,11,28,6,0,20,ENG
b682dcf6,25,16,17,7,1,10,21,11,30,24,6,17,42,68,1,20,ENG
b827d5b3,24,17,10,13,1,9,30,21,19,2,17,10,34,8,0,20,ENG
b853e0ad,60,32,33,22,5,25,100,75,44,8,36,38,98,32,0,20,ENG
b937e490,23,13,15,6,2,12,15,3,7,2,5,11,34,22,0,20,ENG
b9e1436c,0,0,0,0,0,0,0,0,0,0,0,0,0,0,0,20,ENG
b9fbae28,44,20,22,14,8,17,36,19,29,5,24,44,88,32,2,20,ENG
ba115a40,22,15,8,10,4,3,30,27,19,5,14,8,30,27,0,20,ENG
ba23a904,40,24,25,14,1,20,31,11,18,10,8,33,73,68,0,20,ENG
ba3ca78f,0,0,0,0,0,0,0,0,0,0,0,0,0,2,2,20,ENG
bb5fbd2b,25,12,16,6,3,9,19,10,16,4,12,20,45,14,2,20,ENG
bc7dc64d,36,21,21,8,7,19,37,18,12,3,9,12,48,19,0,20,ENG
bd6351cd,40,24,21,12,7,24,40,16,9,2,7,21,61,18,0,20,ENG
bdedffac,0,0,0,0,0,0,0,0,0,0,0,0,0,1,1,20,ENG
be927d03,14,7,7,4,3,5,17,12,8,2,6,11,25,29,0,20,ENG
bf59c794,0,0,0,0,0,0,0,0,0,0,0,0,0,0,0,20,ENG
bf8fad51,21,9,15,5,1,8,15,7,27,19,8,20,41,98,4,20,ENG
bfae110f,15,8,3,8,4,0,5,5,10,2,8,4,19,23,0,20,ENG
bfdb33aa,11,10,5,2,4,5,23,18,9,1,8,18,29,10,0,20,ENG
c0027d2d,3,1,2,1,0,3,14,11,4,1,3,5,8,3,0,20,ENG
c0617e2b,45,23,26,14,5,18,61,43,14,3,11,32,77,16,1,20,ENG
c067631c,82,56,59,18,5,41,64,23,20,10,10,24,106,73,1,20,ENG
c0e27d1a,28,16,14,14,0,13,24,11,42,37,5,32,60,133,2,20,ENG
c13c24c8,0,0,0,0,0,0,0,0,0,0,0,0,0,0,0,20,ENG
c17bfb65,34,20,7,22,5,9,32,23,32,6,26,11,45,30,0,20,ENG
c1949191,8,7,5,3,0,3,5,2,6,3,3,2,10,12,0,20,ENG
c2111b45,1,1,1,0,0,1,2,1,4,3,1,2,3,8,1,20,ENG
c24dba2a,4,3,0,2,2,1,3,2,4,1,3,1,5,2,0,20,ENG
c2f9d19f,16,11,12,4,0,11,20,9,15,5,10,20,36,43,0,20,ENG
c40b6180,30,17,21,8,1,14,32,18,43,26,17,45,75,110,2,20,ENG
c596fcb0,12,9,3,6,3,2,17,15,16,2,14,4,16,16,0,20,ENG
c5b7c315,31,16,18,12,1,14,24,10,35,28,7,44,75,152,0,20,ENG
c5bdb6e3,11,8,5,4,2,7,17,10,13,2,11,3,14,3,0,20,ENG
c691bfe2,44,32,9,20,15,13,40,27,19,0,19,13,57,11,2,20,ENG
c6dc9ecd,23,13,8,10,5,11,34,23,26,2,24,11,34,15,1,20,ENG
c8aa95da,39,21,25,14,0,19,40,21,35,18,17,47,86,74,2,20,ENG
c92e1a31,3,1,1,2,0,1,9,8,8,1,7,3,6,8,0,20,ENG
c931d9f9,20,10,5,10,5,7,45,38,23,4,19,7,27,12,0,20,ENG
c951a6df,55,27,33,17,5,20,50,30,24,7,17,38,93,38,0,20,ENG
caa1a7f0,7,3,1,3,3,2,14,12,3,0,3,6,13,0,0,20,ENG
caffaf5a,8,5,4,1,3,3,7,4,6,2,4,4,12,27,1,20,ENG
cc2d7ad5,39,24,26,9,4,19,39,20,29,9,20,29,68,78,1,20,ENG
cd1acf9d,55,34,35,17,3,36,78,42,27,9,18,45,100,84,3,20,ENG
ce4246f5,23,14,17,6,0,9,16,7,22,14,8,58,81,116,2,20,ENG
ce5143da,14,6,6,5,3,3,11,8,12,1,11,5,19,7,0,20,ENG
cea4ee8f,34,16,11,20,3,13,37,24,35,3,32,17,51,17,2,20,ENG
cee31595,88,51,43,34,11,37,106,69,69,19,50,60,148,56,0,20,ENG
cfd5e123,1,0,0,0,1,0,0,0,1,1,0,0,1,0,0,20,ENG
d0042ab9,44,26,30,13,1,21,31,10,26,13,13,34,78,97,0,20,ENG
d0b3ceb9,1,0,1,0,0,1,3,2,1,0,1,0,1,16,2,20,ENG
d0b6129f,22,15,3,14,5,5,10,5,15,1,14,10,32,16,0,20,ENG
d0f72bf1,4,2,1,3,0,2,2,0,1,1,0,4,8,7,0,20,ENG
d2424d1b,43,26,28,13,2,23,52,29,30,6,24,28,71,68,2,20,ENG
d2d74d9c,2,2,0,2,0,1,2,1,1,0,1,0,2,0,0,20,ENG
d328a254,72,46,30,37,5,17,65,48,59,16,43,66,138,97,1,20,ENG
d484c261,2,2,0,0,2,1,1,0,0,0,0,0,2,1,0,20,ENG
d4cb83cc,1,1,1,0,0,1,3,2,3,1,2,3,4,10,0,20,ENG
d557d734,55,29,34,17,4,27,41,14,34,4,30,40,95,52,1,20,ENG
d56543a0,12,6,5,5,2,7,22,15,15,3,12,15,27,24,0,20,ENG
d5dd5f1f,31,19,10,12,9,12,51,39,39,1,38,14,45,16,0,20,ENG
d7492450,23,18,19,4,0,14,31,17,18,10,8,16,39,86,1,20,ENG
d7553721,51,29,12,33,6,12,59,47,20,4,16,9,60,19,0,20,ENG
d79a8c87,4,2,3,1,0,1,3,2,10,6,4,5,9,45,1,20,ENG
d8931174,37,23,23,14,0,18,34,16,31,22,9,72,109,159,0,20,ENG
d93c2511,43,22,14,25,4,17,32,15,25,5,20,31,74,34,2,20,ENG
d9565625,3,2,3,0,0,3,4,1,1,0,1,2,5,1,0,20,ENG
d9ba39fc,61,39,32,24,5,29,59,30,31,7,24,84,145,91,0,20,ENG
d9cfca3d,9,5,0,5,4,3,7,4,3,0,3,4,13,2,0,20,ENG
da052c14,48,30,10,22,16,17,49,32,29,4,25,15,63,21,0,20,ENG
da7b447d,44,27,32,12,0,22,44,22,40,28,12,34,78,128,5,20,ENG
dae8623e,6,4,0,3,3,1,8,7,7,0,7,1,7,6,0,20,ENG
dbe56a33,41,26,9,24,8,5,20,15,14,2,12,3,44,23,0,20,ENG
dc008610,1,1,0,1,0,1,1,0,1,1,0,0,1,1,0,20,ENG
dc4cae05,5,5,1,2,2,2,14,12,5,1,4,2,7,1,0,20,ENG
dc6f5bdd,26,10,12,8,6,11,16,5,13,7,6,16,42,43,1,20,ENG
dd0daf32,0,0,0,0,0,0,2,2,3,0,3,0,0,1,0,20,ENG
dd323728,5,3,1,3,1,4,5,1,3,1,2,9,14,6,0,20,ENG
de0f152c,38,22,24,11,3,14,37,23,26,12,14,28,66,66,0,20,ENG
de5b5570,55,28,28,20,7,24,67,43,50,11,39,39,94,38,3,20,ENG
debe38a0,44,27,34,10,0,25,45,20,39,27,12,58,102,171,4,20,ENG
def899bd,2,2,1,1,0,1,1,0,2,0,2,2,4,9,1,20,ENG
df10e27c,5,2,3,2,0,2,4,2,2,0,2,3,8,3,1,20,ENG
e06683ca,23,12,18,5,0,6,13,7,20,15,5,40,63,166,2,20,ENG
e082af5b,1,1,1,0,0,1,3,2,0,0,0,0,1,1,0,20,ENG
e0900238,0,0,0,0,0,0,0,0,0,0,0,0,0,0,0,20,ENG
e0991c04,3,1,2,1,0,1,2,1,2,1,1,0,3,6,0,20,ENG
e0bc6fdc,23,12,8,11,4,10,15,5,13,1,12,18,41,19,0,20,ENG
e2716bd0,26,14,3,15,8,10,28,18,18,3,15,13,39,5,0,20,ENG
e28868f3,91,55,54,26,11,29,82,53,45,10,35,53,144,45,2,20,ENG
e2dde94c,2,0,2,0,0,0,2,2,2,0,2,1,3,0,0,20,ENG
e342ad68,16,6,1,4,11,5,22,17,3,1,2,8,24,2,1,20,ENG
e358587b,0,0,0,0,0,0,2,2,0,0,0,0,0,9,1,20,ENG
e3a5814e,41,23,34,5,2,22,43,21,12,3,9,28,69,38,0,20,ENG
e46012d4,45,24,8,20,17,18,66,48,26,4,22,18,63,24,2,20,ENG
e514ab62,52,29,37,11,4,22,53,31,28,8,20,56,108,82,0,20,ENG
e58a03c6,12,10,4,6,2,4,8,4,5,0,5,2,14,9,0,20,ENG
e5a76dfe,0,0,0,0,0,0,0,0,0,0,0,1,1,13,1,20,ENG
e5d01ecf,68,38,49,17,2,43,80,37,16,2,14,36,104,49,0,20,ENG
e61b8aee,45,25,20,19,6,25,55,30,32,16,16,21,66,59,3,20,ENG
e7434f04,1,0,1,0,0,1,1,0,0,0,0,0,1,0,1,20,ENG
e75750a3,6,3,2,2,2,2,7,5,3,0,3,7,13,3,0,20,ENG
e77dc3b2,8,4,2,5,1,5,33,28,9,1,8,8,16,18,1,20,ENG
e7ca0439,29,17,21,8,0,18,25,7,17,15,2,21,50,103,0,20,ENG
e8832875,0,0,0,0,0,0,0,0,0,0,0,0,0,0,0,20,ENG
e8c9f4e9,6,5,2,1,3,1,6,5,2,0,2,1,7,2,0,20,ENG
e9254eec,24,15,17,7,0,8,14,6,25,18,7,31,55,77,1,20,ENG
e97fd090,0,0,0,0,0,0,2,2,1,1,0,2,2,2,0,20,ENG
e9971f2d,17,9,10,6,1,10,17,7,7,6,1,11,28,31,2,20,ENG
eaeca114,31,21,23,8,0,14,23,9,40,29,11,36,67,152,0,20,ENG
eb58eef0,38,20,12,21,5,10,40,30,18,4,14,17,55,34,3,20,ENG
eb7822d7,46,24,23,19,4,20,43,23,21,8,13,22,68,28,1,20,ENG
eba42d2b,19,11,10,9,0,8,18,10,6,1,5,7,26,4,0,20,ENG
ebd0a048,0,0,0,0,0,0,0,0,0,0,0,0,0,0,0,20,ENG
ecf44e09,0,0,0,0,0,0,1,1,0,0,0,0,0,1,0,20,ENG
ed1e53f3,14,10,4,6,4,6,19,13,5,0,5,6,20,2,0,20,ENG
ee38d9c5,59,30,13,31,15,23,68,45,16,0,16,9,68,7,1,20,ENG
efb9215a,51,35,42,6,3,22,36,14,27,12,15,25,76,68,0,20,ENG
f08490a6,4,2,3,1,0,1,4,3,2,0,2,8,12,4,1,20,ENG
f1e94cd6,0,0,0,0,0,0,0,0,0,0,0,0,0,0,0,20,ENG
f23f9d20,0,0,0,0,0,0,1,1,2,0,2,1,1,13,1,20,ENG
f25b010f,42,25,30,10,2,23,46,23,41,28,13,24,66,190,2,20,ENG
f25c8e3a,30,14,8,16,6,11,26,15,18,0,18,10,40,4,0,20,ENG
f2bf1b0f,6,4,1,5,0,1,4,3,9,1,8,2,8,10,0,20,ENG
f2f29dda,5,2,0,3,2,2,9,7,6,2,4,1,6,12,0,20,ENG
f31def1e,7,3,3,4,0,6,7,1,9,5,4,6,13,15,1,20,ENG
f4290206,28,16,20,6,2,14,33,19,18,2,16,20,48,32,0,20,ENG
f4e433d4,9,8,7,2,0,4,11,7,6,0,6,16,25,17,0,20,ENG
f573a8bf,0,0,0,0,0,0,0,0,0,0,0,1,1,0,0,20,ENG
f586779e,8,4,2,5,1,3,14,11,20,2,18,6,14,27,0,20,ENG
f5a00fa4,93,50,43,41,9,46,139,93,43,13,30,50,143,18,1,20,ENG
f5deef4c,29,15,16,12,1,17,20,3,25,16,9,26,55,129,0,20,ENG
f5e6d08d,0,0,0,0,0,0,0,0,0,0,0,0,0,4,0,20,ENG
f63d8a4b,51,31,19,27,5,26,73,47,38,2,36,18,69,35,1,20,ENG
f72293fc,4,2,2,2,0,1,8,7,8,1,7,7,11,9,0,20,ENG
f76e6b4e,1,1,1,0,0,1,1,0,0,0,0,0,1,8,3,20,ENG
f7d50789,40,29,24,13,3,11,24,13,48,32,16,31,71,172,2,20,ENG
f833a830,3,3,0,2,1,2,10,8,3,0,3,0,3,3,0,20,ENG
f874dd44,20,13,7,11,2,11,29,18,20,4,16,19,39,27,1,20,ENG
f8fcd2a5,48,34,33,14,1,28,39,11,33,18,15,57,105,174,4,20,ENG
fa031b34,70,47,28,28,14,27,56,29,34,4,30,12,82,42,0,20,ENG
fa38722f,0,0,0,0,0,0,0,0,0,0,0,0,0,0,0,20,ENG
fb614c44,36,17,22,14,0,15,25,10,15,7,8,11,47,30,0,20,ENG
fc027d02,1,0,0,1,0,0,3,3,2,0,2,3,4,7,0,20,ENG
fc15fb84,47,33,18,22,7,23,71,48,60,8,52,30,77,34,0,20,ENG
fcab00a0,16,10,4,8,4,10,25,15,19,4,15,9,25,31,0,20,ENG
fce2302c,20,16,13,6,1,11,15,4,10,4,6,9,29,37,1,20,ENG
fdd85f94,64,35,28,28,8,23,74,51,27,8,19,38,102,36,4,20,ENG
fe558029,0,0,0,0,0,0,0,0,0,0,0,0,0,1,1,20,ENG
fe8e6fa1,6,2,3,1,2,2,8,6,4,0,4,0,6,3,0,20,ENG
fed96827,20,9,13,7,0,11,14,3,17,11,6,17,37,62,1,20,ENG
ff527768,52,30,19,28,5,22,64,42,20,6,14,20,72,10,1,20,ENG
ffa90327,20,11,12,5,3,8,26,18,10,1,9,13,33,16,1,20,ENG
005ca692,1,0,0,0,1,1,2,1,0,0,0,0,1,0,0,20,EL
00672021,6,4,0,5,1,3,10,7,4,0,4,7,13,2,0,20,EL
0076ab7f,25,15,5,16,4,11,15,4,5,3,2,6,31,14,0,20,EL
007faf7a,1,1,0,1,0,1,2,1,2,0,2,1,2,0,0,20,EL
00963611,1,0,1,0,0,1,1,0,1,1,0,4,5,3,1,20,EL
00b28772,8,2,3,2,3,3,8,5,7,2,5,13,21,11,0,20,EL
00ddb7f7,13,6,5,8,0,8,17,9,13,1,12,6,19,5,0,20,EL
00eba9c9,7,6,4,2,1,2,5,3,2,1,1,5,12,1,0,20,EL
0127419a,4,3,3,1,0,3,8,5,4,0,4,3,7,1,0,20,EL
01464072,3,2,1,2,0,3,4,1,0,0,0,1,4,2,0,20,EL
0176f037,9,4,5,2,2,9,15,6,6,0,6,6,15,26,0,20,EL
017ab4d4,5,2,2,2,1,1,6,5,1,0,1,2,7,1,0,20,EL
0193a8bf,6,4,2,3,1,3,9,6,6,0,6,7,13,2,0,20,EL
01ba3996,0,0,0,0,0,0,0,0,0,0,0,1,1,0,0,20,EL
02319ad7,2,2,2,0,0,1,8,7,6,3,3,1,3,7,0,20,EL
023efc8b,0,0,0,0,0,0,0,0,0,0,0,0,0,1,0,20,EL
02caf6e0,4,3,0,2,2,1,5,4,2,1,1,3,7,10,0,20,EL
02ce2030,4,3,3,1,0,0,3,3,7,6,1,9,13,28,2,20,EL
02ee4c77,3,0,1,1,1,2,3,1,2,0,2,0,3,2,1,20,EL
03622183,0,0,0,0,0,0,2,2,2,1,1,0,0,0,0,20,EL
038aa94a,13,8,6,5,2,5,16,11,13,4,9,10,23,20,0,20,EL
03df04ff,0,0,0,0,0,0,0,0,0,0,0,0,0,0,0,20,EL
042d286e,1,0,0,0,1,1,2,1,7,0,7,2,3,3,0,20,EL
04a35432,2,2,2,0,0,1,4,3,6,3,3,7,9,31,0,20,EL
04e17fd5,0,0,0,0,0,0,3,3,1,0,1,1,1,3,0,20,EL
0534149c,0,0,0,0,0,0,0,0,0,0,0,0,0,0,0,20,EL
053f6e16,5,5,2,2,1,1,2,1,7,4,3,4,9,13,0,20,EL
0562b7f1,1,0,0,1,0,1,1,0,2,0,2,1,2,2,0,20,EL
05a6c38b,5,5,2,1,2,4,9,5,2,0,2,6,11,11,0,20,EL
05a84d52,5,3,0,4,1,1,5,4,2,0,2,1,6,5,0,20,EL
05cb19c5,5,4,3,1,1,0,1,1,2,1,1,2,7,5,0,20,EL
062fc2e6,0,0,0,0,0,0,0,0,0,0,0,3,3,4,0,20,EL
068830ca,0,0,0,0,0,0,0,0,1,0,1,0,0,5,1,20,EL
06983922,4,2,1,1,2,2,6,4,1,0,1,2,6,1,0,20,EL
06a10001,19,11,10,8,1,13,44,31,19,0,19,16,35,5,2,20,EL
06a1d642,1,1,0,1,0,0,2,2,1,0,1,0,1,1,0,20,EL
06e5b0e4,10,5,8,2,0,4,9,5,4,1,3,11,21,31,0,20,EL
06f33dc8,7,3,4,2,1,1,4,3,1,1,0,2,9,7,0,20,EL
070a3904,2,2,0,2,0,1,3,2,1,0,1,0,2,1,1,20,EL
070ec0b1,7,5,2,5,0,5,7,2,1,0,1,6,13,10,0,20,EL
07a821e4,1,1,1,0,0,0,1,1,0,0,0,0,1,0,0,20,EL
080440a4,21,9,13,8,0,13,20,7,11,4,7,12,33,14,0,20,EL
0827221a,1,0,1,0,0,1,4,3,1,0,1,0,1,1,0,20,EL
08990838,13,7,7,6,0,9,15,6,8,6,2,9,22,32,1,20,EL
08fe932d,1,0,1,0,0,1,1,0,0,0,0,2,3,7,0,20,EL
0a6dbbf7,6,5,5,1,0,4,5,1,11,4,7,6,12,14,1,20,EL
0a74011c,1,1,1,0,0,1,2,1,1,0,1,3,4,5,0,20,EL
0ac893aa,6,4,2,4,0,2,13,11,4,1,3,4,10,11,1,20,EL
0adc7748,7,3,6,1,0,5,6,1,2,2,0,5,12,17,0,20,EL
0aeeed3f,14,9,2,8,4,6,15,9,7,1,6,8,22,4,0,20,EL
0af4b238,1,1,0,1,0,1,2,1,0,0,0,0,1,1,0,20,EL
0b0cbe5b,3,1,0,2,1,1,3,2,1,0,1,2,5,0,0,20,EL
0b380363,4,3,1,2,1,2,4,2,1,0,1,3,7,2,0,20,EL
0b4854f9,4,3,4,0,0,3,4,1,4,2,2,2,6,6,0,20,EL
0b4d8274,8,4,5,2,1,4,6,2,2,0,2,0,8,1,0,20,EL
0b4f388a,2,2,1,1,0,1,2,1,1,0,1,1,3,1,0,20,EL
0bad4516,4,3,2,2,0,3,3,0,2,1,1,4,8,3,1,20,EL
0bd57693,0,0,0,0,0,0,2,2,2,1,1,1,1,0,1,20,EL
0be28faf,19,11,12,6,1,6,16,10,5,0,5,11,30,16,0,20,EL
0be95d34,4,4,2,2,0,0,2,2,3,0,3,4,8,0,0,20,EL
0c09c984,6,4,2,2,2,2,4,2,9,4,5,2,8,3,0,20,EL
0c0d6ed1,7,7,1,4,2,4,15,11,7,0,7,6,13,2,0,20,EL
0cc5f4a5,1,0,0,1,0,0,0,0,1,0,1,0,1,0,0,20,EL
0d115860,0,0,0,0,0,0,0,0,0,0,0,0,0,0,0,20,EL
0d2b0b84,0,0,0,0,0,0,6,6,1,0,1,4,4,2,0,20,EL
0d72fbca,5,1,3,2,0,3,6,3,2,0,2,2,7,3,0,20,EL
0dce3356,8,3,4,4,0,6,13,7,1,1,0,6,14,3,0,20,EL
0e0102eb,1,1,0,1,0,0,1,1,0,0,0,0,1,0,0,20,EL
0e21fc3c,1,0,1,0,0,1,1,0,2,1,1,3,4,4,0,20,EL
0e7ccfc4,4,0,3,0,1,1,4,3,6,1,5,4,8,12,0,20,EL
0e96a5e1,3,2,1,1,1,1,3,2,4,3,1,4,7,1,0,20,EL
0fb5e2ad,2,1,1,0,1,1,2,1,1,0,1,0,2,3,0,20,EL
0fbecd11,8,6,4,2,2,4,14,10,8,1,7,8,16,4,0,20,EL
0fd37a3d,24,14,12,10,2,11,34,23,10,2,8,11,35,15,0,20,EL
1001ae82,3,3,1,1,1,1,1,0,2,0,2,1,4,0,0,20,EL
1055fa53,5,2,4,1,0,4,6,2,2,0,2,4,9,4,0,20,EL
108fe016,9,7,2,5,2,7,14,7,2,1,1,5,14,4,0,20,EL
10f1cd17,5,2,1,3,1,3,4,1,2,0,2,4,9,2,0,20,EL
110338ae,0,0,0,0,0,0,0,0,0,0,0,0,0,2,1,20,EL
112521d1,12,6,7,4,1,5,9,4,7,1,6,2,14,7,2,20,EL
113fb4ea,0,0,0,0,0,0,1,1,0,0,0,0,0,2,0,20,EL
1144d8d7,0,0,0,0,0,0,1,1,0,0,0,0,0,0,0,20,EL
116c35df,1,0,0,0,1,0,1,1,1,0,1,0,1,4,0,20,EL
11c0fa9d,3,1,0,1,2,0,3,3,6,0,6,2,5,2,0,20,EL
11e5e469,6,4,5,1,0,3,3,0,7,6,1,6,12,13,0,20,EL
1232e1dc,6,3,5,0,1,2,3,1,12,6,6,11,17,17,0,20,EL
126568a4,0,0,0,0,0,0,0,0,0,0,0,0,0,0,0,20,EL
1281be1c,0,0,0,0,0,0,1,1,0,0,0,2,2,3,0,20,EL
12dcbdcc,23,14,9,12,2,10,29,19,6,1,5,12,35,15,0,20,EL
12e6d21a,2,2,1,1,0,1,5,4,2,1,1,2,4,14,0,20,EL
13203c45,1,0,0,1,0,0,2,2,2,1,1,5,6,9,0,20,EL
132a82f1,6,3,4,2,0,2,2,0,1,0,1,6,12,8,0,20,EL
132f161f,0,0,0,0,0,0,0,0,2,0,2,0,0,1,0,20,EL
1395682c,2,1,2,0,0,2,2,0,2,2,0,1,3,13,0,20,EL
13a78e01,13,10,11,1,1,5,10,5,4,1,3,11,24,7,0,20,EL
13ac19de,0,0,0,0,0,0,0,0,0,0,0,2,2,1,0,20,EL
13ddc856,7,6,3,3,1,4,6,2,9,0,9,3,10,2,0,20,EL
13ea2544,6,4,4,1,1,3,4,1,1,0,1,2,8,4,0,20,EL
146b19d9,13,7,6,6,1,9,17,8,5,0,5,4,17,4,0,20,EL
146f71c9,9,5,3,6,0,1,7,6,5,1,4,9,18,4,0,20,EL
14e8fe86,8,5,4,2,2,4,6,2,5,4,1,10,18,14,0,20,EL
1519a888,0,0,0,0,0,0,0,0,0,0,0,0,0,0,0,20,EL
15937e17,25,10,16,9,0,7,21,14,14,5,9,17,42,30,0,20,EL
15b287da,12,7,1,7,4,6,17,11,5,2,3,2,14,3,0,20,EL
15b6e8d7,10,8,4,6,0,4,4,0,2,0,2,4,14,5,0,20,EL
15d0c248,1,1,1,0,0,1,2,1,4,3,1,3,4,2,1,20,EL
15eb04ec,11,8,4,5,2,6,16,10,5,1,4,4,15,3,0,20,EL
16380240,2,1,1,1,0,0,0,0,0,0,0,0,2,0,0,20,EL
16657b95,11,8,5,4,2,3,8,5,9,3,6,7,18,9,0,20,EL
1668b4b1,1,1,0,1,0,1,1,0,0,0,0,0,1,0,0,20,EL
16886ee5,15,6,9,6,0,10,26,16,5,0,5,12,27,6,0,20,EL
169fd162,3,3,0,1,2,2,4,2,2,0,2,1,4,1,0,20,EL
16daec92,4,1,0,3,1,1,5,4,2,0,2,1,5,0,0,20,EL
170eb35b,7,2,2,5,0,2,12,10,3,2,1,8,15,4,0,20,EL
17145c90,11,8,7,4,0,6,8,2,3,2,1,5,16,16,0,20,EL
17310a6c,2,2,2,0,0,0,2,2,2,0,2,0,2,0,0,20,EL
173eb3cd,4,3,3,1,0,1,5,4,2,2,0,1,5,2,0,20,EL
174651c8,6,3,2,4,0,3,8,5,2,1,1,3,9,9,0,20,EL
176674ab,0,0,0,0,0,0,0,0,0,0,0,0,0,0,0,20,EL
17695062,6,1,2,2,2,1,7,6,1,1,0,1,7,3,0,20,EL
17780d2b,1,0,1,0,0,0,0,0,3,3,0,1,2,7,0,20,EL
178ae8f8,0,0,0,0,0,0,12,12,1,0,1,3,3,2,0,20,EL
17e3e467,1,1,1,0,0,0,0,0,0,0,0,1,2,0,0,20,EL
1858bbf7,0,0,0,0,0,0,0,0,0,0,0,0,0,6,0,20,EL
1880614f,0,0,0,0,0,0,0,0,0,0,0,1,1,0,0,20,EL
189cee7b,4,3,1,3,0,1,4,3,2,0,2,1,5,1,0,20,EL
1971591f,2,2,0,1,1,0,3,3,4,0,4,0,2,2,0,20,EL
19f8e480,5,4,3,2,0,1,3,2,1,0,1,1,6,3,0,20,EL
1a1033a1,10,10,3,5,2,3,12,9,10,0,10,4,14,0,0,20,EL
1a317a1b,11,5,6,3,2,4,8,4,4,1,3,4,15,8,0,20,EL
1a672e2d,4,2,2,1,1,2,7,5,1,0,1,0,4,2,1,20,EL
1a6b7ea4,10,7,3,7,0,6,15,9,12,5,7,9,19,8,0,20,EL
1a799243,10,7,6,3,1,2,4,2,4,0,4,4,14,1,0,20,EL
1a9db1c5,2,1,0,2,0,2,4,2,0,0,0,0,2,4,0,20,EL
1adb73db,1,1,0,1,0,0,2,2,1,1,0,0,1,4,0,20,EL
1adcf39e,5,5,3,1,1,4,12,8,6,3,3,9,14,24,1,20,EL
1ae836b1,3,2,0,2,1,1,4,3,1,0,1,2,5,3,0,20,EL
1b17ed86,8,6,4,4,0,3,7,4,2,1,1,5,13,4,0,20,EL
1b192c1f,17,13,8,9,0,14,32,18,9,2,7,9,26,21,0,20,EL
1b7ddc55,0,0,0,0,0,0,0,0,0,0,0,1,1,0,0,20,EL
1b7ec703,1,0,0,1,0,0,0,0,0,0,0,0,1,0,0,20,EL
1b81794d,0,0,0,0,0,0,0,0,1,0,1,0,0,0,0,20,EL
1bd5735a,2,1,1,1,0,0,0,0,2,0,2,1,3,1,0,20,EL
1bd5fc78,3,2,1,2,0,1,2,1,1,1,0,1,4,6,0,20,EL
1c0567fc,0,0,0,0,0,0,2,2,1,0,1,0,0,0,0,20,EL
1c07b06e,3,2,0,3,0,0,3,3,4,1,3,8,11,4,0,20,EL
1c59240b,8,5,3,5,0,4,17,13,10,0,10,5,13,1,0,20,EL
1c90cd29,3,2,3,0,0,1,3,2,1,1,0,3,6,8,0,20,EL
1c98558c,0,0,0,0,0,0,0,0,0,0,0,0,0,6,1,20,EL
1caa93a5,0,0,0,0,0,0,0,0,1,0,1,0,0,4,1,20,EL
1cbe4984,15,8,5,7,3,4,8,4,10,1,9,9,24,5,0,20,EL
1d5cab82,6,2,5,1,0,2,6,4,3,1,2,1,7,2,0,20,EL
1d896c05,5,0,2,3,0,4,6,2,2,0,2,1,6,2,0,20,EL
1daec722,12,8,2,8,2,3,13,10,5,0,5,5,17,4,0,20,EL
1dbfae2d,2,1,1,1,0,0,0,0,0,0,0,0,2,3,0,20,EL
1e064bfb,0,0,0,0,0,0,0,0,0,0,0,0,0,0,0,20,EL
1e26e376,0,0,0,0,0,0,0,0,0,0,0,0,0,3,1,20,EL
1ec7e1c5,0,0,0,0,0,0,1,1,2,1,1,8,8,20,0,20,EL
1eecc0c6,5,3,1,4,0,3,7,4,1,0,1,7,12,1,1,20,EL
1f3afdcb,1,1,1,0,0,0,2,2,6,2,4,2,3,4,0,20,EL
1fbbfbde,15,7,10,5,0,8,11,3,11,9,2,8,23,50,0,20,EL
1fffae99,18,9,7,10,1,4,16,12,8,0,8,7,25,13,0,20,EL
2054d037,3,1,3,0,0,1,1,0,2,0,2,0,3,2,0,20,EL
2077ae86,1,1,0,1,0,0,0,0,1,1,0,1,2,3,0,20,EL
20b9f052,0,0,0,0,0,0,0,0,0,0,0,0,0,10,0,20,EL
20df3aaf,5,2,2,2,1,3,10,7,1,0,1,2,7,0,0,20,EL
20e73fac,6,4,2,2,2,2,7,5,5,0,5,4,10,9,0,20,EL
213cd822,0,0,0,0,0,0,1,1,0,0,0,0,0,2,1,20,EL
21519148,19,12,9,8,2,11,16,5,7,2,5,7,26,6,0,20,EL
215918bf,0,0,0,0,0,0,1,1,1,0,1,0,0,1,0,20,EL
220ace7e,13,8,4,7,2,10,27,17,6,1,5,4,17,2,0,20,EL
22a239c1,1,1,0,1,0,0,3,3,1,0,1,0,1,1,0,20,EL
22a94b80,0,0,0,0,0,0,0,0,0,0,0,0,0,0,0,20,EL
22cd43d2,0,0,0,0,0,0,0,0,0,0,0,0,0,0,0,20,EL
22db7a5e,0,0,0,0,0,0,0,0,0,0,0,0,0,3,0,20,EL
230f0471,0,0,0,0,0,0,0,0,0,0,0,0,0,0,0,20,EL
23c5db70,5,3,0,3,2,2,5,3,1,0,1,0,5,0,0,20,EL
23f9e9d3,0,0,0,0,0,0,0,0,1,1,0,0,0,0,0,20,EL
2402b0e8,6,4,4,2,0,0,7,7,7,3,4,15,21,15,0,20,EL
242e1043,9,5,5,3,1,3,7,4,4,2,2,3,12,5,0,20,EL
244a1281,13,8,10,2,1,4,7,3,4,1,3,13,26,22,0,20,EL
244a31b9,10,7,10,0,0,4,7,3,4,1,3,22,32,36,0,20,EL
244f57b9,8,6,6,2,0,4,11,7,1,0,1,7,15,5,0,20,EL
2475dcc6,0,0,0,0,0,0,1,1,1,0,1,0,0,1,0,20,EL
24b98f95,3,2,1,1,1,3,6,3,1,0,1,0,3,4,0,20,EL
2513a588,6,4,4,2,0,3,10,7,4,0,4,3,9,2,0,20,EL
25146df0,5,4,3,2,0,2,6,4,3,2,1,11,16,16,0,20,EL
25736bcf,0,0,0,0,0,0,0,0,5,5,0,1,1,4,0,20,EL
258aff54,11,6,5,5,1,2,8,6,1,0,1,3,14,3,0,20,EL
2628fd2b,0,0,0,0,0,0,0,0,0,0,0,0,0,0,0,20,EL
262e5a82,4,4,2,2,0,2,6,4,2,0,2,2,6,0,0,20,EL
2648e18f,2,2,0,2,0,1,3,2,1,0,1,1,3,1,0,20,EL
2677a1de,5,5,1,4,0,1,1,0,2,1,1,2,7,0,0,20,EL
2696b6a9,4,3,1,3,0,3,4,1,2,0,2,0,4,2,0,20,EL
26a796c1,11,6,5,5,1,6,17,11,16,0,16,10,21,1,0,20,EL
26ce2263,16,10,7,7,2,5,19,14,11,1,10,5,21,9,0,20,EL
273c483b,0,0,0,0,0,0,0,0,1,0,1,0,0,0,0,20,EL
275f52fc,0,0,0,0,0,0,0,0,0,0,0,0,0,0,0,20,EL
276cce2e,4,3,3,1,0,2,2,0,4,1,3,4,8,12,0,20,EL
27d902c8,0,0,0,0,0,0,0,0,0,0,0,0,0,2,0,20,EL
27f0ddef,5,3,4,1,0,5,5,0,6,5,1,7,12,30,0,20,EL
27ff9bdb,3,1,2,1,0,1,4,3,0,0,0,0,3,1,1,20,EL
282faa70,2,1,0,2,0,1,6,5,3,1,2,3,5,2,0,20,EL
28a65a2c,0,0,0,0,0,0,0,0,0,0,0,0,0,2,0,20,EL
28b1f3ce,17,9,6,9,2,8,20,12,15,0,15,4,21,3,0,20,EL
28b76e67,10,6,2,8,0,4,17,13,10,0,10,9,19,4,0,20,EL
28eea0fc,9,6,4,4,1,3,6,3,2,0,2,7,16,6,0,20,EL
2903a856,7,5,7,0,0,4,11,7,3,1,2,2,9,3,0,20,EL
2928dca2,6,4,4,2,0,3,5,2,9,7,2,8,14,24,0,20,EL
292a652a,4,2,3,1,0,2,4,2,7,5,2,7,11,16,0,20,EL
29733c72,4,2,3,0,1,1,8,7,3,0,3,2,6,1,0,20,EL
2a0c8ba4,11,6,1,7,3,6,17,11,6,0,6,9,20,4,0,20,EL
2a5fab54,0,0,0,0,0,0,0,0,0,0,0,0,0,0,0,20,EL
2a6cd437,2,2,2,0,0,1,2,1,1,1,0,2,4,1,0,20,EL
2b53f7a5,0,0,0,0,0,0,3,3,1,0,1,3,3,2,0,20,EL
2bab583c,8,8,5,3,0,1,6,5,8,5,3,4,12,24,0,20,EL
2baec6ce,2,1,0,2,0,1,1,0,3,1,2,2,4,7,0,20,EL
2bea06e0,0,0,0,0,0,0,0,0,0,0,0,0,0,2,1,20,EL
2c0f8e9e,2,1,1,1,0,1,7,6,2,0,2,4,6,0,0,20,EL
2c44a35d,2,1,1,1,0,0,6,6,2,0,2,0,2,0,0,20,EL
2cb77ec6,8,3,6,1,1,3,3,0,6,4,2,6,14,19,0,20,EL
2cbb3202,8,5,4,3,1,2,9,7,8,0,8,2,10,1,0,20,EL
2d49b833,10,5,6,2,2,4,9,5,2,2,0,4,14,16,0,20,EL
2d7d4acc,7,2,7,0,0,5,9,4,3,2,1,6,13,12,0,20,EL
2e5e846d,2,0,0,0,2,0,0,0,0,0,0,1,3,3,0,20,EL
2ebc1b44,6,4,2,3,1,2,9,7,4,0,4,6,12,1,0,20,EL
2ef7c612,2,1,1,0,1,2,2,0,2,2,0,0,2,1,0,20,EL
2f52874b,15,7,8,5,2,12,23,11,5,1,4,4,19,14,0,20,EL
2f7af524,13,10,4,8,1,4,7,3,7,3,4,12,25,18,0,20,EL
2f8e326a,12,3,7,5,0,3,13,10,12,1,11,1,13,12,0,20,EL
30061f53,0,0,0,0,0,0,0,0,0,0,0,0,0,1,1,20,EL
301b1e4c,0,0,0,0,0,0,1,1,0,0,0,1,1,0,0,20,EL
30223b33,0,0,0,0,0,0,0,0,0,0,0,0,0,2,0,20,EL
30263816,0,0,0,0,0,0,0,0,0,0,0,0,0,0,0,20,EL
303636d2,0,0,0,0,0,0,2,2,0,0,0,0,0,3,0,20,EL
3046fcff,0,0,0,0,0,0,2,2,2,2,0,3,3,8,0,20,EL
3060f38c,9,5,4,3,2,4,12,8,3,0,3,5,14,16,0,20,EL
30643ce2,3,2,2,0,1,1,2,1,1,0,1,0,3,1,1,20,EL
3098c0df,4,3,0,4,0,0,1,1,3,0,3,1,5,1,0,20,EL
30c220c3,5,2,4,1,0,2,3,1,2,0,2,2,7,2,0,20,EL
30d4a2e5,8,4,4,3,1,3,6,3,5,0,5,12,20,8,0,20,EL
30d75bfb,8,5,5,2,1,4,4,0,4,0,4,1,9,4,0,20,EL
30f5ffa9,0,0,0,0,0,0,0,0,0,0,0,0,0,1,0,20,EL
31114001,4,3,2,2,0,2,3,1,3,1,2,3,7,2,0,20,EL
314a0ea4,8,7,4,3,1,4,18,14,4,0,4,4,12,1,0,20,EL
316de854,10,7,3,6,1,2,9,7,5,0,5,4,14,1,0,20,EL
31c01b85,12,9,4,5,3,8,11,3,5,2,3,8,20,5,0,20,EL
31c69ef1,4,1,2,2,0,3,3,0,1,0,1,1,5,3,1,20,EL
31e3ab68,0,0,0,0,0,0,0,0,0,0,0,0,0,0,0,20,EL
31faf295,7,3,4,2,1,2,3,1,1,0,1,3,10,10,0,20,EL
328f7d51,7,4,4,2,1,0,3,3,4,0,4,2,9,0,1,20,EL
32c016f8,7,2,4,2,1,1,5,4,3,0,3,1,8,2,0,20,EL
32e73151,9,5,2,6,1,3,11,8,6,0,6,9,18,1,0,20,EL
32e7ce92,1,1,1,0,0,1,1,0,0,0,0,0,1,2,1,20,EL
32f60ed8,2,0,0,2,0,1,5,4,1,0,1,5,7,1,0,20,EL
3318286e,0,0,0,0,0,0,0,0,0,0,0,0,0,2,0,20,EL
3353737a,9,7,4,4,1,5,6,1,6,2,4,12,21,10,0,20,EL
33887998,1,1,1,0,0,0,0,0,0,0,0,0,1,1,1,20,EL
339fe0e8,0,0,0,0,0,0,0,0,0,0,0,0,0,1,1,20,EL
33b11df6,7,4,4,2,1,4,10,6,6,0,6,1,8,1,0,20,EL
33b8d077,5,4,0,4,1,3,8,5,1,1,0,7,12,4,0,20,EL
3423f250,5,3,1,2,2,2,8,6,6,0,6,5,10,2,0,20,EL
34269bdf,8,5,4,4,0,3,11,8,4,0,4,5,13,7,0,20,EL
346d51d9,2,1,1,1,0,1,5,4,0,0,0,1,3,1,0,20,EL
34a88e3e,5,4,0,3,2,0,4,4,2,0,2,2,7,2,0,20,EL
34b54da7,3,1,1,2,0,2,2,0,4,3,1,5,8,9,0,20,EL
34c3b935,0,0,0,0,0,0,1,1,0,0,0,0,0,1,2,20,EL
34caa4b3,4,1,1,1,2,1,12,11,9,0,9,2,6,3,0,20,EL
350e71a0,4,2,0,2,2,1,4,3,4,1,3,2,6,3,0,20,EL
35141f4c,7,4,5,2,0,3,7,4,3,1,2,8,15,15,0,20,EL
352ca5eb,3,2,1,2,0,1,3,2,1,0,1,2,5,4,0,20,EL
356c9002,0,0,0,0,0,0,0,0,0,0,0,0,0,0,0,20,EL
35bd124a,4,3,2,2,0,4,7,3,2,2,0,1,5,2,0,20,EL
3626daea,11,7,8,3,0,6,13,7,10,1,9,9,20,17,0,20,EL
366f6f12,3,3,2,1,0,2,2,0,6,5,1,1,4,6,1,20,EL
36a59ba4,4,4,0,3,1,3,8,5,3,1,2,3,7,3,1,20,EL
36a79857,3,2,0,1,2,1,7,6,1,0,1,3,6,1,0,20,EL
36d836c9,10,6,6,4,0,5,7,2,3,0,3,6,16,8,0,20,EL
36d9dabe,0,0,0,0,0,0,1,1,0,0,0,0,0,0,0,20,EL
36f19a65,0,0,0,0,0,0,0,0,1,0,1,0,0,0,0,20,EL
3767b3b7,12,6,11,1,0,5,6,1,7,5,2,3,15,14,0,20,EL
378825c7,5,3,1,4,0,2,5,3,4,2,2,4,9,10,0,20,EL
379652be,3,1,0,3,0,1,7,6,1,0,1,1,4,2,0,20,EL
379dc075,6,2,1,3,2,0,4,4,2,0,2,2,8,0,0,20,EL
37e103f8,0,0,0,0,0,0,3,3,1,0,1,0,0,0,0,20,EL
37f827ec,2,1,1,1,0,2,2,0,0,0,0,4,6,16,0,20,EL
37faa4cb,0,0,0,0,0,0,1,1,1,0,1,0,0,0,0,20,EL
3814b753,0,0,0,0,0,0,0,0,0,0,0,0,0,1,0,20,EL
384d58d9,18,14,8,8,2,12,19,7,9,2,7,11,29,5,0,20,EL
389f24bf,2,0,0,2,0,1,1,0,2,0,2,0,2,2,0,20,EL
38e78902,0,0,0,0,0,0,0,0,0,0,0,0,0,0,0,20,EL
3904e745,14,9,8,5,1,10,18,8,5,0,5,8,22,16,0,20,EL
392a7aea,2,0,0,2,0,1,7,6,4,1,3,2,4,2,0,20,EL
3935e52e,6,3,5,1,0,2,2,0,1,0,1,0,6,2,0,20,EL
3a233281,1,0,1,0,0,1,4,3,1,0,1,0,1,0,0,20,EL
3acadb7f,0,0,0,0,0,0,0,0,0,0,0,0,0,1,0,20,EL
3bb7f478,7,6,1,6,0,3,7,4,5,1,4,1,8,7,0,20,EL
3c16d927,6,5,4,2,0,3,11,8,4,0,4,4,10,2,0,20,EL
3c70fb81,17,10,5,12,0,6,13,7,5,0,5,6,23,12,0,20,EL
3cb6f224,8,3,1,4,3,2,11,9,6,1,5,1,9,7,0,20,EL
3cdfc63e,3,2,3,0,0,3,4,1,9,9,0,8,11,27,0,20,EL
3ce20eda,0,0,0,0,0,0,1,1,0,0,0,2,2,3,0,20,EL
3cefa66a,9,5,5,3,1,3,11,8,6,2,4,5,14,9,0,20,EL
3d022757,0,0,0,0,0,0,0,0,1,0,1,2,2,3,0,20,EL
3d13d9e4,0,0,0,0,0,0,0,0,1,1,0,1,1,0,0,20,EL
3d214e5f,0,0,0,0,0,0,0,0,0,0,0,0,0,1,0,20,EL
3d2320f7,6,3,2,2,2,2,3,1,5,2,3,5,11,6,0,20,EL
3da8cba0,0,0,0,0,0,0,0,0,0,0,0,0,0,0,0,20,EL
3e59d360,1,0,1,0,0,1,2,1,2,0,2,0,1,1,0,20,EL
3e975352,8,6,2,5,1,5,7,2,1,0,1,0,8,1,0,20,EL
3ed84b2c,0,0,0,0,0,0,1,1,1,0,1,1,1,0,0,20,EL
3effaa34,1,1,0,0,1,0,4,4,2,0,2,1,2,4,0,20,EL
3f10bd22,4,2,4,0,0,2,7,5,1,0,1,8,12,12,0,20,EL
3f2d59fe,9,6,5,4,0,3,6,3,5,4,1,12,21,29,0,20,EL
3f359b33,4,2,3,1,0,2,2,0,6,6,0,13,17,17,0,20,EL
3fa66cb2,3,3,3,0,0,2,4,2,1,1,0,1,4,3,0,20,EL
4030c7ae,0,0,0,0,0,0,0,0,0,0,0,0,0,5,0,20,EL
4037db79,15,8,8,7,0,10,18,8,4,1,3,15,30,15,0,20,EL
403f5d20,5,3,3,0,2,2,4,2,0,0,0,1,6,5,0,20,EL
40ca6712,4,4,3,0,1,0,2,2,3,0,3,1,5,1,0,20,EL
40e236a8,1,0,1,0,0,1,1,0,1,0,1,0,1,0,0,20,EL
40ef7347,3,2,1,2,0,1,4,3,0,0,0,1,4,3,0,20,EL
418befe0,12,7,6,5,1,5,9,4,5,1,4,10,22,8,0,20,EL
41b3069f,13,6,8,4,1,6,11,5,3,1,2,8,21,8,0,20,EL
41c12f75,19,13,8,8,3,5,10,5,12,1,11,6,25,8,0,20,EL
41c7bfd7,1,1,1,0,0,0,1,1,0,0,0,1,2,0,0,20,EL
41f32541,18,4,8,9,1,10,13,3,3,1,2,3,21,8,0,20,EL
41ff002d,0,0,0,0,0,0,2,2,0,0,0,0,0,1,0,20,EL
420c18a1,0,0,0,0,0,0,0,0,0,0,0,0,0,2,1,20,EL
4242011c,0,0,0,0,0,0,0,0,4,1,3,6,6,6,0,20,EL
424d5f72,9,6,5,4,0,2,2,0,0,0,0,1,10,4,0,20,EL
4253363a,0,0,0,0,0,0,1,1,1,0,1,0,0,4,0,20,EL
42ec696a,1,0,1,0,0,1,2,1,0,0,0,0,1,1,1,20,EL
4383b0da,1,0,0,0,1,1,3,2,2,1,1,1,2,4,0,20,EL
438ae11e,8,7,4,2,2,4,10,6,2,2,0,8,16,2,0,20,EL
4398b5cb,3,1,2,1,0,1,1,0,1,1,0,0,3,8,0,20,EL
43f71e77,1,1,1,0,0,1,3,2,2,0,2,0,1,1,0,20,EL
441197b8,4,4,2,0,2,2,3,1,7,2,5,7,11,16,1,20,EL
4431aed2,1,1,0,0,1,1,1,0,1,0,1,0,1,1,0,20,EL
447837d1,6,3,4,1,1,5,11,6,1,0,1,0,6,1,1,20,EL
44ac04e9,1,1,0,0,1,1,4,3,1,0,1,0,1,2,0,20,EL
44b49036,0,0,0,0,0,0,0,0,0,0,0,0,0,0,0,20,EL
44bfb6c5,11,5,2,8,1,3,10,7,11,2,9,18,29,4,0,20,EL
44eb9093,6,3,3,2,1,3,11,8,5,0,5,7,13,6,0,20,EL
450ad405,29,20,19,10,0,16,26,10,9,2,7,29,58,29,1,20,EL
4515f00d,2,1,0,2,0,0,3,3,2,0,2,1,3,0,0,20,EL
4574720b,3,2,0,1,2,0,1,1,2,0,2,0,3,3,0,20,EL
45954ec7,9,6,7,2,0,3,7,4,8,4,4,22,31,18,0,20,EL
45b9b619,0,0,0,0,0,0,0,0,1,0,1,0,0,2,0,20,EL
45e11f7e,2,2,2,0,0,2,3,1,3,2,1,7,9,25,0,20,EL
467bae22,12,11,5,5,2,4,7,3,5,0,5,3,15,2,0,20,EL
468fdbad,5,5,2,3,0,4,7,3,1,1,0,3,8,1,0,20,EL
469d3d84,1,1,1,0,0,0,0,0,1,0,1,0,1,0,0,20,EL
46e58246,6,3,6,0,0,3,10,7,4,1,3,3,9,9,0,20,EL
46ff3923,1,1,1,0,0,0,2,2,2,2,0,1,2,13,0,20,EL
4760b2f2,8,7,7,1,0,3,8,5,9,8,1,17,25,40,0,20,EL
47a0b54d,4,3,4,0,0,2,5,3,3,3,0,6,10,16,0,20,EL
47a34c4f,5,4,1,4,0,1,2,1,1,0,1,7,12,4,0,20,EL
47dc80f5,5,3,2,3,0,2,8,6,2,0,2,3,8,0,0,20,EL
48035304,17,12,9,8,0,7,8,1,7,3,4,12,29,16,0,20,EL
481c9ece,20,11,16,4,0,9,15,6,4,3,1,10,30,17,0,20,EL
482e9289,1,0,1,0,0,1,6,5,4,3,1,5,6,9,0,20,EL
485eaf31,5,5,3,1,1,3,6,3,3,2,1,15,20,10,0,20,EL
489e80e3,5,4,4,1,0,1,2,1,2,1,1,0,5,0,0,20,EL
48a2b92a,15,11,6,6,3,6,16,10,7,0,7,9,24,6,0,20,EL
48a5a5d6,13,7,5,4,4,2,16,14,4,0,4,1,14,2,0,20,EL
48b28bfd,5,4,1,3,1,1,4,3,1,0,1,4,9,4,0,20,EL
48e89655,2,2,1,1,0,0,2,2,0,0,0,0,2,0,0,20,EL
48f984b4,0,0,0,0,0,0,0,0,0,0,0,0,0,0,0,20,EL
4914ed4a,2,1,1,0,1,0,0,0,0,0,0,0,2,3,0,20,EL
493924a7,13,8,7,3,3,6,7,1,5,0,5,5,18,6,0,20,EL
496aeede,6,3,1,4,1,0,8,8,6,0,6,3,9,2,0,20,EL
49e9d799,6,2,0,5,1,0,5,5,3,1,2,1,7,4,0,20,EL
4a1a9578,5,3,3,2,0,1,9,8,6,0,6,3,8,2,0,20,EL
4a1abff3,7,5,4,2,1,4,12,8,3,0,3,1,8,0,0,20,EL
4a537185,1,0,0,0,1,0,2,2,2,0,2,1,2,0,0,20,EL
4a56052c,4,1,2,2,0,2,19,17,2,0,2,6,10,5,0,20,EL
4a5a45c7,6,3,1,3,2,0,4,4,0,0,0,0,6,1,0,20,EL
4a895384,0,0,0,0,0,0,3,3,2,1,1,6,6,11,2,20,EL
4aea5077,8,6,2,5,1,4,11,7,8,1,7,7,15,8,0,20,EL
4b1793b0,0,0,0,0,0,0,0,0,0,0,0,0,0,0,0,20,EL
4b2ad4b1,10,6,5,4,1,5,6,1,3,0,3,10,20,7,0,20,EL
4b3c863f,3,1,2,1,0,0,4,4,2,2,0,2,5,7,0,20,EL
4b803b3c,3,1,2,1,0,1,1,0,4,1,3,1,4,10,0,20,EL
4be0b467,0,0,0,0,0,0,0,0,0,0,0,0,0,0,0,20,EL
4c07f0e8,15,11,11,3,1,8,12,4,2,0,2,7,22,11,0,20,EL
4c3a6744,6,4,1,5,0,1,6,5,4,1,3,4,10,1,0,20,EL
4c45cdc2,2,2,0,2,0,1,1,0,0,0,0,0,2,0,0,20,EL
4c6facae,29,16,9,17,3,10,21,11,6,0,6,14,43,4,1,20,EL
4c78b5ed,11,9,4,7,0,3,3,0,5,1,4,6,17,4,1,20,EL
4ca4f601,0,0,0,0,0,0,0,0,0,0,0,0,0,0,0,20,EL
4d0eb7d2,2,2,1,1,0,1,5,4,1,0,1,2,4,1,0,20,EL
4d1666ff,7,7,3,4,0,4,5,1,6,5,1,7,14,19,0,20,EL
4d425e6e,21,12,10,10,1,9,21,12,5,1,4,3,24,4,0,20,EL
4d8cf390,6,4,1,3,2,2,5,3,4,0,4,1,7,2,0,20,EL
4d982baf,1,0,0,1,0,1,2,1,2,0,2,3,4,2,0,20,EL
4da9191b,4,4,4,0,0,3,10,7,5,2,3,11,15,9,0,20,EL
4e015693,6,2,2,4,0,1,6,5,1,0,1,6,12,2,0,20,EL
4e219ad2,2,0,1,0,1,2,8,6,2,1,1,1,3,1,0,20,EL
4e358a2d,12,7,8,3,1,8,12,4,6,5,1,11,23,15,0,20,EL
4e6dbac4,10,6,6,4,0,1,5,4,2,0,2,5,15,6,0,20,EL
4f56170e,1,1,1,0,0,1,2,1,0,0,0,1,2,12,0,20,EL
4f5a953e,8,4,7,1,0,2,8,6,13,8,5,3,11,16,1,20,EL
4f8ce0e1,0,0,0,0,0,0,0,0,0,0,0,0,0,3,0,20,EL
4fc7c059,1,0,1,0,0,1,1,0,0,0,0,2,3,4,0,20,EL
4fe7e935,2,2,0,1,1,0,4,4,2,0,2,2,4,3,0,20,EL
501055d8,0,0,0,0,0,0,0,0,1,0,1,0,0,0,0,20,EL
5042e5c2,0,0,0,0,0,0,0,0,0,0,0,0,0,2,0,20,EL
505d9778,1,1,1,0,0,0,2,2,1,1,0,3,4,1,0,20,EL
507c7bdf,14,10,4,8,2,6,16,10,9,2,7,6,20,6,1,20,EL
50d85cd8,7,4,4,3,0,4,13,9,6,3,3,8,15,23,2,20,EL
50dc94ce,4,2,2,2,0,2,3,1,2,1,1,2,6,0,0,20,EL
50e73475,1,1,1,0,0,1,2,1,1,1,0,3,4,7,0,20,EL
50f823d3,0,0,0,0,0,0,1,1,2,0,2,0,0,0,0,20,EL
518918ad,6,6,5,1,0,1,14,13,10,2,8,8,14,7,0,20,EL
520c318f,5,3,0,5,0,0,2,2,6,1,5,2,7,2,0,20,EL
52611641,5,4,3,2,0,1,4,3,6,3,3,5,10,3,0,20,EL
526541e5,11,4,7,4,0,6,7,1,10,7,3,12,23,14,1,20,EL
5294a83f,3,2,1,1,1,2,6,4,0,0,0,0,3,2,0,20,EL
52e101a8,8,7,6,2,0,3,6,3,6,6,0,8,16,25,0,20,EL
53070b63,1,1,1,0,0,1,1,0,0,0,0,1,2,0,0,20,EL
532aa911,0,0,0,0,0,0,0,0,1,1,0,1,1,2,0,20,EL
539230cf,2,0,1,1,0,1,3,2,4,2,2,2,4,8,0,20,EL
546bb36e,5,1,2,2,1,2,9,7,3,1,2,2,7,1,0,20,EL
54771b10,13,7,10,2,1,6,9,3,7,4,3,6,19,13,0,20,EL
54b4dc4e,9,6,4,3,2,5,15,10,4,1,3,1,10,3,0,20,EL
54bcdeb0,1,1,0,1,0,0,3,3,0,0,0,0,1,0,0,20,EL
54c9ed15,11,3,6,3,2,9,14,5,6,6,0,6,17,20,0,20,EL
54f5ce34,2,1,2,0,0,0,0,0,0,0,0,4,6,4,0,20,EL
5529e983,5,4,3,1,1,2,3,1,3,2,1,1,6,3,0,20,EL
555d5edd,2,0,1,1,0,2,8,6,2,0,2,2,4,4,0,20,EL
55a480e4,3,2,1,2,0,2,5,3,1,0,1,0,3,0,0,20,EL
55abe554,5,2,4,1,0,3,5,2,2,0,2,6,11,2,0,20,EL
55ae91f0,1,1,1,0,0,1,2,1,0,0,0,0,1,1,0,20,EL
55bd7d45,0,0,0,0,0,0,0,0,0,0,0,0,0,0,0,20,EL
56413b1f,5,5,2,3,0,1,6,5,2,1,1,4,9,0,0,20,EL
565bf0da,18,8,15,3,0,13,31,18,10,4,6,12,30,23,1,20,EL
56f6f826,6,5,3,3,0,4,7,3,6,4,2,6,12,73,1,20,EL
571d3ac1,11,7,6,5,0,6,14,8,6,3,3,6,17,8,0,20,EL
572498c7,6,4,3,1,2,4,9,5,8,3,5,6,12,7,0,20,EL
57760e66,5,2,3,2,0,3,8,5,1,0,1,5,10,1,0,20,EL
57ae16f4,6,4,2,3,1,3,7,4,5,1,4,3,9,0,0,20,EL
57e3f0c7,7,4,2,3,2,2,4,2,1,0,1,0,7,1,0,20,EL
580bcd18,2,1,1,1,0,0,2,2,3,1,2,2,4,3,0,20,EL
58797f45,0,0,0,0,0,0,0,0,0,0,0,0,0,0,0,20,EL
588de166,8,6,5,2,1,3,6,3,4,0,4,2,10,2,0,20,EL
58a9a4d9,6,3,0,4,2,0,3,3,2,0,2,2,8,0,0,20,EL
58afe001,15,9,5,8,2,3,10,7,7,0,7,14,29,4,0,20,EL
58dda688,7,5,5,2,0,5,8,3,4,1,3,10,17,11,1,20,EL
58eee997,8,5,4,2,2,2,7,5,0,0,0,1,9,1,0,20,EL
5906ab00,0,0,0,0,0,0,0,0,2,0,2,4,4,1,0,20,EL
593bf50d,6,5,4,2,0,4,6,2,4,2,2,7,13,16,1,20,EL
595ccab1,0,0,0,0,0,0,0,0,0,0,0,0,0,0,0,20,EL
5976f83e,3,1,2,1,0,1,3,2,1,0,1,1,4,7,0,20,EL
59a3efba,3,2,3,0,0,1,4,3,2,0,2,3,6,1,0,20,EL
59a7d912,3,2,1,1,1,0,11,11,7,0,7,2,5,2,0,20,EL
59fd245c,0,0,0,0,0,0,1,1,1,0,1,0,0,0,0,20,EL
5a28b2d9,5,4,2,3,0,2,4,2,11,8,3,11,16,32,0,20,EL
5a48195c,15,9,10,4,1,11,17,6,5,2,3,5,20,16,1,20,EL
5a7301ae,13,7,9,1,3,10,17,7,11,3,8,9,22,17,0,20,EL
5aa53281,12,6,8,4,0,4,11,7,4,2,2,16,28,20,1,20,EL
5ad141cb,12,7,5,4,3,7,31,24,11,0,11,9,21,4,0,20,EL
5af687a1,0,0,0,0,0,0,0,0,0,0,0,0,0,0,0,20,EL
5b3d1a7a,4,4,1,2,1,1,9,8,10,1,9,5,9,8,0,20,EL
5b479568,2,2,0,1,1,0,2,2,4,0,4,0,2,3,0,20,EL
5b887c7a,7,7,5,2,0,3,3,0,3,3,0,5,12,16,1,20,EL
5bfb7572,0,0,0,0,0,0,0,0,0,0,0,0,0,0,0,20,EL
5c4f0f49,3,2,2,1,0,1,4,3,11,6,5,15,18,25,0,20,EL
5c6ba09a,7,4,6,0,1,6,9,3,2,1,1,10,17,7,0,20,EL
5c961282,17,13,12,4,1,11,21,10,9,3,6,8,25,19,0,20,EL
5c9ac7f0,2,1,0,2,0,0,5,5,3,1,2,1,3,0,0,20,EL
5caa62a7,1,0,1,0,0,0,2,2,6,0,6,3,4,0,0,20,EL
5d5219b1,2,1,0,2,0,1,6,5,3,0,3,0,2,0,0,20,EL
5da33b33,5,4,4,1,0,1,3,2,3,0,3,1,6,0,0,20,EL
5ddb8f9f,8,3,1,5,2,1,6,5,2,0,2,3,11,9,1,20,EL
5e1028e5,2,2,2,0,0,1,2,1,1,0,1,1,3,1,0,20,EL
5e74d6c8,17,12,12,4,1,9,15,6,10,2,8,10,27,14,0,20,EL
5e91ddf8,0,0,0,0,0,0,0,0,0,0,0,1,1,2,1,20,EL
5e9fa5c9,11,6,8,3,0,6,12,6,2,1,1,13,24,10,0,20,EL
5ea8ef20,8,3,4,3,1,3,14,11,3,2,1,6,14,6,0,20,EL
5eae500a,1,0,0,0,1,0,0,0,1,0,1,0,1,3,0,20,EL
5eb3130f,0,0,0,0,0,0,0,0,0,0,0,0,0,0,0,20,EL
5eebbfdf,3,3,0,3,0,0,5,5,5,0,5,3,6,2,0,20,EL
5f26e0c5,4,2,3,1,0,3,5,2,3,0,3,4,8,4,0,20,EL
5f4ce4b6,11,6,2,8,1,4,8,4,4,0,4,5,16,2,0,20,EL
5faa73aa,2,1,1,1,0,0,1,1,6,0,6,1,3,3,0,20,EL
5fcb90ac,7,5,5,2,0,2,3,1,4,0,4,2,9,8,0,20,EL
6043997c,2,2,2,0,0,1,1,0,0,0,0,3,5,7,0,20,EL
60c07b31,5,3,5,0,0,1,2,1,9,7,2,7,12,16,1,20,EL
60db2f9b,5,4,2,3,0,2,7,5,2,0,2,3,8,2,0,20,EL
60fd5334,0,0,0,0,0,0,1,1,1,0,1,3,3,2,0,20,EL
614f69aa,13,8,4,6,3,7,16,9,3,1,2,8,21,10,0,20,EL
62ab9184,9,5,0,8,1,1,9,8,7,2,5,7,16,3,0,20,EL
6388e356,0,0,0,0,0,0,1,1,1,0,1,1,1,5,0,20,EL
63b9cc6d,2,1,0,0,2,0,0,0,0,0,0,0,2,0,0,20,EL
63c3659d,5,2,3,2,0,1,2,1,10,6,4,11,16,40,0,20,EL
6438d426,1,0,0,1,0,0,0,0,0,0,0,0,1,0,0,20,EL
645a3363,2,0,0,0,2,0,4,4,2,0,2,1,3,1,0,20,EL
64f69877,3,2,2,1,0,1,4,3,3,0,3,0,3,0,0,20,EL
654600fd,0,0,0,0,0,0,1,1,2,0,2,1,1,0,0,20,EL
6554bb97,5,3,2,2,1,4,6,2,4,0,4,2,7,1,0,20,EL
65553d96,3,0,0,3,0,1,3,2,0,0,0,1,4,0,0,20,EL
65ad4d98,5,2,2,3,0,4,4,0,8,6,2,13,18,24,0,20,EL
65bbfba3,0,0,0,0,0,0,4,4,6,3,3,4,4,7,0,20,EL
6603fed7,7,3,2,3,2,1,5,4,4,1,3,0,7,5,0,20,EL
6622454d,1,1,1,0,0,0,2,2,0,0,0,2,3,1,0,20,EL
6639e500,9,4,2,6,1,6,10,4,0,0,0,2,11,0,0,20,EL
6747869d,1,1,0,1,0,0,2,2,2,0,2,0,1,1,0,20,EL
675b0427,9,6,8,0,1,6,8,2,10,7,3,9,18,27,1,20,EL
67f0703d,8,5,6,2,0,1,3,2,1,0,1,11,19,14,0,20,EL
6800f515,4,2,1,3,0,1,8,7,7,3,4,9,13,3,0,20,EL
685857dc,4,3,2,2,0,0,6,6,8,2,6,12,16,7,0,20,EL
68635c10,18,12,15,3,0,10,15,5,6,5,1,7,25,28,1,20,EL
686cbe7d,9,5,0,4,5,3,9,6,3,0,3,0,9,0,0,20,EL
689c9cf4,11,8,8,3,0,5,5,0,7,3,4,8,19,13,0,20,EL
68dc0dac,9,7,4,2,3,2,11,9,6,0,6,6,15,2,0,20,EL
691bef82,9,4,6,3,0,4,9,5,2,1,1,4,13,1,0,20,EL
6922f806,1,1,0,1,0,0,1,1,0,0,0,0,1,2,0,20,EL
6928979a,12,6,8,3,1,3,10,7,6,1,5,6,18,4,0,20,EL
69374ff5,1,1,1,0,0,1,6,5,3,0,3,4,5,1,0,20,EL
6956ff08,0,0,0,0,0,0,0,0,1,1,0,0,0,0,0,20,EL
6993fcc8,6,2,2,3,1,2,6,4,9,2,7,9,15,6,0,20,EL
69986380,0,0,0,0,0,0,0,0,0,0,0,0,0,0,0,20,EL
69cbc8b6,0,0,0,0,0,0,0,0,2,1,1,3,3,8,0,20,EL
6b08d120,0,0,0,0,0,0,0,0,0,0,0,0,0,0,0,20,EL
6b200d45,6,3,4,2,0,2,5,3,3,2,1,7,13,20,0,20,EL
6b6c793c,10,7,6,3,1,6,9,3,6,1,5,3,13,11,0,20,EL
6b6cbca4,1,0,1,0,0,1,1,0,5,3,2,1,2,4,0,20,EL
6b767188,1,1,0,1,0,1,5,4,2,0,2,4,5,0,0,20,EL
6b85f966,24,15,9,8,7,8,27,19,9,1,8,6,30,9,0,20,EL
6b915aa1,5,3,2,3,0,1,4,3,1,0,1,4,9,2,0,20,EL
6bd05d38,0,0,0,0,0,0,0,0,0,0,0,0,0,0,0,20,EL
6bd5cd5d,11,6,8,3,0,8,17,9,9,6,3,6,17,24,0,20,EL
6be41a31,0,0,0,0,0,0,1,1,1,0,1,0,0,0,0,20,EL
6bfaecc4,0,0,0,0,0,0,0,0,0,0,0,0,0,0,1,20,EL
6bfb4303,8,3,2,6,0,4,8,4,5,0,5,3,11,4,0,20,EL
6bff8a73,8,6,7,1,0,3,3,0,2,2,0,9,17,22,0,20,EL
6c8ddd52,7,3,5,2,0,5,6,1,4,0,4,5,12,5,0,20,EL
6cbf8d0d,1,0,0,0,1,0,0,0,2,0,2,2,3,0,0,20,EL
6dce77a5,7,4,3,3,1,0,9,9,2,0,2,7,14,14,0,20,EL
6e240751,1,1,1,0,0,0,1,1,0,0,0,0,1,0,3,20,EL
6e269dd3,3,2,1,1,1,1,7,6,6,0,6,1,4,2,0,20,EL
6ea23758,3,0,2,1,0,2,2,0,1,1,0,4,7,2,0,20,EL
6ec1ddf1,5,3,1,3,1,3,6,3,1,0,1,5,10,3,0,20,EL
6f1721f0,4,2,1,0,3,0,0,0,2,0,2,0,4,0,0,20,EL
6f4cf369,4,1,2,2,0,1,5,4,7,3,4,8,12,11,0,20,EL
6f8cd6d0,6,2,2,2,2,1,4,3,4,0,4,1,7,3,0,20,EL
6fd8a334,1,1,1,0,0,0,0,0,4,2,2,3,4,3,0,20,EL
6fdac234,2,2,2,0,0,0,4,4,4,2,2,1,3,0,0,20,EL
6fe5c35b,1,0,1,0,0,1,2,1,0,0,0,0,1,3,2,20,EL
6ff8ef56,2,0,0,2,0,0,1,1,3,0,3,5,7,2,0,20,EL
7091324a,0,0,0,0,0,0,0,0,1,0,1,1,1,0,0,20,EL
70c52749,17,8,11,6,0,7,14,7,5,1,4,6,23,12,0,20,EL
70cb75ae,4,3,1,3,0,3,8,5,0,0,0,2,6,1,0,20,EL
70cf63ca,1,0,0,1,0,1,4,3,1,0,1,1,2,1,0,20,EL
71115017,4,3,1,3,0,0,3,3,1,0,1,1,5,1,0,20,EL
7120a04d,1,1,0,1,0,1,6,5,2,0,2,1,2,0,0,20,EL
712dd708,14,9,7,5,2,11,19,8,7,1,6,16,30,23,0,20,EL
713c144a,5,4,2,3,0,5,11,6,3,2,1,4,9,3,0,20,EL
715e5b0e,2,2,0,1,1,0,0,0,1,0,1,1,3,1,0,20,EL
715fc0fe,10,6,6,4,0,2,6,4,6,1,5,1,11,1,0,20,EL
71d5ca31,5,4,2,3,0,2,3,1,4,4,0,2,7,16,0,20,EL
723ba189,0,0,0,0,0,0,1,1,0,0,0,0,0,0,0,20,EL
7272a72a,3,2,1,2,0,0,6,6,2,0,2,1,4,2,0,20,EL
73000a79,11,6,4,6,1,6,9,3,4,3,1,9,20,1,0,20,EL
7304f3b1,1,1,1,0,0,0,1,1,0,0,0,0,1,1,0,20,EL
731302dc,0,0,0,0,0,0,0,0,0,0,0,0,0,0,0,20,EL
733e7ad8,3,2,2,1,0,1,3,2,5,1,4,2,5,3,0,20,EL
7352dca8,8,6,1,5,2,3,7,4,4,0,4,5,13,4,0,20,EL
73683fa9,0,0,0,0,0,0,0,0,0,0,0,0,0,2,0,20,EL
740a0e28,10,2,8,1,1,2,4,2,4,2,2,5,15,9,0,20,EL
741275f5,0,0,0,0,0,0,0,0,0,0,0,0,0,0,0,20,EL
74223a01,8,4,6,2,0,2,4,2,5,3,2,14,22,17,0,20,EL
74288db0,2,1,2,0,0,1,1,0,0,0,0,0,2,0,0,20,EL
742a4995,6,4,3,2,1,2,7,5,2,1,1,4,10,4,1,20,EL
74419746,0,0,0,0,0,0,0,0,0,0,0,0,0,0,0,20,EL
746fec7d,0,0,0,0,0,0,0,0,0,0,0,0,0,0,0,20,EL
74733221,0,0,0,0,0,0,0,0,0,0,0,0,0,1,0,20,EL
7483d9f9,3,0,0,3,0,2,4,2,1,0,1,4,7,1,0,20,EL
74ced675,27,14,17,10,0,14,26,12,3,0,3,9,36,12,0,20,EL
74f2e748,1,0,0,1,0,0,3,3,0,0,0,0,1,1,0,20,EL
75229233,4,3,1,3,0,2,9,7,7,3,4,11,15,3,0,20,EL
754bc99d,8,2,5,2,1,5,12,7,6,2,4,1,9,19,0,20,EL
7586ae9b,1,1,0,1,0,0,0,0,0,0,0,1,2,2,0,20,EL
75b86fb3,5,3,4,1,0,5,6,1,4,3,1,5,10,12,0,20,EL
760be9fa,6,5,2,4,0,2,3,1,2,1,1,2,8,19,0,20,EL
762179d9,21,13,9,8,4,6,21,15,7,1,6,20,41,4,0,20,EL
76864df8,3,1,3,0,0,1,2,1,1,0,1,0,3,0,0,20,EL
768b28d0,8,4,3,5,0,2,9,7,0,0,0,5,13,8,0,20,EL
76c131da,1,0,0,0,1,1,1,0,0,0,0,1,2,0,0,20,EL
76ecfb22,10,8,5,4,1,5,9,4,7,2,5,8,18,9,0,20,EL
770ebf00,5,2,4,1,0,1,3,2,4,0,4,7,12,2,0,20,EL
7713c72a,1,1,0,1,0,1,1,0,2,1,1,0,1,5,0,20,EL
771d74d1,4,3,1,2,1,0,0,0,4,1,3,1,5,0,0,20,EL
77c9e37c,0,0,0,0,0,0,0,0,0,0,0,0,0,0,0,20,EL
77e39b04,6,4,2,2,2,3,7,4,6,0,6,3,9,7,0,20,EL
78a3c38e,0,0,0,0,0,0,3,3,1,1,0,2,2,8,0,20,EL
79019bf4,0,0,0,0,0,0,1,1,0,0,0,0,0,0,0,20,EL
79083382,2,2,2,0,0,1,1,0,3,2,1,3,5,2,0,20,EL
79135368,12,8,7,5,0,2,7,5,1,0,1,6,18,2,0,20,EL
791af558,4,3,3,0,1,1,1,0,1,0,1,2,6,0,0,20,EL
79370f8c,8,5,2,6,0,5,12,7,1,0,1,9,17,2,0,20,EL
7956236f,0,0,0,0,0,0,0,0,0,0,0,1,1,3,0,20,EL
79b0d6a0,0,0,0,0,0,0,0,0,0,0,0,1,1,0,1,20,EL
79c536d7,0,0,0,0,0,0,0,0,0,0,0,0,0,1,0,20,EL
7a20d90a,7,4,5,1,1,2,8,6,6,0,6,16,23,15,0,20,EL
7a2cf111,19,14,8,10,1,5,16,11,7,1,6,14,33,10,0,20,EL
7a412c2d,3,1,1,2,0,1,2,1,0,0,0,12,15,29,0,20,EL
7a47e204,1,0,0,0,1,1,4,3,3,1,2,0,1,4,0,20,EL
7a4cea18,2,0,2,0,0,0,7,7,1,0,1,1,3,2,0,20,EL
7afbd2c3,1,1,0,1,0,1,1,0,1,0,1,0,1,0,0,20,EL
7b456af7,0,0,0,0,0,0,0,0,0,0,0,0,0,1,0,20,EL
7b4c1f6e,0,0,0,0,0,0,0,0,1,0,1,0,0,0,0,20,EL
7b4de647,0,0,0,0,0,0,0,0,0,0,0,1,1,2,0,20,EL
7b57c56a,12,7,6,3,3,6,14,8,9,3,6,14,26,2,0,20,EL
7b5ab7f2,1,0,1,0,0,1,5,4,2,0,2,0,1,1,0,20,EL
7b8ff0ac,1,1,0,0,1,0,0,0,1,0,1,1,2,2,0,20,EL
7b9a86e6,4,4,3,0,1,2,3,1,2,0,2,2,6,0,0,20,EL
7b9a9e25,4,3,0,2,2,2,4,2,1,0,1,1,5,0,0,20,EL
7b9c2d84,10,4,5,3,2,5,9,4,2,0,2,3,13,1,0,20,EL
7ba2eaa9,1,0,0,1,0,0,4,4,3,0,3,3,4,0,0,20,EL
7ba6d84e,0,0,0,0,0,0,0,0,0,0,0,0,0,0,0,20,EL
7baff104,0,0,0,0,0,0,0,0,0,0,0,0,0,0,0,20,EL
7be09c86,1,1,0,1,0,0,1,1,0,0,0,2,3,1,0,20,EL
7c1a0c67,9,3,7,1,1,4,7,3,8,0,8,7,16,8,0,20,EL
7c2965bb,6,5,2,2,2,2,8,6,6,1,5,2,8,0,0,20,EL
7c9fa389,6,5,3,2,1,4,6,2,5,3,2,4,10,14,0,20,EL
7cd6badb,5,2,3,2,0,1,4,3,1,0,1,2,7,2,0,20,EL
7cd78926,29,15,19,6,4,13,24,11,7,3,4,23,52,21,0,20,EL
7cf431a5,2,0,2,0,0,1,3,2,1,1,0,2,4,3,0,20,EL
7cf8150a,0,0,0,0,0,0,0,0,0,0,0,1,1,0,0,20,EL
7d036b4a,2,1,1,1,0,2,3,1,7,0,7,5,7,3,0,20,EL
7d393a9f,2,1,1,1,0,1,1,0,3,3,0,11,13,34,0,20,EL
7dc7187e,1,0,1,0,0,0,0,0,1,1,0,3,4,5,0,20,EL
7e219e84,0,0,0,0,0,0,0,0,1,1,0,0,0,0,0,20,EL
7e56d3db,10,3,6,4,0,4,5,1,3,1,2,1,11,7,0,20,EL
7e74e0c2,4,4,4,0,0,1,3,2,0,0,0,0,4,2,0,20,EL
7e763ddc,2,2,1,1,0,1,2,1,1,0,1,4,6,3,0,20,EL
7e871b0a,6,2,5,1,0,2,4,2,8,6,2,10,16,19,0,20,EL
7e964a67,3,1,0,1,2,2,4,2,1,1,0,1,4,4,0,20,EL
7ec7738e,1,1,1,0,0,0,1,1,0,0,0,0,1,0,0,20,EL
7f5a2470,3,2,0,3,0,0,1,1,1,1,0,0,3,0,0,20,EL
7f622eef,2,1,1,1,0,1,1,0,2,0,2,1,3,2,0,20,EL
7fcc71d8,5,3,0,4,1,2,3,1,1,0,1,3,8,0,0,20,EL
7fd58fe3,2,1,1,0,1,2,4,2,0,0,0,2,4,5,0,20,EL
7ff93107,0,0,0,0,0,0,0,0,2,0,2,1,1,1,0,20,EL
8023bcab,21,13,12,6,3,13,31,18,18,2,16,8,29,4,0,20,EL
8104e41e,1,0,1,0,0,0,0,0,0,0,0,2,3,0,1,20,EL
810e3c74,8,5,2,4,2,2,5,3,4,0,4,1,9,1,0,20,EL
810e40c1,3,2,1,2,0,1,3,2,2,1,1,0,3,5,0,20,EL
81442ecb,16,10,12,4,0,4,7,3,10,1,9,5,21,12,0,20,EL
81b906e7,0,0,0,0,0,0,0,0,0,0,0,0,0,0,1,20,EL
82220b03,2,1,0,0,2,0,0,0,0,0,0,1,3,0,0,20,EL
824bd41a,7,5,6,1,0,6,6,0,8,5,3,4,11,13,0,20,EL
8267f8d4,2,2,1,0,1,2,3,1,2,0,2,1,3,2,0,20,EL
82b85f5a,0,0,0,0,0,0,1,1,2,1,1,0,0,0,0,20,EL
82e3586c,2,2,1,0,1,2,4,2,4,1,3,2,4,3,0,20,EL
82e9b89d,4,4,0,4,0,0,2,2,3,0,3,0,4,9,0,20,EL
82efe6fa,1,1,0,1,0,0,2,2,0,0,0,5,6,4,0,20,EL
83300259,20,12,12,8,0,11,18,7,6,0,6,11,31,16,0,20,EL
834d0be5,2,0,1,1,0,0,4,4,1,1,0,0,2,3,0,20,EL
83534f30,13,8,6,6,1,7,18,11,9,2,7,9,22,12,0,20,EL
839ef2b8,5,3,3,1,1,4,7,3,3,1,2,3,8,3,0,20,EL
83b9c48f,4,2,1,3,0,0,3,3,1,0,1,2,6,2,0,20,EL
83ce5ef1,9,7,4,5,0,5,7,2,4,1,3,1,10,11,0,20,EL
83d961d1,1,1,1,0,0,1,1,0,4,3,1,5,6,9,0,20,EL
8474cb83,10,5,6,4,0,9,14,5,3,1,2,5,15,5,0,20,EL
8494acc4,7,4,5,2,0,3,4,1,7,2,5,3,10,6,0,20,EL
852351df,1,1,1,0,0,1,4,3,1,0,1,1,2,3,0,20,EL
85322440,0,0,0,0,0,0,0,0,0,0,0,0,0,0,0,20,EL
853b7c48,0,0,0,0,0,0,1,1,0,0,0,1,1,3,0,20,EL
854a2041,6,3,3,3,0,1,5,4,2,1,1,4,10,0,0,20,EL
854f7734,5,3,4,0,1,2,7,5,3,1,2,1,6,11,0,20,EL
8558593d,15,11,11,4,0,6,29,23,5,1,4,17,32,6,0,20,EL
85733f33,0,0,0,0,0,0,1,1,0,0,0,0,0,1,0,20,EL
8577e60a,2,1,1,1,0,0,0,0,3,1,2,1,3,0,0,20,EL
85c25f57,0,0,0,0,0,0,0,0,0,0,0,0,0,3,0,20,EL
86168d75,2,1,0,1,1,2,2,0,0,0,0,0,2,2,0,20,EL
862fa9fb,1,1,1,0,0,0,3,3,2,2,0,2,3,7,0,20,EL
8637e09a,0,0,0,0,0,0,0,0,1,0,1,1,1,2,0,20,EL
867239d3,6,4,3,2,1,2,4,2,2,1,1,4,10,1,0,20,EL
86878265,6,6,1,4,1,2,3,1,3,0,3,1,7,3,0,20,EL
8696bc90,13,9,5,4,4,2,10,8,2,0,2,2,15,0,0,20,EL
86e119e0,25,12,10,13,2,11,28,17,2,0,2,5,30,9,0,20,EL
8754c7ca,6,3,3,2,1,4,10,6,7,2,5,5,11,6,2,20,EL
878f0921,1,0,0,0,1,0,3,3,4,0,4,2,3,5,0,20,EL
87d8b5a3,14,10,9,4,1,5,13,8,3,0,3,2,16,3,0,20,EL
881cd6be,10,5,3,7,0,3,6,3,0,0,0,5,15,0,1,20,EL
881ef58c,5,4,3,1,1,2,6,4,3,0,3,1,6,1,0,20,EL
883f251e,1,0,0,0,1,0,1,1,6,3,3,0,1,7,0,20,EL
884a8908,3,2,0,0,3,1,4,3,3,0,3,2,5,3,0,20,EL
886f9aac,1,1,0,1,0,1,2,1,1,0,1,1,2,0,0,20,EL
8870154f,0,0,0,0,0,0,0,0,0,0,0,0,0,0,0,20,EL
88b748d2,0,0,0,0,0,0,1,1,1,0,1,0,0,3,0,20,EL
88c89891,5,4,3,2,0,4,5,1,4,0,4,8,13,9,0,20,EL
8a1d7b51,10,3,6,2,2,6,8,2,4,1,3,12,22,12,1,20,EL
8b0b02c9,2,1,1,1,0,1,3,2,1,0,1,1,3,2,0,20,EL
8b298f56,8,3,4,2,2,1,4,3,2,0,2,8,16,3,0,20,EL
8b3ab7ad,3,3,3,0,0,2,3,1,1,0,1,0,3,1,0,20,EL
8b529245,1,1,0,1,0,1,1,0,0,0,0,0,1,0,0,20,EL
8b683d09,2,1,0,1,1,1,5,4,0,0,0,1,3,3,0,20,EL
8b788c01,1,1,0,0,1,0,4,4,0,0,0,0,1,2,0,20,EL
8bbf17da,1,1,1,0,0,1,3,2,3,2,1,8,9,18,0,20,EL
8bc373ea,3,3,3,0,0,2,2,0,1,1,0,3,6,16,0,20,EL
8c5f1522,0,0,0,0,0,0,0,0,1,0,1,0,0,0,0,20,EL
8c6239f2,4,1,2,2,0,2,4,2,10,8,2,6,10,22,0,20,EL
8ce30c57,2,1,0,2,0,1,1,0,0,0,0,1,3,0,0,20,EL
8cfc2f69,10,7,1,7,2,2,5,3,2,0,2,1,11,4,0,20,EL
8d67689d,2,0,2,0,0,1,2,1,1,0,1,0,2,0,0,20,EL
8d957256,0,0,0,0,0,0,0,0,0,0,0,0,0,4,2,20,EL
8e010ff4,7,4,1,4,2,3,11,8,1,0,1,1,8,0,0,20,EL
8e16dd48,4,4,3,1,0,3,9,6,3,1,2,2,6,8,0,20,EL
8e3e66a0,5,4,1,3,1,0,4,4,2,1,1,4,9,3,0,20,EL
8e58987d,11,4,5,6,0,5,12,7,5,1,4,6,17,1,0,20,EL
8ed17872,11,8,5,5,1,5,19,14,5,0,5,6,17,9,1,20,EL
8ee95cc6,1,1,0,0,1,0,0,0,1,0,1,0,1,0,0,20,EL
8f056768,12,10,2,8,2,4,15,11,5,0,5,1,13,0,0,20,EL
8f7e6783,4,1,2,2,0,2,10,8,4,0,4,3,7,3,0,20,EL
8f8c6934,0,0,0,0,0,0,0,0,0,0,0,0,0,3,0,20,EL
8fb2cd60,2,1,1,0,1,0,0,0,1,1,0,1,3,10,0,20,EL
8fd9996f,8,5,3,4,1,3,6,3,4,1,3,6,14,6,0,20,EL
8ff4872e,0,0,0,0,0,0,0,0,0,0,0,2,2,1,0,20,EL
9001138b,3,3,1,2,0,1,1,0,2,1,1,1,4,0,0,20,EL
9038c2a1,6,5,1,3,2,4,6,2,1,0,1,0,6,0,0,20,EL
903b3b77,5,2,3,2,0,3,7,4,1,0,1,10,15,12,0,20,EL
903b6e8b,0,0,0,0,0,0,0,0,0,0,0,0,0,2,0,20,EL
908eea67,10,7,2,8,0,6,11,5,4,0,4,18,28,34,0,20,EL
90f3beec,17,8,11,5,1,6,17,11,16,3,13,19,36,20,0,20,EL
911680d8,0,0,0,0,0,0,0,0,0,0,0,0,0,0,0,20,EL
9139bb12,4,1,1,2,1,1,6,5,2,0,2,1,5,0,0,20,EL
91538ba3,8,6,7,0,1,3,7,4,1,1,0,13,21,9,1,20,EL
91748070,1,1,1,0,0,1,1,0,0,0,0,1,2,0,0,20,EL
91976866,3,2,2,0,1,0,0,0,1,0,1,0,3,0,0,20,EL
91b43c98,1,1,1,0,0,0,1,1,3,2,1,2,3,1,0,20,EL
92232aad,10,7,4,2,4,4,6,2,2,0,2,9,19,12,0,20,EL
92ffb8f9,2,2,1,0,1,0,1,1,0,0,0,0,2,1,0,20,EL
934e1968,0,0,0,0,0,0,2,2,1,0,1,0,0,2,0,20,EL
93b891d1,0,0,0,0,0,0,3,3,1,0,1,0,0,4,0,20,EL
94130fc4,3,3,1,0,2,1,3,2,3,1,2,0,3,5,0,20,EL
947e036f,5,2,0,4,1,0,5,5,4,0,4,3,8,0,0,20,EL
94b3ccdb,0,0,0,0,0,0,0,0,0,0,0,1,1,0,0,20,EL
94d260aa,0,0,0,0,0,0,0,0,3,3,0,1,1,3,0,20,EL
951f1739,6,4,3,2,1,3,9,6,2,0,2,4,10,1,0,20,EL
953597a1,7,4,5,2,0,3,4,1,5,4,1,8,15,18,0,20,EL
95efdac2,5,2,1,4,0,2,5,3,0,0,0,4,9,1,0,20,EL
96094cbc,2,2,1,0,1,0,3,3,5,0,5,1,3,0,0,20,EL
962e54cb,4,3,1,1,2,3,10,7,7,0,7,2,6,3,0,20,EL
966eea58,4,3,4,0,0,1,7,6,0,0,0,4,8,4,0,20,EL
96cf436e,7,3,5,2,0,3,6,3,9,3,6,7,14,16,0,20,EL
96ddfa79,8,3,1,5,2,2,6,4,4,0,4,3,11,0,1,20,EL
972aeb2a,2,0,0,0,2,1,1,0,2,0,2,4,6,1,0,20,EL
97572117,7,4,3,4,0,1,4,3,4,0,4,8,15,19,0,20,EL
9763a91c,10,9,2,7,1,2,2,0,5,0,5,3,13,1,0,20,EL
9778d8dd,2,1,1,1,0,2,5,3,1,0,1,1,3,0,0,20,EL
977ffc24,1,0,0,0,1,0,2,2,1,0,1,0,1,0,0,20,EL
97810d55,13,10,10,3,0,8,12,4,5,4,1,4,17,28,0,20,EL
980522ec,7,1,2,4,1,3,9,6,2,0,2,3,10,2,0,20,EL
984b3198,2,1,0,1,1,0,0,0,1,0,1,0,2,0,0,20,EL
98554bfd,1,0,0,1,0,1,1,0,0,0,0,4,5,2,0,20,EL
98a84572,0,0,0,0,0,0,1,1,0,0,0,0,0,0,0,20,EL
98b94ef4,0,0,0,0,0,0,0,0,0,0,0,0,0,0,0,20,EL
9907b1c8,10,3,1,9,0,3,12,9,6,0,6,2,12,0,0,20,EL
9993817f,0,0,0,0,0,0,0,0,0,0,0,1,1,0,0,20,EL
9a28eba4,8,7,2,5,1,4,5,1,3,1,2,1,9,4,0,20,EL
9ab16552,14,10,10,4,0,11,15,4,11,5,6,6,20,22,0,20,EL
9b6d9b53,10,8,8,2,0,6,9,3,2,1,1,11,21,16,0,20,EL
9bd3b683,0,0,0,0,0,0,0,0,0,0,0,0,0,0,0,20,EL
9bd73cce,0,0,0,0,0,0,2,2,0,0,0,0,0,0,0,20,EL
9bf914b4,10,5,2,6,2,4,9,5,3,0,3,1,11,1,0,20,EL
9c0a65df,3,1,0,2,1,0,3,3,1,0,1,2,5,1,0,20,EL
9c2b4382,3,2,0,2,1,1,2,1,1,0,1,2,5,1,0,20,EL
9c824717,1,0,0,0,1,0,3,3,0,0,0,0,1,6,0,20,EL
9c94165b,7,1,3,3,1,4,5,1,5,1,4,4,11,6,0,20,EL
9d21da85,21,13,15,6,0,10,24,14,17,3,14,19,40,33,0,20,EL
9d60028d,4,3,1,2,1,2,3,1,1,0,1,2,6,1,0,20,EL
9d689a5b,7,4,4,2,1,2,11,9,0,0,0,0,7,4,0,20,EL
9d7d5334,3,2,3,0,0,2,4,2,5,3,2,7,10,9,0,20,EL
9d971f13,4,2,1,2,1,2,6,4,5,1,4,5,9,6,0,20,EL
9dab6e3b,0,0,0,0,0,0,0,0,0,0,0,0,0,0,0,20,EL
9daeac61,1,0,0,1,0,1,1,0,3,2,1,1,2,4,0,20,EL
9dbb75ca,5,3,1,1,3,0,4,4,5,1,4,1,6,4,0,20,EL
9ddb85e8,3,2,2,1,0,2,7,5,0,0,0,0,3,2,0,20,EL
9e1577aa,4,2,0,1,3,2,2,0,2,0,2,2,6,4,0,20,EL
9e49c320,2,2,0,1,1,0,0,0,0,0,0,1,3,1,1,20,EL
9e525177,15,11,10,4,1,3,6,3,7,2,5,10,25,9,0,20,EL
9ef884b1,1,0,0,1,0,1,1,0,1,0,1,0,1,0,0,20,EL
9f84febe,4,4,1,3,0,1,2,1,1,1,0,2,6,5,0,20,EL
9f9c57f0,0,0,0,0,0,0,0,0,0,0,0,0,0,0,0,20,EL
9fa26bc2,1,1,1,0,0,1,1,0,0,0,0,0,1,0,0,20,EL
9fb640a8,10,6,6,4,0,7,18,11,7,2,5,8,18,9,1,20,EL
9fbbcf39,7,4,6,1,0,3,9,6,7,4,3,17,24,24,0,20,EL
9fc2531b,0,0,0,0,0,0,0,0,1,0,1,0,0,0,0,20,EL
9ffdf29a,0,0,0,0,0,0,0,0,1,0,1,0,0,0,0,20,EL
a0313275,12,8,8,4,0,7,10,3,3,0,3,8,20,4,1,20,EL
a04e2dd2,0,0,0,0,0,0,0,0,0,0,0,0,0,1,0,20,EL
a08b974a,4,1,2,1,1,3,14,11,7,0,7,1,5,3,0,20,EL
a0b730dc,7,4,0,4,3,2,5,3,5,0,5,1,8,2,0,20,EL
a0e9a73d,12,5,2,8,2,6,13,7,8,2,6,4,16,7,0,20,EL
a0f9b535,7,4,4,1,2,5,11,6,3,0,3,4,11,0,0,20,EL
a1232f4e,3,1,3,0,0,3,5,2,6,3,3,6,9,16,0,20,EL
a1c5b23e,5,3,3,1,1,2,2,0,1,0,1,1,6,3,0,20,EL
a1d5bd30,2,2,1,1,0,1,5,4,8,1,7,1,3,0,0,20,EL
a2560346,2,0,0,2,0,1,3,2,2,1,1,0,2,0,0,20,EL
a2609621,6,5,5,1,0,3,8,5,4,2,2,3,9,13,0,20,EL
a26fb8aa,13,8,6,5,2,6,15,9,10,4,6,16,29,14,1,20,EL
a274dccb,0,0,0,0,0,0,0,0,0,0,0,1,1,1,0,20,EL
a29b1131,1,1,0,1,0,0,4,4,0,0,0,0,1,0,0,20,EL
a2da58b1,3,2,3,0,0,3,3,0,1,0,1,1,4,0,0,20,EL
a372a9f2,11,5,6,5,0,3,8,5,5,0,5,5,16,7,0,20,EL
a3b03921,18,10,9,7,2,7,17,10,6,2,4,6,24,2,1,20,EL
a40d5a0c,4,3,2,2,0,0,3,3,3,1,2,1,5,0,0,20,EL
a45eac1f,1,0,0,1,0,1,1,0,1,0,1,0,1,1,0,20,EL
a47e7ecd,15,9,9,5,1,5,12,7,6,4,2,12,27,9,0,20,EL
a4851d9e,3,2,2,0,1,1,2,1,2,1,1,4,7,6,0,20,EL
a489c26e,5,4,5,0,0,3,7,4,2,1,1,5,10,1,0,20,EL
a4971d84,7,2,3,4,0,3,7,4,5,2,3,17,24,21,2,20,EL
a4ac4b8f,10,5,8,2,0,4,10,6,7,2,5,12,22,29,0,20,EL
a4b1028a,10,6,8,0,2,6,8,2,2,0,2,1,11,17,0,20,EL
a4e16ab4,0,0,0,0,0,0,2,2,2,0,2,0,0,0,0,20,EL
a4e428bf,6,3,4,2,0,0,4,4,3,1,2,3,9,7,0,20,EL
a4f642c5,6,3,3,1,2,2,9,7,2,0,2,2,8,1,0,20,EL
a4fe8cda,1,1,0,1,0,1,3,2,0,0,0,0,1,0,0,20,EL
a51a79a2,0,0,0,0,0,0,0,0,1,1,0,1,1,0,0,20,EL
a56bd2ee,0,0,0,0,0,0,0,0,0,0,0,0,0,2,0,20,EL
a62c16d0,5,2,3,1,1,1,6,5,5,0,5,2,7,8,0,20,EL
a63a995f,10,8,5,5,0,4,10,6,7,2,5,6,16,15,0,20,EL
a64b4786,6,5,6,0,0,2,4,2,5,5,0,5,11,25,0,20,EL
a685f013,3,2,1,2,0,0,1,1,1,1,0,8,11,7,0,20,EL
a6f6aad2,0,0,0,0,0,0,0,0,0,0,0,0,0,0,0,20,EL
a70b8345,0,0,0,0,0,0,0,0,0,0,0,0,0,0,0,20,EL
a73c8f95,21,13,17,4,0,11,17,6,14,9,5,22,43,44,2,20,EL
a78ff07f,15,9,8,5,2,8,17,9,16,3,13,9,24,13,0,20,EL
a81ed730,11,5,6,4,1,4,8,4,1,1,0,4,15,3,0,20,EL
a820e429,3,1,0,3,0,1,2,1,6,1,5,0,3,6,1,20,EL
a8741470,0,0,0,0,0,0,1,1,1,1,0,1,1,2,0,20,EL
a881d44a,0,0,0,0,0,0,0,0,0,0,0,0,0,0,0,20,EL
a8c0acb7,15,8,8,7,0,6,11,5,4,2,2,15,30,19,0,20,EL
a8c62306,3,3,0,0,3,0,1,1,0,0,0,1,4,0,0,20,EL
a8f21b9f,4,3,2,0,2,3,9,6,1,1,0,2,6,2,0,20,EL
a9142dc3,1,1,1,0,0,0,1,1,1,0,1,0,1,3,0,20,EL
aa04bee3,3,2,2,1,0,2,10,8,2,0,2,2,5,3,0,20,EL
aa5859cb,8,3,3,3,2,3,6,3,8,1,7,2,10,3,0,20,EL
aa6f2f2c,2,1,0,1,1,1,2,1,1,0,1,1,3,0,0,20,EL
aa8e289e,5,4,1,3,1,2,8,6,2,0,2,1,6,0,0,20,EL
aacdfe88,3,3,1,1,1,1,1,0,5,0,5,4,7,3,0,20,EL
ab096c6f,6,4,3,3,0,4,6,2,6,0,6,8,14,16,0,20,EL
ab6928f2,0,0,0,0,0,0,0,0,0,0,0,0,0,0,0,20,EL
abb3bb95,5,2,1,3,1,3,5,2,2,0,2,0,5,4,0,20,EL
ac290817,3,2,2,0,1,1,2,1,1,0,1,0,3,1,0,20,EL
ad3389d5,0,0,0,0,0,0,0,0,0,0,0,0,0,3,1,20,EL
ad4d0985,15,6,5,10,0,7,16,9,3,0,3,4,19,4,0,20,EL
ad556f81,0,0,0,0,0,0,0,0,0,0,0,0,0,0,0,20,EL
ad597bf7,0,0,0,0,0,0,1,1,1,0,1,0,0,1,0,20,EL
ad7b19ef,2,1,0,0,2,0,0,0,1,0,1,1,3,0,0,20,EL
ade993b9,6,2,2,3,1,4,19,15,5,0,5,1,7,9,0,20,EL
adfbe1f5,9,6,4,3,2,7,17,10,3,0,3,4,13,4,0,20,EL
aeda1f69,2,1,1,0,1,0,5,5,2,1,1,1,3,2,0,20,EL
aeed5c06,1,1,1,0,0,1,4,3,2,0,2,0,1,0,0,20,EL
aefd0c5b,0,0,0,0,0,0,2,2,1,1,0,1,1,1,0,20,EL
afbf187b,5,1,2,3,0,0,0,0,9,6,3,12,17,20,1,20,EL
b0616e3d,21,13,10,6,5,12,17,5,8,3,5,7,28,9,0,20,EL
b0a84aa7,0,0,0,0,0,0,0,0,0,0,0,0,0,0,0,20,EL
b0c12a65,12,8,6,5,1,3,18,15,5,1,4,2,14,0,0,20,EL
b0edd538,3,2,2,1,0,1,4,3,3,2,1,4,7,5,0,20,EL
b1062a37,4,4,4,0,0,2,5,3,9,6,3,4,8,26,0,20,EL
b12d5243,1,0,1,0,0,1,1,0,0,0,0,1,2,0,0,20,EL
b1313ec4,10,4,3,7,0,6,21,15,12,2,10,8,18,8,0,20,EL
b15780e3,0,0,0,0,0,0,0,0,0,0,0,0,0,0,1,20,EL
b1579026,3,3,2,1,0,2,4,2,13,10,3,9,12,40,0,20,EL
b182a240,0,0,0,0,0,0,1,1,1,0,1,0,0,0,0,20,EL
b1cd37e6,23,16,12,6,5,8,28,20,14,2,12,3,26,3,0,20,EL
b1f4086c,1,0,1,0,0,1,1,0,5,1,4,4,5,6,1,20,EL
b2d0ec1b,4,1,0,3,1,2,2,0,2,0,2,0,4,0,0,20,EL
b39a793e,2,2,0,0,2,0,2,2,1,0,1,0,2,1,0,20,EL
b39bf63f,1,1,1,0,0,1,2,1,0,0,0,2,3,3,0,20,EL
b3aed40d,5,1,0,5,0,5,5,0,0,0,0,1,6,4,0,20,EL
b3b310f0,0,0,0,0,0,0,1,1,2,0,2,0,0,2,0,20,EL
b3b7f5a6,0,0,0,0,0,0,0,0,0,0,0,0,0,1,0,20,EL
b3c14bff,2,1,0,1,1,1,2,1,1,0,1,0,2,5,0,20,EL
b3dc6eca,0,0,0,0,0,0,0,0,0,0,0,1,1,2,0,20,EL
b4a014b1,8,5,7,1,0,2,5,3,8,5,3,4,12,26,1,20,EL
b500b384,12,4,2,5,5,5,9,4,5,0,5,5,17,3,0,20,EL
b561db50,6,2,2,1,3,0,2,2,5,1,4,4,10,7,0,20,EL
b583aef5,1,1,1,0,0,1,1,0,0,0,0,1,2,4,0,20,EL
b5920350,5,4,0,3,2,3,6,3,4,2,2,1,6,5,0,20,EL
b5f7d10b,9,7,9,0,0,8,11,3,2,0,2,4,13,5,0,20,EL
b6047994,2,1,1,1,0,2,3,1,0,0,0,0,2,0,0,20,EL
b635c249,3,2,0,3,0,3,8,5,2,0,2,5,8,3,0,20,EL
b6580563,0,0,0,0,0,0,0,0,2,1,1,0,0,4,0,20,EL
b675e328,2,2,1,0,1,1,1,0,1,0,1,1,3,0,0,20,EL
b682dcf6,3,3,3,0,0,1,2,1,2,2,0,2,5,11,1,20,EL
b684a484,2,1,0,2,0,0,0,0,2,0,2,0,2,0,0,20,EL
b6867b96,1,0,1,0,0,1,3,2,0,0,0,0,1,2,0,20,EL
b686f4c0,3,1,3,0,0,1,10,9,5,0,5,4,7,3,0,20,EL
b69261a0,2,1,2,0,0,1,5,4,5,0,5,3,5,5,0,20,EL
b6964eb6,5,3,2,3,0,2,3,1,7,5,2,11,16,18,1,20,EL
b6cd4243,1,0,1,0,0,1,1,0,5,4,1,1,2,6,0,20,EL
b70bde8f,0,0,0,0,0,0,0,0,0,0,0,0,0,0,0,20,EL
b7de5bad,5,4,3,1,1,4,6,2,2,0,2,1,6,1,0,20,EL
b853e0ad,19,9,7,10,2,8,23,15,12,2,10,10,29,3,1,20,EL
b8798a46,0,0,0,0,0,0,0,0,0,0,0,0,0,3,0,20,EL
b8814868,7,5,1,5,1,2,4,2,2,1,1,3,10,2,0,20,EL
b8e740fb,1,1,0,1,0,0,4,4,0,0,0,0,1,0,0,20,EL
b937e490,12,6,7,4,1,5,12,7,7,0,7,14,26,21,0,20,EL
b956af7d,0,0,0,0,0,0,0,0,0,0,0,1,1,6,0,20,EL
b96b595c,9,5,4,3,2,5,6,1,7,3,4,14,23,20,1,20,EL
b997c3de,14,8,6,5,3,6,15,9,11,1,10,11,25,5,0,20,EL
ba3378a5,2,2,0,2,0,0,11,11,2,1,1,4,6,2,0,20,EL
ba3d3bea,6,2,3,1,2,2,6,4,1,0,1,3,9,4,0,20,EL
ba5004e1,5,4,3,2,0,3,10,7,2,0,2,5,10,3,0,20,EL
bab077a4,0,0,0,0,0,0,1,1,1,0,1,0,0,3,0,20,EL
bac46a10,3,2,2,1,0,1,4,3,2,2,0,3,6,10,0,20,EL
bad38a94,9,4,5,3,1,5,9,4,2,0,2,9,18,8,1,20,EL
bb08bce9,15,9,14,1,0,7,17,10,16,12,4,11,26,53,2,20,EL
bb19da7c,2,1,0,2,0,0,8,8,5,1,4,1,3,1,0,20,EL
bbddc31f,11,7,5,4,2,6,13,7,5,1,4,7,18,4,0,20,EL
bc6bd723,3,2,1,2,0,0,4,4,4,0,4,0,3,0,0,20,EL
bc6f5f06,3,3,3,0,0,1,3,2,1,0,1,4,7,14,0,20,EL
bc7dc64d,7,5,3,2,2,1,4,3,5,0,5,5,12,5,0,20,EL
bd142efb,7,5,3,4,0,2,2,0,4,3,1,5,12,11,0,20,EL
bd3e08b6,0,0,0,0,0,0,0,0,0,0,0,0,0,0,0,20,EL
bd46bd6d,3,1,1,1,1,1,4,3,2,0,2,1,4,0,0,20,EL
bd7d2e6d,8,4,6,1,1,3,6,3,2,2,0,2,10,12,0,20,EL
bdc74a8f,1,1,1,0,0,0,1,1,0,0,0,0,1,0,0,20,EL
bdc8912c,28,17,18,8,2,14,35,21,8,0,8,34,62,25,0,20,EL
bdf8165d,11,7,5,4,2,9,16,7,4,0,4,9,20,5,1,20,EL
be094834,0,0,0,0,0,0,0,0,0,0,0,0,0,0,0,20,EL
be2706c0,6,2,4,2,0,3,5,2,3,1,2,5,11,9,0,20,EL
be4e7e47,18,10,9,6,3,6,20,14,10,4,6,12,30,6,0,20,EL
be60b6f4,1,1,0,1,0,0,2,2,3,0,3,0,1,1,0,20,EL
be765073,14,10,6,5,3,6,16,10,13,6,7,5,19,31,0,20,EL
be927d03,4,4,1,2,1,2,2,0,5,1,4,9,13,11,0,20,EL
beb6c168,5,4,1,4,0,2,6,4,1,0,1,4,9,2,0,20,EL
bee0bab1,3,2,3,0,0,1,1,0,0,0,0,1,4,0,0,20,EL
bf309d24,10,8,4,6,0,1,3,2,2,0,2,9,19,2,0,20,EL
bfc5768b,1,1,1,0,0,0,3,3,0,0,0,0,1,0,0,20,EL
bfe272bd,8,6,3,4,1,2,10,8,7,2,5,8,16,2,0,20,EL
c01c66d9,9,6,5,4,0,6,8,2,8,7,1,7,16,16,2,20,EL
c0617e2b,5,2,1,3,1,1,11,10,2,0,2,6,11,2,1,20,EL
c082d484,3,2,2,1,0,1,2,1,3,2,1,2,5,0,0,20,EL
c089980e,0,0,0,0,0,0,0,0,1,0,1,0,0,4,1,20,EL
c0e27d1a,4,3,1,2,1,0,2,2,5,5,0,5,9,13,2,20,EL
c21da05c,1,1,1,0,0,0,0,0,1,1,0,1,2,5,0,20,EL
c2304da8,8,5,4,4,0,4,10,6,5,2,3,10,18,12,0,20,EL
c24544c7,1,1,1,0,0,0,1,1,2,2,0,1,2,0,0,20,EL
c27ae377,2,0,1,1,0,0,0,0,1,0,1,0,2,1,0,20,EL
c2a6033c,1,1,1,0,0,1,1,0,0,0,0,0,1,1,0,20,EL
c32e457e,5,4,5,0,0,3,6,3,4,1,3,4,9,14,1,20,EL
c3767acc,0,0,0,0,0,0,2,2,2,0,2,2,2,0,0,20,EL
c3e39f12,0,0,0,0,0,0,0,0,0,0,0,0,0,2,0,20,EL
c43e5e7e,6,3,2,2,2,2,9,7,4,0,4,1,7,4,0,20,EL
c44a1d58,5,1,1,3,1,2,8,6,2,1,1,4,9,2,0,20,EL
c45a34e7,2,0,1,1,0,1,4,3,7,0,7,4,6,3,0,20,EL
c492c9f0,1,1,0,0,1,1,3,2,0,0,0,2,3,2,0,20,EL
c4987edc,0,0,0,0,0,0,0,0,0,0,0,0,0,2,0,20,EL
c4e87b8b,7,5,1,4,2,2,4,2,4,2,2,2,9,6,0,20,EL
c50281a0,13,10,6,7,0,9,14,5,9,0,9,2,15,5,0,20,EL
c54ea7f0,9,4,3,4,2,1,4,3,7,3,4,6,15,2,0,20,EL
c5bdb6e3,2,2,0,1,1,0,0,0,0,0,0,1,3,0,0,20,EL
c5ea2dab,7,2,3,4,0,3,8,5,3,1,2,12,19,29,1,20,EL
c603ad6a,13,8,6,5,2,7,8,1,2,1,1,6,19,4,1,20,EL
c631f952,0,0,0,0,0,0,0,0,0,0,0,0,0,2,1,20,EL
c63f6e46,2,2,0,2,0,0,1,1,0,0,0,1,3,5,0,20,EL
c699e60c,2,1,0,2,0,2,2,0,2,1,1,0,2,0,0,20,EL
c6ac6579,0,0,0,0,0,0,0,0,1,0,1,0,0,0,0,20,EL
c7069d87,13,6,4,9,0,6,16,10,4,0,4,9,22,10,0,20,EL
c71e97ba,7,5,4,3,0,5,10,5,2,0,2,7,14,4,0,20,EL
c738a5ec,4,3,3,0,1,1,2,1,0,0,0,1,5,0,0,20,EL
c758cdaf,2,2,0,2,0,1,2,1,1,0,1,0,2,1,0,20,EL
c7842dab,18,7,8,8,2,6,11,5,4,2,2,3,21,9,1,20,EL
c83623e2,9,6,8,1,0,6,10,4,9,6,3,14,23,30,0,20,EL
c89e8aae,0,0,0,0,0,0,0,0,0,0,0,2,2,4,0,20,EL
c8a88acd,0,0,0,0,0,0,0,0,0,0,0,0,0,0,0,20,EL
c8c60119,9,8,5,3,1,2,9,7,4,0,4,6,15,4,0,20,EL
c8d7131c,7,4,5,1,1,5,7,2,5,0,5,8,15,5,0,20,EL
c904f3d5,3,0,2,1,0,3,4,1,0,0,0,3,6,1,0,20,EL
c906ce0f,6,3,6,0,0,3,5,2,4,0,4,7,13,22,0,20,EL
c90b2e8f,2,2,2,0,0,0,1,1,1,1,0,5,7,6,1,20,EL
c931d9f9,1,1,0,1,0,0,4,4,5,1,4,1,2,0,0,20,EL
c93a0fd3,14,9,7,7,0,5,13,8,7,0,7,9,23,0,0,20,EL
c952f633,10,3,5,5,0,4,7,3,4,0,4,6,16,4,0,20,EL
c9bdb329,5,3,1,4,0,3,5,2,0,0,0,1,6,2,0,20,EL
ca033449,11,9,7,4,0,8,10,2,7,3,4,10,21,23,0,20,EL
ca45605e,0,0,0,0,0,0,2,2,3,0,3,0,0,2,0,20,EL
ca607d59,6,6,2,3,1,1,3,2,1,0,1,0,6,0,0,20,EL
ca8fa0c0,0,0,0,0,0,0,2,2,0,0,0,0,0,1,0,20,EL
cac76a72,0,0,0,0,0,0,0,0,0,0,0,0,0,3,0,20,EL
cb641b9d,0,0,0,0,0,0,0,0,1,1,0,0,0,2,0,20,EL
cb7786d5,3,0,0,3,0,1,2,1,0,0,0,0,3,0,0,20,EL
cba16a46,0,0,0,0,0,0,0,0,0,0,0,0,0,0,0,20,EL
cc1a0c57,0,0,0,0,0,0,0,0,0,0,0,0,0,0,0,20,EL
cc55da2a,5,3,0,4,1,1,3,2,1,0,1,1,6,3,0,20,EL
cc89c822,0,0,0,0,0,0,1,1,0,0,0,0,0,1,0,20,EL
cc9256ef,0,0,0,0,0,0,0,0,1,0,1,0,0,0,0,20,EL
ccbf1b54,8,6,3,1,4,1,7,6,4,2,2,2,10,3,0,20,EL
ccc66d00,6,3,2,3,1,3,7,4,8,0,8,2,8,2,0,20,EL
ccd38335,0,0,0,0,0,0,0,0,2,0,2,0,0,0,0,20,EL
ccee698e,0,0,0,0,0,0,0,0,1,0,1,1,1,0,0,20,EL
cd0ecf81,4,2,0,3,1,4,5,1,2,0,2,0,4,1,0,20,EL
cd6a1a59,1,0,1,0,0,0,1,1,1,0,1,1,2,3,0,20,EL
cda08080,16,10,11,5,0,10,19,9,5,5,0,13,29,21,2,20,EL
cda49f68,3,2,0,1,2,2,3,1,2,0,2,0,3,1,0,20,EL
cda90ea8,4,3,3,0,1,4,9,5,8,1,7,2,6,2,0,20,EL
ce17b5eb,0,0,0,0,0,0,0,0,0,0,0,1,1,0,0,20,EL
ce30bfc8,3,0,2,1,0,2,3,1,3,2,1,2,5,3,0,20,EL
ce50fd99,11,9,3,6,2,4,11,7,11,0,11,2,13,0,0,20,EL
ce5a24b9,8,4,3,5,0,2,6,4,3,0,3,1,9,5,0,20,EL
ce82f116,3,1,0,3,0,1,10,9,3,0,3,2,5,0,0,20,EL
cea0df32,1,0,1,0,0,0,2,2,0,0,0,1,2,1,0,20,EL
cf15bbb1,23,16,9,12,2,6,18,12,9,2,7,6,29,11,0,20,EL
cf182add,6,3,4,2,0,2,6,4,4,3,1,7,13,9,1,20,EL
cf1c23d8,0,0,0,0,0,0,0,0,0,0,0,0,0,0,0,20,EL
cf623c78,3,2,0,2,1,2,4,2,1,0,1,1,4,1,0,20,EL
cfb6c9e5,1,1,0,1,0,0,0,0,0,0,0,1,2,5,0,20,EL
cfe6238d,3,2,1,1,1,0,0,0,3,0,3,0,3,7,0,20,EL
cff7dcb0,0,0,0,0,0,0,0,0,0,0,0,0,0,0,0,20,EL
d019d5db,1,0,0,1,0,0,1,1,1,0,1,0,1,0,0,20,EL
d01bbb6f,3,1,1,2,0,0,2,2,3,0,3,7,10,2,0,20,EL
d0d8dd44,7,4,6,1,0,6,6,0,2,2,0,7,14,6,0,20,EL
d0f72bf1,5,4,4,1,0,3,4,1,5,3,2,9,14,10,0,20,EL
d1117c6c,15,12,12,2,1,7,12,5,2,1,1,11,26,20,0,20,EL
d125f22f,1,1,0,1,0,0,1,1,2,0,2,0,1,0,0,20,EL
d14229f3,0,0,0,0,0,0,2,2,1,0,1,1,1,0,0,20,EL
d1675302,0,0,0,0,0,0,1,1,0,0,0,0,0,0,0,20,EL
d1992a3b,8,7,6,1,1,8,9,1,2,0,2,2,10,21,0,20,EL
d19ecb20,0,0,0,0,0,0,0,0,1,0,1,1,1,0,0,20,EL
d1d418f8,0,0,0,0,0,0,1,1,0,0,0,0,0,0,0,20,EL
d1f48bfc,7,4,4,3,0,3,9,6,3,0,3,2,9,2,0,20,EL
d1fea02e,5,3,4,1,0,2,4,2,12,8,4,12,17,24,1,20,EL
d2161bae,3,1,2,1,0,1,2,1,4,1,3,9,12,8,0,20,EL
d2800f47,9,4,3,6,0,2,10,8,5,1,4,6,15,3,0,20,EL
d2a802b8,6,2,2,2,2,2,4,2,3,1,2,4,10,4,0,20,EL
d2bf42ba,0,0,0,0,0,0,0,0,0,0,0,0,0,0,0,20,EL
d4133fa1,5,4,3,2,0,3,9,6,3,0,3,8,13,6,0,20,EL
d436eb94,0,0,0,0,0,0,0,0,0,0,0,0,0,0,0,20,EL
d4931a5a,0,0,0,0,0,0,1,1,0,0,0,0,0,0,0,20,EL
d494882e,2,0,2,0,0,0,2,2,2,0,2,5,7,4,0,20,EL
d49f80d7,3,1,1,2,0,1,3,2,5,2,3,1,4,19,1,20,EL
d4a2533d,7,6,2,1,4,4,16,12,5,0,5,3,10,1,0,20,EL
d4d0a9ad,16,10,7,7,2,8,23,15,6,1,5,6,22,5,0,20,EL
d5575935,3,2,1,1,1,1,4,3,2,0,2,1,4,0,1,20,EL
d557d734,19,12,10,9,0,7,11,4,5,0,5,15,34,18,0,20,EL
d5dd5f1f,6,4,2,2,2,1,2,1,4,0,4,2,8,2,0,20,EL
d61b3354,1,0,1,0,0,1,4,3,0,0,0,2,3,5,0,20,EL
d637fc22,2,1,0,2,0,0,1,1,0,0,0,2,4,5,0,20,EL
d68cb24c,8,6,4,2,2,2,14,12,4,1,3,4,12,2,0,20,EL
d790907f,1,0,1,0,0,0,0,0,0,0,0,0,1,1,0,20,EL
d79a8c87,1,1,0,0,1,1,3,2,4,4,0,2,3,7,0,20,EL
d807c7f6,1,1,0,1,0,1,1,0,3,2,1,1,2,5,0,20,EL
d82c6542,10,6,7,2,1,5,8,3,5,1,4,6,16,11,0,20,EL
d849ef0f,6,5,2,4,0,1,3,2,6,1,5,5,11,5,0,20,EL
d8931174,9,4,7,2,0,2,7,5,6,5,1,14,23,27,0,20,EL
d8c679be,7,3,3,4,0,2,8,6,4,1,3,0,7,3,1,20,EL
d8d25850,0,0,0,0,0,0,7,7,1,0,1,3,3,1,0,20,EL
d93c2511,9,5,6,3,0,2,9,7,6,3,3,11,20,5,0,20,EL
d94653be,6,3,3,3,0,1,10,9,6,1,5,0,6,4,0,20,EL
d9565625,4,3,2,2,0,1,4,3,2,1,1,6,10,9,0,20,EL
d97b252e,0,0,0,0,0,0,0,0,0,0,0,0,0,1,0,20,EL
d97cccc9,17,7,6,10,1,9,16,7,14,2,12,19,36,10,0,20,EL
d9a5d930,2,2,0,2,0,2,4,2,0,0,0,0,2,0,1,20,EL
d9b89391,2,2,1,1,0,1,7,6,5,1,4,3,5,2,0,20,EL
d9d43555,0,0,0,0,0,0,1,1,0,0,0,0,0,0,0,20,EL
da1185fc,3,2,0,1,2,2,14,12,8,1,7,8,11,4,0,20,EL
da23d58d,3,2,1,2,0,0,2,2,2,0,2,0,3,0,0,20,EL
da27e268,3,1,1,2,0,3,8,5,2,0,2,3,6,4,0,20,EL
da617483,1,0,1,0,0,1,1,0,6,5,1,6,7,20,0,20,EL
da6cb94b,8,5,4,3,1,4,8,4,3,2,1,13,21,20,1,20,EL
da8b19e2,0,0,0,0,0,0,0,0,0,0,0,0,0,0,0,20,EL
db265666,2,2,1,1,0,1,4,3,1,0,1,0,2,1,1,20,EL
db2e8273,0,0,0,0,0,0,0,0,0,0,0,0,0,0,0,20,EL
db401046,0,0,0,0,0,0,1,1,0,0,0,0,0,2,0,20,EL
db74c6d3,6,1,3,3,0,2,2,0,2,2,0,4,10,6,0,20,EL
db7849ca,1,1,1,0,0,1,1,0,0,0,0,1,2,3,0,20,EL
dba67bc4,3,2,1,2,0,2,2,0,1,0,1,6,9,0,0,20,EL
dbbf4a56,0,0,0,0,0,0,0,0,0,0,0,0,0,0,0,20,EL
dbe16ade,0,0,0,0,0,0,0,0,1,0,1,0,0,0,0,20,EL
dbf3e08b,9,7,7,2,0,5,11,6,10,4,6,10,19,21,0,20,EL
dc415e39,13,10,5,5,3,1,9,8,7,1,6,8,21,1,0,20,EL
dc52c72f,4,3,1,3,0,0,2,2,9,4,5,3,7,4,0,20,EL
dc6f5bdd,5,3,2,3,0,2,3,1,4,3,1,6,11,4,0,20,EL
dc90cfbe,3,3,0,3,0,1,1,0,1,1,0,1,4,0,0,20,EL
dd0daf32,7,6,1,3,3,0,12,12,2,0,2,3,10,1,0,20,EL
dd669209,10,4,4,5,1,5,15,10,7,1,6,8,18,6,0,20,EL
deb20131,9,8,6,3,0,5,10,5,4,1,3,3,12,5,0,20,EL
deba6b05,12,6,2,10,0,5,27,22,15,1,14,7,19,9,0,20,EL
def899bd,4,3,2,2,0,2,2,0,1,1,0,2,6,12,0,20,EL
defb905a,10,7,9,1,0,6,13,7,9,8,1,12,22,36,0,20,EL
dfb6490a,6,2,1,3,2,2,4,2,1,0,1,1,7,2,0,20,EL
dff19848,0,0,0,0,0,0,1,1,0,0,0,1,1,0,0,20,EL
e09436fb,3,1,2,0,1,2,2,0,2,1,1,3,6,3,0,20,EL
e0991c04,1,1,0,1,0,1,5,4,4,1,3,5,6,16,0,20,EL
e0a1c004,4,1,1,2,1,1,10,9,7,4,3,6,10,9,0,20,EL
e0d3e18d,5,1,2,3,0,2,7,5,2,0,2,7,12,4,0,20,EL
e0f613ad,8,3,5,2,1,6,9,3,9,3,6,4,12,3,0,20,EL
e12b0b5b,24,15,8,11,5,11,29,18,10,1,9,11,35,5,1,20,EL
e12d7851,3,2,1,2,0,2,4,2,6,3,3,2,5,23,1,20,EL
e150254d,2,2,1,0,1,1,4,3,0,0,0,0,2,1,0,20,EL
e1ba3d5a,10,6,3,4,3,3,13,10,11,0,11,3,13,2,0,20,EL
e1deea75,0,0,0,0,0,0,1,1,1,1,0,3,3,3,0,20,EL
e248e62f,3,1,2,1,0,1,3,2,3,0,3,0,3,1,0,20,EL
e2781082,16,10,11,5,0,7,15,8,11,1,10,22,38,8,0,20,EL
e27da244,7,5,4,2,1,5,8,3,4,1,3,9,16,17,1,20,EL
e27fdbca,5,1,5,0,0,3,8,5,5,0,5,3,8,6,0,20,EL
e28205f4,3,0,1,1,1,2,6,4,1,0,1,1,4,1,0,20,EL
e28868f3,12,7,3,8,1,9,13,4,6,1,5,11,23,1,0,20,EL
e288d4b3,3,2,2,1,0,2,2,0,2,1,1,2,5,2,0,20,EL
e2bf2abc,1,0,0,0,1,1,1,0,2,1,1,0,1,1,0,20,EL
e2f9bb5f,11,9,5,6,0,2,5,3,4,0,4,3,14,2,0,20,EL
e34e086c,3,1,2,0,1,1,2,1,2,1,1,1,4,0,0,20,EL
e38f1636,5,3,2,3,0,1,4,3,9,8,1,5,10,17,0,20,EL
e3a5814e,8,2,6,2,0,6,11,5,4,0,4,5,13,4,2,20,EL
e3fabb0a,5,4,2,1,2,1,6,5,4,0,4,1,6,2,0,20,EL
e410ade0,8,4,4,2,2,6,17,11,2,0,2,4,12,1,0,20,EL
e4538d74,2,1,0,1,1,0,0,0,1,0,1,1,3,6,0,20,EL
e4738e91,0,0,0,0,0,0,0,0,0,0,0,0,0,1,0,20,EL
e4b72e34,2,0,0,1,1,0,1,1,0,0,0,0,2,1,0,20,EL
e53b5534,9,5,8,1,0,6,9,3,11,8,3,11,20,61,1,20,EL
e54a9890,2,0,1,0,1,1,2,1,4,3,1,3,5,9,0,20,EL
e5f63987,0,0,0,0,0,0,1,1,1,1,0,1,1,4,0,20,EL
e613313c,2,1,2,0,0,1,1,0,1,0,1,0,2,4,0,20,EL
e61b8aee,9,6,7,2,0,4,8,4,4,1,3,2,11,12,0,20,EL
e61d33f1,4,2,0,4,0,0,2,2,6,0,6,3,7,2,0,20,EL
e65a7469,6,5,3,2,1,1,4,3,0,0,0,0,6,1,0,20,EL
e6697917,0,0,0,0,0,0,1,1,0,0,0,0,0,1,0,20,EL
e66e4ddc,10,6,5,5,0,6,13,7,3,1,2,4,14,17,2,20,EL
e6aaca37,2,1,0,1,1,0,1,1,0,0,0,0,2,5,0,20,EL
e6c43eec,11,6,5,5,1,7,11,4,1,0,1,12,23,12,1,20,EL
e6dda1c7,3,3,2,1,0,2,5,3,7,7,0,3,6,21,1,20,EL
e726e11e,3,1,2,1,0,2,5,3,2,0,2,5,8,4,0,20,EL
e73659d3,10,5,4,4,2,5,13,8,6,1,5,2,12,2,0,20,EL
e73c9bb2,18,11,9,8,1,10,18,8,7,3,4,12,30,12,0,20,EL
e76cb9cc,9,5,8,1,0,7,8,1,7,4,3,7,16,13,0,20,EL
e7aa9d7c,0,0,0,0,0,0,0,0,0,0,0,0,0,0,0,20,EL
e7fcf289,0,0,0,0,0,0,2,2,0,0,0,1,1,0,0,20,EL
e8029b54,3,3,2,1,0,0,2,2,1,1,0,4,7,4,0,20,EL
e81f0356,8,5,7,1,0,6,8,2,2,2,0,5,13,8,1,20,EL
e82adcab,6,5,2,4,0,4,8,4,4,0,4,1,7,0,0,20,EL
e92cd3f7,3,3,1,1,1,2,4,2,1,0,1,0,3,5,0,20,EL
e9457fb9,1,1,1,0,0,1,7,6,0,0,0,0,1,1,0,20,EL
e961d3ac,0,0,0,0,0,0,0,0,0,0,0,0,0,0,0,20,EL
e97150c0,2,1,1,1,0,0,2,2,3,2,1,1,3,6,0,20,EL
e98d18ca,0,0,0,0,0,0,1,1,1,0,1,0,0,0,0,20,EL
e9c0c1b2,0,0,0,0,0,0,0,0,0,0,0,0,0,0,0,20,EL
ea610f00,11,7,5,4,2,3,11,8,4,1,3,5,16,1,0,20,EL
ea7a8366,7,7,4,3,0,2,5,3,3,1,2,9,16,8,0,20,EL
eab957a3,4,1,2,2,0,2,5,3,2,1,1,5,9,4,0,20,EL
eac044ad,5,2,2,0,3,4,8,4,3,0,3,0,5,2,0,20,EL
ead14875,21,14,10,9,2,11,20,9,3,1,2,6,27,6,0,20,EL
ead960f2,5,4,1,3,1,3,7,4,4,1,3,1,6,2,0,20,EL
eada676e,14,6,8,5,1,5,12,7,2,0,2,11,25,9,0,20,EL
eaf645bf,0,0,0,0,0,0,0,0,0,0,0,0,0,0,0,20,EL
eb1451a5,0,0,0,0,0,0,0,0,1,0,1,0,0,0,0,20,EL
eb2b33aa,0,0,0,0,0,0,0,0,0,0,0,0,0,0,1,20,EL
eb3f56e5,5,3,4,1,0,3,7,4,3,2,1,4,9,11,0,20,EL
eb6e14be,0,0,0,0,0,0,0,0,0,0,0,0,0,0,0,20,EL
eb7822d7,7,4,0,7,0,3,8,5,3,1,2,6,13,7,0,20,EL
ebca82e8,12,5,7,5,0,5,8,3,10,6,4,19,31,35,0,20,EL
ebca86ca,0,0,0,0,0,0,0,0,0,0,0,0,0,0,0,20,EL
ec30b9c8,2,1,1,1,0,0,4,4,4,3,1,2,4,7,0,20,EL
ec48abb1,2,0,1,1,0,1,1,0,0,0,0,2,4,5,0,20,EL
ec531cdc,3,3,2,1,0,2,3,1,1,0,1,2,5,2,0,20,EL
ecb68eea,7,3,1,4,2,3,6,3,4,2,2,2,9,2,0,20,EL
ecc10d95,2,2,0,1,1,0,3,3,6,0,6,2,4,1,0,20,EL
ed16a617,24,16,13,6,5,9,28,19,8,1,7,6,30,10,0,20,EL
ed5886d2,10,7,6,3,1,5,15,10,8,2,6,6,16,16,0,20,EL
eda40760,5,4,2,3,0,0,4,4,4,1,3,5,10,7,0,20,EL
edd81e2a,0,0,0,0,0,0,0,0,0,0,0,0,0,1,0,20,EL
ee0da7af,6,6,3,3,0,4,7,3,3,0,3,1,7,2,0,20,EL
ee3519f5,10,5,4,6,0,5,12,7,3,0,3,7,17,18,2,20,EL
ee37317d,0,0,0,0,0,0,0,0,0,0,0,1,0,0,0,20,EL
ee47f156,11,9,8,3,0,7,11,4,7,1,6,13,24,11,1,20,EL
eee84d49,0,0,0,0,0,0,0,0,0,0,0,0,0,1,0,20,EL
eef95b11,10,4,7,2,1,5,10,5,5,4,1,11,21,15,0,20,EL
ef3909cd,1,0,1,0,0,1,1,0,0,0,0,0,1,3,0,20,EL
ef88f778,11,8,2,6,3,3,13,10,3,1,2,1,12,3,0,20,EL
ef8f266e,0,0,0,0,0,0,4,4,0,0,0,0,0,0,0,20,EL
efc13588,24,12,6,15,3,14,37,23,8,2,6,13,37,6,0,20,EL
efc33b33,3,2,2,1,0,1,1,0,8,5,3,8,11,23,0,20,EL
f034613c,2,0,2,0,0,1,4,3,1,0,1,1,3,0,0,20,EL
f03f284b,6,6,3,1,2,2,4,2,2,2,0,4,10,6,0,20,EL
f0661424,1,1,0,1,0,1,2,1,1,0,1,1,2,7,0,20,EL
f0e3b343,4,2,1,1,2,1,1,0,3,1,2,0,4,4,0,20,EL
f11a5b76,10,5,6,3,1,7,13,6,9,3,6,9,19,23,0,20,EL
f11fe861,5,3,3,2,0,2,3,1,4,2,2,5,10,14,0,20,EL
f15b778f,45,30,18,21,6,19,36,17,24,5,19,24,69,11,1,20,EL
f15f8b2b,6,4,1,2,3,0,7,7,2,1,1,2,8,1,0,20,EL
f1b55719,0,0,0,0,0,0,0,0,0,0,0,0,0,0,0,20,EL
f1e8372d,0,0,0,0,0,0,0,0,0,0,0,0,0,0,0,20,EL
f209b81e,1,0,0,0,1,1,1,0,1,0,1,0,1,0,0,20,EL
f294b8cc,5,5,3,2,0,3,7,4,2,1,1,3,8,1,0,20,EL
f2eaebe9,0,0,0,0,0,0,1,1,2,2,0,0,0,0,0,20,EL
f30a4ab1,1,0,1,0,0,1,2,1,2,0,2,0,1,2,0,20,EL
f315ca93,17,11,9,7,1,9,17,8,2,2,0,10,27,9,0,20,EL
f323d995,17,8,10,7,0,8,13,5,10,6,4,12,29,54,0,20,EL
f352799f,0,0,0,0,0,0,0,0,0,0,0,0,0,0,1,20,EL
f3722c97,1,1,0,1,0,1,1,0,2,1,1,0,1,0,0,20,EL
f3a97d02,1,1,1,0,0,0,0,0,0,0,0,0,1,4,1,20,EL
f4021366,7,2,6,1,0,3,9,6,9,5,4,8,15,20,0,20,EL
f42e9f3f,0,0,0,0,0,0,0,0,1,0,1,0,0,1,0,20,EL
f4b1e26f,4,3,1,3,0,2,7,5,2,0,2,3,7,0,0,20,EL
f4d8ce5a,3,2,0,3,0,1,1,0,2,0,2,4,7,1,0,20,EL
f512a009,10,8,1,4,5,4,11,7,2,0,2,2,12,1,0,20,EL
f521b80a,4,1,4,0,0,2,2,0,3,2,1,5,9,10,0,20,EL
f533776b,4,3,4,0,0,3,6,3,2,1,1,1,5,10,0,20,EL
f5a00fa4,21,12,7,13,1,7,23,16,10,2,8,9,30,6,0,20,EL
f5ae006d,4,1,0,2,2,2,8,6,2,1,1,2,6,3,0,20,EL
f5deef4c,1,1,0,0,1,1,1,0,3,2,1,0,1,9,0,20,EL
f5eedf74,7,4,7,0,0,2,7,5,6,1,5,4,11,6,0,20,EL
f620b04f,0,0,0,0,0,0,0,0,0,0,0,0,0,0,0,20,EL
f63a8347,0,0,0,0,0,0,0,0,0,0,0,0,0,2,0,20,EL
f6798fc3,1,0,1,0,0,1,1,0,0,0,0,1,2,4,0,20,EL
f68b64fc,17,8,11,5,1,9,17,8,9,3,6,12,29,32,0,20,EL
f7036e1c,4,1,1,2,1,2,4,2,5,0,5,1,5,0,0,20,EL
f7223718,0,0,0,0,0,0,0,0,1,1,0,0,0,0,0,20,EL
f74f680d,2,1,0,1,1,0,1,1,0,0,0,0,2,1,0,20,EL
f7815d38,11,7,6,5,0,4,11,7,4,0,4,1,12,4,0,20,EL
f7b10c66,1,1,1,0,0,0,0,0,0,0,0,0,1,1,0,20,EL
f7c398ec,0,0,0,0,0,0,0,0,0,0,0,0,0,0,0,20,EL
f7e87032,9,6,4,4,1,1,3,2,3,0,3,3,12,2,0,20,EL
f874dd44,1,1,0,1,0,1,3,2,1,0,1,3,4,5,0,20,EL
f93c876b,6,3,2,4,0,3,7,4,6,6,0,5,11,20,0,20,EL
f9acca3a,0,0,0,0,0,0,2,2,3,1,2,5,5,0,0,20,EL
f9c927de,7,4,3,3,1,4,18,14,4,1,3,7,14,10,0,20,EL
f9ebe13d,1,1,0,0,1,1,2,1,0,0,0,0,1,0,0,20,EL
fa73ccc7,12,7,3,8,1,4,15,11,2,0,2,3,15,1,1,20,EL
fa937f7a,3,3,1,1,1,1,8,7,4,0,4,2,5,0,1,20,EL
fae880d5,8,3,3,4,1,4,13,9,4,1,3,6,14,5,0,20,EL
fb054320,9,6,6,3,0,4,8,4,2,0,2,2,11,5,0,20,EL
fb938d24,9,5,3,5,1,3,8,5,4,0,4,15,24,7,0,20,EL
fbafd1b0,5,2,1,4,0,3,4,1,1,0,1,5,10,12,0,20,EL
fbffc4b1,2,2,2,0,0,0,1,1,4,0,4,8,10,19,0,20,EL
fc1cf07a,8,8,5,3,0,3,6,3,4,3,1,11,19,43,1,20,EL
fc3f41aa,1,1,1,0,0,0,1,1,0,0,0,0,1,1,0,20,EL
fc4ab056,1,1,0,0,1,0,5,5,3,1,2,1,2,5,0,20,EL
fc4cf6a7,4,4,3,1,0,2,4,2,1,0,1,2,6,4,0,20,EL
fc4f85b1,13,10,4,8,1,4,8,4,8,4,4,9,22,25,0,20,EL
fce2302c,7,6,4,1,2,4,5,1,6,0,6,4,11,6,0,20,EL
fd7768be,3,3,1,1,1,2,2,0,2,1,1,1,4,1,0,20,EL
fd834d1d,0,0,0,0,0,0,0,0,0,0,0,0,0,0,0,20,EL
fe6c830a,0,0,0,0,0,0,1,1,0,0,0,0,0,3,0,20,EL
fe85a764,7,3,6,0,1,3,4,1,0,0,0,2,9,3,0,20,EL
fe888e39,3,2,1,2,0,2,4,2,1,0,1,3,6,3,1,20,EL
fecd43a3,10,4,7,2,1,6,10,4,1,1,0,5,15,4,0,20,EL
fed7cb61,9,6,5,0,4,2,9,7,6,0,6,1,10,5,0,20,EL
ff497879,3,1,3,0,0,2,3,1,1,1,0,5,8,4,0,20,EL
ffad706e,9,3,3,4,2,2,9,7,4,3,1,14,23,4,0,20,EL
003a5c72,9,4,2,4,3,2,10,8,3,1,2,9,18,12,0,20,SPA
0076ab7f,20,14,11,8,1,6,19,13,17,8,9,12,32,35,1,20,SPA
00b28772,49,28,12,31,6,10,44,34,37,7,30,56,105,30,1,20,SPA
011d8c56,0,0,0,0,0,0,1,1,0,0,0,1,1,6,2,20,SPA
01a49bd2,22,15,10,12,0,8,14,6,17,6,11,16,38,43,1,20,SPA
01eb744d,25,9,7,9,9,9,36,27,23,5,18,14,39,21,0,20,SPA
02319ad7,21,13,3,11,7,3,20,17,16,1,15,7,28,15,0,20,SPA
02c15616,29,15,7,16,6,7,21,14,24,4,20,14,43,9,0,20,SPA
02ef8778,9,7,3,4,2,4,13,9,8,1,7,10,19,4,0,20,SPA
036bba5f,61,30,37,20,4,30,63,33,46,15,31,15,76,41,0,20,SPA
04965583,21,14,8,11,2,8,37,29,14,1,13,23,44,18,0,20,SPA
04a65a8f,0,0,0,0,0,0,0,0,0,0,0,0,0,2,0,20,SPA
04ac8285,0,0,0,0,0,0,1,1,0,0,0,3,3,3,1,20,SPA
04e17fd5,16,12,2,8,6,6,27,21,24,5,19,10,26,29,0,20,SPA
05a4465d,46,23,11,31,4,17,72,55,28,12,16,28,74,32,1,20,SPA
062fc2e6,6,5,5,0,1,5,11,6,1,0,1,2,8,6,0,20,SPA
06983922,12,9,1,6,5,3,19,16,8,0,8,2,14,4,0,20,SPA
070a3904,47,23,11,26,10,17,58,41,30,1,29,24,71,23,1,20,SPA
07129f3c,0,0,0,0,0,0,0,0,0,0,0,0,0,1,0,20,SPA
073b1b37,31,21,19,9,3,16,35,19,13,2,11,21,52,66,1,20,SPA
08511d65,46,31,26,17,3,20,42,22,22,9,13,49,95,102,4,20,SPA
09332647,4,0,1,2,1,1,1,0,4,0,4,1,5,7,0,20,SPA
0959c2a2,38,19,9,19,10,12,36,24,38,4,34,21,59,12,2,20,SPA
09a9e921,5,1,1,2,2,2,6,4,4,0,4,0,5,7,0,20,SPA
09e81276,3,3,2,1,0,1,1,0,0,0,0,0,3,2,0,20,SPA
0a0cc13c,3,3,0,3,0,2,4,2,3,0,3,1,4,2,0,20,SPA
0ac94a23,16,9,5,4,7,3,17,14,15,1,14,7,23,10,0,20,SPA
0ae4e09a,18,11,8,7,3,7,29,22,14,0,14,6,24,17,0,20,SPA
0b33f6ad,41,24,28,13,0,21,34,13,32,26,6,35,76,158,3,20,SPA
0b90bb97,13,8,8,5,0,5,38,33,19,2,17,10,23,27,0,20,SPA
0ba976e4,16,8,4,7,5,5,15,10,14,1,13,8,24,3,0,20,SPA
0bc4e720,7,3,0,3,4,5,9,4,4,0,4,2,9,2,0,20,SPA
0c2ac3cb,74,39,30,38,6,21,64,43,37,4,33,34,108,25,0,20,SPA
0cc474e7,11,8,2,8,1,7,19,12,8,2,6,19,30,11,1,20,SPA
0d690336,2,2,0,1,1,0,0,0,1,0,1,0,2,0,0,20,SPA
0e50f929,27,15,11,10,6,9,27,18,15,4,11,25,52,10,0,20,SPA
0e7ccfc4,2,1,2,0,0,2,4,2,5,2,3,5,7,8,0,20,SPA
0f0aa5b4,28,17,25,3,0,11,18,7,21,12,9,36,64,112,2,20,SPA
0ff67313,0,0,0,0,0,0,0,0,0,0,0,0,0,0,0,20,SPA
10f1cd17,9,8,5,4,0,4,6,2,8,0,8,6,15,17,0,20,SPA
112521d1,19,13,8,9,2,7,25,18,12,1,11,11,30,32,0,20,SPA
114b510e,1,1,0,0,1,1,2,1,1,1,0,1,2,6,0,20,SPA
11b9265b,27,16,15,11,1,9,25,16,15,3,12,25,52,36,0,20,SPA
129af0db,17,8,4,9,4,1,13,12,12,2,10,5,22,23,0,20,SPA
12c50af5,22,15,14,7,1,10,37,27,9,1,8,14,36,12,1,20,SPA
12eda7be,1,1,0,1,0,1,2,1,1,1,0,2,3,1,0,20,SPA
132ac341,35,23,22,13,0,15,19,4,24,15,9,34,69,137,2,20,SPA
167c1bb0,2,2,2,0,0,2,3,1,1,0,1,4,6,15,0,20,SPA
16aa3654,34,22,16,12,6,15,44,29,19,1,18,23,57,10,0,20,SPA
16e9d0ea,37,20,27,8,2,12,32,20,21,8,13,23,60,47,1,20,SPA
174651c8,9,6,4,5,0,5,16,11,8,3,5,18,27,23,0,20,SPA
1840e36d,0,0,0,0,0,0,2,2,0,0,0,2,2,18,2,20,SPA
189cee7b,6,4,0,4,2,1,6,5,5,0,5,5,11,1,0,20,SPA
18abe173,43,27,30,11,2,13,27,14,31,14,17,45,88,124,3,20,SPA
18f0a9f0,0,0,0,0,0,0,2,2,0,0,0,0,0,0,0,20,SPA
19709006,23,10,11,7,5,13,41,28,19,0,19,14,37,13,0,20,SPA
19b776e9,7,5,3,2,2,2,3,1,1,0,1,0,7,1,0,20,SPA
19cdceb0,2,1,1,1,0,1,2,1,2,1,1,2,4,2,0,20,SPA
1a317a1b,25,15,13,10,2,12,28,16,15,3,12,12,37,40,0,20,SPA
1b17ed86,10,4,5,3,2,5,11,6,3,2,1,2,12,5,0,20,SPA
1b40049a,16,9,4,9,3,8,26,18,14,0,14,3,19,0,0,20,SPA
1bacc518,26,19,7,12,7,7,22,15,17,7,10,21,47,9,0,20,SPA
1bda5842,32,21,10,15,7,13,33,20,28,3,25,13,45,5,0,20,SPA
1d1691ad,5,2,4,0,1,5,8,3,4,0,4,2,7,8,0,20,SPA
1d5f96d9,0,0,0,0,0,0,0,0,0,0,0,0,0,0,0,20,SPA
1d8c99b0,0,0,0,0,0,0,1,1,0,0,0,0,0,0,0,20,SPA
1daec722,74,51,23,38,13,24,76,52,58,8,50,36,110,28,1,20,SPA
1f079188,42,24,23,19,0,17,50,33,25,8,17,35,77,58,2,20,SPA
1fb1c435,10,6,4,5,1,2,23,21,9,1,8,9,19,13,0,20,SPA
1fc3c3d7,0,0,0,0,0,0,0,0,0,0,0,1,1,0,0,20,SPA
1fe0492d,61,32,30,28,3,34,60,26,30,8,22,47,108,71,0,20,SPA
1fe67e86,15,10,4,10,1,9,11,2,4,1,3,2,17,20,0,20,SPA
200e89e1,12,9,5,5,2,4,10,6,3,0,3,3,15,4,0,20,SPA
206b11c5,1,1,1,0,0,0,1,1,2,0,2,0,1,0,0,20,SPA
21512407,52,34,24,21,7,34,53,19,33,7,26,24,76,46,0,20,SPA
228b0d9d,28,18,13,12,3,18,27,9,13,2,11,2,30,19,0,20,SPA
2327c29e,5,2,4,0,1,1,3,2,3,0,3,4,9,9,0,20,SPA
237a3851,6,1,1,3,2,3,7,4,1,0,1,10,16,4,0,20,SPA
240d3a0b,59,30,30,27,2,30,86,56,25,7,18,52,111,56,1,20,SPA
24279b8b,1,1,1,0,0,1,1,0,0,0,0,0,1,9,1,20,SPA
24f59bb2,23,15,12,8,3,11,17,6,15,3,12,17,40,12,1,20,SPA
253a06b9,17,12,6,7,4,6,18,12,12,0,12,3,20,5,0,20,SPA
2784f898,25,15,15,9,1,10,17,7,12,6,6,20,45,42,0,20,SPA
27a013f7,44,27,35,8,1,22,36,14,26,18,8,52,96,142,0,20,SPA
27d0a506,18,10,11,7,0,10,18,8,3,0,3,7,25,19,1,20,SPA
283c7121,52,28,12,31,9,18,49,31,20,6,14,31,83,18,1,20,SPA
293211e1,3,2,0,3,0,0,0,0,0,0,0,0,3,2,0,20,SPA
2946f9a1,11,6,6,3,2,6,10,4,5,3,2,12,23,18,1,20,SPA
29b61deb,28,16,14,12,2,12,26,14,16,3,13,12,40,8,1,20,SPA
2a0c8ba4,64,34,27,31,6,21,76,55,25,5,20,26,90,20,4,20,SPA
2a8c9f98,4,2,1,1,2,2,2,0,0,0,0,0,4,0,0,20,SPA
2bef2bca,3,2,2,1,0,1,1,0,6,2,4,0,3,9,0,20,SPA
2e3406ae,64,42,32,27,5,33,74,41,31,11,20,29,93,41,0,20,SPA
2e5e846d,0,0,0,0,0,0,1,1,2,1,1,0,0,5,0,20,SPA
2f965a72,0,0,0,0,0,0,0,0,0,0,0,0,0,0,0,20,SPA
3024e383,54,31,26,25,3,26,43,17,23,7,16,33,87,61,1,20,SPA
307fcd26,0,0,0,0,0,0,0,0,0,0,0,0,0,2,0,20,SPA
31a1288d,1,1,0,1,0,0,1,1,0,0,0,0,1,2,0,20,SPA
32974271,14,6,3,7,4,4,24,20,23,0,23,6,20,18,1,20,SPA
32c0491f,5,4,1,0,4,4,4,0,0,0,0,2,7,1,0,20,SPA
3353737a,57,30,28,25,4,27,64,37,25,5,20,33,90,53,0,20,SPA
335fa267,35,22,16,11,8,15,25,10,12,3,9,33,68,36,0,20,SPA
33a61a52,28,16,14,13,1,12,20,8,22,9,13,22,50,61,0,20,SPA
34e393f2,24,16,11,11,2,15,25,10,13,4,9,10,34,21,0,20,SPA
355c883a,55,30,32,18,5,30,54,24,19,7,12,18,73,48,0,20,SPA
3594a357,0,0,0,0,0,0,0,0,0,0,0,0,0,0,0,20,SPA
360d70f8,32,19,12,11,9,12,29,17,23,5,18,14,46,25,0,20,SPA
3624ce4c,74,43,38,31,5,31,60,29,53,23,30,48,122,94,1,20,SPA
3672b352,0,0,0,0,0,0,0,0,0,0,0,0,0,1,0,20,SPA
36c5f77b,1,0,0,1,0,1,3,2,5,1,4,2,3,2,0,20,SPA
374ee424,0,0,0,0,0,0,1,1,0,0,0,0,0,25,1,20,SPA
379652be,10,4,4,4,2,4,12,8,7,2,5,2,12,3,0,20,SPA
37e103f8,6,5,2,2,2,4,8,4,3,0,3,1,7,3,0,20,SPA
37f04799,0,0,0,0,0,0,1,1,2,1,1,3,3,7,1,20,SPA
37f1cf47,64,36,37,21,6,24,59,35,26,7,19,28,92,63,0,20,SPA
38126309,36,24,13,19,4,12,36,24,15,0,15,17,53,6,0,20,SPA
38ce1150,2,2,2,0,0,1,2,1,0,0,0,0,2,1,0,20,SPA
3902e91b,20,13,9,9,2,7,27,20,12,3,9,9,29,15,1,20,SPA
3a9c4b7b,45,29,26,13,6,21,38,17,24,6,18,44,89,70,1,20,SPA
3aa4a3be,18,12,6,7,5,9,23,14,25,6,19,9,27,13,0,20,SPA
3c05c659,35,19,11,14,10,13,32,19,25,3,22,8,43,2,0,20,SPA
3c16d927,39,25,31,6,2,20,39,19,23,2,21,23,62,30,1,20,SPA
3c7bc9bd,50,27,21,23,6,16,47,31,21,4,17,38,88,33,0,20,SPA
3cefcaef,32,26,20,9,3,14,18,4,19,5,14,22,54,30,1,20,SPA
3d688b46,37,21,14,18,5,15,31,16,17,4,13,24,61,20,1,20,SPA
3da1b6ed,0,0,0,0,0,0,0,0,0,0,0,0,0,0,0,20,SPA
3e016e5a,5,3,1,3,1,0,5,5,4,0,4,0,5,1,0,20,SPA
3e42f707,28,16,15,12,1,14,31,17,20,16,4,48,76,123,2,20,SPA
3e4f735d,0,0,0,0,0,0,0,0,0,0,0,0,0,1,0,20,SPA
3ecc11d8,36,19,28,7,1,17,30,13,33,22,11,62,98,138,2,20,SPA
3ee0dd59,16,12,9,7,0,6,12,6,7,0,7,9,25,2,0,20,SPA
3eed9821,11,5,5,5,1,5,8,3,4,2,2,22,33,32,0,20,SPA
3f10bd22,27,15,16,7,4,15,32,17,20,7,13,31,58,70,0,20,SPA
3f79a1c8,41,22,15,17,9,24,41,17,22,4,18,29,70,14,0,20,SPA
3fc45c73,48,30,33,13,2,27,47,20,28,13,15,39,87,140,0,20,SPA
40449bbd,11,9,9,2,0,5,9,4,11,6,5,17,28,66,2,20,SPA
407feb71,1,0,0,1,0,0,2,2,2,0,2,0,1,0,0,20,SPA
4112ace5,0,0,0,0,0,0,0,0,0,0,0,0,0,0,0,20,SPA
41521385,0,0,0,0,0,0,0,0,0,0,0,0,0,0,0,20,SPA
418f8f61,50,28,26,19,5,22,75,53,22,4,18,33,83,41,1,20,SPA
41b3069f,14,9,10,4,0,7,15,8,13,5,8,8,22,42,1,20,SPA
41c12f75,64,40,34,16,14,27,45,18,32,3,29,23,87,44,0,20,SPA
41f32541,62,33,37,24,1,34,58,24,38,15,23,67,129,73,1,20,SPA
4207e578,1,1,0,1,0,0,4,4,1,1,0,1,2,2,0,20,SPA
42276181,17,9,7,6,4,5,21,16,10,1,9,5,22,5,0,20,SPA
4242011c,24,16,18,4,2,16,28,12,19,11,8,24,48,108,2,20,SPA
43f71e77,8,2,0,4,4,0,12,12,13,2,11,4,12,18,0,20,SPA
44150beb,0,0,0,0,0,0,0,0,1,0,1,0,0,2,0,20,SPA
4442fbcd,41,26,17,17,7,15,40,25,19,7,12,12,53,16,0,20,SPA
45af8a54,4,3,3,1,0,1,4,3,2,0,2,1,5,4,0,20,SPA
45d96179,0,2,0,0,0,0,0,0,0,0,0,7,0,0,0,20,SPA
45e17712,25,11,13,9,3,11,20,9,8,3,5,16,41,32,0,20,SPA
45e304c8,0,0,0,0,0,0,0,0,0,0,0,0,0,0,0,20,SPA
4601e194,20,13,9,7,4,6,27,21,12,3,9,37,57,40,0,20,SPA
46166b49,1,0,1,0,0,0,0,0,2,0,2,0,1,0,0,20,SPA
466824fb,65,34,21,34,10,28,64,36,33,8,25,35,100,39,1,20,SPA
467bae22,25,17,9,14,2,6,36,30,13,0,13,10,35,10,0,20,SPA
46a8347f,6,5,6,0,0,5,6,1,5,3,2,8,14,11,0,20,SPA
46bd3a5b,13,6,8,3,2,6,10,4,6,4,2,16,29,31,0,20,SPA
46e07328,6,2,1,4,1,2,17,15,11,0,11,7,13,6,0,20,SPA
4737cebe,8,7,3,2,3,3,16,13,9,1,8,7,15,2,0,20,SPA
474ecac8,32,15,23,7,2,11,18,7,24,15,9,34,66,132,1,20,SPA
476ca810,4,2,2,2,0,1,1,0,2,1,1,2,6,8,0,20,SPA
487d9b09,7,5,4,2,1,3,6,3,2,2,0,8,15,22,0,20,SPA
48b3dd60,15,10,4,7,4,4,12,8,9,0,9,4,19,5,2,20,SPA
48e89655,2,2,1,1,0,1,2,1,1,0,1,0,2,1,0,20,SPA
4958bfb2,65,46,33,25,7,23,42,19,43,14,29,36,101,53,0,20,SPA
49d028db,8,3,3,5,0,2,14,12,4,2,2,10,18,16,0,20,SPA
49ea92be,33,20,16,12,5,14,52,38,30,2,28,16,49,13,0,20,SPA
4a478107,17,8,5,9,3,6,34,28,14,1,13,6,23,5,1,20,SPA
4a633cfe,9,6,4,4,1,5,9,4,13,9,4,8,17,31,0,20,SPA
4a895384,20,11,11,9,0,12,23,11,9,5,4,17,37,68,0,20,SPA
4accb7e0,45,25,14,26,5,15,41,26,19,4,15,20,65,21,0,20,SPA
4bd414c1,43,23,27,16,0,18,27,9,29,21,8,42,85,175,2,20,SPA
4c2e9442,9,7,1,6,2,4,8,4,8,1,7,5,14,14,0,20,SPA
4c5b14d2,14,7,4,8,2,4,11,7,10,2,8,15,29,22,1,20,SPA
4cee5954,56,39,36,17,3,39,59,20,37,10,27,31,87,60,1,20,SPA
4d1666ff,23,12,14,5,4,10,18,8,16,12,4,23,46,91,2,20,SPA
4d224fe8,96,60,43,45,8,39,99,60,53,10,43,68,164,72,0,20,SPA
4d8cd038,2,1,0,0,2,1,2,1,1,0,1,2,4,0,0,20,SPA
4dbd0916,12,8,4,5,3,2,11,9,14,1,13,6,18,6,0,20,SPA
4df0dff8,0,0,0,0,0,0,0,0,0,0,0,0,0,3,0,20,SPA
4e219ad2,9,4,4,4,1,7,16,9,6,0,6,2,11,0,0,20,SPA
4f28a6ff,44,31,29,15,0,16,32,16,29,15,14,35,79,79,1,20,SPA
5083a734,88,49,25,53,10,36,80,44,38,9,29,34,122,28,0,20,SPA
518f2234,0,0,0,0,0,0,0,0,1,0,1,0,0,0,0,20,SPA
51a3c4c8,27,19,21,6,0,14,24,10,18,13,5,40,67,130,0,20,SPA
51e3954c,24,20,12,10,2,11,20,9,18,3,15,22,46,46,0,20,SPA
529f49ab,70,41,34,30,6,26,58,32,32,8,24,48,118,41,7,20,SPA
532e1e4f,34,21,24,10,0,16,24,8,39,23,16,27,61,153,1,20,SPA
53ddba36,9,7,2,7,0,2,4,2,3,0,3,3,12,1,0,20,SPA
54073b28,30,19,13,12,5,10,40,30,14,3,11,22,52,9,0,20,SPA
545e2f01,4,3,3,1,0,2,4,2,3,3,0,8,12,12,0,20,SPA
55126f3b,70,42,27,30,13,29,89,60,33,8,25,29,99,28,2,20,SPA
5512b1a9,0,0,0,0,0,0,0,0,0,0,0,0,0,1,1,20,SPA
555f3a0b,15,8,12,2,1,11,20,9,11,5,6,12,27,61,0,20,SPA
57be54ec,0,0,0,0,0,0,3,3,3,0,3,1,1,4,0,20,SPA
58640e66,4,4,3,1,0,0,2,2,4,0,4,5,9,2,0,20,SPA
58a3a572,2,2,1,1,0,2,3,1,0,0,0,2,4,1,0,20,SPA
58a9a4d9,45,27,12,26,7,23,60,37,23,1,22,13,58,9,1,20,SPA
58afe001,72,33,24,40,8,31,69,38,52,5,47,43,115,40,2,20,SPA
59b7d823,22,12,14,6,2,11,14,3,7,0,7,3,25,11,0,20,SPA
5a626448,30,22,9,14,7,11,33,22,22,2,20,25,55,23,0,20,SPA
5ab0ea87,80,44,23,43,14,41,71,30,36,5,31,44,124,24,2,20,SPA
5c4dc0ff,0,0,0,0,0,0,1,1,0,0,0,0,0,0,0,20,SPA
5c7845f6,42,21,18,19,5,17,35,18,38,21,17,26,68,82,2,20,SPA
5c96b017,55,30,22,26,7,18,46,28,34,5,29,11,66,23,1,20,SPA
5ca20b7a,62,43,39,18,5,31,59,28,31,7,24,37,99,71,0,20,SPA
5ce0b5ba,2,2,1,0,1,2,6,4,2,1,1,5,7,6,0,20,SPA
5ceba7fc,5,3,0,3,2,1,4,3,2,0,2,3,8,2,0,20,SPA
5d5219b1,3,2,1,0,2,1,9,8,8,0,8,0,3,1,0,20,SPA
5dcf3e90,0,0,0,0,0,0,1,1,1,0,1,1,1,10,1,20,SPA
5eebbfdf,9,5,3,3,3,2,5,3,10,0,10,11,20,4,0,20,SPA
6025fab1,37,18,9,15,13,16,41,25,10,2,8,22,59,12,0,20,SPA
603116a7,19,11,8,8,3,9,28,19,19,2,17,18,37,21,0,20,SPA
60359288,5,4,3,2,0,1,3,2,4,2,2,4,9,24,0,20,SPA
605873e1,12,9,5,5,2,3,8,5,12,3,9,17,29,19,0,20,SPA
605eb473,0,0,0,0,0,0,1,1,2,0,2,5,5,9,1,20,SPA
61220da2,38,25,15,13,10,13,53,40,30,5,25,44,82,42,2,20,SPA
61b62b33,16,11,6,8,2,9,16,7,12,0,12,7,23,2,0,20,SPA
61bb7498,0,0,0,0,0,0,0,0,0,0,0,1,1,1,0,20,SPA
61bd33d0,20,10,7,8,5,11,34,23,23,4,19,18,38,12,0,20,SPA
6265208f,26,17,4,12,10,4,32,28,36,5,31,13,39,46,0,20,SPA
636eae97,31,16,13,14,4,13,50,37,16,1,15,8,39,11,0,20,SPA
63f04c6c,30,19,16,11,3,19,33,14,18,6,12,16,46,26,1,20,SPA
6435143e,0,0,0,0,0,0,0,0,0,0,0,0,0,0,0,20,SPA
64e8ed6d,12,3,4,6,2,2,13,11,11,0,11,4,16,6,0,20,SPA
65154df0,0,0,0,0,0,0,0,0,0,0,0,0,0,0,0,20,SPA
65d62814,0,0,0,0,0,0,0,0,0,0,0,0,0,0,0,20,SPA
6636496a,0,0,0,0,0,0,1,1,1,0,1,0,0,1,0,20,SPA
6763373d,2,1,1,0,1,1,2,1,3,1,2,0,2,1,0,20,SPA
67669ce7,1,1,1,0,0,1,1,0,0,0,0,0,1,0,0,20,SPA
67cdbc0e,63,38,22,30,11,24,58,34,31,7,24,17,80,16,1,20,SPA
6922f806,12,8,6,4,2,3,24,21,11,3,8,7,19,22,0,20,SPA
697295b1,18,9,11,7,0,9,19,10,16,10,6,36,54,82,0,20,SPA
69cbc8b6,37,17,22,14,1,22,40,18,29,16,13,42,79,144,1,20,SPA
6a99e0b1,15,5,0,7,8,5,18,13,18,2,16,5,20,29,0,20,SPA
6bb2c084,76,49,29,40,7,26,78,52,42,6,36,44,120,30,0,20,SPA
6c811eb7,16,10,6,8,2,4,21,17,5,1,4,1,17,3,0,20,SPA
6ce1f46f,56,28,18,29,9,18,70,52,27,0,27,23,79,15,0,20,SPA
6d8f8441,25,18,14,8,3,14,30,16,9,2,7,13,38,19,0,20,SPA
6dce77a5,2,0,1,1,0,2,5,3,0,0,0,1,3,7,0,20,SPA
6f51e382,2,2,2,0,0,2,3,1,0,0,0,2,4,17,6,20,SPA
6f5f82c0,14,8,9,3,2,10,20,10,13,1,12,13,27,21,0,20,SPA
70d74ece,18,8,3,11,4,2,16,14,16,4,12,7,25,30,1,20,SPA
70d8e84c,34,22,29,5,0,16,27,11,26,15,11,28,62,73,1,20,SPA
70f8e0bd,59,32,24,28,7,18,61,43,35,3,32,38,97,27,1,20,SPA
7111d552,26,16,13,8,5,8,32,24,14,0,14,3,29,2,0,20,SPA
715bf047,17,13,6,8,3,6,12,6,3,0,3,3,20,1,0,20,SPA
719384c1,19,8,8,9,2,3,13,10,10,1,9,13,32,15,0,20,SPA
71b47ab9,15,8,6,8,1,6,21,15,14,1,13,10,25,15,0,20,SPA
72a99e38,8,5,2,2,4,4,8,4,5,0,5,4,12,0,0,20,SPA
72b07a9c,33,16,25,7,1,13,35,22,30,16,14,61,94,112,2,20,SPA
7329018e,39,26,13,22,4,18,42,24,24,7,17,34,73,38,0,20,SPA
73683fa9,2,2,2,0,0,1,2,1,0,0,0,2,4,8,1,20,SPA
7460ca0d,67,41,29,32,6,32,101,69,38,11,27,22,89,20,2,20,SPA
74dc806c,0,0,0,0,0,0,4,4,1,0,1,0,0,0,0,20,SPA
75645f0e,7,5,1,4,2,0,9,9,7,4,3,5,12,18,0,20,SPA
75751c99,0,0,0,0,0,0,2,2,0,0,0,0,0,28,2,20,SPA
75bd85ea,27,21,11,16,0,9,30,21,17,5,12,29,56,17,1,20,SPA
79135368,1,1,0,1,0,0,3,3,4,0,4,4,5,1,0,20,SPA
79300479,27,19,5,14,8,7,34,27,13,0,13,17,44,5,0,20,SPA
7958dc65,1,0,0,1,0,1,8,7,3,0,3,1,2,0,0,20,SPA
7a538238,25,14,16,7,2,13,22,9,5,1,4,10,35,14,0,20,SPA
7b456af7,0,0,0,0,0,0,1,1,0,0,0,0,0,7,0,20,SPA
7b5ab7f2,9,5,3,5,1,1,9,8,6,0,6,3,12,1,0,20,SPA
7c2965bb,0,0,0,0,0,0,0,0,0,0,0,2,2,0,0,20,SPA
7c363088,0,0,0,0,0,0,0,0,1,0,1,0,0,0,0,20,SPA
7c388b20,48,30,25,19,4,20,61,41,36,3,33,35,83,29,0,20,SPA
7c4243d4,40,21,17,18,5,13,44,31,13,4,9,11,51,8,0,20,SPA
7dcf86f6,29,19,7,9,13,12,45,33,16,1,15,22,51,7,0,20,SPA
7f203b54,4,3,1,3,0,1,2,1,1,0,1,5,9,12,0,20,SPA
7f4c7c9f,52,27,35,13,4,26,45,19,30,8,22,46,98,61,1,20,SPA
808d48f3,27,23,17,8,2,14,28,14,11,6,5,24,51,52,1,20,SPA
808df563,2,1,1,0,1,1,1,0,0,0,0,1,3,0,0,20,SPA
81069528,42,23,23,17,2,19,43,24,17,4,13,30,72,48,0,20,SPA
81a606fc,1,1,1,0,0,1,1,0,0,0,0,0,1,2,0,20,SPA
81d5c497,1,0,0,1,0,1,2,1,0,0,0,0,1,2,0,20,SPA
81f0781e,19,8,4,10,5,5,46,41,19,3,16,10,29,51,0,20,SPA
82e9b89d,12,6,2,6,4,2,8,6,12,2,10,6,18,9,0,20,SPA
833fb62e,12,10,2,6,4,2,20,18,11,1,10,7,19,2,0,20,SPA
84399660,4,1,1,2,1,1,4,3,1,0,1,0,4,0,0,20,SPA
8455ad90,3,1,0,2,1,3,6,3,5,0,5,3,6,0,0,20,SPA
84bba8b6,2,0,1,1,0,1,7,6,2,0,2,3,5,1,0,20,SPA
84f55b4a,0,0,0,0,0,0,0,0,1,0,1,0,0,0,0,20,SPA
84fb6aff,22,12,14,4,4,10,20,10,11,4,7,12,34,35,0,20,SPA
850c0a0d,33,20,23,8,2,16,34,18,20,4,16,29,62,82,0,20,SPA
85dace26,0,0,0,0,0,0,0,0,0,0,0,0,0,0,0,20,SPA
868ce848,30,18,17,10,3,14,23,9,17,4,13,28,58,38,0,20,SPA
8696bc90,19,17,6,11,2,4,21,17,8,0,8,7,26,8,0,20,SPA
873619c6,0,0,0,0,0,0,0,0,0,0,0,0,0,0,0,20,SPA
873ce3a2,10,4,6,3,1,2,12,10,4,2,2,5,15,3,0,20,SPA
874d7a32,19,13,8,10,1,6,23,17,8,1,7,6,25,13,0,20,SPA
88050721,30,22,8,18,4,10,41,31,13,2,11,18,48,12,1,20,SPA
8875b8c9,0,0,0,0,0,0,0,0,0,0,0,0,0,1,0,20,SPA
88a359d4,7,5,1,5,1,2,19,17,6,2,4,4,11,8,0,20,SPA
88d91621,37,22,11,24,2,8,24,16,16,2,14,17,54,26,1,20,SPA
88f130ed,1,0,1,0,0,0,1,1,0,0,0,0,1,6,0,20,SPA
89151b16,20,13,14,5,1,10,14,4,15,9,6,23,43,74,0,20,SPA
89cbc961,5,2,2,3,0,0,2,2,8,2,6,3,8,9,1,20,SPA
89f951b5,27,14,8,15,4,10,28,18,19,6,13,15,42,18,1,20,SPA
8aafd64f,9,3,3,3,3,4,14,10,4,0,4,10,19,4,1,20,SPA
8b625720,2,1,2,0,0,1,4,3,5,4,1,4,6,12,0,20,SPA
8c3c640c,36,15,13,15,8,16,46,30,32,2,30,13,49,19,1,20,SPA
8cfc2f69,14,8,2,8,4,2,18,16,10,1,9,3,17,10,0,20,SPA
8d47bb39,16,11,12,3,1,9,21,12,15,2,13,28,44,60,0,20,SPA
8db394aa,34,19,17,15,2,16,28,12,20,7,13,52,86,76,2,20,SPA
8dc6dbb3,0,0,0,0,0,0,0,0,0,0,0,0,0,1,0,20,SPA
8e010ff4,11,6,3,6,2,4,12,8,2,0,2,2,13,3,0,20,SPA
8e049cbd,21,16,12,8,1,14,25,11,6,4,2,18,39,46,0,20,SPA
8e088e04,22,15,11,8,3,9,10,1,9,1,8,8,30,13,1,20,SPA
8e48dc61,27,11,9,17,1,12,30,18,13,3,10,8,35,15,1,20,SPA
8e92be30,7,2,0,3,4,1,8,7,8,0,8,3,10,6,0,20,SPA
8ef81d2d,6,4,3,2,1,2,4,2,4,3,1,4,10,7,0,20,SPA
8f29e08b,1,1,1,0,0,1,2,1,0,0,0,0,1,0,0,20,SPA
8f3565b3,31,15,4,22,5,7,29,22,21,4,17,8,39,29,0,20,SPA
8f5e92a6,6,1,2,3,1,2,21,19,13,0,13,10,16,5,0,20,SPA
8f898ba8,13,10,3,6,4,2,14,12,9,1,8,3,16,22,0,20,SPA
8f8c6934,2,1,2,0,0,2,4,2,0,0,0,3,5,17,5,20,SPA
8fae77ea,1,1,1,0,0,0,2,2,0,0,0,1,2,7,3,20,SPA
8fc259d7,2,1,2,0,0,2,5,3,2,1,1,0,2,2,0,20,SPA
9038c2a1,29,20,8,16,5,15,33,18,18,3,15,18,47,9,0,20,SPA
904cd50d,0,0,0,0,0,0,0,0,0,0,0,0,0,2,0,20,SPA
9109185e,0,0,0,0,0,0,0,0,0,0,0,0,0,0,0,20,SPA
9260926b,16,9,5,9,2,4,11,7,5,0,5,12,28,6,0,20,SPA
92d38e6c,42,31,24,15,3,19,28,9,14,1,13,46,88,69,0,20,SPA
93090f69,30,19,24,5,1,11,20,9,34,24,10,34,64,153,1,20,SPA
933e8c8a,19,8,11,8,0,8,20,12,18,5,13,27,46,63,0,20,SPA
949c3655,0,0,0,0,0,0,1,1,0,0,0,0,0,1,0,20,SPA
963829d0,34,21,10,17,7,12,45,33,23,12,11,4,38,21,0,20,SPA
967f34d3,1,1,1,0,0,1,1,0,0,0,0,0,1,14,1,20,SPA
97572117,45,25,26,15,4,20,37,17,24,5,19,14,59,50,1,20,SPA
97852360,1,0,1,0,0,1,3,2,0,0,0,0,1,10,0,20,SPA
9939e168,52,30,26,22,4,27,54,27,29,5,24,16,68,23,1,20,SPA
9970da54,0,0,0,0,0,0,0,0,0,0,0,0,0,2,0,20,SPA
999908af,54,31,25,24,5,16,33,17,23,5,18,17,71,17,1,20,SPA
99bebd12,2,1,0,1,1,0,0,0,1,0,1,0,2,0,0,20,SPA
9a64e67e,48,27,33,15,0,26,35,9,20,7,13,20,68,99,0,20,SPA
9ab48bde,41,32,22,13,6,30,63,33,13,0,13,24,65,21,0,20,SPA
9d2a3d5f,5,3,2,2,1,3,8,5,4,0,4,3,8,6,0,20,SPA
9d66fbe3,16,9,2,7,7,7,24,17,16,4,12,4,20,16,0,20,SPA
9dfdbdeb,0,0,0,0,0,0,0,0,1,0,1,0,0,0,0,20,SPA
9e098912,0,0,0,0,0,0,0,0,0,0,0,0,0,0,0,20,SPA
9e1035f8,23,15,6,16,1,8,30,22,20,3,17,14,37,12,0,20,SPA
9f0ea33f,0,0,0,0,0,0,2,2,0,0,0,1,1,15,1,20,SPA
9f323c71,5,3,2,1,2,3,6,3,6,0,6,8,13,8,0,20,SPA
9f8e9423,30,17,15,14,1,12,23,11,32,16,16,31,61,124,0,20,SPA
a01c3d54,1,1,1,0,0,1,1,0,0,0,0,2,3,18,3,20,SPA
a0255c67,7,3,3,4,0,2,9,7,1,1,0,2,9,2,0,20,SPA
a03c82b2,10,7,8,2,0,9,14,5,7,3,4,9,19,51,0,20,SPA
a08b974a,54,31,30,19,5,30,72,42,33,2,31,22,76,27,0,20,SPA
a0b4bb3e,13,9,2,10,1,5,14,9,9,0,9,7,20,4,1,20,SPA
a190d597,9,5,1,4,4,1,10,9,4,2,2,3,12,10,0,20,SPA
a2609621,24,13,15,9,0,7,15,8,11,7,4,21,45,50,1,20,SPA
a300ac7e,12,6,2,8,2,3,13,10,13,2,11,2,14,0,0,20,SPA
a35134ae,13,6,10,2,1,7,11,4,17,11,6,16,29,31,0,20,SPA
a39bb753,7,3,2,3,2,3,15,12,5,0,5,6,13,0,0,20,SPA
a4971d84,42,32,27,15,0,17,30,13,20,7,13,34,76,105,1,20,SPA
a4995f48,1,1,1,0,0,1,4,3,0,0,0,1,2,13,3,20,SPA
a55d8df5,27,17,14,11,2,16,39,23,18,1,17,8,35,11,0,20,SPA
a58bb1e1,9,5,5,2,2,3,14,11,8,2,6,6,15,9,0,20,SPA
a5cdedc7,0,0,0,0,0,0,0,0,0,0,0,0,0,0,0,20,SPA
a6154613,4,0,0,1,3,2,12,10,6,1,5,1,5,11,0,20,SPA
a685f013,4,2,3,1,0,2,2,0,4,0,4,1,5,6,1,20,SPA
a6951bf8,37,21,25,11,1,16,38,22,19,9,10,38,75,25,0,20,SPA
a6de370d,25,16,14,6,5,7,28,21,30,1,29,13,38,16,0,20,SPA
a7a9d95a,3,3,2,1,0,1,7,6,4,1,3,2,5,10,0,20,SPA
a83d8b0c,29,14,13,14,2,8,35,27,13,1,12,5,34,7,0,20,SPA
a8542814,31,21,9,18,4,13,32,19,16,7,9,17,48,13,2,20,SPA
a8f21b9f,7,4,2,2,3,3,15,12,5,2,3,1,8,1,0,20,SPA
a8fbae1d,31,19,22,8,1,18,30,12,23,13,10,42,73,107,1,20,SPA
a9dc785c,0,0,0,0,0,0,0,0,0,0,0,0,0,1,0,20,SPA
aa0ac32d,12,3,11,1,0,3,4,1,7,6,1,6,18,29,0,20,SPA
aad53e64,1,1,1,0,0,1,1,0,3,1,2,0,1,2,0,20,SPA
aae17c81,0,0,0,0,0,0,0,0,0,0,0,0,0,0,0,20,SPA
ab99e4a0,4,4,2,1,1,1,6,5,0,0,0,5,9,2,0,20,SPA
abb3bb95,21,10,4,8,9,6,17,11,12,1,11,7,28,22,0,20,SPA
ac295d9e,3,2,3,0,0,3,5,2,1,0,1,3,6,24,0,20,SPA
ac3fb1be,12,8,9,2,1,7,11,4,19,17,2,14,26,71,0,20,SPA
ad178594,10,5,4,6,0,4,13,9,10,4,6,18,28,30,0,20,SPA
ad1ffcfd,61,42,31,25,5,30,67,37,35,16,19,40,101,63,1,20,SPA
ad4d0985,66,36,36,23,7,30,71,41,31,8,23,27,93,23,1,20,SPA
adfc9123,32,23,20,11,1,16,26,10,39,24,15,36,68,157,0,20,SPA
aec0fb6f,11,5,4,5,2,5,15,10,5,0,5,7,18,5,0,20,SPA
aed746df,11,7,4,6,1,5,13,8,10,2,8,5,16,7,0,20,SPA
af245161,0,0,0,0,0,0,0,0,0,0,0,0,0,0,1,20,SPA
b037bd4f,6,1,2,3,1,2,13,11,6,1,5,4,10,6,0,20,SPA
b05e2dbd,44,30,29,12,3,28,41,13,22,9,13,18,62,48,1,20,SPA
b0616e3d,29,16,17,10,2,19,28,9,11,1,10,13,42,35,0,20,SPA
b0fce72c,25,17,7,12,6,9,45,36,18,7,11,31,56,24,1,20,SPA
b14d0c5d,23,19,17,6,0,9,14,5,15,12,3,21,44,57,0,20,SPA
b19db005,2,2,1,1,0,2,5,3,4,0,4,0,2,0,1,20,SPA
b233e8e4,37,20,30,6,1,18,27,9,13,9,4,20,57,74,2,20,SPA
b2d03887,18,10,5,10,3,7,18,11,8,3,5,15,33,12,0,20,SPA
b2d0ec1b,28,17,10,13,5,10,28,18,11,1,10,2,30,5,0,20,SPA
b333b014,0,0,0,0,0,0,2,2,0,0,0,0,0,0,0,20,SPA
b35db3f6,1,0,0,1,0,1,10,9,4,0,4,2,3,4,0,20,SPA
b39a793e,9,4,4,5,0,3,10,7,4,0,4,2,11,5,0,20,SPA
b418dbd4,57,37,19,26,12,16,76,60,46,6,40,24,81,44,0,20,SPA
b4a014b1,35,23,25,9,1,15,25,10,33,24,9,37,72,176,1,20,SPA
b579e83d,12,4,5,7,0,7,12,5,10,1,9,11,23,4,1,20,SPA
b5bdf144,0,0,0,0,0,0,0,0,1,0,1,0,0,0,0,20,SPA
b5dd3469,43,19,27,16,0,15,46,31,21,4,17,23,66,24,0,20,SPA
b6e50615,48,35,32,15,1,21,40,19,26,4,22,30,78,73,1,20,SPA
b742cc0d,62,34,39,23,0,27,54,27,45,24,21,35,97,127,0,20,SPA
b7c99b9b,21,15,15,6,0,16,30,14,24,18,6,37,58,131,1,20,SPA
b7ca5c51,22,14,17,2,3,15,25,10,36,29,7,48,70,151,3,20,SPA
b7de5bad,13,5,8,4,1,7,20,13,10,0,10,21,34,31,0,20,SPA
b7f2edff,22,15,14,6,2,13,15,2,13,4,9,13,35,32,0,20,SPA
b857bd29,31,21,24,7,0,13,19,6,31,26,5,22,53,112,1,20,SPA
b86a64b2,30,24,17,10,3,9,30,21,14,10,4,32,62,57,0,20,SPA
b8a642fc,23,14,12,6,5,13,30,17,15,1,14,10,33,14,1,20,SPA
b8c1de25,62,38,25,35,2,22,54,32,27,3,24,20,82,20,1,20,SPA
b92b456a,1,0,0,1,0,0,8,8,3,1,2,2,3,2,0,20,SPA
ba3ca78f,1,1,1,0,0,1,1,0,0,0,0,0,1,2,0,20,SPA
ba5004e1,62,32,32,21,9,38,72,34,25,2,23,27,89,41,0,20,SPA
ba5a9545,24,20,8,14,2,12,22,10,8,0,8,5,29,0,0,20,SPA
bad38a94,73,42,44,23,6,25,61,36,31,5,26,40,113,63,0,20,SPA
bb4a42be,0,0,0,0,0,0,4,4,0,0,0,1,1,1,0,20,SPA
bb4b1242,17,6,4,8,5,4,21,17,16,2,14,9,26,12,0,20,SPA
bba30585,30,14,20,9,1,16,28,12,14,7,7,28,58,101,5,20,SPA
bc61cc65,15,11,3,7,5,8,22,14,7,1,6,12,27,6,0,20,SPA
bc6f5f06,9,7,7,2,0,4,4,0,6,6,0,7,16,30,0,20,SPA
bd3b9a9f,7,4,5,2,0,5,9,4,8,5,3,11,18,23,0,20,SPA
bdb624a3,11,7,5,4,2,4,11,7,6,0,6,2,13,2,0,20,SPA
be170419,13,10,10,2,1,6,16,10,25,17,8,23,36,71,0,20,SPA
bece776f,41,26,14,19,8,12,37,25,27,3,24,10,51,3,0,20,SPA
bf12926c,6,5,2,4,0,5,8,3,6,0,6,1,7,1,0,20,SPA
bfb15d99,0,0,0,0,0,0,1,1,0,0,0,0,0,3,0,20,SPA
bfca375c,6,1,4,2,0,3,5,2,5,2,3,10,16,15,0,20,SPA
bfd381b3,59,37,26,29,4,20,70,50,31,8,23,39,98,42,0,20,SPA
c00097d2,3,1,2,0,1,2,2,0,0,0,0,3,6,2,0,20,SPA
c010b898,12,6,10,2,0,7,9,2,5,2,3,8,20,12,0,20,SPA
c05dfb74,26,19,11,10,5,4,24,20,9,0,9,12,38,7,0,20,SPA
c14bc029,95,59,44,42,9,39,88,49,58,13,45,55,150,68,1,20,SPA
c2111b45,6,5,4,2,0,3,4,1,7,4,3,5,11,28,0,20,SPA
c2846353,3,3,2,1,0,1,1,0,2,1,1,0,3,3,0,20,SPA
c33ee247,1,0,0,1,0,0,2,2,4,1,3,1,2,0,0,20,SPA
c4b8bcf4,10,5,0,6,4,4,22,18,7,2,5,7,17,6,0,20,SPA
c67cd65c,41,24,28,13,0,19,35,16,37,29,8,42,83,144,2,20,SPA
c693cf7c,6,2,0,2,4,2,3,1,2,0,2,1,7,1,0,20,SPA
c7429db3,13,8,4,5,4,7,20,13,7,0,7,5,18,5,0,20,SPA
c77a8043,37,24,8,18,11,16,53,37,21,3,18,12,49,21,0,20,SPA
c78b352d,8,3,5,3,0,1,2,1,5,0,5,2,10,10,0,20,SPA
c90977db,29,18,10,6,13,14,52,38,9,0,9,20,49,2,0,20,SPA
c93231dc,4,2,1,2,1,2,6,4,7,3,4,5,9,0,0,20,SPA
c966fce1,2,1,1,0,1,0,0,0,3,0,3,0,2,3,0,20,SPA
c9cb972b,0,0,0,0,0,0,1,1,0,0,0,1,1,3,1,20,SPA
c9e39d91,26,11,14,9,3,12,39,27,20,0,20,12,38,23,1,20,SPA
ca6edaa0,0,0,0,0,0,0,0,0,0,0,0,0,0,0,0,20,SPA
cac2537b,24,11,7,15,2,8,35,27,15,4,11,15,39,19,0,20,SPA
cb574619,62,42,44,16,2,27,48,21,24,8,16,22,84,97,1,20,SPA
cbbfa2e7,2,1,0,2,0,1,9,8,6,0,6,7,9,9,0,20,SPA
cbdf7d5c,1,0,0,1,0,0,0,0,0,0,0,0,1,0,0,20,SPA
cca05da8,1,0,0,1,0,0,0,0,0,0,0,0,1,0,0,20,SPA
ccaa5728,13,8,10,3,0,5,31,26,12,0,12,7,20,7,0,20,SPA
cce181df,63,40,40,18,5,19,51,32,25,6,19,57,120,36,2,20,SPA
cda0b317,0,0,0,0,0,0,2,2,0,0,0,0,0,13,2,20,SPA
cde52ef5,0,0,0,0,0,0,0,0,0,0,0,0,0,5,0,20,SPA
ce8039aa,3,1,1,0,2,2,6,4,1,0,1,1,4,0,0,20,SPA
ce82f116,13,5,7,3,3,4,23,19,12,2,10,3,16,5,0,20,SPA
ced26057,1,0,1,0,0,0,0,0,1,0,1,0,1,1,0,20,SPA
d04b94db,51,30,27,18,6,21,36,15,18,3,15,22,73,30,0,20,SPA
d080ed5e,79,52,20,44,15,28,86,58,46,8,38,51,130,52,0,20,SPA
d166c007,0,0,0,0,0,0,0,0,0,0,0,0,0,0,0,20,SPA
d1b060e2,1,1,0,0,1,0,1,1,1,0,1,0,1,1,0,20,SPA
d2110326,11,8,7,3,1,5,8,3,17,15,2,11,22,73,0,20,SPA
d2aea9ac,0,0,0,0,0,0,0,0,0,0,0,0,0,0,0,20,SPA
d2be40f2,3,2,2,1,0,1,4,3,2,0,2,4,7,23,2,20,SPA
d2ed99b4,0,0,0,0,0,0,1,1,0,0,0,0,0,0,0,20,SPA
d38fdf53,84,45,53,27,4,42,77,35,30,7,23,58,142,61,6,20,SPA
d4cb83cc,38,16,26,9,3,22,42,20,20,4,16,43,81,66,0,20,SPA
d4ef9ac5,26,19,18,7,1,15,28,13,11,3,8,13,39,34,1,20,SPA
d66b9872,28,20,8,9,11,12,25,13,18,1,17,19,47,7,0,20,SPA
d70a3661,0,0,0,0,0,0,0,0,0,0,0,0,0,0,0,20,SPA
d70ce98e,21,10,4,7,10,3,21,18,9,0,9,7,28,1,0,20,SPA
d717630e,5,2,3,2,0,3,3,0,4,1,3,1,6,3,0,20,SPA
d733aa38,33,16,12,18,3,21,49,28,41,2,39,31,64,37,0,20,SPA
d83bbc54,44,25,25,13,6,25,57,32,22,5,17,31,75,91,1,20,SPA
d87e2cae,5,2,0,4,1,2,8,6,10,4,6,1,6,16,0,20,SPA
d9764034,1,1,1,0,0,1,2,1,0,0,0,2,3,10,0,20,SPA
d9bda115,4,3,0,3,1,1,2,1,1,0,1,4,8,3,0,20,SPA
da27e268,82,52,29,44,9,29,82,53,28,10,18,31,113,53,2,20,SPA
db750822,15,12,7,7,1,5,17,12,9,0,9,10,25,9,0,20,SPA
db8f0eba,37,22,16,16,5,16,33,17,28,4,24,16,53,11,0,20,SPA
dbe519cf,26,18,19,7,0,12,20,8,9,0,9,15,41,20,1,20,SPA
de39485a,11,7,4,4,3,7,21,14,9,0,9,5,16,2,0,20,SPA
de7d40d6,6,5,4,1,1,2,3,1,4,1,3,2,8,3,0,20,SPA
dee86451,7,4,4,2,1,4,14,10,7,5,2,4,11,8,1,20,SPA
df69b544,33,18,12,11,10,9,34,25,22,3,19,12,45,20,1,20,SPA
df8b52a5,74,46,49,19,6,36,79,43,30,9,21,31,105,57,1,20,SPA
e08647d6,24,15,7,11,6,3,32,29,25,2,23,11,35,30,0,20,SPA
e1c805cf,0,0,0,0,0,0,0,0,0,0,0,0,0,0,0,20,SPA
e1cbb531,19,11,13,5,1,4,19,15,8,2,6,8,27,7,0,20,SPA
e1deea75,8,2,4,3,1,1,6,5,4,3,1,8,16,23,0,20,SPA
e288d4b3,13,9,9,4,0,8,18,10,11,1,10,14,27,21,0,20,SPA
e29d1111,43,22,24,15,4,17,48,31,36,8,28,25,68,61,0,20,SPA
e2e9c250,48,25,14,21,13,20,57,37,23,1,22,19,67,16,2,20,SPA
e3fabb0a,13,8,5,6,2,4,38,34,32,1,31,15,28,19,1,20,SPA
e4086af3,3,2,2,0,1,0,0,0,2,1,1,1,4,2,0,20,SPA
e49ce451,41,27,18,21,2,20,42,22,12,5,7,28,69,71,1,20,SPA
e54bd0a2,37,22,13,21,3,12,24,12,15,5,10,16,53,31,0,20,SPA
e61bdd69,19,14,10,6,3,7,17,10,4,1,3,3,22,7,0,20,SPA
e6bc67d7,19,11,11,7,1,9,32,23,10,1,9,7,26,1,0,20,SPA
e7ab4179,15,11,10,5,0,4,9,5,13,8,5,15,30,61,1,20,SPA
e82d2807,1,0,0,0,1,0,2,2,1,0,1,0,1,4,0,20,SPA
e897d8ba,13,7,0,5,8,4,12,8,15,1,14,1,14,9,0,20,SPA
e9ada8cf,6,5,4,2,0,4,5,1,1,1,0,1,7,5,0,20,SPA
ea610f00,5,3,3,2,0,3,7,4,3,0,3,1,6,2,0,20,SPA
ea83bfa6,2,1,2,0,0,2,2,0,0,0,0,2,4,22,3,20,SPA
ea9b2ef9,16,10,12,4,0,6,16,10,29,23,6,33,49,115,2,20,SPA
eac044ad,1,1,0,0,1,0,0,0,1,0,1,0,1,0,0,20,SPA
eb3dd471,18,12,11,6,1,8,25,17,21,0,21,16,34,6,0,20,SPA
ec7c84c2,0,0,0,0,0,0,0,0,1,1,0,0,0,0,0,20,SPA
ecc77652,2,0,1,1,0,0,1,1,0,0,0,0,2,2,0,20,SPA
ecd8c01e,41,26,22,9,10,19,52,33,16,0,16,12,53,19,1,20,SPA
ed5c5fa3,31,19,15,12,4,11,35,24,14,1,13,14,45,17,0,20,SPA
ed6ea4d9,23,13,11,8,4,8,23,15,22,4,18,31,54,9,0,20,SPA
ed9f7cfe,73,46,28,35,10,40,65,25,28,7,21,38,111,56,0,20,SPA
ee8508c0,0,0,0,0,0,0,0,0,0,0,0,1,1,4,2,20,SPA
ee923664,26,15,16,6,4,15,28,13,18,1,17,26,52,28,0,20,SPA
ef322658,30,14,15,11,4,15,41,26,15,4,11,18,48,22,1,20,SPA
efecd633,26,13,18,6,2,7,29,22,20,8,12,28,54,13,1,20,SPA
f03f284b,38,20,15,20,3,13,41,28,28,13,15,35,73,63,3,20,SPA
f090a37a,11,7,1,9,1,5,17,12,2,0,2,5,16,1,0,20,SPA
f0da930c,20,16,18,1,1,7,11,4,14,7,7,23,43,75,1,20,SPA
f11fe861,13,10,10,2,1,3,5,2,9,4,5,2,15,35,0,20,SPA
f1bed920,57,31,32,17,8,26,47,21,30,3,27,31,88,26,1,20,SPA
f20fce1b,0,0,0,0,0,0,1,1,1,0,1,1,1,0,0,20,SPA
f2308b33,60,34,32,22,6,27,52,25,12,4,8,34,94,46,0,20,SPA
f2c6ac01,25,17,14,10,1,13,25,12,39,27,12,37,62,146,1,20,SPA
f3112790,66,40,40,19,7,32,53,21,30,9,21,65,131,77,0,20,SPA
f3b1d9a2,2,1,1,1,0,0,5,5,2,0,2,0,2,0,0,20,SPA
f520049f,4,4,3,1,0,1,2,1,7,6,1,7,11,40,0,20,SPA
f631c17f,19,14,8,9,2,10,23,13,24,0,24,8,27,16,0,20,SPA
f6798fc3,0,0,0,0,0,0,0,0,0,0,0,0,0,0,0,20,SPA
f681a8ef,5,1,2,3,0,2,11,9,12,1,11,5,10,2,0,20,SPA
f6ac68c1,22,17,11,10,1,11,18,7,16,9,7,24,46,91,1,20,SPA
f76fdcd2,6,2,2,2,2,3,5,2,4,0,4,2,8,2,0,20,SPA
f7dc2ae5,28,17,19,8,1,13,23,10,21,8,13,15,43,67,0,20,SPA
f814eccb,0,0,0,0,0,0,6,6,3,1,2,1,1,0,0,20,SPA
f8eca1b6,20,12,6,11,3,6,28,22,17,5,12,6,26,13,0,20,SPA
f9acf8bf,30,17,26,3,1,17,39,22,8,2,6,23,53,27,1,20,SPA
f9b42381,0,0,0,0,0,0,0,0,0,0,0,0,0,0,0,20,SPA
fa937f7a,43,28,16,18,9,21,70,49,19,1,18,15,58,5,0,20,SPA
fb5d47b3,35,20,16,16,3,15,31,16,25,10,15,26,61,69,0,20,SPA
fbd6378b,33,15,22,8,3,18,28,10,29,15,14,38,71,93,0,20,SPA
fd47b4f2,22,13,15,7,0,13,29,16,23,19,4,32,54,116,0,20,SPA
fd51b456,23,17,10,13,0,11,26,15,10,0,10,10,33,8,1,20,SPA
fd771f95,15,9,6,5,4,4,20,16,13,2,11,5,20,10,0,20,SPA
fd9c4805,17,8,5,6,6,4,19,15,18,0,18,6,23,4,1,20,SPA
fdd60087,36,24,20,12,4,10,18,8,12,7,5,19,55,20,1,20,SPA
fed17f5a,21,10,10,10,1,9,39,30,16,6,10,9,30,14,0,20,SPA
ff8f26ef,1,1,1,0,0,1,5,4,0,0,0,4,5,1,0,20,SPA
ffacd3d5,13,7,2,7,4,8,15,7,3,0,3,7,20,1,0,20,SPA
ffad706e,47,34,23,18,6,19,40,21,12,6,6,21,68,38,2,20,SPA
00672021,6,3,3,2,1,3,17,14,5,0,5,6,12,2,0,20,CL
0127419a,2,1,0,1,1,0,4,4,3,0,3,1,3,0,0,20,CL
016ff750,2,2,2,0,0,1,4,3,2,0,2,1,3,3,0,20,CL
01b8a2b2,0,0,0,0,0,0,0,0,0,0,0,0,0,2,0,20,CL
01eb744d,11,3,4,4,3,5,14,9,5,1,4,5,16,4,0,20,CL
028e70b9,0,0,0,0,0,0,1,1,0,0,0,0,0,0,0,20,CL
02c15616,2,0,0,1,1,1,6,5,1,1,0,0,2,7,0,20,CL
02ef8778,0,0,0,0,0,0,0,0,1,0,1,0,0,4,0,20,CL
032f894e,2,1,1,1,0,0,3,3,2,0,2,4,6,1,0,20,CL
0331786b,0,0,0,0,0,0,0,0,0,0,0,0,0,0,0,20,CL
03998238,0,0,0,0,0,0,0,0,0,0,0,0,0,0,0,20,CL
03df04ff,0,0,0,0,0,0,1,1,0,0,0,2,2,6,0,20,CL
042e8a49,7,2,2,2,3,2,11,9,8,0,8,0,7,1,0,20,CL
048a1cbc,6,3,4,2,0,0,2,2,4,0,4,10,16,6,0,20,CL
04989945,0,0,0,0,0,0,0,0,0,0,0,0,0,0,0,20,CL
04ac8285,0,0,0,0,0,0,0,0,0,0,0,1,1,2,0,20,CL
05439de2,7,6,6,1,0,4,5,1,5,3,2,6,13,17,3,20,CL
05d548d8,18,12,13,5,0,12,20,8,9,5,4,30,48,32,2,20,CL
0638becf,0,0,0,0,0,0,0,0,0,0,0,0,0,0,0,20,CL
070ec0b1,14,6,11,2,1,5,11,6,8,1,7,19,33,18,0,20,CL
07a821e4,3,1,1,2,0,2,4,2,0,0,0,2,5,0,0,20,CL
08511d65,3,2,3,0,0,3,6,3,6,5,1,10,13,17,1,20,CL
089550f5,3,1,1,1,1,1,4,3,5,0,5,1,4,2,0,20,CL
0959c2a2,8,5,2,3,3,3,15,12,8,1,7,7,15,3,0,20,CL
0a6dbbf7,11,6,8,2,1,5,6,1,8,3,5,9,20,20,0,20,CL
0ab1f153,8,3,5,2,1,1,11,10,5,0,5,11,19,10,0,20,CL
0ac94a23,3,1,0,2,1,1,9,8,2,0,2,1,4,1,0,20,CL
0b5a292a,17,9,10,3,4,9,22,13,6,1,5,11,28,17,0,20,CL
0ba976e4,2,0,1,0,1,2,6,4,0,0,0,1,3,0,0,20,CL
0bc4e720,2,2,0,2,0,2,2,0,3,0,3,0,2,2,0,20,CL
0c3f7197,1,1,1,0,0,0,4,4,2,0,2,2,3,0,0,20,CL
0cb29e91,8,5,5,3,0,4,11,7,9,1,8,2,10,2,0,20,CL
0d10333c,16,10,7,9,0,7,21,14,6,2,4,16,32,10,0,20,CL
0d267745,18,9,8,10,0,10,15,5,2,2,0,5,23,14,0,20,CL
0d82903c,10,6,6,4,0,2,7,5,5,2,3,10,20,9,0,20,CL
0da6a13e,5,1,1,4,0,1,4,3,1,0,1,0,5,3,0,20,CL
0dce3356,11,7,9,2,0,8,16,8,7,1,6,2,13,13,0,20,CL
0e21fc3c,3,2,1,2,0,0,1,1,2,1,1,2,5,2,2,20,CL
0e6bc38c,2,1,1,1,0,0,2,2,0,0,0,1,3,1,0,20,CL
0ef89a37,6,3,0,1,5,2,12,10,6,0,6,1,7,0,0,20,CL
10072610,0,0,0,0,0,0,0,0,0,0,0,0,0,1,0,20,CL
101da2b5,11,10,5,4,2,7,9,2,7,4,3,15,26,12,0,20,CL
10549b49,3,1,1,2,0,0,6,6,2,2,0,3,6,5,0,20,CL
108fe016,1,1,0,1,0,0,0,0,0,0,0,2,3,0,0,20,CL
10b9fa99,4,1,4,0,0,2,4,2,3,2,1,4,8,10,0,20,CL
10efd0e1,10,7,3,5,2,1,10,9,4,1,3,2,12,4,0,20,CL
10fe831e,7,6,3,2,2,3,16,13,7,5,2,15,22,12,0,20,CL
119b9a8e,2,0,1,1,0,2,3,1,2,1,1,4,6,5,0,20,CL
121101a4,17,13,12,4,1,4,6,2,7,4,3,11,28,24,1,20,CL
1265a93a,7,5,5,2,0,6,13,7,6,2,4,5,12,11,0,20,CL
129af0db,5,5,1,2,2,2,4,2,7,1,6,4,9,2,0,20,CL
133faa84,14,8,10,4,0,7,9,2,4,1,3,10,24,25,1,20,CL
13b44b02,13,5,7,4,2,4,10,6,6,0,6,4,17,10,0,20,CL
13ea2544,8,5,4,3,1,5,11,6,5,2,3,5,13,4,0,20,CL
1467af0d,22,12,14,7,1,7,20,13,7,1,6,4,26,5,0,20,CL
14b8fcdf,3,2,1,1,1,0,3,3,2,2,0,1,4,16,0,20,CL
15f3ec41,1,1,1,0,0,0,2,2,1,0,1,2,3,0,1,20,CL
169fd162,3,2,0,2,1,0,1,1,1,0,1,1,4,1,0,20,CL
16b9d5cf,6,5,4,2,0,2,3,1,4,2,2,6,12,11,0,20,CL
16ceb862,1,0,0,1,0,0,1,1,0,0,0,0,1,0,0,20,CL
179d2851,1,1,1,0,0,1,2,1,2,0,2,0,1,4,0,20,CL
1840e36d,0,0,0,0,0,0,0,0,0,0,0,1,1,8,1,20,CL
18b896d6,2,1,2,0,0,1,2,1,1,0,1,2,4,7,0,20,CL
1931bde9,11,5,2,5,4,3,10,7,1,0,1,1,12,1,0,20,CL
197640fd,3,1,0,3,0,2,7,5,10,2,8,1,4,5,0,20,CL
199cd404,2,0,0,2,0,0,1,1,0,0,0,0,2,1,0,20,CL
19cda00b,9,7,4,3,2,3,18,15,11,0,11,4,13,7,0,20,CL
19e4dca5,0,0,0,0,0,0,1,1,1,1,0,2,2,9,0,20,CL
1a2935f6,3,2,0,3,0,2,2,0,3,2,1,2,5,7,1,20,CL
1a799243,19,12,10,7,2,13,18,5,5,0,5,6,25,6,0,20,CL
1a992676,0,0,0,0,0,0,0,0,0,0,0,1,1,0,0,20,CL
1adcf39e,7,3,6,1,0,5,13,8,2,1,1,15,22,36,0,20,CL
1bacc518,16,10,7,6,3,5,20,15,6,1,5,12,28,5,0,20,CL
1bf33a9a,5,3,3,1,1,3,6,3,1,0,1,0,5,2,0,20,CL
1c07b06e,5,3,0,4,1,1,7,6,5,4,1,9,14,6,0,20,CL
1c78737d,0,0,0,0,0,0,0,0,4,1,3,1,1,3,0,20,CL
1c96ad85,4,3,4,0,0,2,6,4,0,0,0,2,6,4,0,20,CL
1cb49278,3,1,2,1,0,1,3,2,1,0,1,3,6,18,1,20,CL
1d1691ad,0,0,0,0,0,0,0,0,1,1,0,0,0,3,0,20,CL
1d5cab82,20,11,12,7,1,4,28,24,11,1,10,4,24,3,0,20,CL
1dbfae2d,2,2,1,1,0,2,5,3,0,0,0,0,2,1,0,20,CL
1e8dbb59,1,1,1,0,0,1,2,1,0,0,0,1,2,2,0,20,CL
1f3afdcb,3,3,2,1,0,3,3,0,1,1,0,1,4,5,0,20,CL
1f44ac21,4,3,0,1,3,2,7,5,1,1,0,3,7,9,0,20,CL
1fb1c435,4,3,0,4,0,0,5,5,1,0,1,4,8,7,0,20,CL
20030c06,8,5,4,4,0,5,9,4,7,1,6,2,10,14,0,20,CL
21512407,9,6,5,3,1,6,10,4,8,3,5,7,16,16,0,20,CL
21a66f6a,3,3,0,2,1,0,2,2,2,0,2,0,3,4,0,20,CL
228f73ae,0,0,0,0,0,0,0,0,0,0,0,0,0,1,0,20,CL
230a2fac,14,11,9,5,0,9,14,5,8,2,6,2,16,14,0,20,CL
24228180,6,5,2,3,1,2,3,1,5,1,4,1,7,0,0,20,CL
2475dcc6,5,3,0,4,1,1,5,4,2,0,2,7,12,1,0,20,CL
24b98f95,7,3,3,2,2,1,5,4,3,2,1,4,11,8,0,20,CL
24f59bb2,5,3,3,2,0,3,7,4,1,1,0,4,9,4,0,20,CL
262e5a82,3,3,2,1,0,1,8,7,1,0,1,3,6,1,0,20,CL
2784f898,7,4,6,1,0,2,3,1,8,7,1,4,11,9,0,20,CL
27d902c8,1,1,1,0,0,1,2,1,0,0,0,0,1,1,0,20,CL
27f0fcda,1,0,1,0,0,1,1,0,1,0,1,0,1,5,0,20,CL
28d596a0,1,0,1,0,0,1,1,0,0,0,0,0,1,3,0,20,CL
292a652a,5,3,3,1,1,3,4,1,11,10,1,4,9,23,2,20,CL
2946f9a1,2,2,0,2,0,1,1,0,1,0,1,1,3,0,0,20,CL
2973d8ff,0,0,0,0,0,0,0,0,0,0,0,0,0,1,0,20,CL
29c02c9f,0,0,0,0,0,0,2,2,1,0,1,2,2,0,0,20,CL
29fbdc88,2,1,0,1,1,0,2,2,0,0,0,1,3,3,0,20,CL
2a1beb34,24,14,11,12,1,14,30,16,10,4,6,17,41,19,0,20,CL
2a6cd437,1,1,1,0,0,0,0,0,0,0,0,1,2,1,0,20,CL
2acd49b9,9,5,4,4,1,4,6,2,6,0,6,5,14,2,0,20,CL
2b09d998,1,0,1,0,0,0,1,1,1,1,0,0,1,2,0,20,CL
2b3efa4a,5,2,3,1,1,4,16,12,4,1,3,7,12,8,0,20,CL
2b471f99,8,6,3,4,1,2,9,7,4,0,4,4,12,6,0,20,CL
2b622f01,6,4,0,4,2,2,5,3,4,0,4,3,9,4,0,20,CL
2ba38347,8,6,3,5,0,4,13,9,2,2,0,8,16,11,0,20,CL
2bed3eab,4,1,2,2,0,2,3,1,0,0,0,1,5,4,0,20,CL
2c0f8e9e,2,0,0,2,0,0,1,1,1,0,1,2,4,0,0,20,CL
2c44a35d,13,8,6,2,5,6,14,8,12,0,12,3,16,0,0,20,CL
2ccd89a3,10,8,7,2,1,7,7,0,2,1,1,2,12,4,0,20,CL
2d970560,23,14,4,18,1,12,17,5,8,0,8,11,34,15,0,20,CL
2db2fd7b,6,4,4,2,0,5,8,3,3,1,2,9,15,9,0,20,CL
2e4f5f03,14,9,7,6,1,8,15,7,11,1,10,7,21,9,0,20,CL
2ef7c612,4,3,0,4,0,2,3,1,0,0,0,1,5,0,0,20,CL
2f557579,5,3,2,2,1,3,13,10,3,0,3,6,11,0,1,20,CL
2f7acede,12,8,4,6,2,2,9,7,5,2,3,8,20,8,2,20,CL
2f90f6b8,12,8,5,4,3,8,11,3,5,1,4,3,15,1,0,20,CL
2f965a72,0,0,0,0,0,0,0,0,0,0,0,0,0,0,0,20,CL
2fabebc0,0,0,0,0,0,0,0,0,0,0,0,1,1,0,0,20,CL
30941e96,5,4,4,1,0,1,4,3,3,0,3,6,11,9,0,20,CL
30c220c3,7,5,7,0,0,3,7,4,4,0,4,5,12,6,0,20,CL
30f5ffa9,15,12,9,6,0,8,13,5,11,7,4,11,26,14,0,20,CL
31a62dc7,11,6,6,3,2,3,11,8,8,0,8,11,22,18,3,20,CL
31c69ef1,5,3,4,1,0,4,4,0,8,6,2,5,10,33,0,20,CL
3318193b,1,1,0,1,0,0,1,1,0,0,0,0,1,0,0,20,CL
335fa267,7,5,2,5,0,2,5,3,4,1,3,5,12,2,0,20,CL
33b8d077,16,8,8,7,1,6,18,12,8,1,7,10,26,12,0,20,CL
346d51d9,11,5,6,5,0,7,13,6,6,2,4,3,14,6,0,20,CL
34c3b935,0,0,0,0,0,0,0,0,1,0,1,0,0,0,1,20,CL
356c9002,3,3,3,0,0,3,6,3,6,1,5,4,7,7,0,20,CL
360e3062,6,5,2,4,0,3,12,9,6,4,2,6,12,3,0,20,CL
3640af28,6,2,4,2,0,3,5,2,4,3,1,8,14,38,3,20,CL
365836c9,6,5,4,1,1,4,6,2,2,2,0,2,8,28,0,20,CL
36a3ff67,9,6,3,3,3,1,9,8,4,1,3,1,10,11,0,20,CL
38ac43d3,7,4,3,2,2,1,3,2,3,1,2,3,10,5,0,20,CL
38c7feef,7,4,1,4,2,4,8,4,6,0,6,3,10,0,0,20,CL
392a7aea,5,2,2,3,0,2,16,14,7,2,5,1,6,5,0,20,CL
39769cff,20,12,13,6,1,13,25,12,10,3,7,5,25,21,1,20,CL
3a233281,1,0,0,0,1,0,1,1,3,0,3,0,1,1,1,20,CL
3a24769f,0,0,0,0,0,0,1,1,0,0,0,1,1,1,1,20,CL
3b333ac3,8,3,4,4,0,4,16,12,10,1,9,7,15,12,1,20,CL
3b387cc7,0,0,0,0,0,0,0,0,0,0,0,0,0,0,0,20,CL
3b8674e6,17,14,5,8,4,6,13,7,6,1,5,6,23,3,0,20,CL
3bb7b8b4,0,0,0,0,0,0,0,0,0,0,0,0,0,4,3,20,CL
3c6089ab,15,9,2,10,3,9,35,26,6,0,6,5,20,6,0,20,CL
3ca7254a,1,1,1,0,0,0,1,1,1,0,1,0,1,1,0,20,CL
3cefcaef,8,4,7,1,0,1,6,5,1,0,1,5,13,4,0,20,CL
3d68d631,2,1,0,1,1,1,3,2,5,0,5,3,5,1,0,20,CL
3eb22ec9,7,2,4,3,0,2,8,6,3,0,3,2,9,1,0,20,CL
3eed9821,1,1,0,1,0,0,3,3,4,3,1,5,6,6,0,20,CL
3ef0af0d,14,10,6,6,2,4,17,13,7,1,6,15,29,16,0,20,CL
407feb71,0,0,0,0,0,0,0,0,0,0,0,0,0,0,0,20,CL
41e7ef1c,5,3,4,1,0,2,3,1,1,1,0,6,11,6,0,20,CL
42276181,0,0,0,0,0,0,5,5,0,0,0,0,0,0,0,20,CL
42eaa028,1,0,0,0,1,1,4,3,2,0,2,0,1,0,0,20,CL
42fd9c7f,4,4,1,3,0,1,7,6,1,0,1,1,5,0,0,20,CL
433dc9a2,17,11,12,1,4,8,21,13,10,1,9,12,29,25,0,20,CL
436a9dd0,4,2,3,1,0,2,5,3,11,1,10,8,12,5,0,20,CL
43a166b4,3,2,1,1,1,3,4,1,1,0,1,0,3,0,0,20,CL
43b78598,1,1,0,1,0,0,1,1,3,0,3,0,1,5,0,20,CL
44781702,3,1,2,1,0,2,2,0,2,2,0,2,5,6,0,20,CL
44865466,2,2,2,0,0,2,4,2,1,0,1,4,6,4,0,20,CL
448a3608,5,4,3,1,1,2,6,4,2,0,2,1,6,2,0,20,CL
44ac04e9,7,2,4,2,1,2,6,4,3,0,3,7,14,4,0,20,CL
44eb9093,6,3,2,4,0,2,6,4,0,0,0,4,10,1,0,20,CL
45a03961,9,8,2,4,3,4,7,3,3,0,3,9,18,18,0,20,CL
45af8a54,0,0,0,0,0,0,0,0,0,0,0,0,0,0,0,20,CL
45db685d,21,10,6,12,3,8,27,19,7,1,6,13,34,4,0,20,CL
4601e194,1,1,0,1,0,0,3,3,5,3,2,7,8,9,0,20,CL
46a8347f,1,0,0,0,1,0,2,2,0,0,0,2,3,7,0,20,CL
47327321,1,1,0,1,0,1,1,0,1,1,0,0,1,0,0,20,CL
47af88b8,9,7,6,3,0,2,5,3,12,10,2,7,16,33,0,20,CL
47dc80f5,4,2,2,1,1,3,9,6,2,0,2,3,7,6,0,20,CL
47fd5136,6,4,3,2,1,3,3,0,6,4,2,8,14,32,0,20,CL
48b3dd60,6,3,2,3,1,2,3,1,3,0,3,2,8,1,0,20,CL
48d5bd33,4,3,3,1,0,2,9,7,2,0,2,2,6,3,0,20,CL
49296448,15,8,2,9,4,9,19,10,6,2,4,10,25,11,1,20,CL
4958bfb2,15,10,7,6,2,9,18,9,14,7,7,6,21,15,0,20,CL
49fe9070,5,3,1,3,1,2,9,7,2,0,2,1,6,3,0,20,CL
4adc7b42,5,4,1,4,0,0,12,12,8,0,8,4,9,0,0,20,CL
4b3c863f,14,5,12,2,0,8,15,7,3,2,1,4,18,24,0,20,CL
4b6960d2,4,3,1,3,0,3,8,5,4,0,4,11,15,14,1,20,CL
4b803b3c,9,6,4,5,0,7,9,2,9,9,0,18,27,44,1,20,CL
4bd00a50,7,6,3,4,0,5,9,4,4,0,4,2,9,2,1,20,CL
4c2e9442,1,0,0,1,0,0,2,2,1,1,0,1,2,8,0,20,CL
4c370d81,13,12,5,6,2,1,10,9,6,0,6,3,16,2,0,20,CL
4c5e78da,2,0,2,0,0,1,6,5,2,0,2,3,5,2,1,20,CL
4c82730b,3,1,0,3,0,1,8,7,2,0,2,2,5,1,1,20,CL
4d034881,0,0,0,0,0,0,1,1,1,0,1,0,0,1,0,20,CL
4d0eb7d2,2,2,1,1,0,0,2,2,0,0,0,1,3,1,0,20,CL
4d17df3e,4,3,4,0,0,3,5,2,13,8,5,8,12,17,0,20,CL
4d224fe8,23,12,13,10,0,9,21,12,7,1,6,8,31,9,0,20,CL
4d8cd038,1,1,0,0,1,0,1,1,0,0,0,0,1,2,0,20,CL
4dbd0916,2,2,1,0,1,1,2,1,2,0,2,2,4,1,0,20,CL
4dbdf7f7,5,4,0,4,1,1,3,2,5,2,3,4,9,0,0,20,CL
4dedd469,7,4,6,1,0,7,14,7,7,2,5,7,14,13,0,20,CL
4e034598,0,0,0,0,0,0,0,0,0,0,0,0,0,1,0,20,CL
4e204552,0,0,0,0,0,0,0,0,0,0,0,0,0,0,0,20,CL
4f1e6a0b,3,0,0,1,2,1,2,1,0,0,0,2,5,0,0,20,CL
4f28a6ff,6,4,3,2,1,5,10,5,17,9,8,10,16,22,0,20,CL
4f56170e,5,2,3,2,0,1,2,1,1,0,1,6,11,13,0,20,CL
4fa7cb9b,0,0,0,0,0,0,0,0,0,0,0,0,0,0,0,20,CL
5042e5c2,0,0,0,0,0,0,0,0,0,0,0,0,0,0,0,20,CL
5064d4c1,1,1,0,0,1,1,2,1,1,0,1,1,2,0,0,20,CL
50871bcc,10,8,2,6,2,4,15,11,6,0,6,1,11,1,0,20,CL
50c1ff86,19,11,14,5,0,14,21,7,4,2,2,7,26,18,1,20,CL
50dc94ce,11,3,1,6,4,5,14,9,7,0,7,10,21,2,0,20,CL
5148dcc5,8,5,0,5,3,3,7,4,5,0,5,3,11,0,0,20,CL
51a3c4c8,12,3,8,3,1,6,12,6,13,10,3,14,26,34,1,20,CL
51cf8561,2,0,0,2,0,2,4,2,0,0,0,3,5,2,0,20,CL
51dbeea9,14,11,7,7,0,7,10,3,8,3,5,3,17,6,0,20,CL
51ffa295,9,7,7,1,1,4,5,1,3,1,2,0,9,2,0,20,CL
5271c8f1,6,4,5,0,1,5,9,4,2,1,1,7,13,8,0,20,CL
527f063d,2,1,0,1,1,0,2,2,2,0,2,0,2,0,0,20,CL
529f49ab,29,18,15,12,2,5,18,13,10,3,7,12,41,8,0,20,CL
52ec54d0,5,3,3,1,1,2,3,1,7,4,3,9,14,27,0,20,CL
53070b63,0,0,0,0,0,0,0,0,0,0,0,0,0,0,0,20,CL
53cad200,13,5,6,3,4,7,11,4,10,2,8,11,24,15,0,20,CL
54b4dc4e,11,7,3,7,1,4,10,6,2,0,2,2,13,4,0,20,CL
54f2d108,0,0,0,0,0,0,0,0,0,0,0,2,2,2,0,20,CL
54f5ce34,9,7,5,3,1,6,7,1,2,1,1,3,12,2,0,20,CL
55126f3b,16,9,9,5,2,8,26,18,3,0,3,7,23,13,1,20,CL
552e00b9,3,1,1,1,1,1,5,4,0,0,0,0,3,0,0,20,CL
55537f53,0,0,0,0,0,0,0,0,0,0,0,0,0,0,0,20,CL
555d5edd,8,5,4,3,1,1,5,4,2,0,2,1,9,1,0,20,CL
555f3a0b,4,3,2,2,0,1,3,2,2,0,2,8,12,17,1,20,CL
55abe554,15,11,8,5,2,5,9,4,4,0,4,10,25,4,2,20,CL
56413b1f,5,0,1,4,0,2,12,10,6,1,5,1,6,7,0,20,CL
574fff8c,9,4,4,4,1,5,8,3,12,9,3,7,16,15,0,20,CL
580d52dd,12,5,3,5,4,3,8,5,8,2,6,8,20,7,1,20,CL
5853ac44,3,2,0,3,0,0,1,1,1,0,1,2,5,1,0,20,CL
58f077c0,0,0,0,0,0,0,0,0,1,0,1,0,0,2,1,20,CL
5944af8f,3,0,2,1,0,1,3,2,0,0,0,3,6,1,0,20,CL
5976f83e,9,5,6,3,0,4,5,1,2,2,0,3,12,3,0,20,CL
5ab0ea87,8,6,2,5,1,6,15,9,7,1,6,15,23,6,1,20,CL
5af687a1,2,2,1,0,1,2,2,0,0,0,0,0,2,0,0,20,CL
5c07e176,0,0,0,0,0,0,0,0,0,0,0,0,0,1,1,20,CL
5c2b4f07,8,7,2,4,2,4,9,5,7,3,4,2,10,9,0,20,CL
5c2da10f,0,0,0,0,0,0,1,1,0,0,0,0,0,2,0,20,CL
5cb1d026,16,10,12,4,0,8,17,9,11,5,6,5,21,17,0,20,CL
5cdddffa,10,5,3,5,2,6,15,9,2,0,2,6,16,4,0,20,CL
5ceba7fc,1,1,0,1,0,1,2,1,2,0,2,0,1,2,0,20,CL
5d4f7d61,3,0,0,2,1,0,3,3,2,0,2,1,4,4,0,20,CL
5dfc6ad5,13,9,7,5,1,5,11,6,7,2,5,8,21,6,0,20,CL
5e1028e5,17,12,4,11,2,6,14,8,9,2,7,3,20,2,0,20,CL
5e861944,0,0,0,0,0,0,2,2,1,0,1,1,1,0,0,20,CL
5e8936be,0,0,0,0,0,0,0,0,0,0,0,0,0,3,1,20,CL
5eae500a,2,1,1,1,0,0,2,2,3,0,3,1,3,2,0,20,CL
5ed9b537,1,1,0,1,0,0,1,1,1,0,1,2,3,5,0,20,CL
5eecec3d,0,0,0,0,0,0,0,0,1,1,0,2,2,0,0,20,CL
5f0241b2,0,0,0,0,0,0,0,0,0,0,0,0,0,0,0,20,CL
6025fab1,4,3,0,3,1,1,6,5,1,0,1,8,12,4,1,20,CL
603116a7,3,2,1,1,1,1,2,1,3,0,3,5,8,4,0,20,CL
60e86875,13,8,4,7,2,6,11,5,6,1,5,3,16,5,0,20,CL
6250083a,1,0,1,0,0,1,1,0,1,1,0,1,2,0,0,20,CL
62db2015,19,13,8,10,1,8,30,22,6,0,6,7,26,7,0,20,CL
63b9cc6d,4,2,3,1,0,3,10,7,1,0,1,0,4,2,0,20,CL
63d17038,0,0,0,0,0,0,0,0,0,0,0,0,0,2,0,20,CL
6421ec64,0,0,0,0,0,0,0,0,0,0,0,0,0,0,0,20,CL
6434f10d,21,11,8,10,3,10,24,14,3,0,3,9,30,5,0,20,CL
6438d426,2,1,0,2,0,0,3,3,2,0,2,0,2,4,0,20,CL
64f69877,3,1,1,2,0,0,4,4,2,1,1,2,5,2,0,20,CL
652d4c37,4,1,0,2,2,2,5,3,6,0,6,2,6,1,1,20,CL
65adf2db,0,0,0,0,0,0,0,0,0,0,0,0,0,0,0,20,CL
66116290,3,1,2,1,0,1,3,2,0,0,0,0,3,0,0,20,CL
6613c819,15,8,7,4,4,7,17,10,13,3,10,15,30,17,0,20,CL
6622454d,14,9,4,3,7,3,23,20,2,0,2,2,16,2,0,20,CL
6747869d,0,0,0,0,0,0,0,0,0,0,0,1,1,0,0,20,CL
67ac5bb8,12,7,8,4,0,5,7,2,11,6,5,13,25,25,0,20,CL
67b3d74b,2,1,2,0,0,2,2,0,2,1,1,1,3,5,0,20,CL
67cdbc0e,11,7,2,5,4,4,10,6,3,0,3,2,13,4,0,20,CL
68252d6d,4,1,0,2,2,2,7,5,1,0,1,4,8,3,0,20,CL
691bef82,9,6,4,3,2,2,5,3,3,3,0,4,13,13,0,20,CL
691f64f5,3,2,3,0,0,0,2,2,3,0,3,4,7,1,0,20,CL
6928979a,11,6,3,6,2,2,9,7,3,0,3,7,18,4,0,20,CL
69374ff5,11,10,6,3,2,6,14,8,0,0,0,4,15,4,1,20,CL
69384e5d,7,3,1,1,5,2,8,6,5,0,5,2,9,0,0,20,CL
6a479195,0,0,0,0,0,0,0,0,0,0,0,0,0,0,0,20,CL
6aa3e78b,1,1,1,0,0,0,6,6,3,1,2,3,4,4,0,20,CL
6b6cbca4,7,3,5,2,0,1,3,2,4,3,1,12,19,24,0,20,CL
6b994195,7,4,7,0,0,4,5,1,8,1,7,9,16,19,0,20,CL
6c7762c3,4,2,4,0,0,2,3,1,2,2,0,2,6,7,0,20,CL
6c811eb7,1,0,1,0,0,1,5,4,1,0,1,1,2,0,0,20,CL
6ca88b2a,3,2,3,0,0,2,3,1,0,0,0,1,4,2,0,20,CL
6ce1f46f,15,12,5,6,4,6,18,12,4,0,4,9,24,2,0,20,CL
6ceef869,7,5,5,2,0,3,4,1,7,6,1,12,19,43,0,20,CL
6e4df551,6,4,3,2,1,2,11,9,7,1,6,6,12,3,0,20,CL
6eee05f1,10,6,6,4,0,6,13,7,4,2,2,6,16,19,0,20,CL
6f51e382,0,0,0,0,0,0,0,0,0,0,0,1,1,5,1,20,CL
6fbde63a,9,6,2,6,1,5,8,3,0,0,0,0,9,2,0,20,CL
6fd8a334,2,2,1,1,0,1,1,0,0,0,0,2,4,2,0,20,CL
6fe90922,3,3,1,1,1,2,11,9,3,0,3,5,8,4,0,20,CL
70a9cba5,1,1,0,0,1,0,0,0,2,0,2,0,1,0,0,20,CL
70bc68ef,0,0,0,0,0,0,0,0,0,0,0,0,0,0,0,20,CL
70cf63ca,3,1,0,3,0,2,2,0,0,0,0,1,4,0,0,20,CL
70d74ece,4,3,1,3,0,1,2,1,6,0,6,2,6,4,0,20,CL
7111d552,5,2,1,2,2,1,2,1,0,0,0,1,6,0,0,20,CL
7120a04d,2,0,1,1,0,2,2,0,2,0,2,1,3,0,0,20,CL
715bf047,1,0,1,0,0,0,3,3,0,0,0,0,1,1,1,20,CL
71ec39ef,21,11,8,12,1,5,15,10,13,2,11,8,29,9,0,20,CL
720611fe,0,0,0,0,0,0,2,2,0,0,0,0,0,1,0,20,CL
7272a72a,5,2,3,2,0,3,9,6,4,0,4,4,9,1,1,20,CL
72c812f3,20,8,7,7,6,9,15,6,10,3,7,12,32,7,0,20,CL
73000a79,2,1,0,2,0,1,1,0,1,0,1,1,3,3,1,20,CL
733e7ad8,6,2,2,3,1,2,7,5,4,1,3,4,10,5,0,20,CL
73d6a176,1,1,0,1,0,1,1,0,0,0,0,0,1,0,0,20,CL
73fc8cc3,0,0,0,0,0,0,0,0,0,0,0,0,0,0,0,20,CL
74419746,0,0,0,0,0,0,0,0,0,0,0,0,0,2,0,20,CL
7460ca0d,12,8,6,6,0,3,25,22,9,3,6,8,20,5,0,20,CL
746b64a7,13,8,9,4,0,6,13,7,10,10,0,11,24,35,2,20,CL
746fec7d,1,1,0,0,1,1,3,2,2,0,2,3,4,0,0,20,CL
7483d9f9,3,2,1,2,0,2,2,0,3,2,1,5,8,13,0,20,CL
76d5857d,1,1,1,0,0,1,2,1,0,0,0,1,2,4,0,20,CL
77d7c96f,3,2,1,0,2,0,1,1,5,3,2,2,5,8,0,20,CL
77e84962,34,23,10,21,3,11,23,12,6,0,6,23,57,4,0,20,CL
78841da9,6,4,2,3,1,4,9,5,4,0,4,4,10,5,0,20,CL
79c0821a,10,5,4,5,1,1,6,5,7,1,6,7,17,6,1,20,CL
7a11550b,9,4,7,1,1,5,8,3,3,0,3,15,24,10,0,20,CL
7a2e46a8,0,0,0,0,0,0,0,0,0,0,0,0,0,3,0,20,CL
7a4cea18,2,1,1,1,0,0,0,0,0,0,0,1,3,0,0,20,CL
7b075c75,0,0,0,0,0,0,0,0,0,0,0,4,4,4,0,20,CL
7bcc0708,5,1,5,0,0,1,2,1,3,0,3,2,7,1,0,20,CL
7c104bb7,0,0,0,0,0,0,1,1,0,0,0,0,0,0,0,20,CL
7c3ed041,0,0,0,0,0,0,0,0,1,0,1,0,0,0,0,20,CL
7c56da38,11,6,2,7,2,2,8,6,1,0,1,1,12,2,0,20,CL
7edfbb8a,13,7,9,2,2,5,7,2,4,1,3,6,19,12,0,20,CL
7f3b388c,16,11,4,10,2,8,16,8,4,0,4,7,23,1,0,20,CL
7f97771d,7,5,3,3,1,4,6,2,5,2,3,4,11,4,0,20,CL
7fa4e703,2,1,1,0,1,1,1,0,0,0,0,0,2,0,0,20,CL
7fcc71d8,5,4,2,2,1,3,5,2,3,0,3,2,7,3,0,20,CL
7ff93107,0,0,0,0,0,0,0,0,0,0,0,0,0,2,0,20,CL
80490d7f,9,4,6,3,0,4,9,5,15,7,8,15,24,25,1,20,CL
807e869a,3,2,0,3,0,2,2,0,1,0,1,0,3,0,0,20,CL
808d48f3,6,4,3,3,0,4,9,5,5,1,4,5,11,7,0,20,CL
808df563,4,3,2,2,0,3,3,0,0,0,0,1,5,5,0,20,CL
8104e41e,9,5,5,2,2,6,9,3,2,0,2,5,14,3,0,20,CL
810e40c1,1,1,0,1,0,1,2,1,0,0,0,0,1,0,0,20,CL
819b3158,11,5,6,3,2,8,23,15,7,2,5,11,22,6,1,20,CL
82518f62,8,4,5,1,2,2,7,5,4,0,4,4,12,4,0,20,CL
8263d615,1,1,1,0,0,1,1,0,0,0,0,0,1,0,0,20,CL
82a8d4cc,5,3,1,2,2,2,5,3,3,1,2,5,10,3,0,20,CL
82b1198a,0,0,0,0,0,0,0,0,0,0,0,0,0,0,0,20,CL
82dbf623,1,1,1,0,0,0,2,2,2,0,2,1,2,6,0,20,CL
82efe6fa,0,0,0,0,0,0,0,0,0,0,0,0,0,1,0,20,CL
834d0be5,2,1,1,1,0,0,1,1,0,0,0,3,5,1,0,20,CL
8387afe6,4,3,2,2,0,2,5,3,5,0,5,4,8,11,0,20,CL
8455ad90,3,3,1,1,1,3,5,2,4,0,4,0,3,0,0,20,CL
85613cf0,3,2,1,1,1,1,2,1,0,0,0,0,3,4,0,20,CL
85686f86,0,0,0,0,0,0,1,1,0,0,0,0,0,0,0,20,CL
85f8571a,3,2,1,1,1,1,1,0,5,3,2,5,8,34,0,20,CL
8652a85c,1,1,0,1,0,0,1,1,1,0,1,1,2,0,0,20,CL
86dd16a8,9,3,7,1,1,5,7,2,7,4,3,13,22,16,0,20,CL
86dd77d1,8,4,2,4,2,4,5,1,2,1,1,8,16,6,1,20,CL
86e7deaf,12,6,7,5,0,4,7,3,13,8,5,13,25,40,0,20,CL
874d7a32,5,3,2,2,1,3,4,1,4,1,3,3,8,1,1,20,CL
8754c7ca,10,3,9,1,0,7,17,10,9,3,6,3,13,6,1,20,CL
8778c910,0,0,0,0,0,0,0,0,0,0,0,1,1,1,1,20,CL
8794e251,12,8,6,3,3,6,13,7,3,2,1,1,13,3,1,20,CL
88062e83,1,0,0,0,1,1,2,1,2,0,2,3,4,2,0,20,CL
881cd6be,12,8,4,6,2,3,11,8,0,0,0,2,14,3,0,20,CL
886f9aac,2,0,1,1,0,0,1,1,2,0,2,1,3,0,0,20,CL
88e357ef,21,13,8,11,2,10,25,15,9,0,9,5,26,3,0,20,CL
88f130ed,8,6,7,0,1,5,5,0,1,1,0,1,9,4,0,20,CL
892d5bb1,9,7,2,5,2,5,19,14,5,0,5,5,14,1,0,20,CL
89565ac5,0,0,0,0,0,0,0,0,0,0,0,0,0,0,0,20,CL
89ac64a6,11,7,8,2,1,5,10,5,7,4,3,9,20,9,0,20,CL
89b2c8a9,17,9,6,6,5,5,13,8,6,0,6,4,21,0,0,20,CL
89d10e53,8,7,2,5,1,4,5,1,4,1,3,8,16,8,0,20,CL
89f951b5,6,5,5,1,0,3,7,4,4,2,2,10,16,2,1,20,CL
8a08491a,0,0,0,0,0,0,5,5,4,1,3,0,0,2,0,20,CL
8a6ab963,0,0,0,0,0,0,0,0,0,0,0,0,0,0,0,20,CL
8aafd64f,1,0,0,0,1,0,3,3,1,0,1,1,2,1,0,20,CL
8ac501f5,0,0,0,0,0,0,0,0,0,0,0,0,0,2,0,20,CL
8b3ab7ad,14,9,7,4,3,8,16,8,6,4,2,5,19,7,0,20,CL
8b529245,1,1,0,1,0,1,3,2,1,0,1,0,1,1,0,20,CL
8b8a56ce,4,2,3,1,0,4,6,2,0,0,0,0,4,6,0,20,CL
8b9ebd03,5,2,1,4,0,2,8,6,6,0,6,0,5,1,0,20,CL
8bbe2df5,4,3,2,1,1,0,8,8,5,1,4,1,5,4,0,20,CL
8c5f1522,0,0,0,0,0,0,2,2,0,0,0,0,0,0,0,20,CL
8c90fd7a,2,0,1,0,1,0,3,3,4,1,3,3,5,4,0,20,CL
8ce063f9,3,2,2,1,0,1,4,3,3,0,3,3,6,4,0,20,CL
8ce30c57,9,5,1,4,4,3,12,9,6,1,5,6,15,2,0,20,CL
8d78e732,10,6,2,6,2,2,10,8,5,0,5,2,12,8,0,20,CL
8da74c05,0,0,0,0,0,0,0,0,0,0,0,0,0,1,0,20,CL
8e034340,8,6,2,3,3,2,4,2,1,0,1,3,11,0,0,20,CL
8e7f49d3,20,12,12,8,0,6,22,16,8,5,3,23,43,2,0,20,CL
8ea2c099,2,2,2,0,0,2,2,0,0,0,0,0,2,2,0,20,CL
8f21b7bd,0,0,0,0,0,0,0,0,0,0,0,0,0,0,0,20,CL
8f5bfaac,0,0,0,0,0,0,0,0,0,0,0,0,0,0,0,20,CL
8f5e92a6,6,4,2,3,1,2,4,2,2,0,2,4,10,2,0,20,CL
8f62b6ee,0,0,0,0,0,0,0,0,0,0,0,0,0,3,0,20,CL
8f696594,3,2,1,2,0,2,4,2,4,0,4,1,4,0,0,20,CL
8ff2354e,12,7,9,3,0,6,10,4,5,0,5,7,19,17,0,20,CL
903b6e8b,0,0,0,0,0,0,0,0,0,0,0,1,1,2,0,20,CL
90f87966,7,7,5,2,0,6,6,0,4,2,2,3,10,19,0,20,CL
9139bb12,4,2,2,2,0,1,2,1,6,0,6,1,5,0,0,20,CL
91e58f66,0,0,0,0,0,0,3,3,3,0,3,1,1,0,0,20,CL
921f6058,25,15,19,6,0,14,18,4,8,5,3,17,42,16,1,20,CL
92432bc6,7,7,6,1,0,6,12,6,4,0,4,8,15,4,0,20,CL
92e7e919,8,1,3,5,0,4,13,9,2,0,2,2,10,1,0,20,CL
934e1968,7,2,4,1,2,2,10,8,8,0,8,1,8,4,0,20,CL
935e6b8f,11,7,2,8,1,3,8,5,7,0,7,8,19,2,0,20,CL
9413b19f,0,0,0,0,0,0,0,0,0,0,0,1,1,2,1,20,CL
94b2001f,13,5,6,5,2,6,7,1,1,1,0,8,21,14,0,20,CL
952e0df2,0,0,0,0,0,0,0,0,0,0,0,0,0,0,0,20,CL
9591723b,0,0,0,0,0,0,1,1,0,0,0,1,1,0,0,20,CL
96094cbc,6,1,2,2,2,2,13,11,5,2,3,2,8,2,0,20,CL
9674002f,8,5,3,4,1,7,13,6,3,0,3,2,10,2,0,20,CL
9744ff80,8,3,3,4,1,1,14,13,4,0,4,1,9,1,0,20,CL
9778d8dd,0,0,0,0,0,0,0,0,1,1,0,0,0,1,0,20,CL
980522ec,5,3,0,5,0,3,11,8,1,0,1,0,5,4,0,20,CL
984a5a64,1,1,1,0,0,0,2,2,2,1,1,0,1,3,0,20,CL
98d2c2c4,15,9,4,10,1,9,20,11,10,3,7,9,24,10,0,20,CL
997fff07,0,0,0,0,0,0,1,1,2,1,1,3,3,6,0,20,CL
9a1f2e1c,2,2,1,0,1,1,2,1,3,1,2,1,3,1,0,20,CL
9a2e0ccc,8,7,2,4,2,4,9,5,5,0,5,1,9,1,0,20,CL
9ae9eaea,9,1,7,2,0,1,4,3,6,3,3,12,21,35,1,20,CL
9d12e142,0,0,0,0,0,0,0,0,1,0,1,0,0,4,1,20,CL
9d40ca9c,5,4,3,2,0,3,6,3,5,1,4,10,15,9,0,20,CL
9d60028d,6,4,2,4,0,2,5,3,1,0,1,2,8,3,0,20,CL
9d689a5b,15,12,8,5,2,9,18,9,5,0,5,7,22,5,0,20,CL
9e1035f8,8,5,1,7,0,4,12,8,10,0,10,5,13,5,0,20,CL
9e1577aa,4,1,1,1,2,1,3,2,6,2,4,2,6,5,0,20,CL
9efa1d25,3,2,2,0,1,0,1,1,0,0,0,0,3,0,0,20,CL
9f8e9423,9,6,5,4,0,3,7,4,6,5,1,10,19,22,3,20,CL
9f936061,0,0,0,0,0,0,0,0,0,0,0,0,0,0,0,20,CL
a022e78c,6,4,2,3,1,2,11,9,3,1,2,3,9,3,1,20,CL
a0b4bb3e,6,3,4,1,1,2,5,3,1,0,1,3,9,0,0,20,CL
a167537f,6,1,4,2,0,2,13,11,7,1,6,2,8,2,0,20,CL
a179d516,0,0,0,0,0,0,0,0,0,0,0,0,0,1,1,20,CL
a190d597,0,0,0,0,0,0,2,2,2,0,2,0,0,8,0,20,CL
a29b1131,1,1,1,0,0,1,1,0,0,0,0,0,1,0,0,20,CL
a2abe631,0,0,0,0,0,0,1,1,0,0,0,1,1,1,0,20,CL
a39bb753,3,3,1,0,2,1,6,5,0,0,0,3,6,0,0,20,CL
a3b0ed18,1,0,1,0,0,1,1,0,0,0,0,0,1,4,1,20,CL
a45eac1f,1,1,0,1,0,0,1,1,1,0,1,0,1,0,0,20,CL
a4effc55,4,3,3,1,0,1,4,3,2,1,1,3,7,10,0,20,CL
a5296e55,5,4,2,2,1,3,6,3,4,1,3,5,10,4,0,20,CL
a58bb1e1,0,0,0,0,0,0,1,1,1,0,1,4,4,1,0,20,CL
a5db0bec,14,6,4,8,2,5,19,14,12,2,10,5,19,2,0,20,CL
a6154613,2,2,0,2,0,1,3,2,2,0,2,4,6,4,0,20,CL
a634b9d2,5,3,3,2,0,3,7,4,3,0,3,2,7,3,0,20,CL
a65ce836,1,1,0,1,0,1,5,4,2,0,2,1,2,1,0,20,CL
a6951bf8,9,7,5,2,2,3,5,2,1,1,0,11,20,12,0,20,CL
a69e4806,4,4,4,0,0,2,7,5,6,0,6,4,8,1,0,20,CL
a7a9d95a,1,1,0,0,1,0,1,1,0,0,0,4,5,2,0,20,CL
a8542814,1,0,1,0,0,1,8,7,1,0,1,2,3,5,0,20,CL
a8741470,1,0,0,1,0,0,0,0,0,0,0,0,1,8,0,20,CL
a8f21b9f,1,1,0,1,0,0,1,1,0,0,0,0,1,0,0,20,CL
a99138af,1,0,0,0,1,1,1,0,0,0,0,0,1,0,0,20,CL
a9aa0d1d,6,4,1,4,1,2,9,7,0,0,0,5,11,2,0,20,CL
a9dc785c,0,0,0,0,0,0,0,0,0,0,0,0,0,0,0,20,CL
aad56ca3,0,0,0,0,0,0,0,0,0,0,0,0,0,0,0,20,CL
aad9c3f3,1,0,0,0,1,0,1,1,0,0,0,0,1,0,0,20,CL
ab77f2d9,4,2,2,2,0,3,15,12,3,0,3,4,8,3,1,20,CL
abe66106,4,4,2,1,1,1,5,4,1,0,1,1,5,2,0,20,CL
ac3fb1be,5,2,5,0,0,2,6,4,6,5,1,3,8,16,0,20,CL
ac4003af,0,0,0,0,0,0,0,0,0,0,0,0,0,1,0,20,CL
ac73ec79,26,13,16,7,3,13,17,4,8,1,7,12,38,28,2,20,CL
ac7e640b,2,1,1,1,0,1,9,8,1,1,0,5,7,11,0,20,CL
ac861941,2,2,1,1,0,1,5,4,4,1,3,4,6,8,0,20,CL
aca5a6f7,0,0,0,0,0,0,0,0,0,0,0,1,1,0,0,20,CL
ad3389d5,0,0,0,0,0,0,0,0,0,0,0,1,1,1,2,20,CL
ad6df2d5,11,5,5,6,0,5,18,13,6,2,4,17,28,8,1,20,CL
adfc9123,4,3,2,2,0,3,5,2,9,5,4,10,14,42,2,20,CL
ae44e8e2,12,6,4,8,0,1,9,8,7,1,6,6,18,11,0,20,CL
ae4e2852,3,3,0,3,0,3,5,2,3,0,3,1,4,9,0,20,CL
ae59b359,6,5,3,3,0,2,7,5,7,1,6,12,18,9,0,20,CL
aeed5c06,1,0,0,1,0,0,2,2,1,0,1,0,1,0,0,20,CL
aef6e670,22,14,14,8,0,12,16,4,7,3,4,15,37,32,1,20,CL
b05e2dbd,15,9,10,5,0,6,11,5,8,3,5,3,18,17,0,20,CL
b088363d,0,0,0,0,0,0,0,0,0,0,0,0,0,1,0,20,CL
b0b902c8,13,9,11,1,1,6,12,6,1,0,1,4,17,13,0,20,CL
b182a240,7,3,1,4,2,3,12,9,4,0,4,2,9,0,0,20,CL
b19db005,0,0,0,0,0,0,1,1,3,1,2,0,0,0,0,20,CL
b1f4086c,9,7,4,3,2,5,11,6,9,3,6,9,18,18,0,20,CL
b217ef29,2,1,0,2,0,1,3,2,1,0,1,1,3,4,0,20,CL
b2336681,4,4,4,0,0,3,4,1,4,4,0,2,6,17,1,20,CL
b2bd0f6c,4,3,2,2,0,2,5,3,2,0,2,3,7,2,0,20,CL
b34c63a5,2,0,1,1,0,2,3,1,0,0,0,0,2,0,0,20,CL
b35db3f6,3,1,0,3,0,0,1,1,1,1,0,0,3,4,0,20,CL
b3e4a674,3,2,2,1,0,2,6,4,2,1,1,4,7,12,0,20,CL
b400bde0,6,3,2,3,1,0,8,8,5,1,4,6,12,4,0,20,CL
b5f7d10b,3,3,3,0,0,2,8,6,0,0,0,1,4,8,0,20,CL
b66315ae,6,3,1,2,3,3,8,5,6,2,4,8,14,3,0,20,CL
b698cfc6,4,2,2,2,0,2,3,1,2,2,0,5,9,4,1,20,CL
b70bde8f,1,0,1,0,0,0,5,5,1,0,1,2,3,2,0,20,CL
b74277a0,8,5,5,2,1,7,7,0,2,1,1,5,13,6,0,20,CL
b7481dc0,0,0,0,0,0,0,0,0,0,0,0,0,0,0,0,20,CL
b7ca5c51,8,5,5,3,0,5,6,1,11,8,3,12,20,41,0,20,CL
b825a650,4,1,3,1,0,3,5,2,0,0,0,5,9,6,0,20,CL
b9fbae28,10,4,3,7,0,4,10,6,8,1,7,9,19,3,1,20,CL
ba23a904,3,2,2,1,0,0,2,2,4,4,0,1,4,15,1,20,CL
bac46a10,13,7,5,8,0,7,19,12,6,2,4,10,23,16,2,20,CL
bb6c6331,0,0,0,0,0,0,2,2,1,1,0,0,0,0,0,20,CL
bc647827,0,0,0,0,0,0,2,2,0,0,0,1,1,0,0,20,CL
bcb2ccd8,0,0,0,0,0,0,0,0,0,0,0,0,0,2,1,20,CL
bd142efb,5,4,3,2,0,0,1,1,3,2,1,7,12,19,1,20,CL
bd20f4eb,1,1,0,1,0,0,1,1,1,0,1,1,2,0,0,20,CL
bd6351cd,17,14,7,5,5,10,17,7,4,0,4,13,30,5,0,20,CL
beb391dd,8,6,3,3,2,5,13,8,5,2,3,8,16,8,0,20,CL
bee0bab1,3,2,0,3,0,2,10,8,6,1,5,2,5,1,0,20,CL
beec76cc,17,10,4,6,7,5,10,5,4,0,4,6,23,1,0,20,CL
c01f247a,0,0,0,0,0,0,1,1,1,0,1,1,1,0,0,20,CL
c06d1086,3,3,0,3,0,0,0,0,2,0,2,0,3,3,0,20,CL
c0c7ff58,10,7,6,2,2,6,22,16,11,2,9,19,29,7,0,20,CL
c0cddebe,7,4,2,4,1,1,6,5,5,0,5,7,14,6,1,20,CL
c14bc029,18,8,9,4,5,9,19,10,5,3,2,13,31,20,0,20,CL
c1b7847c,38,21,14,20,4,19,46,27,19,2,17,4,42,5,0,20,CL
c20bdcd7,10,5,5,4,1,5,9,4,1,0,1,3,13,3,0,20,CL
c24544c7,5,4,3,2,0,2,7,5,4,2,2,2,7,2,0,20,CL
c2604e3c,0,0,0,0,0,0,4,4,0,0,0,0,0,2,0,20,CL
c27ae377,0,0,0,0,0,0,2,2,0,0,0,0,0,0,0,20,CL
c3ee18ef,1,1,0,1,0,0,1,1,2,0,2,2,3,2,0,20,CL
c43e5e7e,4,1,1,3,0,1,11,10,0,0,0,2,6,4,0,20,CL
c459a650,20,11,11,4,5,11,14,3,6,4,2,8,28,13,0,20,CL
c47541e0,2,1,2,0,0,1,3,2,3,0,3,1,3,5,0,20,CL
c50281a0,7,6,4,3,0,3,7,4,4,0,4,5,12,5,0,20,CL
c50e5bba,15,10,10,4,1,5,21,16,6,0,6,12,27,17,0,20,CL
c56dc39e,19,6,13,5,1,12,25,13,6,2,4,9,28,13,0,20,CL
c56ee8f7,0,0,0,0,0,0,0,0,0,0,0,0,0,3,1,20,CL
c63f6e46,1,1,0,0,1,1,4,3,2,0,2,0,1,1,0,20,CL
c691bfe2,13,6,6,3,4,5,10,5,3,0,3,4,17,2,0,20,CL
c6e5d20f,9,6,5,3,1,4,8,4,9,0,9,14,23,5,1,20,CL
c707411f,3,2,3,0,0,1,3,2,9,5,4,7,10,38,2,20,CL
c7526c18,8,5,4,3,1,1,2,1,9,6,3,3,11,8,0,20,CL
c78b352d,0,0,0,0,0,0,0,0,0,0,0,1,1,1,0,20,CL
c8e65157,11,6,10,1,0,7,11,4,12,6,6,13,24,33,0,20,CL
c904f3d5,9,7,8,1,0,7,8,1,9,8,1,3,12,15,0,20,CL
c9cb972b,0,0,0,0,0,0,0,0,0,0,0,1,1,3,0,20,CL
ca45605e,4,4,0,1,3,1,3,2,4,0,4,1,5,1,0,20,CL
ca5828af,0,0,0,0,0,0,0,0,0,0,0,0,0,0,0,20,CL
ca8033cb,11,7,8,3,0,5,15,10,11,4,7,16,27,26,1,20,CL
cbbfa2e7,3,1,0,2,1,0,1,1,2,0,2,2,5,1,0,20,CL
cc700722,23,15,13,8,2,16,30,14,14,2,12,4,27,11,1,20,CL
cc86b9a3,15,11,2,9,4,9,20,11,8,2,6,11,26,3,0,20,CL
cc96d422,0,0,0,0,0,0,1,1,0,0,0,0,0,0,0,20,CL
cce181df,18,9,4,12,2,6,10,4,11,3,8,13,31,7,0,20,CL
cd1acf9d,16,11,7,8,1,9,14,5,2,1,1,7,23,6,0,20,CL
ce30bfc8,6,2,4,2,0,3,4,1,4,0,4,2,8,2,0,20,CL
ce4246f5,6,5,5,1,0,1,2,1,7,3,4,5,11,28,0,20,CL
ce9e8024,3,1,1,1,1,2,4,2,2,2,0,3,6,9,0,20,CL
cea4ee8f,6,4,3,2,1,3,9,6,5,2,3,5,11,1,0,20,CL
ceb30355,1,1,1,0,0,1,6,5,0,0,0,3,4,6,0,20,CL
cf007308,0,0,0,0,0,0,2,2,2,1,1,0,0,1,0,20,CL
cf182add,16,12,12,2,2,4,9,5,8,0,8,13,29,24,1,20,CL
cf2a6ace,1,0,1,0,0,0,1,1,0,0,0,0,1,0,0,20,CL
d04b94db,20,11,8,11,1,9,18,9,15,6,9,9,29,12,1,20,CL
d072a976,5,2,2,3,0,3,4,1,3,3,0,6,11,15,0,20,CL
d0b6129f,9,7,5,4,0,5,11,6,7,4,3,7,16,14,1,20,CL
d0d8dd44,11,5,7,4,0,4,6,2,6,3,3,15,26,25,0,20,CL
d125f22f,2,2,1,0,1,0,2,2,1,0,1,0,2,0,0,20,CL
d2110326,7,2,5,2,0,3,4,1,7,6,1,5,12,22,0,20,CL
d2416c2e,7,3,0,4,3,1,6,5,6,3,3,1,8,5,0,20,CL
d248cd8f,25,14,17,8,0,9,11,2,7,4,3,12,37,29,0,20,CL
d3de9af0,0,0,0,0,0,0,2,2,4,2,2,0,0,4,0,20,CL
d4232ba9,4,2,1,1,2,1,9,8,4,2,2,7,11,0,0,20,CL
d436eb94,0,0,0,0,0,0,0,0,0,0,0,0,0,5,1,20,CL
d4e93bab,2,0,2,0,0,1,12,11,4,1,3,6,8,2,0,20,CL
d504b3e1,5,4,1,3,1,2,3,1,0,0,0,0,5,4,0,20,CL
d5c04323,5,4,3,1,1,2,7,5,6,4,2,14,19,22,0,20,CL
d5f2f82b,22,9,11,11,0,10,14,4,20,12,8,17,39,28,0,20,CL
d6a889ea,6,4,4,2,0,4,4,0,0,0,0,3,9,5,0,20,CL
d6e53a3a,7,5,5,2,0,5,5,0,8,5,3,6,13,20,0,20,CL
d70ce98e,2,1,0,1,1,0,5,5,3,0,3,2,4,0,0,20,CL
d72f8d9e,3,3,2,1,0,2,3,1,8,2,6,5,8,9,0,20,CL
d7553721,9,3,3,5,1,8,17,9,5,1,4,5,14,5,0,20,CL
d75f3980,5,5,5,0,0,3,4,1,2,0,2,4,9,7,0,20,CL
d781d855,18,12,8,8,2,12,21,9,7,0,7,10,28,11,0,20,CL
d7c09951,8,3,3,4,1,4,16,12,6,3,3,5,13,7,0,20,CL
d83bbc54,11,7,6,5,0,10,18,8,8,1,7,14,25,20,2,20,CL
d8feae4a,11,6,10,1,0,7,13,6,11,5,6,4,15,17,0,20,CL
d9a5d930,1,1,0,0,1,1,4,3,3,1,2,1,2,0,0,20,CL
da7b447d,8,6,7,1,0,5,7,2,6,4,2,6,14,13,0,20,CL
da974c7b,14,10,11,2,1,8,16,8,16,10,6,12,26,31,0,20,CL
dad4b285,15,4,8,7,0,4,7,3,5,3,2,11,26,21,1,20,CL
dae8623e,2,1,1,1,0,0,1,1,4,1,3,0,2,4,0,20,CL
db3cb6ee,5,2,5,0,0,2,5,3,9,6,3,12,17,33,0,20,CL
db4ed67b,0,0,0,0,0,0,1,1,1,0,1,1,1,0,0,20,CL
db750822,1,0,0,1,0,0,1,1,3,0,3,1,2,1,0,20,CL
dba67bc4,11,6,5,5,1,9,19,10,10,5,5,10,21,5,0,20,CL
dbd3a428,11,6,4,5,2,2,9,7,6,0,6,4,15,7,0,20,CL
dbf053da,1,1,1,0,0,1,8,7,1,0,1,2,3,1,0,20,CL
dc008610,1,1,0,1,0,1,2,1,3,0,3,0,1,1,0,20,CL
dc29b608,0,0,0,0,0,0,0,0,0,0,0,0,0,0,0,20,CL
dc3fa3b5,11,8,6,5,0,4,15,11,5,0,5,7,18,7,0,20,CL
dc62b55d,2,2,0,0,2,0,3,3,0,0,0,3,5,0,0,20,CL
dda3969e,1,0,0,1,0,0,1,1,0,0,0,0,1,0,0,20,CL
de39485a,1,1,0,1,0,0,4,4,3,0,3,0,1,0,0,20,CL
dea698d9,1,0,1,0,0,0,3,3,1,0,1,4,5,4,0,20,CL
df69b544,7,3,2,1,4,3,12,9,5,0,5,6,13,5,1,20,CL
dff153a4,8,5,3,3,2,5,14,9,2,0,2,5,13,5,0,20,CL
e0314d87,4,2,3,1,0,2,5,3,2,0,2,8,12,10,0,20,CL
e06683ca,9,5,6,3,0,2,3,1,2,1,1,9,18,32,1,20,CL
e07c2923,5,2,3,1,1,3,11,8,7,0,7,2,7,0,0,20,CL
e0900238,0,0,0,0,0,0,1,1,1,0,1,1,1,0,0,20,CL
e0921a4f,1,1,1,0,0,0,3,3,4,1,3,1,2,0,0,20,CL
e0bc6fdc,2,1,0,1,1,1,4,3,3,0,3,2,4,3,0,20,CL
e162b013,10,7,7,3,0,8,15,7,3,2,1,11,21,11,0,20,CL
e1cbb531,0,0,0,0,0,0,0,0,1,0,1,0,0,0,0,20,CL
e204ec12,6,3,3,3,0,3,4,1,3,0,3,3,9,0,0,20,CL
e26f559f,10,9,8,2,0,6,12,6,9,1,8,15,25,6,1,20,CL
e2716bd0,0,0,0,0,0,0,1,1,0,0,0,2,2,0,0,20,CL
e280527c,6,3,1,5,0,3,26,23,6,1,5,9,15,5,0,20,CL
e288d4b3,0,0,0,0,0,0,0,0,0,0,0,1,1,0,0,20,CL
e2dde94c,7,2,5,1,1,2,9,7,7,2,5,1,8,4,0,20,CL
e33c06cf,11,7,8,2,1,5,6,1,6,4,2,4,15,7,0,20,CL
e342ad68,2,1,0,0,2,0,2,2,2,0,2,0,2,0,0,20,CL
e34fc66d,3,2,2,1,0,1,3,2,6,4,2,7,10,36,0,20,CL
e3cceee6,2,2,2,0,0,1,1,0,2,2,0,1,3,4,0,20,CL
e3d0b0c4,8,6,6,2,0,5,5,0,6,5,1,11,19,40,0,20,CL
e40d028b,0,0,0,0,0,0,0,0,0,0,0,0,0,1,0,20,CL
e42d61c7,20,5,11,6,3,14,17,3,6,1,5,7,27,10,0,20,CL
e46012d4,8,5,1,4,3,5,17,12,6,0,6,6,14,5,0,20,CL
e599253a,8,5,3,4,1,5,12,7,2,0,2,3,11,8,0,20,CL
e5bf73f3,0,0,0,0,0,0,1,1,0,0,0,0,0,0,0,20,CL
e613313c,0,0,0,0,0,0,1,1,1,0,1,2,2,1,0,20,CL
e6bc67d7,4,4,2,2,0,1,2,1,1,0,1,0,4,0,0,20,CL
e6eadfb8,7,6,5,2,0,5,8,3,2,0,2,11,18,12,0,20,CL
e7986081,3,1,0,2,1,0,3,3,9,4,5,4,7,8,0,20,CL
e81f0356,10,7,7,3,0,5,9,4,4,2,2,4,14,22,1,20,CL
e8ed3abc,1,0,0,1,0,1,3,2,1,0,1,0,1,0,0,20,CL
e9971f2d,0,0,0,0,0,0,1,1,2,1,1,0,0,1,0,20,CL
e9c0c1b2,0,0,0,0,0,0,0,0,0,0,0,1,1,3,0,20,CL
eb2fe5b6,2,1,1,1,0,0,3,3,1,0,1,0,2,2,0,20,CL
eb58eef0,7,4,5,2,0,0,2,2,6,0,6,5,12,1,0,20,CL
ebc56869,1,1,0,1,0,0,1,1,0,0,0,0,1,0,0,20,CL
ecada4fc,0,0,0,0,0,0,0,0,0,0,0,1,1,2,0,20,CL
ed1e53f3,4,2,2,1,1,4,4,0,2,0,2,2,6,3,0,20,CL
ed2b33cb,3,1,3,0,0,1,1,0,0,0,0,0,3,0,0,20,CL
ed87a229,6,2,5,1,0,4,14,10,3,0,3,2,8,7,1,20,CL
ed9f7cfe,23,15,16,3,4,12,22,10,7,0,7,16,39,25,0,20,CL
ee3519f5,22,14,15,7,0,11,23,12,6,3,3,7,29,11,1,20,CL
ee8508c0,0,0,0,0,0,0,0,0,0,0,0,0,0,5,0,20,CL
ee926a02,8,2,4,4,0,2,9,7,4,0,4,2,10,12,0,20,CL
ee93c1a9,1,1,0,1,0,0,2,2,3,0,3,0,1,2,0,20,CL
ee950928,6,3,0,5,1,1,13,12,5,0,5,2,8,1,0,20,CL
eed332df,1,1,0,0,1,0,0,0,1,0,1,0,1,4,0,20,CL
ef619b0b,2,1,1,0,1,0,2,2,0,0,0,0,2,1,0,20,CL
ef9c1c95,18,12,8,8,2,3,18,15,7,3,4,11,29,6,0,20,CL
f0021247,3,0,2,1,0,0,6,6,8,0,8,7,10,3,0,20,CL
f00de885,0,0,0,0,0,0,1,1,0,0,0,0,0,2,1,20,CL
f0661424,27,12,9,13,5,12,20,8,7,3,4,18,45,17,1,20,CL
f0da930c,3,2,3,0,0,2,4,2,5,4,1,1,4,20,0,20,CL
f0f7f62f,0,0,0,0,0,0,1,1,0,0,0,0,0,4,1,20,CL
f0fc9d0e,1,1,0,0,1,0,0,0,6,3,3,3,4,7,0,20,CL
f25c8e3a,9,7,4,5,0,2,6,4,1,0,1,2,11,2,0,20,CL
f2d063ec,8,5,3,4,1,2,6,4,5,3,2,5,13,4,0,20,CL
f315ca93,17,10,13,4,0,10,15,5,6,3,3,12,29,25,1,20,CL
f3600c02,5,3,2,2,1,2,8,6,1,0,1,3,8,0,0,20,CL
f4290206,5,4,4,1,0,1,3,2,1,0,1,6,11,14,0,20,CL
f520049f,2,1,1,1,0,1,2,1,0,0,0,2,4,6,0,20,CL
f586779e,5,2,0,4,1,1,4,3,7,2,5,1,6,10,0,20,CL
f5ba8903,0,0,0,0,0,0,0,0,0,0,0,0,0,0,0,20,CL
f5c8b425,11,6,4,6,1,4,16,12,2,0,2,3,14,1,0,20,CL
f5dfc256,0,0,0,0,0,0,0,0,0,0,0,0,0,0,0,20,CL
f6ac68c1,6,3,6,0,0,2,5,3,2,1,1,3,9,36,1,20,CL
f7036e1c,6,2,0,5,1,2,10,8,4,0,4,2,8,1,0,20,CL
f76e6b4e,0,0,0,0,0,0,0,0,0,0,0,0,0,0,1,20,CL
f7d50789,7,3,5,2,0,4,6,2,7,3,4,3,10,34,0,20,CL
f81ef10d,7,3,3,3,1,2,10,8,10,2,8,6,13,4,0,20,CL
f833a830,7,3,4,2,1,1,18,17,4,0,4,3,10,2,0,20,CL
f9acca3a,14,10,8,6,0,8,8,0,7,2,5,4,18,5,1,20,CL
f9e0c603,0,0,0,0,0,0,0,0,0,0,0,1,1,0,1,20,CL
fa18c72e,4,2,0,1,3,0,7,7,3,1,2,5,9,0,0,20,CL
fa274d97,0,0,0,0,0,0,3,3,1,0,1,1,1,2,0,20,CL
fc46aab1,0,0,0,0,0,0,0,0,0,0,0,0,0,0,0,20,CL
fc4f85b1,16,4,13,3,0,9,14,5,10,5,5,15,31,15,0,20,CL
fc62f087,2,1,1,1,0,1,1,0,2,1,1,0,2,1,0,20,CL
fcb38f57,0,0,0,0,0,0,0,0,0,0,0,0,0,2,0,20,CL
fd51b456,0,0,0,0,0,0,4,4,2,0,2,1,1,0,0,20,CL
fdd60087,5,4,5,0,0,2,2,0,0,0,0,3,8,4,0,20,CL
fdf3cb77,11,4,5,5,1,5,9,4,6,3,3,6,17,12,0,20,CL
fe2db476,9,8,4,4,1,4,13,9,1,0,1,9,18,12,0,20,CL
fe641c1a,7,2,7,0,0,3,4,1,6,1,5,4,11,7,0,20,CL
fed17f5a,5,2,2,2,1,2,10,8,4,0,4,1,6,3,0,20,CL
fed7cb61,2,1,2,0,0,1,4,3,2,0,2,1,3,5,0,20,CL
ff0ab48c,6,6,5,1,0,6,12,6,7,0,7,5,11,19,0,20,CL
ff579c7e,11,5,2,9,0,5,13,8,7,1,6,11,22,6,1,20,CL
0000acda,18,12,9,5,4,10,24,14,11,1,10,4,22,9,0,20,ITA
008a6e6d,29,16,20,9,0,14,28,14,29,19,10,25,54,118,1,20,ITA
00b0bb87,14,4,9,4,1,6,9,3,10,6,4,16,30,44,0,20,ITA
016ff750,6,5,3,2,1,4,8,4,5,0,5,1,7,8,1,20,ITA
01b8a2b2,0,0,0,0,0,0,0,0,0,0,0,1,1,10,1,20,ITA
01efac19,24,14,12,10,2,7,29,22,24,2,22,9,33,24,2,20,ITA
023937a9,27,14,18,9,0,10,26,16,17,3,14,8,35,39,0,20,ITA
02b2937c,21,11,5,14,2,6,25,19,11,1,10,11,32,21,0,20,ITA
02caf6e0,20,11,10,7,3,10,31,21,11,1,10,8,28,34,0,20,ITA
0375723e,19,10,4,12,3,9,38,29,14,0,14,7,26,1,0,20,ITA
03f946ed,9,4,2,7,0,3,17,14,11,5,6,1,10,27,0,20,ITA
0489bb30,3,1,2,0,1,0,5,5,4,0,4,1,4,2,0,20,ITA
04989945,2,0,0,1,1,1,3,2,1,0,1,3,5,0,0,20,ITA
04df29a5,0,0,0,0,0,0,0,0,0,0,0,0,0,0,0,20,ITA
05e19d6a,54,29,28,18,8,16,52,36,34,5,29,34,88,32,2,20,ITA
060606ec,11,8,5,3,3,5,8,3,11,0,11,5,16,6,0,20,ITA
0728bebe,59,31,25,23,11,18,53,35,29,2,27,15,74,31,1,20,ITA
07767f42,25,13,9,12,4,11,35,24,12,6,6,19,44,23,1,20,ITA
07abb358,32,20,13,15,4,12,34,22,18,1,17,8,40,13,1,20,ITA
0821331c,47,28,27,19,1,25,36,11,29,15,14,52,99,92,2,20,ITA
085e71a7,0,0,0,0,0,0,1,1,0,0,0,3,3,8,1,20,ITA
089550f5,10,8,4,5,1,6,14,8,8,1,7,9,19,13,0,20,ITA
08990838,3,3,2,1,0,1,3,2,8,6,2,5,8,10,0,20,ITA
08aa9cd1,19,12,1,7,11,5,25,20,19,2,17,9,28,25,0,20,ITA
08f5afaa,1,0,1,0,0,1,2,1,0,0,0,3,4,25,7,20,ITA
091795f2,1,1,1,0,0,0,3,3,2,2,0,4,5,5,0,20,ITA
09538fdb,27,14,7,13,7,6,31,25,23,1,22,10,37,18,1,20,ITA
0a3065c8,13,10,6,5,2,8,12,4,5,1,4,10,23,23,0,20,ITA
0a447501,14,11,2,7,5,3,14,11,13,1,12,5,19,12,1,20,ITA
0a483542,35,18,22,7,6,18,32,14,19,6,13,18,53,41,0,20,ITA
0ab1f153,67,43,32,28,7,35,62,27,22,8,14,35,102,47,0,20,ITA
0b5a292a,31,17,12,12,7,11,29,18,24,5,19,21,52,43,0,20,ITA
0c35d28d,1,1,0,0,1,0,0,0,0,0,0,0,1,0,0,20,ITA
0ccac09c,83,44,51,28,4,50,106,56,40,13,27,58,141,107,0,20,ITA
0cd0e21b,4,2,1,1,2,2,4,2,2,1,1,0,4,9,0,20,ITA
0d077b88,19,9,8,10,1,9,22,13,12,2,10,22,41,23,0,20,ITA
0d422df7,1,0,1,0,0,1,2,1,0,0,0,4,5,11,1,20,ITA
0d82903c,44,26,23,14,7,12,33,21,26,6,20,47,91,46,3,20,ITA
0db169ae,39,25,16,20,3,16,55,39,36,14,22,41,80,42,0,20,ITA
0dfce079,0,0,0,0,0,0,0,0,0,0,0,0,0,1,0,20,ITA
0e21fc3c,18,7,9,3,6,6,24,18,12,3,9,8,26,9,0,20,ITA
0f47717b,0,0,0,0,0,0,0,0,0,0,0,1,1,0,0,20,ITA
103b7264,0,0,0,0,0,0,0,0,0,0,0,1,1,2,0,20,ITA
1079c685,5,2,1,2,2,3,9,6,2,0,2,2,7,7,0,20,ITA
10dc46f0,0,0,0,0,0,0,0,0,0,0,0,2,2,12,0,20,ITA
10e7f486,22,14,12,8,2,16,23,7,13,3,10,9,31,34,0,20,ITA
1253a12e,1,0,0,0,1,1,1,0,3,1,2,3,4,15,0,20,ITA
1295552e,47,27,33,8,6,27,42,15,10,0,10,22,69,42,0,20,ITA
130a7a3f,24,15,10,11,3,9,42,33,17,2,15,24,48,5,0,20,ITA
13f89eaa,8,5,5,3,0,2,3,1,6,3,3,5,13,29,1,20,ITA
144607cc,52,30,27,18,7,19,62,43,33,7,26,25,77,47,3,20,ITA
149c5f5d,20,12,17,3,0,11,19,8,13,9,4,7,27,34,0,20,ITA
14b8fcdf,8,6,4,4,0,4,5,1,4,4,0,11,19,18,0,20,ITA
157d29b6,9,6,3,5,1,5,18,13,7,0,7,4,13,4,0,20,ITA
15d0c248,42,24,24,15,3,19,32,13,39,30,9,41,83,69,2,20,ITA
162efffd,61,31,31,26,4,27,65,38,38,3,35,29,90,8,1,20,ITA
16569fef,64,35,34,20,10,30,49,19,41,7,34,25,89,49,0,20,ITA
16657b95,25,15,6,14,5,8,27,19,13,4,9,22,47,23,0,20,ITA
16b9d5cf,35,24,21,14,0,10,21,11,19,11,8,30,65,64,1,20,ITA
16bb656a,15,12,11,4,0,5,11,6,6,5,1,12,27,26,0,20,ITA
173061c0,57,32,37,12,8,30,60,30,35,18,17,53,110,100,0,20,ITA
1770bd68,59,41,43,15,1,36,68,32,26,6,20,17,76,41,1,20,ITA
17f3620a,9,4,0,7,2,3,11,8,5,2,3,3,12,10,0,20,ITA
18736214,0,0,0,0,0,0,0,0,0,0,0,0,0,0,0,20,ITA
1880614f,10,6,4,4,2,2,9,7,7,2,5,8,18,7,0,20,ITA
18f9dbd0,18,9,13,3,2,14,17,3,6,1,5,9,27,27,0,20,ITA
197640fd,31,20,9,16,6,13,25,12,34,5,29,17,48,23,0,20,ITA
19e4eab9,56,25,34,19,3,26,46,20,40,20,20,45,101,77,0,20,ITA
1ab6fad3,1,1,0,0,1,0,0,0,1,0,1,0,1,0,0,20,ITA
1b82f8df,29,19,13,12,4,10,34,24,20,5,15,8,37,15,1,20,ITA
1cac99dc,6,2,3,2,1,4,8,4,3,0,3,3,9,5,0,20,ITA
1cadaf34,0,0,0,0,0,0,0,0,1,0,1,0,0,0,0,20,ITA
1d00a56c,0,0,0,0,0,0,0,0,0,0,0,1,1,0,0,20,ITA
1d0bb7e4,3,2,2,1,0,0,2,2,4,0,4,6,9,6,1,20,ITA
1e12c53b,18,9,14,3,1,9,16,7,13,7,6,17,35,48,1,20,ITA
1ea5f91c,27,13,14,10,3,10,42,32,30,3,27,22,49,22,0,20,ITA
1eeeff8a,23,13,15,6,2,12,29,17,14,2,12,10,33,25,0,20,ITA
1f9328da,30,18,9,12,9,9,29,20,25,6,19,13,43,30,0,20,ITA
1fca9171,11,5,2,6,3,3,15,12,9,1,8,3,14,2,1,20,ITA
20730eae,7,4,2,5,0,3,9,6,4,0,4,0,7,5,0,20,ITA
20b3a502,21,14,15,5,1,7,18,11,12,2,10,12,33,7,0,20,ITA
20b9f052,1,0,1,0,0,1,5,4,0,0,0,1,2,10,3,20,ITA
2146785a,52,33,28,22,2,17,41,24,23,5,18,21,73,47,1,20,ITA
217875a4,25,11,17,8,0,14,22,8,21,14,7,14,39,41,0,20,ITA
22051fbe,32,21,22,8,2,15,28,13,19,10,9,25,57,42,0,20,ITA
228f73ae,3,2,1,2,0,2,4,2,2,0,2,0,3,1,0,20,ITA
230a2fac,59,35,27,19,13,32,61,29,27,11,16,28,87,54,0,20,ITA
2334478a,38,22,14,19,5,15,39,24,16,4,12,10,48,26,1,20,ITA
244f57b9,13,9,7,4,2,5,23,18,11,2,9,14,27,17,0,20,ITA
246d153b,45,24,23,18,4,17,37,20,24,6,18,41,86,61,0,20,ITA
263b855a,0,0,0,0,0,0,0,0,0,0,0,0,0,0,0,20,ITA
26db8853,28,9,19,6,3,13,42,29,14,6,8,33,61,19,0,20,ITA
282b3a4d,3,2,0,2,1,1,3,2,1,0,1,1,4,5,0,20,ITA
28a15394,0,0,0,0,0,0,0,0,0,0,0,0,0,0,1,20,ITA
2990c466,13,5,10,3,0,3,5,2,20,16,4,12,25,61,1,20,ITA
2a1beb34,77,43,36,29,12,34,75,41,32,8,24,46,123,45,0,20,ITA
2b15a82a,4,4,1,3,0,3,5,2,0,0,0,2,6,0,0,20,ITA
2c0f8e9e,9,7,1,4,4,5,13,8,7,0,7,3,12,1,0,20,ITA
2c3a6c21,32,18,11,16,5,10,46,36,34,9,25,16,48,15,1,20,ITA
2c851997,32,21,7,16,9,8,30,22,28,2,26,11,43,10,0,20,ITA
2cfae697,26,16,13,11,2,10,26,16,19,7,12,26,52,22,0,20,ITA
2d970560,53,27,19,26,8,23,51,28,38,10,28,39,92,40,0,20,ITA
2e3596d1,2,2,1,1,0,2,3,1,1,0,1,0,2,2,0,20,ITA
2ead2809,15,8,6,8,1,5,16,11,2,0,2,1,16,14,0,20,ITA
2f3452eb,18,9,13,4,1,12,26,14,16,3,13,24,42,26,0,20,ITA
2f557579,21,15,6,8,7,6,35,29,13,0,13,30,51,4,1,20,ITA
2f7407fa,1,1,1,0,0,1,1,0,0,0,0,0,1,1,0,20,ITA
30223b33,0,0,0,0,0,0,1,1,0,0,0,0,0,2,1,20,ITA
30f5ffa9,39,20,24,14,1,14,33,19,19,11,8,28,67,85,1,20,ITA
31b252fc,0,0,0,0,0,0,0,0,0,0,0,0,0,0,0,20,ITA
32a33c68,1,0,1,0,0,0,0,0,0,0,0,0,1,0,0,20,ITA
331c0a43,42,27,18,20,4,13,43,30,42,27,15,54,96,62,1,20,ITA
33914f14,8,6,1,6,1,3,6,3,11,6,5,8,16,43,0,20,ITA
339c6ed4,4,2,3,1,0,0,0,0,4,2,2,1,5,9,0,20,ITA
339fe0e8,0,0,0,0,0,0,1,1,0,0,0,0,0,7,2,20,ITA
33b8d077,67,35,26,31,10,19,71,52,26,9,17,46,113,46,2,20,ITA
33ecf462,25,15,4,11,10,9,23,14,5,0,5,13,38,9,0,20,ITA
343c0d52,24,13,9,10,5,5,32,27,24,7,17,11,35,16,1,20,ITA
343f753a,1,0,1,0,0,1,2,1,0,0,0,0,1,6,2,20,ITA
3535098b,26,22,11,11,4,14,18,4,10,3,7,11,37,29,0,20,ITA
356c9002,11,6,9,1,1,7,29,22,26,10,16,14,25,33,1,20,ITA
35dd6d80,53,33,34,12,7,24,56,32,25,13,12,53,106,81,1,20,ITA
360b2bb1,3,1,0,3,0,1,8,7,3,3,0,9,12,2,1,20,ITA
3626daea,24,12,11,8,5,12,21,9,13,5,8,20,44,41,0,20,ITA
38ac43d3,14,7,3,8,3,4,19,15,12,1,11,3,17,13,0,20,ITA
39ee6cb6,24,18,14,9,1,15,30,15,28,7,21,32,56,62,1,20,ITA
3b333ac3,36,23,20,9,7,18,38,20,22,7,15,10,46,32,1,20,ITA
3b61c9ec,31,15,20,7,4,15,38,23,19,2,17,21,52,45,2,20,ITA
3b8674e6,58,32,27,18,13,31,66,35,44,9,35,32,90,34,1,20,ITA
3bb7af3b,16,11,6,10,0,6,15,9,4,1,3,5,21,9,0,20,ITA
3bb7f478,16,11,2,7,7,2,13,11,11,4,7,6,22,33,0,20,ITA
3c05c659,5,5,2,2,1,1,5,4,2,1,1,1,6,0,0,20,ITA
3cd3b384,14,9,6,3,5,5,7,2,8,0,8,15,29,21,1,20,ITA
3ead85f9,46,25,28,15,3,16,27,11,32,18,14,56,102,157,1,20,ITA
3ed84b2c,3,2,0,3,0,0,5,5,0,0,0,2,5,1,0,20,ITA
3ef0a2d7,0,0,0,0,0,0,0,0,0,0,0,0,0,0,0,20,ITA
3effaa34,2,1,0,0,2,0,1,1,0,0,0,0,2,0,0,20,ITA
4195b8b6,9,7,8,1,0,4,14,10,15,11,4,15,24,39,0,20,ITA
422ec08a,12,8,2,6,4,1,7,6,12,3,9,3,15,34,0,20,ITA
42b1a58a,15,6,11,4,0,10,14,4,15,9,6,25,40,50,1,20,ITA
43a1bea5,4,3,0,1,3,2,3,1,1,0,1,0,4,0,0,20,ITA
440c84ed,7,3,1,4,2,4,9,5,8,0,8,1,8,4,0,20,ITA
4431aed2,8,6,2,4,2,0,24,24,10,2,8,11,19,7,0,20,ITA
44510fde,8,7,2,3,3,4,11,7,5,1,4,0,8,7,0,20,ITA
44ac04e9,31,20,14,11,6,9,36,27,20,3,17,15,46,26,0,20,ITA
44eb9093,30,16,16,12,2,16,33,17,15,4,11,14,44,25,0,20,ITA
455a2b79,10,6,3,6,1,7,21,14,6,1,5,4,14,3,0,20,ITA
4571fa88,4,4,1,3,0,1,3,2,1,0,1,3,7,3,0,20,ITA
45af5134,7,6,2,4,1,6,12,6,4,1,3,0,7,3,0,20,ITA
45b9b619,13,7,3,7,3,5,24,19,5,1,4,7,20,10,0,20,ITA
4611e028,73,46,25,41,7,22,96,74,45,15,30,49,122,53,1,20,ITA
46f5c54d,53,32,36,12,5,22,53,31,30,11,19,46,99,91,2,20,ITA
46fa7204,25,15,9,13,3,10,21,11,13,1,12,7,32,2,0,20,ITA
47a500ae,25,14,18,7,0,17,34,17,31,22,9,35,60,126,1,20,ITA
482145e9,9,6,2,6,1,3,13,10,7,0,7,5,14,5,0,20,ITA
48d5bd33,22,14,2,17,3,9,31,22,13,2,11,5,27,5,0,20,ITA
4a56052c,36,18,13,16,7,14,43,29,35,5,30,18,54,31,1,20,ITA
4a5a45c7,30,13,9,13,8,12,33,21,28,0,28,15,45,18,0,20,ITA
4a6914ff,0,0,0,0,0,0,2,2,0,0,0,0,0,4,3,20,ITA
4b029b31,4,3,3,1,0,2,5,3,11,6,5,18,22,25,1,20,ITA
4b3e1a38,50,31,26,19,5,26,46,20,50,31,19,30,80,151,1,20,ITA
4c3a6744,17,11,4,8,5,7,16,9,15,0,15,6,23,7,0,20,ITA
4c62d0c8,1,1,1,0,0,1,1,0,1,0,1,0,1,5,1,20,ITA
4c78b5ed,60,35,25,31,4,28,72,44,29,6,23,47,107,34,1,20,ITA
4cdcbc14,7,2,0,3,4,3,7,4,4,0,4,5,12,4,0,20,ITA
4cde5509,5,1,0,2,3,1,13,12,4,3,1,5,10,21,0,20,ITA
4ce8f4a3,1,1,0,1,0,0,0,0,0,0,0,0,1,0,0,20,ITA
4e1d5e59,1,0,0,0,1,0,2,2,0,0,0,0,1,1,0,20,ITA
4e219ad2,7,3,2,3,2,2,10,8,5,0,5,8,15,3,0,20,ITA
4e358a2d,19,11,12,6,1,6,11,5,8,6,2,19,38,52,0,20,ITA
4e6dbac4,60,35,25,24,11,15,79,64,67,16,51,37,97,60,1,20,ITA
4f2908e5,19,16,8,8,3,8,9,1,14,9,5,22,41,58,1,20,ITA
4fa7cb9b,2,1,1,1,0,1,12,11,7,0,7,5,7,5,0,20,ITA
5128bde4,26,16,14,8,4,14,27,13,15,4,11,23,49,53,0,20,ITA
528492ea,31,21,19,8,4,8,35,27,11,0,11,14,45,25,0,20,ITA
5294a83f,50,30,21,19,10,27,82,55,32,1,31,21,71,9,1,20,ITA
52ec54d0,28,17,18,8,2,12,17,5,32,29,3,31,59,94,2,20,ITA
5313ed43,17,12,8,8,1,9,35,26,20,1,19,17,34,19,0,20,ITA
536cebe5,16,11,4,9,3,7,34,27,14,1,13,3,19,12,0,20,ITA
539230cf,17,10,10,7,0,5,8,3,11,6,5,8,25,18,0,20,ITA
53a0e358,32,16,19,8,5,13,59,46,31,3,28,33,65,27,0,20,ITA
53de807a,43,25,24,15,4,28,43,15,19,9,10,34,77,85,0,20,ITA
54e53b7e,10,8,1,7,2,4,18,14,12,2,10,11,21,3,0,20,ITA
5592007b,17,9,3,9,5,6,18,12,7,0,7,5,22,1,0,20,ITA
563a68ad,43,22,15,24,4,16,43,27,24,8,16,34,77,31,2,20,ITA
56400c01,32,21,22,10,0,21,37,16,36,28,8,27,59,110,2,20,ITA
56b2957b,20,8,8,9,3,3,16,13,10,1,9,10,30,17,0,20,ITA
570bb4b9,31,15,10,15,6,14,39,25,22,1,21,11,42,7,0,20,ITA
5710a281,13,7,7,6,0,4,15,11,12,4,8,7,20,10,1,20,ITA
58027adc,15,10,6,7,2,9,19,10,7,4,3,10,25,23,0,20,ITA
582a251c,0,0,0,0,0,0,0,0,0,0,0,0,0,3,1,20,ITA
5832ebfe,49,28,29,19,1,26,44,18,23,8,15,31,80,68,0,20,ITA
585a73a8,17,11,12,5,0,8,13,5,30,21,9,25,42,150,2,20,ITA
58d97e77,1,0,0,0,1,0,0,0,1,0,1,0,1,1,0,20,ITA
58e933d2,5,3,0,4,1,0,9,9,13,3,10,2,7,14,0,20,ITA
599d91d0,0,0,0,0,0,0,0,0,1,1,0,0,0,0,0,20,ITA
59be3a74,4,0,3,1,0,1,1,0,4,0,4,0,4,0,0,20,ITA
5a2cb25d,58,36,26,21,11,26,55,29,29,10,19,31,89,15,1,20,ITA
5aa53281,49,26,26,18,5,22,44,22,32,15,17,60,109,98,1,20,ITA
5aaef9ef,43,22,21,16,6,14,61,47,21,4,17,29,72,36,0,20,ITA
5bd72174,7,4,3,2,2,3,11,8,15,0,15,1,8,8,0,20,ITA
5c397195,5,2,1,3,1,2,9,7,5,0,5,4,9,1,0,20,ITA
5cec2c74,32,18,14,13,5,12,35,23,31,6,25,24,56,36,0,20,ITA
5df4ef30,8,4,4,3,1,7,16,9,6,0,6,8,16,9,0,20,ITA
5e834dce,5,1,1,2,2,1,2,1,1,0,1,0,5,0,0,20,ITA
5e861944,12,6,8,2,2,5,16,11,7,0,7,5,17,4,0,20,ITA
5eae500a,13,7,4,7,2,3,10,7,14,6,8,1,14,28,0,20,ITA
5efc5389,14,9,9,3,2,7,18,11,25,9,16,23,37,71,0,20,ITA
5fa57166,0,0,0,0,0,0,0,0,0,0,0,0,0,1,0,20,ITA
5fd5ed86,63,36,37,20,6,20,34,14,48,22,26,74,137,118,1,20,ITA
6010ba04,0,0,0,0,0,0,0,0,0,0,0,0,0,0,0,20,ITA
601ef102,19,11,6,8,5,7,27,20,23,2,21,8,27,28,0,20,ITA
61b3978f,53,35,25,23,5,26,52,26,38,16,22,35,88,88,1,20,ITA
61f2f56a,1,0,0,1,0,0,1,1,2,0,2,1,2,3,0,20,ITA
6213fd82,38,23,22,10,6,13,39,26,15,2,13,32,70,48,1,20,ITA
62437b4f,8,4,4,3,1,1,4,3,3,0,3,4,12,7,0,20,ITA
63071a3f,49,25,36,12,1,26,42,16,37,29,8,35,84,140,2,20,ITA
649b01d8,1,1,1,0,0,1,3,2,0,0,0,0,1,21,1,20,ITA
64cd167d,32,17,17,13,2,15,26,11,22,12,10,34,66,69,0,20,ITA
6523afa4,1,1,0,1,0,0,0,0,3,1,2,5,6,4,1,20,ITA
652811aa,38,25,22,13,3,20,39,19,27,10,17,37,75,54,1,20,ITA
66a9470c,0,0,0,0,0,0,0,0,0,0,0,0,0,1,0,20,ITA
67f649be,0,0,0,0,0,0,2,2,0,0,0,1,1,7,1,20,ITA
6817095b,1,0,1,0,0,1,3,2,2,0,2,0,1,1,0,20,ITA
68252d6d,26,19,7,10,9,7,28,21,9,0,9,9,35,4,0,20,ITA
6928979a,36,21,14,15,7,8,37,29,20,5,15,14,50,14,0,20,ITA
6a189491,10,7,5,3,2,4,5,1,12,7,5,1,11,22,0,20,ITA
6aafdc27,26,19,18,6,2,10,21,11,32,23,9,30,56,65,1,20,ITA
6c1f7328,9,6,2,2,5,2,10,8,8,2,6,2,11,1,0,20,ITA
6ca663b4,1,0,0,1,0,0,4,4,2,0,2,1,2,4,0,20,ITA
6cc97b6a,10,4,7,3,0,5,13,8,5,2,3,19,29,9,1,20,ITA
6e058f06,8,6,5,2,1,3,4,1,5,0,5,1,9,0,0,20,ITA
6e4df551,27,13,5,13,9,13,45,32,24,0,24,17,44,6,1,20,ITA
6eee05f1,42,23,17,23,2,22,39,17,21,14,7,49,91,92,0,20,ITA
6f5ead86,61,31,25,31,5,30,112,82,53,11,42,50,111,51,1,20,ITA
718b8afd,17,9,9,5,3,6,13,7,17,2,15,4,21,18,1,20,ITA
71dc23da,31,16,15,13,3,18,35,17,17,2,15,9,40,42,1,20,ITA
72be9309,0,0,0,0,0,0,0,0,0,0,0,0,0,1,0,20,ITA
73ddc40c,4,3,0,3,1,1,4,3,9,6,3,3,7,9,0,20,ITA
74419746,1,1,1,0,0,0,1,1,0,0,0,0,1,8,3,20,ITA
756959aa,19,12,3,13,3,4,22,18,9,3,6,7,26,6,0,20,ITA
75b86fb3,32,17,14,11,7,15,24,9,18,9,9,26,58,54,0,20,ITA
75e60d75,33,19,13,17,3,6,28,22,14,2,12,21,54,31,0,20,ITA
7737dee2,4,2,1,1,2,1,5,4,2,1,1,0,4,1,0,20,ITA
780e3631,35,21,9,20,6,12,33,21,28,8,20,25,60,40,2,20,ITA
78841da9,13,9,3,7,3,9,25,16,15,3,12,10,23,14,1,20,ITA
79083382,2,1,2,0,0,0,3,3,1,0,1,1,3,7,0,20,ITA
79443529,6,2,1,4,1,4,13,9,5,2,3,7,13,6,0,20,ITA
7aa84ac5,4,4,3,1,0,1,11,10,3,1,2,1,5,0,0,20,ITA
7b075c75,3,2,3,0,0,1,3,2,12,12,0,11,14,32,0,20,ITA
7b4b9221,0,0,0,0,0,0,1,1,0,0,0,0,0,1,0,20,ITA
7b4de647,0,0,0,0,0,0,0,0,0,0,0,0,0,0,0,20,ITA
7b536033,5,3,2,1,2,1,2,1,3,1,2,1,6,7,0,20,ITA
7b5f516f,0,0,0,0,0,0,0,0,0,0,0,0,0,0,0,20,ITA
7ba1f1ef,0,0,0,0,0,0,0,0,2,0,2,0,0,0,0,20,ITA
7d3cbc67,13,11,4,2,7,7,19,12,12,4,8,6,19,6,0,20,ITA
7d50454d,22,15,16,6,0,6,11,5,23,17,6,23,45,66,2,20,ITA
7e81a17d,7,5,1,5,1,3,7,4,2,0,2,0,7,1,0,20,ITA
7eb97a8e,34,20,12,18,4,15,59,44,21,0,21,11,45,9,0,20,ITA
7ec7738e,2,2,2,0,0,1,4,3,1,0,1,0,2,1,1,20,ITA
7ed4921e,37,19,25,12,0,10,18,8,41,29,12,31,68,135,2,20,ITA
7f24b3eb,3,1,1,2,0,1,1,0,0,0,0,0,3,0,0,20,ITA
7f267d66,16,9,9,7,0,9,24,15,12,4,8,9,25,14,1,20,ITA
7f66ea09,3,1,3,0,0,3,3,0,0,0,0,6,9,22,0,20,ITA
7f78ad23,6,1,2,2,2,2,6,4,3,2,1,5,11,17,0,20,ITA
7fd58fe3,21,13,10,7,4,11,41,30,20,4,16,21,42,28,1,20,ITA
7fe90ccd,7,3,2,3,2,4,8,4,3,1,2,6,13,8,1,20,ITA
7ff93107,3,2,0,2,1,0,5,5,3,0,3,3,6,1,0,20,ITA
801831fe,0,0,0,0,0,0,2,2,1,0,1,1,1,0,0,20,ITA
80c718dd,4,1,2,1,1,3,7,4,1,0,1,1,5,4,0,20,ITA
81255c03,17,11,5,7,5,4,24,20,35,8,27,9,26,39,0,20,ITA
817c6964,16,8,8,5,3,9,16,7,5,0,5,9,25,5,0,20,ITA
822a7761,0,0,0,0,0,0,0,0,0,0,0,0,0,1,0,20,ITA
82328faf,0,0,0,0,0,0,0,0,0,0,0,0,0,0,0,20,ITA
825b8997,16,8,11,4,1,6,10,4,19,12,7,22,38,36,0,20,ITA
82b1198a,0,0,0,0,0,0,0,0,0,0,0,0,0,2,1,20,ITA
82dbf623,0,0,0,0,0,0,1,1,4,0,4,1,1,3,0,20,ITA
82efe6fa,11,8,6,3,2,5,7,2,9,6,3,18,29,21,1,20,ITA
84594618,7,6,2,5,0,5,6,1,24,17,7,10,17,69,0,20,ITA
84b6acaa,30,14,22,8,0,11,22,11,34,29,5,34,64,145,3,20,ITA
852351df,14,10,10,3,1,8,21,13,12,3,9,15,29,19,2,20,ITA
854ee61a,12,8,4,6,2,4,15,11,9,0,9,3,15,5,0,20,ITA
85613cf0,12,5,4,1,7,3,11,8,11,1,10,2,14,12,0,20,ITA
85e51909,1,1,1,0,0,1,1,0,0,0,0,0,1,0,0,20,ITA
8650af85,9,5,6,3,0,4,8,4,25,22,3,26,35,41,1,20,ITA
8697c095,13,5,3,7,3,2,12,10,1,0,1,1,14,3,0,20,ITA
8794e251,47,31,16,19,12,15,41,26,36,6,30,32,79,19,0,20,ITA
881ef58c,14,10,3,5,6,5,12,7,4,0,4,5,19,5,0,20,ITA
88c89891,11,6,6,5,0,6,17,11,2,1,1,11,22,13,0,20,ITA
8913a9f9,0,0,0,0,0,0,0,0,0,0,0,0,0,0,0,20,ITA
89976232,42,24,24,14,4,17,35,18,44,29,15,71,113,121,1,20,ITA
89b2c8a9,13,9,1,8,4,2,27,25,10,1,9,7,20,4,0,20,ITA
8a08491a,13,7,2,6,5,4,31,27,12,0,12,6,19,14,0,20,ITA
8abd0c03,15,9,8,4,3,6,11,5,9,2,7,5,20,10,0,20,ITA
8b303bcb,0,0,0,0,0,0,0,0,0,0,0,2,2,1,0,20,ITA
8b609c34,1,0,0,1,0,0,0,0,0,0,0,1,2,2,0,20,ITA
8b66d9cc,10,7,5,4,1,3,9,6,5,0,5,2,12,3,0,20,ITA
8b8a56ce,31,19,18,13,0,13,22,9,25,20,5,22,53,62,1,20,ITA
8b95acda,42,26,27,14,1,12,24,12,33,22,11,59,101,155,1,20,ITA
8bc8829a,3,2,0,2,1,0,0,0,3,1,2,0,3,0,0,20,ITA
8c63fae5,2,2,2,0,0,2,3,1,1,0,1,2,4,7,0,20,ITA
8c65eb5f,44,19,19,22,3,14,38,24,20,7,13,19,63,19,2,20,ITA
8c725b43,36,18,26,9,1,14,32,18,31,20,11,55,91,134,1,20,ITA
8cabdc1e,0,0,0,0,0,0,1,1,0,0,0,4,4,19,2,20,ITA
8cb494c9,0,0,0,0,0,0,0,0,0,0,0,0,0,0,0,20,ITA
8cc29864,13,9,13,0,0,4,10,6,10,7,3,4,17,23,0,20,ITA
8cea6319,13,6,9,4,0,9,15,6,14,12,2,9,22,30,0,20,ITA
8d8178ac,19,11,0,9,10,4,27,23,17,3,14,5,24,38,2,20,ITA
8da74c05,4,3,1,1,2,1,2,1,3,1,2,3,7,4,1,20,ITA
8efa621b,29,13,20,9,0,14,32,18,48,38,10,36,65,169,5,20,ITA
8f866fe8,9,7,2,3,4,1,7,6,12,0,12,10,19,11,0,20,ITA
8fef5412,41,25,23,15,3,21,49,28,21,8,13,43,84,42,1,20,ITA
8ff07990,2,2,0,2,0,0,2,2,1,1,0,8,10,22,0,20,ITA
9085dd7c,41,28,21,15,5,23,46,23,18,9,9,10,51,58,0,20,ITA
909bce7f,38,20,29,9,0,15,57,42,20,7,13,28,66,25,2,20,ITA
91899ca8,15,8,11,4,0,7,20,13,10,7,3,22,37,50,0,20,ITA
91976866,4,3,1,0,3,3,3,0,2,0,2,2,6,1,0,20,ITA
919dd4b1,0,0,0,0,0,0,0,0,0,0,0,0,0,0,0,20,ITA
91c9de34,1,0,1,0,0,0,0,0,0,0,0,1,2,0,0,20,ITA
921f6058,81,44,46,33,2,28,54,26,39,14,25,61,142,74,2,20,ITA
92b4758e,35,27,24,8,3,12,23,11,16,6,10,33,68,64,1,20,ITA
92d83c27,13,8,9,4,0,6,31,25,15,4,11,13,26,10,0,20,ITA
933d3b51,27,12,19,8,0,8,18,10,28,23,5,15,42,53,1,20,ITA
934e264d,1,0,0,0,1,0,1,1,0,0,0,0,1,0,0,20,ITA
93b891d1,17,10,4,7,6,2,11,9,9,1,8,4,21,2,0,20,ITA
93cf32a8,34,24,21,11,2,16,22,6,40,18,22,70,104,138,2,20,ITA
9413b19f,0,0,0,0,0,0,2,2,1,0,1,1,1,7,2,20,ITA
94816803,6,4,4,2,0,3,10,7,4,0,4,0,6,0,0,20,ITA
94b2001f,30,20,16,12,2,18,30,12,12,3,9,26,56,44,0,20,ITA
952a03fe,18,11,11,7,0,7,11,4,28,20,8,32,50,86,2,20,ITA
9591723b,0,0,0,0,0,0,0,0,0,0,0,0,0,0,0,20,ITA
9592289a,15,10,6,4,5,3,10,7,11,0,11,9,24,13,1,20,ITA
95adf1e1,0,0,0,0,0,0,0,0,0,0,0,0,0,2,0,20,ITA
95facda1,58,38,37,17,4,25,69,44,30,1,29,25,83,26,0,20,ITA
96640846,0,0,0,0,0,0,0,0,0,0,0,0,0,1,0,20,ITA
96960855,20,10,12,5,3,9,30,21,12,2,10,11,31,11,0,20,ITA
96e0490d,81,42,48,30,3,40,83,43,38,16,22,25,106,78,1,20,ITA
970b8574,12,5,4,5,3,6,10,4,3,2,1,5,17,12,0,20,ITA
980522ec,11,6,2,8,1,5,20,15,3,0,3,0,11,0,0,20,ITA
983ff2c7,20,10,12,6,2,13,19,6,5,1,4,11,31,15,0,20,ITA
9866afec,2,1,0,0,2,1,2,1,2,1,1,0,2,0,0,20,ITA
98d2c2c4,51,30,18,25,8,22,63,41,41,6,35,28,79,26,0,20,ITA
9907b1c8,15,11,4,7,4,3,24,21,14,0,14,5,20,5,0,20,ITA
997fff07,12,9,7,3,2,6,9,3,5,3,2,6,18,16,0,20,ITA
9b30df1e,2,1,2,0,0,1,2,1,4,4,0,6,8,14,0,20,ITA
9b6f7fd5,33,19,12,17,4,14,37,23,17,2,15,8,41,9,0,20,ITA
9d4c45d6,43,25,15,21,7,10,46,36,19,0,19,17,60,23,1,20,ITA
9dc96f10,1,1,0,1,0,0,0,0,0,0,0,0,1,0,0,20,ITA
9e1577aa,22,6,10,8,4,10,24,14,21,7,14,13,35,41,0,20,ITA
9e90fb5d,24,10,6,11,7,7,31,24,15,1,14,6,30,10,0,20,ITA
9f5a610b,0,0,0,0,0,0,0,0,0,0,0,0,0,0,0,20,ITA
a111cf41,0,0,0,0,0,0,1,1,0,0,0,1,1,18,2,20,ITA
a1216563,5,4,2,1,2,3,10,7,5,1,4,3,8,1,0,20,ITA
a36084cd,1,1,0,1,0,0,0,0,0,0,0,1,2,0,0,20,ITA
a3d94a58,52,35,36,12,4,12,41,29,59,33,26,75,127,116,2,20,ITA
a40819d9,40,24,21,17,2,19,36,17,33,24,9,50,90,86,3,20,ITA
a40d5a0c,16,13,5,8,3,5,20,15,14,0,14,3,19,6,0,20,ITA
a4e85758,36,26,21,12,3,20,27,7,27,13,14,31,67,53,1,20,ITA
a4fe8cda,4,2,2,1,1,1,15,14,6,1,5,2,6,6,0,20,ITA
a5296e55,26,16,10,11,5,12,30,18,28,5,23,21,47,15,0,20,ITA
a64cbd35,43,31,22,19,2,16,45,29,26,8,18,17,60,32,0,20,ITA
a65ce836,10,7,5,3,2,3,10,7,4,0,4,2,12,3,0,20,ITA
a69cc629,1,1,1,0,0,0,0,0,1,0,1,1,2,0,0,20,ITA
a69e4806,6,4,1,5,0,2,15,13,13,0,13,5,11,5,0,20,ITA
a8a874f1,76,50,35,37,4,33,69,36,42,14,28,33,109,36,0,20,ITA
a8f21b9f,12,8,4,6,2,3,10,7,6,1,5,3,15,1,0,20,ITA
a96e5dc0,37,21,24,10,3,18,35,17,23,12,11,18,55,58,1,20,ITA
aae9d04a,67,37,43,19,5,30,67,37,50,15,35,36,103,115,0,20,ITA
ab1ca213,52,29,20,28,4,18,60,42,36,12,24,32,84,46,1,20,ITA
ab4449d6,1,0,1,0,0,0,1,1,0,0,0,2,3,15,5,20,ITA
ac1f056e,0,0,0,0,0,0,4,4,0,0,0,0,0,1,0,20,ITA
ac4003af,0,0,0,0,0,0,0,0,0,0,0,0,0,3,0,20,ITA
ac4a4508,64,40,28,26,10,22,54,32,29,3,26,21,85,17,0,20,ITA
ac7e640b,21,11,12,8,1,5,11,6,9,5,4,30,51,22,1,20,ITA
ad6df2d5,46,21,16,23,7,21,63,42,29,12,17,32,78,30,0,20,ITA
aded8e6f,0,0,0,0,0,0,1,1,0,0,0,2,2,0,0,20,ITA
ae4e2852,10,8,6,4,0,6,14,8,5,2,3,8,18,18,1,20,ITA
ae64d449,37,20,23,13,1,16,40,24,28,10,18,20,57,29,0,20,ITA
ae7058f9,11,7,6,5,0,6,11,5,3,2,1,15,26,26,0,20,ITA
ae82fa48,4,4,1,2,1,0,4,4,4,0,4,1,5,2,0,20,ITA
b0243215,22,12,14,7,1,8,14,6,11,7,4,16,38,33,0,20,ITA
b0f7e36c,38,22,13,15,10,10,52,42,19,0,19,6,44,6,0,20,ITA
b1236c63,10,7,5,5,0,6,21,15,13,2,11,4,14,12,0,20,ITA
b1deecf8,23,17,16,7,0,8,16,8,29,17,12,24,47,75,0,20,ITA
b233e8e4,18,6,14,4,0,10,19,9,8,4,4,10,28,28,0,20,ITA
b3af9be1,42,24,25,13,4,22,41,19,34,9,25,49,91,78,1,20,ITA
b3fd7075,44,24,19,21,4,16,52,36,19,3,16,40,84,11,0,20,ITA
b59e02da,22,13,10,9,3,8,28,20,13,2,11,11,33,19,0,20,ITA
b5bf1770,23,13,9,12,2,7,13,6,29,19,10,23,46,54,2,20,ITA
b5cae4e6,3,0,3,0,0,2,9,7,4,0,4,1,4,5,0,20,ITA
b6964eb6,25,16,15,9,1,10,13,3,44,35,9,56,81,126,2,20,ITA
b6b2b820,69,47,31,29,9,22,84,62,40,12,28,22,91,23,0,20,ITA
b70bde8f,18,10,10,7,1,6,22,16,15,1,14,9,27,4,0,20,ITA
b7a5bc86,6,4,3,2,1,2,10,8,5,3,2,5,11,8,0,20,ITA
b86fe156,2,0,2,0,0,0,1,1,4,1,3,2,4,0,0,20,ITA
b871bf55,13,8,8,3,2,6,11,5,6,4,2,4,17,19,0,20,ITA
b96b595c,59,29,42,12,5,14,20,6,40,27,13,42,101,109,1,20,ITA
ba1e04b3,46,31,21,19,6,19,40,21,24,10,14,21,67,31,1,20,ITA
ba3d3bea,17,11,10,5,2,10,20,10,7,1,6,13,30,10,0,20,ITA
bbafc0c4,37,25,24,7,6,19,34,15,23,3,20,14,51,20,4,20,ITA
bdc74a8f,5,3,4,0,1,2,4,2,2,0,2,2,7,3,0,20,ITA
bdd0692f,4,2,3,1,0,0,1,1,5,1,4,2,6,2,0,20,ITA
be927d03,11,5,3,5,3,6,19,13,11,3,8,14,25,24,0,20,ITA
bee704fc,46,25,30,16,0,11,31,20,39,21,18,29,75,129,1,20,ITA
bf13975c,39,18,19,12,8,17,56,39,27,6,21,26,65,18,1,20,ITA
bf168004,0,0,0,0,0,0,0,0,0,0,0,0,0,1,0,20,ITA
bf309d24,40,25,14,20,6,8,30,22,10,1,9,33,73,16,2,20,ITA
bf356094,2,1,1,0,1,1,2,1,1,0,1,1,3,0,0,20,ITA
bf39bdec,17,7,5,10,2,6,22,16,10,2,8,5,22,22,0,20,ITA
bf4d31d3,0,0,0,0,0,0,0,0,0,0,0,0,0,0,0,20,ITA
bf57eaab,7,5,1,4,2,0,7,7,3,0,3,5,12,2,0,20,ITA
c01c66d9,9,5,6,3,0,4,11,7,13,8,5,13,22,26,0,20,ITA
c0c7ff58,43,26,19,18,6,24,65,41,32,4,28,32,75,18,2,20,ITA
c0cddebe,48,27,13,27,8,13,34,21,35,6,29,22,70,16,0,20,ITA
c235e803,7,5,5,2,0,5,8,3,6,6,0,9,16,21,0,20,ITA
c316607a,14,9,12,2,0,7,10,3,13,8,5,11,25,28,2,20,ITA
c375dfa5,1,0,1,0,0,1,5,4,3,0,3,7,8,11,0,20,ITA
c3a8bcd8,42,26,16,22,4,15,48,33,22,6,16,37,79,25,2,20,ITA
c414df9d,48,30,21,25,2,16,43,27,27,6,21,16,64,18,0,20,ITA
c4efe2b4,1,0,0,1,0,0,0,0,2,1,1,1,2,0,0,20,ITA
c50cee19,11,8,5,5,1,4,12,8,10,1,9,8,19,5,0,20,ITA
c53083ad,18,10,13,4,1,5,15,10,13,2,11,9,27,14,0,20,ITA
c56dc39e,56,29,28,23,5,33,76,43,31,17,14,45,101,80,0,20,ITA
c59f90b0,0,0,0,0,0,0,0,0,0,0,0,0,0,0,0,20,ITA
c5adc293,6,4,1,4,1,2,5,3,3,2,1,4,10,8,0,20,ITA
c693347d,9,4,2,5,2,4,11,7,7,0,7,2,11,26,0,20,ITA
c6e8cf1f,29,17,8,19,2,10,35,25,21,7,14,29,58,15,0,20,ITA
c707411f,23,15,13,10,0,10,17,7,19,14,5,25,48,76,1,20,ITA
c710f7d5,31,15,14,17,0,16,33,17,8,3,5,4,35,25,0,20,ITA
c7259b83,47,24,15,25,7,15,55,40,30,5,25,26,73,25,0,20,ITA
c730da00,5,1,4,1,0,3,5,2,4,3,1,4,9,8,1,20,ITA
c75b6a02,7,4,2,3,2,1,8,7,4,1,3,2,9,13,0,20,ITA
c840baa2,2,0,0,1,1,1,1,0,0,0,0,0,2,0,0,20,ITA
ca241ad3,0,0,0,0,0,0,0,0,1,0,1,3,3,3,0,20,ITA
ca8fa0c0,0,0,0,0,0,0,0,0,0,0,0,0,0,0,0,20,ITA
caec77da,0,0,0,0,0,0,0,0,0,0,0,1,1,0,0,20,ITA
caffaf5a,4,3,2,2,0,2,6,4,15,12,3,27,31,72,0,20,ITA
cbec1196,10,4,2,5,3,5,18,13,8,1,7,4,14,11,0,20,ITA
cc700722,50,27,20,21,9,18,54,36,19,3,16,16,66,11,1,20,ITA
cce9f582,0,0,0,0,0,0,1,1,4,3,1,4,4,13,0,20,ITA
cd0fa27b,42,21,15,21,6,12,35,23,26,2,24,26,68,26,1,20,ITA
cdf65d12,40,23,24,15,1,17,27,10,20,13,7,35,75,69,0,20,ITA
ce30bfc8,38,19,12,18,8,14,41,27,28,8,20,30,68,20,1,20,ITA
ce5b170a,5,3,4,1,0,2,3,1,4,3,1,3,8,7,0,20,ITA
cedb3e36,38,23,12,22,4,12,37,25,32,10,22,18,56,24,2,20,ITA
cf007308,16,7,5,6,5,5,20,15,11,1,10,11,27,4,0,20,ITA
cf1c23d8,0,0,0,0,0,0,0,0,0,0,0,0,0,1,1,20,ITA
cfbf9881,19,10,13,4,2,7,17,10,22,11,11,15,34,42,0,20,ITA
d023d70f,61,32,24,25,12,21,65,44,26,3,23,26,87,17,0,20,ITA
d0d8dd44,33,18,20,12,1,14,27,13,34,24,10,52,85,121,1,20,ITA
d0dbca9f,18,13,13,5,0,7,12,5,13,8,5,12,30,31,0,20,ITA
d183e9d6,40,22,24,8,8,21,41,20,22,4,18,27,67,58,0,20,ITA
d1b49282,53,34,17,23,13,27,52,25,24,6,18,17,70,34,0,20,ITA
d2fd20d6,0,0,0,0,0,0,0,0,0,0,0,0,0,0,0,20,ITA
d37b0350,0,0,0,0,0,0,0,0,0,0,0,1,1,3,0,20,ITA
d3b888e3,13,7,9,4,0,5,15,10,5,0,5,7,20,14,0,20,ITA
d3d758d8,34,26,13,17,4,8,32,24,25,10,15,9,43,16,0,20,ITA
d3de9af0,7,3,1,2,4,1,6,5,18,7,11,2,9,11,0,20,ITA
d4535821,11,6,7,4,0,4,11,7,14,2,12,14,25,16,0,20,ITA
d4890c25,0,0,0,0,0,0,0,0,0,0,0,0,0,0,0,20,ITA
d4931a5a,2,1,0,2,0,0,0,0,2,0,2,1,3,1,0,20,ITA
d4c9725f,56,39,32,18,6,33,53,20,34,6,28,43,99,62,2,20,ITA
d5575935,1,1,0,1,0,1,2,1,0,0,0,0,1,1,0,20,ITA
d6a889ea,8,6,4,3,1,5,6,1,4,1,3,3,11,2,0,20,ITA
d6e53a3a,25,15,14,10,1,13,23,10,30,23,7,25,50,101,2,20,ITA
d705ba44,29,16,7,17,5,5,31,26,23,5,18,5,34,20,1,20,ITA
d711d04f,12,8,2,7,3,3,25,22,4,1,3,0,12,5,1,20,ITA
d7918b13,3,2,0,3,0,2,3,1,1,0,1,0,3,4,0,20,ITA
d7d32194,3,2,1,2,0,1,3,2,1,0,1,0,3,1,0,20,ITA
d80b1835,3,1,0,2,1,2,2,0,2,0,2,1,4,2,0,20,ITA
d85c238b,20,11,10,5,5,3,15,12,14,3,11,20,40,21,0,20,ITA
d89b0ebb,1,1,1,0,0,0,0,0,1,0,1,1,2,1,0,20,ITA
d8dfae8a,0,0,0,0,0,0,0,0,0,0,0,0,0,0,0,20,ITA
d9624b51,14,8,11,3,0,10,10,0,9,5,4,13,27,37,1,20,ITA
d97f2e8d,41,28,26,10,5,17,31,14,29,3,26,16,57,39,0,20,ITA
d995ed27,16,9,5,6,5,5,17,12,8,3,5,7,23,10,0,20,ITA
da13074e,5,3,1,3,1,2,13,11,9,4,5,5,10,4,0,20,ITA
da5a981b,29,24,17,11,1,17,31,14,4,0,4,13,42,15,1,20,ITA
da974c7b,51,33,30,17,4,17,28,11,28,16,12,31,82,61,1,20,ITA
db092d3b,67,47,21,34,12,29,73,44,25,7,18,54,121,15,2,20,ITA
dc1c2fce,20,6,6,13,1,8,33,25,17,1,16,18,38,17,0,20,ITA
dc3a9a0d,27,15,14,10,3,10,33,23,6,0,6,11,38,9,0,20,ITA
dc3fa3b5,18,8,14,3,1,8,23,15,9,1,8,8,26,9,0,20,ITA
dc61b402,1,1,0,1,0,1,1,0,0,0,0,0,1,0,0,20,ITA
dd06d56c,0,0,0,0,0,0,0,0,0,0,0,0,0,3,0,20,ITA
dd0daf32,32,22,10,17,5,19,45,26,27,3,24,11,43,6,0,20,ITA
dd29f81d,10,4,7,3,0,7,9,2,10,3,7,9,19,16,0,20,ITA
de045b15,27,13,20,6,1,12,25,13,48,37,11,38,65,145,1,20,ITA
dea698d9,14,10,3,3,8,4,20,16,10,3,7,6,20,21,1,20,ITA
deb748c9,48,27,33,9,6,23,45,22,41,24,17,37,85,109,3,20,ITA
df301450,8,3,3,1,4,0,13,13,9,1,8,5,13,1,0,20,ITA
df3cda47,41,21,10,24,7,19,64,45,25,1,24,23,64,17,0,20,ITA
df525574,16,4,7,7,2,4,13,9,19,5,14,9,25,25,1,20,ITA
df85d472,13,8,3,0,10,1,4,3,3,0,3,7,20,12,0,20,ITA
dfd56738,1,1,1,0,0,0,0,0,0,0,0,2,3,0,0,20,ITA
e01ca8f4,3,1,1,1,1,3,7,4,1,0,1,3,6,0,0,20,ITA
e0314d87,37,19,23,12,2,23,46,23,14,6,8,36,73,68,2,20,ITA
e0921a4f,19,10,6,9,4,9,39,30,15,0,15,13,32,3,0,20,ITA
e14ec482,36,22,21,10,5,12,47,35,23,1,22,16,52,20,0,20,ITA
e1b0a70d,0,0,0,0,0,0,0,0,0,0,0,0,0,4,0,20,ITA
e1cbb531,11,9,3,5,3,5,12,7,3,1,2,9,20,2,0,20,ITA
e23f56c1,13,7,4,5,4,5,18,13,11,1,10,2,15,1,0,20,ITA
e26bd2f4,52,27,26,20,6,20,56,36,27,11,16,35,87,32,2,20,ITA
e288d4b3,14,11,8,4,2,7,20,13,9,3,6,16,30,19,0,20,ITA
e33f36d5,46,32,30,13,3,17,27,10,50,32,18,27,73,96,1,20,ITA
e358587b,0,0,0,0,0,0,0,0,0,0,0,0,0,0,1,20,ITA
e3756e72,0,0,0,0,0,0,0,0,0,0,0,0,0,0,0,20,ITA
e3cceee6,8,7,5,3,0,1,3,2,4,3,1,4,12,16,1,20,ITA
e40d028b,0,0,0,0,0,0,0,0,0,0,0,0,0,3,1,20,ITA
e468c053,12,6,5,6,1,6,17,11,4,0,4,5,17,3,0,20,ITA
e58cbfd5,0,0,0,0,0,0,1,1,0,0,0,4,4,0,0,20,ITA
e599253a,47,21,17,18,12,16,52,36,27,7,20,27,74,22,2,20,ITA
e5bf73f3,21,14,11,7,3,7,24,17,19,0,19,5,26,12,0,20,ITA
e63e122d,2,1,0,2,0,0,0,0,0,0,0,1,3,1,0,20,ITA
e726e11e,4,3,1,2,1,2,8,6,4,0,4,0,4,4,0,20,ITA
e74f0e59,15,8,4,7,4,11,27,16,20,7,13,19,34,72,0,20,ITA
e7ee38c3,0,0,0,0,0,0,1,1,0,0,0,0,0,8,0,20,ITA
e83f8ebb,1,0,0,1,0,1,1,0,0,0,0,0,1,0,0,20,ITA
e85fb9b8,3,0,3,0,0,1,1,0,2,2,0,1,4,9,0,20,ITA
e8c930bb,29,17,10,16,3,15,50,35,21,3,18,45,74,34,1,20,ITA
e947ee4a,47,24,25,15,7,19,46,27,33,15,18,27,74,19,2,20,ITA
e94d79e3,47,31,34,11,2,16,34,18,29,13,16,31,78,74,2,20,ITA
ea06dd97,43,23,17,19,7,13,40,27,20,4,16,25,68,25,0,20,ITA
ea164f99,23,15,8,13,2,14,29,15,19,14,5,27,50,28,0,20,ITA
eb2fe5b6,15,9,3,8,4,3,14,11,12,0,12,4,19,0,0,20,ITA
eccbe56a,23,14,2,10,11,3,19,16,20,3,17,8,31,14,0,20,ITA
ed5886d2,54,26,19,27,8,18,46,28,44,15,29,26,80,49,0,20,ITA
ed65da8c,0,0,0,0,0,0,0,0,0,0,0,0,0,0,0,20,ITA
eda40760,37,28,16,16,5,20,37,17,20,9,11,31,68,57,0,20,ITA
ee251371,14,8,5,7,2,6,20,14,13,1,12,8,22,1,0,20,ITA
ee4f2f3b,9,5,0,6,3,2,30,28,13,0,13,8,17,15,0,20,ITA
ee833569,3,2,3,0,0,2,3,1,0,0,0,1,4,9,0,20,ITA
ee93c1a9,13,5,4,5,4,5,25,20,11,0,11,13,26,12,1,20,ITA
ef5b337e,4,3,2,0,2,0,6,6,4,0,4,13,17,9,0,20,ITA
ef619b0b,20,15,6,8,6,6,24,18,18,3,15,11,31,12,0,20,ITA
ef94dc2f,2,1,0,0,2,0,8,8,3,0,3,1,3,10,0,20,ITA
f058ed1f,0,0,0,0,0,0,0,0,0,0,0,0,0,4,0,20,ITA
f0f7f62f,0,0,0,0,0,0,2,2,0,0,0,0,0,13,2,20,ITA
f1cfc209,56,25,23,25,8,23,65,42,20,3,17,36,92,62,0,20,ITA
f1f1f238,39,25,22,15,2,19,29,10,45,39,6,55,94,131,1,20,ITA
f239e6dd,0,0,0,0,0,0,0,0,0,0,0,0,0,0,0,20,ITA
f26e3c59,22,13,13,6,3,7,23,16,16,4,12,6,28,23,0,20,ITA
f32df091,0,0,0,0,0,0,0,0,0,0,0,0,0,0,0,20,ITA
f45f9427,52,25,35,12,5,18,51,33,34,4,30,19,71,65,0,20,ITA
f4ec4fd0,3,1,0,2,1,2,8,6,3,0,3,1,4,7,0,20,ITA
f503ea63,51,25,18,31,2,24,68,44,35,14,21,33,84,46,1,20,ITA
f554e29b,0,0,0,0,0,0,0,0,0,0,0,0,0,10,0,20,ITA
f5ba8903,1,1,1,0,0,1,2,1,0,0,0,0,1,0,0,20,ITA
f61c7c4e,20,14,7,10,3,4,20,16,9,0,9,3,23,3,0,20,ITA
f6a06749,0,0,0,0,0,0,0,0,0,0,0,0,0,0,0,20,ITA
f6f6b6e8,3,2,3,0,0,1,4,3,3,2,1,1,4,3,0,20,ITA
f7036e1c,22,7,2,8,12,4,34,30,30,2,28,15,37,11,0,20,ITA
f7223718,34,20,24,7,3,18,25,7,19,9,10,15,49,45,0,20,ITA
f7e2af2c,8,4,3,5,0,3,4,1,6,6,0,7,15,20,0,20,ITA
f8d41a8c,0,0,0,0,0,0,0,0,0,0,0,0,0,0,0,20,ITA
f8f0744b,0,0,0,0,0,0,0,0,0,0,0,0,0,0,0,20,ITA
f91e81c9,27,19,15,9,3,17,30,13,20,5,15,20,47,52,0,20,ITA
f93ed0df,2,1,2,0,0,2,3,1,0,0,0,0,2,11,10,20,ITA
faa1b07d,5,3,3,2,0,2,3,1,2,2,0,17,22,23,0,20,ITA
fb2c533b,27,17,16,8,3,14,34,20,10,3,7,18,45,15,0,20,ITA
fb77bfef,25,17,21,4,0,14,24,10,23,14,9,40,65,60,2,20,ITA
fba81826,30,21,19,7,4,11,27,16,20,7,13,18,48,22,0,20,ITA
fc4f85b1,38,29,19,16,3,18,32,14,17,7,10,45,83,60,1,20,ITA
fe012aca,12,7,3,8,1,6,20,14,24,0,24,3,15,4,0,20,ITA
fe0b8f0e,1,1,0,1,0,1,2,1,2,2,0,1,2,6,0,20,ITA
fe471a89,1,0,1,0,0,1,3,2,0,0,0,0,1,0,0,20,ITA
fe479e17,1,0,0,1,0,0,0,0,1,0,1,0,1,0,0,20,ITA
fe6a7685,20,8,13,7,0,6,17,11,38,34,4,33,53,96,1,20,ITA
fed5f993,34,17,19,15,0,16,28,12,54,39,15,30,64,99,0,20,ITA
ff4296df,2,2,0,2,0,1,1,0,0,0,0,4,6,0,1,20,ITA
ff764de3,28,16,12,13,3,8,27,19,11,3,8,14,42,9,1,20,ITA
ff800ed8,34,20,18,10,6,21,38,17,16,4,12,26,60,52,0,20,ITA
005c0807,26,16,5,16,5,15,46,31,15,3,12,16,42,18,0,20,FRA
007faf7a,1,0,1,0,0,1,1,0,0,0,0,0,1,0,0,20,FRA
0118c54c,29,17,19,9,1,8,17,9,15,5,10,19,48,15,1,20,FRA
032f894e,28,15,9,15,4,8,33,25,19,1,18,15,43,10,1,20,FRA
0557ff4f,28,21,17,9,2,13,29,16,21,6,15,20,48,38,0,20,FRA
05816e19,17,10,6,9,2,8,24,16,12,1,11,19,36,10,0,20,FRA
0630eb63,10,3,4,3,3,6,17,11,7,0,7,2,12,7,0,20,FRA
0670ee51,0,0,0,0,0,0,0,0,1,1,0,0,0,1,0,20,FRA
06df8256,18,12,12,5,1,6,12,6,20,11,9,27,45,57,1,20,FRA
07f73a4f,1,1,0,0,1,0,0,0,0,0,0,0,1,0,0,20,FRA
08082af0,16,9,12,3,1,7,11,4,12,9,3,17,33,34,0,20,FRA
095e4199,0,0,0,0,0,0,0,0,0,0,0,0,0,0,0,20,FRA
0984c5d5,1,1,0,1,0,1,1,0,0,0,0,0,1,0,0,20,FRA
0a63446f,39,25,26,12,1,23,37,14,19,3,16,17,56,64,0,20,FRA
0a89e877,26,20,16,9,1,14,33,19,19,4,15,14,40,18,0,20,FRA
0aa874f4,46,29,31,14,1,17,57,40,12,3,9,26,72,38,3,20,FRA
0b0cbe5b,45,34,10,25,10,20,55,35,30,0,30,10,55,15,0,20,FRA
0b4d8274,12,9,1,5,6,2,12,10,12,0,12,0,12,4,0,20,FRA
0bb6e193,0,0,0,0,0,0,1,1,2,0,2,3,3,4,0,20,FRA
0be95d34,20,14,5,11,4,6,27,21,12,2,10,7,27,7,0,20,FRA
0c291a1a,2,2,2,0,0,2,3,1,0,0,0,1,3,3,0,20,FRA
0cbc8baa,12,8,5,6,1,2,6,4,23,8,15,20,32,50,0,20,FRA
0d2158d5,7,5,4,3,0,4,9,5,3,1,2,4,11,2,0,20,FRA
0d3585b5,10,5,1,8,1,6,10,4,7,0,7,2,12,1,1,20,FRA
0e6bc38c,12,9,3,4,5,4,8,4,3,0,3,1,13,3,0,20,FRA
0eb03d5b,18,11,12,6,0,14,21,7,5,3,2,15,33,15,0,20,FRA
0f26fd24,3,2,2,1,0,1,9,8,2,0,2,1,4,3,0,20,FRA
0f52f925,7,2,4,3,0,2,5,3,2,0,2,1,8,3,0,20,FRA
0f8418aa,46,27,21,21,4,16,48,32,14,5,9,20,66,25,0,20,FRA
0f86995c,1,1,1,0,0,0,0,0,0,0,0,4,5,0,0,20,FRA
0f87f8c2,2,1,0,2,0,0,0,0,0,0,0,0,2,2,0,20,FRA
0f9b8301,31,24,13,13,5,14,36,22,13,4,9,19,50,21,0,20,FRA
1001ae82,25,16,9,14,2,8,25,17,14,1,13,7,32,5,0,20,FRA
10f0fdd3,40,27,18,19,3,13,21,8,16,3,13,22,62,6,0,20,FRA
11ced928,6,3,2,3,1,1,2,1,4,1,3,7,13,14,0,20,FRA
11ff3d56,38,24,15,22,1,12,29,17,9,2,7,23,61,16,3,20,FRA
1232e1dc,16,13,14,2,0,10,11,1,21,17,4,18,34,61,0,20,FRA
132a82f1,25,15,16,9,0,12,18,6,10,5,5,36,61,55,4,20,FRA
132bb875,0,0,0,0,0,0,0,0,0,0,0,0,0,1,2,20,FRA
1467af0d,54,32,22,22,10,20,56,36,23,3,20,19,73,9,0,20,FRA
14e8e9d7,14,8,8,6,0,5,11,6,18,12,6,22,36,71,0,20,FRA
16324e1d,29,19,20,9,0,17,34,17,22,16,6,39,68,80,0,20,FRA
166a981d,21,13,15,5,1,9,17,8,5,0,5,12,33,23,0,20,FRA
16aa7d4c,12,6,10,2,0,7,12,5,8,5,3,15,27,50,0,20,FRA
18ebca4b,36,16,11,11,14,10,35,25,19,6,13,7,43,33,1,20,FRA
19a12bed,58,47,40,14,4,24,35,11,17,2,15,58,116,58,0,20,FRA
19cda00b,17,12,2,8,7,4,34,30,14,3,11,11,28,1,3,20,FRA
19f8e480,16,10,6,10,0,5,7,2,6,1,5,8,24,4,0,20,FRA
1a4b9094,60,37,30,19,11,30,53,23,17,1,16,32,92,38,0,20,FRA
1a6f2a66,3,1,1,2,0,3,12,9,7,2,5,4,7,5,0,20,FRA
1a992676,13,10,2,9,2,7,15,8,7,1,6,10,23,1,0,20,FRA
1ad8cb67,42,21,26,15,1,21,40,19,34,22,12,58,100,97,0,20,FRA
1b6862e8,6,5,3,2,1,3,9,6,5,0,5,1,7,1,0,20,FRA
1bab7b66,16,8,12,4,0,10,15,5,22,15,7,24,40,63,0,20,FRA
1bfb6fef,23,19,15,8,0,7,13,6,18,9,9,20,43,75,0,20,FRA
1d2d5cc8,3,1,3,0,0,3,4,1,0,0,0,1,4,2,4,20,FRA
1ddbc7ca,0,0,0,0,0,0,0,0,0,0,0,1,1,0,0,20,FRA
1ec7e1c5,27,14,20,5,2,10,19,9,21,13,8,26,53,143,1,20,FRA
20094685,16,10,5,8,3,4,26,22,8,2,6,8,24,1,0,20,FRA
2054d037,17,10,3,11,3,6,21,15,10,1,9,5,22,20,0,20,FRA
20e73fac,40,12,18,20,2,17,68,51,38,7,31,20,60,25,0,20,FRA
2145368f,65,31,20,37,8,21,43,22,29,4,25,25,90,11,1,20,FRA
21f8d950,13,8,5,5,3,3,13,10,8,4,4,3,16,16,0,20,FRA
22721b88,55,29,31,19,5,31,64,33,27,6,21,56,111,97,0,20,FRA
22bfb57e,14,11,3,10,1,4,13,9,7,1,6,3,17,5,1,20,FRA
2306bfde,3,2,2,1,0,2,3,1,0,0,0,1,4,2,1,20,FRA
23bf644d,1,1,0,1,0,0,4,4,0,0,0,0,1,0,0,20,FRA
23c63b7f,10,6,4,3,3,3,18,15,8,1,7,4,14,13,0,20,FRA
242b350c,0,0,0,0,0,0,0,0,0,0,0,1,1,0,0,20,FRA
2434f24a,0,0,0,0,0,0,3,3,0,0,0,2,2,9,0,20,FRA
243f4a0b,80,45,23,52,5,35,82,47,26,9,17,41,121,40,6,20,FRA
244bc2c8,15,9,7,6,2,3,10,7,9,2,7,7,22,16,0,20,FRA
247accfd,26,14,17,8,1,15,20,5,29,18,11,37,63,78,2,20,FRA
24eb7ed6,8,6,4,2,2,3,13,10,4,0,4,8,16,6,0,20,FRA
254c927d,1,0,1,0,0,1,1,0,1,0,1,0,1,0,0,20,FRA
26777636,22,14,4,15,3,11,34,23,10,0,10,8,30,3,0,20,FRA
2677a1de,17,9,5,7,5,9,27,18,11,0,11,4,21,0,0,20,FRA
26975a92,1,1,1,0,0,1,2,1,1,0,1,0,1,10,4,20,FRA
26e4447b,48,26,28,17,3,20,64,44,21,0,21,15,63,14,0,20,FRA
275e2c51,24,17,16,7,1,8,18,10,35,18,17,39,63,118,1,20,FRA
279ddf6a,71,52,29,33,9,19,49,30,23,8,15,36,107,36,0,20,FRA
288e1e13,13,9,7,5,1,8,12,4,11,11,0,18,31,54,0,20,FRA
28a65a2c,0,0,0,0,0,0,0,0,0,0,0,1,1,2,0,20,FRA
28dabd43,0,0,0,0,0,0,1,1,0,0,0,0,0,11,1,20,FRA
2945f4b7,7,5,2,2,3,2,7,5,3,0,3,3,10,3,0,20,FRA
29c02c9f,10,4,2,4,4,5,9,4,6,1,5,6,16,9,0,20,FRA
29d8ad3f,27,15,22,5,0,16,31,15,25,14,11,40,67,130,2,20,FRA
29ef0f49,2,0,0,2,0,0,3,3,5,0,5,1,3,7,0,20,FRA
2a657da0,12,6,5,5,2,6,17,11,13,0,13,2,14,0,0,20,FRA
2acf0cd7,27,19,12,12,3,6,12,6,13,7,6,12,39,20,1,20,FRA
2b1bed19,44,24,17,17,10,10,28,18,25,5,20,53,97,21,2,20,FRA
2b3d9aad,0,0,0,0,0,0,0,0,1,0,1,0,0,0,0,20,FRA
2b9fdeea,1,0,0,1,0,0,1,1,0,0,0,0,1,0,0,20,FRA
2c92d3c0,1,0,0,1,0,0,1,1,0,0,0,2,3,1,0,20,FRA
2e52206e,2,1,0,1,1,0,4,4,2,0,2,2,4,4,0,20,FRA
2ee1b96b,0,0,0,0,0,0,0,0,0,0,0,0,0,0,0,20,FRA
2f965a72,0,0,0,0,0,0,0,0,0,0,0,0,0,1,1,20,FRA
2fa2a875,0,0,0,0,0,0,1,1,1,0,1,0,0,10,5,20,FRA
3010aefb,1,0,1,0,0,1,1,0,0,0,0,0,1,0,0,20,FRA
30144daa,18,11,7,8,3,10,26,16,11,0,11,7,25,5,0,20,FRA
3071a619,5,2,1,3,1,1,3,2,2,0,2,4,9,5,0,20,FRA
31a62dc7,53,28,18,28,7,27,60,33,24,4,20,26,79,39,0,20,FRA
3225654e,1,0,1,0,0,0,0,0,1,0,1,1,2,0,0,20,FRA
32c2d95f,46,33,29,15,2,17,30,13,26,14,12,47,93,99,1,20,FRA
32f3d97e,19,15,5,9,5,9,30,21,8,2,6,16,35,8,0,20,FRA
33508c78,11,4,6,3,2,6,29,23,8,1,7,7,18,3,0,20,FRA
33887998,0,0,0,0,0,0,0,0,0,0,0,0,0,5,1,20,FRA
3423f250,22,18,5,12,5,10,32,22,23,1,22,17,39,14,1,20,FRA
34bb6fbd,53,33,29,20,4,33,75,42,24,11,13,29,82,60,0,20,FRA
3681cfff,14,11,10,4,0,3,7,4,14,8,6,17,31,26,1,20,FRA
3708e9fa,49,27,17,26,6,14,69,55,28,0,28,31,80,22,0,20,FRA
375622c5,22,13,7,12,3,13,44,31,9,0,9,10,32,10,0,20,FRA
380a15e2,0,0,0,0,0,0,0,0,0,0,0,0,0,0,0,20,FRA
38568467,3,1,1,2,0,2,10,8,5,0,5,4,7,5,0,20,FRA
38d9ce53,0,0,0,0,0,0,0,0,0,0,0,0,0,0,0,20,FRA
3a74f92b,0,0,0,0,0,0,1,1,0,0,0,0,0,0,0,20,FRA
3b5cd50d,8,5,2,5,1,2,8,6,1,0,1,3,11,0,0,20,FRA
3befc2b6,76,53,45,29,2,39,71,32,32,17,15,34,110,111,1,20,FRA
3c6bbbab,76,49,53,22,1,34,57,23,30,11,19,59,135,98,0,20,FRA
3dd738a1,36,22,19,15,2,19,28,9,6,2,4,11,47,21,0,20,FRA
3deb2342,0,0,0,0,0,0,0,0,0,0,0,0,0,0,0,20,FRA
3e092724,17,11,5,12,0,7,27,20,8,2,6,19,36,16,3,20,FRA
3eaf8817,4,3,1,1,2,1,6,5,5,0,5,3,7,1,0,20,FRA
3ef0fa48,30,22,11,15,4,17,42,25,9,2,7,19,49,10,1,20,FRA
3ef68782,2,0,1,1,0,1,3,2,1,0,1,1,3,0,0,20,FRA
3f1a7191,13,7,10,2,1,4,8,4,8,3,5,15,28,15,0,20,FRA
3f5b4635,37,27,20,16,1,18,38,20,8,7,1,47,84,66,1,20,FRA
4085f08e,36,16,25,9,2,18,43,25,33,10,23,34,70,59,1,20,FRA
414e1f69,2,2,1,1,0,1,3,2,0,0,0,1,3,1,0,20,FRA
41e7ef1c,23,16,5,14,4,11,23,12,12,1,11,18,41,24,1,20,FRA
42dcf26d,19,13,14,4,1,9,13,4,7,4,3,18,37,65,0,20,FRA
42eaa028,15,7,3,7,5,6,24,18,26,2,24,5,20,3,0,20,FRA
42fd9c7f,7,2,1,5,1,3,10,7,4,0,4,3,10,0,0,20,FRA
4315f30d,19,11,13,6,0,9,22,13,10,4,6,38,57,31,4,20,FRA
433dc9a2,42,27,19,16,7,20,51,31,13,1,12,10,52,26,0,20,FRA
436a9dd0,19,11,9,9,1,5,14,9,10,2,8,6,25,4,0,20,FRA
43b78598,4,2,1,3,0,1,10,9,7,1,6,2,6,11,0,20,FRA
43e7a164,46,32,27,19,0,21,29,8,14,8,6,55,101,82,4,20,FRA
44f8c299,49,26,16,29,4,16,45,29,20,4,16,15,64,19,0,20,FRA
450e277f,8,2,6,2,0,5,7,2,4,2,2,5,13,38,1,20,FRA
45c1c326,36,23,13,18,5,12,42,30,8,0,8,13,49,13,0,20,FRA
462475ed,15,10,2,10,3,2,13,11,11,0,11,2,17,20,0,20,FRA
46750e9c,4,2,2,2,0,0,3,3,0,0,0,2,6,1,0,20,FRA
468fdbad,11,5,8,0,3,2,4,2,5,2,3,1,12,3,0,20,FRA
46907171,6,4,4,2,0,3,8,5,2,0,2,4,10,0,0,20,FRA
469d3d84,9,9,2,5,2,2,7,5,2,0,2,4,13,4,0,20,FRA
46a7b605,0,0,0,0,0,0,1,1,1,0,1,0,0,0,0,20,FRA
46d50339,24,16,14,8,2,14,37,23,8,2,6,18,42,29,0,20,FRA
46faabfa,8,7,2,5,1,5,16,11,5,1,4,10,18,11,1,20,FRA
4749367a,5,4,2,3,0,5,10,5,4,1,3,4,9,5,1,20,FRA
475583ff,36,25,14,13,9,17,47,30,18,5,13,33,69,43,0,20,FRA
4788cb6b,1,0,0,0,1,0,0,0,0,0,0,0,1,0,0,20,FRA
47af88b8,17,13,12,5,0,10,14,4,32,29,3,20,37,83,0,20,FRA
47c609d5,3,3,1,0,2,0,0,0,6,0,6,1,4,1,0,20,FRA
48b28bfd,16,12,2,11,3,3,9,6,6,1,5,15,31,10,0,20,FRA
49070d66,5,2,3,2,0,2,7,5,3,2,1,10,15,17,0,20,FRA
4914ed4a,4,1,1,2,1,2,3,1,2,0,2,4,8,8,0,20,FRA
4a537185,0,0,0,0,0,0,0,0,0,0,0,0,0,0,0,20,FRA
4b96c347,28,18,8,15,5,12,23,11,6,1,5,19,47,10,0,20,FRA
4be0b467,15,5,0,11,4,5,9,4,3,0,3,1,16,0,0,20,FRA
4bf69118,36,22,17,17,2,22,47,25,16,6,10,22,58,41,0,20,FRA
4c4ffacc,57,35,38,15,4,21,41,20,22,10,12,22,79,61,1,20,FRA
4c700f46,14,5,10,2,2,8,13,5,14,7,7,15,29,33,1,20,FRA
4c93a97f,0,0,0,0,0,0,0,0,1,0,1,0,0,2,0,20,FRA
4e0afc5d,62,40,45,13,4,30,67,37,20,6,14,17,79,44,0,20,FRA
4e7bfc23,12,6,5,7,0,7,12,5,6,0,6,1,13,3,0,20,FRA
4e7d66f8,28,20,11,12,5,12,28,16,14,3,11,8,36,6,0,20,FRA
4e7db402,1,1,1,0,0,1,1,0,0,0,0,0,1,12,0,20,FRA
4f255115,30,14,15,13,2,11,29,18,11,3,8,13,43,21,2,20,FRA
5046b7d4,7,4,1,2,4,1,7,6,4,1,3,2,9,2,0,20,FRA
5065d67d,21,14,15,6,0,9,9,0,13,10,3,28,49,66,0,20,FRA
509a4ccb,6,5,1,1,4,3,9,6,4,1,3,2,8,7,1,20,FRA
5148dcc5,20,15,7,10,3,3,14,11,14,1,13,10,30,11,0,20,FRA
51c30111,1,0,0,0,1,1,2,1,1,1,0,1,2,0,0,20,FRA
51c83a90,0,0,0,0,0,0,0,0,1,0,1,0,0,0,0,20,FRA
51dbeea9,10,7,4,5,1,5,10,5,2,0,2,1,11,2,1,20,FRA
527f063d,5,1,0,2,3,0,3,3,7,0,7,1,6,2,0,20,FRA
5314e067,45,26,25,13,7,25,48,23,13,2,11,23,68,39,3,20,FRA
53283127,0,0,0,0,0,0,0,0,0,0,0,0,0,0,0,20,FRA
53e585f2,2,2,0,2,0,0,2,2,0,0,0,2,4,0,0,20,FRA
54131505,20,11,8,10,2,7,23,16,9,0,9,5,25,6,1,20,FRA
542cc80f,25,13,13,11,1,6,20,14,7,2,5,7,32,5,0,20,FRA
57a46f3f,0,0,0,0,0,0,0,0,0,0,0,0,0,0,0,20,FRA
5853ac44,2,1,0,1,1,1,3,2,4,2,2,3,5,6,0,20,FRA
586ef3a3,0,0,0,0,0,0,1,1,0,0,0,1,1,1,1,20,FRA
58ad9383,1,1,1,0,0,1,1,0,0,0,0,1,2,9,0,20,FRA
58ae47b2,22,12,8,8,6,10,26,16,8,1,7,8,30,12,0,20,FRA
59bf127b,48,24,16,27,5,29,54,25,12,4,8,29,77,17,0,20,FRA
5b1bf5e3,46,27,13,27,6,17,48,31,15,1,14,16,62,8,2,20,FRA
5b5724d2,23,8,15,6,2,13,17,4,2,1,1,19,42,22,0,20,FRA
5c2da10f,4,1,0,3,1,0,4,4,1,1,0,0,4,7,0,20,FRA
5c9ac7f0,3,1,0,2,1,1,5,4,0,0,0,0,3,7,0,20,FRA
5ceba7fc,5,2,0,1,4,3,5,2,2,0,2,5,10,1,0,20,FRA
5d42d487,8,3,3,2,3,3,9,6,7,1,6,6,14,5,0,20,FRA
5d93ccee,0,0,0,0,0,0,0,0,1,1,0,1,1,6,0,20,FRA
5d9577aa,0,0,0,0,0,0,0,0,0,0,0,0,0,0,0,20,FRA
5e080f73,13,8,5,6,2,9,32,23,8,0,8,1,14,7,0,20,FRA
5e22e2a4,91,53,39,43,9,35,79,44,27,5,22,43,134,36,0,20,FRA
5f0241b2,0,0,0,0,0,0,0,0,0,0,0,0,0,1,2,20,FRA
5f26e0c5,28,19,20,7,1,11,14,3,16,10,6,16,44,42,2,20,FRA
5f3eaaf5,15,7,5,4,6,6,21,15,6,0,6,8,23,6,0,20,FRA
6043997c,1,0,1,0,0,0,0,0,1,0,1,1,2,5,0,20,FRA
60f58477,0,0,0,0,0,0,0,0,0,0,0,0,0,0,0,20,FRA
61590953,40,29,24,16,0,23,42,19,14,6,8,32,72,37,0,20,FRA
6191093d,26,18,7,15,4,5,26,21,17,1,16,14,40,11,0,20,FRA
625c144a,3,1,3,0,0,3,4,1,1,0,1,2,5,9,1,20,FRA
6421dd73,32,20,7,17,8,15,30,15,17,0,17,14,46,7,0,20,FRA
6481421d,16,8,5,6,5,7,24,17,14,1,13,9,25,5,0,20,FRA
65391fa7,6,3,2,4,0,4,4,0,0,0,0,4,10,14,0,20,FRA
6578600f,0,0,0,0,0,0,0,0,0,0,0,0,0,1,0,20,FRA
6605d143,2,1,0,2,0,0,6,6,6,5,1,4,6,43,0,20,FRA
6690ef25,28,17,15,13,0,15,24,9,19,12,7,28,56,42,1,20,FRA
67ac5bb8,41,29,27,11,3,15,22,7,27,18,9,22,63,86,2,20,FRA
67b7357e,14,7,11,3,0,2,4,2,11,10,1,10,24,44,1,20,FRA
68a87d66,1,1,1,0,0,0,1,1,0,0,0,0,1,0,0,20,FRA
69384e5d,12,7,1,9,2,3,21,18,10,0,10,4,16,1,0,20,FRA
698b37b8,0,0,0,0,0,0,7,7,2,0,2,0,0,3,0,20,FRA
698f11e3,3,3,2,1,0,1,1,0,0,0,0,3,6,2,0,20,FRA
6a26e528,0,0,0,0,0,0,0,0,0,0,0,0,0,0,0,20,FRA
6a827d8e,24,11,15,6,3,13,31,18,12,1,11,24,48,11,1,20,FRA
6b200d45,27,20,16,11,0,11,14,3,23,17,6,39,66,59,0,20,FRA
6b2c894b,43,26,28,14,1,19,28,9,13,3,10,24,67,34,0,20,FRA
6b4436ba,2,1,0,2,0,2,4,2,0,0,0,4,6,0,0,20,FRA
6bca20fe,6,4,1,4,1,1,3,2,2,0,2,2,8,1,0,20,FRA
6bde367b,52,39,16,30,6,25,77,52,10,0,10,35,87,21,1,20,FRA
6be41a31,2,2,1,0,1,0,2,2,1,0,1,1,3,0,0,20,FRA
6c8ddd52,6,4,3,1,2,4,8,4,0,0,0,2,8,5,0,20,FRA
6dfd8f05,29,14,18,9,2,14,28,14,24,9,15,27,56,50,0,20,FRA
6e5b5a45,54,29,24,28,2,28,63,35,31,16,15,42,96,48,2,20,FRA
6e7f1353,60,28,20,29,11,13,52,39,39,5,34,23,83,9,0,20,FRA
6fbde63a,3,2,2,1,0,1,6,5,4,2,2,3,6,1,0,20,FRA
706a60e1,14,10,5,6,3,5,12,7,8,0,8,3,17,3,0,20,FRA
7091324a,0,0,0,0,0,0,0,0,0,0,0,0,0,0,0,20,FRA
71ec39ef,58,32,19,34,5,17,56,39,19,7,12,31,89,27,1,20,FRA
72a0fb65,22,15,17,5,0,9,20,11,34,23,11,37,59,112,2,20,FRA
72c812f3,65,34,30,25,10,18,43,25,29,4,25,33,98,15,0,20,FRA
741418c3,26,16,8,11,7,13,35,22,20,4,16,11,37,4,0,20,FRA
74733221,0,0,0,0,0,0,1,1,0,0,0,0,0,3,0,20,FRA
75a63397,44,28,23,15,6,11,39,28,17,3,14,12,56,12,0,20,FRA
767212e6,36,22,23,13,0,21,53,32,22,7,15,33,69,46,1,20,FRA
76806215,0,0,0,0,0,0,0,0,0,0,0,0,0,0,0,20,FRA
770d7eb8,29,16,17,11,1,11,27,16,14,5,9,20,49,40,1,20,FRA
775185ae,8,6,3,3,2,3,6,3,1,0,1,4,12,2,0,20,FRA
779847d6,47,36,28,17,2,31,55,24,18,13,5,40,87,77,1,20,FRA
77d7c96f,33,21,12,16,5,15,23,8,12,3,9,19,52,34,0,20,FRA
7800bdb8,0,0,0,0,0,0,0,0,0,0,0,0,0,0,0,20,FRA
7909ffa4,30,18,13,17,0,15,35,20,12,5,7,20,50,12,1,20,FRA
796b1c41,3,1,0,3,0,2,5,3,2,0,2,1,4,4,0,20,FRA
79b2399c,42,32,18,16,8,16,48,32,17,3,14,21,63,28,0,20,FRA
7b075c75,1,1,0,1,0,0,0,0,6,5,1,4,5,17,0,20,FRA
7b9a9e25,7,3,3,3,1,4,13,9,11,1,10,4,11,6,0,20,FRA
7b9c2d84,105,64,45,56,4,48,96,48,26,8,18,34,139,35,0,20,FRA
7c2965bb,1,0,0,1,0,0,0,0,0,0,0,0,1,0,0,20,FRA
7c6d6c96,3,1,0,3,0,0,0,0,6,3,3,2,5,15,0,20,FRA
7cab69b5,28,17,13,14,1,10,21,11,8,3,5,16,44,24,0,20,FRA
7cdda3bf,21,12,4,10,7,9,38,29,21,0,21,7,28,32,1,20,FRA
7cf431a5,28,16,19,9,0,16,29,13,15,4,11,12,40,12,0,20,FRA
7d937aa1,13,7,5,8,0,5,22,17,8,0,8,8,21,4,0,20,FRA
7d9397f8,22,7,14,8,0,6,17,11,12,2,10,7,29,13,0,20,FRA
7d9b37bf,0,0,0,0,0,0,0,0,0,0,0,0,0,1,0,20,FRA
7dfbba27,23,17,5,11,7,8,25,17,14,1,13,10,33,3,0,20,FRA
7e82a78f,13,11,3,8,2,7,28,21,9,1,8,9,22,2,0,20,FRA
7ebfac0f,1,0,0,1,0,1,1,0,1,0,1,0,1,1,0,20,FRA
7f622eef,1,1,0,1,0,0,3,3,0,0,0,0,1,2,0,20,FRA
7fecbcdb,10,7,7,1,2,8,15,7,4,1,3,4,14,18,0,20,FRA
7ffaf233,3,3,1,1,1,1,2,1,1,0,1,1,4,2,0,20,FRA
80556f08,26,22,9,16,1,12,27,15,14,2,12,9,35,12,1,20,FRA
808df563,6,4,3,3,0,2,3,1,2,1,1,2,8,2,0,20,FRA
80d1adb3,1,0,1,0,0,0,1,1,0,0,0,0,1,1,0,20,FRA
80e4c841,27,19,18,9,0,10,22,12,15,11,4,40,67,120,3,20,FRA
814ac171,0,0,0,0,0,0,1,1,1,0,1,0,0,2,0,20,FRA
81d3318f,12,6,5,4,3,8,15,7,5,0,5,3,15,2,0,20,FRA
822d51d7,41,26,16,22,3,21,45,24,23,2,21,22,63,16,0,20,FRA
82518f62,12,7,5,6,1,5,10,5,1,0,1,4,16,1,0,20,FRA
82671804,6,3,3,3,0,3,5,2,5,2,3,5,11,6,0,20,FRA
8332db56,25,16,18,6,1,12,21,9,17,1,16,15,40,28,0,20,FRA
834b5c4c,0,0,0,0,0,0,1,1,0,0,0,1,1,6,0,20,FRA
8413ceb1,1,0,1,0,0,0,3,3,1,1,0,1,2,5,0,20,FRA
84549a07,0,0,0,0,0,0,2,2,0,0,0,2,2,0,0,20,FRA
84d94b91,26,12,6,18,2,9,26,17,11,4,7,10,36,25,3,20,FRA
8577e60a,33,20,12,16,5,18,32,14,20,2,18,18,51,5,0,20,FRA
85e2d218,12,1,6,5,1,6,9,3,1,0,1,2,14,1,0,20,FRA
8608f269,0,0,0,0,0,0,1,1,0,0,0,0,0,1,0,20,FRA
861227d2,30,19,25,5,0,19,32,13,31,18,13,31,61,116,0,20,FRA
86574238,35,20,17,14,4,13,30,17,15,1,14,19,54,10,1,20,FRA
86e7deaf,28,16,15,13,0,13,16,3,18,15,3,26,54,54,0,20,FRA
8746d5d0,35,25,15,17,3,14,25,11,11,2,9,30,65,37,0,20,FRA
87e9c7cd,0,0,0,0,0,0,0,0,0,0,0,0,0,0,0,20,FRA
8802c1d5,9,7,4,4,1,4,11,7,6,1,5,2,11,3,1,20,FRA
8846a40f,30,18,16,13,1,12,37,25,19,0,19,17,47,9,0,20,FRA
885b7aa7,62,35,30,31,1,30,59,29,27,6,21,49,111,31,0,20,FRA
8a2248b4,1,1,1,0,0,1,3,2,0,0,0,0,1,8,0,20,FRA
8b28686a,2,2,2,0,0,1,1,0,0,0,0,0,2,2,0,20,FRA
8b298f56,21,12,6,15,0,11,40,29,7,2,5,7,28,16,0,20,FRA
8bbe2df5,28,11,9,17,2,12,27,15,16,3,13,22,50,28,0,20,FRA
8c90fd7a,8,4,1,0,7,1,11,10,8,0,8,11,19,32,0,20,FRA
8c955557,4,3,2,1,1,1,6,5,1,0,1,3,7,0,0,20,FRA
8d043f1d,7,3,4,3,0,4,7,3,1,0,1,1,8,3,0,20,FRA
8da74c05,6,2,2,3,1,4,16,12,7,2,5,7,13,1,1,20,FRA
8eec784d,0,0,0,0,0,0,1,1,0,0,0,0,0,1,0,20,FRA
8f325097,5,5,3,2,0,2,3,1,8,6,2,9,14,18,0,20,FRA
8f4d116f,52,27,20,28,4,24,69,45,38,18,20,38,90,59,0,20,FRA
8f534f8e,2,2,2,0,0,2,2,0,0,0,0,1,3,0,0,20,FRA
8f696594,4,3,2,0,2,0,5,5,0,0,0,2,6,2,0,20,FRA
8fa8f8d2,0,0,0,0,0,0,2,2,0,0,0,0,0,3,3,20,FRA
9001138b,3,2,0,2,1,0,5,5,2,0,2,4,7,2,0,20,FRA
909222de,15,10,3,8,4,4,10,6,7,0,7,4,19,3,0,20,FRA
90eb507d,61,36,31,23,7,30,48,18,15,4,11,39,100,59,1,20,FRA
90f87966,19,11,11,7,1,11,22,11,19,11,8,28,47,90,1,20,FRA
90fcf472,20,9,8,10,2,2,13,11,6,0,6,9,29,8,0,20,FRA
91e58f66,4,4,1,3,0,0,1,1,0,0,0,1,5,1,0,20,FRA
91f2da4c,5,5,4,0,1,1,5,4,5,0,5,3,8,2,0,20,FRA
92232aad,44,26,22,15,7,24,47,23,21,11,10,43,87,59,0,20,FRA
923f4dda,7,3,1,4,2,2,7,5,13,6,7,4,11,21,0,20,FRA
92b56413,10,4,3,6,1,2,12,10,6,0,6,6,16,1,0,20,FRA
92cd4bef,68,36,30,32,6,22,60,38,21,5,16,29,97,23,0,20,FRA
934a0957,2,0,2,0,0,1,4,3,0,0,0,2,4,2,0,20,FRA
93c942fb,0,0,0,0,0,0,0,0,0,0,0,0,0,0,0,20,FRA
942b4f90,22,16,2,12,8,8,19,11,12,0,12,4,26,1,0,20,FRA
94f8d10c,29,15,17,11,1,18,26,8,17,6,11,26,55,98,0,20,FRA
95981861,1,1,0,1,0,0,2,2,2,0,2,3,4,1,0,20,FRA
972aeb2a,19,9,15,3,1,5,10,5,13,4,9,21,40,36,1,20,FRA
9744ff80,12,7,3,6,3,4,25,21,19,1,18,10,22,5,0,20,FRA
97bfa797,3,0,1,2,0,1,6,5,2,0,2,3,6,0,0,20,FRA
97fb4608,11,8,6,3,2,6,13,7,4,0,4,5,16,8,0,20,FRA
9980269a,11,7,0,5,6,3,5,2,3,1,2,6,17,32,0,20,FRA
9a1f2e1c,24,16,12,8,4,10,18,8,6,3,3,10,34,14,0,20,FRA
9a506145,4,3,1,3,0,2,2,0,1,0,1,6,10,17,0,20,FRA
9ae9eaea,28,18,18,7,3,13,26,13,7,3,4,26,54,32,0,20,FRA
9b398aea,29,22,14,8,7,10,21,11,14,1,13,18,47,33,0,20,FRA
9b6556d2,11,6,3,7,1,4,12,8,5,0,5,2,13,1,0,20,FRA
9bb0b9f1,6,5,3,2,1,5,9,4,1,0,1,1,7,5,0,20,FRA
9c2b1f11,0,0,0,0,0,0,0,0,0,0,0,0,0,0,0,20,FRA
9cebd6ce,1,1,1,0,0,0,0,0,0,0,0,0,1,6,0,20,FRA
9daeac61,11,5,8,2,1,6,7,1,7,2,5,6,17,21,0,20,FRA
9e64fc85,3,2,3,0,0,2,4,2,5,3,2,8,11,41,0,20,FRA
a0434482,24,12,7,15,2,8,28,20,25,4,21,9,33,25,0,20,FRA
a046fc35,0,0,0,0,0,0,1,1,0,0,0,1,1,1,1,20,FRA
a0791826,14,10,7,4,3,7,19,12,5,0,5,6,20,3,0,20,FRA
a0b65401,35,18,15,16,4,11,34,23,13,3,10,15,50,18,0,20,FRA
a0f9b535,20,13,12,6,2,9,28,19,7,0,7,9,29,5,1,20,FRA
a2d873dd,9,7,2,5,2,4,20,16,7,0,7,5,14,5,0,20,FRA
a440d8ca,15,12,11,4,0,7,7,0,10,8,2,15,30,42,0,20,FRA
a46472d0,31,21,20,10,1,12,17,5,8,5,3,25,56,47,1,20,FRA
a4b1028a,55,26,34,18,3,32,64,32,22,5,17,48,103,59,1,20,FRA
a4c3f7af,55,29,18,32,5,20,53,33,16,3,13,23,78,8,1,20,FRA
a5db0bec,28,12,6,18,4,10,35,25,15,1,14,13,41,11,0,20,FRA
a634b9d2,18,10,6,11,1,11,16,5,8,0,8,7,25,10,0,20,FRA
a8567629,2,2,1,1,0,1,1,0,0,0,0,0,2,2,0,20,FRA
a8797cf1,27,11,10,13,4,18,31,13,8,2,6,16,43,21,0,20,FRA
a99138af,16,7,8,5,3,2,9,7,2,2,0,2,18,0,0,20,FRA
aa1a8c7e,0,0,0,0,0,0,1,1,0,0,0,0,0,0,0,20,FRA
aad56ca3,0,0,0,0,0,0,0,0,0,0,0,0,0,0,0,20,FRA
ab096c6f,17,10,13,4,0,9,21,12,8,3,5,30,47,44,2,20,FRA
ac89503b,5,3,5,0,0,4,5,1,3,3,0,2,7,11,0,20,FRA
ad7b19ef,29,18,11,14,4,14,25,11,10,0,10,22,51,7,1,20,FRA
ad82197c,32,21,18,13,1,17,27,10,29,24,5,26,58,97,0,20,FRA
ae59b359,19,12,6,13,0,9,19,10,6,0,6,16,35,9,0,20,FRA
ae7d0ecd,0,0,0,0,0,0,1,1,1,0,1,0,0,15,1,20,FRA
aef6e670,33,25,25,8,0,14,20,6,7,3,4,21,54,33,1,20,FRA
af0c835b,4,1,2,1,1,2,7,5,2,0,2,4,8,7,0,20,FRA
b0547a87,35,21,9,22,4,18,56,38,15,3,12,6,41,19,0,20,FRA
b056e3da,0,0,0,0,0,0,0,0,0,0,0,0,0,0,1,20,FRA
b2336681,9,4,5,3,1,2,7,5,3,2,1,11,20,28,0,20,FRA
b2791a55,0,0,0,0,0,0,2,2,1,1,0,0,0,6,0,20,FRA
b2bd0f6c,12,6,5,5,2,7,29,22,19,3,16,16,28,8,2,20,FRA
b34c63a5,3,2,0,1,2,3,4,1,3,0,3,0,3,0,0,20,FRA
b49729cb,2,1,2,0,0,2,4,2,1,0,1,4,6,14,3,20,FRA
b4c816a9,0,0,0,0,0,0,1,1,0,0,0,0,0,0,0,20,FRA
b5bb8188,0,0,0,0,0,0,2,2,1,0,1,1,1,0,0,20,FRA
b6047994,3,3,1,1,1,1,4,3,1,0,1,1,4,0,0,20,FRA
b666421b,23,12,14,7,2,10,17,7,23,13,10,27,50,85,1,20,FRA
b66d1d8a,51,25,27,20,4,31,52,21,19,4,15,33,84,32,0,20,FRA
b684a484,7,6,1,4,2,0,2,2,3,0,3,1,8,2,0,20,FRA
b748968d,15,6,10,3,2,7,10,3,5,4,1,11,26,23,0,20,FRA
b871bf55,7,5,6,1,0,7,14,7,6,2,4,7,14,32,0,20,FRA
b8d22478,33,17,19,12,2,16,36,20,13,1,12,24,57,10,0,20,FRA
b92edde2,0,0,0,0,0,0,0,0,0,0,0,0,0,0,0,20,FRA
b94b8be1,3,2,1,2,0,2,4,2,3,0,3,0,3,0,0,20,FRA
b98cea65,0,0,0,0,0,0,0,0,0,0,0,0,0,2,0,20,FRA
b99bec05,73,49,44,21,8,40,69,29,31,7,24,67,140,90,2,20,FRA
bb67bff1,3,3,0,3,0,1,1,0,0,0,0,0,3,1,0,20,FRA
bc0bfc64,5,2,0,2,3,1,10,9,8,4,4,1,6,3,0,20,FRA
bc270726,1,1,1,0,0,1,2,1,0,0,0,0,1,10,4,20,FRA
bc50c437,0,0,0,0,0,0,1,1,1,0,1,1,1,0,0,20,FRA
bc7b4580,38,22,18,20,0,25,35,10,10,5,5,18,56,19,0,20,FRA
bcc81786,27,21,21,5,1,14,25,11,14,7,7,18,45,56,0,20,FRA
bced0375,84,54,37,42,5,33,74,41,28,10,18,39,123,49,4,20,FRA
bcf1b2e9,1,1,1,0,0,1,3,2,0,0,0,0,1,12,0,20,FRA
bdedd861,8,5,0,7,1,2,13,11,3,0,3,2,10,9,0,20,FRA
be13e5a8,0,0,0,0,0,0,0,0,1,0,1,0,0,2,0,20,FRA
beae3a73,39,23,17,20,2,18,46,28,17,2,15,12,51,37,0,20,FRA
beb391dd,30,19,18,8,4,13,23,10,16,1,15,21,51,19,1,20,FRA
bef0a7ac,12,9,0,9,3,3,18,15,15,2,13,3,15,23,1,20,FRA
bef22bc4,10,6,1,6,3,4,10,6,11,0,11,6,16,5,0,20,FRA
c05d65d1,1,1,0,0,1,1,1,0,1,0,1,1,2,0,0,20,FRA
c1b16364,10,6,3,4,3,4,8,4,3,0,3,5,15,1,0,20,FRA
c20bdcd7,37,21,23,11,3,25,41,16,16,1,15,19,56,20,0,20,FRA
c26a3918,34,22,18,13,3,16,36,20,16,3,13,22,56,51,0,20,FRA
c3e4ecbb,3,2,2,1,0,3,5,2,4,1,3,9,12,29,0,20,FRA
c46fa34c,11,8,6,4,1,4,24,20,6,1,5,4,15,10,1,20,FRA
c47541e0,27,14,8,12,7,8,19,11,17,2,15,21,48,16,0,20,FRA
c4bbea9f,27,17,20,7,0,13,28,15,22,18,4,49,76,121,1,20,FRA
c58270f8,0,0,0,0,0,0,2,2,0,0,0,0,0,1,0,20,FRA
c5a500ca,36,20,17,14,5,12,47,35,11,1,10,11,47,23,0,20,FRA
c6056d58,26,14,15,11,0,13,21,8,23,17,6,27,53,118,0,20,FRA
c69ef855,39,25,18,15,6,20,61,41,25,6,19,16,55,49,0,20,FRA
c6e5d20f,43,29,20,19,4,21,45,24,21,7,14,46,89,36,0,20,FRA
c7526c18,5,4,3,1,1,1,2,1,2,2,0,4,9,18,0,20,FRA
c76b7567,36,21,11,16,9,15,47,32,21,1,20,9,45,9,0,20,FRA
c795c408,2,2,2,0,0,1,1,0,3,1,2,3,5,7,0,20,FRA
c801616a,33,23,15,16,2,14,47,33,17,2,15,12,45,20,1,20,FRA
c8090cb3,39,16,12,26,1,16,50,34,17,0,17,13,52,6,0,20,FRA
ca122e29,1,1,1,0,0,0,1,1,1,0,1,0,1,0,0,20,FRA
cac76a72,0,0,0,0,0,0,0,0,0,0,0,0,0,5,3,20,FRA
cc41f558,29,19,19,8,2,13,24,11,21,4,17,23,52,43,0,20,FRA
cc77354e,67,34,37,27,3,27,57,30,27,14,13,34,101,53,1,20,FRA
cc83b74d,10,6,0,3,7,4,17,13,18,2,16,10,20,24,0,20,FRA
ccb1c3af,6,3,1,3,2,2,5,3,1,0,1,1,7,0,0,20,FRA
ccee698e,3,2,1,2,0,1,1,0,1,0,1,0,3,3,0,20,FRA
ce492295,16,11,14,1,1,10,30,20,14,13,1,15,31,47,0,20,FRA
cecbce23,1,0,1,0,0,1,2,1,2,0,2,0,1,14,2,20,FRA
cfd8dde3,1,1,1,0,0,1,3,2,2,0,2,2,3,3,0,20,FRA
d07e3b41,16,10,6,6,4,5,16,11,11,0,11,8,24,3,1,20,FRA
d14229f3,21,18,5,11,5,4,21,17,16,1,15,5,26,5,0,20,FRA
d21e361a,7,5,2,2,3,4,14,10,5,0,5,2,9,4,0,20,FRA
d2448564,34,22,13,16,5,11,30,19,9,0,9,14,48,5,0,20,FRA
d26cd32d,5,3,5,0,0,2,8,6,4,3,1,4,9,10,0,20,FRA
d33c706e,28,18,11,9,8,7,27,20,21,6,15,3,31,10,0,20,FRA
d3ce9f1f,27,15,13,12,2,10,22,12,9,3,6,17,44,20,0,20,FRA
d4133fa1,29,14,12,16,1,12,43,31,14,4,10,40,69,47,1,20,FRA
d4d35152,16,10,7,7,2,5,9,4,4,0,4,7,23,4,0,20,FRA
d504b3e1,13,9,4,5,4,6,14,8,4,1,3,7,20,5,0,20,FRA
d512db65,0,0,0,0,0,0,2,2,0,0,0,0,0,2,0,20,FRA
d520120b,12,8,1,6,5,4,17,13,9,2,7,8,20,29,0,20,FRA
d5f2f82b,39,20,17,18,4,11,26,15,25,8,17,25,64,31,1,20,FRA
d63e2912,57,36,26,24,7,25,40,15,20,5,15,23,80,34,1,20,FRA
d6f88a1d,37,22,14,19,4,10,37,27,19,6,13,12,49,14,2,20,FRA
d7bf3d19,43,27,18,21,4,21,61,40,23,9,14,36,79,14,2,20,FRA
d83f8f69,1,1,1,0,0,1,1,0,0,0,0,0,1,2,0,20,FRA
d8992b84,23,18,11,11,1,11,24,13,9,2,7,8,31,5,0,20,FRA
d8b97bb3,0,0,0,0,0,0,0,0,0,0,0,0,0,0,0,20,FRA
d9764034,42,26,28,13,1,24,41,17,30,13,17,25,67,69,2,20,FRA
d9a66c60,6,4,2,2,2,2,4,2,0,0,0,0,6,1,0,20,FRA
dab1b8dc,1,1,1,0,0,1,1,0,0,0,0,0,1,0,0,20,FRA
db7849ca,16,11,7,8,1,8,23,15,12,1,11,5,21,13,1,20,FRA
db87a2c4,0,0,0,0,0,0,0,0,0,0,0,0,0,0,0,20,FRA
dcfb17f4,0,0,0,0,0,0,1,1,0,0,0,1,1,0,0,20,FRA
de488e56,48,35,27,19,2,36,61,25,21,4,17,39,87,64,0,20,FRA
debc2f28,16,8,8,6,2,5,12,7,6,1,5,5,21,5,0,20,FRA
dff153a4,22,14,7,14,1,13,29,16,7,1,6,15,37,7,0,20,FRA
e067808c,5,1,1,0,4,1,4,3,4,1,3,0,5,10,0,20,FRA
e0f3a1f6,18,9,13,5,0,9,18,9,20,16,4,33,51,87,1,20,FRA
e110ea4b,0,0,0,0,0,0,0,0,0,0,0,0,0,1,0,20,FRA
e162b013,27,21,9,12,6,16,26,10,17,5,12,18,45,19,1,20,FRA
e1df6989,53,27,18,27,8,19,46,27,18,2,16,17,70,7,0,20,FRA
e2f9bb5f,40,22,12,26,2,15,35,20,7,1,6,16,56,13,0,20,FRA
e34fc66d,17,9,15,2,0,7,19,12,16,12,4,10,27,74,2,20,FRA
e3756e72,1,1,1,0,0,0,1,1,0,0,0,0,1,0,0,20,FRA
e3d0b0c4,27,18,18,8,1,16,23,7,12,11,1,22,49,77,0,20,FRA
e3e05edf,25,10,16,6,3,16,28,12,8,0,8,17,42,35,0,20,FRA
e4b72e34,32,20,16,12,4,19,44,25,8,1,7,23,55,25,0,20,FRA
e4bb1f08,0,0,0,0,0,0,0,0,0,0,0,1,1,2,0,20,FRA
e50623a0,43,28,19,21,3,17,40,23,20,8,12,26,69,23,0,20,FRA
e54a9890,51,33,27,20,4,14,26,12,13,5,8,23,74,59,0,20,FRA
e562a02e,1,1,0,0,1,0,1,1,0,0,0,0,1,0,0,20,FRA
e5cd9da6,1,1,1,0,0,0,0,0,2,1,1,1,2,3,0,20,FRA
e61bdd69,53,33,30,21,2,29,58,29,15,1,14,13,66,22,1,20,FRA
e6777e6b,15,9,10,5,0,6,14,8,14,9,5,23,38,90,3,20,FRA
e68f2cb4,12,7,4,5,3,4,22,18,13,2,11,9,21,3,1,20,FRA
e6eadfb8,22,14,17,3,2,12,20,8,2,1,1,8,30,15,0,20,FRA
e768de1f,84,50,36,38,10,24,64,40,39,4,35,34,118,39,2,20,FRA
e7986081,12,7,2,5,5,4,14,10,14,3,11,5,17,31,0,20,FRA
e8a65bc8,0,0,0,0,0,0,1,1,0,0,0,0,0,0,0,20,FRA
e8edfdc9,16,8,6,7,3,3,7,4,4,2,2,1,17,9,0,20,FRA
e90af77c,3,1,0,3,0,1,5,4,1,1,0,2,5,2,0,20,FRA
e90dc1d5,1,1,1,0,0,0,0,0,1,0,1,1,2,0,0,20,FRA
e97150c0,15,9,13,1,1,9,20,11,21,17,4,17,32,59,1,20,FRA
e9743d8a,3,1,3,0,0,2,5,3,1,1,0,0,3,3,0,20,FRA
ea02beaf,24,13,12,9,3,10,33,23,23,2,21,27,51,23,1,20,FRA
ea0aa7e0,18,14,7,11,0,9,20,11,7,2,5,7,25,18,0,20,FRA
ea0ff634,22,12,6,11,5,6,31,25,16,3,13,8,30,26,0,20,FRA
ea42c03f,15,8,12,3,0,7,13,6,13,10,3,11,26,35,2,20,FRA
ea540835,3,3,0,3,0,2,5,3,0,0,0,1,4,0,0,20,FRA
ecada4fc,0,0,0,0,0,0,0,0,1,0,1,0,0,4,2,20,FRA
ed45c4a5,81,55,25,43,13,25,68,43,34,4,30,38,119,16,2,20,FRA
ed90babd,10,5,2,6,2,5,13,8,9,1,8,11,21,8,1,20,FRA
edd1466a,32,21,22,7,3,17,36,19,12,5,7,26,58,36,0,20,FRA
edd81e2a,7,5,6,1,0,4,7,3,11,9,2,6,13,42,0,20,FRA
ef2e5e1a,39,27,13,23,3,20,49,29,16,1,15,17,56,24,0,20,FRA
ef7cd87a,32,21,10,21,1,10,30,20,31,11,20,29,61,18,1,20,FRA
ef9c1c95,72,44,31,35,6,29,74,45,32,9,23,59,131,40,1,20,FRA
f00de885,0,0,0,0,0,0,0,0,0,0,0,1,1,11,0,20,FRA
f10983ae,37,25,21,15,1,19,31,12,16,3,13,16,53,29,0,20,FRA
f18d7ab2,22,14,13,9,0,9,11,2,12,4,8,15,37,28,1,20,FRA
f3600c02,18,10,3,13,2,9,29,20,11,1,10,4,22,7,1,20,FRA
f3642ba8,0,0,0,0,0,0,1,1,1,1,0,1,1,1,0,20,FRA
f36c432f,2,1,0,1,1,1,5,4,1,0,1,1,3,5,0,20,FRA
f449640d,36,25,21,11,4,17,32,15,10,1,9,24,60,45,0,20,FRA
f4bc42b1,20,12,8,9,3,5,18,13,9,1,8,4,24,5,0,20,FRA
f5044e54,63,27,34,21,8,31,88,57,38,12,26,32,95,43,0,20,FRA
f54d2149,17,11,2,13,2,5,7,2,7,2,5,5,22,6,0,20,FRA
f5b6fb78,40,25,23,11,6,16,43,27,14,5,9,29,69,58,1,20,FRA
f5c8b425,17,8,2,11,4,5,13,8,6,1,5,5,22,1,1,20,FRA
f5efb153,28,13,24,4,0,10,20,10,23,19,4,26,54,104,0,20,FRA
f6496133,31,19,10,14,7,14,35,21,11,0,11,12,43,4,1,20,FRA
f7691f63,37,24,10,22,5,18,39,21,18,4,14,17,54,25,0,20,FRA
f7b1d4e0,2,2,0,1,1,1,2,1,5,0,5,2,4,3,0,20,FRA
f81ef10d,24,15,10,13,1,11,25,14,14,2,12,9,33,6,1,20,FRA
f83c8d6c,12,8,5,4,3,3,13,10,8,4,4,6,18,12,0,20,FRA
f84a807c,0,0,0,0,0,0,1,1,0,0,0,0,0,1,0,20,FRA
f86ca403,18,13,9,8,1,3,5,2,8,1,7,14,32,13,0,20,FRA
f98b15f0,23,12,11,11,1,9,43,34,22,1,21,13,36,10,0,20,FRA
f9921b7f,4,4,3,1,0,1,5,4,0,0,0,1,5,3,0,20,FRA
f99fe221,49,32,31,14,4,29,46,17,16,4,12,23,72,47,0,20,FRA
f9d5908e,20,10,6,11,3,9,23,14,10,3,7,13,33,7,0,20,FRA
fa060e71,6,2,3,3,0,2,2,0,3,2,1,2,8,2,0,20,FRA
fa18c72e,20,11,3,8,9,5,31,26,14,0,14,4,24,6,0,20,FRA
fb14aa28,24,13,9,8,7,7,30,23,17,0,17,7,31,24,0,20,FRA
fbbb9269,18,11,9,4,5,6,22,16,8,1,7,18,36,23,0,20,FRA
fbf76716,16,8,4,4,8,7,21,14,2,0,2,4,20,1,0,20,FRA
fc62f087,20,11,9,10,1,8,14,6,9,5,4,10,30,32,0,20,FRA
fcb27134,54,32,35,16,3,22,34,12,14,3,11,31,85,25,0,20,FRA
fcb38f57,0,0,0,0,0,0,0,0,0,0,0,2,2,5,0,20,FRA
fcbcbd94,3,0,0,3,0,0,2,2,2,0,2,1,4,1,0,20,FRA
fd2bc67d,34,21,24,10,0,17,25,8,27,16,11,26,60,79,0,20,FRA
feb5d3ab,58,35,32,20,6,28,52,24,9,3,6,23,81,34,0,20,FRA
ff0ab48c,32,23,20,9,3,13,22,9,12,4,8,18,50,34,1,20,FRA
ff20acfe,0,0,0,0,0,0,0,0,0,0,0,0,0,0,0,20,FRA
ff3a6a60,0,0,0,0,0,0,1,1,0,0,0,0,0,0,0,20,FRA
ffec9769,8,4,0,2,6,4,15,11,5,0,5,1,9,11,1,20,FRA
00242715,42,22,28,13,1,14,29,15,31,15,16,49,91,79,0,21,GER
00242b75,58,32,19,26,13,20,50,30,34,9,25,57,115,55,0,21,GER
00844823,14,11,11,3,0,8,14,6,15,8,7,22,36,61,0,21,GER
00963611,42,29,29,12,1,27,46,19,25,10,15,59,101,66,1,21,GER
009a4f60,22,15,4,14,4,12,15,3,13,0,13,11,33,17,0,21,GER
016ff750,17,11,7,5,5,12,19,7,18,1,17,15,32,20,0,21,GER
01834aa0,29,20,25,4,0,14,25,11,33,26,7,40,69,104,0,21,GER
02760e49,1,1,0,1,0,0,8,8,4,0,4,5,6,3,0,21,GER
028e70b9,1,0,0,1,0,1,2,1,0,0,0,0,1,0,0,21,GER
042e8a49,14,8,6,7,1,2,21,19,22,0,22,4,18,3,0,21,GER
048a1cbc,30,13,14,8,8,16,31,15,21,4,17,28,58,31,1,21,GER
05439de2,37,21,14,19,4,17,32,15,29,13,16,43,80,60,0,21,GER
054849d2,37,27,21,13,3,17,29,12,17,5,12,22,59,55,0,21,GER
056d2d95,50,25,28,18,4,28,54,26,32,7,25,50,100,99,0,21,GER
05ba9d7c,26,15,10,7,9,11,23,12,20,0,20,10,36,11,0,21,GER
05d548d8,58,40,34,18,6,26,42,16,31,22,9,73,131,122,2,21,GER
05f99a4a,27,13,15,10,2,11,19,8,20,3,17,8,35,15,0,21,GER
061e8e23,15,6,3,6,6,5,21,16,17,0,17,6,21,3,0,21,GER
0630eb63,5,3,2,2,1,1,5,4,1,0,1,2,7,1,0,21,GER
070ec0b1,17,9,8,8,1,7,20,13,20,9,11,21,38,41,1,21,GER
080440a4,77,49,53,22,2,37,63,26,31,12,19,44,121,92,0,21,GER
08593525,71,41,22,42,7,33,90,57,41,12,29,78,149,50,0,21,GER
088ca1bd,37,19,17,13,7,16,30,14,26,10,16,28,65,38,0,21,GER
096a77c4,4,1,1,2,1,0,0,0,2,0,2,0,4,0,0,21,GER
0a1cb833,2,0,2,0,0,2,2,0,0,0,0,1,3,17,4,21,GER
0a3d6d2b,19,8,12,6,1,10,16,6,13,4,9,22,41,41,1,21,GER
0a89e877,12,7,4,5,3,2,9,7,9,1,8,8,20,8,0,21,GER
0b4f388a,15,10,1,13,1,0,6,6,16,1,15,8,23,8,0,21,GER
0b7dae21,20,9,12,6,2,8,17,9,13,4,9,18,38,40,0,21,GER
0c61c77c,21,14,13,5,3,9,20,11,14,1,13,12,33,8,0,21,GER
0cddeaa7,7,3,6,0,1,3,7,4,9,2,7,6,13,7,0,21,GER
0d55d942,0,0,0,0,0,0,0,0,1,0,1,0,0,6,0,21,GER
0d8a37c2,0,0,0,0,0,0,0,0,0,0,0,1,1,4,0,21,GER
0da32a38,12,9,2,5,5,2,8,6,3,1,2,5,17,6,0,21,GER
0e0102eb,0,0,0,0,0,0,0,0,0,0,0,0,0,0,0,21,GER
0e6bc38c,8,2,0,5,3,1,4,3,6,0,6,2,10,7,0,21,GER
0fbecd11,58,38,14,33,11,24,48,24,23,6,17,36,94,24,0,21,GER
1025db8e,36,20,24,11,1,16,33,17,37,18,19,69,105,149,2,21,GER
106bca06,11,9,3,7,1,1,6,5,15,1,14,6,17,6,0,21,GER
11bc43f4,0,0,0,0,0,0,1,1,0,0,0,0,0,0,0,21,GER
11d8aff0,0,0,0,0,0,0,0,0,0,0,0,0,0,0,0,21,GER
11fd2b75,41,24,15,19,7,21,54,33,40,14,26,37,78,32,1,21,GER
1238a3f9,3,2,1,1,1,0,6,6,3,2,1,1,4,7,0,21,GER
13203c45,24,12,14,8,2,11,20,9,10,1,9,19,43,28,0,21,GER
14a7af33,44,28,17,25,2,15,37,22,12,2,10,24,68,37,0,21,GER
15413fa5,21,13,11,10,0,12,33,21,11,2,9,20,41,14,1,21,GER
15b287da,48,28,21,16,11,16,49,33,18,1,17,14,62,22,0,21,GER
15f24fe7,16,12,4,5,7,2,17,15,10,1,9,9,25,21,0,21,GER
15fd5593,3,1,0,1,2,0,5,5,5,1,4,3,6,4,0,21,GER
169fd162,3,2,1,0,2,1,7,6,4,0,4,1,4,1,0,21,GER
16b4260e,0,0,0,0,0,0,0,0,1,0,1,0,0,0,0,21,GER
16daec92,18,10,6,11,1,9,24,15,13,0,13,18,36,15,0,21,GER
17376543,0,0,0,0,0,0,3,3,0,0,0,3,3,9,1,21,GER
17780d2b,21,10,12,9,0,10,30,20,21,8,13,28,49,27,0,21,GER
17f3620a,9,4,1,7,1,3,22,19,11,0,11,6,15,14,0,21,GER
18a9efe4,1,0,1,0,0,0,2,2,2,0,2,0,1,2,0,21,GER
19a967ab,0,0,0,0,0,0,1,1,3,1,2,0,0,0,0,21,GER
1a1033a1,9,6,2,6,1,6,11,5,11,0,11,8,17,2,0,21,GER
1a4b9094,9,8,4,3,2,3,6,3,7,0,7,10,19,7,1,21,GER
1a5d7cb9,19,13,14,3,2,8,27,19,17,6,11,13,32,27,0,21,GER
1a83027b,8,3,1,5,2,3,9,6,5,2,3,6,14,4,0,21,GER
1ae836b1,53,32,17,27,9,19,53,34,32,7,25,26,79,18,0,21,GER
1b6d8083,1,1,0,1,0,0,1,1,0,0,0,2,3,0,0,21,GER
1bc432b7,6,6,1,3,2,2,12,10,8,2,6,4,10,15,0,21,GER
1be390b3,0,0,0,0,0,0,0,0,1,0,1,1,1,0,0,21,GER
1c08a3c8,1,1,1,0,0,0,0,0,1,1,0,2,3,1,0,21,GER
1cbe4984,60,40,32,22,6,34,62,28,51,7,44,42,102,59,0,21,GER
1d8e9add,18,12,11,6,1,12,21,9,21,12,9,16,34,71,0,21,GER
1df0c0b9,24,15,12,9,3,15,23,8,12,2,10,18,42,31,0,21,GER
1e43fad8,2,1,2,0,0,1,2,1,0,0,0,1,3,9,3,21,GER
1f2d714c,6,5,2,3,1,3,10,7,2,0,2,4,10,3,0,21,GER
1f44ac21,7,2,1,3,3,1,4,3,19,4,15,4,11,16,0,21,GER
1fc4f3d1,0,0,0,0,0,0,0,0,0,0,0,0,0,0,0,21,GER
1fda91b3,7,3,3,3,1,5,9,4,0,0,0,5,12,1,0,21,GER
20030c06,40,26,19,15,6,23,37,14,29,20,9,40,80,74,0,21,GER
217c93a1,10,7,4,6,0,5,13,8,6,0,6,2,12,1,0,21,GER
220ace7e,22,16,8,10,4,8,35,27,21,0,21,8,30,6,0,21,GER
228f73ae,25,14,8,10,7,6,32,26,19,1,18,13,38,4,0,21,GER
22919e97,9,4,4,3,2,7,14,7,2,0,2,6,15,1,0,21,GER
229cd98a,16,8,0,10,6,2,15,13,14,3,11,9,25,9,0,21,GER
234204f4,1,1,0,0,1,0,0,0,0,0,0,0,1,0,0,21,GER
2374aaca,5,5,1,2,2,0,6,6,10,3,7,4,9,6,0,21,GER
2590ddf7,0,0,0,0,0,0,0,0,0,0,0,0,0,0,0,21,GER
25ab9c9c,27,15,12,12,3,5,21,16,25,15,10,37,64,64,0,21,GER
25f50295,8,4,3,5,0,1,3,2,12,8,4,27,35,73,0,21,GER
2696b6a9,11,6,1,9,1,4,8,4,4,0,4,5,16,1,0,21,GER
271b8617,17,11,5,6,6,8,26,18,22,0,22,18,35,10,0,21,GER
2723ce5d,2,1,0,1,1,2,2,0,0,0,0,0,2,1,0,21,GER
27270af4,1,1,0,1,0,1,2,1,3,1,2,3,4,1,0,21,GER
277c49ed,49,29,37,12,0,24,45,21,51,21,30,65,114,140,1,21,GER
27d2618c,0,0,0,0,0,0,0,0,0,0,0,0,0,7,1,21,GER
2903a856,26,20,12,12,2,10,53,43,27,2,25,27,53,9,0,21,GER
2a29eb9b,15,8,9,5,1,9,14,5,9,3,6,21,36,31,0,21,GER
2a6cd437,13,9,9,3,1,6,8,2,12,5,7,11,24,27,0,21,GER
2b09d998,35,24,12,15,8,17,31,14,22,5,17,29,64,30,0,21,GER
2b114be3,18,10,2,10,6,13,30,17,23,1,22,9,27,8,1,21,GER
2b5527c4,0,0,0,0,0,0,0,0,0,0,0,0,0,0,0,21,GER
2b7c56b4,20,15,6,10,4,5,18,13,5,1,4,2,22,2,0,21,GER
2b83fa49,35,19,23,11,1,23,31,8,19,2,17,10,45,45,0,21,GER
2c0558b8,20,12,5,7,8,7,22,15,17,2,15,14,34,3,0,21,GER
2c44a35d,13,7,6,5,2,1,6,5,6,0,6,0,13,0,1,21,GER
2d61d13a,17,9,11,5,1,6,13,7,20,11,9,13,30,57,0,21,GER
2db2fd7b,26,16,17,8,1,14,32,18,24,17,7,40,66,63,1,21,GER
2e7ff968,1,1,1,0,0,1,1,0,0,0,0,0,1,7,1,21,GER
2f3e911a,3,2,2,1,0,2,4,2,1,0,1,2,5,2,0,21,GER
2f7fec15,0,0,0,0,0,0,0,0,0,0,0,0,0,0,0,21,GER
2ff76adc,36,23,21,11,4,19,38,19,26,3,23,24,60,33,0,21,GER
302527b2,21,13,12,7,2,9,20,11,30,21,9,42,63,100,0,21,GER
30941e96,31,19,10,18,3,13,24,11,22,1,21,30,61,40,0,21,GER
30c220c3,4,1,1,2,1,2,4,2,1,0,1,3,7,4,0,21,GER
3189f61a,14,8,7,6,1,4,15,11,5,2,3,6,20,8,0,21,GER
32e7ce92,0,0,0,0,0,0,0,0,0,0,0,0,0,2,0,21,GER
33144cc5,3,2,0,3,0,2,3,1,1,0,1,1,4,1,0,21,GER
33340bd6,0,0,0,0,0,0,0,0,0,0,0,0,0,0,0,21,GER
33b554b7,43,26,12,19,12,23,70,47,39,3,36,27,70,23,0,21,GER
34a0f5ff,5,3,2,2,1,1,6,5,5,0,5,4,9,3,0,21,GER
34b54da7,2,2,1,1,0,1,3,2,6,4,2,4,6,7,0,21,GER
34e12499,34,19,14,19,1,18,28,10,13,6,7,31,65,29,1,21,GER
34e4343c,2,0,0,2,0,0,1,1,0,0,0,0,2,2,0,21,GER
35d64857,35,20,22,13,0,24,43,19,19,2,17,29,64,53,0,21,GER
36a3ff67,33,16,9,16,8,9,33,24,22,2,20,14,47,13,0,21,GER
36a59ba4,48,28,19,26,3,19,63,44,35,7,28,50,98,20,1,21,GER
378825c7,43,24,27,13,3,26,42,16,39,7,32,47,90,66,0,21,GER
37998008,0,0,0,0,0,0,0,0,0,0,0,0,0,2,0,21,GER
37f606f0,13,10,3,8,2,5,8,3,10,0,10,3,16,0,0,21,GER
384d58d9,30,15,12,15,3,11,20,9,20,7,13,23,53,29,1,21,GER
38ac43d3,11,6,3,7,1,6,12,6,4,0,4,9,20,7,0,21,GER
3935e52e,20,17,10,7,3,8,18,10,17,5,12,20,40,17,0,21,GER
3a233281,14,8,3,7,4,4,15,11,13,0,13,9,23,3,0,21,GER
3bb625ac,8,4,4,4,0,4,7,3,12,4,8,29,37,25,0,21,GER
3c4b7820,12,8,5,5,2,6,11,5,3,0,3,3,15,4,0,21,GER
3c6089ab,49,22,11,23,15,24,73,49,43,3,40,21,70,18,1,21,GER
3cd9e95a,1,0,1,0,0,1,4,3,1,0,1,0,1,11,2,21,GER
3eb0f2df,34,19,11,19,4,9,31,22,34,2,32,27,61,18,0,21,GER
3eeb80e0,3,2,1,2,0,3,6,3,4,1,3,2,5,6,0,21,GER
3effaa34,11,2,0,7,4,6,13,7,11,1,10,3,14,15,0,21,GER
3f2d59fe,16,5,15,1,0,3,12,9,20,15,5,32,48,76,1,21,GER
3f65898c,61,35,39,17,5,28,64,36,33,11,22,58,119,98,1,21,GER
3f7cd8f1,0,0,0,0,0,0,0,0,0,0,0,0,0,3,0,21,GER
4114f306,1,0,0,1,0,1,2,1,2,0,2,2,3,1,0,21,GER
41bff4fa,17,10,10,6,1,9,16,7,7,3,4,16,33,31,0,21,GER
420c18a1,1,1,1,0,0,1,1,0,0,0,0,2,3,9,2,21,GER
437f2b00,44,31,13,24,7,14,51,37,40,8,32,24,68,24,0,21,GER
441197b8,31,23,16,15,0,16,28,12,27,6,21,47,78,85,0,21,GER
442b56fa,54,33,23,21,10,24,59,35,57,5,52,43,97,39,1,21,GER
4468ec10,3,2,1,2,0,1,1,0,3,0,3,4,7,3,0,21,GER
4567a0b4,12,8,3,6,3,4,8,4,10,0,10,4,16,5,0,21,GER
45a03961,44,27,20,16,8,23,40,17,29,5,24,48,92,31,1,21,GER
463503e2,1,1,0,0,1,0,0,0,2,1,1,1,2,10,0,21,GER
47064058,0,0,0,0,0,0,1,1,0,0,0,2,2,14,0,21,GER
48035304,49,35,36,12,1,25,37,12,38,22,16,65,114,123,0,21,GER
49296448,40,28,16,19,5,10,53,43,25,5,20,36,76,19,0,21,GER
493924a7,51,33,27,17,7,24,35,11,28,7,21,22,73,59,1,21,GER
496aeede,55,37,22,28,5,28,58,30,32,11,21,34,89,39,0,21,GER
4aea5077,62,37,30,22,10,27,60,33,34,5,29,35,97,85,1,21,GER
4b6dd263,0,0,0,0,0,0,0,0,0,0,0,0,0,0,0,21,GER
4c3a6744,2,1,1,1,0,0,2,2,4,0,4,5,7,3,0,21,GER
4c6facae,58,33,19,32,7,18,41,23,31,8,23,51,109,17,0,21,GER
4ccd8957,1,1,1,0,0,0,1,1,4,0,4,2,3,1,0,21,GER
4d8cd038,2,0,0,2,0,0,4,4,3,0,3,1,3,7,0,21,GER
4e204552,0,0,0,0,0,0,0,0,0,0,0,0,0,0,0,21,GER
4e3a947f,5,3,2,2,1,0,4,4,6,1,5,2,7,6,0,21,GER
4f16405e,7,3,2,4,1,1,13,12,10,4,6,3,10,13,0,21,GER
4fa7cb9b,2,1,1,1,0,1,3,2,7,0,7,2,4,1,0,21,GER
5042e5c2,4,2,0,2,2,0,2,2,3,1,2,2,6,3,0,21,GER
50871bcc,8,2,6,1,1,3,13,10,4,0,4,10,18,1,0,21,GER
50e6dc35,6,3,1,3,2,0,3,3,3,1,2,4,10,6,0,21,GER
526ea7cc,58,32,39,17,2,20,33,13,48,35,13,66,124,160,3,21,GER
53070b63,0,0,0,0,0,0,0,0,0,0,0,0,0,0,0,21,GER
53e07d0b,7,6,3,2,2,2,8,6,4,1,3,2,9,4,0,21,GER
53eeaf6a,15,8,7,6,2,6,27,21,13,2,11,6,21,8,0,21,GER
541127d5,13,9,2,10,1,2,12,10,10,3,7,7,20,9,0,21,GER
543ddcaf,34,23,28,6,0,16,25,9,18,4,14,22,56,58,0,21,GER
54b4dc4e,46,31,15,26,5,19,38,19,21,4,17,8,54,6,1,21,GER
54e4866f,18,7,6,7,5,14,34,20,13,0,13,27,45,18,1,21,GER
555d5edd,12,7,4,8,0,7,33,26,18,3,15,12,24,7,0,21,GER
5569bf9a,40,25,23,17,0,20,40,20,30,7,23,27,67,53,0,21,GER
56413b1f,41,23,16,21,4,17,43,26,32,4,28,33,74,17,0,21,GER
565bf0da,18,12,13,3,2,11,17,6,13,4,9,17,35,34,0,21,GER
5722eced,0,0,0,0,0,0,0,0,1,0,1,0,0,0,0,21,GER
5723931e,0,0,0,0,0,0,1,1,0,0,0,0,0,0,0,21,GER
5762be5c,20,12,12,7,1,13,22,9,18,8,10,21,41,50,2,21,GER
57d88cf9,49,31,11,29,9,19,46,27,37,5,32,24,73,13,0,21,GER
582a5247,25,16,20,3,2,10,22,12,13,3,10,15,40,32,0,21,GER
58450270,8,4,1,6,1,1,1,0,6,2,4,3,11,1,0,21,GER
5853ac44,3,1,3,0,0,1,1,0,0,0,0,3,6,1,0,21,GER
58a2e9f6,13,9,8,3,2,8,19,11,15,3,12,12,25,36,0,21,GER
58ce23e5,5,4,0,5,0,1,7,6,13,1,12,5,10,1,1,21,GER
5939baa2,45,29,24,18,3,15,37,22,42,14,28,49,94,45,1,21,GER
59a48c59,0,0,0,0,0,0,1,1,0,0,0,3,3,0,0,21,GER
59e4b92e,29,10,13,15,1,10,20,10,14,5,9,31,60,47,0,21,GER
5c4bf6ba,1,1,1,0,0,1,3,2,0,0,0,3,4,9,2,21,GER
5c899683,9,6,4,2,3,4,8,4,11,1,10,3,12,2,0,21,GER
5d4f7d61,7,2,0,5,2,1,4,3,5,2,3,3,10,20,0,21,GER
5d8e331f,54,28,16,31,7,23,59,36,34,10,24,66,120,41,2,21,GER
5db45ee5,0,0,0,0,0,0,1,1,0,0,0,0,0,0,0,21,GER
5ddb8f9f,22,16,6,9,7,13,28,15,20,3,17,17,39,31,0,21,GER
5dfc6ad5,18,12,6,11,1,8,16,8,13,3,10,22,40,13,0,21,GER
5e22e2a4,51,38,19,24,8,20,54,34,36,7,29,52,103,34,1,21,GER
5e66fa06,31,20,17,14,0,12,31,19,28,18,10,47,78,114,0,21,GER
5ea8ef20,24,13,10,12,2,9,25,16,15,4,11,21,45,24,1,21,GER
5ed9b537,6,4,2,3,1,2,8,6,6,3,3,8,14,24,0,21,GER
5fd5e542,13,7,4,7,2,9,12,3,6,1,5,18,31,7,1,21,GER
603cb947,7,4,4,0,3,3,8,5,8,1,7,7,14,5,1,21,GER
610aa1e9,14,7,10,4,0,9,17,8,3,1,2,13,27,12,0,21,GER
614eca9b,35,19,15,18,2,20,40,20,17,4,13,26,61,16,1,21,GER
6190474d,9,5,1,6,2,2,11,9,8,1,7,11,20,11,0,21,GER
626fab5f,42,23,26,11,5,19,25,6,24,2,22,36,78,62,1,21,GER
62ab9184,52,32,14,32,6,21,52,31,34,4,30,21,73,30,0,21,GER
62c7067a,9,6,3,5,1,5,6,1,5,0,5,2,11,1,0,21,GER
62f94e47,0,0,0,0,0,0,0,0,0,0,0,0,0,0,0,21,GER
635f2732,42,28,13,15,14,17,47,30,37,3,34,33,75,14,0,21,GER
63b9cc6d,17,8,5,11,1,6,14,8,17,2,15,8,25,5,0,21,GER
652d4c37,19,19,4,11,4,9,29,20,15,2,13,6,25,8,0,21,GER
66385c46,24,18,14,8,2,8,17,9,15,0,15,15,39,16,0,21,GER
677da306,33,24,19,10,4,18,27,9,48,25,23,54,87,164,2,21,GER
68635c10,2,1,0,2,0,1,1,0,2,0,2,0,2,0,0,21,GER
68829001,21,7,6,9,6,8,23,15,16,3,13,8,29,12,0,21,GER
69374ff5,43,20,14,26,3,16,31,15,12,0,12,12,55,10,1,21,GER
699fb8db,22,11,19,3,0,10,19,9,10,8,2,35,57,49,0,21,GER
6aa3e78b,47,25,26,13,8,15,34,19,26,3,23,30,77,46,0,21,GER
6b21b7b5,9,4,6,1,2,2,4,2,4,1,3,2,11,0,0,21,GER
6b8887c2,4,4,0,1,3,2,3,1,1,0,1,0,4,1,0,21,GER
6bd5cd5d,44,29,30,12,2,23,39,16,43,27,16,49,93,118,2,21,GER
6c6a3300,24,12,11,11,2,12,23,11,7,0,7,4,28,6,0,21,GER
6ca598d5,2,2,1,1,0,0,1,1,1,0,1,0,2,0,0,21,GER
6cafd68d,6,2,5,1,0,6,8,2,4,2,2,13,19,42,0,21,GER
6ce43701,3,2,1,1,1,0,0,0,3,0,3,0,3,2,0,21,GER
6e44569a,4,3,2,1,1,2,3,1,2,0,2,2,6,2,0,21,GER
6ec6fde0,18,12,11,6,1,8,14,6,28,15,13,13,31,32,2,21,GER
6ecbddf6,18,12,6,9,3,1,16,15,26,2,24,18,36,27,0,21,GER
6f8cd6d0,24,14,9,10,5,10,23,13,27,4,23,15,39,13,1,21,GER
6fd8a334,11,7,5,5,1,9,13,4,17,5,12,13,24,33,0,21,GER
70678132,5,1,3,1,1,2,5,3,1,0,1,1,6,1,0,21,GER
70dcf94d,7,4,4,3,0,3,15,12,4,1,3,7,14,9,0,21,GER
71ec39ef,33,18,16,15,2,13,27,14,33,6,27,40,73,52,0,21,GER
7242b495,12,9,7,4,1,5,8,3,9,3,6,8,20,13,1,21,GER
73000a79,32,17,13,16,3,18,35,17,22,5,17,23,55,23,0,21,GER
74c7c2db,14,6,3,6,5,7,14,7,10,0,10,13,27,10,0,21,GER
74f2e748,7,4,4,3,0,4,8,4,4,0,4,1,8,7,0,21,GER
75422cbf,0,0,0,0,0,0,0,0,0,0,0,0,0,0,0,21,GER
763b8b37,6,5,1,4,1,4,4,0,5,1,4,3,9,4,0,21,GER
76b2817e,32,19,22,9,1,10,17,7,19,5,14,18,50,42,0,21,GER
76fa965f,22,13,7,12,3,6,25,19,18,1,17,15,37,2,0,21,GER
78b9e99c,0,0,0,0,0,0,0,0,1,0,1,0,0,0,0,21,GER
791abba1,17,9,9,7,1,13,23,10,25,13,12,25,42,66,0,21,GER
7961f7aa,3,1,1,0,2,1,3,2,3,1,2,7,10,2,1,21,GER
79c90e45,15,12,7,6,2,6,15,9,12,3,9,18,33,31,0,21,GER
79ca3e23,36,14,13,18,5,8,39,31,28,2,26,19,55,20,0,21,GER
7aac47fe,1,1,0,1,0,1,1,0,1,1,0,3,4,9,0,21,GER
7c473e12,14,7,10,3,1,7,15,8,23,20,3,26,40,68,1,21,GER
7c56da38,16,11,3,7,6,8,18,10,27,1,26,9,25,14,0,21,GER
7ca196eb,3,2,1,1,1,2,4,2,1,0,1,0,3,0,0,21,GER
7cd6badb,24,17,3,16,5,7,32,25,26,3,23,13,37,14,0,21,GER
7d841904,1,1,1,0,0,0,0,0,1,0,1,2,3,0,0,21,GER
7dca49f6,5,2,2,2,1,2,9,7,6,1,5,4,9,1,0,21,GER
7ed08d5c,2,2,1,1,0,1,1,0,3,0,3,2,4,2,0,21,GER
7f609bfc,52,24,29,17,6,27,47,20,27,8,19,37,89,73,1,21,GER
7f97771d,10,5,4,4,2,7,9,2,8,4,4,13,23,19,0,21,GER
7fa4e703,24,13,9,8,7,9,25,16,14,1,13,10,34,11,0,21,GER
7fe12375,1,1,1,0,0,1,3,2,1,0,1,0,1,8,3,21,GER
809940aa,36,26,15,18,3,12,30,18,5,1,4,14,50,15,0,21,GER
80c9e555,1,1,1,0,0,0,0,0,1,0,1,1,2,0,0,21,GER
80f36c88,39,28,17,15,7,20,52,32,30,8,22,14,53,25,1,21,GER
815c314f,49,26,28,18,3,29,49,20,40,25,15,68,117,103,1,21,GER
81868f73,0,0,0,0,0,0,0,0,0,0,0,0,0,1,0,21,GER
834d0be5,8,2,2,5,1,2,4,2,9,1,8,2,10,10,0,21,GER
8494acc4,33,20,17,15,1,21,42,21,30,8,22,30,63,51,2,21,GER
857a5abe,24,18,15,9,0,14,23,9,19,11,8,27,51,76,1,21,GER
8593f88c,34,19,18,13,3,15,43,28,38,9,29,29,63,40,0,21,GER
867501bf,19,13,11,6,2,6,29,23,11,0,11,5,24,5,0,21,GER
86e119e0,47,32,20,26,1,18,49,31,24,3,21,49,96,57,0,21,GER
8758ddf4,1,0,1,0,0,1,1,0,0,0,0,2,3,1,0,21,GER
8778c910,0,0,0,0,0,0,1,1,0,0,0,2,2,12,3,21,GER
88d4144a,66,39,42,21,3,35,72,37,34,5,29,55,121,61,1,21,GER
88e357ef,39,19,7,19,13,12,32,20,17,0,17,26,65,3,0,21,GER
89ac64a6,41,22,23,12,6,19,31,12,23,10,13,49,90,70,1,21,GER
8b6e0db2,26,18,15,11,0,10,17,7,28,22,6,29,55,89,0,21,GER
8d78e732,15,9,0,7,8,2,13,11,9,1,8,3,18,11,0,21,GER
8e235926,13,10,6,7,0,3,10,7,2,0,2,3,16,17,0,21,GER
8eb55dbb,5,4,2,2,1,3,5,2,4,0,4,6,11,7,0,21,GER
8f056768,66,40,20,38,8,22,68,46,50,6,44,54,120,38,0,21,GER
8ff2354e,29,18,20,8,1,19,41,22,15,3,12,16,45,35,0,21,GER
901c0f97,65,44,33,28,4,12,73,61,34,7,27,45,110,24,0,21,GER
90339309,65,38,37,26,2,20,36,16,46,27,19,64,129,82,1,21,GER
92432bc6,50,28,20,21,9,11,36,25,33,1,32,30,80,24,0,21,GER
924f9191,39,23,14,23,2,18,34,16,20,2,18,24,63,22,0,21,GER
92948149,10,5,6,4,0,5,10,5,3,1,2,11,21,29,1,21,GER
9321b8ed,0,0,0,0,0,0,0,0,0,0,0,0,0,0,2,21,GER
93a50d2c,13,7,9,4,0,6,10,4,8,3,5,15,28,38,0,21,GER
94c18565,4,2,0,4,0,2,8,6,7,0,7,3,7,3,0,21,GER
962e54cb,8,3,4,1,3,4,16,12,4,1,3,1,9,3,0,21,GER
9642c929,10,7,4,6,0,7,16,9,4,3,1,7,17,5,1,21,GER
99f7e9aa,33,14,15,17,1,22,50,28,19,4,15,26,59,39,1,21,GER
9a2e0ccc,11,6,1,6,4,5,27,22,10,1,9,11,22,4,0,21,GER
9ab16552,43,29,21,20,2,25,51,26,31,12,19,31,74,68,2,21,GER
9af1f9ff,2,1,2,0,0,1,2,1,5,4,1,5,7,5,0,21,GER
9b1b7d78,16,6,10,5,1,8,25,17,7,0,7,3,19,14,0,21,GER
9ceb7642,8,4,1,5,2,2,9,7,6,0,6,10,18,9,0,21,GER
9d12e142,0,0,0,0,0,0,0,0,0,0,0,0,0,5,1,21,GER
9f381d8b,9,4,1,5,3,2,4,2,13,2,11,6,15,4,0,21,GER
9f979eb2,13,6,9,3,1,6,13,7,14,11,3,15,28,63,0,21,GER
9fec8860,37,20,19,14,4,17,29,12,21,7,14,20,57,62,0,21,GER
a0415710,25,10,17,4,4,11,21,10,18,1,17,16,41,36,0,21,GER
a0606ae8,0,0,0,0,0,0,0,0,0,0,0,0,0,0,0,21,GER
a167537f,27,14,13,9,5,12,43,31,25,1,24,17,44,7,1,21,GER
a2a85828,29,15,11,9,9,10,31,21,15,1,14,10,39,9,1,21,GER
a3ddb1b9,25,13,13,10,2,5,23,18,21,0,21,5,30,10,0,21,GER
a42760bc,1,1,0,0,1,0,0,0,1,0,1,1,2,0,0,21,GER
a4effc55,2,2,2,0,0,0,0,0,3,2,1,6,8,13,0,21,GER
a4f94a0d,17,8,9,5,3,5,18,13,13,1,12,17,34,16,0,21,GER
a53b661f,24,9,5,10,9,8,14,6,18,4,14,17,41,16,0,21,GER
a572e291,27,15,13,11,3,17,28,11,27,10,17,26,53,30,0,21,GER
a5ae8f8e,24,14,17,6,1,15,31,16,22,9,13,29,53,94,1,21,GER
a5ce09f2,15,9,9,5,1,4,18,14,10,3,7,32,47,19,2,21,GER
a5ec3ede,32,21,23,8,1,18,31,13,26,17,9,41,73,91,2,21,GER
a65ce836,43,34,20,20,3,20,37,17,35,10,25,48,91,52,0,21,GER
a6c58494,4,1,3,1,0,1,1,0,2,0,2,1,5,1,0,21,GER
a70b8345,0,0,0,0,0,0,0,0,0,0,0,1,1,9,1,21,GER
a73c8f95,54,28,35,18,1,21,45,24,55,29,26,48,102,96,0,21,GER
a7813ac4,19,14,10,7,2,12,31,19,18,1,17,14,33,33,0,21,GER
a8d4428b,32,19,13,13,6,13,27,14,39,4,35,17,49,36,0,21,GER
a8db7ebb,20,9,8,11,1,8,19,11,13,3,10,5,25,8,0,21,GER
a9142dc3,4,2,1,2,1,2,4,2,7,3,4,7,11,4,0,21,GER
a92ab7be,0,0,0,0,0,0,0,0,0,0,0,0,0,1,0,21,GER
aad48be9,49,28,20,27,2,13,31,18,43,16,27,42,91,101,0,21,GER
ab3f1bdf,1,1,1,0,0,1,1,0,1,0,1,0,1,1,0,21,GER
ab5b7dc1,15,8,6,6,3,5,17,12,17,2,15,12,27,11,0,21,GER
ab700320,14,10,5,8,1,4,12,8,10,3,7,8,22,11,1,21,GER
ac73ec79,44,30,14,28,2,21,37,16,33,1,32,23,67,33,2,21,GER
ad00b1a8,14,7,6,7,1,7,13,6,8,2,6,6,20,7,0,21,GER
ad3389d5,0,0,0,0,0,0,1,1,0,0,0,1,1,11,3,21,GER
ae44e8e2,23,14,6,13,4,4,23,19,15,0,15,13,36,21,0,21,GER
aeaf1bc1,0,0,0,0,0,0,0,0,0,0,0,0,0,0,0,21,GER
aeda1f69,7,4,3,4,0,4,5,1,4,0,4,2,9,4,0,21,GER
aeed5c06,10,6,4,5,1,6,20,14,11,0,11,12,22,5,0,21,GER
af0d79a9,14,10,6,6,2,8,25,17,23,4,19,31,45,74,0,21,GER
afb0c500,0,0,0,0,0,0,0,0,0,0,0,0,0,1,0,21,GER
b0a0698b,48,24,33,13,2,23,42,19,25,9,16,53,101,109,0,21,GER
b1a21aca,0,0,0,0,0,0,1,1,0,0,0,0,0,1,0,21,GER
b1cd37e6,54,31,22,23,9,22,54,32,43,6,37,26,80,28,2,21,GER
b3325a30,55,35,18,33,4,17,52,35,29,4,25,23,78,21,0,21,GER
b3b7f5a6,4,0,2,1,1,1,4,3,5,2,3,3,7,5,0,21,GER
b4b08774,0,0,0,0,0,0,1,1,0,0,0,0,0,0,0,21,GER
b4cf5806,3,2,0,3,0,1,8,7,10,3,7,2,5,9,0,21,GER
b500b384,17,9,6,7,4,6,16,10,7,0,7,5,22,1,0,21,GER
b69261a0,12,6,2,9,1,4,12,8,18,4,14,14,26,23,0,21,GER
b6a6e0a7,24,12,8,13,3,8,16,8,4,1,3,4,28,1,0,21,GER
b77f44a4,47,29,35,11,1,18,32,14,38,18,20,52,99,109,0,21,GER
b797f558,13,5,6,6,1,4,15,11,10,2,8,7,20,5,0,21,GER
b825a650,38,26,9,24,5,18,35,17,20,2,18,29,67,14,0,21,GER
b93b7882,12,3,5,5,2,4,11,7,8,0,8,13,25,9,0,21,GER
bb08bce9,16,10,11,5,0,7,16,9,14,10,4,21,37,61,1,21,GER
bbd86530,74,41,39,30,5,35,71,36,34,5,29,35,109,50,0,21,GER
bc249af8,5,2,1,2,2,1,3,2,6,1,5,0,5,1,0,21,GER
bc6bd723,19,9,4,10,5,5,20,15,1,0,1,5,24,7,0,21,GER
bcb2ccd8,1,0,1,0,0,1,2,1,0,0,0,2,3,7,0,21,GER
bd142efb,30,17,19,9,2,11,21,10,19,12,7,33,63,89,1,21,GER
be42a291,26,13,8,10,8,8,36,28,18,1,17,9,35,4,0,21,GER
be625686,0,0,0,0,0,0,0,0,1,0,1,0,0,0,0,21,GER
beb882a8,57,42,22,29,6,21,46,25,30,5,25,43,100,36,0,21,GER
beda9675,1,0,0,0,1,1,2,1,1,0,1,0,1,0,0,21,GER
bee0bab1,12,10,3,4,5,4,17,13,12,0,12,12,24,4,0,21,GER
bf075f6b,18,14,7,9,2,5,13,8,11,1,10,11,29,8,0,21,GER
bfd522a6,0,0,0,0,0,0,0,0,0,0,0,0,0,0,0,21,GER
c0d3bd23,23,12,13,8,2,10,16,6,14,4,10,24,47,37,0,21,GER
c1242d4e,2,1,2,0,0,2,6,4,0,0,0,0,2,12,3,21,GER
c149016b,65,44,25,34,6,29,71,42,53,14,39,51,116,59,0,21,GER
c18d22f5,24,18,17,7,0,17,31,14,19,8,11,27,51,41,0,21,GER
c1b7847c,2,0,0,1,1,0,4,4,2,0,2,1,3,0,0,21,GER
c2009df3,34,22,8,21,5,15,35,20,24,5,19,19,53,20,1,21,GER
c2211709,83,48,44,31,8,33,65,32,49,13,36,82,165,38,2,21,GER
c3ee18ef,41,31,16,17,8,17,31,14,24,6,18,19,60,38,0,21,GER
c3fd9887,0,0,0,0,0,0,0,0,1,0,1,1,1,1,0,21,GER
c41f7379,0,0,0,0,0,0,0,0,0,0,0,0,0,0,0,21,GER
c4e87b8b,13,8,2,8,3,4,20,16,17,3,14,4,17,26,0,21,GER
c50281a0,19,13,12,6,1,9,21,12,19,5,14,16,35,19,0,21,GER
c51e68be,1,1,1,0,0,0,0,0,1,0,1,0,1,0,0,21,GER
c5224618,4,2,1,3,0,1,2,1,3,3,0,4,8,9,0,21,GER
c562c5b4,36,24,23,12,1,14,23,9,29,22,7,39,75,111,0,21,GER
c59b67ed,0,0,0,0,0,0,1,1,0,0,0,0,0,0,0,21,GER
c5fd13e9,23,16,15,6,2,12,24,12,27,16,11,36,59,115,1,21,GER
c64c01fc,4,4,2,2,0,1,2,1,2,0,2,0,4,2,0,21,GER
c6608135,2,2,2,0,0,1,3,2,5,1,4,0,2,2,0,21,GER
c89e8aae,0,0,0,0,0,0,0,0,0,0,0,0,0,1,0,21,GER
c8c60119,18,12,8,7,3,10,14,4,5,1,4,8,26,22,0,21,GER
ca618d23,36,24,13,19,4,12,32,20,19,2,17,16,52,14,0,21,GER
ca8033cb,23,19,8,12,3,11,18,7,16,6,10,18,41,44,1,21,GER
cb6d81b3,20,9,10,9,1,10,18,8,14,3,11,12,32,18,0,21,GER
cbac6ec9,0,0,0,0,0,0,3,3,1,0,1,2,2,10,1,21,GER
cc86b9a3,37,23,12,21,4,16,39,23,30,2,28,44,81,11,0,21,GER
cc971106,3,2,0,3,0,2,2,0,3,1,2,1,4,1,0,21,GER
cd59b9df,2,2,2,0,0,2,2,0,0,0,0,2,4,8,1,21,GER
cd82452e,31,17,14,13,4,9,44,35,35,3,32,14,45,24,0,21,GER
ce17b5eb,0,0,0,0,0,0,1,1,1,0,1,3,3,11,3,21,GER
cf623c78,17,13,7,9,1,8,21,13,19,5,14,29,46,26,0,21,GER
d01bbb6f,53,31,22,19,12,19,52,33,42,1,41,31,84,11,0,21,GER
d1273f09,71,46,29,31,11,29,92,63,45,6,39,38,109,41,0,21,GER
d1661819,33,20,22,10,1,7,21,14,22,4,18,24,57,41,0,21,GER
d1db4b83,3,3,1,1,1,0,3,3,4,0,4,7,10,6,0,21,GER
d20f088b,0,0,0,0,0,0,0,0,0,0,0,0,0,3,0,21,GER
d2416c2e,10,6,1,6,3,1,17,16,16,0,16,6,16,13,0,21,GER
d248cd8f,37,30,18,19,0,14,20,6,25,14,11,33,70,74,2,21,GER
d25fee56,38,26,19,15,4,19,42,23,19,3,16,18,56,22,1,21,GER
d28339cb,0,0,0,0,0,0,0,0,0,0,0,0,0,0,0,21,GER
d2c580ce,12,8,7,4,1,7,9,2,9,3,6,10,22,8,0,21,GER
d3096421,16,6,2,9,5,7,12,5,10,0,10,3,19,8,0,21,GER
d3585b17,0,0,0,0,0,0,0,0,0,0,0,0,0,0,0,21,GER
d4a2533d,22,10,10,7,5,8,29,21,18,0,18,17,39,3,1,21,GER
d4d0a9ad,14,10,10,4,0,5,15,10,16,5,11,11,25,15,1,21,GER
d571df78,0,0,0,0,0,0,1,1,0,0,0,1,1,2,0,21,GER
d6862409,7,5,1,4,2,0,10,10,8,3,5,10,17,18,0,21,GER
d686dbc0,16,10,9,6,1,3,10,7,12,2,10,11,27,22,0,21,GER
d699d8ef,0,0,0,0,0,0,0,0,0,0,0,0,0,0,0,21,GER
d781d855,39,27,16,17,6,28,40,12,21,1,20,28,67,33,1,21,GER
d847944b,9,4,2,5,2,4,11,7,4,1,3,6,15,14,0,21,GER
d9e196bf,21,15,9,5,7,10,22,12,18,1,17,16,37,21,0,21,GER
da27e268,2,2,0,0,2,0,4,4,4,1,3,2,4,1,0,21,GER
daa78200,12,8,6,6,0,8,17,9,11,0,11,3,15,11,0,21,GER
db401046,0,0,0,0,0,0,1,1,1,0,1,2,2,9,2,21,GER
db4ed67b,30,18,9,20,1,14,38,24,23,5,18,18,48,11,1,21,GER
dbf053da,18,11,4,10,4,7,16,9,20,1,19,16,34,9,0,21,GER
dc38e3bc,2,0,0,1,1,0,0,0,1,0,1,1,3,1,0,21,GER
dc62b55d,36,16,10,19,7,13,49,36,29,2,27,31,67,9,0,21,GER
dc62fbee,58,32,24,28,6,16,51,35,29,2,27,13,71,10,0,21,GER
dc90cfbe,3,2,1,1,1,2,5,3,5,1,4,2,5,8,0,21,GER
dd669209,24,15,6,12,6,13,24,11,21,2,19,22,46,15,0,21,GER
de4cac2d,48,29,19,19,10,21,44,23,29,1,28,22,70,11,2,21,GER
dee3013b,0,0,0,0,0,0,1,1,0,0,0,0,0,1,0,21,GER
deee6467,1,0,0,1,0,0,2,2,0,0,0,1,2,0,0,21,GER
df8e7b62,3,1,0,3,0,0,3,3,3,0,3,3,6,4,0,21,GER
dfb6490a,9,6,4,3,2,2,14,12,16,0,16,10,19,8,0,21,GER
e0b113a7,51,24,22,27,2,24,53,29,40,6,34,51,102,31,2,21,GER
e0d515ef,0,0,0,0,0,0,0,0,0,0,0,0,0,0,0,21,GER
e12b0b5b,44,25,21,16,7,14,46,32,30,3,27,47,91,18,0,21,GER
e162b013,30,21,19,6,5,20,29,9,16,6,10,18,48,29,2,21,GER
e21042ae,24,13,9,11,4,7,26,19,20,6,14,4,28,29,0,21,GER
e26fcca3,30,15,15,14,1,15,28,13,23,2,21,13,43,14,0,21,GER
e27da244,47,29,33,14,0,30,54,24,35,10,25,55,102,134,0,21,GER
e27de4fa,18,11,11,6,1,13,21,8,7,3,4,23,41,22,0,21,GER
e280527c,29,21,12,16,1,12,37,25,7,2,5,35,64,27,0,21,GER
e33c06cf,32,21,15,14,3,13,21,8,24,12,12,21,53,36,1,21,GER
e3f6253d,0,0,0,0,0,0,1,1,0,0,0,0,0,0,0,21,GER
e5478b87,5,3,2,3,0,1,14,13,9,0,9,3,8,4,0,21,GER
e5649a78,12,6,2,9,1,5,16,11,5,0,5,6,18,4,0,21,GER
e5f63987,2,2,1,1,0,2,8,6,2,0,2,1,3,2,0,21,GER
e6c43eec,17,9,9,8,0,5,12,7,12,5,7,29,46,25,0,21,GER
e79269bd,14,8,12,2,0,6,17,11,3,0,3,6,20,8,0,21,GER
e7d22eae,5,3,4,1,0,1,8,7,3,0,3,7,12,2,0,21,GER
e7d59f4f,22,13,8,11,3,10,23,13,9,1,8,17,39,7,1,21,GER
e7fcf289,35,18,8,22,5,11,37,26,27,1,26,9,44,8,0,21,GER
e82adcab,31,17,12,16,3,17,30,13,13,0,13,12,43,7,0,21,GER
e87ad81a,10,5,7,3,0,7,15,8,7,3,4,13,23,21,0,21,GER
e92cd3f7,7,5,0,5,2,2,14,12,13,2,11,3,10,13,0,21,GER
ea003d07,5,1,0,3,2,1,6,5,1,0,1,1,6,12,0,21,GER
eac044ad,6,3,3,1,2,1,13,12,6,0,6,9,15,7,0,21,GER
eba42d2b,7,4,3,3,1,4,8,4,4,1,3,3,10,1,0,21,GER
ed79b7d3,15,9,4,6,5,2,16,14,29,5,24,0,15,27,0,21,GER
f0a37d36,42,22,24,15,3,27,40,13,30,10,20,42,84,96,0,21,GER
f26834c7,31,20,7,15,9,14,23,9,20,1,19,5,36,12,0,21,GER
f2dd9a21,57,32,20,32,5,20,52,32,32,5,27,35,92,29,1,21,GER
f35430a4,11,7,9,2,0,9,16,7,22,18,4,26,37,51,1,21,GER
f3722c97,1,0,0,1,0,1,1,0,0,0,0,0,1,0,0,21,GER
f503ef6e,0,0,0,0,0,0,0,0,0,0,0,0,0,0,0,21,GER
f521b80a,26,16,15,10,1,14,24,10,43,32,11,51,77,121,0,21,GER
f5ae006d,1,0,0,0,1,0,1,1,0,0,0,0,1,0,0,21,GER
f69fba57,12,8,2,5,5,2,9,7,6,1,5,5,17,7,0,21,GER
f6bdc830,31,10,16,15,0,10,23,13,26,18,8,36,67,89,2,21,GER
f761c901,2,2,2,0,0,1,1,0,1,0,1,0,2,0,0,21,GER
f7aa75bd,15,10,6,7,2,5,9,4,9,1,8,1,16,19,1,21,GER
f820504e,5,2,2,3,0,1,3,2,2,1,1,2,7,9,0,21,GER
f86ad3f5,50,34,31,17,2,30,62,32,38,17,21,55,105,118,1,21,GER
f86cabbd,7,4,7,0,0,5,8,3,8,2,6,15,22,54,1,21,GER
f93e6e94,11,7,2,6,3,3,21,18,25,1,24,9,20,28,0,21,GER
f9446dcd,7,3,1,5,1,2,9,7,11,0,11,3,10,3,0,21,GER
f956479d,7,5,2,4,1,3,16,13,12,0,12,5,12,6,0,21,GER
f95d2f9d,0,0,0,0,0,0,0,0,0,0,0,0,0,0,0,21,GER
f972644c,17,9,3,12,2,7,23,16,10,0,10,6,23,9,0,21,GER
f99fe221,2,2,2,0,0,0,2,2,2,0,2,0,2,2,0,21,GER
f9acca3a,53,35,27,18,8,23,49,26,26,3,23,25,78,39,1,21,GER
f9e7c4ac,2,1,0,1,1,0,1,1,7,1,6,1,3,4,0,21,GER
fa274d97,9,6,4,3,2,2,11,9,12,4,8,6,15,10,0,21,GER
fa661778,35,19,19,13,3,13,38,25,29,3,26,28,63,47,1,21,GER
fbbc8e15,0,0,0,0,0,0,1,1,0,0,0,1,1,0,0,21,GER
fc0f3ef3,0,0,0,0,0,0,0,0,0,0,0,0,0,0,0,21,GER
fc62fdf4,21,11,13,5,3,11,24,13,5,1,4,11,32,13,0,21,GER
fd53759d,11,6,1,8,2,5,9,4,10,1,9,9,20,2,0,21,GER
fdd60087,2,1,0,1,1,1,1,0,0,0,0,1,3,4,0,21,GER
fe2db476,10,7,6,4,0,5,12,7,5,1,4,5,15,12,0,21,GER
fe46e261,15,7,9,6,0,4,10,6,6,1,5,6,21,16,0,21,GER
fe641c1a,40,30,15,20,5,11,31,20,28,10,18,22,62,15,1,21,GER
fe888e39,14,8,9,5,0,4,12,8,6,2,4,9,23,2,1,21,GER
ff182fdc,3,2,0,0,3,0,2,2,1,0,1,1,4,3,0,21,GER
ff5ea0bf,42,27,24,17,1,15,26,11,17,12,5,33,75,70,0,21,GER
ff98492b,19,10,9,7,3,7,16,9,9,2,7,15,34,10,1,21,GER
ffbbc83b,37,21,21,13,3,19,52,33,38,7,31,51,88,47,1,21,GER
00f0482f,0,0,0,0,0,0,0,0,0,0,0,0,0,0,0,21,ENG
01226327,60,32,26,27,7,30,48,18,19,1,18,30,90,41,1,21,ENG
012c975a,6,4,3,3,0,3,3,0,4,3,1,6,12,27,1,21,ENG
02b29014,52,32,25,19,8,14,43,29,24,7,17,39,91,31,1,21,ENG
0313a347,25,13,18,6,1,9,13,4,53,47,6,29,54,162,1,21,ENG
03622183,0,0,0,0,0,0,1,1,0,0,0,0,0,0,0,21,ENG
03edb878,6,2,1,3,2,3,7,4,6,1,5,1,7,0,0,21,ENG
0420d84f,39,26,21,14,4,21,30,9,22,6,16,13,52,37,2,21,ENG
0442183b,17,10,8,8,1,9,16,7,7,2,5,18,35,25,1,21,ENG
07802f7f,22,13,3,16,3,12,28,16,39,2,37,3,25,27,1,21,ENG
08452314,9,7,3,5,1,2,12,10,8,0,8,8,17,1,0,21,ENG
099e666f,2,1,1,0,1,2,2,0,0,0,0,1,3,3,0,21,ENG
0b33f6ad,38,21,20,16,2,25,34,9,22,5,17,17,55,30,0,21,ENG
0d4ceb32,9,5,2,4,3,1,8,7,8,1,7,6,15,5,0,21,ENG
0df2b165,25,16,12,11,2,13,47,34,26,8,18,14,39,29,1,21,ENG
0f7533cd,31,15,17,10,4,18,39,21,19,5,14,21,52,39,0,21,ENG
101da2b5,31,17,8,14,9,20,43,23,11,2,9,23,54,17,0,21,ENG
10b9fa99,57,36,31,24,2,20,46,26,40,19,21,49,106,87,3,21,ENG
111c3236,5,2,3,2,0,1,3,2,2,0,2,4,9,8,1,21,ENG
119b9a8e,13,6,10,3,0,7,11,4,12,7,5,11,24,28,0,21,ENG
11ff3d56,29,16,11,17,1,9,16,7,10,1,9,10,39,12,2,21,ENG
1265a93a,55,35,24,22,9,21,44,23,36,7,29,17,72,52,0,21,ENG
132a82f1,51,37,27,22,2,31,46,15,28,16,12,61,112,94,0,21,ENG
1544f145,10,5,3,4,3,2,12,10,13,6,7,4,14,5,0,21,ENG
1566e437,3,2,1,1,1,0,0,0,2,0,2,1,4,0,0,21,ENG
1598599e,26,17,18,6,2,7,20,13,12,1,11,14,40,8,0,21,ENG
15ea812b,66,39,52,11,3,25,49,24,54,42,12,44,110,163,1,21,ENG
15f3ec41,23,15,11,7,5,8,21,13,15,1,14,6,29,6,0,21,ENG
16ceb862,4,2,0,1,3,1,7,6,4,1,3,5,9,10,0,21,ENG
17370b95,10,8,8,1,1,4,6,2,2,0,2,1,11,1,0,21,ENG
17695062,14,7,5,5,4,6,17,11,15,1,14,10,24,12,0,21,ENG
178ae8f8,12,6,4,7,1,2,29,27,9,0,9,5,17,3,0,21,ENG
17acc2ed,0,0,0,0,0,0,0,0,0,0,0,0,0,0,0,21,ENG
17d4507a,59,26,32,19,8,33,58,25,41,12,29,22,81,81,1,21,ENG
1880614f,4,1,0,3,1,3,5,2,3,0,3,2,6,0,0,21,ENG
18b896d6,31,23,16,14,1,12,15,3,17,10,7,18,49,51,0,21,ENG
18b999f4,0,0,0,0,0,0,1,1,3,0,3,0,0,0,0,21,ENG
18e96f64,27,16,14,10,3,11,23,12,50,35,15,38,65,159,1,21,ENG
1900032e,50,31,31,15,4,35,52,17,29,16,13,42,92,122,0,21,ENG
1961b2aa,35,23,16,16,3,17,58,41,19,1,18,10,45,12,1,21,ENG
197640fd,52,32,29,18,5,24,44,20,29,5,24,29,81,62,1,21,ENG
19f4d211,0,0,0,0,0,0,0,0,0,0,0,0,0,0,0,21,ENG
1a4ef233,11,7,6,4,1,8,12,4,8,4,4,12,23,26,0,21,ENG
1a7fcf39,74,31,38,28,8,32,74,42,17,2,15,23,97,50,2,21,ENG
1aa84968,69,42,41,23,5,41,67,26,36,15,21,49,118,105,1,21,ENG
1ae30132,6,5,4,2,0,3,6,3,3,1,2,6,12,12,0,21,ENG
1b84dbe1,63,38,40,16,7,29,54,25,42,4,38,31,94,87,0,21,ENG
1bf33a9a,19,11,8,10,1,8,21,13,25,2,23,12,31,9,0,21,ENG
1c7012b8,59,35,33,25,1,21,51,30,39,11,28,59,118,41,0,21,ENG
1cb49278,11,6,8,3,0,0,8,8,19,14,5,20,31,51,1,21,ENG
1d042188,45,25,30,13,2,21,45,24,32,17,15,45,90,108,0,21,ENG
1ecb65be,23,11,8,9,6,11,32,21,16,0,16,14,37,5,0,21,ENG
1ef37668,30,21,18,9,3,19,39,20,30,9,21,12,42,34,0,21,ENG
1f9a3a04,3,2,1,2,0,1,1,0,0,0,0,2,5,3,0,21,ENG
1fb1c435,14,7,8,3,3,4,22,18,7,0,7,5,19,16,0,21,ENG
1fdfd6da,3,3,2,1,0,1,2,1,3,2,1,6,9,16,1,21,ENG
21166ff4,27,17,13,14,0,17,30,13,12,9,3,28,55,80,1,21,ENG
21945a9e,0,0,0,0,0,0,0,0,0,0,0,0,0,0,0,21,ENG
21a66f6a,22,12,1,17,4,8,26,18,28,11,17,11,33,40,0,21,ENG
2389cdc2,71,40,43,22,6,41,74,33,50,11,39,60,131,95,0,21,ENG
246d153b,37,20,22,7,8,21,43,22,22,6,16,45,82,94,2,21,ENG
254147d4,52,27,27,17,8,28,63,35,24,2,22,10,62,14,0,21,ENG
25b82f9a,2,1,0,2,0,1,1,0,0,0,0,1,3,0,0,21,ENG
2628fd2b,1,0,1,0,0,1,1,0,1,0,1,0,1,11,2,21,ENG
2691c772,12,6,2,6,4,3,13,10,14,2,12,5,17,11,0,21,ENG
26f6dca8,9,2,3,4,2,3,10,7,9,0,9,7,16,5,0,21,ENG
27c01749,6,3,1,3,2,0,2,2,4,0,4,0,6,2,0,21,ENG
282679b4,38,20,14,20,4,14,61,47,13,4,9,11,49,16,0,21,ENG
282f75f3,30,15,20,8,2,16,23,7,29,20,9,32,62,106,0,21,ENG
289601e6,45,28,24,16,5,27,44,17,21,4,17,37,82,68,0,21,ENG
28b40c9c,12,5,9,3,0,8,11,3,8,5,3,6,18,26,1,21,ENG
28d596a0,0,0,0,0,0,0,1,1,0,0,0,0,0,0,3,21,ENG
2928dca2,35,23,25,10,0,19,35,16,40,32,8,27,62,134,2,21,ENG
29733c72,1,0,1,0,0,0,7,7,3,0,3,3,4,3,0,21,ENG
2973d8ff,5,3,1,2,2,1,9,8,5,1,4,4,9,5,0,21,ENG
2acd49b9,22,16,19,3,0,8,20,12,11,4,7,23,45,25,0,21,ENG
2b16cb1a,16,9,6,9,1,4,9,5,10,0,10,4,20,2,0,21,ENG
2b471f99,62,35,25,30,7,23,44,21,26,5,21,30,92,21,0,21,ENG
2b622f01,32,16,12,16,4,8,29,21,12,0,12,18,50,10,0,21,ENG
2b91cf8e,24,14,15,6,3,6,13,7,27,20,7,29,53,104,1,21,ENG
2baec6ce,13,7,5,7,1,8,9,1,7,5,2,3,16,18,0,21,ENG
2bd83368,3,3,3,0,0,0,2,2,1,0,1,1,4,3,0,21,ENG
2bed3eab,8,7,5,3,0,5,7,2,4,1,3,4,12,10,0,21,ENG
2ce2508a,65,34,25,31,9,42,77,35,29,6,23,35,100,47,2,21,ENG
2d61d13a,19,10,11,4,4,6,9,3,2,2,0,12,31,28,1,21,ENG
2e4f5f03,46,34,23,18,5,28,57,29,39,9,30,21,67,79,1,21,ENG
2f7acede,16,9,11,5,0,5,20,15,16,4,12,11,27,12,1,21,ENG
2f90f6b8,26,19,9,14,3,11,33,22,30,3,27,14,40,16,1,21,ENG
2f965a72,1,0,1,0,0,1,5,4,0,0,0,1,2,13,3,21,ENG
2fba6108,4,2,3,1,0,4,5,1,1,1,0,1,5,1,0,21,ENG
30040f5d,0,0,0,0,0,0,1,1,2,0,2,0,0,2,0,21,ENG
30e81a88,8,5,1,4,3,1,13,12,15,2,13,5,13,5,0,21,ENG
312626c1,3,1,1,1,1,0,1,1,4,3,1,2,5,7,0,21,ENG
31c69ef1,24,13,13,8,3,4,16,12,31,23,8,35,59,92,0,21,ENG
321a71a7,2,2,2,0,0,2,2,0,0,0,0,0,2,3,0,21,ENG
3233eefd,5,4,4,0,1,2,7,5,11,5,6,10,15,26,2,21,ENG
32f60ed8,9,7,3,4,2,5,12,7,6,0,6,3,12,1,0,21,ENG
3312f911,29,16,14,12,3,6,23,17,24,8,16,22,51,16,0,21,ENG
3353737a,47,25,30,13,4,23,48,25,39,7,32,32,79,50,1,21,ENG
33887998,0,0,0,0,0,0,1,1,0,0,0,1,1,9,3,21,ENG
3423f250,34,17,13,16,5,12,58,46,31,1,30,29,63,27,0,21,ENG
3515d404,75,49,30,41,4,29,70,41,36,4,32,42,117,60,0,21,ENG
35e413f1,49,26,21,24,4,24,57,33,46,22,24,62,111,56,0,21,ENG
3626f7d9,24,12,23,1,0,14,23,9,23,6,17,25,49,63,0,21,ENG
36c2ca73,1,0,1,0,0,1,4,3,0,0,0,0,1,11,1,21,ENG
3727dd3c,39,14,18,19,2,10,37,27,26,14,12,36,75,42,0,21,ENG
383e68b1,0,0,0,0,0,0,0,0,0,0,0,0,0,0,0,21,ENG
38c7feef,4,0,0,3,1,0,2,2,1,0,1,2,6,0,0,21,ENG
38ceb24a,33,14,11,16,6,10,36,26,34,2,32,26,59,7,1,21,ENG
3925dbd6,7,4,0,3,4,2,8,6,12,3,9,3,10,8,0,21,ENG
3935e52e,0,0,0,0,0,0,0,0,0,0,0,1,1,0,0,21,ENG
394854c4,47,34,28,14,5,21,50,29,26,7,19,25,72,70,1,21,ENG
3a24769f,6,2,2,4,0,3,15,12,9,1,8,5,11,6,1,21,ENG
3a949a25,0,0,0,0,0,0,0,0,0,0,0,0,0,3,0,21,ENG
3add8ed8,1,1,0,1,0,0,0,0,1,1,0,0,1,0,0,21,ENG
3ae14ed1,33,18,14,15,4,13,45,32,13,1,12,19,52,17,0,21,ENG
3b029691,7,3,2,5,0,3,8,5,3,0,3,3,10,1,0,21,ENG
3bb7b8b4,3,1,3,0,0,3,4,1,0,0,0,0,3,11,4,21,ENG
3c066877,0,0,0,0,0,0,0,0,2,0,2,1,1,0,0,21,ENG
3d50bcdb,0,0,0,0,0,0,0,0,0,0,0,0,0,0,0,21,ENG
3e1550ee,0,0,0,0,0,0,0,0,0,0,0,0,0,0,0,21,ENG
3e9e06cb,11,8,7,4,0,5,12,7,26,22,4,32,43,88,3,21,ENG
3ea50f67,19,9,11,3,5,5,22,17,16,3,13,8,27,11,0,21,ENG
3eb22ec9,26,14,7,12,7,11,52,41,17,1,16,17,43,8,0,21,ENG
3ec9195b,45,27,27,12,6,21,44,23,39,16,23,49,94,90,0,21,ENG
3f2d59fe,1,1,1,0,0,1,1,0,1,0,1,0,1,3,0,21,ENG
3fe6bd8c,16,7,11,5,0,13,21,8,12,7,5,16,32,74,0,21,ENG
4047c976,2,2,1,1,0,0,5,5,6,0,6,1,3,0,0,21,ENG
4115ce4e,37,19,25,11,1,25,49,24,44,27,17,84,121,132,0,21,ENG
420d7c7d,108,61,69,30,9,49,87,38,53,36,17,36,144,96,5,21,ENG
42130443,0,0,0,0,0,0,0,0,0,0,0,0,0,0,0,21,ENG
43309491,1,1,0,1,0,0,0,0,0,0,0,0,1,0,0,21,ENG
43439614,49,22,16,28,5,21,72,51,29,12,17,36,85,51,1,21,ENG
43458538,4,1,2,1,1,0,0,0,3,0,3,1,5,1,0,21,ENG
43a166b4,3,2,0,2,1,1,3,2,5,1,4,1,4,2,0,21,ENG
4468ec10,1,1,1,0,0,0,0,0,0,0,0,0,1,0,0,21,ENG
44781702,27,17,10,11,6,13,30,17,10,5,5,18,45,49,2,21,ENG
44bfb6c5,86,46,42,38,6,36,88,52,55,11,44,65,151,46,2,21,ENG
450ab6fc,14,7,5,9,0,3,6,3,27,17,10,12,26,86,0,21,ENG
4535e4bb,1,0,1,0,0,0,0,0,0,0,0,0,1,5,0,21,ENG
45963054,18,12,1,8,9,2,15,13,14,5,9,4,22,32,0,21,ENG
45db685d,57,30,22,31,4,31,76,45,33,5,28,40,97,21,3,21,ENG
466fb2c5,1,1,1,0,0,1,1,0,0,0,0,2,3,22,6,21,ENG
46ee5234,15,11,11,3,1,8,10,2,8,6,2,16,31,30,1,21,ENG
47369df8,45,27,9,29,7,15,44,29,33,11,22,69,114,39,0,21,ENG
47a34c4f,14,6,7,7,0,7,28,21,11,4,7,24,38,20,2,21,ENG
4806ec67,0,0,0,0,0,0,2,2,2,0,2,3,3,16,4,21,ENG
4879f8cb,0,0,0,0,0,0,0,0,0,0,0,0,0,0,0,21,ENG
48a5a5d6,7,1,2,3,2,4,10,6,6,0,6,8,15,4,0,21,ENG
495945ef,23,15,6,12,5,10,42,32,26,9,17,44,67,33,0,21,ENG
49fe9070,20,9,6,11,3,7,43,36,23,1,22,8,28,8,0,21,ENG
4ab53cdb,25,16,5,15,5,13,28,15,25,4,21,2,27,7,0,21,ENG
4b40d9ca,1,1,1,0,0,0,1,1,0,0,0,2,3,29,2,21,ENG
4b511457,69,35,25,39,5,26,68,42,28,7,21,30,99,18,0,21,ENG
4bcf39f6,20,8,9,7,4,4,24,20,20,0,20,13,33,6,0,21,ENG
4c370d81,33,15,3,17,13,6,32,26,42,5,37,11,44,12,0,21,ENG
4d034881,4,1,0,2,2,2,11,9,2,0,2,2,6,0,0,21,ENG
4d0eb7d2,1,1,1,0,0,0,2,2,1,0,1,0,1,1,0,21,ENG
4dc4f138,44,28,32,9,3,30,49,19,38,15,23,36,80,55,2,21,ENG
4e9a0555,12,7,2,4,6,5,18,13,14,3,11,1,13,21,0,21,ENG
4f565d77,74,38,38,29,7,26,62,36,49,14,35,45,119,53,3,21,ENG
4f974391,32,13,15,15,2,18,32,14,29,14,15,32,64,79,2,21,ENG
4fa62ae4,0,0,0,0,0,0,0,0,0,0,0,0,0,0,0,21,ENG
4fb9c88f,16,6,6,7,3,12,25,13,13,0,13,19,35,11,1,21,ENG
507c7bdf,57,30,16,29,12,26,100,74,38,0,38,26,83,29,0,21,ENG
50dc94ce,15,10,2,11,2,7,15,8,10,1,9,6,21,7,0,21,ENG
50e6dc35,1,1,0,1,0,1,3,2,1,0,1,0,1,2,0,21,ENG
515ebe8d,22,14,15,7,0,11,24,13,17,14,3,20,42,81,0,21,ENG
51cf8561,25,15,12,9,4,14,24,10,17,4,13,23,48,28,0,21,ENG
52105203,6,4,5,1,0,4,11,7,16,14,2,18,24,59,1,21,ENG
5271c8f1,13,9,1,8,4,5,21,16,12,5,7,5,18,14,1,21,ENG
527f063d,12,8,1,8,3,2,13,11,2,0,2,6,18,11,0,21,ENG
529f49ab,44,21,16,24,4,24,56,32,17,5,12,23,67,18,0,21,ENG
531a4aa8,5,3,2,3,0,1,5,4,2,0,2,2,7,5,0,21,ENG
5348aada,2,2,1,0,1,0,0,0,2,1,1,1,3,2,0,21,ENG
53af52f3,0,0,0,0,0,0,0,0,0,0,0,0,0,10,0,21,ENG
53cad200,53,28,22,24,7,19,37,18,30,5,25,28,81,62,2,21,ENG
5540c9dc,0,0,0,0,0,0,0,0,2,0,2,1,1,7,0,21,ENG
55b4f1d6,5,4,3,0,2,1,7,6,5,1,4,1,6,2,0,21,ENG
56f7a928,86,45,32,38,16,45,108,63,35,8,27,46,132,20,1,21,ENG
57df7a11,20,12,14,6,0,11,34,23,12,0,12,8,28,28,2,21,ENG
57e3f0c7,20,15,8,6,6,8,23,15,16,1,15,12,32,19,0,21,ENG
58bc7d18,0,0,0,0,0,0,0,0,0,0,0,0,0,0,0,21,ENG
58eee997,13,10,6,4,3,5,22,17,9,0,9,5,18,1,0,21,ENG
59e6e5bf,17,8,1,8,8,6,12,6,22,6,16,6,23,33,0,21,ENG
5a04fd92,24,15,8,11,5,8,28,20,10,0,10,8,32,8,0,21,ENG
5a4280b1,11,6,9,2,0,7,9,2,11,7,4,6,17,24,0,21,ENG
5a7301ae,54,29,29,22,3,31,60,29,38,15,23,27,81,52,2,21,ENG
5c2b4f07,55,33,33,17,5,15,40,25,28,5,23,19,74,44,3,21,ENG
5cbd1eb0,64,35,48,9,7,23,40,17,29,10,19,21,85,62,1,21,ENG
5cdddffa,41,20,11,21,9,18,44,26,28,4,24,19,60,15,0,21,ENG
5e105217,6,3,2,4,0,1,3,2,5,0,5,2,8,1,0,21,ENG
5e74d6c8,0,0,0,0,0,0,1,1,1,0,1,1,1,7,0,21,ENG
5ed97752,1,1,0,1,0,1,1,0,0,0,0,0,1,0,0,21,ENG
5eecec3d,21,10,13,5,3,9,14,5,23,15,8,18,39,56,1,21,ENG
5f09991f,35,22,18,17,0,19,43,24,18,6,12,30,65,40,2,21,ENG
5f1a2f31,3,2,1,2,0,1,6,5,4,2,2,0,3,6,0,21,ENG
615ef733,17,13,12,4,1,9,14,5,6,3,3,17,34,26,0,21,ENG
62d7ef38,0,0,0,0,0,0,0,0,0,0,0,0,0,2,0,21,ENG
6385ebfb,0,0,0,0,0,0,0,0,0,0,0,0,0,1,0,21,ENG
6421ec64,7,4,3,1,3,2,7,5,4,0,4,2,9,0,0,21,ENG
6434f10d,72,40,24,40,8,33,66,33,23,9,14,36,108,54,3,21,ENG
64b08de7,16,12,9,7,0,8,21,13,15,7,8,8,24,12,0,21,ENG
653ee42d,11,6,2,7,2,3,6,3,3,0,3,8,19,2,0,21,ENG
6612cd8c,11,8,1,6,4,0,5,5,4,2,2,2,13,1,0,21,ENG
6613c819,78,41,37,36,5,28,77,49,43,18,25,62,140,107,0,21,ENG
6622454d,14,10,5,7,2,5,19,14,9,1,8,10,24,2,0,21,ENG
6722d4f0,0,0,0,0,0,0,0,0,0,0,0,0,0,0,0,21,ENG
67ac5bb8,25,15,19,5,1,13,19,6,27,19,8,26,51,74,2,21,ENG
67ca8566,74,45,46,22,6,30,88,58,41,3,38,44,118,52,1,21,ENG
6956ff08,5,5,3,2,0,1,2,1,1,1,0,3,8,4,0,21,ENG
6a713852,1,0,1,0,0,1,1,0,1,0,1,1,2,11,2,21,ENG
6adbc307,34,19,19,15,0,17,38,21,25,14,11,28,62,64,2,21,ENG
6b47c5db,96,63,45,44,7,26,66,40,38,11,27,61,157,55,0,21,ENG
6b625ac2,0,0,0,0,0,0,1,1,0,0,0,0,0,17,8,21,ENG
6bb2c084,78,37,27,38,13,27,68,41,35,6,29,56,134,17,2,21,ENG
6bd603db,1,0,0,1,0,0,0,0,1,0,1,0,1,1,0,21,ENG
6c17e046,15,13,1,11,3,5,22,17,17,2,15,9,24,12,0,21,ENG
6c203af0,104,68,50,48,6,33,67,34,42,6,36,64,168,67,0,21,ENG
6ca5ec4b,27,10,10,14,3,13,25,12,20,1,19,16,43,14,0,21,ENG
6d5701f2,21,14,17,4,0,8,12,4,30,23,7,24,45,110,1,21,ENG
6d646ff7,0,0,0,0,0,0,1,1,0,0,0,0,0,1,0,21,ENG
6e7f1353,7,4,4,2,1,1,4,3,5,0,5,4,11,1,0,21,ENG
6f7d826d,49,18,22,26,1,20,58,38,52,17,35,43,92,44,2,21,ENG
715bf047,28,17,8,15,5,11,46,35,17,0,17,15,43,3,0,21,ENG
71ef519e,10,3,5,3,2,3,17,14,17,2,15,12,22,47,0,21,ENG
728e9b2e,0,0,0,0,0,0,0,0,0,0,0,0,0,0,0,21,ENG
7399c7a8,14,6,8,5,1,6,11,5,10,4,6,9,23,42,0,21,ENG
74b2cd7e,26,13,20,5,1,9,17,8,25,11,14,30,56,119,0,21,ENG
74e12f1e,26,10,5,17,4,11,31,20,15,4,11,16,42,20,0,21,ENG
758dd7f0,24,14,8,14,2,11,17,6,8,1,7,9,33,15,1,21,ENG
75a72a99,31,22,16,8,7,14,35,21,24,1,23,15,46,23,0,21,ENG
76dd1480,30,20,9,14,7,13,44,31,31,2,29,34,64,21,1,21,ENG
77bb1522,30,18,16,12,2,14,43,29,20,4,16,18,48,12,3,21,ENG
77cf6852,19,8,9,9,1,12,25,13,15,9,6,15,34,52,2,21,ENG
77d7c96f,48,30,27,16,5,10,18,8,14,5,9,27,75,49,0,21,ENG
77e84962,61,36,20,30,11,17,49,32,26,0,26,30,91,14,0,21,ENG
78b8ac63,15,7,7,7,1,5,17,12,10,3,7,6,21,30,0,21,ENG
7914b9fe,13,9,10,3,0,7,11,4,27,22,5,13,26,88,0,21,ENG
79300479,9,3,2,6,1,4,14,10,2,0,2,2,11,5,0,21,ENG
7956236f,3,3,3,0,0,3,4,1,0,0,0,2,5,10,2,21,ENG
79b0d6a0,0,0,0,0,0,0,1,1,0,0,0,1,1,3,3,21,ENG
79bc4c45,33,18,15,10,8,13,40,27,20,3,17,12,45,17,0,21,ENG
79c0821a,46,28,19,24,3,17,32,15,18,1,17,15,61,11,2,21,ENG
79c84d1c,26,15,12,7,7,10,29,19,19,1,18,22,48,10,0,21,ENG
7a11550b,3,2,1,1,1,0,4,4,3,2,1,4,7,29,0,21,ENG
7a1f2c08,34,15,13,17,4,16,36,20,39,7,32,29,63,25,0,21,ENG
7a2e46a8,3,2,3,0,0,3,4,1,0,0,0,2,5,26,7,21,ENG
7af88b33,26,11,18,6,2,9,21,12,12,4,8,5,31,11,0,21,ENG
7ba2eaa9,16,9,4,6,6,6,28,22,18,2,16,31,47,8,0,21,ENG
7ba6d84e,0,0,0,0,0,0,0,0,0,0,0,0,0,8,3,21,ENG
7bb5f40e,15,8,4,11,0,7,23,16,32,4,28,10,25,32,1,21,ENG
7c104bb7,35,11,18,9,8,13,44,31,31,1,30,20,55,9,0,21,ENG
7c39363f,2,1,2,0,0,1,1,0,0,0,0,0,2,0,0,21,ENG
7d2d3329,8,7,3,5,0,4,10,6,4,1,3,4,12,9,1,21,ENG
7edfbb8a,2,1,2,0,0,0,0,0,1,1,0,2,4,8,0,21,ENG
7f3b388c,58,31,21,29,8,27,54,27,28,10,18,44,102,66,1,21,ENG
7fcc71d8,12,6,5,5,2,2,19,17,5,1,4,13,25,2,0,21,ENG
803ae100,63,38,28,28,7,29,73,44,34,11,23,50,113,31,1,21,ENG
80c31c97,0,0,0,0,0,0,0,0,0,0,0,0,0,1,0,21,ENG
810e3c74,12,6,4,8,0,5,14,9,7,1,6,4,16,0,0,21,ENG
819aa8e7,32,15,6,20,6,13,48,35,28,0,28,10,42,7,0,21,ENG
819b3158,25,15,8,12,5,10,39,29,13,4,9,20,45,9,0,21,ENG
81d8091f,2,1,2,0,0,2,8,6,1,0,1,2,4,1,0,21,ENG
82927de4,44,26,14,24,6,11,73,62,43,1,42,36,80,9,0,21,ENG
8397a50c,32,16,23,7,2,16,24,8,59,40,19,41,73,172,3,21,ENG
839c14e1,12,8,6,4,2,6,21,15,6,1,5,8,20,16,1,21,ENG
83d074ff,26,12,6,16,4,11,38,27,25,4,21,9,35,4,0,21,ENG
849c826a,5,4,2,2,1,2,8,6,1,0,1,1,6,2,0,21,ENG
8574c61f,0,0,0,0,0,0,3,3,1,0,1,1,1,0,0,21,ENG
85f8571a,14,5,11,3,0,7,13,6,11,5,6,8,22,25,0,21,ENG
862a1c15,49,29,21,25,3,14,56,42,23,4,19,25,74,20,1,21,ENG
86695068,14,7,4,7,3,6,15,9,12,2,10,7,21,3,0,21,ENG
867239d3,36,26,15,16,5,11,33,22,24,2,22,26,62,37,0,21,ENG
86dd77d1,29,19,15,12,2,16,24,8,19,7,12,14,43,28,0,21,ENG
86e7deaf,20,12,11,8,1,14,21,7,21,13,8,33,53,86,1,21,ENG
87935cf3,3,2,1,2,0,3,3,0,3,2,1,3,6,11,0,21,ENG
87f7500e,5,3,3,2,0,2,4,2,7,0,7,5,10,17,0,21,ENG
88acf83f,0,0,0,0,0,0,0,0,0,0,0,0,0,0,0,21,ENG
892d5bb1,20,5,2,10,8,6,30,24,19,0,19,8,28,4,0,21,ENG
8a7ff278,43,25,29,14,0,24,42,18,27,8,19,41,84,87,2,21,ENG
8aec0537,45,24,24,15,6,24,53,29,25,4,21,23,68,18,1,21,ENG
8b04d6c1,98,51,45,42,11,54,129,75,51,9,42,48,146,66,0,21,ENG
8b529245,3,1,2,1,0,1,1,0,0,0,0,2,5,5,0,21,ENG
8b788c01,2,1,1,1,0,0,10,10,17,3,14,1,3,8,0,21,ENG
8b9ebd03,13,7,6,6,1,6,16,10,13,0,13,8,21,8,0,21,ENG
8d03ca5a,10,6,6,4,0,4,11,7,3,1,2,9,19,3,0,21,ENG
8d228291,4,2,1,2,1,1,3,2,0,0,0,3,7,4,0,21,ENG
8d3c902d,58,37,44,12,2,25,43,18,42,26,16,32,90,125,2,21,ENG
8d62d31a,14,9,11,2,1,3,4,1,10,8,2,21,35,36,2,21,ENG
8df7a2fb,32,15,16,14,2,14,29,15,54,45,9,43,75,148,2,21,ENG
8f62b6ee,0,0,0,0,0,0,1,1,0,0,0,0,0,10,1,21,ENG
8fa8f8d2,0,0,0,0,0,0,0,0,0,0,0,0,0,0,0,21,ENG
90f91999,61,37,23,31,7,27,84,57,38,6,32,43,104,23,2,21,ENG
9228b07c,31,18,17,12,2,16,39,23,15,9,6,34,65,21,2,21,ENG
92e7e919,32,18,11,14,7,18,72,54,28,3,25,14,46,8,0,21,ENG
9319781b,11,5,5,3,3,7,9,2,5,1,4,11,22,9,0,21,ENG
9328b835,1,0,1,0,0,1,1,0,1,0,1,1,2,12,3,21,ENG
935e6b8f,24,15,12,9,3,10,26,16,12,1,11,34,58,30,0,21,ENG
93feac6e,21,9,2,11,8,8,27,19,14,4,10,10,31,37,0,21,ENG
966e28d0,9,6,4,4,1,5,9,4,2,0,2,1,10,1,1,21,ENG
9674002f,75,35,22,38,15,25,69,44,40,2,38,31,106,14,0,21,ENG
96bb8cc2,22,15,12,6,4,12,35,23,16,0,16,9,31,29,1,21,ENG
97333cf5,60,41,19,32,9,27,75,48,26,1,25,24,84,19,0,21,ENG
979b811d,23,14,9,11,3,12,34,22,25,1,24,19,42,14,0,21,ENG
984a5a64,83,53,56,25,2,34,57,23,41,10,31,38,121,66,2,21,ENG
989d5705,8,3,5,3,0,1,13,12,14,9,5,19,27,18,0,21,ENG
99813635,28,13,11,13,4,8,39,31,18,3,15,15,43,13,0,21,ENG
9a104dee,0,0,0,0,0,0,1,1,0,0,0,0,0,0,0,21,ENG
9a28eba4,28,16,11,13,4,13,21,8,23,1,22,7,35,12,1,21,ENG
9a71e978,14,6,11,2,1,10,22,12,2,0,2,9,23,23,0,21,ENG
9a9c05db,54,32,31,22,1,32,73,41,36,13,23,56,110,91,1,21,ENG
9ae9eaea,13,5,6,7,0,6,11,5,11,2,9,12,25,25,0,21,ENG
9b398aea,29,16,18,10,1,13,27,14,14,1,13,15,44,25,0,21,ENG
9c94165b,44,28,21,16,7,21,36,15,34,9,25,20,64,44,2,21,ENG
9dbb75ca,18,10,4,11,3,4,22,18,20,1,19,12,30,13,0,21,ENG
9dc96f10,3,3,1,2,0,0,0,0,2,1,1,0,3,1,0,21,ENG
9deaf2c8,2,1,1,0,1,0,1,1,1,0,1,0,2,2,0,21,ENG
9e1035f8,12,5,4,6,2,5,16,11,16,0,16,3,15,8,0,21,ENG
9e525177,88,54,53,29,6,32,45,13,65,17,48,62,150,84,2,21,ENG
9e5708be,0,0,0,0,0,0,0,0,0,0,0,2,2,15,2,21,ENG
9f1893b9,1,1,0,1,0,0,0,0,0,0,0,0,1,0,0,21,ENG
9f4647e9,17,12,12,4,1,10,16,6,11,2,9,1,18,12,0,21,ENG
9f472354,2,1,0,0,2,2,3,1,0,0,0,3,5,1,0,21,ENG
9f7c837d,55,33,37,15,3,27,41,14,56,37,19,33,88,120,0,21,ENG
9fbbcf39,35,24,23,12,0,19,33,14,28,13,15,52,87,115,1,21,ENG
a1232f4e,5,5,3,1,1,0,1,1,13,11,2,13,18,36,2,21,ENG
a179d516,0,0,0,0,0,0,0,0,0,0,0,0,0,0,0,21,ENG
a1d5bd30,18,9,2,8,8,7,27,20,22,2,20,8,26,10,0,21,ENG
a29b1131,15,7,8,3,4,7,20,13,7,1,6,5,20,9,0,21,ENG
a2b105e0,31,14,13,15,3,18,42,24,26,5,21,19,50,14,2,21,ENG
a3b03921,32,16,17,11,4,12,49,37,27,4,23,20,52,15,1,21,ENG
a4ac4b8f,33,20,26,7,0,13,24,11,18,12,6,32,65,84,1,21,ENG
a4fe8cda,0,0,0,0,0,0,0,0,0,0,0,0,0,0,0,21,ENG
a53649b7,3,1,0,2,1,0,2,2,6,0,6,0,3,5,0,21,ENG
a58bb1e1,17,10,4,9,4,7,14,7,13,2,11,8,25,16,0,21,ENG
a67a09fb,18,7,15,2,1,8,15,7,6,4,2,16,34,34,1,21,ENG
a712ca2b,20,14,12,8,0,7,18,11,32,22,10,22,42,59,0,21,ENG
a7588cdc,0,0,0,0,0,0,0,0,0,0,0,0,0,0,0,21,ENG
a8748947,9,3,1,4,4,1,4,3,6,0,6,0,9,3,0,21,ENG
a9142dc3,2,0,1,1,0,1,1,0,0,0,0,3,5,1,0,21,ENG
aa54ec6f,15,9,12,3,0,5,10,5,8,7,1,9,24,30,2,21,ENG
aa6f2f2c,0,0,0,0,0,0,2,2,0,0,0,0,0,0,0,21,ENG
aa849a12,63,38,20,30,13,26,59,33,30,2,28,15,78,21,0,21,ENG
ab070c55,15,7,1,7,7,2,9,7,17,6,11,4,19,39,0,21,ENG
ab13a5aa,1,1,1,0,0,1,1,0,0,0,0,1,2,11,1,21,ENG
ab4b3e35,8,3,3,3,2,7,15,8,5,0,5,8,16,6,0,21,ENG
ab651565,30,17,14,12,4,8,24,16,24,2,22,11,41,9,0,21,ENG
ab7d7882,0,0,0,0,0,0,0,0,0,0,0,0,0,0,0,21,ENG
abe66106,17,9,1,11,5,8,21,13,11,1,10,6,23,2,0,21,ENG
ac05f970,7,4,1,5,1,1,7,6,20,3,17,7,14,7,0,21,ENG
ac861941,23,14,13,10,0,11,18,7,37,31,6,23,46,123,3,21,ENG
ad1f61f3,17,8,10,4,3,6,15,9,8,1,7,8,25,10,0,21,ENG
ae0a7ddf,9,4,8,1,0,4,10,6,5,1,4,7,16,17,0,21,ENG
ae4fc6a4,27,14,11,13,3,16,35,19,19,3,16,24,51,9,1,21,ENG
ae5019e6,33,23,21,10,2,20,39,19,14,4,10,14,47,22,0,21,ENG
aed3a70f,29,17,5,16,8,10,33,23,21,2,19,7,36,24,0,21,ENG
af341b88,9,4,8,1,0,4,4,0,1,1,0,1,10,11,0,21,ENG
af69e7f0,15,8,7,5,3,7,12,5,8,2,6,14,29,16,0,21,ENG
b04ee927,26,15,14,10,2,12,54,42,18,0,18,29,55,16,0,21,ENG
b0b4fd3e,31,14,8,16,7,15,24,9,20,3,17,12,43,5,3,21,ENG
b217ef29,14,9,7,7,0,7,8,1,6,0,6,7,21,22,0,21,ENG
b28bbd58,78,41,45,20,13,30,79,49,48,2,46,41,119,19,0,21,ENG
b2bc3b1f,26,18,8,15,3,11,30,19,21,0,21,9,35,4,0,21,ENG
b2d31e83,50,26,33,14,3,27,53,26,30,7,23,31,81,75,0,21,ENG
b2ee9d2c,0,0,0,0,0,0,0,0,0,0,0,0,0,0,0,21,ENG
b2f9c73e,2,2,1,0,1,1,3,2,0,0,0,0,2,0,0,21,ENG
b400bde0,21,10,5,12,4,5,12,7,15,0,15,15,36,4,0,21,ENG
b561db50,3,2,1,2,0,0,7,7,2,0,2,8,11,12,0,21,ENG
b581987a,3,1,1,1,1,1,8,7,1,0,1,0,3,14,0,21,ENG
b63e789d,51,33,28,18,5,26,83,57,26,4,22,28,79,12,1,21,ENG
b66315ae,17,6,5,5,7,11,28,17,16,0,16,15,32,5,0,21,ENG
b827d5b3,33,19,14,15,4,16,45,29,29,3,26,17,50,27,1,21,ENG
b853e0ad,81,39,39,38,4,29,89,60,49,9,40,45,126,26,1,21,ENG
b937e490,7,5,5,2,0,3,4,1,3,0,3,2,9,4,0,21,ENG
b98570d1,33,18,14,16,3,14,31,17,21,6,15,16,49,26,0,21,ENG
b9fbae28,79,42,39,35,5,27,56,29,42,4,38,59,138,34,0,21,ENG
ba115a40,14,9,1,6,7,4,20,16,7,1,6,5,19,7,0,21,ENG
bb5fbd2b,49,23,24,15,10,18,34,16,30,5,25,22,71,30,0,21,ENG
bba30585,34,21,21,13,0,19,32,13,18,13,5,20,54,40,2,21,ENG
bc0bfc64,7,4,0,3,4,4,10,6,3,1,2,4,11,1,0,21,ENG
bc7dc64d,25,16,10,13,2,11,40,29,21,2,19,25,50,24,0,21,ENG
bd6351cd,68,41,42,19,7,43,83,40,23,2,21,41,109,33,2,21,ENG
bd8a7d05,5,5,3,2,0,0,0,0,4,1,3,2,7,4,0,21,ENG
bf3aeb61,5,1,3,0,2,1,6,5,3,0,3,3,8,2,0,21,ENG
bf8fad51,4,2,3,1,0,0,3,3,4,2,2,8,12,53,0,21,ENG
bfae110f,0,0,0,0,0,0,1,1,0,0,0,0,0,0,0,21,ENG
c0027d2d,3,2,2,1,0,2,8,6,7,0,7,7,10,2,0,21,ENG
c0398aca,5,3,2,1,2,5,16,11,2,0,2,0,5,0,1,21,ENG
c0617e2b,37,22,20,11,6,21,51,30,23,6,17,35,72,14,1,21,ENG
c067631c,9,5,5,4,0,3,7,4,6,2,4,11,20,20,0,21,ENG
c0e27d1a,12,9,5,7,0,4,4,0,16,9,7,16,28,50,2,21,ENG
c17bfb65,33,21,7,21,5,14,37,23,30,2,28,9,42,24,0,21,ENG
c2731c10,81,41,30,39,12,29,97,68,47,8,39,27,108,31,0,21,ENG
c2dfedeb,13,10,6,5,2,6,18,12,2,0,2,4,17,2,0,21,ENG
c2f9d19f,1,1,1,0,0,0,0,0,1,0,1,0,1,0,0,21,ENG
c3e39f12,1,0,1,0,0,1,2,1,0,0,0,0,1,9,0,21,ENG
c40b6180,29,16,15,10,4,12,25,13,29,16,13,47,76,92,3,21,ENG
c47541e0,26,10,8,10,8,10,34,24,23,1,22,15,41,14,1,21,ENG
c596fcb0,12,5,1,6,5,2,12,10,10,3,7,7,19,14,0,21,ENG
c5b7c315,28,15,20,8,0,14,31,17,46,33,13,51,79,161,0,21,ENG
c5bdb6e3,1,0,0,0,1,0,0,0,0,0,0,1,2,1,0,21,ENG
c684d3c9,20,10,9,11,0,9,19,10,16,10,6,13,33,39,1,21,ENG
c691bfe2,48,30,6,22,20,12,33,21,30,0,30,15,63,11,0,21,ENG
c7170b46,2,1,2,0,0,1,2,1,0,0,0,0,2,0,0,21,ENG
c73ada83,0,0,0,0,0,0,0,0,0,0,0,0,0,0,0,21,ENG
c81d773d,37,19,30,6,1,19,40,21,26,20,6,42,79,197,2,21,ENG
c8aa95da,13,4,8,5,0,7,19,12,19,12,7,27,40,52,1,21,ENG
c908a1bc,0,0,0,0,0,0,0,0,0,0,0,0,0,0,0,21,ENG
c92e1a31,12,5,2,4,6,4,17,13,14,0,14,2,14,1,1,21,ENG
c931d9f9,15,9,4,7,4,3,18,15,10,1,9,0,15,6,0,21,ENG
c951a6df,52,29,23,22,7,14,35,21,32,9,23,43,95,47,0,21,ENG
ca22ccb0,0,0,0,0,0,0,0,0,0,0,0,0,0,0,0,21,ENG
ca2bc3df,0,0,0,0,0,0,0,0,0,0,0,0,0,0,0,21,ENG
caa1a7f0,1,0,0,1,0,0,1,1,1,0,1,0,1,0,0,21,ENG
cc2d7ad5,48,28,30,15,3,25,46,21,36,19,17,29,77,87,2,21,ENG
cc700722,80,45,39,37,4,28,95,67,31,12,19,19,99,25,1,21,ENG
cc70a1d5,0,0,0,0,0,0,0,0,0,0,0,0,0,0,0,21,ENG
cd1acf9d,56,33,31,18,7,36,56,20,24,3,21,49,105,50,3,21,ENG
cde3309f,0,0,0,0,0,0,0,0,0,0,0,0,0,17,0,21,ENG
ce4246f5,16,10,8,6,2,4,8,4,13,9,4,28,44,93,0,21,ENG
ce5143da,12,6,2,6,4,7,19,12,17,0,17,7,19,13,0,21,ENG
cea4ee8f,18,11,8,6,4,7,19,12,9,0,9,7,25,3,0,21,ENG
cee31595,57,32,25,27,5,15,39,24,28,3,25,23,80,31,0,21,ENG
d0042ab9,56,36,31,18,7,20,50,30,37,13,24,35,91,90,3,21,ENG
d01231f0,3,2,0,2,1,1,2,1,1,0,1,0,3,2,0,21,ENG
d04b94db,85,48,53,23,9,42,72,30,30,10,20,41,126,78,2,21,ENG
d0b6129f,16,7,8,5,3,7,15,8,11,2,9,4,20,18,0,21,ENG
d0f72bf1,21,14,13,4,4,8,14,6,17,8,9,19,40,46,0,21,ENG
d2424d1b,42,22,16,22,4,15,33,18,28,3,25,24,66,58,0,21,ENG
d484c261,0,0,0,0,0,0,1,1,0,0,0,0,0,0,0,21,ENG
d557d734,29,15,15,10,4,13,33,20,20,5,15,23,52,46,0,21,ENG
d56543a0,4,1,3,1,0,2,5,3,1,0,1,6,10,7,0,21,ENG
d5dd5f1f,12,8,7,4,1,3,20,17,18,0,18,7,19,17,0,21,ENG
d6192210,40,14,34,6,0,23,41,18,51,32,19,42,82,122,2,21,ENG
d7492450,1,0,1,0,0,1,1,0,0,0,0,0,1,0,0,21,ENG
d7553721,28,22,12,11,5,10,29,19,12,1,11,7,35,5,0,21,ENG
d79a8c87,43,20,28,13,2,17,35,18,37,27,10,24,67,120,0,21,ENG
d87e2cae,2,1,1,1,0,1,4,3,6,1,5,1,3,12,0,21,ENG
d8931174,29,17,19,10,0,18,29,11,28,23,5,60,89,122,4,21,ENG
d93c2511,51,24,23,25,3,23,36,13,35,10,25,29,80,46,0,21,ENG
d9cfca3d,1,0,0,0,1,0,2,2,1,0,1,0,1,1,1,21,ENG
da052c14,38,26,8,16,14,16,44,28,28,2,26,16,54,12,0,21,ENG
da7b447d,40,20,31,9,0,21,32,11,18,13,5,14,54,85,2,21,ENG
da8b19e2,0,0,0,0,0,0,0,0,0,0,0,0,0,0,0,21,ENG
dad4b285,67,33,34,25,8,29,57,28,24,5,19,33,100,64,0,21,ENG
dbe56a33,33,21,8,15,10,13,31,18,19,3,16,2,35,25,0,21,ENG
dc31b84c,5,2,4,1,0,3,3,0,0,0,0,0,5,3,0,21,ENG
dc64b8b3,68,45,39,27,2,37,59,22,39,32,7,61,129,70,1,21,ENG
dc6f5bdd,7,3,3,2,2,3,8,5,6,2,4,10,17,37,0,21,ENG
dd323728,6,5,4,2,0,5,9,4,3,1,2,6,12,6,0,21,ENG
dd897ee7,0,0,0,0,0,0,0,0,0,0,0,0,0,0,0,21,ENG
dda3969e,4,3,3,0,1,1,4,3,2,1,1,1,5,16,0,21,ENG
de112b84,39,24,25,12,2,24,49,25,27,3,24,14,53,29,0,21,ENG
de31038e,0,0,0,0,0,0,0,0,0,0,0,0,0,0,0,21,ENG
de5b5570,22,14,10,11,1,7,12,5,16,5,11,17,39,9,1,21,ENG
debe38a0,41,21,29,12,0,22,39,17,43,31,12,41,82,131,0,21,ENG
df10e27c,4,2,1,2,1,2,7,5,3,2,1,3,7,1,0,21,ENG
e06683ca,3,2,1,2,0,0,0,0,1,1,0,5,8,8,1,21,ENG
e0bc6fdc,3,3,2,0,1,1,3,2,0,0,0,1,4,6,0,21,ENG
e28868f3,11,5,6,4,1,6,13,7,9,3,6,9,20,7,0,21,ENG
e342ad68,18,9,4,4,10,7,16,9,10,0,10,1,19,10,1,21,ENG
e34fc66d,33,19,18,11,4,15,28,13,24,13,11,44,77,151,1,21,ENG
e3a5814e,33,17,13,13,7,17,40,23,24,3,21,31,64,31,1,21,ENG
e46012d4,34,21,6,18,10,13,48,35,26,1,25,9,43,10,0,21,ENG
e49ce451,38,25,21,13,4,17,35,18,15,3,12,35,73,33,1,21,ENG
e4e0deaa,0,0,0,0,0,0,0,0,0,0,0,0,0,0,0,21,ENG
e514ab62,83,39,52,20,11,56,88,32,40,14,26,55,138,102,1,21,ENG
e58a03c6,2,0,1,1,0,0,7,7,3,1,2,1,3,2,0,21,ENG
e5a76dfe,1,1,1,0,0,1,2,1,0,0,0,0,1,3,2,21,ENG
e608ed4c,0,0,0,0,0,0,0,0,0,0,0,0,0,0,0,21,ENG
e61b8aee,50,26,18,17,15,30,58,28,23,7,16,24,74,38,3,21,ENG
e73c9bb2,14,7,10,3,1,8,17,9,7,2,5,16,30,20,0,21,ENG
e75750a3,7,5,5,1,1,3,19,16,9,0,9,7,14,8,0,21,ENG
e7aa9d7c,6,4,1,4,1,4,12,8,12,1,11,4,10,5,1,21,ENG
e7ca0439,4,2,4,0,0,3,4,1,4,3,1,4,8,45,0,21,ENG
e7ee38c3,0,0,0,0,0,0,0,0,0,0,0,0,0,4,1,21,ENG
e8c9f4e9,5,1,0,3,2,2,9,7,2,0,2,0,5,2,0,21,ENG
e97fd090,25,14,7,15,3,7,23,16,20,2,18,7,32,18,0,21,ENG
e9971f2d,5,4,3,2,0,1,3,2,6,5,1,3,8,15,0,21,ENG
ea6bc03a,27,16,17,10,0,10,19,9,18,12,6,27,54,34,2,21,ENG
eaeca114,10,5,3,6,1,3,4,1,2,1,1,9,19,23,0,21,ENG
eb58eef0,23,7,6,14,3,7,31,24,18,3,15,26,49,18,1,21,ENG
eb7822d7,25,11,13,12,0,13,31,18,19,5,14,22,47,10,3,21,ENG
ed1e53f3,22,11,12,8,2,9,23,14,9,0,9,11,33,11,0,21,ENG
ee38d9c5,32,16,5,16,11,14,41,27,14,1,13,9,41,5,0,21,ENG
efb9215a,37,20,23,13,1,16,38,22,21,7,14,11,48,44,1,21,ENG
f13d02a6,25,11,12,5,8,11,32,21,11,0,11,3,28,5,1,21,ENG
f1e94cd6,8,5,1,4,3,6,15,9,13,0,13,3,11,2,0,21,ENG
f230bc30,15,7,5,7,3,7,20,13,12,1,11,3,18,9,0,21,ENG
f25b010f,29,22,23,5,1,17,21,4,41,31,10,17,46,147,0,21,ENG
f25c8e3a,11,5,1,8,2,7,17,10,10,0,10,9,20,6,0,21,ENG
f2bf1b0f,25,16,4,15,6,6,17,11,20,2,18,4,29,19,1,21,ENG
f315ca93,0,0,0,0,0,0,0,0,0,0,0,0,0,0,0,21,ENG
f4290206,13,3,6,4,3,7,14,7,12,1,11,12,25,30,0,21,ENG
f4d296e4,49,30,28,19,2,17,28,11,35,21,14,47,96,92,0,21,ENG
f4e433d4,17,9,7,6,4,6,13,7,8,1,7,19,36,12,1,21,ENG
f522d7ec,35,19,19,9,7,19,43,24,16,2,14,16,51,9,0,21,ENG
f586779e,7,5,3,3,1,1,7,6,6,0,6,5,12,17,0,21,ENG
f5a00fa4,75,40,34,35,6,35,91,56,18,3,15,47,122,28,0,21,ENG
f5b281e7,4,3,1,2,1,3,8,5,4,0,4,0,4,4,0,21,ENG
f5deef4c,22,10,12,10,0,12,24,12,22,14,8,30,52,95,1,21,ENG
f631c17f,16,8,6,9,1,5,24,19,24,0,24,2,18,6,0,21,ENG
f72293fc,19,11,6,9,4,11,23,12,11,2,9,17,36,19,0,21,ENG
f76e6b4e,0,0,0,0,0,0,0,0,0,0,0,0,0,3,1,21,ENG
f7750aa0,3,3,2,1,0,1,4,3,3,1,2,5,8,5,0,21,ENG
f7d50789,35,22,22,11,2,18,30,12,40,28,12,10,45,121,0,21,ENG
f833a830,11,6,3,7,1,2,31,29,14,1,13,6,17,12,0,21,ENG
f874dd44,29,19,14,12,3,12,41,29,26,8,18,33,62,33,0,21,ENG
f8e588df,0,0,0,0,0,0,0,0,1,0,1,0,0,0,0,21,ENG
f8fcd2a5,25,12,22,2,1,14,20,6,8,3,5,46,71,98,1,21,ENG
fa031b34,50,32,21,22,7,16,51,35,28,3,25,14,64,36,1,21,ENG
fb2dec57,2,1,1,0,1,0,1,1,2,0,2,2,4,7,0,21,ENG
fb614c44,61,37,38,18,5,20,41,21,36,10,26,30,91,58,1,21,ENG
fc027d02,23,14,11,5,7,14,21,7,15,2,13,17,40,21,0,21,ENG
fc15fb84,47,24,24,18,5,18,56,38,44,6,38,32,79,32,1,21,ENG
fcab00a0,0,0,0,0,0,0,2,2,3,0,3,0,0,2,0,21,ENG
fce2302c,27,15,5,14,8,11,31,20,31,10,21,16,43,63,0,21,ENG
fdd85f94,6,5,0,6,0,2,5,3,3,0,3,1,7,0,0,21,ENG
fdf3cb77,73,36,50,15,8,52,89,37,41,7,34,41,114,102,1,21,ENG
fed7cb61,18,9,6,10,2,6,27,21,25,0,25,4,22,22,1,21,ENG
ff527768,8,4,2,5,1,4,14,10,7,3,4,13,21,3,0,21,ENG
ffa90327,16,13,6,7,3,7,23,16,11,0,11,6,22,11,0,21,ENG
ffec9769,0,0,0,0,0,0,0,0,0,0,0,0,0,0,0,21,ENG
0027c6cc,13,6,7,6,0,5,7,2,6,4,2,13,26,27,0,21,EL
005ca692,5,3,3,1,1,1,5,4,1,0,1,3,8,3,0,21,EL
00672021,4,2,1,2,1,4,9,5,3,1,2,3,7,2,0,21,EL
00ddb7f7,7,5,4,3,0,1,10,9,9,2,7,5,12,1,0,21,EL
00eba9c9,1,0,0,1,0,1,2,1,5,0,5,2,3,0,0,21,EL
00f0482f,1,0,1,0,0,0,0,0,0,0,0,0,1,0,0,21,EL
011d8c56,0,0,0,0,0,0,0,0,0,0,0,0,0,1,0,21,EL
0127419a,4,4,0,4,0,2,8,6,7,0,7,1,5,5,0,21,EL
0193a8bf,9,7,4,5,0,1,13,12,12,0,12,8,17,3,0,21,EL
01ccefab,8,3,3,4,1,6,9,3,4,1,3,3,11,6,0,21,EL
02a496ff,12,6,10,2,0,5,15,10,13,7,6,6,18,15,0,21,EL
02ce2030,3,2,0,3,0,2,7,5,6,4,2,7,10,18,1,21,EL
02d2c436,7,5,5,2,0,2,5,3,5,3,2,20,27,17,0,21,EL
02fbc447,3,2,1,1,1,1,1,0,1,0,1,3,6,0,0,21,EL
032f894e,5,3,2,2,1,1,6,5,4,0,4,5,10,1,0,21,EL
0362c29e,6,4,3,2,1,4,7,3,1,1,0,4,10,9,0,21,EL
03df04ff,0,0,0,0,0,0,0,0,0,0,0,0,0,1,0,21,EL
03f946ed,2,2,0,1,1,0,1,1,2,0,2,0,2,6,0,21,EL
042d286e,0,0,0,0,0,0,4,4,4,0,4,0,0,3,0,21,EL
04df29a5,3,1,0,1,2,1,1,0,0,0,0,0,3,2,0,21,EL
0557ff4f,4,3,4,0,0,1,2,1,1,0,1,2,6,2,0,21,EL
0562b7f1,0,0,0,0,0,0,2,2,1,0,1,0,0,3,0,21,EL
0578b238,12,8,9,2,1,8,13,5,10,3,7,9,21,19,0,21,EL
05bffdb1,0,0,0,0,0,0,0,0,0,0,0,0,0,2,1,21,EL
05e19d6a,8,4,4,3,1,2,8,6,10,2,8,6,14,9,0,21,EL
0658de43,2,1,0,2,0,2,3,1,1,0,1,0,2,0,0,21,EL
0670ee51,0,0,0,0,0,0,0,0,0,0,0,0,0,3,0,21,EL
06a10001,10,4,3,6,1,3,11,8,13,0,13,9,19,8,0,21,EL
06eae126,9,5,0,7,2,4,9,5,0,0,0,2,11,1,0,21,EL
070ec0b1,1,1,0,1,0,1,2,1,1,1,0,1,2,5,0,21,EL
07a821e4,1,1,0,1,0,0,0,0,3,0,3,0,1,0,0,21,EL
08593525,9,7,4,5,0,6,13,7,3,1,2,9,18,5,0,21,EL
08f5afaa,0,0,0,0,0,0,0,0,0,0,0,0,0,6,1,21,EL
0990f2fb,9,7,6,3,0,1,2,1,6,2,4,10,19,19,0,21,EL
09a9e921,1,1,1,0,0,1,3,2,5,1,4,2,3,3,0,21,EL
0a3d6d2b,2,2,1,1,0,0,1,1,2,2,0,4,6,1,0,21,EL
0a6dbbf7,2,1,2,0,0,1,1,0,1,1,0,7,9,4,0,21,EL
0a8d6b91,4,1,1,1,2,0,3,3,2,0,2,1,5,0,0,21,EL
0ac893aa,5,3,3,2,0,1,1,0,4,3,1,4,9,10,0,21,EL
0acf0e1c,0,0,0,0,0,0,0,0,0,0,0,0,0,0,0,21,EL
0aeeed3f,15,7,8,5,2,5,12,7,11,1,10,10,25,3,0,21,EL
0b0f256d,1,1,0,1,0,1,3,2,1,0,1,0,1,2,0,21,EL
0b5a292a,11,6,8,3,0,5,13,8,4,2,2,7,18,11,0,21,EL
0be28faf,5,2,3,2,0,2,12,10,9,3,6,9,14,6,0,21,EL
0bf123b6,3,1,2,1,0,2,4,2,1,0,1,3,6,3,0,21,EL
0bf3c11c,0,0,0,0,0,0,2,2,0,0,0,0,0,2,0,21,EL
0c3057a9,1,1,0,1,0,0,6,6,2,0,2,1,2,5,0,21,EL
0c5c94d0,4,3,2,2,0,2,4,2,2,0,2,2,6,2,0,21,EL
0c81fbf1,0,0,0,0,0,0,0,0,0,0,0,0,0,0,0,21,EL
0cb29e91,8,4,2,5,1,5,12,7,8,1,7,7,15,5,0,21,EL
0cd0e21b,6,4,5,1,0,3,4,1,3,0,3,3,9,2,0,21,EL
0d10333c,16,7,7,9,0,8,12,4,5,1,4,10,26,1,0,21,EL
0d267745,10,7,7,2,1,5,11,6,1,1,0,8,18,17,0,21,EL
0d4fd3a0,7,6,6,1,0,4,8,4,4,1,3,3,10,18,0,21,EL
0d72fbca,6,2,1,5,0,2,6,4,2,0,2,0,6,2,0,21,EL
0d901d79,0,0,0,0,0,0,0,0,0,0,0,1,1,0,0,21,EL
0db169ae,15,6,6,6,3,6,13,7,4,2,2,3,18,11,1,21,EL
0e5753c7,16,7,5,10,1,7,14,7,0,0,0,8,24,4,0,21,EL
0e96a5e1,1,1,0,1,0,1,1,0,2,1,1,0,1,2,0,21,EL
0eb8ee41,14,8,9,2,3,4,9,5,3,0,3,14,28,2,1,21,EL
0eeafda5,0,0,0,0,0,0,1,1,0,0,0,2,2,4,0,21,EL
0f888175,7,4,3,2,2,3,8,5,8,0,8,3,10,2,0,21,EL
0fbb73c2,2,1,1,1,0,2,11,9,4,0,4,7,9,8,0,21,EL
1013b476,4,2,3,1,0,2,5,3,1,0,1,2,6,5,0,21,EL
10161491,0,0,0,0,0,0,0,0,0,0,0,0,0,0,0,21,EL
108fe016,6,3,1,4,1,2,3,1,1,0,1,1,7,1,0,21,EL
112c495e,5,1,2,1,2,3,5,2,3,1,2,9,14,4,0,21,EL
116c35df,1,0,0,0,1,0,5,5,4,0,4,2,3,6,0,21,EL
11a1a615,8,1,6,2,0,4,8,4,6,3,3,0,8,8,0,21,EL
11b4f41a,4,2,2,2,0,2,5,3,2,1,1,3,7,6,0,21,EL
11b9265b,2,0,2,0,0,1,1,0,1,1,0,1,3,0,0,21,EL
11c0fa9d,0,0,0,0,0,0,2,2,0,0,0,4,4,1,0,21,EL
11c7fa75,0,0,0,0,0,0,0,0,0,0,0,0,0,1,1,21,EL
11f5df14,0,0,0,0,0,0,0,0,0,0,0,1,1,2,1,21,EL
121101a4,2,1,2,0,0,0,1,1,5,4,1,6,8,14,0,21,EL
123dd5e2,5,2,3,1,1,2,9,7,2,0,2,3,8,5,0,21,EL
1295b5e3,10,5,4,5,1,4,16,12,5,1,4,10,20,18,0,21,EL
12aa7661,5,2,4,1,0,4,6,2,0,0,0,1,6,3,0,21,EL
12c35abe,4,4,1,3,0,0,7,7,0,0,0,2,6,2,0,21,EL
12dcbdcc,11,8,4,6,1,5,10,5,7,3,4,7,18,11,1,21,EL
12e6d21a,3,3,0,1,2,0,8,8,3,1,2,2,5,11,0,21,EL
130a7a3f,11,6,5,3,3,6,31,25,10,2,8,5,16,4,0,21,EL
132a82f1,5,0,0,4,1,2,3,1,3,3,0,10,15,13,0,21,EL
1338e42b,9,5,4,4,1,5,9,4,5,1,4,5,14,4,0,21,EL
1395682c,1,1,1,0,0,1,1,0,1,1,0,2,3,16,0,21,EL
13b44b02,2,2,2,0,0,2,8,6,0,0,0,4,6,6,0,21,EL
13c8e5f6,0,0,0,0,0,0,5,5,1,0,1,3,3,0,0,21,EL
13ea2544,1,1,0,1,0,1,6,5,2,0,2,1,2,6,0,21,EL
14229604,1,1,0,0,1,0,0,0,0,0,0,0,1,0,0,21,EL
14349aeb,3,1,2,0,1,3,6,3,2,0,2,2,5,1,0,21,EL
14866457,1,0,0,1,0,0,0,0,0,0,0,0,1,1,0,21,EL
148e136f,7,4,1,2,4,2,4,2,2,0,2,0,7,0,0,21,EL
14a4dd0d,0,0,0,0,0,0,0,0,2,0,2,0,0,1,0,21,EL
15975a3c,7,4,3,3,1,3,5,2,0,0,0,6,13,2,0,21,EL
1598599e,4,1,1,2,1,0,1,1,3,1,2,4,8,1,0,21,EL
15b949ab,2,1,2,0,0,1,1,0,1,1,0,6,8,26,0,21,EL
15eb04ec,13,8,4,7,2,8,17,9,6,2,4,10,23,3,0,21,EL
15fd5593,9,6,0,9,0,6,11,5,4,2,2,1,10,6,0,21,EL
165a2e40,1,0,0,0,1,0,3,3,1,0,1,0,1,0,0,21,EL
16657b95,13,9,9,3,1,2,8,6,5,1,4,16,29,31,1,21,EL
166a981d,1,1,0,0,1,0,1,1,1,0,1,0,1,0,0,21,EL
1695c659,10,6,7,1,2,5,11,6,7,1,6,1,11,1,0,21,EL
16aa3654,8,5,1,3,4,7,8,1,4,0,4,0,8,1,0,21,EL
16b9d5cf,7,4,5,2,0,3,7,4,15,7,8,10,17,20,0,21,EL
16c149b8,13,9,10,2,1,4,7,3,3,0,3,11,24,16,0,21,EL
16daec92,8,3,1,5,2,4,9,5,5,2,3,9,17,3,0,21,EL
172bab0a,9,4,4,4,1,2,4,2,9,0,9,1,10,1,0,21,EL
17695062,7,4,3,3,1,1,4,3,3,0,3,8,15,3,0,21,EL
179d2851,0,0,0,0,0,0,0,0,0,0,0,0,0,4,2,21,EL
17e3e467,6,5,1,4,1,1,6,5,6,2,4,0,6,1,0,21,EL
1880614f,8,5,0,6,2,3,6,3,2,0,2,4,12,2,0,21,EL
1971591f,5,4,1,3,1,2,3,1,3,0,3,1,6,2,0,21,EL
197640fd,5,4,3,1,1,2,2,0,3,0,3,1,6,1,0,21,EL
19a12bed,7,3,4,3,0,3,6,3,5,0,5,7,14,4,0,21,EL
19c36442,8,6,1,5,2,2,3,1,3,1,2,7,15,6,0,21,EL
19e74ea6,2,2,1,1,0,1,4,3,1,0,1,1,3,0,0,21,EL
1a4ef233,1,1,0,1,0,0,0,0,0,0,0,0,1,3,0,21,EL
1a6b7ea4,8,4,4,3,1,4,9,5,9,0,9,10,18,9,0,21,EL
1a799243,5,3,2,1,2,2,8,6,4,0,4,4,9,0,0,21,EL
1a9db1c5,0,0,0,0,0,0,0,0,0,0,0,0,0,0,0,21,EL
1adcf39e,9,7,4,2,3,4,9,5,4,2,2,6,15,7,0,21,EL
1b033987,9,4,4,5,0,2,9,7,3,0,3,5,14,3,0,21,EL
1b192c1f,15,7,8,4,3,12,29,17,9,2,7,17,32,12,0,21,EL
1b7af391,1,0,0,1,0,0,1,1,2,0,2,0,1,0,0,21,EL
1b81794d,9,3,3,3,3,4,9,5,4,0,4,0,9,0,0,21,EL
1bd5735a,0,0,0,0,0,0,0,0,1,0,1,1,1,0,0,21,EL
1bda5842,5,4,1,4,0,1,5,4,4,0,4,5,10,1,0,21,EL
1bfdb73a,6,2,5,1,0,3,3,0,1,1,0,1,7,4,0,21,EL
1c07b06e,0,0,0,0,0,0,3,3,3,2,1,6,6,1,0,21,EL
1cfd188f,1,1,0,1,0,1,2,1,0,0,0,1,2,1,0,21,EL
1d25929b,0,0,0,0,0,0,3,3,1,0,1,0,0,2,0,21,EL
1d42db4a,16,10,9,6,1,4,13,9,7,3,4,6,22,16,0,21,EL
1d54e8f8,8,4,2,3,3,3,13,10,3,1,2,2,10,1,0,21,EL
1d5cab82,10,3,2,6,2,5,9,4,4,0,4,4,14,1,0,21,EL
1d8e9add,5,4,1,4,0,1,3,2,3,1,2,7,12,10,0,21,EL
1dbfae2d,0,0,0,0,0,0,2,2,1,0,1,1,1,1,0,21,EL
1e1378e1,2,1,0,1,1,0,4,4,1,0,1,2,4,0,0,21,EL
1e8dbb59,1,1,1,0,0,0,1,1,8,6,2,3,4,17,0,21,EL
1f0072a6,1,0,0,1,0,0,0,0,1,0,1,1,2,0,0,21,EL
1f079188,3,0,1,2,0,1,5,4,6,3,3,7,10,9,0,21,EL
1f3afdcb,2,2,1,1,0,2,2,0,1,0,1,0,2,2,0,21,EL
1f6298f2,0,0,0,0,0,0,1,1,1,0,1,0,0,0,0,21,EL
1fda91b3,5,3,2,2,1,1,5,4,7,0,7,5,10,6,0,21,EL
2003bf6f,0,0,0,0,0,0,0,0,0,0,0,0,0,1,0,21,EL
200e89e1,3,3,0,2,1,0,4,4,3,0,3,2,5,0,0,21,EL
202b3b68,2,0,0,1,1,2,6,4,3,1,2,3,5,1,1,21,EL
20730eae,3,1,1,1,1,1,1,0,4,0,4,0,3,5,0,21,EL
20b9f052,0,0,0,0,0,0,0,0,0,0,0,0,0,4,1,21,EL
210bade3,1,0,0,0,1,1,1,0,0,0,0,0,1,2,0,21,EL
21166ff4,4,3,2,2,0,2,4,2,4,2,2,6,10,16,0,21,EL
21453b2e,0,0,0,0,0,0,0,0,1,0,1,0,0,0,0,21,EL
2146785a,4,1,2,2,0,3,5,2,2,2,0,3,7,3,0,21,EL
216891d5,6,6,5,1,0,6,7,1,2,0,2,0,6,2,0,21,EL
21945a9e,1,1,0,0,1,0,0,0,0,0,0,0,1,0,0,21,EL
21a66f6a,0,0,0,0,0,0,0,0,1,1,0,0,0,2,0,21,EL
2209c211,5,2,2,2,1,3,6,3,2,1,1,4,9,7,0,21,EL
228b0d9d,4,0,1,2,1,4,6,2,0,0,0,0,4,5,0,21,EL
22919e97,1,1,0,1,0,0,2,2,0,0,0,2,3,0,0,21,EL
22f2ce4b,1,0,0,1,0,0,6,6,8,2,6,3,4,1,0,21,EL
230a2fac,9,7,6,3,0,5,9,4,4,1,3,8,17,10,0,21,EL
230f0471,9,5,8,1,0,8,13,5,6,2,4,6,15,13,0,21,EL
23559bd9,6,5,5,1,0,5,8,3,2,2,0,4,10,2,0,21,EL
235a646b,3,1,3,0,0,2,4,2,3,0,3,5,8,4,0,21,EL
23a10591,0,0,0,0,0,0,0,0,0,0,0,0,0,0,0,21,EL
23f9e9d3,1,1,0,0,1,0,2,2,0,0,0,0,1,0,0,21,EL
24228180,6,5,0,4,2,2,9,7,8,1,7,1,7,12,0,21,EL
2429a3ec,7,2,2,5,0,6,10,4,5,1,4,4,11,7,0,21,EL
242e1043,10,3,5,5,0,6,14,8,5,2,3,9,19,13,0,21,EL
244a31b9,8,4,6,2,0,2,8,6,4,1,3,21,29,14,0,21,EL
2475dcc6,3,0,1,1,1,2,5,3,4,1,3,1,4,1,0,21,EL
24b98f95,0,0,0,0,0,0,0,0,0,0,0,0,0,0,0,21,EL
24fc70d3,6,3,3,3,0,3,4,1,6,2,4,9,15,18,0,21,EL
25126342,0,0,0,0,0,0,2,2,2,2,0,5,5,46,0,21,EL
254b831b,1,1,1,0,0,1,2,1,2,1,1,1,2,4,0,21,EL
258a6f4d,0,0,0,0,0,0,2,2,2,0,2,1,1,1,0,21,EL
25b74470,11,7,9,2,0,7,8,1,2,1,1,8,19,6,0,21,EL
25e6f8cb,1,1,0,1,0,0,4,4,1,0,1,1,2,1,0,21,EL
2628fd2b,0,0,0,0,0,0,1,1,0,0,0,0,0,2,3,21,EL
262e5a82,4,3,1,3,0,0,1,1,0,0,0,0,4,0,0,21,EL
264b6d64,0,0,0,0,0,0,0,0,0,0,0,0,0,2,0,21,EL
26a796c1,5,1,3,2,0,3,6,3,3,0,3,4,9,4,0,21,EL
26b7d548,6,2,1,4,1,5,7,2,0,0,0,2,8,1,0,21,EL
26ce2263,11,8,5,6,0,3,9,6,3,0,3,6,17,4,0,21,EL
2707b562,0,0,0,0,0,0,1,1,2,0,2,0,0,0,0,21,EL
275f52fc,0,0,0,0,0,0,0,0,0,0,0,1,1,0,0,21,EL
27b35319,0,0,0,0,0,0,1,1,0,0,0,0,0,0,0,21,EL
27d902c8,0,0,0,0,0,0,0,0,0,0,0,0,0,0,0,21,EL
27e3271e,7,5,1,5,1,5,10,5,8,1,7,4,11,2,0,21,EL
27f0ddef,2,2,2,0,0,1,4,3,1,1,0,3,5,12,0,21,EL
27f0fcda,1,1,0,1,0,0,0,0,0,0,0,0,1,0,0,21,EL
27ff9bdb,1,0,0,1,0,1,6,5,4,0,4,1,2,0,0,21,EL
282faa70,4,3,2,2,0,4,8,4,1,1,0,2,6,0,0,21,EL
28eaa0f3,5,4,3,2,0,1,2,1,2,0,2,6,11,4,0,21,EL
28eea0fc,3,1,1,0,2,2,8,6,3,1,2,6,9,7,0,21,EL
292a652a,4,3,2,2,0,1,3,2,0,0,0,4,8,7,1,21,EL
2969ccd2,4,2,1,1,2,1,5,4,1,0,1,2,6,1,0,21,EL
29733c72,0,0,0,0,0,0,2,2,0,0,0,0,0,2,0,21,EL
29e48848,4,4,2,2,0,3,6,3,2,0,2,3,7,9,0,21,EL
29fbdc88,13,7,4,5,4,6,17,11,3,1,2,11,24,2,0,21,EL
2a70dcc9,0,0,0,0,0,0,1,1,3,0,3,2,2,1,0,21,EL
2a74db8a,3,2,1,1,1,1,3,2,0,0,0,0,3,0,0,21,EL
2a8c9f98,0,0,0,0,0,0,0,0,0,0,0,0,0,0,0,21,EL
2acd49b9,9,5,5,4,0,4,5,1,5,1,4,7,16,7,0,21,EL
2b1c4abd,1,0,0,1,0,0,1,1,1,0,1,0,1,1,0,21,EL
2b3efa4a,13,5,11,2,0,9,21,12,9,3,6,14,27,25,0,21,EL
2b53f7a5,3,2,2,1,0,0,5,5,5,0,5,4,7,1,0,21,EL
2b622f01,17,12,4,7,6,5,14,9,3,0,3,5,22,1,0,21,EL
2b79c1a3,0,0,0,0,0,0,0,0,0,0,0,0,0,0,0,21,EL
2ba38347,7,6,4,3,0,3,4,1,1,1,0,4,11,6,0,21,EL
2bab583c,5,3,4,1,0,4,6,2,13,7,6,20,25,27,0,21,EL
2baec6ce,3,0,3,0,0,2,4,2,7,3,4,2,5,4,0,21,EL
2bf50b37,3,2,2,1,0,2,3,1,0,0,0,1,4,1,0,21,EL
2ccd89a3,2,1,1,0,1,0,0,0,0,0,0,0,2,3,0,21,EL
2cd081e3,2,2,1,1,0,1,2,1,0,0,0,1,3,3,0,21,EL
2ce71308,0,0,0,0,0,0,1,1,1,0,1,1,1,0,0,21,EL
2d26a704,5,3,2,3,0,3,7,4,1,0,1,2,7,1,0,21,EL
2d45ce0a,1,1,1,0,0,0,0,0,1,0,1,1,2,3,0,21,EL
2d49b833,8,3,5,3,0,3,7,4,3,3,0,11,19,15,0,21,EL
2e594b84,7,3,3,4,0,2,6,4,0,0,0,3,10,4,1,21,EL
2e77d607,4,2,3,1,0,3,3,0,4,3,1,5,9,14,1,21,EL
2ef7c612,1,0,0,0,1,1,2,1,1,0,1,1,2,0,0,21,EL
2f3452eb,1,1,1,0,0,0,1,1,1,1,0,2,3,5,0,21,EL
2f557579,7,3,6,0,1,3,8,5,8,1,7,6,13,1,0,21,EL
2f7acede,11,4,3,7,1,7,14,7,11,2,9,14,25,5,1,21,EL
301c287b,9,4,1,6,2,1,5,4,1,0,1,1,10,4,0,21,EL
30223b33,0,0,0,0,0,0,0,0,0,0,0,0,0,1,1,21,EL
3060f38c,0,0,0,0,0,0,0,0,0,0,0,0,0,0,0,21,EL
30643ce2,0,0,0,0,0,0,0,0,0,0,0,0,0,0,0,21,EL
3092b473,0,0,0,0,0,0,0,0,0,0,0,1,1,0,0,21,EL
3098c0df,0,0,0,0,0,0,0,0,1,0,1,1,1,0,0,21,EL
30d4a2e5,6,3,2,3,1,4,6,2,5,0,5,6,12,13,0,21,EL
30d75bfb,0,0,0,0,0,0,1,1,0,0,0,1,1,0,0,21,EL
30fab1ee,4,3,2,1,1,2,9,7,3,1,2,6,10,3,1,21,EL
313d5ee5,10,3,6,1,3,4,12,8,4,0,4,2,12,2,0,21,EL
315e74cf,8,5,2,4,2,2,7,5,7,2,5,4,12,4,0,21,EL
316de854,9,7,4,4,1,2,8,6,8,1,7,5,14,3,0,21,EL
31822f8c,0,0,0,0,0,0,0,0,0,0,0,0,0,0,0,21,EL
319322cd,9,3,9,0,0,8,14,6,10,4,6,8,17,18,1,21,EL
31a62dc7,6,3,3,3,0,5,12,7,6,1,5,3,9,6,1,21,EL
321a71a7,4,4,4,0,0,0,1,1,0,0,0,0,4,6,0,21,EL
321f83a2,11,8,3,6,2,2,6,4,7,1,6,5,16,3,0,21,EL
327c20e6,4,4,3,1,0,1,2,1,11,1,10,17,21,16,1,21,EL
328f7d51,9,3,2,5,2,4,10,6,9,0,9,3,12,3,1,21,EL
32f7976d,1,1,1,0,0,1,1,0,0,0,0,0,1,4,0,21,EL
3318193b,5,3,1,2,2,1,2,1,5,2,3,0,5,13,0,21,EL
3353737a,3,2,0,2,1,1,4,3,4,0,4,5,8,4,0,21,EL
346d51d9,13,7,2,11,0,9,13,4,7,0,7,14,27,6,0,21,EL
34caa4b3,4,2,1,2,1,4,4,0,4,0,4,2,6,0,0,21,EL
35044395,13,9,8,3,2,5,9,4,4,1,3,5,18,4,0,21,EL
35141f4c,14,8,9,4,1,7,10,3,11,4,7,8,22,9,0,21,EL
352ca5eb,13,7,2,8,3,7,18,11,10,2,8,3,16,6,0,21,EL
35389469,1,1,0,1,0,0,3,3,1,0,1,0,1,8,0,21,EL
3564fbc8,4,2,0,4,0,1,3,2,2,1,1,1,5,3,0,21,EL
359a9fb4,1,1,1,0,0,1,1,0,1,0,1,3,4,0,0,21,EL
35c54115,4,4,4,0,0,1,2,1,12,9,3,12,16,18,0,21,EL
3624ce4c,10,6,5,4,1,4,4,0,7,4,3,6,16,17,0,21,EL
3626daea,6,2,6,0,0,3,5,2,3,0,3,8,14,10,1,21,EL
370ae604,1,1,1,0,0,0,1,1,0,0,0,1,2,0,0,21,EL
37268799,4,3,2,1,1,2,5,3,1,0,1,0,4,0,0,21,EL
374ee424,0,0,0,0,0,0,1,1,0,0,0,0,0,2,0,21,EL
3768a876,1,0,0,1,0,0,0,0,0,0,0,0,1,0,0,21,EL
376d4a41,1,0,0,1,0,1,1,0,0,0,0,0,1,0,0,21,EL
37736209,9,4,6,2,1,6,8,2,7,3,4,6,15,11,0,21,EL
37d0048f,8,3,3,3,2,4,9,5,1,0,1,6,14,5,0,21,EL
37d39918,2,1,1,1,0,1,3,2,4,1,3,9,11,4,1,21,EL
37f606f0,5,3,1,2,2,4,7,3,2,0,2,5,10,0,1,21,EL
3814b753,4,4,0,3,1,2,4,2,1,0,1,1,5,1,0,21,EL
383e8f03,2,1,0,2,0,2,3,1,1,0,1,0,2,0,0,21,EL
387750b7,1,1,1,0,0,1,1,0,0,0,0,0,1,2,0,21,EL
390eb94b,8,4,4,3,1,2,11,9,6,0,6,2,10,1,0,21,EL
3925ee80,1,1,1,0,0,0,0,0,1,0,1,2,3,1,0,21,EL
3935e52e,2,1,1,1,0,0,1,1,3,2,1,4,6,1,0,21,EL
393a257c,4,4,3,1,0,0,1,1,4,3,1,2,6,8,0,21,EL
39769cff,5,3,2,2,1,2,2,0,6,0,6,2,7,5,0,21,EL
398dc4f4,6,4,2,3,1,2,5,3,2,0,2,2,8,3,0,21,EL
3a17d72b,0,0,0,0,0,0,0,0,0,0,0,0,0,0,0,21,EL
3a233281,3,3,0,3,0,1,5,4,3,0,3,1,4,2,0,21,EL
3a4e124d,9,6,3,6,0,2,11,9,4,0,4,2,11,1,0,21,EL
3a770838,2,0,1,1,0,1,4,3,6,1,5,3,5,1,0,21,EL
3a7e7259,2,2,1,1,0,2,3,1,1,0,1,4,6,15,0,21,EL
3add8ed8,0,0,0,0,0,0,0,0,1,0,1,0,0,0,0,21,EL
3b0108d6,0,0,0,0,0,0,0,0,0,0,0,0,0,0,0,21,EL
3b5cd50d,1,0,0,1,0,0,0,0,3,2,1,0,1,0,0,21,EL
3bb7f478,5,3,0,3,2,1,4,3,2,0,2,2,7,4,0,21,EL
3c70fb81,15,12,8,7,0,11,16,5,15,0,15,4,19,6,0,21,EL
3c93b9f0,7,1,4,2,1,3,4,1,4,4,0,4,11,7,0,21,EL
3ca7254a,14,10,8,4,2,6,18,12,6,0,6,2,16,0,0,21,EL
3ce20eda,4,1,3,1,0,0,1,1,5,4,1,9,13,25,0,21,EL
3d214e5f,1,1,1,0,0,1,1,0,0,0,0,0,1,3,0,21,EL
3d62c18b,1,0,1,0,0,0,0,0,8,7,1,7,8,7,0,21,EL
3d6691dd,1,1,1,0,0,1,2,1,1,0,1,1,2,0,0,21,EL
3d688b46,5,2,2,3,0,1,4,3,2,2,0,3,8,6,0,21,EL
3dab8efd,1,0,1,0,0,1,1,0,0,0,0,2,3,0,0,21,EL
3e6b69c2,18,9,10,7,1,8,13,5,5,1,4,13,31,31,0,21,EL
3e8c66c3,3,3,3,0,0,2,5,3,3,2,1,3,6,5,0,21,EL
3ea50f67,2,1,0,2,0,0,2,2,5,0,5,1,3,2,0,21,EL
3ead85f9,5,3,3,2,0,3,4,1,9,8,1,11,16,22,0,21,EL
3ec9f005,1,0,0,1,0,0,1,1,0,0,0,0,1,0,0,21,EL
3ee0dd59,7,2,3,3,1,3,5,2,6,3,3,15,22,10,0,21,EL
3f2587ee,0,0,0,0,0,0,0,0,0,0,0,0,0,0,0,21,EL
3f2d59fe,6,5,2,4,0,2,3,1,6,1,5,6,12,10,0,21,EL
3ff205d5,0,0,0,0,0,0,1,1,0,0,0,0,0,1,0,21,EL
4037db79,2,2,1,1,0,1,6,5,7,4,3,8,10,2,0,21,EL
403f5d20,7,6,5,2,0,5,7,2,5,2,3,9,16,28,0,21,EL
4044e8d8,1,1,1,0,0,1,6,5,3,0,3,0,1,0,0,21,EL
407feb71,6,4,2,2,2,2,8,6,3,0,3,4,10,0,0,21,EL
41034650,8,6,0,7,1,2,7,5,1,0,1,11,19,9,0,21,EL
41723204,0,0,0,0,0,0,2,2,2,1,1,0,0,3,0,21,EL
41f0b196,0,0,0,0,0,0,0,0,0,0,0,1,1,2,0,21,EL
4210aebe,1,1,0,1,0,0,0,0,2,0,2,0,1,0,0,21,EL
42eaa028,2,2,0,2,0,0,5,5,6,0,6,2,4,3,0,21,EL
42ec696a,0,0,0,0,0,0,0,0,0,0,0,1,1,1,0,21,EL
437f2b00,8,4,1,4,3,1,7,6,10,0,10,2,10,1,0,21,EL
4383b0da,0,0,0,0,0,0,3,3,2,0,2,1,1,3,0,21,EL
4398b5cb,13,4,8,5,0,6,14,8,9,6,3,17,30,16,0,21,EL
43c004a8,5,3,3,0,2,1,11,10,8,0,8,3,8,2,0,21,EL
43f71e77,5,4,1,1,3,0,11,11,6,0,6,1,6,2,0,21,EL
4468ec10,2,2,1,0,1,2,2,0,0,0,0,0,2,0,0,21,EL
44781702,10,7,3,4,3,5,13,8,11,2,9,9,19,25,1,21,EL
44b49036,7,4,5,2,0,0,0,0,1,1,0,7,14,4,0,21,EL
45191c29,0,0,0,0,0,0,1,1,0,0,0,0,0,0,0,21,EL
452c3055,4,1,1,2,1,1,2,1,4,1,3,1,5,2,0,21,EL
4567a0b4,6,1,0,3,3,3,5,2,3,0,3,5,11,1,0,21,EL
45963054,1,1,0,0,1,0,0,0,0,0,0,1,2,2,0,21,EL
45e17712,6,1,1,4,1,5,6,1,7,0,7,6,12,12,0,21,EL
45f5aa2f,1,0,1,0,0,0,0,0,1,0,1,1,2,2,0,21,EL
46152b69,3,2,3,0,0,1,1,0,3,0,3,5,8,4,0,21,EL
469be117,9,7,5,3,1,3,5,2,3,1,2,1,10,3,0,21,EL
46e58246,19,9,18,1,0,12,19,7,5,0,5,8,27,6,0,21,EL
46fcf2fb,0,0,0,0,0,0,2,2,0,0,0,2,2,0,0,21,EL
47064058,0,0,0,0,0,0,1,1,0,0,0,1,1,2,0,21,EL
4737cebe,1,1,0,0,1,1,2,1,2,0,2,3,4,2,0,21,EL
474439fb,8,4,5,3,0,2,7,5,2,0,2,1,9,2,0,21,EL
4760b2f2,2,2,1,1,0,1,1,0,2,2,0,1,3,3,0,21,EL
47681787,0,0,0,0,0,0,0,0,0,0,0,0,0,0,0,21,EL
47a0b54d,8,5,3,4,1,7,10,3,2,1,1,3,11,8,0,21,EL
47a34c4f,1,1,1,0,0,1,3,2,2,1,1,4,5,2,0,21,EL
47c1458c,6,2,5,1,0,2,4,2,7,5,2,5,11,28,1,21,EL
47c7a40c,1,1,1,0,0,1,1,0,0,0,0,1,2,4,0,21,EL
47dc80f5,4,1,0,4,0,1,8,7,5,4,1,4,8,1,0,21,EL
481c9ece,4,3,3,0,1,2,7,5,5,0,5,8,12,8,0,21,EL
48a2b92a,4,2,0,1,3,0,8,8,6,3,3,6,10,5,0,21,EL
48a5a5d6,1,0,1,0,0,1,1,0,1,0,1,1,2,2,0,21,EL
48c81dd3,0,0,0,0,0,0,1,1,0,0,0,0,0,0,0,21,EL
492e9836,0,0,0,0,0,0,0,0,0,0,0,0,0,0,0,21,EL
49aa1724,4,3,2,1,1,2,5,3,0,0,0,4,8,6,0,21,EL
49e9d799,0,0,0,0,0,0,3,3,4,0,4,0,0,2,0,21,EL
4a1abff3,2,1,1,1,0,0,2,2,4,0,4,2,4,1,0,21,EL
4a56052c,7,6,5,2,0,4,7,3,6,3,3,7,14,16,0,21,EL
4a5a45c7,9,6,2,4,3,2,13,11,7,0,7,10,19,10,0,21,EL
4a97f4c2,5,1,0,4,1,2,12,10,6,0,6,2,7,2,0,21,EL
4a99131a,0,0,0,0,0,0,0,0,0,0,0,1,1,0,0,21,EL
4adc7b42,17,6,8,8,1,6,19,13,7,2,5,14,31,4,0,21,EL
4b3c863f,0,0,0,0,0,0,0,0,0,0,0,0,0,0,0,21,EL
4b3e1a38,3,1,3,0,0,2,2,0,1,1,0,1,4,3,0,21,EL
4b3f2936,1,1,0,1,0,1,1,0,0,0,0,0,1,0,0,21,EL
4b48d876,6,3,2,4,0,2,3,1,4,0,4,0,6,0,0,21,EL
4b803b3c,0,0,0,0,0,0,1,1,1,0,1,0,0,2,0,21,EL
4bce9c16,10,9,0,5,5,3,5,2,5,0,5,2,12,2,0,21,EL
4bd414c1,13,7,8,5,0,7,10,3,9,5,4,4,17,47,1,21,EL
4c07f0e8,6,4,4,1,1,2,11,9,5,1,4,9,15,5,0,21,EL
4c0a6a48,0,0,0,0,0,0,3,3,0,0,0,2,2,0,0,21,EL
4c184730,1,1,0,1,0,1,1,0,0,0,0,0,1,1,0,21,EL
4c1b67d6,5,2,4,0,1,3,5,2,6,0,6,5,10,9,0,21,EL
4c45cdc2,2,2,1,0,1,1,3,2,5,2,3,0,2,1,1,21,EL
4c5039bd,0,0,0,0,0,0,0,0,0,0,0,0,0,1,1,21,EL
4c5e78da,11,10,1,8,2,5,8,3,2,0,2,3,14,1,0,21,EL
4c6711e2,0,0,0,0,0,0,1,1,0,0,0,0,0,3,0,21,EL
4c700f46,9,4,7,2,0,4,6,2,7,5,2,12,21,11,1,21,EL
4c82730b,7,0,1,4,2,5,11,6,9,2,7,2,9,6,0,21,EL
4cb950ea,6,4,4,2,0,5,7,2,3,1,2,7,13,18,0,21,EL
4cd69919,4,3,4,0,0,1,7,6,0,0,0,3,7,2,0,21,EL
4cde5509,0,0,0,0,0,0,2,2,0,0,0,0,0,5,0,21,EL
4d6a842d,0,0,0,0,0,0,0,0,0,0,0,0,0,3,0,21,EL
4d77b365,6,3,1,2,3,2,6,4,7,0,7,0,6,2,0,21,EL
4d90ce8c,0,0,0,0,0,0,0,0,0,0,0,0,0,0,0,21,EL
4da9191b,15,8,6,9,0,10,15,5,7,0,7,15,30,9,0,21,EL
4dedd469,3,2,0,2,1,1,10,9,4,0,4,6,9,6,0,21,EL
4e204552,0,0,0,0,0,0,0,0,1,0,1,0,0,0,0,21,EL
4e2da7f7,1,1,0,0,1,1,3,2,2,1,1,4,5,5,0,21,EL
4e358a2d,5,3,5,0,0,5,6,1,2,1,1,11,16,12,1,21,EL
4e3f5992,3,0,0,2,1,2,3,1,0,0,0,1,4,0,0,21,EL
4f1e6a0b,7,4,3,1,3,3,6,3,3,0,3,5,12,1,0,21,EL
4f5a953e,1,0,1,0,0,0,2,2,1,1,0,2,3,4,0,21,EL
4fac8f81,7,3,5,2,0,1,3,2,1,1,0,3,10,14,0,21,EL
501055d8,1,0,0,1,0,1,3,2,0,0,0,0,1,0,0,21,EL
507c7bdf,15,6,4,7,4,8,27,19,8,0,8,5,20,12,0,21,EL
5083a734,22,9,6,10,6,10,22,12,23,1,22,11,33,6,0,21,EL
50c1ff86,8,3,2,5,1,4,8,4,1,1,0,4,12,3,0,21,EL
50ccf47d,2,1,1,1,0,2,4,2,5,1,4,8,10,3,0,21,EL
50cddd19,1,1,0,0,1,1,4,3,4,2,2,1,2,1,0,21,EL
50dc94ce,2,2,0,0,2,2,4,2,4,0,4,0,2,0,0,21,EL
5136940a,0,0,0,0,0,0,1,1,0,0,0,0,0,0,0,21,EL
518918ad,5,0,1,3,1,1,2,1,1,0,1,2,7,0,0,21,EL
518f2234,0,0,0,0,0,0,3,3,0,0,0,1,1,2,0,21,EL
51b41c5c,9,7,3,5,1,1,6,5,6,2,4,18,27,7,1,21,EL
520b18e0,0,0,0,0,0,0,0,0,0,0,0,0,0,0,0,21,EL
526541e5,8,2,5,3,0,2,4,2,9,3,6,4,12,15,0,21,EL
527f063d,7,3,0,6,1,0,3,3,2,0,2,3,10,1,0,21,EL
529f49ab,17,9,5,10,2,6,9,3,6,3,3,13,30,9,0,21,EL
52d7f819,3,0,1,1,1,1,7,6,9,2,7,8,11,16,0,21,EL
532e1e4f,3,2,1,2,0,1,1,0,8,8,0,5,8,17,0,21,EL
536cebe5,1,0,1,0,0,1,1,0,2,0,2,0,1,2,0,21,EL
53af52f3,0,0,0,0,0,0,1,1,0,0,0,0,0,1,1,21,EL
53ccc8ad,14,6,9,5,0,8,23,15,15,7,8,23,37,37,0,21,EL
53d93280,0,0,0,0,0,0,0,0,1,0,1,0,0,0,0,21,EL
540c9a17,6,5,0,6,0,3,10,7,4,1,3,2,8,4,0,21,EL
540ec57b,8,5,3,4,1,2,7,5,12,0,12,4,12,3,0,21,EL
54b4dc4e,10,6,3,6,1,2,7,5,5,1,4,6,16,3,0,21,EL
54bb5c3f,1,0,1,0,0,0,0,0,0,0,0,0,1,5,1,21,EL
54f5ce34,3,2,2,1,0,0,0,0,3,1,2,2,5,3,0,21,EL
5521f419,0,0,0,0,0,0,1,1,0,0,0,1,1,0,0,21,EL
555031bc,0,0,0,0,0,0,0,0,0,0,0,0,0,2,0,21,EL
555d5edd,3,2,0,2,1,2,9,7,1,0,1,4,7,3,0,21,EL
55a480e4,10,6,3,4,3,4,11,7,5,0,5,4,14,5,0,21,EL
55a88fd9,6,2,3,3,0,3,17,14,7,0,7,6,12,4,0,21,EL
55abe554,0,0,0,0,0,0,1,1,2,0,2,3,3,5,0,21,EL
55b93ae0,0,0,0,0,0,0,0,0,0,0,0,0,0,1,0,21,EL
55bd7d45,0,0,0,0,0,0,1,1,0,0,0,0,0,0,0,21,EL
55c95c3e,8,3,5,2,1,3,9,6,6,1,5,4,12,4,0,21,EL
561b8eb8,18,9,8,5,5,11,26,15,6,0,6,12,30,13,1,21,EL
5631b735,12,5,6,3,3,7,13,6,5,1,4,14,26,4,0,21,EL
56413b1f,1,1,0,0,1,1,5,4,2,0,2,0,1,1,0,21,EL
56901a62,0,0,0,0,0,0,1,1,0,0,0,0,0,2,2,21,EL
56ad2519,7,5,4,2,1,6,14,8,5,1,4,5,12,10,0,21,EL
56dd5e10,5,0,3,1,1,2,6,4,4,2,2,8,13,8,0,21,EL
56f6f826,15,10,11,4,0,10,12,2,10,4,6,12,27,43,0,21,EL
56f7a928,6,3,4,2,0,5,14,9,6,2,4,7,13,3,0,21,EL
5700824a,2,1,0,1,1,1,2,1,3,1,2,1,3,0,0,21,EL
57a0ea13,4,3,3,1,0,2,2,0,2,0,2,0,4,2,0,21,EL
57a46f3f,4,2,1,1,2,2,3,1,0,0,0,0,4,0,0,21,EL
57df4cea,10,5,3,6,1,3,10,7,9,4,5,8,18,9,0,21,EL
57e3f0c7,10,6,4,5,1,1,11,10,8,1,7,5,15,2,0,21,EL
58027adc,1,1,0,1,0,1,2,1,2,0,2,0,1,3,0,21,EL
580bcd18,5,3,3,2,0,4,8,4,1,1,0,7,12,5,0,21,EL
5845bdfa,0,0,0,0,0,0,0,0,1,0,1,0,0,1,0,21,EL
58df8bfe,1,1,0,1,0,0,0,0,1,1,0,0,1,2,0,21,EL
58eee997,5,4,2,2,1,2,5,3,4,0,4,0,5,6,0,21,EL
58f077c0,0,0,0,0,0,0,0,0,1,0,1,0,0,4,0,21,EL
595ccab1,0,0,0,0,0,0,1,1,0,0,0,0,0,2,0,21,EL
596cc50e,7,5,5,1,1,4,8,4,2,0,2,3,10,24,0,21,EL
59bf127b,11,4,7,2,2,4,10,6,4,1,3,12,23,6,0,21,EL
59fd245c,1,1,0,0,1,1,1,0,0,0,0,0,1,0,0,21,EL
5a48195c,0,0,0,0,0,0,0,0,0,0,0,0,0,1,0,21,EL
5a51caa1,0,0,0,0,0,0,0,0,1,0,1,0,0,0,0,21,EL
5a626448,4,3,1,3,0,2,3,1,6,0,6,3,7,1,0,21,EL
5a80aea3,4,3,2,1,1,2,12,10,2,0,2,16,20,3,0,21,EL
5a9dab86,0,0,0,0,0,0,1,1,0,0,0,2,2,0,0,21,EL
5aa53281,6,4,3,3,0,1,3,2,4,1,3,12,18,12,1,21,EL
5acc4a10,20,13,10,8,2,10,17,7,6,1,5,15,35,9,0,21,EL
5ad141cb,13,5,4,7,2,6,16,10,6,1,5,5,18,4,0,21,EL
5ad50391,15,8,9,4,2,4,13,9,16,2,14,19,34,22,0,21,EL
5b3d1a7a,3,3,0,3,0,2,5,3,6,2,4,6,9,7,0,21,EL
5b479568,1,1,0,0,1,0,1,1,0,0,0,0,1,1,0,21,EL
5b5c2228,13,9,8,4,1,4,9,5,6,1,5,14,27,9,0,21,EL
5bc43860,3,1,1,2,0,2,2,0,1,0,1,0,3,0,0,21,EL
5c0466ba,1,1,1,0,0,0,0,0,0,0,0,0,1,0,0,21,EL
5c2b4f07,10,7,2,5,3,6,8,2,4,0,4,8,18,8,1,21,EL
5c4f0f49,3,2,2,1,0,2,2,0,1,0,1,6,9,15,1,21,EL
5c6337cd,0,0,0,0,0,0,0,0,3,1,2,4,4,0,0,21,EL
5c7845f6,3,2,3,0,0,2,2,0,2,0,2,5,8,9,1,21,EL
5ca20b7a,7,5,4,1,2,2,2,0,2,1,1,3,10,5,1,21,EL
5caa62a7,1,0,0,1,0,1,4,3,1,0,1,3,4,0,0,21,EL
5cdddffa,14,9,8,4,2,6,7,1,3,0,3,1,15,1,1,21,EL
5ce0b5ba,3,3,1,2,0,1,5,4,1,0,1,1,4,4,0,21,EL
5ce91d9b,5,4,0,3,2,2,7,5,3,1,2,0,5,4,0,21,EL
5cec2c74,10,4,5,4,1,5,9,4,8,0,8,8,18,4,0,21,EL
5d4f7d61,3,1,0,0,3,2,4,2,3,1,2,1,4,6,0,21,EL
5d51b074,4,2,1,1,2,0,8,8,3,0,3,6,10,1,0,21,EL
5da33b33,3,3,0,2,1,1,4,3,1,0,1,0,3,0,0,21,EL
5db295be,19,10,3,13,3,9,19,10,8,0,8,6,25,3,0,21,EL
5db45ee5,2,1,1,1,0,1,2,1,0,0,0,1,3,0,0,21,EL
5e1028e5,1,0,0,1,0,0,1,1,1,0,1,0,1,1,0,21,EL
5e74d6c8,1,0,1,0,0,0,0,0,2,1,1,0,1,4,0,21,EL
5e861944,4,2,0,1,3,2,7,5,1,0,1,4,8,4,0,21,EL
5e8936be,0,0,0,0,0,0,0,0,0,0,0,0,0,2,1,21,EL
5eaf85b5,2,2,2,0,0,2,2,0,3,1,2,4,6,10,0,21,EL
5eb77bef,6,2,2,3,1,3,8,5,5,2,3,2,8,0,0,21,EL
5eebbfdf,8,3,2,4,2,4,10,6,5,0,5,8,16,4,0,21,EL
5f011e05,16,12,8,8,0,3,5,2,10,6,4,16,32,37,0,21,EL
5f06ae82,5,2,4,1,0,1,7,6,8,1,7,1,6,7,0,21,EL
5f3d00d1,6,4,2,4,0,1,9,8,6,1,5,1,7,3,0,21,EL
60097ff6,1,1,0,0,1,1,4,3,0,0,0,2,3,0,0,21,EL
601299e9,0,0,0,0,0,0,3,3,3,0,3,0,0,2,0,21,EL
603cb947,0,0,0,0,0,0,0,0,0,0,0,0,0,0,0,21,EL
605fe3e6,0,0,0,0,0,0,0,0,0,0,0,0,0,0,0,21,EL
60a6fe9c,0,0,0,0,0,0,0,0,0,0,0,0,0,0,0,21,EL
60c07b31,5,2,5,0,0,4,7,3,5,3,2,4,9,17,0,21,EL
60db2f9b,6,4,3,3,0,3,9,6,2,0,2,4,10,3,0,21,EL
611f4f60,4,1,3,1,0,3,3,0,2,0,2,3,7,1,0,21,EL
614c1695,2,0,0,1,1,2,4,2,1,0,1,1,3,0,0,21,EL
614f69aa,8,5,6,1,1,4,10,6,3,0,3,13,21,14,0,21,EL
61590953,4,1,1,3,0,2,5,3,5,0,5,8,12,12,1,21,EL
615c4d8f,7,3,2,5,0,4,8,4,0,0,0,1,8,1,0,21,EL
61db425b,0,0,0,0,0,0,1,1,0,0,0,0,0,1,0,21,EL
6200dc3c,2,1,1,1,0,2,3,1,4,0,4,0,2,0,0,21,EL
625c144a,0,0,0,0,0,0,0,0,0,0,0,1,1,9,1,21,EL
62d0dcc5,2,1,1,1,0,0,1,1,1,1,0,0,2,0,0,21,EL
62f94e47,2,1,0,2,0,2,2,0,0,0,0,0,2,0,0,21,EL
63458a96,3,1,3,0,0,1,5,4,2,1,1,4,7,4,0,21,EL
639ea276,0,0,0,0,0,0,0,0,0,0,0,0,0,0,0,21,EL
63f04c6c,18,12,9,8,1,8,18,10,12,2,10,14,32,12,1,21,EL
647cf7f1,3,1,2,1,0,0,6,6,3,0,3,3,6,4,0,21,EL
64e8ed6d,2,1,0,2,0,0,2,2,2,0,2,2,4,1,0,21,EL
653010fb,2,1,0,1,1,0,1,1,0,0,0,0,2,0,0,21,EL
6554bb97,6,2,3,1,2,4,6,2,3,1,2,5,11,0,0,21,EL
655d956b,2,1,2,0,0,2,4,2,0,0,0,0,2,1,0,21,EL
6583a8a9,7,5,3,4,0,4,8,4,0,0,0,0,7,3,0,21,EL
65ad4d98,7,4,5,2,0,5,7,2,11,6,5,9,16,31,0,21,EL
6603fed7,1,0,0,0,1,0,6,6,1,0,1,1,2,0,0,21,EL
660e71be,0,0,0,0,0,0,0,0,0,0,0,0,0,0,0,21,EL
66a7effe,5,3,0,4,1,2,3,1,4,0,4,3,8,8,0,21,EL
675b0427,3,3,2,1,0,0,4,4,4,2,2,8,11,9,0,21,EL
67669ce7,0,0,0,0,0,0,0,0,0,0,0,0,0,1,0,21,EL
6796e284,2,0,0,1,1,0,0,0,0,0,0,1,3,1,0,21,EL
67ac5bb8,3,0,2,1,0,2,7,5,5,4,1,9,12,28,0,21,EL
67f0703d,2,2,2,0,0,2,2,0,3,1,2,2,4,6,0,21,EL
6800f515,9,4,6,3,0,3,11,8,8,3,5,14,23,13,1,21,EL
68dc0dac,4,3,1,3,0,1,5,4,11,3,8,2,6,8,0,21,EL
691bef82,6,3,1,4,1,4,4,0,3,1,2,4,10,7,0,21,EL
692cd6de,2,0,2,0,0,0,2,2,10,2,8,8,10,18,0,21,EL
69374ff5,14,4,6,7,1,4,7,3,3,0,3,6,20,0,0,21,EL
6959bef9,4,2,3,1,0,2,4,2,1,0,1,1,5,0,0,21,EL
697dc00a,7,5,3,2,2,1,4,3,6,0,6,14,21,6,0,21,EL
6a2b9aee,1,0,1,0,0,0,1,1,0,0,0,0,1,1,0,21,EL
6a73afe7,0,0,0,0,0,0,0,0,0,0,0,0,0,0,0,21,EL
6a827d8e,5,3,4,0,1,2,4,2,3,2,1,4,9,4,0,21,EL
6a829019,4,2,1,3,0,1,8,7,6,1,5,8,12,9,0,21,EL
6aa3e78b,3,1,1,2,0,0,0,0,1,1,0,1,4,6,0,21,EL
6b074beb,2,2,0,0,2,0,0,0,3,0,3,0,2,0,0,21,EL
6b3e4b53,2,0,0,1,1,2,2,0,0,0,0,1,3,1,0,21,EL
6b47c5db,6,4,3,3,0,3,7,4,5,0,5,9,15,9,0,21,EL
6b4e77fe,0,0,0,0,0,0,0,0,0,0,0,0,0,0,0,21,EL
6b6c793c,4,4,1,2,1,2,6,4,4,0,4,3,7,2,0,21,EL
6b6cbca4,2,2,1,1,0,2,3,1,2,1,1,3,5,4,0,21,EL
6b88c810,3,1,0,2,1,2,4,2,2,0,2,0,3,1,0,21,EL
6b8cd7dd,5,4,0,3,2,3,3,0,11,2,9,5,10,12,0,21,EL
6b915aa1,1,1,0,1,0,0,1,1,4,0,4,3,4,3,0,21,EL
6b994195,15,7,11,4,0,11,15,4,18,10,8,11,26,46,2,21,EL
6c249ea7,3,2,1,2,0,2,6,4,2,0,2,5,8,5,0,21,EL
6c330f30,8,7,5,2,1,3,5,2,2,0,2,2,10,6,0,21,EL
6c7762c3,37,24,18,19,0,18,29,11,9,1,8,20,57,22,0,21,EL
6ca0b04a,0,0,0,0,0,0,0,0,0,0,0,2,2,1,1,21,EL
6cafd68d,9,7,3,6,0,5,7,2,3,2,1,9,18,10,0,21,EL
6cbf8d0d,0,0,0,0,0,0,4,4,2,0,2,3,3,3,0,21,EL
6ce46a59,0,0,0,0,0,0,0,0,0,0,0,0,0,2,0,21,EL
6d86d9cd,2,1,0,2,0,0,2,2,5,0,5,0,2,1,0,21,EL
6e36226f,1,0,0,1,0,1,2,1,0,0,0,0,1,0,0,21,EL
6e5497ca,4,2,1,2,1,1,2,1,4,0,4,1,5,1,1,21,EL
6ea23758,18,13,10,4,4,10,18,8,4,0,4,5,23,6,0,21,EL
6ec6fde0,12,9,6,6,0,8,11,3,4,0,4,2,14,7,0,21,EL
6f5f82c0,7,5,0,6,1,5,12,7,3,0,3,1,8,3,0,21,EL
6fa81fa5,0,0,0,0,0,0,0,0,0,0,0,0,0,0,0,21,EL
6fa87bf4,1,1,0,1,0,1,2,1,2,0,2,2,3,0,0,21,EL
6fd8a334,8,8,1,6,1,5,10,5,10,3,7,9,17,12,1,21,EL
6fe2aba3,0,0,0,0,0,0,1,1,0,0,0,0,0,0,0,21,EL
6fe5c35b,0,0,0,0,0,0,0,0,0,0,0,1,1,5,0,21,EL
701a15f5,4,4,1,3,0,0,0,0,0,0,0,0,4,0,0,21,EL
705f5269,0,0,0,0,0,0,0,0,0,0,0,2,2,1,0,21,EL
706a60e1,2,1,0,1,1,1,2,1,1,1,0,1,3,1,0,21,EL
70cb75ae,16,10,8,7,1,7,23,16,7,1,6,10,26,6,0,21,EL
70cf63ca,20,9,9,7,4,9,22,13,9,1,8,6,26,2,0,21,EL
7120a04d,2,0,1,0,1,0,4,4,1,0,1,1,3,0,0,21,EL
712dd708,10,8,6,3,1,5,8,3,5,2,3,10,20,14,0,21,EL
713c144a,7,3,4,2,1,2,8,6,4,0,4,2,9,1,0,21,EL
715e5b0e,4,4,1,2,1,2,7,5,0,0,0,2,6,0,0,21,EL
719384c1,8,6,2,5,1,3,11,8,4,1,3,10,18,3,0,21,EL
7220ffd7,4,3,2,1,1,0,4,4,2,0,2,2,6,4,0,21,EL
7272a72a,2,1,0,2,0,1,1,0,6,2,4,5,7,4,0,21,EL
73000a79,7,4,4,2,1,3,11,8,0,0,0,2,9,3,0,21,EL
7314bba4,3,2,3,0,0,2,3,1,3,2,1,7,10,19,0,21,EL
731bf16a,0,0,0,0,0,0,0,0,0,0,0,0,0,2,0,21,EL
734b6a70,3,2,2,1,0,2,8,6,1,0,1,3,6,7,0,21,EL
736157b7,10,6,6,4,0,3,7,4,5,1,4,6,16,10,0,21,EL
73affbb6,0,0,0,0,0,0,0,0,0,0,0,0,0,1,0,21,EL
73ddc40c,0,0,0,0,0,0,0,0,0,0,0,1,1,3,0,21,EL
740a0e28,9,7,5,4,0,3,7,4,3,1,2,2,11,9,0,21,EL
741418c3,5,2,2,3,0,2,9,7,5,0,5,5,10,4,0,21,EL
742a4995,10,5,6,2,2,4,9,5,10,2,8,6,16,4,0,21,EL
742ea558,0,0,0,0,0,0,0,0,0,0,0,0,0,0,0,21,EL
74510b8f,1,1,1,0,0,1,2,1,3,0,3,1,2,0,0,21,EL
7460ca0d,15,6,7,7,1,6,15,9,10,5,5,13,28,13,0,21,EL
746b64a7,8,5,7,1,0,5,8,3,11,10,1,17,25,42,1,21,EL
7483d9f9,0,0,0,0,0,0,0,0,1,0,1,1,1,3,0,21,EL
74f2e748,6,3,3,3,0,4,5,1,6,1,5,7,13,10,0,21,EL
7566531d,20,14,12,7,1,13,22,9,12,4,8,17,37,5,0,21,EL
75a72a99,2,2,1,0,1,0,1,1,3,0,3,1,3,2,0,21,EL
75dd7eeb,3,0,2,1,0,2,3,1,0,0,0,1,4,1,0,21,EL
76847418,2,1,0,2,0,1,1,0,0,0,0,2,4,0,0,21,EL
76d5857d,2,2,0,2,0,2,5,3,2,0,2,2,4,5,0,21,EL
76d679c7,4,2,3,1,0,0,2,2,2,1,1,5,9,6,0,21,EL
76fa5f80,0,0,0,0,0,0,0,0,0,0,0,1,1,1,0,21,EL
770d7eb8,8,3,6,1,1,4,5,1,2,1,1,2,10,7,0,21,EL
77bf714c,10,9,1,6,3,2,5,3,9,2,7,7,17,6,0,21,EL
781cff03,4,2,1,3,0,2,5,3,2,0,2,0,4,2,0,21,EL
786f179e,6,5,4,2,0,4,13,9,2,1,1,2,8,2,0,21,EL
78a3c38e,3,1,3,0,0,3,7,4,7,5,2,6,9,31,1,21,EL
78e68b4d,12,9,6,3,3,5,11,6,8,6,2,7,19,38,0,21,EL
78f21137,12,8,6,4,2,8,13,5,2,1,1,6,18,7,0,21,EL
79083382,10,9,6,4,0,5,11,6,11,3,8,6,16,9,0,21,EL
79135368,13,8,8,4,1,4,16,12,2,0,2,7,20,3,0,21,EL
79194648,1,1,1,0,0,0,1,1,0,0,0,1,2,0,0,21,EL
792c7b94,5,4,4,1,0,2,6,4,4,0,4,3,8,5,0,21,EL
79300479,7,3,1,6,0,2,4,2,1,0,1,4,11,0,1,21,EL
79370f8c,5,4,2,3,0,5,10,5,1,0,1,3,8,0,0,21,EL
7952d0c2,4,3,2,1,1,4,14,10,2,0,2,4,8,3,0,21,EL
79c536d7,0,0,0,0,0,0,1,1,0,0,0,0,0,1,0,21,EL
79c90e45,4,2,0,2,2,3,3,0,1,0,1,2,6,3,0,21,EL
7a2cf111,8,6,3,5,0,5,13,8,3,1,2,7,15,10,0,21,EL
7a4cea18,2,0,0,1,1,1,1,0,0,0,0,1,3,0,0,21,EL
7b075c75,0,0,0,0,0,0,0,0,0,0,0,2,2,4,0,21,EL
7b41edb2,3,2,1,2,0,1,9,8,4,3,1,8,11,4,1,21,EL
7b57c56a,14,8,7,5,2,8,30,22,13,4,9,13,27,6,0,21,EL
7ba6d84e,0,0,0,0,0,0,0,0,0,0,0,1,1,3,0,21,EL
7bc34048,0,0,0,0,0,0,1,1,2,1,1,5,5,14,0,21,EL
7be09c86,0,0,0,0,0,0,2,2,1,0,1,0,0,3,0,21,EL
7bf8ad6c,1,0,0,1,0,0,3,3,1,1,0,5,6,0,0,21,EL
7c1a0c67,1,1,1,0,0,0,0,0,4,0,4,3,4,3,0,21,EL
7c2965bb,6,3,1,3,2,1,3,2,3,0,3,2,8,1,0,21,EL
7c4cb72d,8,6,6,2,0,3,8,5,2,1,1,6,14,5,0,21,EL
7c7fdb0f,9,3,2,6,1,5,16,11,7,0,7,8,17,5,0,21,EL
7c85e03f,7,5,5,1,1,6,9,3,4,4,0,2,9,11,0,21,EL
7c9fa389,13,4,5,4,4,5,10,5,8,0,8,6,19,5,0,21,EL
7cb9de24,4,1,3,1,0,2,5,3,11,7,4,17,21,23,1,21,EL
7cd78926,9,7,7,2,0,3,6,3,4,0,4,9,18,8,0,21,EL
7d2d3329,8,5,2,6,0,3,6,3,10,2,8,12,20,3,0,21,EL
7d9397f8,3,2,0,1,2,1,3,2,5,0,5,4,7,3,0,21,EL
7dc7187e,0,0,0,0,0,0,0,0,1,1,0,0,0,0,0,21,EL
7e1c86f1,1,0,0,1,0,1,3,2,0,0,0,2,3,5,0,21,EL
7e40455a,6,4,4,2,0,4,6,2,10,5,5,14,20,15,0,21,EL
7e56d3db,10,2,7,2,1,5,11,6,10,1,9,6,16,17,0,21,EL
7ebfac0f,2,1,0,2,0,0,8,8,1,0,1,4,6,1,0,21,EL
7ec1955f,6,3,4,2,0,3,4,1,1,0,1,8,14,6,0,21,EL
7ecc9dee,7,5,3,3,1,4,6,2,4,2,2,2,9,3,1,21,EL
7edfbb8a,10,6,9,1,0,4,6,2,7,6,1,3,13,4,0,21,EL
7ef972c3,1,1,1,0,0,1,3,2,1,1,0,4,5,4,0,21,EL
7f40333d,0,0,0,0,0,0,0,0,0,0,0,1,1,1,1,21,EL
7f609bfc,5,3,2,3,0,3,7,4,5,0,5,2,7,2,0,21,EL
7f63620c,2,2,2,0,0,2,2,0,0,0,0,2,4,2,0,21,EL
7f73bdf4,15,14,4,8,3,2,6,4,5,1,4,6,21,6,0,21,EL
801831fe,2,2,2,0,0,1,2,1,1,0,1,3,5,2,0,21,EL
8023bcab,4,3,1,1,2,2,6,4,0,0,0,2,6,0,0,21,EL
808d48f3,8,7,2,5,1,7,9,2,1,0,1,9,17,6,0,21,EL
808df563,1,1,0,1,0,0,0,0,1,0,1,1,2,3,0,21,EL
80c31c97,2,2,1,1,0,1,1,0,1,1,0,0,2,10,1,21,EL
80f36c88,8,4,0,4,4,1,9,8,8,0,8,10,18,4,0,21,EL
816bdfdd,5,3,2,2,1,1,7,6,4,4,0,3,8,8,0,21,EL
817c6964,11,6,7,2,2,4,11,7,9,1,8,10,21,13,1,21,EL
819aa8e7,0,0,0,0,0,0,1,1,2,0,2,2,2,0,0,21,EL
81d5c497,1,1,0,0,1,0,1,1,2,0,2,1,2,1,0,21,EL
81f0781e,8,5,3,2,3,3,15,12,9,0,9,4,12,4,0,21,EL
821770dd,7,4,2,1,4,1,8,7,1,0,1,3,10,1,0,21,EL
82220b03,12,8,6,5,1,6,11,5,1,0,1,3,15,3,0,21,EL
826e8b63,16,9,6,8,2,6,12,6,3,0,3,7,23,3,0,21,EL
829ae874,6,4,5,1,0,4,10,6,7,1,6,5,11,16,0,21,EL
82a8d4cc,0,0,0,0,0,0,0,0,1,0,1,3,3,4,0,21,EL
82b1198a,0,0,0,0,0,0,0,0,0,0,0,0,0,0,0,21,EL
82e9b1bb,8,5,5,3,0,3,5,2,6,4,2,7,15,18,1,21,EL
82efe6fa,20,5,16,3,1,10,14,4,6,3,3,13,33,29,1,21,EL
83300259,13,5,11,1,1,8,16,8,5,0,5,13,26,12,0,21,EL
834d0be5,1,0,0,1,0,1,1,0,3,0,3,0,1,1,0,21,EL
83534f30,3,2,0,3,0,1,4,3,1,1,0,2,5,2,0,21,EL
839c14e1,6,3,3,2,1,4,7,3,8,2,6,4,10,13,0,21,EL
84a42351,1,0,0,1,0,0,1,1,0,0,0,9,10,3,0,21,EL
84e5adcd,0,0,0,0,0,0,6,6,7,0,7,2,2,4,0,21,EL
852184c3,9,5,5,3,1,5,18,13,9,0,9,7,16,5,0,21,EL
852351df,7,5,3,4,0,3,13,10,8,1,7,15,22,20,0,21,EL
8530dd74,10,4,4,6,0,8,14,6,11,1,10,4,14,5,1,21,EL
85686f86,0,0,0,0,0,0,0,0,0,0,0,0,0,1,0,21,EL
857c7688,3,1,1,1,1,1,2,1,0,0,0,1,4,2,0,21,EL
85c76f0a,0,0,0,0,0,0,0,0,0,0,0,0,0,0,0,21,EL
85f7d1be,7,5,3,2,2,4,6,2,4,2,2,10,17,7,0,21,EL
8614496d,4,2,4,0,0,1,2,1,13,8,5,6,10,21,3,21,EL
864c362f,0,0,0,0,0,0,0,0,0,0,0,0,0,1,0,21,EL
86695068,8,2,1,6,1,1,1,0,8,0,8,4,12,1,0,21,EL
867239d3,12,5,6,3,3,6,10,4,6,0,6,8,20,3,0,21,EL
86878265,6,3,2,3,1,1,5,4,2,0,2,3,9,0,0,21,EL
86b3d4cc,5,3,4,1,0,1,1,0,2,2,0,3,8,19,0,21,EL
86b575a7,3,1,0,0,3,1,7,6,4,0,4,0,3,0,0,21,EL
871961e8,6,3,4,2,0,0,7,7,3,0,3,4,10,0,0,21,EL
878f0921,0,0,0,0,0,0,1,1,1,0,1,1,1,2,0,21,EL
881fb89d,1,1,1,0,0,1,4,3,2,0,2,0,1,1,0,21,EL
886f9aac,4,2,2,2,0,3,3,0,1,0,1,1,5,1,0,21,EL
88968486,3,1,1,2,0,1,1,0,3,1,2,8,11,11,0,21,EL
88a9ea33,13,9,8,4,1,6,9,3,2,0,2,4,17,1,0,21,EL
88c89891,0,0,0,0,0,0,0,0,1,0,1,0,0,0,0,21,EL
8960cf3d,1,1,1,0,0,1,4,3,3,0,3,4,5,6,0,21,EL
89b2c8a9,1,1,0,1,0,1,5,4,2,0,2,3,4,0,0,21,EL
89c63f8c,2,1,0,2,0,0,0,0,4,1,3,12,14,22,0,21,EL
89cbc961,5,3,3,1,1,1,2,1,1,0,1,8,13,13,0,21,EL
8a2248b4,0,0,0,0,0,0,0,0,1,0,1,0,0,0,0,21,EL
8a6e0e81,8,4,4,4,0,3,11,8,9,0,9,4,12,2,0,21,EL
8a7a5ad7,9,2,4,5,0,6,10,4,1,0,1,6,15,1,0,21,EL
8b04d6c1,6,2,2,2,2,3,6,3,3,0,3,8,14,4,0,21,EL
8b0b02c9,0,0,0,0,0,0,1,1,0,0,0,1,1,0,0,21,EL
8b3ab7ad,10,7,5,4,1,6,10,4,7,4,3,14,24,9,0,21,EL
8b3d765f,0,0,0,0,0,0,0,0,0,0,0,0,0,1,1,21,EL
8b529245,5,2,0,0,5,1,6,5,5,0,5,0,5,1,0,21,EL
8b788c01,1,1,1,0,0,0,0,0,1,0,1,0,1,4,0,21,EL
8b8a56ce,14,10,7,7,0,8,12,4,2,1,1,14,28,21,1,21,EL
8b929ec2,6,4,4,2,0,5,8,3,13,12,1,19,25,57,0,21,EL
8b92fc98,1,0,0,1,0,0,1,1,0,0,0,0,1,0,0,21,EL
8b9b8e43,16,6,11,4,1,8,13,5,3,1,2,14,30,16,0,21,EL
8b9ebd03,1,0,0,0,1,1,4,3,4,0,4,1,2,3,0,21,EL
8bbe2df5,7,2,3,1,3,2,6,4,6,0,6,10,17,5,0,21,EL
8c3c640c,3,3,1,2,0,1,5,4,6,0,6,4,7,2,0,21,EL
8c90fd7a,3,2,0,3,0,0,1,1,1,0,1,0,3,1,0,21,EL
8c955557,0,0,0,0,0,0,0,0,2,0,2,0,0,0,0,21,EL
8ca0559d,6,4,1,5,0,3,7,4,3,1,2,0,6,3,0,21,EL
8ca850b8,11,10,5,5,1,4,10,6,5,1,4,7,18,4,0,21,EL
8cc9ef90,2,1,0,1,1,2,3,1,0,0,0,4,6,1,0,21,EL
8cd7091d,9,2,6,3,0,4,9,5,8,3,5,12,21,11,0,21,EL
8ce30c57,4,3,1,0,3,0,4,4,4,0,4,2,6,1,0,21,EL
8d47bb39,11,4,5,6,0,6,9,3,8,1,7,10,21,14,0,21,EL
8d711616,1,0,1,0,0,1,3,2,1,0,1,0,1,2,0,21,EL
8d7fe72a,6,3,4,1,1,3,9,6,1,0,1,3,9,2,0,21,EL
8d965034,3,1,1,1,1,0,7,7,2,0,2,2,5,1,0,21,EL
8dfed6e9,1,0,0,0,1,1,3,2,1,0,1,0,1,3,0,21,EL
8e16dd48,0,0,0,0,0,0,0,0,0,0,0,0,0,0,0,21,EL
8e371868,2,1,2,0,0,1,3,2,5,3,2,6,8,5,1,21,EL
8e48dc61,8,4,1,7,0,0,5,5,1,0,1,6,14,1,0,21,EL
8e697a8f,2,1,1,0,1,0,3,3,2,0,2,0,2,0,0,21,EL
8e92be30,2,1,0,2,0,0,1,1,5,1,4,0,2,2,0,21,EL
8ec4c2f7,16,12,13,2,1,9,11,2,5,0,5,5,21,15,1,21,EL
8ee7161d,4,0,4,0,0,2,4,2,3,3,0,4,8,15,0,21,EL
8eec784d,5,3,1,3,1,1,4,3,4,1,3,1,6,1,0,21,EL
8f1d4155,0,0,0,0,0,0,1,1,0,0,0,0,0,2,0,21,EL
8f21b7bd,12,8,6,3,3,7,11,4,5,0,5,3,15,10,1,21,EL
8f5bfaac,4,2,2,2,0,2,6,4,1,0,1,0,4,1,0,21,EL
8f62b6ee,1,1,1,0,0,1,1,0,0,0,0,0,1,0,0,21,EL
8f68aa41,6,4,5,1,0,3,3,0,8,4,4,9,15,28,1,21,EL
8f7e6783,3,1,1,2,0,0,7,7,2,1,1,3,6,5,0,21,EL
8fa8f8d2,0,0,0,0,0,0,0,0,0,0,0,0,0,0,0,21,EL
8fef5412,4,1,3,1,0,3,3,0,2,1,1,3,7,6,0,21,EL
8ff4872e,3,2,1,2,0,2,3,1,2,0,2,17,20,13,0,21,EL
903b6e8b,1,0,1,0,0,1,1,0,0,0,0,0,1,3,0,21,EL
906baf89,3,2,2,1,0,2,4,2,1,0,1,4,7,2,0,21,EL
908eea67,10,8,6,4,0,7,9,2,1,1,0,8,18,14,0,21,EL
90d7dda6,8,3,1,7,0,4,12,8,6,3,3,9,17,8,0,21,EL
90f87966,2,1,2,0,0,2,6,4,6,3,3,13,15,18,0,21,EL
913329c8,0,0,0,0,0,0,0,0,0,0,0,0,0,0,0,21,EL
9139bb12,1,0,0,1,0,1,4,3,1,0,1,2,3,0,0,21,EL
91f2da4c,0,0,0,0,0,0,1,1,0,0,0,0,0,3,0,21,EL
91f8302e,18,10,7,10,1,10,29,19,10,0,10,11,29,3,0,21,EL
92560306,4,1,1,2,1,2,4,2,3,0,3,4,8,4,0,21,EL
926314b9,4,3,3,1,0,2,3,1,2,0,2,0,4,2,1,21,EL
92b17b2a,7,3,3,2,2,5,6,1,4,1,3,3,10,1,0,21,EL
92e7e919,2,2,1,1,0,0,4,4,3,0,3,0,2,0,0,21,EL
92ffb8f9,14,7,8,4,2,8,21,13,6,2,4,5,19,3,0,21,EL
93090f69,6,3,2,2,2,2,5,3,8,7,1,8,14,22,0,21,EL
9321b8ed,0,0,0,0,0,0,0,0,0,0,0,0,0,0,1,21,EL
93a50d2c,4,3,2,2,0,1,2,1,5,2,3,8,12,9,0,21,EL
93b95f72,1,0,1,0,0,1,2,1,0,0,0,0,1,3,1,21,EL
93db8be8,0,0,0,0,0,0,0,0,0,0,0,0,0,1,1,21,EL
9413b19f,1,0,1,0,0,1,1,0,0,0,0,0,1,3,0,21,EL
94d260aa,0,0,0,0,0,0,3,3,3,3,0,4,4,14,0,21,EL
94f8e060,0,0,0,0,0,0,0,0,1,0,1,4,4,2,0,21,EL
950ff24d,0,0,0,0,0,0,1,1,0,0,0,0,0,0,0,21,EL
951f1739,1,1,0,1,0,0,6,6,7,0,7,3,4,0,0,21,EL
957e00ad,5,4,2,3,0,2,4,2,3,0,3,3,8,3,0,21,EL
95a24690,5,4,0,4,1,2,6,4,6,1,5,5,10,0,0,21,EL
95a4435e,0,0,0,0,0,0,0,0,0,0,0,0,0,0,0,21,EL
95efdac2,7,4,4,3,0,0,7,7,4,0,4,8,15,2,0,21,EL
96094cbc,6,1,1,3,2,3,6,3,3,0,3,8,14,0,0,21,EL
963829d0,23,11,10,8,5,9,27,18,9,2,7,5,28,8,0,21,EL
965a81e2,2,2,1,1,0,0,2,2,2,0,2,2,4,0,0,21,EL
973a70bc,0,0,0,0,0,0,3,3,5,0,5,0,0,1,0,21,EL
975eda74,1,1,0,1,0,1,3,2,3,1,2,3,4,1,0,21,EL
9778d8dd,2,2,2,0,0,1,3,2,2,1,1,2,4,4,0,21,EL
977ffc24,1,0,0,1,0,0,1,1,0,0,0,0,1,0,0,21,EL
979d0640,0,0,0,0,0,0,0,0,0,0,0,0,0,1,0,21,EL
97b87472,10,5,8,2,0,6,12,6,9,6,3,13,23,18,0,21,EL
97e2aa67,4,1,1,1,2,2,7,5,4,0,4,1,5,0,0,21,EL
981e1bee,4,1,0,3,1,2,5,3,5,0,5,4,8,3,0,21,EL
99127249,6,1,2,3,1,4,12,8,5,0,5,2,8,0,0,21,EL
9a34c46d,3,2,2,1,0,2,3,1,1,0,1,4,7,3,0,21,EL
9a64e67e,6,4,5,1,0,4,10,6,2,1,1,3,9,18,0,21,EL
9b92e48d,0,0,0,0,0,0,0,0,0,0,0,0,0,0,0,21,EL
9bf914b4,7,4,2,3,2,2,8,6,5,0,5,7,14,1,0,21,EL
9c2e7413,0,0,0,0,0,0,0,0,0,0,0,0,0,0,0,21,EL
9c94165b,8,3,5,3,0,5,7,2,8,0,8,3,11,9,0,21,EL
9cfa4d3f,0,0,0,0,0,0,0,0,2,0,2,0,0,0,0,21,EL
9d115f7a,4,3,0,3,1,1,4,3,3,1,2,0,4,2,0,21,EL
9d21da85,14,8,8,5,1,8,14,6,3,0,3,13,27,14,0,21,EL
9d40ca9c,5,4,2,2,1,3,4,1,7,4,3,15,20,18,0,21,EL
9d66fbe3,2,0,0,2,0,2,5,3,2,1,1,1,3,9,0,21,EL
9d689a5b,6,2,1,4,1,1,6,5,4,0,4,2,8,3,0,21,EL
9d739099,1,0,1,0,0,0,1,1,5,0,5,0,1,1,0,21,EL
9d7d5334,0,0,0,0,0,0,3,3,1,0,1,0,0,0,0,21,EL
9dbb75ca,4,2,0,3,1,2,7,5,1,0,1,0,4,3,0,21,EL
9dc96f10,5,4,2,2,1,3,3,0,1,0,1,3,8,1,0,21,EL
9e49c320,2,0,0,2,0,0,1,1,1,0,1,0,2,2,0,21,EL
9e525177,19,9,10,6,3,7,13,6,9,1,8,13,32,28,0,21,EL
9ef884b1,0,0,0,0,0,0,1,1,0,0,0,0,0,0,0,21,EL
9efa1d25,7,4,1,5,1,1,16,15,6,0,6,5,12,3,0,21,EL
9f0ea33f,0,0,0,0,0,0,1,1,0,0,0,0,0,0,0,21,EL
9f333379,3,2,2,0,1,1,2,1,4,0,4,4,7,1,0,21,EL
9f6325f9,8,4,3,4,1,7,13,6,8,4,4,6,14,15,0,21,EL
9f84febe,7,1,2,4,1,3,7,4,2,0,2,12,19,5,0,21,EL
9fc2531b,0,0,0,0,0,0,0,0,0,0,0,0,0,0,0,21,EL
9ff78253,3,1,0,1,2,1,4,3,1,0,1,2,5,0,1,21,EL
a0284e8e,9,7,8,1,0,4,6,2,11,7,4,3,12,12,0,21,EL
a07cac95,9,5,6,2,1,6,11,5,7,3,4,16,25,11,0,21,EL
a0b730dc,4,4,0,2,2,1,2,1,6,0,6,1,5,1,0,21,EL
a11c995d,1,0,0,1,0,1,1,0,0,0,0,1,2,0,0,21,EL
a1232f4e,5,5,3,2,0,2,3,1,6,2,4,7,12,19,1,21,EL
a1d5bd30,5,4,0,3,2,4,7,3,11,1,10,1,6,1,0,21,EL
a26fb8aa,10,6,2,7,1,8,17,9,7,3,4,6,16,23,0,21,EL
a2768a3a,0,0,0,0,0,0,0,0,0,0,0,0,0,0,0,21,EL
a2950e2d,3,2,2,1,0,0,5,5,1,0,1,3,6,1,0,21,EL
a29b1131,3,1,1,1,1,3,5,2,3,0,3,0,3,0,0,21,EL
a29e5244,9,5,5,2,2,1,2,1,0,0,0,1,10,1,0,21,EL
a2b0d521,2,0,2,0,0,2,5,3,1,0,1,2,4,0,0,21,EL
a2f2d806,1,0,1,0,0,0,0,0,2,0,2,0,1,2,0,21,EL
a31f54ca,6,3,4,1,1,5,10,5,7,0,7,2,8,11,0,21,EL
a36524bf,3,3,3,0,0,1,1,0,1,0,1,0,3,5,0,21,EL
a372a9f2,5,3,2,1,2,3,11,8,5,2,3,2,7,10,0,21,EL
a39b9ef6,3,2,1,1,1,2,8,6,3,0,3,5,8,6,0,21,EL
a3b03921,5,3,1,2,2,2,12,10,11,0,11,2,7,2,0,21,EL
a40819d9,13,8,5,6,2,4,6,2,3,2,1,10,23,16,0,21,EL
a45eac1f,1,1,0,1,0,1,3,2,2,0,2,0,1,3,0,21,EL
a469d983,0,0,0,0,0,0,0,0,0,0,0,0,0,2,0,21,EL
a4851d9e,3,2,2,1,0,2,2,0,2,1,1,8,11,6,0,21,EL
a5142492,1,1,1,0,0,1,2,1,0,0,0,0,1,0,0,21,EL
a5296e55,0,0,0,0,0,0,1,1,1,0,1,0,0,2,0,21,EL
a53649b7,5,3,2,1,2,0,1,1,5,0,5,3,8,0,0,21,EL
a53b661f,1,1,0,0,1,0,3,3,1,0,1,0,1,2,0,21,EL
a583c8c0,5,5,1,1,3,1,10,9,10,1,9,5,10,2,0,21,EL
a58bb1e1,11,4,3,3,5,3,6,3,5,0,5,3,14,3,0,21,EL
a5e96539,0,0,0,0,0,0,0,0,0,0,0,0,0,0,0,21,EL
a62c16d0,2,1,0,1,1,1,3,2,0,0,0,0,2,7,0,21,EL
a634b9d2,6,5,3,3,0,1,2,1,2,0,2,2,8,5,0,21,EL
a63a995f,18,9,12,5,1,8,19,11,14,8,6,27,45,30,0,21,EL
a63c8107,1,0,0,1,0,0,0,0,2,2,0,0,1,6,0,21,EL
a65c844b,5,3,2,2,1,2,6,4,2,1,1,3,8,1,0,21,EL
a67a09fb,1,0,1,0,0,1,4,3,6,1,5,5,6,8,0,21,EL
a6951bf8,7,2,4,1,2,3,9,6,6,1,5,4,11,8,0,21,EL
a69e4806,5,5,3,2,0,0,3,3,5,0,5,3,8,2,0,21,EL
a7220785,11,7,8,3,0,5,9,4,5,2,3,2,13,0,0,21,EL
a72c139d,1,0,1,0,0,0,0,0,2,2,0,3,4,6,0,21,EL
a73c8f95,15,7,11,3,1,13,17,4,2,2,0,3,18,8,0,21,EL
a74ea18d,2,1,2,0,0,1,1,0,1,0,1,0,2,1,0,21,EL
a793f5a8,0,0,0,0,0,0,1,1,0,0,0,0,0,0,0,21,EL
a7a9d95a,4,3,0,4,0,2,5,3,2,0,2,2,6,2,0,21,EL
a7dbd292,5,3,0,3,2,2,5,3,0,0,0,7,12,0,0,21,EL
a81ed730,0,0,0,0,0,0,3,3,0,0,0,1,1,2,0,21,EL
a8327abd,1,0,1,0,0,0,0,0,4,0,4,4,5,0,0,21,EL
a8797cf1,3,1,2,1,0,2,4,2,1,0,1,3,6,2,0,21,EL
a8b8af8d,1,1,1,0,0,0,1,1,0,0,0,1,2,2,0,21,EL
a8c0acb7,11,7,9,1,1,8,10,2,6,3,3,8,19,16,0,21,EL
a8c62306,0,0,0,0,0,0,1,1,0,0,0,0,0,1,0,21,EL
a8ee54ad,30,19,13,14,3,12,28,16,18,2,16,17,47,16,0,21,EL
a8f21b9f,6,4,1,5,0,1,9,8,8,0,8,3,9,2,0,21,EL
a8f41212,2,1,1,1,0,1,5,4,4,1,3,0,2,2,0,21,EL
a9a3b55d,0,0,0,0,0,0,0,0,0,0,0,0,0,4,0,21,EL
a9be27f2,3,2,2,0,1,1,4,3,3,1,2,7,10,5,0,21,EL
aa04bee3,1,0,1,0,0,1,7,6,2,0,2,0,1,0,0,21,EL
aa34ed38,0,0,0,0,0,0,0,0,0,0,0,1,1,0,0,21,EL
aa436c56,1,0,1,0,0,0,0,0,2,1,1,0,1,4,0,21,EL
aa54ec6f,6,3,3,3,0,5,6,1,3,2,1,5,11,13,0,21,EL
aa5859cb,0,0,0,0,0,0,0,0,0,0,0,0,0,0,0,21,EL
aa8e289e,3,2,0,1,2,0,3,3,3,0,3,5,8,0,0,21,EL
aad56ca3,4,3,0,1,3,2,4,2,7,1,6,8,12,0,0,21,EL
aad9c3f3,3,1,0,2,1,1,6,5,1,0,1,1,4,1,0,21,EL
ab6928f2,6,3,1,5,0,3,3,0,1,0,1,6,12,2,0,21,EL
abe66106,10,7,3,6,1,2,8,6,11,1,10,2,12,0,0,21,EL
ac290817,1,0,0,1,0,1,5,4,0,0,0,2,3,0,0,21,EL
ac861941,3,3,1,2,0,2,3,1,9,6,3,6,9,10,0,21,EL
acf7e795,9,5,7,2,0,5,8,3,10,9,1,19,28,27,1,21,EL
ad1ffcfd,3,0,1,1,1,1,8,7,3,0,3,2,5,5,0,21,EL
ad3389d5,0,0,0,0,0,0,1,1,0,0,0,0,0,2,1,21,EL
ade993b9,11,9,3,7,1,5,20,15,11,2,9,7,18,6,0,21,EL
ade9a05f,3,2,2,1,0,1,2,1,1,0,1,2,5,3,0,21,EL
aded8e6f,5,2,1,4,0,3,8,5,4,1,3,7,12,4,0,21,EL
adfc4cc1,2,2,0,0,2,0,1,1,0,0,0,0,2,1,0,21,EL
ae3e6d85,13,9,5,4,4,7,15,8,12,0,12,7,20,6,0,21,EL
ae59b359,8,5,3,5,0,3,6,3,4,1,3,6,14,2,0,21,EL
aeed5c06,2,0,1,1,0,2,8,6,4,0,4,5,7,1,0,21,EL
af50141d,5,1,1,2,2,2,5,3,0,0,0,2,7,3,0,21,EL
af7e69d1,10,6,6,3,1,6,9,3,10,6,4,8,18,16,0,21,EL
af859ca4,2,1,1,1,0,1,7,6,1,0,1,6,8,5,0,21,EL
afa0d4e0,0,0,0,0,0,0,0,0,0,0,0,1,1,3,0,21,EL
afaafed3,1,0,0,1,0,0,1,1,0,0,0,0,1,0,0,21,EL
afbf187b,3,2,2,1,0,0,2,2,3,1,2,2,5,8,0,21,EL
afff46e6,0,0,0,0,0,0,0,0,0,0,0,0,0,2,0,21,EL
b004076a,7,6,3,4,0,1,5,4,6,0,6,9,16,7,0,21,EL
b0151137,3,2,2,1,0,2,7,5,1,1,0,3,6,2,0,21,EL
b036b4e2,1,1,1,0,0,1,2,1,1,0,1,1,2,1,0,21,EL
b056e3da,0,0,0,0,0,0,0,0,0,0,0,0,0,0,0,21,EL
b1313ec4,18,10,8,7,3,14,25,11,9,0,9,11,29,9,0,21,EL
b1cbc666,6,4,0,5,1,2,5,3,6,1,5,2,8,5,0,21,EL
b1dae700,2,1,2,0,0,2,2,0,0,0,0,0,2,0,0,21,EL
b1f4086c,7,4,3,4,0,6,7,1,3,0,3,5,12,10,0,21,EL
b20f5a66,3,2,3,0,0,0,1,1,6,3,3,10,13,16,0,21,EL
b229aa13,0,0,0,0,0,0,0,0,0,0,0,0,0,0,0,21,EL
b2336681,4,1,2,2,0,0,3,3,3,1,2,3,7,5,0,21,EL
b2561711,1,0,1,0,0,1,2,1,1,0,1,0,1,0,0,21,EL
b28c32d3,2,1,1,1,0,1,5,4,3,0,3,2,4,7,0,21,EL
b2bd0f6c,6,4,2,3,1,2,7,5,10,1,9,6,12,4,0,21,EL
b37c0a9f,0,0,0,0,0,0,0,0,0,0,0,0,0,0,0,21,EL
b387af71,1,1,0,0,1,1,3,2,2,0,2,4,5,6,1,21,EL
b39b2cba,1,0,0,0,1,0,2,2,2,0,2,0,1,0,0,21,EL
b39bf63f,1,1,0,1,0,0,1,1,2,0,2,1,2,1,0,21,EL
b3a712de,2,2,0,1,1,1,2,1,2,0,2,1,3,0,0,21,EL
b3aed40d,3,2,2,1,0,2,6,4,4,4,0,6,9,13,0,21,EL
b3de00a7,0,0,0,0,0,0,0,0,0,0,0,0,0,1,0,21,EL
b44c39da,2,1,1,0,1,2,3,1,3,1,2,1,3,1,0,21,EL
b4705807,6,3,2,3,1,1,5,4,4,0,4,2,8,5,0,21,EL
b49bc5e0,0,0,0,0,0,0,0,0,2,1,1,0,0,1,0,21,EL
b4a98bb4,0,0,0,0,0,0,0,0,0,0,0,0,0,1,0,21,EL
b50a9c75,5,3,2,2,1,2,4,2,0,0,0,1,6,0,0,21,EL
b57b998c,6,4,2,3,1,3,4,1,2,0,2,0,6,0,0,21,EL
b5f7d10b,7,2,3,4,0,2,5,3,4,1,3,4,11,5,0,21,EL
b62878a5,3,1,2,1,0,1,3,2,0,0,0,1,4,0,0,21,EL
b682dcf6,3,2,3,0,0,2,2,0,4,4,0,5,8,19,0,21,EL
b684a484,5,2,3,2,0,0,0,0,4,1,3,1,6,6,0,21,EL
b6964eb6,1,0,0,1,0,0,1,1,3,3,0,5,6,13,0,21,EL
b6b6bfc4,2,2,1,1,0,1,1,0,0,0,0,2,4,3,0,21,EL
b7139e01,3,2,2,1,0,0,7,7,6,1,5,10,13,13,1,21,EL
b7669d1e,2,1,2,0,0,1,2,1,1,0,1,0,2,0,0,21,EL
b77706dd,0,0,0,0,0,0,0,0,0,0,0,0,0,0,0,21,EL
b79858d5,5,2,3,1,1,3,8,5,3,1,2,1,6,0,0,21,EL
b7c19c48,0,0,0,0,0,0,1,1,3,3,0,7,7,11,0,21,EL
b827d5b3,8,4,2,5,1,3,11,8,10,1,9,6,14,8,0,21,EL
b82df7cb,1,1,0,1,0,1,3,2,1,0,1,2,3,1,0,21,EL
b8441408,8,3,6,2,0,5,7,2,6,0,6,10,18,11,0,21,EL
b853e0ad,10,5,5,5,0,6,15,9,19,1,18,14,24,6,0,21,EL
b85bf253,8,3,3,4,1,3,12,9,3,0,3,6,14,6,1,21,EL
b8814868,4,3,0,3,1,0,5,5,3,0,3,0,4,1,0,21,EL
b8a642fc,10,3,3,2,5,4,10,6,9,0,9,3,13,0,0,21,EL
b8c1de25,30,20,14,11,5,12,25,13,6,1,5,15,45,5,1,21,EL
b8e740fb,11,6,7,4,0,4,8,4,7,1,6,11,22,4,0,21,EL
ba23a904,8,7,3,5,0,5,8,3,6,3,3,7,15,27,0,21,EL
bac46a10,8,5,3,5,0,7,12,5,8,3,5,14,22,16,0,21,EL
bafcf742,16,10,13,2,1,7,11,4,3,1,2,12,28,12,0,21,EL
bb79b58f,2,1,1,1,0,0,1,1,3,0,3,0,2,7,0,21,EL
bb833a0a,0,0,0,0,0,0,0,0,0,0,0,0,0,0,0,21,EL
bc08556f,6,2,2,4,0,1,7,6,4,3,1,5,11,7,0,21,EL
bc7dc64d,9,6,2,5,2,3,5,2,7,0,7,6,15,2,1,21,EL
bcdc8055,2,1,2,0,0,1,4,3,4,1,3,8,10,17,0,21,EL
bced0375,20,9,7,12,1,10,22,12,16,6,10,14,34,15,0,21,EL
bd142efb,5,3,3,2,0,4,7,3,13,4,9,18,23,14,0,21,EL
bd3fb505,0,0,0,0,0,0,3,3,2,0,2,0,0,0,0,21,EL
bd7d2e6d,3,2,3,0,0,1,2,1,2,2,0,4,7,4,1,21,EL
bdc74a8f,14,9,5,7,2,5,19,14,6,2,4,5,19,5,0,21,EL
bdc8912c,28,14,11,14,3,17,27,10,11,0,11,14,42,10,0,21,EL
be765073,10,7,4,6,0,2,6,4,6,1,5,9,19,9,0,21,EL
be9938ed,1,1,1,0,0,0,0,0,3,1,2,0,1,2,0,21,EL
bee0bab1,6,4,1,3,2,2,8,6,3,0,3,4,10,0,0,21,EL
beec76cc,17,9,4,9,4,3,11,8,9,1,8,10,27,9,0,21,EL
bf128850,5,4,2,3,0,2,5,3,6,2,4,4,9,0,0,21,EL
bf309d24,14,7,5,9,0,7,20,13,4,2,2,23,37,13,1,21,EL
bf34eebd,1,0,1,0,0,1,4,3,2,0,2,0,1,0,0,21,EL
bfde3de5,3,0,1,2,0,3,6,3,1,1,0,0,3,0,0,21,EL
c001a28e,2,1,2,0,0,2,4,2,0,0,0,2,4,2,0,21,EL
c00e6676,0,0,0,0,0,0,3,3,0,0,0,0,0,0,0,21,EL
c0617e2b,11,7,3,5,3,6,14,8,12,2,10,13,24,2,2,21,EL
c08fc464,6,1,3,3,0,2,4,2,1,0,1,1,7,0,0,21,EL
c0c7ff58,9,6,5,3,1,4,8,4,3,0,3,5,14,10,0,21,EL
c0e27d1a,1,1,0,0,1,0,4,4,8,7,1,3,4,15,1,21,EL
c20bdcd7,5,3,2,3,0,5,5,0,0,0,0,7,12,8,0,21,EL
c2111b45,9,6,4,5,0,8,10,2,10,5,5,11,20,17,0,21,EL
c2123906,2,1,0,2,0,1,3,2,3,1,2,1,3,3,0,21,EL
c2304da8,12,10,4,8,0,7,8,1,5,2,3,1,13,4,0,21,EL
c235e803,5,3,2,3,0,0,0,0,4,2,2,0,5,5,0,21,EL
c24544c7,2,1,2,0,0,0,0,0,1,0,1,2,4,1,0,21,EL
c2a6033c,8,8,6,1,1,4,6,2,2,0,2,3,11,2,0,21,EL
c2bd8585,15,9,10,4,1,8,26,18,9,3,6,11,26,3,0,21,EL
c2e41cfb,0,0,0,0,0,0,0,0,0,0,0,0,0,1,1,21,EL
c328ab28,2,0,0,1,1,1,3,2,2,0,2,0,2,0,0,21,EL
c339426b,2,1,0,1,1,2,3,1,2,0,2,2,4,0,0,21,EL
c34824b1,3,1,2,1,0,0,2,2,3,2,1,3,6,5,1,21,EL
c3853da6,14,8,7,6,1,3,5,2,6,0,6,6,20,5,0,21,EL
c3e4ecbb,9,3,8,0,1,4,11,7,3,1,2,11,20,26,0,21,EL
c41f7379,0,0,0,0,0,0,0,0,0,0,0,0,0,1,0,21,EL
c43e5e7e,4,1,0,3,1,1,2,1,3,0,3,3,7,4,0,21,EL
c455a2b2,6,4,2,3,1,2,3,1,1,0,1,3,9,2,0,21,EL
c45a34e7,2,1,0,0,2,1,2,1,0,0,0,0,2,0,0,21,EL
c4a306a1,4,2,2,2,0,3,8,5,4,2,2,6,10,15,0,21,EL
c50281a0,13,6,7,3,3,11,14,3,3,0,3,5,18,5,0,21,EL
c54ea7f0,10,8,4,4,2,4,15,11,6,1,5,12,22,3,0,21,EL
c585302b,0,0,0,0,0,0,0,0,0,0,0,0,0,2,0,21,EL
c5a500ca,12,8,2,8,2,4,18,14,5,0,5,3,15,4,0,21,EL
c5adc293,5,4,3,2,0,3,3,0,3,2,1,4,9,5,1,21,EL
c5bdb6e3,2,1,0,2,0,0,1,1,2,0,2,1,3,0,0,21,EL
c5cbbcff,2,0,1,0,1,0,5,5,4,0,4,11,13,5,0,21,EL
c5ea2dab,7,3,5,2,0,3,7,4,4,2,2,11,18,14,1,21,EL
c603091a,7,3,5,1,1,5,9,4,8,6,2,7,14,11,0,21,EL
c63f6e46,3,1,1,0,2,1,6,5,2,0,2,2,5,1,0,21,EL
c64c01fc,0,0,0,0,0,0,0,0,0,0,0,0,0,0,0,21,EL
c650629d,6,3,1,2,3,0,5,5,2,0,2,3,9,3,0,21,EL
c68b1b13,10,3,6,2,2,5,9,4,7,3,4,7,17,11,0,21,EL
c6cf860f,2,1,1,1,0,1,2,1,0,0,0,5,7,1,0,21,EL
c6dda86e,9,2,7,2,0,5,13,8,3,1,2,8,17,8,0,21,EL
c7069d87,11,4,6,5,0,3,8,5,2,0,2,1,12,1,0,21,EL
c70b221c,3,2,2,1,0,0,6,6,4,3,1,5,8,20,0,21,EL
c71e97ba,6,2,3,3,0,0,3,3,4,1,3,8,14,7,0,21,EL
c77a8043,9,8,7,1,1,7,16,9,13,0,13,7,16,10,0,21,EL
c7842dab,0,0,0,0,0,0,0,0,0,0,0,0,0,0,0,21,EL
c7b13c29,0,0,0,0,0,0,0,0,0,0,0,0,0,3,0,21,EL
c7e955d0,0,0,0,0,0,0,2,2,1,0,1,0,0,1,0,21,EL
c7fbd3f1,1,0,0,1,0,0,2,2,1,1,0,5,6,1,0,21,EL
c8160af7,1,0,1,0,0,1,1,0,0,0,0,1,2,1,0,21,EL
c83623e2,7,4,4,3,0,4,7,3,7,4,3,13,20,26,0,21,EL
c83c2c9c,2,1,1,1,0,1,1,0,2,0,2,4,6,6,0,21,EL
c8694401,13,8,9,1,3,7,13,6,5,1,4,7,20,19,0,21,EL
c86c0fab,1,0,0,1,0,0,0,0,3,0,3,0,1,0,0,21,EL
c8a4aafd,6,6,4,1,1,1,3,2,8,5,3,9,15,18,0,21,EL
c8ad0857,7,5,4,3,0,3,3,0,11,5,6,23,30,47,0,21,EL
c8d7131c,6,1,3,2,1,1,5,4,5,0,5,3,9,6,0,21,EL
c8e65157,11,7,8,2,1,5,9,4,9,6,3,10,21,38,0,21,EL
c904f3d5,2,0,1,1,0,2,2,0,4,3,1,3,5,3,0,21,EL
c9081f9a,4,3,2,0,2,1,4,3,1,0,1,2,6,2,0,21,EL
c92e1a31,4,2,0,2,2,1,4,3,6,1,5,1,5,6,0,21,EL
c931d9f9,8,4,1,6,1,4,12,8,6,0,6,2,10,2,0,21,EL
c952f633,11,7,5,3,3,3,7,4,4,0,4,6,17,4,0,21,EL
c967f6b8,7,3,5,2,0,2,5,3,7,3,4,10,17,19,0,21,EL
ca033449,17,13,6,6,5,8,12,4,10,5,5,21,38,21,0,21,EL
ca45605e,2,2,0,0,2,0,1,1,0,0,0,1,3,0,0,21,EL
ca607d59,3,2,0,2,1,1,1,0,1,0,1,0,3,0,0,21,EL
caaf2ed1,7,4,4,3,0,5,9,4,11,2,9,8,15,2,0,21,EL
cb4f24c6,0,0,0,0,0,0,0,0,0,0,0,0,0,0,1,21,EL
cb641b9d,0,0,0,0,0,0,0,0,0,0,0,0,0,0,0,21,EL
cc83b74d,2,1,0,0,2,1,1,0,1,0,1,1,3,1,0,21,EL
ccc66d00,9,7,5,2,2,2,5,3,5,1,4,2,11,0,0,21,EL
ccce7025,6,0,5,0,1,1,3,2,8,4,4,13,19,18,0,21,EL
cd0fa27b,6,3,2,4,0,1,7,6,6,1,5,1,7,0,0,21,EL
cd4959d1,0,0,0,0,0,0,0,0,0,0,0,0,0,4,0,21,EL
cd6a1a59,6,3,3,3,0,3,7,4,4,3,1,10,16,4,1,21,EL
cd7dade5,0,0,0,0,0,0,0,0,0,0,0,0,0,1,0,21,EL
cdc20132,7,4,6,1,0,4,8,4,4,2,2,7,14,18,0,21,EL
ce50fd99,4,1,1,1,2,2,4,2,2,0,2,1,5,0,0,21,EL
ce940592,5,3,4,1,0,3,3,0,2,0,2,3,8,9,0,21,EL
ce9e8024,1,0,1,0,0,1,2,1,2,2,0,1,2,10,0,21,EL
cea4ee8f,3,3,0,3,0,0,4,4,7,0,7,3,6,2,0,21,EL
cee45ad0,4,3,2,2,0,1,6,5,13,8,5,8,12,29,0,21,EL
cf007308,3,3,1,1,1,0,3,3,1,0,1,0,3,1,0,21,EL
cf043a33,2,0,0,2,0,2,4,2,2,0,2,2,4,0,0,21,EL
cf15bbb1,20,10,8,9,3,10,22,12,8,2,6,11,31,6,0,21,EL
cf182add,2,1,1,1,0,1,2,1,1,0,1,1,3,4,0,21,EL
cf8ef0a1,0,0,0,0,0,0,0,0,0,0,0,0,0,2,0,21,EL
cfb6c9e5,14,8,9,5,0,6,11,5,6,2,4,8,22,13,0,21,EL
cfcf183b,3,3,1,0,2,1,2,1,1,0,1,2,5,1,0,21,EL
cfe852d8,0,0,0,0,0,0,0,0,0,0,0,0,0,1,0,21,EL
d019d5db,5,3,1,3,1,4,7,3,0,0,0,2,7,0,0,21,EL
d035138b,10,6,6,4,0,3,7,4,4,0,4,4,14,3,0,21,EL
d080ed5e,12,5,3,6,3,7,19,12,11,1,10,12,24,7,0,21,EL
d125f22f,2,0,0,1,1,0,1,1,2,0,2,0,2,0,0,21,EL
d1274b84,0,0,0,0,0,0,1,1,0,0,0,0,0,1,1,21,EL
d1562e2e,8,3,7,1,0,3,8,5,8,2,6,3,11,6,0,21,EL
d1bf91e0,3,1,1,2,0,0,1,1,3,0,3,2,5,4,0,21,EL
d2795011,0,0,0,0,0,0,0,0,1,0,1,0,0,0,0,21,EL
d280923b,1,0,0,1,0,1,1,0,8,4,4,7,8,10,0,21,EL
d2ddff2d,1,1,0,1,0,1,1,0,1,0,1,0,1,1,0,21,EL
d3272fba,0,0,0,0,0,0,1,1,2,0,2,0,0,1,0,21,EL
d38fdf53,4,2,2,2,0,1,1,0,0,0,0,6,10,7,0,21,EL
d3aaad90,2,2,1,1,0,2,4,2,1,1,0,1,3,2,1,21,EL
d3ce0e89,0,0,0,0,0,0,0,0,0,0,0,0,0,0,0,21,EL
d4133fa1,10,4,6,4,0,7,10,3,4,2,2,3,13,4,0,21,EL
d4232ba9,7,4,2,4,1,4,13,9,5,1,4,4,11,1,0,21,EL
d436eb94,0,0,0,0,0,0,0,0,0,0,0,0,0,1,0,21,EL
d494882e,1,0,1,0,0,1,1,0,0,0,0,1,2,0,0,21,EL
d4aa40b8,8,5,1,5,2,4,7,3,5,1,4,3,11,3,0,21,EL
d4c9725f,8,3,4,3,1,3,10,7,7,2,5,9,17,8,0,21,EL
d4cb83cc,11,7,3,5,3,4,10,6,7,2,5,8,19,9,0,21,EL
d4e7c451,1,1,1,0,0,0,0,0,3,1,2,1,2,1,0,21,EL
d4f034db,3,2,1,2,0,2,5,3,3,3,0,4,7,6,0,21,EL
d4fa7d01,9,4,5,3,1,6,11,5,4,2,2,5,14,12,0,21,EL
d504b3e1,4,3,2,2,0,3,6,3,5,1,4,2,6,1,0,21,EL
d5127c3f,5,4,2,2,1,2,6,4,2,0,2,4,9,2,0,21,EL
d51d1d9d,0,0,0,0,0,0,0,0,1,0,1,0,0,6,0,21,EL
d557d734,14,8,7,6,1,5,13,8,10,3,7,15,29,8,0,21,EL
d571df78,1,1,0,0,1,1,4,3,7,1,6,0,1,2,0,21,EL
d5854b7a,0,0,0,0,0,0,1,1,0,0,0,2,2,1,0,21,EL
d5aac0e9,2,0,0,2,0,1,3,2,0,0,0,0,2,1,0,21,EL
d5dd5f1f,1,0,0,1,0,0,3,3,5,0,5,1,2,2,0,21,EL
d665d581,3,2,2,1,0,1,6,5,3,2,1,3,6,23,0,21,EL
d72f8d9e,2,1,2,0,0,2,3,1,1,0,1,1,3,0,1,21,EL
d7354a36,5,3,2,2,1,2,2,0,1,0,1,2,7,0,0,21,EL
d73a07e2,1,1,1,0,0,1,3,2,0,0,0,0,1,0,0,21,EL
d7553721,14,8,7,7,0,3,6,3,4,0,4,6,20,0,0,21,EL
d78e8c43,1,1,1,0,0,0,1,1,1,0,1,0,1,0,0,21,EL
d79a8c87,7,3,4,2,1,1,1,0,4,2,2,4,11,13,0,21,EL
d7a70e5e,3,3,0,2,1,1,3,2,2,0,2,0,3,0,0,21,EL
d7f99582,0,0,0,0,0,0,1,1,2,0,2,0,0,2,0,21,EL
d820a7c8,2,2,2,0,0,1,7,6,3,0,3,2,4,2,0,21,EL
d84b7d06,1,0,1,0,0,1,1,0,0,0,0,0,1,0,0,21,EL
d87d58e7,1,1,0,0,1,0,0,0,1,1,0,0,1,0,0,21,EL
d87e2cae,0,0,0,0,0,0,0,0,2,0,2,0,0,2,0,21,EL
d8931174,4,3,4,0,0,3,5,2,6,3,3,11,15,29,0,21,EL
d8d25850,2,2,0,2,0,0,0,0,1,0,1,2,4,0,0,21,EL
d8ff3b2c,16,6,13,3,0,10,16,6,6,2,4,9,25,15,0,21,EL
d92b0327,7,3,2,5,0,3,8,5,5,2,3,12,19,4,0,21,EL
d93c2511,7,2,4,2,1,3,7,4,9,4,5,8,15,8,0,21,EL
d94653be,2,1,1,1,0,1,2,1,1,0,1,0,2,0,0,21,EL
d9565625,21,13,13,8,0,9,15,6,13,2,11,19,40,19,1,21,EL
d97cccc9,8,4,5,2,1,5,7,2,2,1,1,1,9,2,0,21,EL
d9847696,1,0,0,1,0,0,0,0,0,0,0,1,2,2,0,21,EL
d9a5d930,0,0,0,0,0,0,0,0,0,0,0,0,0,0,0,21,EL
d9ac09e2,0,0,0,0,0,0,3,3,1,0,1,0,0,0,0,21,EL
d9d43555,0,0,0,0,0,0,0,0,0,0,0,0,0,0,0,21,EL
d9e196bf,6,5,3,2,1,3,4,1,10,2,8,3,9,1,0,21,EL
da3bf1b3,3,1,1,2,0,0,3,3,5,0,5,4,7,3,0,21,EL
da7b447d,15,12,10,5,0,5,10,5,7,6,1,17,32,28,0,21,EL
da974c7b,16,12,12,3,1,7,14,7,11,4,7,10,26,22,1,21,EL
db092d3b,6,3,2,3,1,3,11,8,0,0,0,7,13,1,0,21,EL
db123b51,3,2,2,1,0,1,3,2,4,0,4,4,7,9,0,21,EL
db1aced4,5,2,4,1,0,2,3,1,1,0,1,5,10,5,0,21,EL
db2e8273,1,1,0,0,1,1,1,0,0,0,0,1,2,0,0,21,EL
db50aeaa,3,0,3,0,0,3,4,1,4,3,1,2,5,7,0,21,EL
db74c6d3,4,3,1,2,1,2,3,1,5,5,0,8,12,32,0,21,EL
dba1f190,7,6,0,4,3,1,6,5,6,1,5,1,8,3,0,21,EL
dba67bc4,4,3,2,2,0,2,4,2,2,0,2,3,7,0,0,21,EL
dbad5a31,8,5,5,1,2,5,11,6,5,1,4,14,22,14,0,21,EL
dbf3e08b,2,1,2,0,0,1,2,1,4,3,1,3,5,6,0,21,EL
dc234f98,10,3,8,2,0,4,4,0,12,6,6,21,31,20,0,21,EL
dc29b608,0,0,0,0,0,0,1,1,0,0,0,0,0,2,1,21,EL
dc3fa3b5,12,7,5,6,1,5,19,14,2,1,1,4,16,5,0,21,EL
dc415e39,4,3,1,2,1,0,7,7,2,0,2,3,7,0,0,21,EL
dc52c72f,8,6,5,3,0,5,6,1,5,2,3,6,14,12,0,21,EL
dc6f5bdd,4,3,2,2,0,2,4,2,3,1,2,8,12,3,0,21,EL
dc90cfbe,0,0,0,0,0,0,0,0,2,0,2,0,0,3,0,21,EL
dd0daf32,13,7,5,6,2,5,13,8,6,0,6,9,22,2,0,21,EL
dd788526,9,6,6,2,1,6,13,7,5,2,3,10,19,21,0,21,EL
ddd5348b,1,1,0,0,1,0,0,0,0,0,0,0,1,0,0,21,EL
dde7068b,2,0,1,0,1,0,1,1,0,0,0,0,2,0,0,21,EL
deb20131,8,6,6,2,0,2,4,2,9,5,4,7,15,9,0,21,EL
deba6b05,7,6,3,4,0,5,13,8,9,1,8,10,17,4,0,21,EL
debc6b55,1,0,0,0,1,0,1,1,1,0,1,0,1,0,0,21,EL
df41e06e,6,3,4,0,2,4,6,2,7,4,3,10,16,16,0,21,EL
dff19848,1,0,0,0,1,1,1,0,4,1,3,0,1,2,0,21,EL
e02f182f,5,3,3,2,0,2,2,0,2,1,1,6,11,2,0,21,EL
e03c2d97,16,11,5,10,1,7,12,5,7,1,6,10,26,7,0,21,EL
e07c2923,16,10,4,9,3,7,17,10,3,0,3,9,25,1,0,21,EL
e09436fb,5,5,3,2,0,2,4,2,1,0,1,3,8,1,0,21,EL
e0d3e18d,2,2,1,1,0,0,2,2,2,0,2,6,8,0,0,21,EL
e111bf12,11,9,5,2,4,6,10,4,5,2,3,5,16,6,0,21,EL
e1604571,2,1,2,0,0,1,4,3,5,4,1,3,5,12,0,21,EL
e16932d8,1,0,0,1,0,0,0,0,2,0,2,0,1,0,0,21,EL
e1ba3d5a,5,2,0,1,4,3,6,3,1,0,1,2,7,0,0,21,EL
e1bbb68d,2,2,1,0,1,1,2,1,2,1,1,0,2,2,0,21,EL
e1cbb531,3,0,1,0,2,2,5,3,1,0,1,4,7,2,0,21,EL
e23f56c1,0,0,0,0,0,0,0,0,0,0,0,0,0,0,0,21,EL
e2716bd0,6,3,0,5,1,3,7,4,2,0,2,4,10,2,0,21,EL
e2781082,2,2,0,0,2,2,4,2,2,0,2,1,3,3,0,21,EL
e28205f4,2,1,2,0,0,1,4,3,4,0,4,0,2,2,0,21,EL
e28245d9,3,2,0,3,0,1,7,6,2,0,2,1,4,3,0,21,EL
e2a302a8,12,10,7,3,2,10,24,14,4,0,4,5,17,11,0,21,EL
e373f1ec,3,3,2,1,0,3,8,5,4,2,2,13,16,10,0,21,EL
e38f1636,5,3,1,4,0,3,5,2,5,4,1,2,7,3,0,21,EL
e3a5814e,5,3,3,2,0,3,5,2,5,0,5,7,12,6,0,21,EL
e3e3f401,1,1,0,1,0,1,1,0,2,0,2,6,7,1,0,21,EL
e45ee4bc,7,2,4,2,1,3,9,6,7,2,5,5,12,7,0,21,EL
e4ac16cf,7,2,7,0,0,3,3,0,9,8,1,6,13,17,1,21,EL
e53830f2,0,0,0,0,0,0,0,0,0,0,0,0,0,0,0,21,EL
e5a35ae9,5,4,0,2,3,2,4,2,3,0,3,1,6,0,0,21,EL
e5a76dfe,0,0,0,0,0,0,0,0,0,0,0,0,0,2,0,21,EL
e613313c,1,1,0,1,0,1,1,0,0,0,0,1,2,1,0,21,EL
e61b8aee,18,9,10,7,1,11,16,5,3,1,2,9,27,6,0,21,EL
e6631d18,7,3,6,1,0,4,10,6,8,1,7,7,14,11,0,21,EL
e66c698a,6,4,2,4,0,2,5,3,7,1,6,0,6,0,0,21,EL
e66e4ddc,2,2,2,0,0,2,4,2,2,2,0,3,5,5,0,21,EL
e6fa388d,2,2,0,0,2,0,2,2,2,0,2,3,5,0,0,21,EL
e705903c,1,0,1,0,0,0,1,1,0,0,0,0,1,0,0,21,EL
e7199efb,5,3,0,5,0,1,2,1,4,0,4,0,5,1,0,21,EL
e73c9bb2,7,3,5,2,0,3,8,5,3,0,3,5,12,14,0,21,EL
e75dc411,5,2,4,1,0,3,11,8,1,0,1,3,8,4,1,21,EL
e791ed65,0,0,0,0,0,0,0,0,0,0,0,0,0,0,0,21,EL
e7e257d2,0,0,0,0,0,0,0,0,1,0,1,0,0,1,0,21,EL
e7f3e8a7,1,0,0,0,1,0,0,0,3,0,3,3,4,0,0,21,EL
e7fcf289,4,3,1,2,1,2,8,6,3,0,3,4,8,1,0,21,EL
e82900ef,0,0,0,0,0,0,1,1,1,0,1,1,1,1,0,21,EL
e82adcab,2,1,0,1,1,1,4,3,0,0,0,6,8,1,0,21,EL
e872ca65,4,3,3,1,0,0,4,4,2,0,2,1,5,2,0,21,EL
e8796ba6,14,5,10,3,1,7,12,5,5,0,5,9,23,7,0,21,EL
e8918589,0,0,0,0,0,0,0,0,0,0,0,0,0,5,0,21,EL
e8acf576,1,1,1,0,0,0,4,4,4,0,4,7,8,1,1,21,EL
e8ed3abc,0,0,0,0,0,0,0,0,0,0,0,0,0,1,0,21,EL
e8ef59da,0,0,0,0,0,0,0,0,0,0,0,0,0,1,0,21,EL
e9895d1c,1,1,0,0,1,0,3,3,1,1,0,2,3,1,0,21,EL
e9971f2d,3,3,0,3,0,2,3,1,3,2,1,4,7,10,0,21,EL
e9b0ccaf,2,1,2,0,0,0,0,0,2,0,2,0,2,0,0,21,EL
ea6a7ab4,0,0,0,0,0,0,0,0,0,0,0,0,0,0,0,21,EL
ea770abf,4,2,4,0,0,3,4,1,9,5,4,6,10,7,0,21,EL
ea83bfa6,0,0,0,0,0,0,0,0,0,0,0,0,0,3,0,21,EL
ea9b2ef9,2,0,2,0,0,1,6,5,4,3,1,10,12,41,0,21,EL
eab5c31f,0,0,0,0,0,0,2,2,1,0,1,1,1,1,0,21,EL
eab85789,3,1,3,0,0,1,4,3,2,0,2,1,4,0,0,21,EL
eac044ad,6,4,2,3,1,4,9,5,2,0,2,4,10,2,0,21,EL
eb2b33aa,0,0,0,0,0,0,0,0,0,0,0,1,1,1,0,21,EL
eb49bd3f,4,2,3,1,0,1,2,1,5,2,3,7,11,13,0,21,EL
eb5bc3eb,14,6,8,5,1,9,17,8,9,3,6,15,29,20,0,21,EL
eb6e14be,1,0,0,1,0,1,2,1,5,1,4,3,4,0,0,21,EL
eb7822d7,8,2,2,5,1,4,7,3,12,4,8,10,18,5,0,21,EL
eb8b2a35,1,0,0,0,1,0,2,2,5,0,5,0,1,0,0,21,EL
ebca82e8,3,2,2,0,1,2,4,2,4,2,2,5,8,19,0,21,EL
ebdc9c7e,6,3,6,0,0,4,6,2,4,3,1,8,14,22,2,21,EL
ec30b9c8,7,4,1,6,0,3,8,5,7,2,5,6,13,1,0,21,EL
ecb68eea,4,3,3,1,0,2,8,6,2,1,1,3,7,2,0,21,EL
ecc10d95,1,0,0,1,0,0,0,0,0,0,0,2,3,1,0,21,EL
ed16a617,10,9,5,3,2,4,10,6,5,0,5,5,15,2,0,21,EL
ed1cc44a,2,2,1,1,0,2,3,1,5,2,3,7,9,14,1,21,EL
ed45a7d7,9,4,3,5,1,4,19,15,7,1,6,8,17,5,0,21,EL
ed6ea4d9,10,5,4,3,3,2,4,2,11,0,11,7,17,5,0,21,EL
ee251371,5,2,2,3,0,1,6,5,5,0,5,3,8,3,0,21,EL
ee3519f5,1,0,1,0,0,0,0,0,0,0,0,1,2,2,1,21,EL
ee38d9c5,5,4,2,0,3,3,6,3,1,0,1,3,8,0,0,21,EL
ee926a02,23,17,11,9,3,10,20,10,13,5,8,16,39,9,0,21,EL
ee950928,11,4,4,4,3,2,17,15,11,0,11,7,18,7,0,21,EL
eeba07f8,0,0,0,0,0,0,2,2,2,0,2,0,0,1,0,21,EL
eed332df,0,0,0,0,0,0,0,0,1,0,1,0,0,0,0,21,EL
eef95b11,3,1,3,0,0,1,2,1,2,2,0,3,6,11,0,21,EL
ef233486,1,0,0,0,1,0,1,1,3,1,2,0,1,0,0,21,EL
ef32d66d,0,0,0,0,0,0,1,1,0,0,0,0,0,0,0,21,EL
ef3909cd,0,0,0,0,0,0,2,2,0,0,0,0,0,9,0,21,EL
ef4d73aa,10,5,3,7,0,5,11,6,7,4,3,16,26,9,0,21,EL
ef88f778,7,4,0,2,5,4,14,10,3,1,2,0,7,3,0,21,EL
ef9c1c95,12,7,5,4,3,5,13,8,6,0,6,6,18,3,0,21,EL
efc13588,8,6,2,5,1,5,9,4,0,0,0,3,11,3,0,21,EL
efc33b33,4,3,4,0,0,2,7,5,3,2,1,4,8,18,0,21,EL
f038585f,0,0,0,0,0,0,0,0,0,0,0,0,0,0,0,21,EL
f0661424,13,6,4,6,3,5,8,3,6,1,5,9,22,5,1,21,EL
f0677ed7,15,7,8,7,0,5,22,17,14,5,9,15,30,16,0,21,EL
f07a0fe5,13,5,8,5,0,7,10,3,12,6,6,11,24,32,0,21,EL
f0e4c69e,0,0,0,0,0,0,0,0,0,0,0,0,0,0,1,21,EL
f0f5a383,1,1,0,0,1,0,0,0,0,0,0,0,1,1,0,21,EL
f0f68cb9,2,1,1,0,1,1,3,2,2,1,1,5,7,5,0,21,EL
f18d7ab2,4,1,1,2,1,4,5,1,3,2,1,2,6,5,0,21,EL
f201798c,1,0,1,0,0,0,5,5,0,0,0,0,1,1,0,21,EL
f209b81e,0,0,0,0,0,0,9,9,1,0,1,2,2,0,0,21,EL
f230bc30,14,12,6,3,5,8,19,11,2,1,1,3,17,8,0,21,EL
f26e3c59,32,19,18,11,3,15,27,12,9,2,7,11,43,7,0,21,EL
f2cfb59a,0,0,0,0,0,0,1,1,0,0,0,0,0,0,0,21,EL
f301f363,12,8,5,5,2,3,10,7,2,0,2,4,16,0,0,21,EL
f323d995,2,0,2,0,0,1,1,0,1,0,1,3,5,10,0,21,EL
f329ec76,4,2,3,0,1,3,4,1,2,0,2,4,8,2,0,21,EL
f352799f,0,0,0,0,0,0,0,0,0,0,0,0,0,1,0,21,EL
f3600c02,9,6,3,5,1,3,7,4,4,0,4,4,13,0,0,21,EL
f38cc3b3,0,0,0,0,0,0,0,0,2,0,2,0,0,0,0,21,EL
f3a97d02,0,0,0,0,0,0,2,2,0,0,0,0,0,3,1,21,EL
f3b2463e,6,4,5,1,0,3,5,2,1,0,1,3,9,1,1,21,EL
f40dd3c7,4,3,2,2,0,1,2,1,5,2,3,10,14,16,0,21,EL
f42e9f3f,0,0,0,0,0,0,0,0,0,0,0,0,0,2,0,21,EL
f4b52308,10,5,3,5,2,4,6,2,1,0,1,8,18,7,0,21,EL
f4ceb85b,2,2,0,2,0,0,0,0,1,0,1,0,2,4,0,21,EL
f4d8ce5a,0,0,0,0,0,0,1,1,3,1,2,4,4,2,0,21,EL
f5044e54,7,6,2,4,1,5,11,6,1,0,1,2,9,1,0,21,EL
f533776b,3,2,3,0,0,3,3,0,2,2,0,5,8,11,0,21,EL
f5ae006d,4,2,0,2,2,2,4,2,5,0,5,0,4,0,0,21,EL
f5c8b425,3,1,1,1,1,0,7,7,2,0,2,1,4,3,0,21,EL
f5deef4c,3,2,0,3,0,0,0,0,8,2,6,9,12,18,0,21,EL
f620b04f,0,0,0,0,0,0,0,0,0,0,0,0,0,0,0,21,EL
f63cda26,3,2,0,2,1,1,2,1,1,0,1,0,3,0,0,21,EL
f69d4d79,2,1,0,0,2,2,4,2,1,1,0,6,8,6,0,21,EL
f716e4e4,1,0,0,1,0,0,1,1,1,0,1,0,1,0,0,21,EL
f754c59e,6,3,3,3,0,2,6,4,2,0,2,1,7,1,0,21,EL
f7b10c66,1,0,1,0,0,1,2,1,0,0,0,0,1,2,1,21,EL
f7c491f1,3,1,3,0,0,0,0,0,2,2,0,4,7,16,0,21,EL
f7d50789,1,1,1,0,0,1,3,2,3,2,1,2,3,4,0,21,EL
f7dc2ae5,4,2,0,4,0,0,3,3,4,0,4,2,6,6,0,21,EL
f7e87032,9,6,4,3,2,1,4,3,6,1,5,2,11,3,0,21,EL
f80d03ca,2,2,0,1,1,0,2,2,1,0,1,0,2,1,0,21,EL
f820504e,6,6,3,3,0,4,8,4,3,1,2,6,12,3,1,21,EL
f8342731,25,13,10,13,2,13,26,13,18,7,11,15,40,18,0,21,EL
f874dd44,3,3,2,0,1,2,6,4,8,2,6,2,5,12,0,21,EL
f8fcd2a5,6,5,3,2,1,1,3,2,1,0,1,3,9,10,0,21,EL
f934cffd,3,1,0,3,0,1,2,1,0,0,0,1,4,5,0,21,EL
f94e06da,0,0,0,0,0,0,0,0,1,0,1,0,0,2,0,21,EL
f9a72ca4,1,0,1,0,0,1,2,1,0,0,0,0,1,1,0,21,EL
f9acca3a,21,11,7,12,2,10,24,14,8,1,7,7,28,5,0,21,EL
f9c927de,13,6,5,8,0,5,15,10,6,0,6,9,22,6,0,21,EL
f9d5908e,3,2,2,0,1,1,5,4,4,0,4,2,5,0,0,21,EL
f9dfb7ae,3,2,2,1,0,1,2,1,5,2,3,4,7,11,1,21,EL
fa18c72e,10,8,3,5,2,3,8,5,1,0,1,0,10,0,0,21,EL
fa265f6d,2,2,1,1,0,1,5,4,0,0,0,1,3,0,0,21,EL
fa73ccc7,2,2,1,0,1,1,4,3,2,0,2,3,5,0,0,21,EL
fae880d5,6,3,3,3,0,2,9,7,8,1,7,6,12,4,0,21,EL
fb37a645,3,1,2,1,0,2,3,1,1,0,1,0,3,1,0,21,EL
fb4558af,3,3,1,0,2,3,4,1,1,0,1,2,5,2,0,21,EL
fb5d47b3,5,4,2,2,1,4,7,3,6,0,6,1,6,5,0,21,EL
fb614c44,14,9,5,6,3,6,9,3,7,2,5,11,25,13,0,21,EL
fc027d02,5,3,1,3,1,1,4,3,6,1,5,5,10,12,0,21,EL
fc056d1e,0,0,0,0,0,0,0,0,0,0,0,0,0,0,0,21,EL
fc1cf07a,8,8,5,3,0,2,3,1,5,3,2,4,12,8,0,21,EL
fc46aab1,21,14,7,12,2,7,21,14,19,2,17,4,25,6,0,21,EL
fc4cf6a7,6,6,2,4,0,3,5,2,6,4,2,4,10,3,0,21,EL
fcb38f57,0,0,0,0,0,0,0,0,1,0,1,0,0,1,0,21,EL
fcb8b607,5,1,0,4,1,4,6,2,1,0,1,2,7,0,0,21,EL
fce2302c,4,3,2,1,1,3,4,1,5,2,3,7,11,12,0,21,EL
fd2bc67d,0,0,0,0,0,0,1,1,1,0,1,2,2,4,0,21,EL
fd4ee68b,6,3,2,3,1,1,6,5,5,1,4,9,15,4,0,21,EL
fd834d1d,0,0,0,0,0,0,0,0,0,0,0,1,1,3,0,21,EL
fdbde523,11,8,4,4,3,7,9,2,15,2,13,5,16,9,0,21,EL
fe192f45,1,0,0,1,0,1,4,3,3,0,3,2,3,3,0,21,EL
fe6c830a,9,5,7,1,1,5,17,12,10,1,9,6,15,5,0,21,EL
fe7d8182,0,0,0,0,0,0,0,0,0,0,0,0,0,0,0,21,EL
fefce889,0,0,0,0,0,0,0,0,0,0,0,1,1,1,0,21,EL
ff182fdc,0,0,0,0,0,0,0,0,0,0,0,0,0,0,0,21,EL
ff20acfe,1,0,0,1,0,0,1,1,1,1,0,4,5,0,0,21,EL
ff226994,5,5,5,0,0,2,2,0,2,1,1,10,15,30,0,21,EL
ff497879,2,1,2,0,0,1,1,0,2,1,1,3,5,4,0,21,EL
ff764de3,4,3,1,3,0,2,7,5,4,1,3,2,6,3,0,21,EL
ff98492b,3,1,1,2,0,2,6,4,1,0,1,5,8,2,0,21,EL
ffbbc83b,10,7,2,6,2,6,9,3,1,0,1,6,16,2,0,21,EL
ffe5ecdb,1,0,0,1,0,0,0,0,0,0,0,1,2,0,0,21,EL
004d185e,31,17,17,9,5,9,39,30,20,0,20,13,44,28,0,21,SPA
0076ab7f,23,12,16,5,2,4,10,6,10,6,4,24,47,24,2,21,SPA
00b28772,50,28,22,24,4,19,46,27,40,9,31,57,107,46,1,21,SPA
01e5f06e,29,10,17,9,3,11,22,11,15,0,15,14,43,9,0,21,SPA
01eb744d,38,21,10,23,5,15,45,30,18,1,17,22,60,16,0,21,SPA
02319ad7,12,7,1,3,8,3,18,15,13,2,11,6,18,16,0,21,SPA
02c15616,71,42,21,40,10,26,62,36,40,3,37,29,100,28,0,21,SPA
036bba5f,54,29,32,21,1,30,80,50,35,8,27,31,85,28,0,21,SPA
037dbd30,18,10,11,6,1,9,19,10,11,2,9,12,30,20,0,21,SPA
039ae103,0,0,0,0,0,0,1,1,0,0,0,2,2,2,0,21,SPA
03dc5b1f,0,0,0,0,0,0,1,1,1,0,1,0,0,0,0,21,SPA
04965583,9,5,5,3,1,5,12,7,10,1,9,12,21,9,0,21,SPA
04981123,12,7,4,5,3,6,18,12,10,0,10,4,16,2,0,21,SPA
04ac8285,0,0,0,0,0,0,0,0,0,0,0,0,0,0,0,21,SPA
04e17fd5,17,11,2,9,6,4,21,17,15,0,15,8,25,23,0,21,SPA
056269d7,52,33,28,17,7,30,53,23,19,6,13,20,72,48,2,21,SPA
05a4465d,24,13,10,13,1,8,35,27,16,1,15,12,36,21,0,21,SPA
062fc2e6,28,17,16,8,4,15,21,6,14,4,10,20,48,32,0,21,SPA
08511d65,15,12,8,6,1,6,10,4,9,5,4,19,34,39,1,21,SPA
08990838,7,4,2,4,1,2,5,3,2,0,2,11,18,21,0,21,SPA
0959c2a2,25,16,9,8,8,10,26,16,16,2,14,22,47,4,0,21,SPA
09a9e921,9,5,5,3,1,3,5,2,5,0,5,3,12,2,0,21,SPA
0a0cc13c,6,2,0,4,2,2,8,6,4,0,4,3,9,2,0,21,SPA
0a447501,5,5,0,4,1,0,2,2,8,1,7,3,8,9,0,21,SPA
0a8bcb23,7,3,3,2,2,1,8,7,2,0,2,2,9,3,0,21,SPA
0ac94a23,19,15,6,7,6,6,26,20,15,1,14,12,31,15,0,21,SPA
0ae4e09a,11,7,5,4,2,6,23,17,10,3,7,4,15,6,0,21,SPA
0b2c8585,48,28,21,22,5,16,52,36,25,3,22,49,97,25,0,21,SPA
0b90bb97,31,13,9,12,10,6,37,31,15,3,12,6,37,17,0,21,SPA
0ba976e4,9,4,2,4,3,2,10,8,4,0,4,3,12,1,0,21,SPA
0bbab654,1,0,1,0,0,0,5,5,1,1,0,4,5,5,0,21,SPA
0bc4e720,18,8,5,8,5,5,26,21,8,0,8,3,21,3,0,21,SPA
0c3f7197,8,4,1,3,4,0,3,3,5,0,5,5,13,0,0,21,SPA
0c717ae6,1,1,1,0,0,0,0,0,1,1,0,3,4,9,0,21,SPA
0cc474e7,1,1,0,1,0,0,0,0,0,0,0,1,2,1,0,21,SPA
0d298637,0,0,0,0,0,0,1,1,0,0,0,0,0,1,0,21,SPA
0d9b2d31,44,27,16,16,12,17,71,54,46,1,45,33,77,7,0,21,SPA
0dce3356,2,1,2,0,0,2,2,0,1,0,1,0,2,1,0,21,SPA
0e4fef6e,32,15,11,19,2,21,34,13,16,7,9,27,59,43,0,21,SPA
0e5ddc7c,4,3,2,1,1,0,11,11,3,0,3,2,6,4,0,21,SPA
0ef89a37,8,6,2,5,1,3,9,6,7,0,7,2,10,1,0,21,SPA
0f7dbaf6,0,0,0,0,0,0,0,0,0,0,0,0,0,0,0,21,SPA
10072610,0,0,0,0,0,0,1,1,0,0,0,0,0,11,0,21,SPA
11b9265b,7,4,7,0,0,2,5,3,2,1,1,3,10,2,0,21,SPA
12c50af5,64,32,22,30,12,21,94,73,30,2,28,22,86,15,2,21,SPA
12eda7be,20,9,5,15,0,8,23,15,14,1,13,9,29,12,0,21,SPA
132ac341,20,11,13,6,1,7,12,5,22,19,3,34,54,127,1,21,SPA
15781606,4,3,3,1,0,0,9,9,5,1,4,5,9,4,0,21,SPA
16aa3654,8,5,2,3,3,2,19,17,16,0,16,15,23,6,0,21,SPA
16e9d0ea,42,26,25,12,5,20,43,23,18,4,14,35,77,48,0,21,SPA
174651c8,13,9,5,6,2,9,21,12,5,1,4,19,32,32,1,21,SPA
18017beb,4,2,2,2,0,0,3,3,2,0,2,2,6,3,0,21,SPA
1827a42d,12,9,8,4,0,5,11,6,4,3,1,13,25,27,0,21,SPA
1840e36d,0,0,0,0,0,0,1,1,1,0,1,1,1,17,2,21,SPA
18abe173,26,17,17,9,0,12,21,9,7,4,3,25,51,88,1,21,SPA
19709006,15,9,3,8,4,6,13,7,2,0,2,10,25,1,0,21,SPA
19b776e9,30,14,9,16,5,8,19,11,19,0,19,15,45,12,0,21,SPA
19c36442,22,11,11,10,1,6,28,22,10,0,10,24,46,16,1,21,SPA
1a317a1b,10,8,5,5,0,6,20,14,5,1,4,9,19,10,0,21,SPA
1b40049a,7,3,3,2,2,4,16,12,4,0,4,6,13,1,0,21,SPA
1bacc518,44,27,21,19,4,15,35,20,20,4,16,38,82,29,2,21,SPA
1bda5842,18,8,4,10,4,7,36,29,24,2,22,8,26,5,0,21,SPA
1c2c55fc,34,19,26,8,0,16,28,12,40,30,10,52,86,113,0,21,SPA
1c772b46,0,0,0,0,0,0,0,0,0,0,0,0,0,0,0,21,SPA
1d1691ad,14,7,5,8,1,3,5,2,6,3,3,6,20,12,1,21,SPA
1daec722,64,51,19,40,5,25,66,41,45,4,41,40,104,27,0,21,SPA
1e465e70,3,1,2,1,0,1,3,2,2,0,2,4,7,2,0,21,SPA
1f079188,25,14,8,15,2,19,33,14,20,1,19,13,38,19,0,21,SPA
1fe0492d,55,30,28,21,6,23,52,29,44,6,38,66,121,72,0,21,SPA
1fe67e86,26,15,11,12,3,9,18,9,22,7,15,7,33,46,0,21,SPA
200e89e1,29,19,5,18,6,9,24,15,20,0,20,6,35,8,0,21,SPA
21512407,61,39,30,25,6,26,52,26,22,4,18,40,101,58,1,21,SPA
217011a0,0,0,0,0,0,0,0,0,0,0,0,0,0,0,0,21,SPA
228b0d9d,23,16,15,5,3,11,19,8,12,2,10,10,33,31,0,21,SPA
237a3851,26,19,8,14,4,7,33,26,10,1,9,17,43,18,0,21,SPA
23c5db70,2,0,0,2,0,0,0,0,2,0,2,0,2,0,0,21,SPA
23fffc06,2,1,1,0,1,0,1,1,0,0,0,0,2,0,0,21,SPA
240d3a0b,39,19,10,23,6,15,46,31,20,7,13,33,72,34,0,21,SPA
24279b8b,0,0,0,0,0,0,0,0,0,0,0,0,0,1,0,21,SPA
244f57b9,7,3,1,2,4,5,20,15,5,0,5,14,21,3,0,21,SPA
24f59bb2,1,1,1,0,0,0,1,1,5,3,2,4,5,7,0,21,SPA
253a06b9,6,2,3,1,2,2,4,2,1,0,1,1,7,0,0,21,SPA
2784f898,20,8,13,6,1,8,14,6,19,6,13,19,39,42,0,21,SPA
27a013f7,24,16,14,9,1,7,15,8,23,18,5,43,67,89,2,21,SPA
283c7121,51,30,16,31,4,20,66,46,25,4,21,22,73,17,0,21,SPA
2946f9a1,27,14,13,11,3,12,35,23,19,9,10,40,67,58,0,21,SPA
29ad0dd4,0,0,0,0,0,0,0,0,0,0,0,0,0,0,0,21,SPA
29b61deb,20,10,8,8,4,5,16,11,15,2,13,7,27,10,0,21,SPA
2a0c8ba4,52,28,17,29,6,17,76,59,22,3,19,27,79,25,0,21,SPA
2a8c9f98,5,1,1,2,2,2,5,3,2,0,2,4,9,6,0,21,SPA
2b6dc4d7,1,1,0,0,1,0,1,1,0,0,0,0,1,0,0,21,SPA
2bef2bca,22,11,12,8,2,9,9,0,24,15,9,20,42,47,1,21,SPA
2ceb58ab,21,13,13,8,0,12,31,19,7,1,6,14,35,12,0,21,SPA
2e5e846d,6,4,3,1,2,2,13,11,9,0,9,9,15,13,0,21,SPA
2f3e911a,34,20,15,16,3,10,33,23,15,4,11,13,47,37,0,21,SPA
3024e383,15,8,9,4,2,8,12,4,7,0,7,13,28,17,1,21,SPA
307fcd26,0,0,0,0,0,0,0,0,0,0,0,0,0,3,2,21,SPA
31f5b89b,11,8,2,8,1,5,8,3,3,1,2,6,17,7,0,21,SPA
32974271,11,5,1,5,5,2,27,25,12,1,11,7,18,16,3,21,SPA
32c0491f,1,1,1,0,0,1,2,1,0,0,0,0,1,3,0,21,SPA
335039a2,24,17,12,10,2,8,37,29,17,5,12,13,37,17,1,21,SPA
335fa267,9,6,5,2,2,7,13,6,12,6,6,10,19,20,0,21,SPA
3376a776,7,5,2,5,0,1,4,3,8,3,5,6,13,17,0,21,SPA
33a61a52,56,29,33,16,7,22,39,17,26,4,22,37,93,55,1,21,SPA
34269bdf,93,44,50,34,9,32,83,51,56,13,43,53,146,75,2,21,SPA
34caa4b3,1,1,0,1,0,1,2,1,2,0,2,1,2,0,0,21,SPA
34e393f2,98,56,52,40,6,40,85,45,52,14,38,68,166,58,2,21,SPA
3521abfe,5,4,4,1,0,3,6,3,5,3,2,6,11,24,0,21,SPA
355c883a,32,18,17,12,3,17,33,16,9,3,6,27,59,36,0,21,SPA
35a6e5c7,3,0,3,0,0,1,4,3,3,0,3,3,6,0,0,21,SPA
3624ce4c,21,10,13,6,2,10,19,9,14,8,6,16,37,39,0,21,SPA
3672b352,9,4,1,6,2,5,12,7,9,0,9,5,14,4,0,21,SPA
374ee424,0,0,0,0,0,0,1,1,0,0,0,3,3,14,0,21,SPA
379dc075,12,9,4,5,3,2,23,21,17,3,14,8,20,7,0,21,SPA
37e103f8,0,0,0,0,0,0,0,0,1,0,1,0,0,0,0,21,SPA
37f04799,12,8,10,1,1,5,7,2,3,2,1,14,26,48,1,21,SPA
37f1cf47,37,18,22,13,2,18,37,19,21,8,13,25,62,57,0,21,SPA
38699c72,12,4,1,5,6,2,13,11,3,1,2,3,15,8,0,21,SPA
38ce1150,48,24,21,21,6,11,41,30,25,2,23,16,64,18,0,21,SPA
3902e91b,24,15,11,6,7,10,39,29,14,5,9,18,42,22,1,21,SPA
3a58d075,1,1,1,0,0,0,1,1,0,0,0,0,1,0,0,21,SPA
3a9c4b7b,56,28,27,22,7,22,31,9,39,10,29,43,99,68,0,21,SPA
3aa4a3be,11,7,2,6,3,1,16,15,11,0,11,3,14,14,0,21,SPA
3aa74860,0,0,0,0,0,0,0,0,0,0,0,0,0,0,0,21,SPA
3ae7e4ea,8,5,5,3,0,6,14,8,4,0,4,4,12,7,0,21,SPA
3afeb49f,1,1,0,1,0,0,0,0,0,0,0,0,1,1,0,21,SPA
3c16d927,38,22,17,15,6,17,38,21,35,2,33,27,65,40,1,21,SPA
3ca6106c,18,13,9,8,1,6,26,20,13,1,12,6,24,5,0,21,SPA
3cefcaef,26,16,17,6,3,12,24,12,16,4,12,26,52,32,1,21,SPA
3d688b46,23,15,10,12,1,8,19,11,13,3,10,13,36,16,1,21,SPA
3d7e48ce,14,10,8,4,2,4,23,19,14,1,13,3,17,10,0,21,SPA
3da1b6ed,1,0,1,0,0,0,0,0,0,0,0,0,1,0,0,21,SPA
3e42f707,26,17,13,13,0,13,24,11,36,19,17,59,85,171,0,21,SPA
3e8bb8ce,0,0,0,0,0,0,0,0,0,0,0,0,0,0,0,21,SPA
3ecc11d8,19,12,11,8,0,9,21,12,12,5,7,53,72,73,0,21,SPA
3ed84b2c,0,0,0,0,0,0,1,1,0,0,0,0,0,1,0,21,SPA
3ee0dd59,41,22,18,20,3,20,34,14,22,10,12,40,81,39,0,21,SPA
3eed9821,5,1,3,2,0,1,2,1,11,6,5,9,14,15,0,21,SPA
3f10bd22,27,21,15,11,1,15,22,7,10,3,7,37,64,62,1,21,SPA
3fc45c73,22,15,16,6,0,9,27,18,17,7,10,28,50,96,0,21,SPA
40449bbd,7,6,4,3,0,1,5,4,8,7,1,23,30,54,2,21,SPA
405f267a,18,10,14,3,1,8,26,18,14,1,13,20,38,24,0,21,SPA
4112ace5,31,21,10,15,6,11,42,31,17,6,11,18,49,14,0,21,SPA
418f8f61,18,11,10,3,5,5,22,17,10,1,9,9,27,12,1,21,SPA
41c12f75,61,33,31,21,9,32,56,24,33,3,30,31,92,55,0,21,SPA
41f32541,54,28,24,25,5,23,43,20,25,11,14,41,95,70,0,21,SPA
41fb0f4e,5,5,1,3,1,3,6,3,8,0,8,2,7,0,0,21,SPA
42276181,7,4,3,2,2,3,11,8,10,0,10,0,7,3,0,21,SPA
42a028c5,0,0,0,0,0,0,0,0,0,0,0,0,0,0,0,21,SPA
43f71e77,11,4,3,5,3,8,22,14,5,1,4,3,14,19,0,21,SPA
44150beb,0,0,0,0,0,0,0,0,0,0,0,1,1,0,0,21,SPA
4442fbcd,14,7,5,8,1,9,18,9,8,5,3,8,22,12,1,21,SPA
452c3055,7,2,2,4,1,4,10,6,7,0,7,1,8,2,0,21,SPA
45af8a54,12,6,7,4,1,3,24,21,15,0,15,11,23,10,0,21,SPA
45d96179,0,13,0,0,0,0,0,0,0,0,0,26,0,0,0,21,SPA
45e17712,35,21,20,12,3,15,26,11,24,7,17,26,61,60,0,21,SPA
45e304c8,3,1,2,1,0,1,1,0,0,0,0,0,3,0,0,21,SPA
4601e194,45,30,22,16,7,24,52,28,21,2,19,49,94,48,0,21,SPA
466824fb,39,16,8,27,4,17,60,43,24,6,18,29,68,41,0,21,SPA
467bae22,5,1,0,3,2,1,5,4,2,1,1,1,6,1,0,21,SPA
46a8347f,18,12,13,5,0,8,12,4,5,0,5,8,26,14,0,21,SPA
46bd3a5b,16,9,8,6,2,8,12,4,9,1,8,20,36,31,0,21,SPA
4737cebe,9,8,0,6,3,3,8,5,7,2,5,3,12,4,0,21,SPA
474ecac8,16,12,12,3,1,7,18,11,21,10,11,33,49,84,1,21,SPA
47d493c3,16,12,11,5,0,8,14,6,10,4,6,11,27,16,0,21,SPA
487d9b09,28,14,21,5,2,12,21,9,22,8,14,33,61,67,1,21,SPA
48e89655,8,6,3,3,2,3,12,9,5,0,5,2,10,1,0,21,SPA
4958bfb2,27,20,12,10,5,11,20,9,19,1,18,13,40,27,0,21,SPA
49ea92be,6,4,1,3,2,2,13,11,11,0,11,5,11,3,0,21,SPA
4a478107,18,10,7,9,2,8,36,28,17,0,17,11,29,11,0,21,SPA
4a633cfe,19,9,14,4,1,9,15,6,16,8,8,14,33,40,0,21,SPA
4a895384,8,4,5,3,0,7,14,7,6,3,3,13,21,38,0,21,SPA
4aa253fd,2,1,0,2,0,1,2,1,1,0,1,0,2,3,0,21,SPA
4ac7608e,11,7,7,3,1,5,11,6,16,9,7,20,31,49,1,21,SPA
4accb7e0,10,6,6,4,0,5,16,11,8,1,7,7,17,10,0,21,SPA
4b3c863f,1,1,1,0,0,0,3,3,0,0,0,0,1,6,0,21,SPA
4b5e7e90,37,18,26,9,2,14,31,17,14,8,6,24,61,68,0,21,SPA
4bd414c1,22,15,19,3,0,13,18,5,32,22,10,22,44,146,2,21,SPA
4c0a6a48,19,9,10,6,3,8,22,14,8,1,7,10,29,9,0,21,SPA
4c2e9442,11,9,3,7,1,3,14,11,13,3,10,2,13,34,0,21,SPA
4c5b14d2,9,3,1,5,3,4,12,8,8,0,8,17,26,11,0,21,SPA
4cee5954,45,25,23,19,3,19,35,16,30,8,22,39,84,72,0,21,SPA
4d1666ff,27,15,14,11,2,10,24,14,24,16,8,40,67,104,0,21,SPA
4d224fe8,84,49,50,30,4,33,73,40,50,17,33,70,154,62,0,21,SPA
4d8cd038,0,0,0,0,0,0,0,0,0,0,0,0,0,0,0,21,SPA
4dbd0916,30,17,9,17,4,11,24,13,22,1,21,11,41,10,0,21,SPA
4e219ad2,20,10,8,6,6,10,41,31,12,0,12,8,28,8,0,21,SPA
4f28a6ff,36,21,23,10,3,19,28,9,26,12,14,33,69,71,1,21,SPA
5083a734,59,26,19,32,8,11,41,30,53,17,36,26,85,32,1,21,SPA
518f2234,4,3,1,2,1,1,3,2,1,1,0,1,5,1,0,21,SPA
51a3c4c8,29,17,19,10,0,18,23,5,30,15,15,36,65,128,2,21,SPA
51e3954c,25,14,14,11,0,11,20,9,11,6,5,25,50,26,0,21,SPA
52611641,8,4,2,3,3,0,3,3,5,3,2,12,20,8,0,21,SPA
529f49ab,7,4,4,3,0,5,8,3,4,1,3,2,9,1,0,21,SPA
532e1e4f,17,11,10,5,2,11,18,7,33,25,8,23,40,111,1,21,SPA
5343eb4e,12,7,1,4,7,3,8,5,5,0,5,3,15,2,0,21,SPA
53520a67,55,29,25,25,5,22,52,30,39,7,32,51,106,45,0,21,SPA
54073b28,17,5,4,8,5,8,18,10,6,0,6,4,21,1,0,21,SPA
540ec57b,19,11,10,7,2,8,28,20,20,1,19,9,28,8,0,21,SPA
5496cc91,28,17,12,10,6,9,35,26,26,1,25,21,49,9,0,21,SPA
55126f3b,64,42,22,31,11,28,98,70,35,6,29,36,100,40,0,21,SPA
555f3a0b,55,31,40,11,4,37,61,24,23,10,13,36,91,73,0,21,SPA
56cafd0a,0,0,0,0,0,0,0,0,2,2,0,3,3,11,0,21,SPA
57be54ec,3,2,0,2,1,2,8,6,4,0,4,2,5,16,0,21,SPA
58a9a4d9,34,22,13,15,6,19,53,34,15,0,15,15,49,9,0,21,SPA
58afe001,64,39,22,35,7,23,80,57,40,5,35,42,106,28,0,21,SPA
5976f83e,31,16,23,6,2,18,32,14,25,4,21,10,41,24,1,21,SPA
59b7d823,9,7,6,3,0,3,8,5,8,1,7,4,13,24,0,21,SPA
5a36f180,9,7,5,2,2,3,10,7,11,0,11,8,17,5,0,21,SPA
5a626448,21,12,6,8,7,14,35,21,20,3,17,11,32,16,0,21,SPA
5ab0ea87,63,35,21,29,13,27,76,49,27,4,23,53,116,18,2,21,SPA
5acc4a10,20,10,14,6,0,8,18,10,7,1,6,20,40,23,0,21,SPA
5b28b2f6,34,18,23,11,0,13,39,26,24,1,23,21,55,26,1,21,SPA
5c4dc0ff,4,2,2,1,1,0,9,9,3,1,2,0,4,3,0,21,SPA
5c7845f6,23,16,15,8,0,8,14,6,20,13,7,12,35,46,0,21,SPA
5c96b017,50,29,21,22,7,14,45,31,28,2,26,29,79,20,0,21,SPA
5ca20b7a,15,12,7,5,3,6,18,12,6,2,4,6,21,13,0,21,SPA
5ce0b5ba,5,2,1,4,0,1,5,4,2,0,2,5,10,7,0,21,SPA
5cec2487,6,3,2,2,2,1,3,2,1,1,0,2,8,6,0,21,SPA
5db04597,26,17,21,4,1,12,26,14,18,6,12,35,61,27,0,21,SPA
5dcf3e90,1,0,1,0,0,1,2,1,0,0,0,0,1,7,7,21,SPA
5dd16ace,1,0,0,1,0,1,2,1,0,0,0,2,3,0,0,21,SPA
5e95c000,0,0,0,0,0,0,0,0,0,0,0,0,0,1,0,21,SPA
5eebbfdf,22,12,10,7,5,5,25,20,21,4,17,26,48,15,1,21,SPA
6025fab1,37,23,18,16,3,13,36,23,14,2,12,48,85,14,1,21,SPA
603116a7,25,21,11,6,8,11,24,13,13,1,12,10,35,15,0,21,SPA
60359288,15,10,10,4,1,9,10,1,15,7,8,15,30,37,0,21,SPA
608bcb88,0,0,0,0,0,0,0,0,0,0,0,0,0,0,0,21,SPA
608f2092,21,10,15,5,1,8,18,10,15,4,11,15,36,27,0,21,SPA
61220da2,14,6,3,6,5,5,14,9,2,0,2,13,27,4,0,21,SPA
61bb7498,0,0,0,0,0,0,0,0,0,0,0,0,0,2,0,21,SPA
61bd33d0,13,8,6,3,4,3,12,9,19,0,19,12,25,7,0,21,SPA
625c144a,0,0,0,0,0,0,0,0,0,0,0,0,0,0,1,21,SPA
6265208f,27,14,6,15,6,8,28,20,26,3,23,15,42,58,1,21,SPA
636eae97,31,16,11,14,6,15,42,27,15,1,14,5,36,3,0,21,SPA
63b0ca6b,11,5,3,4,4,5,11,6,7,2,5,3,14,19,0,21,SPA
63d17038,1,1,1,0,0,0,0,0,0,0,0,1,2,4,0,21,SPA
63f04c6c,35,19,16,11,8,11,31,20,21,5,16,34,69,47,1,21,SPA
64a76620,1,1,0,1,0,0,0,0,1,0,1,0,1,0,0,21,SPA
64e8ed6d,0,0,0,0,0,0,1,1,0,0,0,0,0,0,0,21,SPA
6583a8a9,4,2,2,2,0,3,4,1,5,2,3,4,8,9,0,21,SPA
67669ce7,1,1,1,0,0,1,1,0,0,0,0,0,1,6,0,21,SPA
683788fd,0,0,0,0,0,0,1,1,1,0,1,0,0,0,0,21,SPA
685857dc,15,8,6,7,2,5,13,8,6,3,3,7,22,9,0,21,SPA
68796d61,7,5,5,0,2,0,5,5,5,0,5,4,11,6,0,21,SPA
689c9cf4,19,10,12,5,2,8,14,6,9,1,8,18,37,47,0,21,SPA
6922f806,15,6,2,4,9,3,17,14,18,2,16,1,16,10,1,21,SPA
697295b1,11,9,7,4,0,7,14,7,12,6,6,23,34,54,0,21,SPA
69c5633e,0,0,0,0,0,0,1,1,1,0,1,2,2,1,0,21,SPA
6a99e0b1,11,7,0,4,7,2,14,12,13,1,12,5,16,22,0,21,SPA
6c4776b1,1,0,1,0,0,1,1,0,1,0,1,0,1,22,6,21,SPA
6c7762c3,40,22,22,14,4,12,29,17,21,6,15,19,59,24,1,21,SPA
6c811eb7,16,10,4,9,3,7,25,18,14,1,13,2,18,2,0,21,SPA
6ce1f46f,42,22,15,15,12,11,44,33,26,6,20,15,57,10,3,21,SPA
6d8f8441,24,10,14,7,3,14,27,13,13,1,12,14,38,27,0,21,SPA
6e36226f,1,0,0,1,0,0,1,1,0,0,0,0,1,3,0,21,SPA
6e4df551,9,6,2,4,3,2,12,10,13,2,11,7,16,6,0,21,SPA
6eaed4eb,43,32,36,7,0,21,35,14,38,24,14,51,94,149,1,21,SPA
6f4c734d,32,17,13,18,1,14,31,17,16,7,9,27,59,33,1,21,SPA
6f51e382,0,0,0,0,0,0,2,2,0,0,0,0,0,12,2,21,SPA
6f5f82c0,76,43,45,20,11,27,64,37,25,4,21,23,99,42,0,21,SPA
70d74ece,8,6,4,2,2,5,15,10,9,2,7,8,16,24,0,21,SPA
7111d552,32,22,14,10,8,11,43,32,28,0,28,7,39,4,0,21,SPA
719384c1,15,9,7,7,1,4,16,12,13,3,10,22,37,21,0,21,SPA
71b47ab9,19,10,1,14,4,2,23,21,18,1,17,6,25,8,0,21,SPA
72a84002,42,25,24,15,3,16,37,21,28,15,13,32,74,119,0,21,SPA
72a99e38,16,10,5,9,2,4,22,18,14,0,14,11,27,8,0,21,SPA
72b07a9c,3,2,2,1,0,3,5,2,2,2,0,7,10,3,0,21,SPA
7329018e,43,29,15,22,6,12,41,29,23,5,18,39,82,34,1,21,SPA
7460ca0d,65,40,32,23,10,33,81,48,35,8,27,45,110,21,3,21,SPA
74aa6ab7,2,1,2,0,0,0,2,2,1,0,1,2,4,2,1,21,SPA
74d9a90b,1,0,0,0,1,0,0,0,0,0,0,0,1,0,0,21,SPA
75645f0e,1,1,0,0,1,1,8,7,7,2,5,3,4,9,0,21,SPA
76d679c7,12,7,6,6,0,4,6,2,7,2,5,6,18,25,1,21,SPA
77e39b04,4,2,0,3,1,2,5,3,4,0,4,1,5,2,0,21,SPA
788be7f9,2,1,1,0,1,0,1,1,0,0,0,1,3,0,0,21,SPA
78c40e94,11,3,5,6,0,2,13,11,5,1,4,9,20,5,0,21,SPA
79300479,1,0,0,1,0,1,2,1,1,0,1,1,2,0,0,21,SPA
7a538238,33,22,23,7,3,19,36,17,15,6,9,15,48,39,0,21,SPA
7b456af7,0,0,0,0,0,0,1,1,0,0,0,0,0,0,1,21,SPA
7b5ab7f2,29,19,12,12,5,6,23,17,20,0,20,17,46,6,0,21,SPA
7c388b20,42,24,24,12,6,14,46,32,35,6,29,34,76,43,0,21,SPA
7c4243d4,46,29,18,24,4,20,47,27,11,2,9,14,60,23,1,21,SPA
7dcf86f6,11,3,2,7,2,2,23,21,25,2,23,16,27,21,0,21,SPA
7e98cff1,4,0,0,3,1,1,7,6,3,0,3,5,9,5,0,21,SPA
7f203b54,11,5,6,5,0,5,7,2,1,0,1,10,21,23,0,21,SPA
7f4c7c9f,32,22,26,6,0,21,35,14,22,2,20,27,59,54,0,21,SPA
80153344,2,0,1,1,0,2,4,2,1,1,0,0,2,6,0,21,SPA
808d48f3,10,6,4,6,0,7,9,2,7,1,6,6,16,8,0,21,SPA
81442ecb,62,42,34,20,8,23,41,18,23,2,21,23,85,30,1,21,SPA
81d5c497,8,3,0,4,4,2,9,7,1,0,1,2,10,2,0,21,SPA
81f0781e,24,15,8,10,6,7,34,27,17,4,13,15,39,26,0,21,SPA
82803509,5,3,4,1,0,2,15,13,7,0,7,1,6,1,0,21,SPA
82e9b89d,6,3,2,2,2,2,14,12,5,1,4,1,7,9,0,21,SPA
833fb62e,13,9,3,8,2,4,11,7,11,1,10,10,23,2,0,21,SPA
84399660,13,9,3,5,5,4,18,14,4,0,4,2,15,4,0,21,SPA
8455ad90,15,11,8,4,3,3,31,28,12,0,12,2,17,0,0,21,SPA
850c0a0d,45,26,31,11,3,27,54,27,36,11,25,69,114,73,1,21,SPA
85bed4ee,3,3,1,2,0,1,6,5,7,0,7,2,5,0,0,21,SPA
868ce848,1,1,0,0,1,1,3,2,1,0,1,3,4,6,0,21,SPA
8696bc90,12,8,5,5,2,2,12,10,6,0,6,5,17,6,0,21,SPA
877f31c2,4,3,1,2,1,0,4,4,1,0,1,1,5,1,0,21,SPA
88050721,27,17,13,13,1,10,29,19,20,5,15,18,45,9,1,21,SPA
88a359d4,3,3,0,1,2,1,5,4,3,0,3,0,3,3,0,21,SPA
88d91621,42,25,13,26,3,8,22,14,22,5,17,22,64,24,2,21,SPA
8970907e,25,12,12,8,5,8,49,41,21,1,20,25,50,15,0,21,SPA
89cbc961,12,8,7,5,0,7,11,4,7,5,2,8,20,42,1,21,SPA
89d1e9fa,1,0,1,0,0,1,1,0,0,0,0,0,1,0,0,21,SPA
89f951b5,32,18,18,10,4,12,41,29,19,4,15,26,58,29,1,21,SPA
8a6daac3,6,4,4,1,1,5,8,3,2,0,2,2,8,1,0,21,SPA
8aafd64f,8,4,1,6,1,4,17,13,3,0,3,5,13,2,0,21,SPA
8abefbcf,1,1,0,1,0,0,0,0,1,0,1,0,1,0,0,21,SPA
8b625720,11,9,9,2,0,6,14,8,9,6,3,11,22,32,0,21,SPA
8c2c48a9,2,2,1,1,0,1,6,5,7,3,4,8,10,4,0,21,SPA
8c3c640c,30,17,14,12,4,10,31,21,30,5,25,15,45,17,0,21,SPA
8c5f1522,7,3,1,4,2,5,10,5,4,0,4,6,13,5,1,21,SPA
8cfc2f69,7,4,1,4,2,1,16,15,7,0,7,2,9,8,0,21,SPA
8d47bb39,12,6,6,6,0,6,11,5,16,4,12,27,39,58,0,21,SPA
8d6a9c93,3,0,2,1,0,1,1,0,2,0,2,1,4,7,0,21,SPA
8db394aa,54,30,36,17,1,14,30,16,14,4,10,47,101,75,3,21,SPA
8e010ff4,5,3,1,4,0,2,14,12,3,0,3,5,10,1,0,21,SPA
8e088e04,13,6,7,3,3,6,13,7,12,1,11,10,23,21,0,21,SPA
8e48dc61,35,23,15,16,4,15,30,15,19,5,14,25,60,35,1,21,SPA
8e92be30,9,5,0,3,6,3,8,5,17,1,16,3,12,7,0,21,SPA
8f29e08b,0,0,0,0,0,0,0,0,0,0,0,0,0,1,0,21,SPA
8f3565b3,20,12,2,11,7,4,15,11,17,4,13,2,22,17,1,21,SPA
8f5e92a6,15,6,10,4,1,2,17,15,15,0,15,7,22,4,0,21,SPA
8f898ba8,9,8,1,7,1,2,8,6,2,1,1,4,13,14,0,21,SPA
8f8c6934,2,2,2,0,0,1,3,2,0,0,0,1,3,12,0,21,SPA
8fae77ea,0,0,0,0,0,0,2,2,2,0,2,2,2,8,1,21,SPA
9038c2a1,9,3,5,2,2,4,16,12,6,1,5,10,19,4,0,21,SPA
90f83973,10,7,7,3,0,7,13,6,5,1,4,8,18,10,0,21,SPA
92d38e6c,46,24,34,10,2,20,30,10,38,17,21,62,108,125,2,21,SPA
93090f69,32,20,18,12,2,14,21,7,29,20,9,29,61,86,0,21,SPA
933e8c8a,0,0,0,0,0,0,0,0,2,0,2,0,0,2,0,21,SPA
94084f83,0,0,0,0,0,0,0,0,0,0,0,0,0,0,0,21,SPA
954c26c9,0,0,0,0,0,0,0,0,0,0,0,1,1,1,0,21,SPA
958d67bb,1,1,0,1,0,0,0,0,0,0,0,0,1,0,0,21,SPA
963829d0,51,30,25,21,5,21,77,56,32,2,30,17,68,19,0,21,SPA
967f34d3,0,0,0,0,0,0,0,0,0,0,0,0,0,7,3,21,SPA
968a1c2f,1,1,0,1,0,1,2,1,1,0,1,0,1,0,0,21,SPA
974322dc,27,15,14,10,3,11,19,8,11,1,10,17,44,19,0,21,SPA
97572117,38,23,14,19,5,15,30,15,16,2,14,22,60,42,0,21,SPA
97852360,2,0,2,0,0,2,4,2,0,0,0,2,4,19,0,21,SPA
978cd030,39,24,31,8,0,17,29,12,32,18,14,52,91,98,0,21,SPA
9939e168,61,36,27,23,11,24,67,43,27,9,18,23,84,38,0,21,SPA
9970da54,0,0,0,0,0,0,0,0,0,0,0,0,0,0,0,21,SPA
99bebd12,2,2,0,2,0,0,2,2,0,0,0,1,3,2,0,21,SPA
9a64e67e,34,20,25,8,1,9,19,10,35,24,11,36,70,87,1,21,SPA
9d2a3d5f,6,4,2,3,1,4,7,3,3,0,3,2,8,4,0,21,SPA
9d66fbe3,7,4,1,4,2,2,11,9,8,0,8,4,11,13,1,21,SPA
9f0ea33f,0,0,0,0,0,0,1,1,0,0,0,0,0,13,2,21,SPA
9f323c71,28,17,12,10,6,10,25,15,12,1,11,12,40,38,0,21,SPA
9f351459,19,14,6,7,6,3,29,26,12,0,12,9,28,9,0,21,SPA
9f8e9423,22,14,16,5,1,10,19,9,26,18,8,36,58,114,2,21,SPA
9f9e1b9c,2,0,1,1,0,1,3,2,0,0,0,0,2,0,0,21,SPA
a01c3d54,0,0,0,0,0,0,0,0,0,0,0,2,2,17,1,21,SPA
a039d52e,1,1,0,1,0,0,1,1,0,0,0,0,1,0,0,21,SPA
a08b974a,36,24,12,16,8,13,37,24,33,1,32,19,55,30,1,21,SPA
a0b4bb3e,13,9,5,5,3,2,14,12,7,1,6,2,15,2,0,21,SPA
a10361d2,5,4,2,2,1,1,10,9,5,0,5,8,13,2,0,21,SPA
a1216563,12,7,3,8,1,3,15,12,16,1,15,6,18,9,0,21,SPA
a190d597,1,0,1,0,0,1,3,2,0,0,0,0,1,2,0,21,SPA
a300ac7e,6,2,3,3,0,2,10,8,6,1,5,2,8,5,0,21,SPA
a39bb753,3,2,1,2,0,0,3,3,3,0,3,3,6,0,0,21,SPA
a4971d84,61,39,31,26,4,26,34,8,24,11,13,42,103,96,0,21,SPA
a4995f48,0,0,0,0,0,0,2,2,0,0,0,3,3,29,3,21,SPA
a4b00319,88,54,47,35,6,46,72,26,30,4,26,39,127,61,0,21,SPA
a4fe8cda,0,0,0,0,0,0,1,1,0,0,0,1,1,0,0,21,SPA
a55d8df5,32,18,14,14,4,10,35,25,26,0,26,11,43,8,0,21,SPA
a56da3ba,36,22,17,16,3,19,35,16,19,5,14,15,51,50,0,21,SPA
a60823a4,23,15,10,8,5,15,22,7,10,4,6,16,39,23,1,21,SPA
a6154613,11,7,0,4,7,3,12,9,7,0,7,5,16,13,0,21,SPA
a62b4888,50,30,20,23,7,24,65,41,27,6,21,17,67,14,0,21,SPA
a6951bf8,19,14,4,12,3,8,19,11,8,2,6,21,40,11,1,21,SPA
a6de370d,16,9,9,6,1,3,21,18,18,0,18,13,29,5,0,21,SPA
a75b4071,2,2,1,0,1,0,1,1,0,0,0,5,7,3,0,21,SPA
a7a9d95a,6,3,1,2,3,3,7,4,8,0,8,9,15,6,0,21,SPA
a7f00c8c,3,3,2,1,0,1,3,2,3,0,3,4,7,7,0,21,SPA
a83d8b0c,21,14,10,10,1,9,26,17,12,0,12,9,30,6,0,21,SPA
a8542814,12,7,5,6,1,7,13,6,7,2,5,14,26,8,0,21,SPA
a8fbae1d,42,21,32,8,2,19,36,17,39,14,25,59,101,112,0,21,SPA
a98f3cbf,7,6,5,2,0,5,13,8,3,0,3,3,10,2,0,21,SPA
a9dc785c,0,0,0,0,0,0,1,1,0,0,0,0,0,3,1,21,SPA
aa0ac32d,22,13,17,5,0,10,18,8,23,15,8,36,58,97,1,21,SPA
aa677a35,19,9,8,8,3,8,30,22,14,1,13,22,41,15,0,21,SPA
aa7da569,2,1,2,0,0,1,2,1,1,1,0,0,2,0,0,21,SPA
aad53e64,10,5,6,1,3,5,24,19,10,1,9,16,26,8,0,21,SPA
ab99e4a0,2,2,1,1,0,0,1,1,0,0,0,1,3,0,0,21,SPA
abb3bb95,9,5,3,2,4,1,7,6,11,3,8,5,14,15,0,21,SPA
ac295d9e,4,3,4,0,0,2,4,2,0,0,0,0,4,16,2,21,SPA
ac7e7b1c,8,5,2,4,2,3,13,10,0,0,0,4,12,3,0,21,SPA
ac8b2421,20,10,16,3,1,8,13,5,9,1,8,5,25,21,0,21,SPA
ad178594,6,3,5,1,0,4,6,2,0,0,0,3,9,13,0,21,SPA
ad1ffcfd,18,8,8,7,3,8,24,16,14,7,7,14,32,25,1,21,SPA
ad6df2d5,13,8,7,4,2,7,13,6,5,1,4,11,24,5,0,21,SPA
adfc9123,16,11,11,5,0,9,12,3,9,4,5,26,42,46,0,21,SPA
ae86d473,8,2,2,2,4,0,8,8,15,2,13,2,10,9,0,21,SPA
aed746df,39,29,18,13,8,15,48,33,20,3,17,19,58,14,0,21,SPA
afafac57,1,1,1,0,0,1,1,0,0,0,0,0,1,0,0,21,SPA
afdc14d7,1,0,1,0,0,0,2,2,0,0,0,1,2,0,0,21,SPA
b05e2dbd,59,33,40,13,6,33,68,35,22,3,19,38,97,62,1,21,SPA
b0616e3d,12,8,6,5,1,6,12,6,5,2,3,9,21,7,0,21,SPA
b0fce72c,28,14,8,16,4,12,50,38,28,8,20,27,55,35,1,21,SPA
b14d0c5d,9,3,6,3,0,4,9,5,6,4,2,16,25,28,0,21,SPA
b14f755d,64,41,42,17,5,35,84,49,27,8,19,36,100,33,3,21,SPA
b19db005,14,9,4,9,1,6,17,11,10,0,10,9,23,3,1,21,SPA
b1e5bbec,0,0,0,0,0,0,0,0,0,0,0,0,0,1,0,21,SPA
b233e8e4,45,21,35,9,1,24,44,20,29,17,12,36,81,100,2,21,SPA
b2d0ec1b,70,36,30,30,10,32,92,60,46,2,44,22,92,19,0,21,SPA
b39a793e,4,3,1,2,1,0,2,2,5,0,5,2,6,2,0,21,SPA
b3b62f94,23,15,15,8,0,15,24,9,18,12,6,22,45,78,0,21,SPA
b3dc6eca,11,7,7,4,0,4,13,9,17,13,4,44,55,85,0,21,SPA
b3f97139,1,1,1,0,0,1,2,1,0,0,0,1,2,0,0,21,SPA
b418dbd4,34,19,9,19,6,7,22,15,30,1,29,15,49,20,0,21,SPA
b4a014b1,22,13,17,4,1,8,16,8,35,27,8,31,53,114,1,21,SPA
b51b1b9c,21,18,12,3,6,8,24,16,20,0,20,15,36,12,1,21,SPA
b5dd3469,23,15,12,10,1,5,19,14,9,3,6,19,42,12,1,21,SPA
b6e50615,24,19,14,5,5,10,24,14,14,0,14,11,35,29,0,21,SPA
b742cc0d,27,16,18,8,1,12,22,10,19,5,14,40,67,74,3,21,SPA
b7c04927,33,17,16,17,0,18,30,12,26,8,18,14,47,54,1,21,SPA
b7c99b9b,20,12,13,6,1,14,31,17,25,13,12,37,57,104,0,21,SPA
b7ca5c51,17,11,9,5,3,6,17,11,32,27,5,59,76,132,3,21,SPA
b7d7f3bf,16,9,3,6,7,7,30,23,9,0,9,15,31,11,0,21,SPA
b7f2edff,6,3,1,4,1,2,5,3,6,2,4,6,12,11,0,21,SPA
b86a64b2,30,16,21,8,1,12,21,9,24,15,9,43,73,113,0,21,SPA
b8a642fc,12,7,4,4,4,3,17,14,8,0,8,10,22,3,0,21,SPA
b8c1de25,53,37,18,33,2,15,37,22,17,0,17,25,78,21,1,21,SPA
b92b456a,1,0,1,0,0,1,1,0,0,0,0,0,1,0,0,21,SPA
ba3ca78f,0,0,0,0,0,0,1,1,0,0,0,0,0,7,0,21,SPA
ba5004e1,59,39,29,23,7,30,81,51,43,2,41,31,90,42,0,21,SPA
ba5a9545,19,12,7,9,3,9,26,17,6,0,6,11,30,8,0,21,SPA
ba71d071,8,4,6,2,0,3,5,2,19,13,6,16,24,50,0,21,SPA
bb4b1242,21,15,6,7,8,9,22,13,11,0,11,6,27,5,0,21,SPA
bb6c6331,1,0,0,1,0,1,5,4,1,0,1,0,1,0,0,21,SPA
bba30585,1,0,1,0,0,1,2,1,1,1,0,2,3,5,0,21,SPA
bbc19252,55,26,28,24,3,23,51,28,38,9,29,43,98,36,2,21,SPA
bbf5c11b,15,9,4,4,7,7,22,15,14,2,12,15,30,25,0,21,SPA
bc61cc65,20,10,9,6,5,10,16,6,12,0,12,15,35,8,1,21,SPA
bc6f5f06,4,3,2,2,0,1,1,0,5,4,1,6,10,34,0,21,SPA
bdb624a3,8,2,3,4,1,2,7,5,4,0,4,5,13,7,0,21,SPA
bdc14559,18,12,10,8,0,5,15,10,7,1,6,11,29,18,0,21,SPA
be170419,23,12,16,7,0,10,15,5,19,14,5,32,55,110,0,21,SPA
be3a0121,5,4,4,0,1,1,3,2,3,0,3,2,7,7,0,21,SPA
bece776f,45,23,9,22,14,7,43,36,31,2,29,8,53,2,0,21,SPA
bf12926c,9,4,3,5,1,6,16,10,15,0,15,11,20,6,0,21,SPA
bfb15d99,0,0,0,0,0,0,0,0,0,0,0,0,0,1,1,21,SPA
c00097d2,14,7,8,3,3,8,18,10,24,16,8,35,49,52,1,21,SPA
c05dfb74,20,7,4,10,6,6,24,18,15,0,15,11,31,4,0,21,SPA
c14bc029,57,34,27,23,7,30,59,29,35,2,33,19,76,43,0,21,SPA
c2111b45,11,6,7,3,1,7,18,11,21,11,10,13,24,55,0,21,SPA
c261b5dd,2,2,2,0,0,2,4,2,0,0,0,1,3,0,0,21,SPA
c2cfbfc9,4,2,1,3,0,1,2,1,2,0,2,4,8,0,0,21,SPA
c46736ab,18,10,8,7,3,10,26,16,12,4,8,14,32,13,0,21,SPA
c4b888df,68,43,36,25,7,33,60,27,37,12,25,49,117,89,0,21,SPA
c4dce677,8,4,4,4,0,3,18,15,5,0,5,8,16,9,0,21,SPA
c4f5eb61,0,0,0,0,0,0,1,1,1,1,0,0,0,1,0,21,SPA
c5fa58ea,38,18,19,18,1,13,53,40,23,6,17,31,69,38,1,21,SPA
c67cd65c,34,19,26,7,1,12,29,17,22,11,11,46,80,106,3,21,SPA
c77a8043,27,13,9,12,6,10,32,22,24,5,19,12,39,25,0,21,SPA
c78b352d,47,27,32,10,5,21,43,22,24,6,18,42,89,63,1,21,SPA
c90977db,33,19,12,14,7,12,55,43,18,0,18,15,48,9,0,21,SPA
c960cfdb,0,0,0,0,0,0,0,0,0,0,0,0,0,1,0,21,SPA
c966fce1,0,0,0,0,0,0,1,1,2,0,2,0,0,0,0,21,SPA
c997b942,1,1,1,0,0,0,2,2,0,0,0,1,2,0,0,21,SPA
c9cb972b,1,1,1,0,0,1,2,1,1,0,1,0,1,16,2,21,SPA
c9e39d91,59,31,23,27,9,16,65,49,27,2,25,32,91,34,0,21,SPA
cac2537b,28,12,8,16,4,10,36,26,8,2,6,21,49,14,0,21,SPA
cb574619,58,40,34,23,1,24,52,28,42,11,31,37,95,77,0,21,SPA
cbdf7d5c,0,0,0,0,0,0,0,0,1,0,1,0,0,0,0,21,SPA
ccaa5728,6,4,2,2,2,1,14,13,6,0,6,3,9,3,0,21,SPA
cce181df,46,29,21,20,5,18,39,21,17,6,11,19,65,16,1,21,SPA
cd9b37a3,0,0,0,0,0,0,1,1,0,0,0,0,0,0,0,21,SPA
cda0b317,0,0,0,0,0,0,1,1,1,0,1,0,0,11,2,21,SPA
cde52ef5,0,0,0,0,0,0,1,1,0,0,0,0,0,18,0,21,SPA
ced26057,7,4,5,2,0,4,6,2,4,2,2,8,15,1,0,21,SPA
d080ed5e,61,36,14,36,11,18,45,27,36,8,28,32,93,26,0,21,SPA
d2110326,16,8,10,6,0,8,12,4,28,21,7,27,43,102,1,21,SPA
d2aea9ac,1,0,0,1,0,0,2,2,2,0,2,1,2,4,0,21,SPA
d2ed99b4,0,0,0,0,0,0,0,0,0,0,0,0,0,0,0,21,SPA
d38fdf53,37,17,23,12,2,14,23,9,10,2,8,35,72,14,2,21,SPA
d3b888e3,2,0,1,1,0,1,6,5,1,0,1,6,8,0,0,21,SPA
d49f3e6b,47,31,13,27,7,10,49,39,37,2,35,19,66,21,0,21,SPA
d4cb83cc,31,19,17,11,3,7,20,13,14,3,11,31,62,43,0,21,SPA
d4ef9ac5,4,0,4,0,0,0,2,2,10,1,9,7,11,12,0,21,SPA
d637fc22,38,16,21,14,3,16,50,34,30,14,16,29,67,40,1,21,SPA
d66b9872,9,8,3,3,3,3,17,14,11,0,11,7,16,2,0,21,SPA
d70ce98e,18,10,3,9,6,6,17,11,12,0,12,6,24,0,2,21,SPA
d733aa38,15,8,6,5,4,8,29,21,12,0,12,16,31,13,0,21,SPA
d83bbc54,52,31,21,29,2,22,55,33,33,13,20,47,99,69,0,21,SPA
d858d079,0,0,0,0,0,0,0,0,0,0,0,0,0,0,0,21,SPA
d87e2cae,3,1,0,3,0,1,3,2,3,1,2,0,3,8,0,21,SPA
db001fa9,92,48,63,28,1,43,85,42,30,5,25,41,133,74,0,21,SPA
db750822,4,1,2,0,2,1,6,5,3,0,3,3,7,2,0,21,SPA
dc1c2fce,47,31,21,20,6,9,51,42,48,3,45,18,65,27,0,21,SPA
dc56efc9,0,0,0,0,0,0,0,0,0,0,0,0,0,0,0,21,SPA
dd672e1f,20,13,13,7,0,7,10,3,18,12,6,11,31,71,0,21,SPA
ddd5348b,9,3,3,2,4,2,7,5,7,1,6,3,12,4,0,21,SPA
de39485a,27,15,14,6,7,15,34,19,24,0,24,17,44,16,1,21,SPA
debc6b55,5,3,0,2,3,0,3,3,3,1,2,2,7,4,0,21,SPA
dee86451,19,12,7,11,1,5,21,16,11,3,8,11,30,14,1,21,SPA
def69cd0,24,12,14,8,2,11,34,23,20,3,17,23,47,22,0,21,SPA
df69b544,37,22,10,18,9,12,40,28,20,1,19,12,49,11,0,21,SPA
df8b52a5,91,52,62,25,4,43,78,35,33,6,27,61,152,102,2,21,SPA
e08647d6,4,2,1,2,1,1,10,9,9,2,7,1,5,6,0,21,SPA
e1846dde,0,0,0,0,0,0,1,1,0,0,0,3,3,5,1,21,SPA
e208bcc8,5,4,2,1,2,3,4,1,2,0,2,3,8,0,0,21,SPA
e2716bd0,19,12,2,14,3,8,21,13,14,1,13,13,32,8,2,21,SPA
e29d1111,43,21,29,10,4,24,52,28,21,1,20,29,72,47,0,21,SPA
e4346678,1,0,1,0,0,1,3,2,0,0,0,0,1,17,3,21,SPA
e49ce451,14,8,8,4,2,5,9,4,5,2,3,10,24,9,0,21,SPA
e54bd0a2,39,18,18,16,5,16,42,26,28,8,20,37,76,42,0,21,SPA
e6bc67d7,18,12,8,7,3,10,45,35,24,1,23,8,26,7,0,21,SPA
e6eadfb8,2,0,1,0,1,0,1,1,0,0,0,0,2,0,0,21,SPA
e7986081,0,0,0,0,0,0,1,1,0,0,0,1,1,0,0,21,SPA
e7ab4179,24,14,11,12,1,12,22,10,8,6,2,13,37,51,1,21,SPA
e7f4603c,13,7,4,6,3,6,12,6,12,0,12,10,23,4,1,21,SPA
e82d2807,0,0,0,0,0,0,3,3,2,1,1,2,2,6,0,21,SPA
e897d8ba,24,18,5,7,12,6,22,16,24,1,23,7,31,29,0,21,SPA
e8a0d2f7,0,0,0,0,0,0,0,0,0,0,0,1,1,0,0,21,SPA
e8deefd6,0,2,0,0,0,0,0,0,0,0,0,6,0,0,0,21,SPA
e9ada8cf,5,5,3,2,0,2,3,1,2,0,2,3,8,3,1,21,SPA
e9fbcc21,0,0,0,0,0,0,2,2,0,0,0,1,1,0,0,21,SPA
ea6a7ab4,2,1,0,1,1,2,8,6,1,0,1,0,2,0,0,21,SPA
ea83bfa6,1,0,1,0,0,1,3,2,0,0,0,2,3,14,0,21,SPA
ea9b2ef9,24,11,13,9,2,11,23,12,28,26,2,38,62,130,1,21,SPA
ead61f73,27,11,16,9,2,16,32,16,18,2,16,29,56,58,1,21,SPA
eb3dd471,21,14,11,7,3,7,39,32,23,1,22,20,41,30,0,21,SPA
eb82b6f1,46,30,28,15,3,25,64,39,22,2,20,16,62,14,0,21,SPA
ec1a731e,1,1,0,1,0,0,2,2,2,2,0,1,2,5,0,21,SPA
ecd8c01e,38,28,12,23,3,12,35,23,22,2,20,22,60,7,0,21,SPA
ed3f5f4c,43,28,33,10,0,10,18,8,17,7,10,37,80,92,0,21,SPA
ed5c5fa3,30,22,15,12,3,8,24,16,14,1,13,16,46,24,0,21,SPA
ed6ea4d9,30,17,12,10,8,6,19,13,21,2,19,22,52,13,0,21,SPA
ed9f7cfe,30,17,13,12,5,17,26,9,15,0,15,16,46,18,0,21,SPA
ee8508c0,0,0,0,0,0,0,0,0,0,0,0,0,0,6,2,21,SPA
ee923664,11,5,9,2,0,3,9,6,8,0,8,9,20,18,0,21,SPA
eeba07f8,19,11,5,7,7,6,17,11,10,1,9,8,27,11,0,21,SPA
ef322658,25,12,10,11,4,10,25,15,13,3,10,18,43,19,0,21,SPA
efaefda0,3,2,0,3,0,1,2,1,1,0,1,2,5,3,0,21,SPA
efecd633,25,14,15,7,3,11,31,20,23,8,15,28,53,33,0,21,SPA
f090a37a,5,3,1,3,1,4,8,4,0,0,0,1,6,0,0,21,SPA
f0da930c,20,7,14,5,1,12,17,5,17,11,6,21,41,65,0,21,SPA
f11fe861,26,17,18,8,0,17,31,14,22,14,8,37,63,112,1,21,SPA
f127d782,1,1,0,1,0,1,3,2,0,0,0,2,3,7,0,21,SPA
f1bed920,16,8,8,5,3,7,23,16,10,1,9,20,36,15,1,21,SPA
f28876e5,1,1,0,1,0,1,2,1,0,0,0,0,1,0,0,21,SPA
f2a68b97,18,14,14,4,0,10,18,8,16,3,13,19,37,33,0,21,SPA
f4c69aa6,14,6,5,7,2,5,10,5,16,1,15,5,19,4,1,21,SPA
f520049f,0,0,0,0,0,0,1,1,8,6,2,6,6,12,0,21,SPA
f6798fc3,1,1,1,0,0,0,2,2,0,0,0,0,1,12,2,21,SPA
f681a8ef,10,6,5,5,0,3,10,7,15,1,14,12,22,5,0,21,SPA
f6ac68c1,40,25,32,7,1,21,34,13,33,19,14,42,82,110,0,21,SPA
f6f6b6e8,21,14,14,7,0,8,11,3,15,10,5,46,67,100,0,21,SPA
f7c491f1,6,3,6,0,0,4,6,2,5,4,1,12,18,33,0,21,SPA
f7dc2ae5,30,16,21,7,2,18,22,4,12,5,7,15,45,63,0,21,SPA
f8eca1b6,11,3,0,8,3,4,15,11,11,0,11,2,13,14,0,21,SPA
f934c5c9,0,0,0,0,0,0,0,0,0,0,0,0,0,1,0,21,SPA
faed84db,38,22,16,16,6,16,54,38,33,11,22,26,64,54,0,21,SPA
fb5d47b3,55,34,22,24,9,21,40,19,26,4,22,30,85,47,1,21,SPA
fbd6378b,30,17,20,10,0,10,16,6,21,13,8,39,69,90,0,21,SPA
fce521d7,1,1,0,0,1,0,0,0,1,0,1,0,1,1,0,21,SPA
fd01216a,2,0,0,2,0,0,0,0,0,0,0,0,2,0,0,21,SPA
fd47b4f2,5,2,3,2,0,3,4,1,2,1,1,7,12,23,1,21,SPA
fd51b456,61,37,30,22,9,22,52,30,14,1,13,19,80,31,1,21,SPA
fd771f95,8,4,2,3,3,1,6,5,2,0,2,6,14,7,0,21,SPA
fe05804b,21,12,15,6,0,11,21,10,18,8,10,35,56,91,0,21,SPA
fea23125,0,0,0,0,0,0,1,1,0,0,0,0,0,2,0,21,SPA
fed17f5a,41,24,14,24,3,19,52,33,35,11,24,23,64,41,0,21,SPA
ffacd3d5,27,15,10,10,7,11,26,15,9,0,9,8,35,15,0,21,SPA
005ca692,2,2,2,0,0,0,4,4,2,0,2,4,6,14,0,21,CL
00672021,5,2,2,2,1,3,8,5,3,0,3,2,7,3,0,21,CL
0076ab7f,7,3,4,3,0,1,3,2,7,5,2,4,11,5,1,21,CL
01204d46,2,2,1,1,0,0,0,0,3,2,1,4,6,10,0,21,CL
012c975a,4,3,2,2,0,2,5,3,0,0,0,5,9,13,0,21,CL
016ff750,7,3,5,2,0,5,6,1,5,1,4,2,9,2,0,21,CL
0176f037,11,6,8,1,2,7,15,8,9,0,9,7,18,8,1,21,CL
01b8a2b2,1,0,1,0,0,1,1,0,0,0,0,1,2,5,1,21,CL
01c3aff5,13,10,5,6,2,4,13,9,6,0,6,3,16,3,0,21,CL
01da7812,1,1,0,1,0,0,3,3,2,0,2,2,3,1,0,21,CL
01eb744d,3,1,1,2,0,2,12,10,5,0,5,0,3,8,0,21,CL
028e70b9,0,0,0,0,0,0,1,1,0,0,0,0,0,0,0,21,CL
02c15616,16,9,8,6,2,12,21,9,6,0,6,11,27,11,0,21,CL
02caf6e0,4,2,0,3,1,1,5,4,2,0,2,2,6,2,0,21,CL
0331786b,4,2,2,2,0,0,2,2,1,0,1,6,10,6,0,21,CL
03622183,0,0,0,0,0,0,0,0,0,0,0,0,0,0,0,21,CL
038aa94a,0,0,0,0,0,0,0,0,1,1,0,0,0,3,0,21,CL
042e8a49,7,2,3,1,3,3,7,4,6,0,6,2,9,3,0,21,CL
048a1cbc,7,4,4,3,0,4,6,2,3,0,3,5,12,6,0,21,CL
04e17fd5,1,0,0,1,0,0,1,1,1,0,1,2,3,7,0,21,CL
05439de2,14,7,6,8,0,5,7,2,8,3,5,14,28,19,1,21,CL
056269d7,6,2,5,1,0,5,7,2,3,2,1,10,16,1,0,21,CL
05a84d52,9,4,1,5,3,3,5,2,7,1,6,5,14,11,0,21,CL
05d548d8,12,5,10,2,0,7,12,5,17,10,7,19,31,46,1,21,CL
0630eb63,0,0,0,0,0,0,0,0,0,0,0,0,0,0,0,21,CL
06f33dc8,0,0,0,0,0,0,3,3,2,0,2,0,0,0,0,21,CL
08511d65,2,1,2,0,0,2,3,1,5,2,3,7,9,10,0,21,CL
0880e10b,0,0,0,0,0,0,0,0,0,0,0,0,0,0,0,21,CL
08aa9cd1,0,0,0,0,0,0,1,1,0,0,0,0,0,0,0,21,CL
091c86e2,0,0,0,0,0,0,0,0,1,0,1,0,0,0,0,21,CL
0959c2a2,13,8,5,2,6,6,12,6,10,1,9,17,30,4,0,21,CL
096a77c4,1,0,1,0,0,0,1,1,0,0,0,0,1,0,0,21,CL
0a3d6d2b,8,4,3,3,2,3,4,1,1,1,0,2,10,3,0,21,CL
0a6dbbf7,3,2,2,1,0,2,3,1,0,0,0,5,8,10,0,21,CL
0a721e85,6,3,3,3,0,0,2,2,1,0,1,2,8,3,0,21,CL
0a89e877,9,3,3,5,1,2,4,2,1,0,1,2,11,2,0,21,CL
0ab1f153,12,8,6,6,0,8,18,10,4,1,3,5,17,4,0,21,CL
0b4f388a,3,1,0,2,1,0,5,5,2,0,2,2,5,0,0,21,CL
0ba976e4,1,1,0,0,1,0,3,3,3,1,2,1,2,2,0,21,CL
0be95d34,5,3,1,2,2,2,4,2,1,0,1,3,8,0,0,21,CL
0c2ac3cb,2,0,0,1,1,2,2,0,3,1,2,3,5,2,0,21,CL
0cadc46d,2,0,1,1,0,2,4,2,1,0,1,3,5,1,0,21,CL
0d82903c,10,6,4,3,3,5,13,8,9,1,8,15,25,8,0,21,CL
0d9b2d31,12,7,5,4,3,6,18,12,13,2,11,5,17,3,0,21,CL
0e6bc38c,7,2,3,2,2,2,3,1,6,1,5,0,7,2,0,21,CL
0eac2f24,1,1,1,0,0,1,2,1,0,0,0,1,2,0,0,21,CL
0ef89a37,0,0,0,0,0,0,1,1,2,1,1,1,1,0,0,21,CL
101da2b5,9,2,0,6,3,4,9,5,7,1,6,7,16,4,1,21,CL
10549b49,0,0,0,0,0,0,2,2,1,0,1,1,1,3,0,21,CL
108fe016,2,1,1,1,0,2,3,1,5,1,4,2,4,1,0,21,CL
10fe831e,6,5,3,3,0,3,6,3,8,2,6,11,17,43,1,21,CL
119b9a8e,2,1,1,1,0,1,2,1,1,1,0,4,6,9,0,21,CL
1265a93a,22,15,16,5,1,11,19,8,11,3,8,4,26,24,0,21,CL
129af0db,4,2,0,3,1,0,2,2,8,1,7,4,8,2,0,21,CL
12aa7661,8,5,5,1,2,5,9,4,3,0,3,11,19,11,0,21,CL
1394bf42,0,0,0,0,0,0,0,0,0,0,0,0,0,1,0,21,CL
13ea2544,9,3,4,5,0,3,9,6,0,0,0,0,9,0,0,21,CL
1467af0d,21,10,8,10,3,11,23,12,4,1,3,6,27,2,0,21,CL
148e136f,6,4,1,4,1,0,5,5,3,1,2,0,6,0,0,21,CL
14b8fcdf,0,0,0,0,0,0,0,0,1,1,0,0,0,3,0,21,CL
14e05913,0,0,0,0,0,0,0,0,0,0,0,0,0,1,0,21,CL
14e8fe86,7,5,6,0,1,4,7,3,6,3,3,5,12,2,0,21,CL
15975a3c,1,0,0,1,0,1,2,1,3,3,0,3,4,10,0,21,CL
15d0c248,4,3,2,2,0,3,3,0,5,2,3,4,8,8,0,21,CL
15f3ec41,5,4,2,1,2,1,3,2,3,0,3,4,9,3,0,21,CL
15fd5593,9,5,5,3,1,6,9,3,4,0,4,6,15,11,1,21,CL
169fd162,0,0,0,0,0,0,1,1,2,0,2,2,2,1,0,21,CL
16ceb862,2,1,0,1,1,0,0,0,3,0,3,2,4,2,0,21,CL
17145c90,1,1,0,1,0,1,1,0,0,0,0,0,1,0,0,21,CL
178ae8f8,6,2,3,3,0,1,8,7,7,1,6,2,8,2,0,21,CL
17e3e467,14,9,6,6,2,4,13,9,5,1,4,6,20,4,0,21,CL
1840e36d,0,0,0,0,0,0,1,1,0,0,0,0,0,4,0,21,CL
18b896d6,6,4,2,3,1,4,7,3,13,8,5,5,11,40,0,21,CL
19709006,7,5,1,5,1,1,9,8,4,1,3,2,9,0,0,21,CL
19a967ab,5,1,1,4,0,4,6,2,1,0,1,1,6,3,0,21,CL
19cda00b,15,10,5,8,2,7,23,16,9,1,8,8,23,2,0,21,CL
1a2935f6,1,0,1,0,0,1,6,5,7,1,6,11,12,23,0,21,CL
1a4b9094,1,1,0,1,0,0,2,2,3,0,3,2,3,5,0,21,CL
1a799243,18,12,10,7,1,7,14,7,7,1,6,11,29,8,0,21,CL
1a992676,0,0,0,0,0,0,4,4,4,0,4,7,7,2,0,21,CL
1adcf39e,10,5,8,2,0,7,13,6,1,0,1,11,21,14,1,21,CL
1bacc518,8,5,3,3,2,3,9,6,4,1,3,15,23,7,0,21,CL
1bd5735a,0,0,0,0,0,0,0,0,2,0,2,4,4,6,0,21,CL
1bf33a9a,6,4,2,3,1,3,6,3,7,1,6,3,9,0,0,21,CL
1c07b06e,7,1,0,6,1,3,8,5,5,1,4,9,16,3,2,21,CL
1c78737d,6,3,0,4,2,1,4,3,3,0,3,4,10,2,0,21,CL
1c90cd29,4,2,3,1,0,1,3,2,6,3,3,4,8,4,1,21,CL
1cb49278,3,2,0,3,0,2,5,3,4,4,0,10,13,21,0,21,CL
1d1691ad,4,3,3,1,0,1,1,0,1,0,1,1,5,1,0,21,CL
1d2d5cc8,0,0,0,0,0,0,0,0,0,0,0,0,0,2,0,21,CL
1d5cab82,17,5,7,8,2,6,21,15,6,0,6,8,25,5,0,21,CL
1dbfae2d,7,4,2,5,0,1,3,2,0,0,0,3,10,1,0,21,CL
1e064bfb,0,0,0,0,0,0,0,0,0,0,0,0,0,0,0,21,CL
1e1378e1,2,2,0,2,0,2,6,4,0,0,0,2,4,1,0,21,CL
1e465e70,0,0,0,0,0,0,1,1,0,0,0,0,0,0,0,21,CL
1ec7e1c5,3,2,3,0,0,2,4,2,5,4,1,8,11,25,0,21,CL
1f3afdcb,9,5,7,2,0,4,7,3,10,5,5,9,18,6,0,21,CL
1f44ac21,1,0,1,0,0,1,3,2,3,1,2,3,4,10,0,21,CL
1f9328da,0,0,0,0,0,0,0,0,0,0,0,0,0,0,0,21,CL
20030c06,9,5,6,3,0,5,12,7,5,2,3,3,12,10,1,21,CL
2054d037,1,1,0,0,1,0,1,1,1,0,1,0,1,1,0,21,CL
20df3aaf,0,0,0,0,0,0,3,3,1,0,1,1,1,1,0,21,CL
20e73fac,4,2,2,1,1,2,13,11,7,1,6,5,9,6,0,21,CL
21453b2e,0,0,0,0,0,0,0,0,0,0,0,0,0,0,0,21,CL
21512407,11,5,5,4,2,6,10,4,8,2,6,10,21,14,0,21,CL
22721b88,8,7,5,3,0,4,8,4,2,1,1,10,18,6,0,21,CL
22798128,6,4,3,2,1,1,4,3,4,0,4,5,11,1,0,21,CL
22aba139,3,0,3,0,0,0,2,2,1,0,1,0,3,4,0,21,CL
24051310,19,14,13,6,0,13,20,7,11,3,8,13,32,26,0,21,CL
2475dcc6,3,3,1,1,1,2,4,2,5,0,5,0,3,0,0,21,CL
24f59bb2,7,4,2,3,2,2,3,1,5,2,3,2,9,3,1,21,CL
256ac8f4,2,2,2,0,0,2,4,2,2,2,0,6,8,8,1,21,CL
2690dffa,1,0,1,0,0,1,1,0,0,0,0,0,1,1,0,21,CL
2784f898,20,12,12,6,2,8,12,4,11,6,5,10,30,18,0,21,CL
27d902c8,0,0,0,0,0,0,0,0,1,0,1,0,0,0,1,21,CL
288e1e13,1,1,1,0,0,0,0,0,4,2,2,4,5,9,1,21,CL
28b1f3ce,24,16,11,9,4,12,31,19,7,1,6,0,24,10,0,21,CL
28d596a0,0,0,0,0,0,0,0,0,0,0,0,0,0,0,0,21,CL
28f66c2e,0,0,0,0,0,0,2,2,1,1,0,0,0,3,0,21,CL
2903a856,6,2,3,1,2,5,21,16,4,0,4,2,8,4,0,21,CL
292a652a,2,2,2,0,0,1,1,0,1,0,1,3,5,1,0,21,CL
2944f86f,18,12,8,9,1,5,15,10,8,1,7,18,36,9,0,21,CL
2946f9a1,18,8,12,5,1,11,21,10,8,1,7,12,30,20,0,21,CL
29733c72,0,0,0,0,0,0,0,0,0,0,0,0,0,0,1,21,CL
29c02c9f,7,5,6,1,0,6,15,9,6,2,4,3,10,11,0,21,CL
2a0c8ba4,11,7,3,4,4,7,15,8,1,0,1,6,17,3,0,21,CL
2a1beb34,10,9,2,7,1,4,18,14,5,0,5,12,22,6,0,21,CL
2b09d998,7,5,3,4,0,4,8,4,3,0,3,5,12,3,0,21,CL
2b114be3,7,5,2,2,3,3,14,11,5,0,5,5,12,1,0,21,CL
2b9fdeea,8,6,6,1,1,5,12,7,2,0,2,2,10,2,0,21,CL
2baec6ce,5,3,4,1,0,1,2,1,1,0,1,2,7,11,0,21,CL
2bed3eab,2,1,1,1,0,1,2,1,0,0,0,3,5,5,0,21,CL
2bef2bca,6,3,4,2,0,3,4,1,2,0,2,2,8,2,0,21,CL
2bf50b37,0,0,0,0,0,0,0,0,0,0,0,1,1,0,0,21,CL
2c0558b8,9,6,3,3,3,2,9,7,2,0,2,1,10,0,0,21,CL
2c0f8e9e,2,1,1,0,1,0,1,1,1,0,1,3,5,0,0,21,CL
2c44a35d,3,1,2,1,0,0,2,2,4,0,4,1,4,0,0,21,CL
2cb77ec6,1,0,0,0,1,0,3,3,5,3,2,5,6,5,0,21,CL
2ccd89a3,5,5,1,3,1,3,3,0,1,0,1,2,7,5,0,21,CL
2d61d13a,6,3,5,1,0,1,2,1,10,5,5,6,12,6,1,21,CL
2d970560,11,4,4,5,2,4,7,3,14,3,11,6,17,11,0,21,CL
2db2fd7b,15,6,9,5,1,9,13,4,9,5,4,14,29,17,0,21,CL
2e4f5f03,6,3,4,1,1,3,8,5,7,1,6,6,12,12,0,21,CL
2e7ff968,1,0,1,0,0,0,0,0,0,0,0,0,1,6,0,21,CL
2ebc1b44,4,2,0,3,1,1,7,6,6,0,6,2,6,1,0,21,CL
2ef7c612,11,8,4,4,3,5,11,6,16,1,15,3,14,3,0,21,CL
2f90f6b8,14,9,2,10,2,10,18,8,7,0,7,8,22,4,0,21,CL
2fabebc0,0,0,0,0,0,0,0,0,0,0,0,0,0,2,0,21,CL
2fd337af,1,1,0,1,0,0,2,2,3,2,1,6,7,12,0,21,CL
303636d2,3,2,2,1,0,2,4,2,2,0,2,12,15,10,0,21,CL
30643ce2,0,0,0,0,0,0,0,0,0,0,0,0,0,0,0,21,CL
30941e96,15,7,7,7,1,7,10,3,8,0,8,2,17,6,0,21,CL
30d4a2e5,5,3,3,2,0,5,8,3,2,0,2,12,17,11,0,21,CL
30f5ffa9,6,3,5,1,0,2,5,3,3,2,1,2,8,4,0,21,CL
31114001,11,7,7,4,0,5,11,6,8,4,4,5,16,3,0,21,CL
31c69ef1,14,8,5,7,2,5,8,3,12,8,4,16,30,23,0,21,CL
32314605,5,4,5,0,0,4,7,3,1,0,1,8,13,3,0,21,CL
335fa267,6,5,2,3,1,3,5,2,0,0,0,4,10,2,0,21,CL
3376a776,3,1,0,2,1,2,4,2,2,1,1,4,7,5,0,21,CL
33887998,0,0,0,0,0,0,0,0,0,0,0,0,0,3,1,21,CL
339fe0e8,0,0,0,0,0,0,0,0,0,0,0,0,0,0,0,21,CL
33b11df6,4,3,2,2,0,3,8,5,1,0,1,2,6,1,0,21,CL
33b8d077,6,3,1,3,2,1,7,6,12,3,9,4,10,0,0,21,CL
34b54da7,0,0,0,0,0,0,1,1,2,2,0,2,2,1,0,21,CL
34c3b935,0,0,0,0,0,0,0,0,0,0,0,0,0,1,0,21,CL
34caa4b3,6,4,0,4,2,2,9,7,1,1,0,0,6,3,0,21,CL
36a3ff67,12,8,5,6,1,3,11,8,8,2,6,7,19,7,0,21,CL
36a59ba4,24,12,13,8,3,15,22,7,9,3,6,9,33,8,0,21,CL
36a79857,1,0,0,1,0,0,3,3,2,0,2,1,2,0,0,21,CL
378825c7,15,9,10,5,0,10,16,6,10,0,10,11,26,19,2,21,CL
37e103f8,1,1,0,0,1,1,1,0,0,0,0,0,1,0,0,21,CL
3814b753,5,1,3,0,2,0,5,5,5,0,5,3,8,4,0,21,CL
384d58d9,10,7,8,2,0,4,7,3,2,1,1,3,13,4,0,21,CL
38c7feef,1,1,0,0,1,0,0,0,0,0,0,0,1,0,0,21,CL
392a7aea,5,3,2,3,0,2,8,6,4,0,4,8,13,6,0,21,CL
39769cff,13,7,10,2,1,10,13,3,7,3,4,13,26,17,0,21,CL
3b1ed320,1,1,1,0,0,1,1,0,0,0,0,1,2,0,0,21,CL
3b333ac3,9,4,5,2,2,6,15,9,6,1,5,7,16,9,0,21,CL
3b8674e6,13,12,5,8,0,6,10,4,8,1,7,10,23,9,1,21,CL
3bb7b8b4,0,0,0,0,0,0,1,1,0,0,0,0,0,5,1,21,CL
3c6089ab,7,3,3,0,4,4,14,10,9,2,7,3,10,3,0,21,CL
3cdfc63e,5,3,3,2,0,2,7,5,5,3,2,16,21,21,0,21,CL
3cefcaef,13,6,7,5,1,8,17,9,7,1,6,13,26,14,1,21,CL
3d2320f7,3,0,0,2,1,1,4,3,3,1,2,5,8,2,1,21,CL
3d50bcdb,2,1,1,1,0,1,3,2,4,0,4,3,5,4,0,21,CL
3eb22ec9,12,8,1,7,4,5,15,10,11,1,10,4,16,5,1,21,CL
3eed9821,1,0,0,1,0,0,1,1,1,0,1,0,1,0,0,21,CL
3ef0af0d,10,4,3,4,3,3,7,4,5,1,4,9,19,2,0,21,CL
3f10bd22,4,4,2,1,1,3,5,2,1,0,1,7,11,2,0,21,CL
3f65d5ce,0,0,0,0,0,0,0,0,0,0,0,0,0,1,0,21,CL
3f79a1c8,2,1,2,0,0,2,6,4,2,0,2,4,6,0,0,21,CL
4030c7ae,1,1,1,0,0,1,1,0,0,0,0,0,1,1,2,21,CL
40676b27,5,4,4,1,0,3,5,2,5,1,4,3,8,3,0,21,CL
41034650,0,0,0,0,0,0,0,0,0,0,0,0,0,0,0,21,CL
414e1f69,0,0,0,0,0,0,0,0,1,0,1,0,0,0,0,21,CL
41e7ef1c,14,10,8,3,3,8,11,3,7,1,6,8,22,13,0,21,CL
41f0b196,0,0,0,0,0,0,2,2,0,0,0,1,1,2,1,21,CL
41f32541,8,3,4,4,0,3,10,7,6,1,5,10,18,7,0,21,CL
420c18a1,0,0,0,0,0,0,0,0,0,0,0,0,0,2,0,21,CL
42130443,0,0,0,0,0,0,0,0,0,0,0,0,0,0,0,21,CL
42dcf26d,8,7,5,3,0,5,10,5,5,2,3,7,15,13,0,21,CL
42fd9c7f,2,1,2,0,0,0,5,5,1,0,1,1,3,7,0,21,CL
4315f30d,2,1,2,0,0,1,1,0,5,5,0,6,8,24,1,21,CL
4352d221,1,1,0,0,1,0,0,0,1,0,1,1,2,0,0,21,CL
436a9dd0,20,12,5,13,2,6,21,15,25,7,18,13,33,11,0,21,CL
43a166b4,2,2,0,2,0,1,4,3,2,0,2,0,2,3,0,21,CL
43b78598,3,0,1,2,0,0,1,1,2,1,1,3,6,3,0,21,CL
43cd8b69,1,0,0,0,1,1,1,0,1,0,1,0,1,2,0,21,CL
4431aed2,2,1,0,2,0,0,4,4,3,0,3,1,3,0,0,21,CL
448a3608,0,0,0,0,0,0,3,3,1,1,0,0,0,2,0,21,CL
44eb9093,8,3,1,3,4,0,5,5,0,0,0,7,15,4,0,21,CL
45a03961,12,5,4,7,1,6,10,4,5,0,5,10,22,16,0,21,CL
45af8a54,6,6,2,1,3,3,7,4,5,0,5,4,10,0,0,21,CL
45b9b619,4,4,2,2,0,1,9,8,3,1,2,1,5,4,0,21,CL
45db685d,26,17,8,14,4,13,35,22,18,5,13,26,52,14,0,21,CL
4601e194,5,5,1,4,0,2,5,3,4,2,2,6,11,6,0,21,CL
467bae22,3,2,0,3,0,2,4,2,1,1,0,1,4,0,0,21,CL
468fdbad,2,0,1,1,0,1,2,1,2,0,2,1,3,0,0,21,CL
47fd5136,3,3,0,2,1,1,4,3,6,5,1,9,12,15,0,21,CL
48035304,15,6,13,2,0,5,5,0,13,7,6,11,26,32,0,21,CL
489e80e3,15,8,4,9,2,7,19,12,10,0,10,11,26,2,0,21,CL
48b3dd60,7,6,4,2,1,4,8,4,1,0,1,2,9,1,0,21,CL
48d5bd33,3,3,1,2,0,2,6,4,3,0,3,3,6,0,0,21,CL
49296448,13,4,7,5,1,2,20,18,6,1,5,12,25,8,1,21,CL
4958bfb2,3,1,0,0,3,2,2,0,3,0,3,2,5,1,0,21,CL
496aeede,9,5,4,5,0,3,19,16,12,4,8,11,20,6,0,21,CL
49b45985,0,0,0,0,0,0,0,0,0,0,0,0,0,1,0,21,CL
49fe9070,6,4,2,4,0,2,13,11,9,0,9,6,12,3,0,21,CL
4a1a9578,8,3,4,4,0,3,8,5,2,0,2,2,10,2,0,21,CL
4aea5077,21,12,8,8,5,13,19,6,16,3,13,11,32,25,0,21,CL
4b6960d2,0,0,0,0,0,0,0,0,2,1,1,0,0,1,0,21,CL
4b77bb89,0,0,0,0,0,0,0,0,0,0,0,0,0,0,0,21,CL
4b803b3c,10,7,9,1,0,3,11,8,5,4,1,11,21,31,0,21,CL
4c14af32,3,3,1,0,2,1,2,1,0,0,0,0,3,0,0,21,CL
4c184730,1,1,0,0,1,0,0,0,0,0,0,0,1,0,0,21,CL
4c2a5d34,0,0,0,0,0,0,2,2,3,1,2,2,2,2,0,21,CL
4c2fa917,0,0,0,0,0,0,0,0,0,0,0,0,0,0,0,21,CL
4c32fb38,0,0,0,0,0,0,0,0,0,0,0,0,0,0,0,21,CL
4c370d81,3,2,3,0,0,1,4,3,5,0,5,2,5,4,0,21,CL
4c3a6744,2,1,1,0,1,0,4,4,2,0,2,2,4,0,0,21,CL
4c78b5ed,6,4,5,1,0,3,11,8,3,0,3,10,16,7,0,21,CL
4d034881,1,0,1,0,0,0,1,1,2,0,2,0,1,0,0,21,CL
4d1666ff,3,1,2,1,0,3,3,0,7,4,3,6,9,13,0,21,CL
4d224fe8,23,13,11,12,0,8,25,17,18,3,15,18,41,12,0,21,CL
4d8cd038,1,0,0,0,1,0,0,0,0,0,0,0,1,0,0,21,CL
4dbd0916,5,2,2,3,0,4,7,3,4,0,4,0,5,3,0,21,CL
4e219ad2,6,4,1,2,3,3,5,2,0,0,0,2,8,0,0,21,CL
4e3f5992,3,1,2,1,0,0,2,2,1,0,1,2,5,3,0,21,CL
4e6dbac4,9,5,5,4,0,3,13,10,10,2,8,15,24,10,2,21,CL
4f1e6a0b,6,4,1,3,2,1,4,3,7,0,7,0,6,0,0,21,CL
4f28a6ff,7,3,4,2,1,3,8,5,1,0,1,11,18,13,1,21,CL
4fa7cb9b,1,1,0,0,1,1,1,0,1,0,1,1,2,0,0,21,CL
4fb9c88f,6,3,3,3,0,2,4,2,6,1,5,7,13,4,0,21,CL
501055d8,0,0,0,0,0,0,0,0,1,0,1,0,0,0,0,21,CL
5042e5c2,0,0,0,0,0,0,0,0,0,0,0,0,0,0,0,21,CL
507c7bdf,9,6,2,4,3,1,11,10,5,0,5,4,13,2,0,21,CL
50871bcc,8,7,4,3,1,3,8,5,7,1,6,3,11,0,0,21,CL
50dc94ce,5,2,1,0,4,2,3,1,2,0,2,2,7,1,0,21,CL
5148dcc5,4,4,2,2,0,3,6,3,3,0,3,4,8,2,0,21,CL
515ebe8d,5,3,3,2,0,2,5,3,8,4,4,6,11,11,0,21,CL
51a3c4c8,10,6,6,3,1,6,9,3,6,4,2,7,17,27,0,21,CL
51cf8561,12,7,7,5,0,7,12,5,7,1,6,4,16,12,0,21,CL
51dbeea9,1,1,1,0,0,1,2,1,1,1,0,2,3,1,0,21,CL
520c318f,3,0,2,0,1,2,6,4,5,0,5,1,4,7,0,21,CL
52611641,3,2,0,3,0,1,3,2,0,0,0,2,5,1,0,21,CL
5271c8f1,1,0,0,0,1,0,1,1,1,0,1,2,3,0,0,21,CL
527f063d,1,0,0,1,0,1,3,2,2,0,2,0,1,0,0,21,CL
5294a83f,17,5,9,3,5,6,21,15,5,2,3,4,21,2,0,21,CL
52e101a8,2,0,2,0,0,2,2,0,0,0,0,1,3,3,0,21,CL
52ec54d0,5,1,2,3,0,3,5,2,2,2,0,8,13,9,0,21,CL
53cad200,26,14,14,11,1,16,23,7,21,9,12,11,37,31,0,21,CL
53de807a,2,1,0,1,1,1,1,0,2,2,0,2,4,6,0,21,CL
54f5ce34,5,2,3,2,0,1,2,1,6,4,2,5,10,10,0,21,CL
55126f3b,16,10,6,5,5,10,30,20,9,3,6,11,27,4,0,21,CL
5526deb1,0,0,0,0,0,0,0,0,1,0,1,0,0,0,0,21,CL
552e00b9,2,2,0,1,1,2,3,1,1,0,1,1,3,0,0,21,CL
555f3a0b,11,7,6,5,0,6,11,5,7,2,5,7,18,12,1,21,CL
55abe554,9,6,5,3,1,7,9,2,3,2,1,9,18,9,0,21,CL
5715bb71,0,0,0,0,0,0,0,0,3,0,3,2,2,0,0,21,CL
5722eced,8,5,4,2,2,2,9,7,2,0,2,2,10,0,0,21,CL
57d88cf9,24,9,7,9,8,8,16,8,19,2,17,5,29,8,0,21,CL
580d52dd,1,0,1,0,0,0,4,4,4,1,3,7,8,6,0,21,CL
58a9a4d9,7,5,3,4,0,3,8,5,2,0,2,2,9,1,0,21,CL
58ae47b2,3,2,1,1,1,0,0,0,3,0,3,1,4,1,0,21,CL
58dda688,2,2,0,2,0,2,5,3,6,5,1,10,12,21,1,21,CL
58eee997,0,0,0,0,0,0,0,0,1,0,1,1,1,0,0,21,CL
5976f83e,9,7,3,5,1,5,10,5,6,1,5,2,11,7,0,21,CL
5ab0ea87,8,3,2,3,3,5,12,7,3,0,3,1,9,1,0,21,CL
5b54bf3b,0,0,0,0,0,0,1,1,5,0,5,0,0,0,0,21,CL
5c4dc0ff,0,0,0,0,0,0,1,1,1,0,1,0,0,0,0,21,CL
5c899683,1,1,0,1,0,0,0,0,3,0,3,0,1,2,0,21,CL
5caa62a7,0,0,0,0,0,0,1,1,1,0,1,0,0,0,0,21,CL
5cb1d026,12,5,9,1,2,4,20,16,9,2,7,7,19,13,0,21,CL
5d0e0a1f,9,6,6,1,2,4,8,4,1,0,1,5,14,7,0,21,CL
5da33b33,3,1,1,1,1,1,2,1,1,0,1,2,5,0,0,21,CL
5dfc6ad5,8,6,2,3,3,1,5,4,1,1,0,7,15,5,0,21,CL
5e74d6c8,1,0,0,1,0,0,0,0,1,0,1,1,2,2,0,21,CL
5eae500a,0,0,0,0,0,0,1,1,3,0,3,0,0,5,0,21,CL
5ed9b537,10,3,6,4,0,3,7,4,7,5,2,7,17,12,0,21,CL
5eecec3d,8,4,2,4,2,2,3,1,8,7,1,9,17,24,1,21,CL
5ef3d210,1,0,0,1,0,1,1,0,0,0,0,0,1,0,0,21,CL
5fcb90ac,4,2,3,1,0,3,7,4,2,0,2,2,6,1,0,21,CL
5fd5e542,12,9,7,4,1,5,15,10,8,1,7,18,30,12,0,21,CL
6025fab1,13,7,8,4,1,8,26,18,3,2,1,18,31,1,0,21,CL
603116a7,5,3,0,3,2,4,4,0,1,0,1,0,5,0,0,21,CL
6043997c,4,3,1,3,0,3,3,0,0,0,0,6,10,3,0,21,CL
608f2092,0,0,0,0,0,0,0,0,1,0,1,2,2,0,0,21,CL
60c07b31,5,3,5,0,0,1,5,4,2,1,1,1,6,12,0,21,CL
60e86875,7,3,5,2,0,4,14,10,2,0,2,3,10,2,0,21,CL
620922ed,0,0,0,0,0,0,0,0,0,0,0,0,0,1,0,21,CL
62d7ef38,0,0,0,0,0,0,0,0,0,0,0,0,0,0,0,21,CL
63b9cc6d,1,0,0,1,0,0,0,0,0,0,0,1,2,0,0,21,CL
63e905bc,0,0,0,0,0,0,0,0,0,0,0,0,0,0,0,21,CL
6412cc03,5,2,4,0,1,2,3,1,1,0,1,1,6,1,0,21,CL
6421ec64,1,0,1,0,0,1,3,2,5,0,5,3,4,1,0,21,CL
6434f10d,11,8,2,8,1,4,16,12,7,1,6,9,20,9,2,21,CL
652d4c37,1,0,0,1,0,0,2,2,3,0,3,1,2,2,0,21,CL
6622454d,9,6,2,3,4,3,11,8,2,0,2,4,13,2,0,21,CL
6639e500,6,4,1,5,0,3,6,3,5,0,5,1,7,0,0,21,CL
6747869d,1,1,0,1,0,0,3,3,10,1,9,2,3,2,0,21,CL
675b0427,3,1,1,0,2,1,3,2,6,4,2,9,12,26,0,21,CL
67cdbc0e,12,8,2,9,1,4,11,7,5,0,5,6,18,3,1,21,CL
67f0703d,5,2,3,2,0,2,5,3,5,4,1,12,17,20,0,21,CL
68252d6d,5,2,3,0,2,4,8,4,1,0,1,1,6,1,0,21,CL
6853490f,1,1,0,0,1,0,3,3,2,0,2,1,2,0,0,21,CL
691bef82,9,5,1,8,0,2,6,4,5,2,3,5,14,14,2,21,CL
6928979a,14,11,2,9,3,4,15,11,4,0,4,6,20,0,0,21,CL
69384e5d,5,3,1,3,1,2,14,12,5,1,4,3,8,0,0,21,CL
6a2b9aee,0,0,0,0,0,0,1,1,1,1,0,0,0,0,0,21,CL
6b21b7b5,0,0,0,0,0,0,0,0,0,0,0,0,0,0,0,21,CL
6b6cbca4,1,0,1,0,0,1,2,1,4,4,0,5,6,12,1,21,CL
6b8887c2,0,0,0,0,0,0,1,1,0,0,0,0,0,0,0,21,CL
6b915aa1,7,5,3,3,1,2,6,4,9,0,9,7,14,7,0,21,CL
6be41a31,2,1,2,0,0,1,1,0,1,0,1,1,3,0,0,21,CL
6c811eb7,1,1,0,1,0,0,2,2,2,2,0,0,1,2,0,21,CL
6ce1f46f,19,6,10,8,1,9,26,17,11,2,9,19,38,3,0,21,CL
6ce43701,0,0,0,0,0,0,0,0,2,0,2,0,0,0,0,21,CL
6ceef869,10,7,9,1,0,7,10,3,7,7,0,11,21,25,0,21,CL
6d7e4b06,1,1,0,1,0,1,2,1,2,1,1,4,5,4,0,21,CL
6e4df551,3,3,0,2,1,2,10,8,6,2,4,3,6,0,0,21,CL
6e7f1353,9,6,3,4,2,2,11,9,6,0,6,5,14,0,0,21,CL
6eee05f1,11,4,8,3,0,2,10,8,7,6,1,24,35,34,0,21,CL
6f3cc2fe,0,0,0,0,0,0,1,1,1,0,1,0,0,2,0,21,CL
6f51e382,0,0,0,0,0,0,0,0,0,0,0,0,0,2,0,21,CL
6f8cd6d0,5,3,3,2,0,2,10,8,14,2,12,6,11,6,0,21,CL
6fe90922,2,1,0,2,0,0,6,6,1,0,1,3,5,3,0,21,CL
70d74ece,8,2,1,5,2,2,3,1,3,1,2,2,10,2,0,21,CL
7111d552,11,8,4,4,3,4,11,7,10,1,9,1,12,3,0,21,CL
7120a04d,5,3,3,1,1,3,12,9,9,0,9,3,8,5,0,21,CL
7155e3e1,4,3,2,2,0,2,2,0,1,0,1,7,11,2,0,21,CL
715e5b0e,3,3,0,3,0,2,6,4,1,0,1,2,5,0,0,21,CL
7272a72a,4,3,4,0,0,0,4,4,5,0,5,0,4,3,0,21,CL
72c812f3,18,10,9,7,2,3,9,6,14,2,12,5,23,9,0,21,CL
733e7ad8,1,0,1,0,0,0,2,2,1,0,1,8,9,8,0,21,CL
73affbb6,0,0,0,0,0,0,6,6,3,1,2,1,1,1,0,21,CL
73d6a176,1,0,0,0,1,0,2,2,2,0,2,2,3,0,0,21,CL
73fc8cc3,1,0,1,0,0,0,0,0,1,0,1,1,2,0,0,21,CL
74419746,0,0,0,0,0,0,1,1,1,0,1,0,0,2,0,21,CL
746fec7d,0,0,0,0,0,0,0,0,1,0,1,1,1,0,0,21,CL
74733221,0,0,0,0,0,0,0,0,0,0,0,0,0,1,0,21,CL
7483d9f9,8,3,4,4,0,3,6,3,10,5,5,12,20,30,0,21,CL
75b86fb3,5,2,3,2,0,3,7,4,1,0,1,4,9,8,0,21,CL
768b28d0,0,0,0,0,0,0,0,0,1,0,1,0,0,4,0,21,CL
76d5857d,6,3,4,1,1,2,5,3,6,4,2,8,14,18,0,21,CL
7713c72a,6,4,5,1,0,4,7,3,13,6,7,10,16,33,0,21,CL
77e39b04,5,4,0,1,4,0,7,7,4,0,4,2,7,0,0,21,CL
77e84962,10,8,5,3,2,1,2,1,4,1,3,3,13,5,1,21,CL
780e3631,9,4,5,2,2,5,11,6,8,4,4,11,20,2,0,21,CL
79300479,2,1,0,1,1,2,4,2,0,0,0,0,2,1,0,21,CL
79c0821a,13,11,7,6,0,8,16,8,4,0,4,7,20,5,0,21,CL
7a11550b,4,2,3,1,0,1,4,3,0,0,0,5,9,19,0,21,CL
7a2e46a8,1,0,1,0,0,1,1,0,0,0,0,0,1,4,0,21,CL
7a435eb3,0,0,0,0,0,0,0,0,0,0,0,0,0,1,0,21,CL
7a4cea18,4,2,1,3,0,0,1,1,2,0,2,1,5,0,0,21,CL
7b456af7,0,0,0,0,0,0,1,1,0,0,0,0,0,0,0,21,CL
7b9c2d84,6,3,0,3,3,2,9,7,4,2,2,6,12,1,0,21,CL
7ba6d84e,0,0,0,0,0,0,0,0,0,0,0,0,0,3,0,21,CL
7c3ed041,2,0,1,1,0,1,3,2,2,1,1,7,9,2,0,21,CL
7c56da38,18,17,4,7,7,8,14,6,15,0,15,8,26,2,0,21,CL
7cd6badb,13,4,6,5,2,1,13,12,6,1,5,5,18,1,0,21,CL
7cf431a5,4,2,2,2,0,1,5,4,3,0,3,1,5,3,0,21,CL
7f3b388c,19,13,11,7,1,10,14,4,10,3,7,13,32,28,0,21,CL
7f97771d,2,1,1,1,0,0,2,2,3,1,2,11,13,5,0,21,CL
7fa4e703,4,1,1,2,1,1,7,6,2,1,1,4,8,5,0,21,CL
7fd58fe3,3,1,1,2,0,1,6,5,1,0,1,3,6,0,0,21,CL
807e869a,3,3,2,1,0,1,7,6,4,1,3,4,7,4,0,21,CL
8104e41e,10,5,5,5,0,2,4,2,2,0,2,5,15,1,0,21,CL
81442ecb,9,8,6,1,2,3,4,1,7,0,7,3,12,5,0,21,CL
819b3158,15,4,3,10,2,4,14,10,8,0,8,11,26,5,0,21,CL
81d3318f,6,3,4,0,2,5,11,6,1,0,1,0,6,2,0,21,CL
82a39b66,0,0,0,0,0,0,0,0,0,0,0,2,2,0,0,21,CL
833a8fbc,9,6,7,1,1,5,8,3,7,3,4,8,17,20,0,21,CL
83e1f40e,0,0,0,0,0,0,0,0,0,0,0,0,0,0,0,21,CL
853b7c48,1,0,1,0,0,1,2,1,0,0,0,1,2,7,0,21,CL
85686f86,1,0,1,0,0,1,2,1,7,0,7,2,3,1,0,21,CL
862fa9fb,1,1,1,0,0,1,4,3,4,3,1,7,8,21,0,21,CL
864db10a,0,0,0,0,0,0,0,0,0,0,0,1,1,0,0,21,CL
866c67e9,0,0,0,0,0,0,1,1,0,0,0,3,3,7,0,21,CL
867239d3,3,2,0,2,1,1,5,4,3,0,3,3,6,3,0,21,CL
8690eef7,1,0,0,1,0,1,3,2,1,0,1,1,2,0,0,21,CL
8696bc90,4,1,2,2,0,1,3,2,2,0,2,1,5,0,0,21,CL
86dd16a8,5,3,4,1,0,2,9,7,5,3,2,16,21,29,0,21,CL
86dd77d1,23,12,8,9,6,10,14,4,6,1,5,14,37,17,0,21,CL
86e7deaf,6,3,4,2,0,3,6,3,7,3,4,8,14,23,0,21,CL
873619c6,0,0,0,0,0,0,0,0,0,0,0,0,0,0,0,21,CL
875898c7,14,8,14,0,0,10,13,3,4,0,4,7,21,31,1,21,CL
8778c910,0,0,0,0,0,0,1,1,0,0,0,0,0,5,1,21,CL
8794e251,18,12,8,7,3,7,15,8,3,0,3,16,34,5,0,21,CL
886f9aac,3,3,1,1,1,2,7,5,4,0,4,5,8,0,0,21,CL
88968486,2,1,2,0,0,2,7,5,6,5,1,8,10,34,0,21,CL
88e357ef,4,1,2,2,0,2,7,5,5,0,5,6,10,2,0,21,CL
892d5bb1,13,7,0,7,6,5,15,10,11,2,9,6,19,3,0,21,CL
8954fddc,3,2,1,1,1,1,1,0,2,0,2,0,3,6,0,21,CL
89ac64a6,12,5,8,4,0,4,11,7,9,3,6,8,20,16,0,21,CL
89f951b5,8,5,3,3,2,4,12,8,5,1,4,6,14,5,0,21,CL
8a1d7b51,9,6,5,1,3,4,7,3,6,3,3,5,14,12,1,21,CL
8aafd64f,6,5,1,3,2,3,8,5,2,0,2,4,10,3,0,21,CL
8b298f56,8,5,1,6,1,2,5,3,2,0,2,2,10,0,0,21,CL
8b3ab7ad,3,0,1,1,1,0,1,1,3,2,1,3,6,5,0,21,CL
8b3d765f,0,0,0,0,0,0,0,0,0,0,0,0,0,0,0,21,CL
8b683d09,1,0,0,1,0,0,4,4,1,1,0,2,3,2,0,21,CL
8b788c01,0,0,0,0,0,0,1,1,2,0,2,3,3,3,0,21,CL
8b8e759d,11,2,6,2,3,6,13,7,8,3,5,5,16,8,0,21,CL
8bc373ea,8,2,5,3,0,1,2,1,8,7,1,17,25,20,0,21,CL
8ce30c57,2,0,2,0,0,1,7,6,3,2,1,4,6,5,0,21,CL
8d78e732,2,1,1,0,1,1,2,1,6,1,5,2,4,4,0,21,CL
8e034340,4,4,0,3,1,1,2,1,0,0,0,1,5,2,0,21,CL
8e7f49d3,12,9,10,2,0,6,14,8,9,4,5,15,27,10,0,21,CL
8e8f40e0,1,0,1,0,0,1,3,2,0,0,0,1,2,2,0,21,CL
8f5e92a6,7,2,5,2,0,4,9,5,5,0,5,2,9,2,0,21,CL
8fd9996f,10,7,9,0,1,3,8,5,11,6,5,20,30,44,0,21,CL
8ff2354e,2,1,1,1,0,1,3,2,0,0,0,3,5,6,0,21,CL
903b6e8b,0,0,0,0,0,0,0,0,0,0,0,2,2,2,0,21,CL
90463dba,4,4,1,3,0,3,3,0,1,0,1,3,7,0,0,21,CL
9139bb12,6,3,3,3,0,5,12,7,1,1,0,2,8,3,1,21,CL
91899ca8,1,1,1,0,0,0,0,0,0,0,0,0,1,1,1,21,CL
921f6058,4,3,2,1,1,0,2,2,3,2,1,6,10,4,0,21,CL
922da988,5,3,3,1,1,2,10,8,3,0,3,4,9,2,0,21,CL
923f4dda,1,0,1,0,0,1,2,1,2,0,2,1,2,2,0,21,CL
92432bc6,16,8,4,11,1,10,20,10,8,0,8,9,25,4,0,21,CL
928a4a61,7,5,3,3,1,3,9,6,8,2,6,5,12,3,1,21,CL
934e1968,4,1,2,0,2,1,8,7,6,1,5,3,7,10,0,21,CL
935e6b8f,1,1,1,0,0,1,5,4,5,2,3,7,8,8,0,21,CL
93b891d1,0,0,0,0,0,0,0,0,0,0,0,0,0,0,0,21,CL
93fffbcf,0,0,0,0,0,0,0,0,0,0,0,0,0,0,0,21,CL
947e036f,15,10,6,8,1,5,25,20,12,1,11,4,19,8,0,21,CL
94b2001f,18,10,11,7,0,13,18,5,7,3,4,20,38,10,0,21,CL
94f8d10c,3,1,3,0,0,1,3,2,3,3,0,5,8,14,0,21,CL
9614b550,6,2,4,2,0,2,2,0,3,1,2,20,26,19,1,21,CL
9674002f,16,8,7,8,1,5,14,9,10,0,10,10,26,1,0,21,CL
9686fc54,0,0,0,0,0,0,0,0,9,9,0,6,6,22,0,21,CL
96e0490d,2,2,2,0,0,2,6,4,3,0,3,2,4,2,0,21,CL
9744ff80,3,3,1,2,0,0,3,3,2,1,1,2,5,1,0,21,CL
9778d8dd,2,0,0,2,0,1,4,3,2,0,2,3,5,3,0,21,CL
980522ec,0,0,0,0,0,0,1,1,0,0,0,3,3,0,0,21,CL
98d2c2c4,19,8,6,10,3,8,19,11,7,1,6,11,30,6,0,21,CL
99127249,7,3,4,3,0,0,9,9,7,1,6,3,10,2,0,21,CL
9a1f2e1c,21,9,11,8,2,9,26,17,13,2,11,12,33,12,0,21,CL
9a2e0ccc,2,1,1,0,1,0,2,2,0,0,0,1,3,0,0,21,CL
9c2b4382,1,1,0,0,1,0,0,0,0,0,0,0,1,0,0,21,CL
9c94165b,7,5,2,4,1,4,4,0,3,0,3,8,15,6,0,21,CL
9d12e142,0,0,0,0,0,0,0,0,0,0,0,1,1,0,0,21,CL
9d60028d,2,1,1,1,0,2,3,1,1,0,1,2,4,3,0,21,CL
9d689a5b,10,6,2,7,1,5,12,7,3,0,3,3,13,4,0,21,CL
9dc96f10,0,0,0,0,0,0,0,0,0,0,0,0,0,0,0,21,CL
9ddb85e8,2,2,1,1,0,0,1,1,4,0,4,0,2,1,0,21,CL
9e1035f8,4,2,0,3,1,0,1,1,1,0,1,3,7,1,0,21,CL
9e525177,14,6,9,4,1,9,12,3,10,2,8,9,23,15,0,21,CL
9f1893b9,1,1,0,1,0,0,2,2,1,0,1,4,5,0,0,21,CL
9f8e9423,11,4,8,2,1,2,4,2,5,3,2,14,25,32,1,21,CL
9fc2531b,0,0,0,0,0,0,1,1,0,0,0,0,0,0,0,21,CL
a08b974a,4,0,0,1,3,1,13,12,12,1,11,6,10,4,0,21,CL
a0b4bb3e,2,0,1,1,0,2,4,2,2,0,2,3,5,1,0,21,CL
a0f9b535,0,0,0,0,0,0,0,0,1,0,1,1,1,0,0,21,CL
a167537f,4,2,2,2,0,2,4,2,0,0,0,0,4,4,0,21,CL
a1d5bd30,1,1,0,1,0,1,5,4,3,0,3,0,1,3,0,21,CL
a39bb753,0,0,0,0,0,0,0,0,0,0,0,2,2,0,0,21,CL
a3b0ed18,1,1,1,0,0,1,1,0,0,0,0,0,1,4,1,21,CL
a3b952f8,0,0,0,0,0,0,0,0,0,0,0,0,0,2,1,21,CL
a3d94a58,18,9,13,3,2,4,13,9,19,6,13,30,48,28,0,21,CL
a4b1028a,6,4,5,1,0,4,9,5,6,1,5,11,17,12,0,21,CL
a4e16ab4,1,0,0,1,0,1,3,2,0,0,0,1,2,2,0,21,CL
a4effc55,1,0,1,0,0,0,0,0,1,1,0,1,2,7,0,21,CL
a6154613,1,1,0,1,0,0,0,0,3,2,1,1,2,5,0,21,CL
a65ce836,7,5,5,2,0,3,8,5,11,7,4,5,12,13,1,21,CL
a793f5a8,0,0,0,0,0,0,1,1,0,0,0,0,0,0,0,21,CL
a802405e,0,0,0,0,0,0,4,4,2,0,2,4,4,3,0,21,CL
a81ed730,2,0,1,1,0,0,3,3,1,1,0,5,7,3,0,21,CL
a8542814,5,3,2,3,0,4,6,2,7,4,3,6,11,3,0,21,CL
a8567629,7,6,3,3,1,3,7,4,2,0,2,4,11,13,1,21,CL
a9142dc3,2,1,0,2,0,1,1,0,1,0,1,2,4,0,0,21,CL
a9aa0d1d,0,0,0,0,0,0,1,1,0,0,0,2,2,1,0,21,CL
a9be27f2,8,4,7,1,0,3,9,6,9,6,3,13,21,19,1,21,CL
a9dc785c,0,0,0,0,0,0,0,0,0,0,0,0,0,0,0,21,CL
ab1b205d,1,0,0,1,0,1,6,5,1,0,1,0,1,0,0,21,CL
abb3bb95,3,1,1,1,1,2,4,2,3,0,3,1,4,1,0,21,CL
ac4003af,0,0,0,0,0,0,1,1,0,0,0,0,0,0,2,21,CL
ac73ec79,14,9,9,4,1,7,15,8,9,1,8,19,33,16,3,21,CL
ac7e640b,0,0,0,0,0,0,0,0,0,0,0,0,0,0,0,21,CL
ad6df2d5,4,3,1,1,2,2,10,8,5,0,5,12,16,2,1,21,CL
adfbe1f5,5,5,1,2,2,2,7,5,3,1,2,4,9,4,0,21,CL
adfc9123,3,2,0,3,0,1,1,0,3,2,1,3,6,6,0,21,CL
ae44e8e2,10,7,2,7,1,3,12,9,6,0,6,6,16,3,0,21,CL
ae9898c5,0,0,0,0,0,0,0,0,0,0,0,1,1,0,0,21,CL
aef6e670,13,7,9,4,0,2,8,6,9,4,5,5,18,41,1,21,CL
afb0c500,0,0,0,0,0,0,0,0,0,0,0,0,0,1,0,21,CL
b0616e3d,1,0,1,0,0,0,1,1,2,0,2,2,3,1,0,21,CL
b088363d,4,2,3,1,0,2,5,3,1,0,1,7,11,4,0,21,CL
b0b902c8,5,4,4,1,0,5,7,2,2,0,2,3,8,7,0,21,CL
b0c7a51d,9,4,7,2,0,5,9,4,8,3,5,12,21,21,0,21,CL
b0f7e36c,9,5,3,3,3,3,12,9,5,0,5,1,10,4,0,21,CL
b105919e,4,3,0,2,2,1,1,0,1,0,1,0,4,0,0,21,CL
b1579026,1,0,1,0,0,1,7,6,5,2,3,6,7,8,0,21,CL
b182a240,4,3,1,0,3,2,5,3,0,0,0,2,6,1,0,21,CL
b19db005,4,1,2,2,0,2,11,9,2,0,2,2,6,1,0,21,CL
b1dae700,0,0,0,0,0,0,0,0,3,0,3,0,0,0,0,21,CL
b217ef29,4,3,3,1,0,3,4,1,0,0,0,0,4,7,0,21,CL
b39bf63f,3,1,0,2,1,2,7,5,5,0,5,2,5,4,0,21,CL
b3a712de,2,1,0,2,0,1,7,6,6,0,6,6,8,2,0,21,CL
b400bde0,6,2,0,3,3,0,3,3,3,0,3,3,9,0,0,21,CL
b4a014b1,9,6,4,4,1,3,5,2,9,4,5,12,21,25,1,21,CL
b583aef5,0,0,0,0,0,0,0,0,0,0,0,0,0,7,1,21,CL
b5f66351,7,6,4,3,0,3,6,3,4,0,4,9,16,6,0,21,CL
b5f7d10b,6,4,4,1,1,3,10,7,5,1,4,12,18,13,0,21,CL
b62878a5,0,0,0,0,0,0,0,0,0,0,0,0,0,0,0,21,CL
b66315ae,3,0,0,1,2,0,3,3,6,0,6,2,5,0,0,21,CL
b686f4c0,1,1,0,0,1,1,3,2,1,0,1,0,1,2,0,21,CL
b69261a0,7,5,4,2,1,3,6,3,5,3,2,6,13,4,0,21,CL
b70bde8f,0,0,0,0,0,0,1,1,0,0,0,0,0,0,0,21,CL
b74277a0,19,12,10,6,3,7,13,6,12,4,8,14,33,15,0,21,CL
b79d8e93,8,3,5,2,1,3,4,1,3,3,0,5,13,4,0,21,CL
b7a5bc86,9,4,5,3,1,5,11,6,4,0,4,8,17,11,0,21,CL
b825a650,7,4,4,2,1,3,11,8,5,0,5,6,13,6,0,21,CL
b853e0ad,12,3,4,7,1,6,13,7,9,0,9,7,19,4,0,21,CL
b8814868,9,6,5,4,0,4,11,7,4,0,4,4,13,0,0,21,CL
b8e740fb,15,4,3,8,4,3,8,5,7,0,7,11,26,4,0,21,CL
b937e490,1,0,0,1,0,0,0,0,0,0,0,0,1,1,0,21,CL
b96b595c,15,8,9,6,0,6,9,3,9,6,3,11,26,25,0,21,CL
b997c3de,20,14,11,8,1,5,12,7,7,0,7,8,28,12,0,21,CL
b9fbae28,10,8,8,1,1,3,8,5,13,3,10,14,24,13,0,21,CL
ba3d3bea,1,0,1,0,0,0,3,3,1,0,1,1,2,1,0,21,CL
bac46a10,7,5,6,1,0,5,10,5,2,2,0,8,15,20,1,21,CL
bc6bd723,2,0,0,2,0,1,4,3,5,0,5,2,4,0,0,21,CL
bc6f5f06,1,0,1,0,0,1,1,0,4,3,1,1,2,6,0,21,CL
bcb2ccd8,0,0,0,0,0,0,0,0,0,0,0,0,0,4,0,21,CL
bd20f4eb,6,4,4,1,1,4,11,7,3,1,2,2,8,4,0,21,CL
bd6351cd,24,17,9,10,5,11,20,9,2,0,2,6,30,8,1,21,CL
be42a291,1,1,1,0,0,0,2,2,2,0,2,0,1,1,0,21,CL
be60b6f4,1,0,1,0,0,0,5,5,1,0,1,0,1,0,0,21,CL
be927d03,4,3,2,2,0,2,4,2,1,0,1,3,7,6,0,21,CL
bef0a7ac,1,1,1,0,0,0,0,0,3,0,3,0,1,2,0,21,CL
bfc5768b,9,4,4,5,0,5,9,4,5,1,4,2,11,6,0,21,CL
bfe272bd,4,1,1,3,0,1,4,3,2,1,1,6,10,2,0,21,CL
c01f247a,13,4,8,2,3,8,21,13,4,2,2,8,21,10,0,21,CL
c14bc029,8,4,2,5,1,3,12,9,6,3,3,12,20,9,0,21,CL
c1febb46,7,3,4,2,1,3,6,3,3,0,3,11,18,2,0,21,CL
c24544c7,11,10,2,6,3,4,7,3,1,0,1,8,19,1,1,21,CL
c283ddef,0,0,0,0,0,0,0,0,0,0,0,0,0,0,0,21,CL
c3ee18ef,24,16,14,7,3,8,15,7,10,2,8,5,29,17,0,21,CL
c432ba7d,0,0,0,0,0,0,0,0,0,0,0,0,0,0,0,21,CL
c43e5e7e,3,1,0,1,2,1,2,1,1,0,1,1,4,0,0,21,CL
c459a650,6,4,3,3,0,3,5,2,4,1,3,3,9,0,0,21,CL
c4987edc,0,0,0,0,0,0,0,0,4,2,2,2,2,15,0,21,CL
c50e5bba,13,8,8,4,1,7,16,9,9,0,9,9,22,7,0,21,CL
c56dc39e,19,12,7,12,0,8,13,5,9,3,6,13,32,24,0,21,CL
c603ad6a,4,1,3,0,1,3,6,3,11,4,7,9,13,9,0,21,CL
c63f6e46,1,0,0,1,0,1,3,2,1,1,0,1,2,4,0,21,CL
c6486b01,1,1,0,0,1,1,8,7,6,0,6,4,5,1,0,21,CL
c64c01fc,2,2,1,0,1,0,0,0,0,0,0,0,2,0,0,21,CL
c691bfe2,5,4,2,1,2,2,7,5,6,0,6,3,8,1,0,21,CL
c7069d87,9,3,4,5,0,5,17,12,3,0,3,6,15,8,0,21,CL
c71e97ba,4,3,2,1,1,2,5,3,5,1,4,12,16,7,1,21,CL
c7526c18,3,2,1,2,0,1,5,4,0,0,0,2,5,6,0,21,CL
c864997f,0,0,0,0,0,0,0,0,0,0,0,0,0,0,0,21,CL
c904f3d5,4,0,2,2,0,2,5,3,5,4,1,12,16,22,1,21,CL
c906ce0f,6,5,5,1,0,5,9,4,9,6,3,4,10,32,0,21,CL
c931d9f9,0,0,0,0,0,0,1,1,1,0,1,0,0,0,0,21,CL
ca45605e,5,2,1,2,2,0,2,2,6,0,6,0,5,1,0,21,CL
ca607d59,3,2,0,3,0,1,1,0,1,0,1,0,3,1,0,21,CL
ca8033cb,2,2,1,1,0,1,3,2,0,0,0,4,6,9,0,21,CL
cbbfa2e7,1,0,0,1,0,0,0,0,1,0,1,3,4,1,0,21,CL
cc77354e,9,5,5,3,1,5,10,5,3,1,2,8,17,6,1,21,CL
cc86b9a3,6,5,1,5,0,2,10,8,10,1,9,13,19,5,0,21,CL
cd1acf9d,10,4,7,3,0,6,12,6,5,0,5,12,22,9,2,21,CL
ce30bfc8,6,1,2,3,1,1,4,3,1,0,1,5,11,3,0,21,CL
ce4246f5,3,2,1,2,0,2,4,2,5,5,0,2,5,23,0,21,CL
cecbce23,0,0,0,0,0,0,0,0,0,0,0,0,0,2,0,21,CL
d003e213,5,4,4,1,0,1,7,6,2,0,2,3,8,5,0,21,CL
d0d8dd44,6,5,2,4,0,3,4,1,8,4,4,17,23,16,0,21,CL
d125f22f,0,0,0,0,0,0,3,3,0,0,0,0,0,0,0,21,CL
d14229f3,0,0,0,0,0,0,1,1,0,0,0,0,0,0,0,21,CL
d1f48bfc,5,3,2,2,1,0,3,3,2,0,2,5,10,2,0,21,CL
d2416c2e,5,4,0,4,1,4,13,9,9,2,7,3,8,7,0,21,CL
d2424d1b,11,6,7,2,2,8,19,11,7,0,7,15,26,31,1,21,CL
d248cd8f,22,16,15,7,0,11,15,4,6,2,4,14,36,13,2,21,CL
d2795011,6,2,3,2,1,1,2,1,2,0,2,5,11,2,0,21,CL
d2800f47,8,3,3,4,1,5,9,4,7,2,5,3,11,0,0,21,CL
d29202c2,6,3,1,2,3,3,4,1,4,0,4,3,9,5,0,21,CL
d3de9af0,4,3,2,2,0,1,1,0,2,0,2,1,5,10,0,21,CL
d4133fa1,7,3,2,5,0,5,13,8,7,1,6,12,19,8,0,21,CL
d436eb94,1,0,1,0,0,1,1,0,0,0,0,1,2,4,0,21,CL
d4535821,10,2,6,4,0,7,10,3,5,0,5,12,22,19,0,21,CL
d4e93bab,14,8,11,2,1,2,12,10,8,2,6,9,23,3,0,21,CL
d4f034db,3,2,3,0,0,3,4,1,2,2,0,5,8,11,0,21,CL
d5dafedb,0,0,0,0,0,0,3,3,0,0,0,0,0,4,0,21,CL
d5f2f82b,18,6,9,9,0,8,11,3,16,10,6,10,28,39,0,21,CL
d63e2912,9,8,7,2,0,3,8,5,8,1,7,12,21,10,1,21,CL
d68cb24c,0,0,0,0,0,0,3,3,2,0,2,0,0,1,0,21,CL
d6e53a3a,9,6,5,3,1,3,3,0,8,6,2,7,16,10,0,21,CL
d70ce98e,5,2,0,2,3,2,7,5,2,0,2,2,7,0,0,21,CL
d781d855,8,3,3,5,0,5,10,5,7,1,6,6,14,5,0,21,CL
d80b1835,0,0,0,0,0,0,0,0,0,0,0,0,0,0,0,21,CL
d8931174,4,3,2,1,1,3,6,3,7,4,3,5,9,15,0,21,CL
d93c2511,11,5,3,8,0,8,14,6,2,0,2,5,16,8,0,21,CL
d94653be,6,5,3,0,3,3,5,2,4,0,4,1,7,4,0,21,CL
d97b252e,0,0,0,0,0,0,0,0,0,0,0,0,0,2,1,21,CL
d97f2e8d,0,0,0,0,0,0,0,0,0,0,0,0,0,1,0,21,CL
d9b9b71a,2,1,1,1,0,0,3,3,2,0,2,2,4,1,0,21,CL
d9d43555,0,0,0,0,0,0,1,1,2,0,2,0,0,1,0,21,CL
da1185fc,4,2,0,2,2,2,5,3,5,0,5,3,7,2,0,21,CL
da27e268,1,0,0,1,0,0,0,0,2,0,2,2,3,4,0,21,CL
db4ed67b,13,10,7,5,1,4,15,11,10,1,9,5,18,5,0,21,CL
db750822,2,0,0,1,1,1,1,0,1,0,1,0,2,0,0,21,CL
dba67bc4,15,9,4,10,1,7,15,8,10,2,8,13,28,3,0,21,CL
dbf053da,3,1,2,0,1,1,4,3,0,0,0,4,7,1,0,21,CL
dc52c72f,8,7,4,4,0,6,11,5,6,0,6,14,22,19,0,21,CL
dc7f8a28,0,0,0,0,0,0,0,0,0,0,0,0,0,0,0,21,CL
dca7b0fb,6,1,4,2,0,3,4,1,0,0,0,1,7,1,0,21,CL
dd323728,7,4,4,3,0,2,3,1,4,1,3,6,13,3,1,21,CL
de39485a,4,2,2,0,2,4,5,1,4,0,4,1,5,3,0,21,CL
dea698d9,0,0,0,0,0,0,3,3,1,1,0,2,2,5,0,21,CL
defb905a,7,5,5,2,0,4,7,3,7,3,4,8,15,19,0,21,CL
df10e27c,0,0,0,0,0,0,0,0,0,0,0,2,2,1,0,21,CL
df3cda47,3,1,1,2,0,0,8,8,3,1,2,5,8,1,0,21,CL
df69b544,8,1,3,5,0,4,6,2,4,0,4,5,13,3,0,21,CL
dfb50e5c,0,0,0,0,0,0,0,0,1,0,1,1,1,0,0,21,CL
dfb6490a,0,0,0,0,0,0,2,2,3,0,3,1,1,2,0,21,CL
dff153a4,18,5,6,10,2,8,25,17,7,2,5,18,36,10,1,21,CL
e08647d6,0,0,0,0,0,0,1,1,0,0,0,0,0,0,0,21,CL
e0921a4f,1,0,0,1,0,0,8,8,1,0,1,1,2,1,0,21,CL
e0bc6fdc,7,4,4,1,2,4,6,2,3,0,3,3,10,4,0,21,CL
e162b013,6,5,5,0,1,4,8,4,5,2,3,1,7,4,0,21,CL
e27fdbca,15,10,10,4,1,4,12,8,9,3,6,7,22,21,0,21,CL
e280527c,14,6,4,10,0,7,18,11,5,3,2,12,26,8,1,21,CL
e288d4b3,11,6,8,3,0,2,14,12,7,3,4,10,21,17,0,21,CL
e33c06cf,7,3,2,5,0,3,6,3,5,2,3,13,20,19,0,21,CL
e342ad68,6,6,1,4,1,2,8,6,6,0,6,5,11,3,1,21,CL
e358587b,0,0,0,0,0,0,1,1,0,0,0,2,2,2,1,21,CL
e3cceee6,5,3,3,2,0,2,3,1,2,1,1,9,14,12,1,21,CL
e40d028b,0,0,0,0,0,0,0,0,0,0,0,0,0,0,0,21,CL
e42d61c7,8,4,3,3,2,3,10,7,6,1,5,7,15,2,1,21,CL
e46012d4,9,3,1,4,4,4,20,16,12,2,10,2,11,2,0,21,CL
e4d5e2ae,0,0,0,0,0,0,0,0,0,0,0,0,0,0,0,21,CL
e54a9890,3,1,2,1,0,1,2,1,2,0,2,0,3,2,0,21,CL
e599253a,3,3,2,1,0,0,5,5,2,0,2,5,8,3,1,21,CL
e5a76dfe,0,0,0,0,0,0,0,0,0,0,0,0,0,0,0,21,CL
e613313c,8,4,6,2,0,5,9,4,11,5,6,10,18,17,1,21,CL
e73c9bb2,7,5,2,4,1,3,7,4,5,0,5,1,8,3,0,21,CL
e76cb9cc,13,10,12,1,0,8,8,0,13,10,3,8,21,49,0,21,CL
e7986081,0,0,0,0,0,0,0,0,1,0,1,0,0,1,0,21,CL
e81f0356,0,0,0,0,0,0,0,0,1,0,1,3,3,5,0,21,CL
e85fb9b8,1,1,1,0,0,1,2,1,0,0,0,2,3,5,1,21,CL
e8c0cafd,3,2,2,1,0,1,2,1,1,0,1,1,4,3,0,21,CL
e92cd3f7,1,0,0,1,0,1,1,0,0,0,0,0,1,0,0,21,CL
e9c0c1b2,0,0,0,0,0,0,1,1,0,0,0,0,0,0,2,21,CL
ea0ff634,2,0,1,0,1,0,3,3,0,0,0,1,3,1,0,21,CL
eaeca114,3,3,2,0,1,3,4,1,1,0,1,3,6,4,0,21,CL
eb2b33aa,0,0,0,0,0,0,0,0,0,0,0,1,1,6,2,21,CL
eb2fe5b6,6,2,1,2,3,2,8,6,2,0,2,0,6,1,0,21,CL
eb58eef0,7,2,2,5,0,0,4,4,4,0,4,9,16,2,0,21,CL
eb6e14be,1,1,1,0,0,0,8,8,2,0,2,3,4,2,0,21,CL
eb7822d7,5,5,0,5,0,2,3,1,2,2,0,4,9,4,0,21,CL
ebc56869,0,0,0,0,0,0,2,2,2,0,2,1,1,0,0,21,CL
ecada4fc,0,0,0,0,0,0,1,1,0,0,0,1,1,2,1,21,CL
ecb68eea,7,1,2,5,0,5,12,7,5,1,4,13,20,4,0,21,CL
ed140063,1,1,1,0,0,1,7,6,6,4,2,5,6,3,0,21,CL
ed1e53f3,16,10,5,5,6,7,15,8,13,1,12,9,25,3,1,21,CL
ed2b33cb,2,2,0,1,1,2,3,1,2,1,1,2,4,3,0,21,CL
ed33f42d,0,0,0,0,0,0,0,0,1,1,0,1,1,0,0,21,CL
ed45c4a5,11,8,4,6,1,6,9,3,7,0,7,20,31,3,1,21,CL
ed5886d2,5,3,2,3,0,3,5,2,9,2,7,5,10,9,0,21,CL
ed87a229,2,0,2,0,0,2,2,0,2,0,2,0,2,3,0,21,CL
ed9f7cfe,11,8,6,3,2,3,5,2,8,0,8,8,19,9,0,21,CL
eda40760,0,0,0,0,0,0,0,0,2,2,0,1,1,1,0,21,CL
edd38473,1,0,0,1,0,1,1,0,5,2,3,1,2,2,0,21,CL
ee3519f5,2,2,0,1,1,2,4,2,3,1,2,5,7,11,0,21,CL
ee37317d,0,1,0,0,0,0,0,0,0,0,0,0,0,0,0,21,CL
ee8508c0,0,0,0,0,0,0,0,0,0,0,0,0,0,1,0,21,CL
ee93c1a9,2,1,1,0,1,0,0,0,1,0,1,2,4,3,0,21,CL
ef2e5e1a,0,0,0,0,0,0,0,0,1,0,1,1,1,0,0,21,CL
ef619b0b,4,2,2,1,1,1,6,5,1,0,1,9,13,4,0,21,CL
f0661424,13,7,8,4,1,6,12,6,4,1,3,7,20,15,0,21,CL
f090a37a,1,0,0,0,1,0,0,0,1,0,1,2,3,0,0,21,CL
f0da930c,5,5,4,1,0,3,5,2,4,1,3,6,11,14,0,21,CL
f0f7f62f,0,0,0,0,0,0,0,0,0,0,0,0,0,3,0,21,CL
f0fc9d0e,0,0,0,0,0,0,1,1,3,0,3,0,0,0,0,21,CL
f25c8e3a,2,2,1,1,0,0,3,3,3,0,3,4,6,2,0,21,CL
f315ca93,2,2,1,0,1,1,2,1,1,1,0,2,4,6,0,21,CL
f36d5624,1,1,0,1,0,1,2,1,1,0,1,1,2,0,0,21,CL
f38cc3b3,0,0,0,0,0,0,1,1,3,2,1,4,4,7,0,21,CL
f3945e07,0,0,0,0,0,0,0,0,2,0,2,1,1,7,0,21,CL
f3fa599d,11,9,7,2,2,4,7,3,5,0,5,11,22,8,0,21,CL
f4290206,1,1,1,0,0,1,1,0,3,0,3,0,1,4,0,21,CL
f45f9427,2,1,1,1,0,2,5,3,2,1,1,2,4,2,0,21,CL
f4c69aa6,1,1,1,0,0,0,0,0,0,0,0,0,1,0,0,21,CL
f4ceb85b,2,1,0,0,2,1,1,0,1,0,1,2,4,1,0,21,CL
f521b80a,3,3,2,1,0,2,4,2,9,7,2,5,8,27,0,21,CL
f586779e,0,0,0,0,0,0,0,0,2,1,1,1,1,2,0,21,CL
f5deef4c,4,2,2,2,0,3,4,1,6,4,2,3,7,11,0,21,CL
f5f2ec59,1,1,0,1,0,0,0,0,0,0,0,0,1,0,0,21,CL
f620b04f,0,0,0,0,0,0,0,0,3,0,3,1,1,5,0,21,CL
f6798fc3,0,0,0,0,0,0,0,0,0,0,0,0,0,0,0,21,CL
f6ac68c1,6,3,2,3,1,2,4,2,7,5,2,8,14,40,0,21,CL
f7036e1c,1,1,0,0,1,0,3,3,4,0,4,5,6,1,0,21,CL
f7223718,5,2,3,2,0,3,10,7,3,2,1,6,11,18,1,21,CL
f76e6b4e,0,0,0,0,0,0,0,0,0,0,0,0,0,1,1,21,CL
f76fdcd2,0,0,0,0,0,0,0,0,0,0,0,0,0,0,0,21,CL
f7e87032,8,4,4,3,1,2,12,10,4,1,3,5,13,4,0,21,CL
f833a830,3,2,0,1,2,1,7,6,5,0,5,0,3,2,0,21,CL
f8ce97ca,0,0,0,0,0,0,1,1,0,0,0,0,0,1,0,21,CL
f93c876b,4,1,3,1,0,3,4,1,3,1,2,7,11,7,0,21,CL
fa274d97,3,2,1,1,1,1,4,3,0,0,0,1,4,9,0,21,CL
fa73ccc7,4,2,2,2,0,2,9,7,9,3,6,7,11,4,0,21,CL
fb938d24,10,2,9,1,0,6,17,11,11,0,11,13,23,9,1,21,CL
fc62f087,12,9,10,2,0,8,11,3,5,3,2,5,17,14,0,21,CL
fd51b456,16,12,6,8,2,9,23,14,10,0,10,6,22,9,0,21,CL
fd771f95,1,0,0,0,1,0,1,1,2,0,2,0,1,1,0,21,CL
fd9c4805,3,2,1,1,1,0,7,7,3,1,2,1,4,0,0,21,CL
fdf4b948,8,4,3,5,0,3,6,3,4,1,3,7,15,4,0,21,CL
fe2db476,0,0,0,0,0,0,3,3,1,1,0,4,4,3,0,21,CL
fe641c1a,11,8,3,6,2,3,5,2,5,0,5,4,15,8,0,21,CL
fe888e39,0,0,0,0,0,0,1,1,0,0,0,0,0,0,0,21,CL
fecd43a3,9,6,8,1,0,4,9,5,3,2,1,6,15,5,0,21,CL
fed7cb61,17,10,7,8,2,7,15,8,8,0,8,9,26,12,0,21,CL
fffea3e5,4,3,2,2,0,0,2,2,0,0,0,2,6,1,0,21,CL
008a6e6d,15,9,9,5,1,7,11,4,9,4,5,8,23,34,0,21,ITA
01040647,6,4,1,4,1,2,7,5,4,1,3,4,10,4,0,21,ITA
01a49bd2,54,31,28,24,2,17,42,25,29,15,14,44,98,78,1,21,ITA
01b8a2b2,0,0,0,0,0,0,0,0,2,0,2,3,3,5,1,21,ITA
01c3aff5,34,19,9,20,5,12,33,21,21,3,18,28,62,26,0,21,ITA
01efac19,30,19,8,16,6,14,47,33,26,7,19,12,42,38,1,21,ITA
023937a9,18,15,13,5,0,12,31,19,39,21,18,37,55,114,2,21,ITA
028e70b9,2,2,1,1,0,1,3,2,1,1,0,0,2,1,0,21,ITA
02caf6e0,24,14,15,4,5,14,39,25,22,3,19,18,42,28,0,21,ITA
0375723e,19,12,10,6,3,6,19,13,8,0,8,8,27,2,2,21,ITA
03f946ed,2,0,0,2,0,2,7,5,4,0,4,1,3,7,0,21,ITA
0489bb30,6,2,3,2,1,3,3,0,6,0,6,6,12,6,0,21,ITA
04df29a5,2,1,1,1,0,0,3,3,0,0,0,0,2,3,0,21,ITA
05e19d6a,53,30,28,19,6,20,38,18,47,15,32,46,99,51,0,21,ITA
0728bebe,33,19,15,11,7,11,42,31,25,2,23,34,67,14,0,21,ITA
07767f42,7,5,2,5,0,3,10,7,6,2,4,13,20,10,0,21,ITA
081b6080,0,0,0,0,0,0,2,2,0,0,0,0,0,0,0,21,ITA
0821331c,30,16,20,9,1,9,20,11,26,17,9,60,90,94,0,21,ITA
085e71a7,1,0,1,0,0,1,1,0,0,0,0,1,2,13,1,21,ITA
089550f5,4,3,2,2,0,2,3,1,5,1,4,4,8,2,1,21,ITA
08990838,0,0,0,0,0,0,1,1,0,0,0,1,1,3,0,21,ITA
08aa9cd1,0,0,0,0,0,0,0,0,1,0,1,1,1,2,0,21,ITA
08f5afaa,0,0,0,0,0,0,1,1,1,0,1,1,1,23,2,21,ITA
09538fdb,13,4,2,8,3,4,19,15,23,1,22,7,20,18,0,21,ITA
099a2de5,0,0,0,0,0,0,0,0,0,0,0,0,0,0,0,21,ITA
0a1efd3c,2,1,1,1,0,1,3,2,2,0,2,0,2,5,0,21,ITA
0a3065c8,21,14,15,5,1,12,21,9,17,2,15,17,38,35,0,21,ITA
0a447501,8,3,0,4,4,2,9,7,5,0,5,5,13,8,0,21,ITA
0a483542,35,18,17,12,6,8,28,20,16,5,11,15,50,42,0,21,ITA
0ab1f153,43,25,22,15,6,29,60,31,16,2,14,43,86,22,2,21,ITA
0b5a292a,24,13,17,6,1,17,33,16,17,4,13,28,52,29,1,21,ITA
0c8f27b5,0,0,0,0,0,0,0,0,0,0,0,0,0,0,0,21,ITA
0cadc46d,3,1,0,2,1,0,8,8,9,2,7,3,6,20,0,21,ITA
0d077b88,6,5,1,4,1,2,7,5,14,6,8,12,18,8,0,21,ITA
0d422df7,0,0,0,0,0,0,0,0,0,0,0,0,0,14,1,21,ITA
0d82903c,37,23,19,13,5,13,25,12,20,4,16,31,68,57,0,21,ITA
0db169ae,28,19,14,13,1,13,28,15,18,5,13,22,50,18,0,21,ITA
0e0e4422,0,0,0,0,0,0,0,0,0,0,0,0,0,1,0,21,ITA
0e21fc3c,13,9,7,4,2,3,15,12,6,1,5,6,19,2,0,21,ITA
0e490f6e,3,1,0,0,3,0,4,4,4,0,4,1,4,0,0,21,ITA
0fee6bda,23,14,16,6,1,11,20,9,22,16,6,41,64,71,2,21,ITA
1079c685,3,2,0,2,1,0,5,5,4,2,2,2,5,6,0,21,ITA
10dc46f0,1,0,1,0,0,1,2,1,0,0,0,0,1,6,2,21,ITA
10e7f486,26,13,19,5,2,19,27,8,26,5,21,31,57,53,0,21,ITA
11e0904f,1,0,0,1,0,1,2,1,2,0,2,1,2,0,0,21,ITA
1295552e,43,20,26,9,8,27,53,26,17,1,16,36,79,41,0,21,ITA
129af0db,17,12,2,10,5,4,28,24,22,2,20,5,22,21,0,21,ITA
12c35abe,7,4,3,3,1,6,10,4,4,0,4,1,8,3,0,21,ITA
130a7a3f,24,12,9,14,1,14,40,26,21,0,21,6,30,9,0,21,ITA
13c8e5f6,1,1,0,1,0,1,1,0,0,0,0,0,1,0,0,21,ITA
144607cc,46,28,22,21,3,21,70,49,22,2,20,33,79,57,1,21,ITA
149c5f5d,34,19,23,9,2,22,41,19,22,9,13,12,46,52,3,21,ITA
14b8fcdf,24,11,10,12,2,10,20,10,15,10,5,15,39,46,0,21,ITA
157d29b6,9,5,4,1,4,4,21,17,12,0,12,13,22,3,0,21,ITA
15d0c248,32,20,19,11,2,16,24,8,20,9,11,21,53,29,1,21,ITA
162efffd,41,24,17,22,2,15,60,45,32,1,31,17,58,20,1,21,ITA
16657b95,27,20,10,14,3,10,28,18,21,7,14,40,67,61,1,21,ITA
16b9d5cf,18,9,11,6,1,9,18,9,15,6,9,21,39,49,3,21,ITA
16bb656a,42,28,30,10,2,14,24,10,28,19,9,27,69,62,1,21,ITA
173061c0,45,18,35,8,2,28,45,17,34,7,27,36,81,64,1,21,ITA
174944a3,2,1,2,0,0,2,2,0,0,0,0,1,3,5,0,21,ITA
1780bb4a,12,8,10,2,0,7,17,10,6,1,5,15,27,15,1,21,ITA
185bf610,2,2,1,1,0,1,4,3,2,0,2,1,3,1,0,21,ITA
18736214,0,0,0,0,0,0,0,0,0,0,0,0,0,2,3,21,ITA
18f9dbd0,5,2,3,2,0,2,5,3,3,1,2,2,7,5,0,21,ITA
19d1c41f,0,0,0,0,0,0,0,0,2,0,2,1,1,0,0,21,ITA
19e4eab9,59,33,36,20,3,27,49,22,48,27,21,68,127,94,2,21,ITA
1ac232b8,50,29,26,22,2,27,52,25,19,1,18,16,66,31,0,21,ITA
1ad1f50d,6,2,0,6,0,1,16,15,7,0,7,5,11,3,0,21,ITA
1b82f8df,24,13,14,9,1,11,30,19,13,3,10,14,38,25,1,21,ITA
1bd5fc78,5,2,1,4,0,3,12,9,6,1,5,7,12,7,1,21,ITA
1cac99dc,4,2,0,3,1,1,7,6,0,0,0,0,4,0,0,21,ITA
1cadaf34,7,3,0,4,3,2,4,2,4,0,4,2,9,5,0,21,ITA
1d0bb7e4,5,5,0,3,2,4,5,1,2,1,1,2,7,7,1,21,ITA
1db295e5,33,16,17,13,3,14,19,5,38,26,12,40,73,97,2,21,ITA
1de40dae,22,12,7,10,5,12,26,14,19,4,15,11,33,5,0,21,ITA
1ea5f91c,28,17,14,7,7,11,35,24,16,1,15,24,52,34,0,21,ITA
1f9328da,41,26,22,14,5,19,34,15,18,0,18,16,57,15,1,21,ITA
20094685,24,13,15,6,3,14,41,27,9,0,9,16,40,10,1,21,ITA
20730eae,13,6,4,7,2,6,15,9,17,0,17,4,17,14,1,21,ITA
2079b3cc,12,6,6,4,2,6,21,15,5,0,5,2,14,6,0,21,ITA
20b3a502,48,28,26,17,5,15,37,22,26,7,19,24,72,20,0,21,ITA
20b9f052,2,0,2,0,0,2,2,0,1,0,1,0,2,7,4,21,ITA
2146785a,101,64,61,32,8,54,90,36,42,9,33,37,138,82,1,21,ITA
215f3907,42,21,14,20,8,22,70,48,40,4,36,24,66,17,0,21,ITA
217875a4,27,19,11,13,3,12,30,18,22,14,8,36,63,60,0,21,ITA
2200181e,15,9,8,5,2,8,13,5,9,5,4,16,31,33,0,21,ITA
226008f1,21,13,13,6,2,10,22,12,20,15,5,20,41,56,0,21,ITA
22bfb57e,8,7,5,3,0,3,13,10,7,1,6,5,13,7,0,21,ITA
22ca11f1,6,4,2,2,2,6,9,3,9,2,7,3,9,3,0,21,ITA
2306bf5c,4,2,1,1,2,1,5,4,4,0,4,6,10,4,0,21,ITA
230a2fac,79,50,54,21,4,43,75,32,37,13,24,35,114,64,1,21,ITA
2334478a,15,8,6,6,3,5,23,18,10,1,9,12,27,12,0,21,ITA
23610943,27,18,13,10,4,16,42,26,26,4,22,21,48,49,1,21,ITA
259deea9,0,0,0,0,0,0,0,0,0,0,0,0,0,0,0,21,ITA
263b855a,0,0,0,0,0,0,1,1,0,0,0,3,3,1,0,21,ITA
26c54058,39,17,34,4,1,15,25,10,22,10,12,36,75,91,1,21,ITA
26cd1bff,1,1,0,0,1,1,1,0,1,0,1,0,1,0,0,21,ITA
26db8853,50,23,28,19,3,21,60,39,36,3,33,34,84,23,0,21,ITA
277da414,2,0,2,0,0,2,6,4,0,0,0,2,4,20,1,21,ITA
2873973b,0,0,0,0,0,0,0,0,0,0,0,0,0,0,0,21,ITA
2990c466,1,1,1,0,0,0,0,0,2,1,1,2,3,8,0,21,ITA
2a1beb34,80,48,30,36,14,36,84,48,44,9,35,69,149,40,0,21,ITA
2bae5658,2,1,2,0,0,0,3,3,5,1,4,1,3,0,0,21,ITA
2c0f8e9e,14,8,4,4,6,5,18,13,11,0,11,7,21,1,1,21,ITA
2c38b327,13,6,6,3,4,4,16,12,7,2,5,7,20,12,0,21,ITA
2c851997,31,15,10,17,4,8,27,19,19,3,16,4,35,13,0,21,ITA
2cfae697,50,25,23,25,2,16,37,21,36,13,23,79,129,37,6,21,ITA
2d970560,46,35,20,15,11,17,41,24,50,7,43,41,87,34,0,21,ITA
2d9d9e42,0,0,0,0,0,0,0,0,0,0,0,0,0,0,0,21,ITA
2e0ae188,4,2,2,1,1,1,2,1,5,0,5,1,5,2,0,21,ITA
2ead2809,22,12,3,13,6,6,25,19,18,3,15,5,27,16,0,21,ITA
2f3452eb,29,17,16,11,2,17,33,16,18,4,14,30,59,52,0,21,ITA
2f557579,26,18,8,12,6,13,72,59,30,1,29,37,63,6,1,21,ITA
2f7407fa,0,0,0,0,0,0,0,0,0,0,0,0,0,0,0,21,ITA
30223b33,0,0,0,0,0,0,1,1,1,0,1,0,0,7,2,21,ITA
30f5ffa9,48,32,29,16,3,23,34,11,30,19,11,30,78,89,1,21,ITA
31d7f557,9,4,2,7,0,3,9,6,4,1,3,2,11,6,0,21,ITA
326d09ef,0,0,0,0,0,0,0,0,0,0,0,0,0,0,0,21,ITA
32a33c68,2,0,1,1,0,1,1,0,3,1,2,0,2,8,0,21,ITA
32c0491f,1,1,1,0,0,0,1,1,1,0,1,0,1,0,0,21,ITA
339c6ed4,2,2,2,0,0,2,2,0,1,1,0,1,3,5,0,21,ITA
339fe0e8,1,1,1,0,0,0,0,0,0,0,0,1,2,4,0,21,ITA
33b8d077,54,29,23,24,7,20,61,41,43,17,26,40,94,38,0,21,ITA
33e98344,0,0,0,0,0,0,1,1,0,0,0,0,0,0,0,21,ITA
33ecf462,11,7,2,7,2,4,19,15,14,2,12,9,20,3,0,21,ITA
343c0d52,24,11,2,15,7,7,31,24,23,1,22,10,34,18,0,21,ITA
343f753a,0,0,0,0,0,0,2,2,0,0,0,2,2,13,2,21,ITA
348bafd4,9,7,9,0,0,2,5,3,4,3,1,2,11,8,0,21,ITA
34bb6fbd,0,0,0,0,0,0,1,1,0,0,0,0,0,2,0,21,ITA
3535098b,16,11,8,6,2,7,9,2,8,4,4,17,33,22,1,21,ITA
356c9002,28,19,17,9,2,21,53,32,24,3,21,9,37,27,1,21,ITA
35b4bc62,0,0,0,0,0,0,0,0,0,0,0,0,0,0,0,21,ITA
35dd6d80,43,22,29,11,3,22,39,17,27,14,13,44,87,51,0,21,ITA
3626daea,12,6,3,9,0,8,20,12,16,1,15,25,37,31,0,21,ITA
366be751,0,0,0,0,0,0,0,0,0,0,0,0,0,1,0,21,ITA
3688af6c,0,0,0,0,0,0,1,1,0,0,0,0,0,0,0,21,ITA
36d7971a,5,0,3,0,2,4,7,3,1,0,1,2,7,6,0,21,ITA
36d9dabe,4,1,0,3,1,2,9,7,4,0,4,5,9,6,0,21,ITA
38bf62b5,0,0,0,0,0,0,1,1,1,0,1,1,1,8,0,21,ITA
39583cfd,2,2,1,1,0,2,12,10,2,0,2,3,5,0,0,21,ITA
39ee6cb6,6,3,2,3,1,2,7,5,12,3,9,5,11,15,1,21,ITA
3a35db3d,5,4,5,0,0,3,5,2,10,6,4,13,18,21,0,21,ITA
3b333ac3,28,17,12,14,2,13,23,10,8,1,7,17,45,9,0,21,ITA
3b61c9ec,9,6,6,2,1,4,10,6,11,2,9,8,17,13,1,21,ITA
3b8674e6,63,33,21,37,5,20,59,39,35,12,23,47,110,46,1,21,ITA
3bb7af3b,6,2,1,2,3,2,6,4,1,0,1,2,8,4,0,21,ITA
3bb7f478,8,6,2,3,3,3,9,6,9,4,5,1,9,11,0,21,ITA
3ca7254a,22,14,6,11,5,7,35,28,10,0,10,9,31,2,1,21,ITA
3cb132e6,5,2,2,1,2,2,5,3,0,0,0,0,5,1,0,21,ITA
3cd3b384,42,30,27,10,5,23,39,16,22,2,20,32,74,76,1,21,ITA
3cf7dc7e,40,23,14,24,2,27,52,25,24,4,20,34,74,13,0,21,ITA
3dd45b70,36,25,19,13,4,17,36,19,15,3,12,20,56,42,1,21,ITA
3e092724,9,4,5,3,1,2,4,2,13,8,5,5,14,6,1,21,ITA
3ead85f9,17,7,8,7,2,8,19,11,29,22,7,24,41,80,0,21,ITA
3ec3c1c9,32,20,17,11,4,18,41,23,27,9,18,39,71,48,0,21,ITA
3f1107d5,0,0,0,0,0,0,0,0,1,0,1,1,1,0,0,21,ITA
3f79a1c8,26,13,11,14,1,8,28,20,10,3,7,19,45,13,0,21,ITA
407feb71,18,10,7,7,4,10,23,13,10,0,10,2,20,2,0,21,ITA
41bd99ea,0,0,0,0,0,0,0,0,0,0,0,0,0,0,0,21,ITA
42b1a58a,9,4,4,5,0,6,7,1,4,2,2,11,20,16,0,21,ITA
42fff925,3,1,1,2,0,2,4,2,2,1,1,0,3,2,0,21,ITA
4366d5e9,1,1,0,1,0,0,0,0,0,0,0,0,1,1,0,21,ITA
440c84ed,4,2,2,2,0,1,6,5,4,1,3,0,4,1,0,21,ITA
4431aed2,14,13,4,6,4,7,22,15,13,1,12,6,20,9,0,21,ITA
44510fde,3,1,0,1,2,2,3,1,2,0,2,0,3,2,0,21,ITA
44ac04e9,1,1,0,0,1,0,5,5,7,1,6,4,5,3,0,21,ITA
44eb9093,15,9,6,7,2,6,15,9,9,7,2,4,19,15,0,21,ITA
45191c29,1,1,0,1,0,1,1,0,0,0,0,0,1,0,0,21,ITA
45392b06,16,9,2,11,3,6,28,22,10,3,7,9,25,7,0,21,ITA
4571fa88,13,6,5,6,2,5,6,1,6,1,5,3,16,15,0,21,ITA
457cb02f,0,0,0,0,0,0,0,0,0,0,0,0,0,0,0,21,ITA
45b9b619,21,12,6,11,4,7,25,18,14,0,14,7,28,12,0,21,ITA
4611e028,41,18,17,23,1,22,49,27,24,10,14,41,82,45,1,21,ITA
46fa7204,39,28,9,15,15,12,34,22,30,0,30,10,49,2,0,21,ITA
48b3dd60,17,9,7,10,0,12,31,19,6,1,5,18,35,9,1,21,ITA
48d5bd33,19,8,2,13,4,8,23,15,16,1,15,2,21,4,0,21,ITA
4a56052c,20,12,8,12,0,9,33,24,14,3,11,14,34,21,3,21,ITA
4a5a45c7,40,24,13,20,7,21,60,39,37,2,35,42,82,23,1,21,ITA
4a6914ff,0,0,0,0,0,0,0,0,0,0,0,0,0,2,0,21,ITA
4ae67f27,12,5,8,4,0,7,12,5,15,9,6,11,23,44,1,21,ITA
4b029b31,28,18,21,7,0,14,23,9,17,7,10,38,66,62,1,21,ITA
4b3e1a38,13,8,7,6,0,6,9,3,17,14,3,8,21,39,1,21,ITA
4b520f96,1,0,1,0,0,0,0,0,0,0,0,0,1,0,0,21,ITA
4c3a6744,0,0,0,0,0,0,0,0,0,0,0,0,0,0,0,21,ITA
4c62d0c8,0,0,0,0,0,0,0,0,0,0,0,1,1,6,0,21,ITA
4c78b5ed,68,32,38,28,2,30,86,56,21,0,21,57,125,21,0,21,ITA
4c7919df,1,0,0,0,1,1,1,0,0,0,0,0,1,0,0,21,ITA
4cde5509,5,4,0,4,1,3,6,3,5,3,2,6,11,27,1,21,ITA
4d17df3e,22,14,13,9,0,9,24,15,30,18,12,53,75,77,1,21,ITA
4dea2f2c,0,0,0,0,0,0,0,0,0,0,0,0,0,0,0,21,ITA
4e358a2d,3,2,3,0,0,3,4,1,3,3,0,7,10,18,1,21,ITA
4e6dbac4,59,40,20,30,9,27,84,57,52,12,40,33,92,47,0,21,ITA
4f2908e5,1,1,1,0,0,1,2,1,2,2,0,3,4,12,0,21,ITA
4fa7cb9b,1,0,1,0,0,1,3,2,0,0,0,0,1,0,0,21,ITA
5048486b,2,2,1,1,0,0,4,4,5,0,5,0,2,4,0,21,ITA
509a4ccb,9,6,2,6,1,4,10,6,10,1,9,0,9,3,0,21,ITA
5128bde4,29,17,8,17,4,20,42,22,17,7,10,20,49,29,0,21,ITA
51ffa295,1,0,1,0,0,1,7,6,5,0,5,3,4,1,0,21,ITA
524eb8c5,0,0,0,0,0,0,0,0,0,0,0,0,0,0,0,21,ITA
528492ea,21,10,9,10,2,4,23,19,10,0,10,18,39,8,1,21,ITA
5294a83f,43,24,15,19,9,15,73,58,41,2,39,13,56,11,1,21,ITA
52ec54d0,19,14,10,8,1,6,14,8,24,13,11,33,52,67,0,21,ITA
536cebe5,26,9,4,8,14,8,37,29,21,1,20,7,33,17,0,21,ITA
539230cf,13,10,6,6,1,7,8,1,5,3,2,12,25,19,0,21,ITA
53a0e358,42,22,17,11,14,21,62,41,23,1,22,26,68,34,0,21,ITA
53de807a,43,24,20,19,4,25,40,15,27,14,13,45,88,73,1,21,ITA
543d9d2b,0,0,0,0,0,0,0,0,0,0,0,0,0,0,0,21,ITA
54ab971f,39,22,18,14,7,29,45,16,30,8,22,17,56,41,0,21,ITA
54e53b7e,16,11,5,5,6,6,31,25,19,1,18,18,34,8,0,21,ITA
5570e6fb,34,21,19,14,1,19,28,9,23,12,11,35,69,55,1,21,ITA
55a1cac2,24,13,7,13,4,11,31,20,10,2,8,9,33,22,0,21,ITA
55db5c36,10,4,7,2,1,6,15,9,11,3,8,11,21,30,0,21,ITA
563a68ad,12,9,6,5,1,4,10,6,8,6,2,7,19,10,0,21,ITA
56400c01,3,2,2,1,0,3,7,4,8,5,3,1,4,9,1,21,ITA
570bb4b9,29,17,10,10,9,14,35,21,27,3,24,18,47,9,0,21,ITA
57469b2d,28,14,7,13,8,9,37,28,17,2,15,6,34,11,0,21,ITA
5832ebfe,2,1,1,1,0,0,1,1,1,0,1,1,3,1,0,21,ITA
585a73a8,13,10,10,3,0,7,9,2,17,12,5,26,39,81,0,21,ITA
58e933d2,9,4,2,4,3,4,12,8,9,1,8,5,14,4,0,21,ITA
5944af8f,15,8,9,1,5,8,21,13,10,1,9,8,23,8,0,21,ITA
59bf127b,69,41,21,41,7,23,40,17,24,2,22,36,105,13,2,21,ITA
5a2cb25d,39,22,11,24,4,18,48,30,30,5,25,23,62,12,0,21,ITA
5aa53281,50,29,29,19,2,18,31,13,38,18,20,72,122,77,3,21,ITA
5aaef9ef,67,36,21,37,9,26,74,48,25,3,22,28,95,25,0,21,ITA
5bd72174,0,0,0,0,0,0,2,2,4,0,4,1,1,3,0,21,ITA
5c397195,8,4,2,5,1,2,5,3,1,0,1,0,8,2,0,21,ITA
5cec2c74,29,17,16,10,3,13,33,20,27,3,24,18,47,25,1,21,ITA
5e861944,24,16,13,9,2,11,47,36,14,1,13,14,38,18,0,21,ITA
5eae500a,11,1,1,6,4,6,14,8,11,1,10,3,14,34,0,21,ITA
5efc5389,34,21,22,9,3,22,38,16,34,13,21,32,66,94,0,21,ITA
5f951ef1,9,6,8,0,1,5,20,15,8,1,7,6,15,6,0,21,ITA
5fa57166,21,12,14,5,2,10,21,11,20,10,10,37,58,48,1,21,ITA
5fd5ed86,51,34,36,14,1,21,36,15,54,21,33,70,121,142,1,21,ITA
601ef102,10,7,2,5,3,2,10,8,7,1,6,2,12,19,0,21,ITA
6029a945,6,2,3,1,2,4,7,3,1,0,1,1,7,2,0,21,ITA
608f2092,4,4,3,1,0,2,3,1,3,0,3,7,11,6,0,21,ITA
61b3978f,66,44,37,22,7,41,73,32,40,20,20,42,108,88,0,21,ITA
61f2f56a,6,6,1,2,3,1,3,2,3,1,2,3,9,7,0,21,ITA
620922ed,0,0,0,0,0,0,0,0,0,0,0,0,0,0,0,21,ITA
6213fd82,34,16,15,11,8,10,45,35,30,3,27,50,84,64,0,21,ITA
62437b4f,16,8,5,6,5,6,17,11,14,0,14,13,29,6,0,21,ITA
63071a3f,22,12,16,5,1,13,26,13,9,4,5,11,33,42,1,21,ITA
649b01d8,1,1,1,0,0,1,2,1,0,0,0,1,2,16,0,21,ITA
64cd167d,17,9,12,5,0,5,10,5,12,6,6,21,38,26,0,21,ITA
64e8ed6d,3,2,0,0,3,1,10,9,5,0,5,0,3,5,2,21,ITA
658d44be,26,15,21,5,0,16,28,12,12,3,9,14,40,34,0,21,ITA
6604165d,7,6,2,5,0,3,6,3,5,0,5,5,12,8,0,21,ITA
6639e500,5,0,1,3,1,2,12,10,6,0,6,1,6,4,0,21,ITA
6662d731,0,0,0,0,0,0,1,1,0,0,0,0,0,2,0,21,ITA
67cdbc0e,27,14,8,13,6,12,41,29,23,3,20,29,56,11,0,21,ITA
67f649be,0,0,0,0,0,0,0,0,0,0,0,0,0,1,0,21,ITA
6817095b,0,0,0,0,0,0,0,0,0,0,0,0,0,0,0,21,ITA
68252d6d,9,4,1,5,3,5,21,16,12,0,12,2,11,0,1,21,ITA
6928979a,58,31,23,29,6,23,72,49,29,4,25,26,84,14,0,21,ITA
6a189491,1,0,0,1,0,1,1,0,0,0,0,0,1,1,0,21,ITA
6b635f5c,19,9,10,8,1,8,13,5,10,7,3,23,42,52,1,21,ITA
6c1f7328,5,2,1,2,2,2,11,9,10,0,10,0,5,3,0,21,ITA
6cc97b6a,30,11,14,13,3,8,29,21,22,9,13,26,56,32,0,21,ITA
6e058f06,5,3,1,1,3,0,4,4,13,5,8,2,7,9,0,21,ITA
6e4df551,3,2,2,1,0,2,8,6,8,1,7,1,4,1,0,21,ITA
6eee05f1,41,29,27,12,2,17,34,17,34,20,14,62,103,89,1,21,ITA
6f5ead86,51,25,21,27,3,29,66,37,35,4,31,31,82,40,1,21,ITA
6fe90922,22,13,11,6,5,12,33,21,33,4,29,19,41,36,1,21,ITA
7005ac66,0,0,0,0,0,0,0,0,0,0,0,0,0,0,0,21,ITA
7033ca08,0,0,0,0,0,0,0,0,0,0,0,0,0,0,0,21,ITA
71dc23da,27,15,17,8,2,13,28,15,14,2,12,13,40,25,0,21,ITA
7280b54f,0,0,0,0,0,0,0,0,0,0,0,0,0,0,0,21,ITA
72be9309,0,0,0,0,0,0,0,0,0,0,0,0,0,2,0,21,ITA
73ddc40c,1,1,0,1,0,0,0,0,0,0,0,1,2,0,0,21,ITA
741e058f,24,14,16,6,2,13,36,23,19,5,14,16,40,12,2,21,ITA
74419746,1,0,1,0,0,1,1,0,0,0,0,0,1,6,3,21,ITA
75b86fb3,36,22,13,21,2,17,27,10,34,16,18,40,76,75,0,21,ITA
75e60d75,5,3,1,3,1,0,2,2,4,3,1,0,5,2,0,21,ITA
75efed2e,5,2,4,0,1,0,1,1,0,0,0,0,5,0,0,21,ITA
75f2c59f,18,11,7,8,3,7,23,16,24,5,19,27,45,24,0,21,ITA
7737dee2,2,2,2,0,0,1,3,2,1,0,1,0,2,0,0,21,ITA
77d6fd4d,0,0,0,0,0,0,0,0,0,0,0,0,0,1,0,21,ITA
780e3631,14,7,4,6,4,7,24,17,17,2,15,17,31,7,1,21,ITA
78841da9,10,7,0,6,4,5,9,4,4,1,3,4,14,5,0,21,ITA
79083382,3,1,2,1,0,2,4,2,1,0,1,2,5,5,0,21,ITA
79443529,13,4,3,4,6,5,16,11,16,2,14,4,17,15,0,21,ITA
7b075c75,24,14,17,7,0,6,12,6,28,23,5,20,44,72,0,21,ITA
7b082ec2,23,13,19,3,1,11,28,17,14,1,13,16,39,32,0,21,ITA
7ba1f1ef,19,10,7,7,5,11,19,8,6,1,5,17,36,27,0,21,ITA
7cd520e8,6,4,2,2,2,2,2,0,3,0,3,2,8,4,0,21,ITA
7d3cbc67,11,5,6,4,1,6,16,10,12,2,10,12,23,15,0,21,ITA
7d50454d,25,19,13,10,2,14,26,12,23,12,11,25,50,58,1,21,ITA
7eb97a8e,22,11,7,12,3,10,31,21,15,0,15,9,31,7,0,21,ITA
7ec7738e,3,1,2,1,0,1,2,1,2,0,2,1,4,2,1,21,ITA
7edfbb8a,28,18,17,9,2,8,14,6,32,20,12,18,46,61,1,21,ITA
7f267d66,19,8,7,7,5,13,36,23,10,3,7,14,33,12,0,21,ITA
7f78ad23,21,14,11,8,2,13,22,9,16,5,11,20,41,43,0,21,ITA
7fac99d4,54,33,26,22,6,27,53,26,29,10,19,29,83,15,0,21,ITA
7fd58fe3,14,7,6,5,3,7,15,8,10,1,9,4,18,13,0,21,ITA
7fe90ccd,33,16,15,13,5,15,30,15,17,1,16,18,51,41,0,21,ITA
801831fe,1,0,0,1,0,0,2,2,0,0,0,0,1,0,0,21,ITA
80dbbd10,9,2,2,6,1,3,22,19,21,5,16,6,15,51,0,21,ITA
81255c03,13,6,2,6,5,2,27,25,32,6,26,13,26,28,0,21,ITA
817c6964,15,12,6,6,3,7,17,10,12,2,10,10,25,9,0,21,ITA
81a4c239,2,1,1,1,0,0,10,10,8,1,7,5,7,8,0,21,ITA
822a7761,3,2,0,1,2,0,3,3,5,1,4,3,6,5,0,21,ITA
82328faf,0,0,0,0,0,0,0,0,1,0,1,0,0,1,1,21,ITA
825b8997,0,0,0,0,0,0,0,0,1,1,0,6,6,7,1,21,ITA
82b1198a,0,0,0,0,0,0,0,0,0,0,0,0,0,4,0,21,ITA
82dbf623,4,1,2,2,0,2,5,3,3,0,3,2,6,17,0,21,ITA
82efe6fa,59,37,28,25,6,25,45,20,38,17,21,68,127,78,3,21,ITA
83e4643e,22,14,9,10,3,13,39,26,30,4,26,27,49,19,0,21,ITA
852351df,21,11,11,7,3,13,24,11,18,4,14,27,48,11,0,21,ITA
854ee61a,13,8,5,5,3,5,13,8,9,0,9,7,20,5,0,21,ITA
85f7d1be,18,14,11,6,1,10,14,4,9,3,6,19,37,20,0,21,ITA
8650af85,32,20,15,14,3,10,23,13,46,37,9,50,82,100,1,21,ITA
8697c095,3,1,2,1,0,3,4,1,0,0,0,1,4,1,0,21,ITA
875898c7,22,16,18,4,0,10,17,7,9,5,4,17,39,48,1,21,ITA
8790f988,19,10,6,7,6,7,19,12,21,4,17,9,28,12,0,21,ITA
8794e251,72,42,24,41,7,28,60,32,32,11,21,43,115,29,1,21,ITA
881ef58c,2,2,2,0,0,2,2,0,0,0,0,0,2,0,0,21,ITA
88895312,15,8,3,11,1,6,14,8,5,1,4,2,17,0,0,21,ITA
88c89891,4,3,2,2,0,3,7,4,10,1,9,4,8,12,0,21,ITA
89976232,30,16,13,13,4,13,33,20,22,9,13,53,83,62,0,21,ITA
89b2c8a9,16,14,4,7,5,5,25,20,7,1,6,9,25,3,1,21,ITA
8abd0c03,40,18,23,16,1,20,39,19,21,9,12,24,64,43,0,21,ITA
8b609c34,29,14,16,6,7,17,33,16,13,3,10,29,58,40,0,21,ITA
8b66d9cc,27,17,8,12,7,11,31,20,6,0,6,4,31,11,0,21,ITA
8b8a56ce,45,26,23,20,2,18,30,12,42,26,16,42,87,125,0,21,ITA
8b95acda,28,16,19,8,1,13,23,10,43,29,14,68,96,133,1,21,ITA
8bc8829a,18,10,11,7,0,6,19,13,10,5,5,15,33,10,0,21,ITA
8c65eb5f,1,1,1,0,0,1,1,0,1,0,1,2,3,0,0,21,ITA
8c725b43,34,20,22,12,0,18,32,14,26,14,12,36,70,109,1,21,ITA
8c90fd7a,22,15,2,6,14,3,15,12,6,0,6,7,29,10,0,21,ITA
8c964914,1,0,0,1,0,0,1,1,1,0,1,0,1,0,0,21,ITA
8cabdc1e,2,2,2,0,0,2,2,0,0,0,0,0,2,14,4,21,ITA
8cc29864,33,18,20,11,2,10,21,11,21,14,7,25,58,94,1,21,ITA
8d8178ac,13,6,2,3,8,1,15,14,18,0,18,7,20,29,0,21,ITA
8da74c05,39,25,23,15,1,11,27,16,31,8,23,32,71,46,2,21,ITA
8dfed6e9,9,4,1,7,1,1,13,12,4,0,4,2,11,4,0,21,ITA
8f68aa41,4,2,3,1,0,3,10,7,6,5,1,4,8,13,0,21,ITA
8f866fe8,2,2,0,2,0,0,1,1,3,1,2,3,5,5,0,21,ITA
8faf7b3c,16,10,8,3,5,7,27,20,10,0,10,7,23,9,0,21,ITA
8fef5412,22,11,17,4,1,13,27,14,13,4,9,17,39,23,0,21,ITA
90573602,0,0,0,0,0,0,0,0,3,0,3,2,2,3,0,21,ITA
9085dd7c,14,10,11,3,0,10,22,12,4,2,2,6,20,15,0,21,ITA
909bce7f,14,8,6,7,1,9,24,15,11,2,9,8,22,11,0,21,ITA
90b70194,44,27,21,18,5,26,61,35,41,5,36,22,66,24,1,21,ITA
91899ca8,3,2,3,0,0,2,3,1,6,2,4,5,8,5,0,21,ITA
919dd4b1,0,0,0,0,0,0,1,1,0,0,0,0,0,0,0,21,ITA
91d0fabf,20,11,12,5,3,12,21,9,13,4,9,11,31,27,0,21,ITA
921f6058,67,33,41,19,7,24,48,24,30,16,14,79,146,60,2,21,ITA
92b4758e,40,23,26,12,2,13,29,16,33,17,16,58,98,60,1,21,ITA
92d83c27,38,17,21,9,8,16,45,29,25,4,21,30,68,25,1,21,ITA
933d3b51,39,28,30,8,1,10,20,10,35,20,15,28,67,73,0,21,ITA
93b891d1,10,7,4,4,2,1,8,7,7,0,7,4,14,2,0,21,ITA
93cf32a8,14,9,11,3,0,7,12,5,28,14,14,33,47,71,1,21,ITA
9413b19f,0,0,0,0,0,0,1,1,0,0,0,0,0,5,0,21,ITA
94816803,7,3,2,3,2,0,7,7,4,0,4,5,12,3,0,21,ITA
94a3606c,0,0,0,0,0,0,0,0,0,0,0,0,0,1,0,21,ITA
94b2001f,62,31,37,16,9,35,66,31,32,12,20,66,128,68,2,21,ITA
952a03fe,15,10,6,9,0,4,5,1,16,9,7,18,33,41,0,21,ITA
957e4c87,61,36,26,28,7,21,53,32,33,6,27,19,80,25,1,21,ITA
9592289a,15,9,4,6,5,6,20,14,14,0,14,3,18,5,1,21,ITA
95facda1,56,28,23,23,10,25,68,43,26,4,22,23,79,49,0,21,ITA
963a328b,52,32,24,24,4,25,54,29,22,2,20,22,74,15,1,21,ITA
9654d8de,2,2,0,1,1,1,8,7,3,0,3,2,4,8,0,21,ITA
96640846,0,0,0,0,0,0,0,0,0,0,0,0,0,1,0,21,ITA
96960855,7,6,7,0,0,4,7,3,0,0,0,3,10,1,0,21,ITA
96e0490d,36,21,15,10,11,20,35,15,11,2,9,23,59,42,0,21,ITA
970b8574,32,19,23,7,2,13,28,15,18,9,9,47,79,50,1,21,ITA
97e8ea97,2,1,1,1,0,2,3,1,1,0,1,0,2,1,0,21,ITA
980522ec,12,6,6,4,2,7,20,13,16,1,15,9,21,13,1,21,ITA
983ff2c7,24,11,14,7,3,14,28,14,18,3,15,17,41,24,0,21,ITA
98d2c2c4,63,39,17,38,8,32,76,44,52,4,48,39,102,27,2,21,ITA
997fff07,38,20,28,8,2,16,27,11,17,7,10,27,65,74,1,21,ITA
9d4c45d6,48,26,15,20,13,15,64,49,31,8,23,18,66,43,0,21,ITA
9d5ab351,2,1,1,0,1,0,3,3,1,0,1,0,2,0,0,21,ITA
9d60028d,0,0,0,0,0,0,0,0,0,0,0,0,0,1,0,21,ITA
9dc96f10,0,0,0,0,0,0,0,0,0,0,0,0,0,0,0,21,ITA
9e1577aa,42,23,19,15,8,27,45,18,23,9,14,27,69,56,3,21,ITA
9f84febe,36,23,19,12,5,21,48,27,18,1,17,30,66,32,0,21,ITA
9fa26bc2,1,1,1,0,0,1,1,0,0,0,0,0,1,1,3,21,ITA
a111cf41,1,1,1,0,0,1,1,0,0,0,0,1,2,8,1,21,ITA
a128b07e,19,11,10,9,0,11,38,27,15,2,13,6,25,15,0,21,ITA
a3d94a58,63,32,41,19,3,27,49,22,31,13,18,96,159,71,2,21,ITA
a40819d9,16,11,8,7,1,5,17,12,12,5,7,24,40,38,1,21,ITA
a4948e67,12,5,2,6,4,4,7,3,15,1,14,3,15,20,0,21,ITA
a4e85758,15,9,9,6,0,7,12,5,17,9,8,23,38,34,0,21,ITA
a4fe8cda,4,3,1,2,1,1,2,1,1,0,1,1,5,0,0,21,ITA
a5055b1b,1,1,0,1,0,0,0,0,0,0,0,1,2,0,0,21,ITA
a5296e55,18,10,8,7,3,7,20,13,23,4,19,18,36,12,0,21,ITA
a5f458d9,18,12,11,6,1,11,26,15,8,0,8,5,23,7,0,21,ITA
a69cc629,0,0,0,0,0,0,0,0,2,0,2,3,3,3,0,21,ITA
a69e4806,29,18,10,13,6,10,36,26,37,1,36,18,47,14,0,21,ITA
a69eb5fd,0,0,0,0,0,0,0,0,0,0,0,0,0,0,0,21,ITA
a8a874f1,81,47,43,28,10,29,56,27,35,15,20,51,132,65,1,21,ITA
a8f21b9f,9,4,3,6,0,6,31,25,9,0,9,6,15,1,0,21,ITA
a96e5dc0,21,12,16,3,2,12,27,15,15,7,8,13,34,28,0,21,ITA
a9aa0d1d,24,13,8,9,7,6,9,3,1,0,1,3,27,1,0,21,ITA
aae9d04a,62,33,36,19,7,28,51,23,48,17,31,49,111,83,1,21,ITA
ab1ca213,24,17,10,10,4,12,34,22,12,1,11,12,36,25,0,21,ITA
ab4449d6,1,1,1,0,0,1,4,3,0,0,0,0,1,23,5,21,ITA
ac4003af,2,2,2,0,0,1,3,2,0,0,0,2,4,5,1,21,ITA
ac7e640b,1,0,0,1,0,1,1,0,3,2,1,4,5,3,0,21,ITA
ad84294f,0,0,0,0,0,0,0,0,0,0,0,1,1,0,0,21,ITA
aded8e6f,1,0,1,0,0,1,4,3,1,0,1,0,1,0,0,21,ITA
ae4e2852,0,0,0,0,0,0,0,0,0,0,0,0,0,1,0,21,ITA
ae5b04fe,26,19,17,9,0,9,14,5,10,2,8,18,44,19,1,21,ITA
ae64d449,26,14,11,12,3,12,28,16,10,1,9,12,38,9,0,21,ITA
ae7058f9,48,34,28,16,4,23,37,14,25,13,12,37,85,43,1,21,ITA
ae82fa48,14,8,6,7,1,5,11,6,11,0,11,7,21,8,0,21,ITA
ae94a6c5,0,0,0,0,0,0,1,1,0,0,0,0,0,0,0,21,ITA
ae9898c5,3,0,1,2,0,2,3,1,2,0,2,4,7,2,0,21,ITA
afa0d4e0,7,6,2,4,1,2,3,1,0,0,0,2,9,3,0,21,ITA
afe31d55,0,0,0,0,0,0,0,0,0,0,0,0,0,0,0,21,ITA
b0243215,1,0,1,0,0,1,3,2,8,5,3,7,8,9,1,21,ITA
b02af64f,0,0,0,0,0,0,0,0,0,0,0,0,0,0,0,21,ITA
b056e3da,0,0,0,0,0,0,0,0,0,0,0,0,0,0,1,21,ITA
b0f7e36c,53,28,23,16,14,22,58,36,26,2,24,13,66,19,0,21,ITA
b1236c63,6,4,2,3,1,2,13,11,5,0,5,1,7,7,0,21,ITA
b1deecf8,18,12,11,7,0,10,14,4,15,11,4,15,33,56,0,21,ITA
b3af9be1,47,31,27,14,6,21,34,13,37,19,18,54,101,106,0,21,ITA
b3fd7075,9,7,4,2,3,6,12,6,7,1,6,7,16,7,0,21,ITA
b4a3d61a,0,0,0,0,0,0,0,0,1,0,1,0,0,0,0,21,ITA
b5bf1770,21,14,13,6,2,8,14,6,36,26,10,46,67,76,0,21,ITA
b6964eb6,14,8,5,7,2,6,10,4,17,11,6,28,42,46,1,21,ITA
b6b2b820,40,24,15,22,3,16,37,21,17,6,11,19,59,15,0,21,ITA
b70bde8f,9,6,3,5,1,4,11,7,6,1,5,7,16,1,0,21,ITA
b7a5bc86,20,15,9,7,4,11,19,8,14,1,13,16,36,21,0,21,ITA
b96b595c,51,32,34,13,4,18,40,22,24,15,9,76,127,121,2,21,ITA
ba1e04b3,35,22,17,15,3,12,35,23,26,7,19,22,57,27,0,21,ITA
ba3d3bea,7,2,1,5,1,4,18,14,3,1,2,9,16,7,0,21,ITA
bb376bed,26,14,11,11,4,7,21,14,17,5,12,27,53,26,0,21,ITA
bbafc0c4,48,33,25,14,9,24,38,14,21,7,14,16,64,38,0,21,ITA
bd84fc61,37,22,25,12,0,19,47,28,19,5,14,32,69,29,2,21,ITA
bdc74a8f,44,18,14,24,6,18,61,43,25,3,22,22,66,14,1,21,ITA
bdd0692f,1,0,0,1,0,1,1,0,0,0,0,1,2,0,0,21,ITA
be2706c0,24,14,18,5,1,12,22,10,19,4,15,18,42,35,1,21,ITA
be927d03,15,7,8,4,3,3,13,10,13,0,13,6,21,31,0,21,ITA
bee704fc,49,29,33,14,2,21,33,12,42,33,9,44,93,122,1,21,ITA
bf309d24,10,8,4,6,0,2,8,6,11,2,9,12,22,4,0,21,ITA
bf356094,11,4,2,6,3,3,11,8,6,0,6,6,17,1,0,21,ITA
bf39bdec,1,1,0,0,1,0,2,2,4,0,4,1,2,1,0,21,ITA
bf4d31d3,0,0,0,0,0,0,0,0,0,0,0,0,0,0,0,21,ITA
bf57eaab,6,4,0,4,2,2,13,11,4,0,4,2,8,3,0,21,ITA
c010b898,31,16,22,8,1,21,35,14,39,18,21,48,79,94,4,21,ITA
c01c66d9,3,1,2,0,1,3,5,2,1,0,1,0,3,3,0,21,ITA
c0c7ff58,58,31,26,21,11,25,70,45,33,3,30,36,94,32,1,21,ITA
c195ae4a,0,0,0,0,0,0,0,0,0,0,0,0,0,0,0,21,ITA
c1d95617,0,0,0,0,0,0,0,0,1,0,1,0,0,16,3,21,ITA
c1e8e74e,19,9,10,6,3,7,25,18,13,5,8,22,41,25,0,21,ITA
c235e803,9,5,3,6,0,2,2,0,8,6,2,3,12,21,0,21,ITA
c283ddef,2,0,0,2,0,0,6,6,0,0,0,0,2,3,0,21,ITA
c316607a,38,23,34,3,1,21,35,14,31,21,10,50,88,59,2,21,ITA
c3a847c7,0,0,0,0,0,0,0,0,0,0,0,0,0,0,0,21,ITA
c459a650,18,10,7,5,6,8,19,11,17,2,15,11,29,5,0,21,ITA
c4efe2b4,2,1,2,0,0,0,1,1,2,0,2,2,4,4,0,21,ITA
c50cee19,19,10,11,4,4,11,21,10,15,0,15,3,22,25,0,21,ITA
c53083ad,11,8,5,3,3,5,16,11,7,1,6,13,24,16,0,21,ITA
c56dc39e,51,23,21,26,4,26,48,22,37,7,30,33,84,66,0,21,ITA
c5adc293,6,5,3,2,1,0,1,1,4,2,2,3,9,1,0,21,ITA
c6056d58,44,24,33,10,1,25,53,28,37,31,6,62,106,153,0,21,ITA
c609e90e,0,0,0,0,0,0,1,1,0,0,0,0,0,0,0,21,ITA
c693347d,11,4,1,5,5,2,12,10,9,2,7,1,12,25,1,21,ITA
c6e8cf1f,32,13,11,18,3,15,50,35,23,5,18,17,49,17,0,21,ITA
c707411f,31,18,24,7,0,17,24,7,22,13,9,23,54,82,2,21,ITA
c7259b83,27,9,7,13,7,10,40,30,29,9,20,26,53,24,0,21,ITA
c730da00,8,4,3,5,0,2,6,4,7,5,2,14,22,11,1,21,ITA
c77be0cf,50,32,29,17,4,21,40,19,33,11,22,19,69,61,0,21,ITA
c803c92a,0,0,0,0,0,0,0,0,0,0,0,0,0,1,0,21,ITA
c8c0dccd,5,3,3,1,1,0,4,4,7,2,5,1,6,3,0,21,ITA
c976160c,10,8,5,5,0,0,0,0,2,0,2,1,11,0,0,21,ITA
ca241ad3,0,0,0,0,0,0,1,1,1,0,1,1,1,0,0,21,ITA
ca3db240,34,17,16,15,3,22,49,27,36,4,32,24,58,50,0,21,ITA
caffaf5a,17,4,10,7,0,7,13,6,45,34,11,57,74,93,1,21,ITA
cc1a0c57,0,0,0,0,0,0,1,1,0,0,0,0,0,4,2,21,ITA
cce9f582,26,15,14,9,3,9,16,7,25,16,9,44,70,105,1,21,ITA
cd0fa27b,26,7,3,17,6,7,28,21,21,6,15,15,41,24,1,21,ITA
cdf65d12,19,13,13,6,0,13,18,5,23,17,6,27,46,44,2,21,ITA
ce1a6c7e,0,0,0,0,0,0,0,0,0,0,0,0,0,0,0,21,ITA
ce30bfc8,30,17,17,8,5,5,28,23,15,3,12,19,49,16,0,21,ITA
cec60a2f,13,5,4,6,3,5,32,27,23,5,18,20,33,22,1,21,ITA
cedb3e36,47,22,11,31,5,17,63,46,38,14,24,19,66,28,0,21,ITA
cf007308,15,4,3,6,6,7,12,5,11,1,10,2,17,10,0,21,ITA
cf043a33,5,2,3,1,1,3,10,7,3,0,3,8,13,0,1,21,ITA
cf1c23d8,0,0,0,0,0,0,0,0,0,0,0,0,0,0,0,21,ITA
cfb38237,3,1,1,2,0,0,0,0,2,2,0,1,4,4,0,21,ITA
cfbf9881,6,5,5,1,0,3,5,2,5,3,2,1,7,10,0,21,ITA
d023d70f,38,28,13,19,6,16,45,29,19,5,14,15,53,7,0,21,ITA
d0d8dd44,28,16,15,12,1,15,24,9,24,18,6,41,69,95,0,21,ITA
d0dbca9f,27,15,16,9,2,15,24,9,18,6,12,23,50,26,0,21,ITA
d183e9d6,9,6,1,5,3,3,5,2,11,1,10,12,21,24,0,21,ITA
d1b49282,76,42,32,36,8,20,60,40,51,16,35,25,101,30,0,21,ITA
d3298c99,5,4,2,2,1,4,10,6,5,0,5,9,14,7,0,21,ITA
d37b0350,7,3,2,5,0,1,20,19,4,2,2,4,11,32,0,21,ITA
d3aaad90,4,3,0,3,1,2,9,7,3,1,2,3,7,2,0,21,ITA
d3b888e3,10,4,6,3,1,6,17,11,11,1,10,8,18,7,0,21,ITA
d3d758d8,21,9,9,10,2,9,26,17,13,5,8,9,30,13,0,21,ITA
d3de9af0,12,5,2,3,7,4,13,9,19,5,14,6,18,19,0,21,ITA
d4535821,38,22,22,15,1,20,40,20,38,6,32,40,78,54,0,21,ITA
d4931a5a,5,1,2,2,1,0,3,3,6,0,6,1,6,7,0,21,ITA
d4c9725f,48,29,22,21,5,19,38,19,29,6,23,34,82,64,5,21,ITA
d60099bc,2,2,0,2,0,1,6,5,5,0,5,1,3,2,0,21,ITA
d60c26fc,9,7,4,4,1,3,7,4,7,0,7,2,11,0,0,21,ITA
d6a889ea,7,4,4,2,1,0,2,2,5,0,5,5,12,8,0,21,ITA
d6e53a3a,37,19,20,16,1,18,28,10,42,21,21,31,68,64,0,21,ITA
d6f88a1d,49,22,21,22,6,18,54,36,34,1,33,30,79,10,1,21,ITA
d705ba44,30,18,4,16,10,11,35,24,27,4,23,12,42,21,0,21,ITA
d711d04f,9,5,1,6,2,4,10,6,6,0,6,2,11,7,1,21,ITA
d7d32194,6,3,0,3,3,2,9,7,11,0,11,4,10,8,0,21,ITA
d80b1835,7,4,5,0,2,5,12,7,9,1,8,14,21,15,0,21,ITA
d85c238b,27,13,8,11,8,8,25,17,28,4,24,27,54,13,1,21,ITA
d9565625,32,17,23,6,3,17,34,17,18,5,13,25,57,42,0,21,ITA
d9624b51,20,13,11,9,0,3,8,5,21,13,8,47,67,75,0,21,ITA
d97f2e8d,29,15,15,8,6,16,36,20,20,4,16,16,45,41,0,21,ITA
d995ed27,34,19,16,13,5,16,53,37,26,2,24,39,73,12,0,21,ITA
da5a981b,17,9,14,1,2,8,22,14,5,2,3,5,22,6,0,21,ITA
da974c7b,36,24,25,7,4,19,32,13,46,26,20,29,65,64,2,21,ITA
db092d3b,39,18,17,21,1,15,32,17,10,1,9,20,59,12,0,21,ITA
dc1c2fce,2,0,0,0,2,2,5,3,2,0,2,0,2,1,0,21,ITA
dc3fa3b5,56,32,26,22,8,23,63,40,14,1,13,11,67,15,1,21,ITA
dd06d56c,0,0,0,0,0,0,0,0,0,0,0,0,0,0,0,21,ITA
dd0daf32,58,24,13,27,18,13,62,49,34,0,34,39,97,10,0,21,ITA
dd52d069,0,0,0,0,0,0,1,1,0,0,0,0,0,0,0,21,ITA
dea698d9,6,3,1,3,2,3,15,12,11,3,8,5,11,15,1,21,ITA
df3cda47,33,19,12,10,11,14,43,29,22,0,22,9,42,2,1,21,ITA
df85d472,0,0,0,0,0,0,0,0,0,0,0,0,0,0,0,21,ITA
e0314d87,38,22,29,6,3,23,48,25,32,13,19,53,91,107,3,21,ITA
e0921a4f,14,8,3,4,7,2,14,12,15,0,15,1,15,1,0,21,ITA
e0ce7038,0,0,0,0,0,0,0,0,1,1,0,0,0,0,0,21,ITA
e14ec482,37,18,13,12,12,16,39,23,22,3,19,10,47,22,0,21,ITA
e1b0a70d,0,0,0,0,0,0,0,0,0,0,0,0,0,1,0,21,ITA
e1cbb531,1,1,0,1,0,0,1,1,1,1,0,0,1,1,1,21,ITA
e33f36d5,21,15,10,9,2,13,20,7,30,17,13,25,46,77,0,21,ITA
e358587b,0,0,0,0,0,0,1,1,0,0,0,1,1,6,0,21,ITA
e3cceee6,12,9,8,4,0,5,13,8,16,9,7,21,33,40,0,21,ITA
e40d028b,0,0,0,0,0,0,0,0,0,0,0,0,0,3,1,21,ITA
e42d61c7,53,32,23,19,11,23,48,25,31,1,30,22,75,23,1,21,ITA
e468c053,5,1,2,2,1,1,14,13,11,1,10,10,15,3,0,21,ITA
e4b39692,0,0,0,0,0,0,0,0,0,0,0,0,0,2,1,21,ITA
e58cbfd5,29,16,15,11,3,9,32,23,11,0,11,20,49,19,1,21,ITA
e599253a,26,15,5,17,4,12,19,7,12,1,11,8,34,6,0,21,ITA
e5bf73f3,26,10,8,10,8,10,25,15,37,2,35,11,37,15,0,21,ITA
e66ebabb,0,0,0,0,0,0,0,0,0,0,0,1,1,7,2,21,ITA
e74f0e59,34,24,18,13,3,16,37,21,37,10,27,30,64,62,3,21,ITA
e81f0356,2,1,2,0,0,2,7,5,2,0,2,2,4,8,0,21,ITA
e85fb9b8,12,9,9,3,0,5,11,6,18,13,5,27,39,56,0,21,ITA
e8c930bb,56,27,27,22,7,26,84,58,51,10,41,87,143,45,1,21,ITA
e921b9db,4,3,0,2,2,3,6,3,2,0,2,0,4,0,0,21,ITA
e947ee4a,35,19,18,15,2,11,44,33,33,4,29,45,80,34,0,21,ITA
e94d79e3,28,12,16,11,1,15,35,20,20,14,6,14,42,52,1,21,ITA
ea06dd97,12,7,3,6,3,6,10,4,2,0,2,9,21,5,0,21,ITA
ea164f99,4,0,3,1,0,2,3,1,3,1,2,6,10,0,0,21,ITA
ea468ea8,25,18,16,9,0,13,21,8,22,11,11,26,51,56,1,21,ITA
eb2fe5b6,20,9,4,8,8,9,26,17,17,0,17,7,27,4,0,21,ITA
eb76987d,20,10,10,8,2,8,22,14,13,4,9,24,44,37,1,21,ITA
ec1f737d,0,0,0,0,0,0,0,0,0,0,0,0,0,0,0,21,ITA
ec5dae45,18,9,9,6,3,3,15,12,6,1,5,10,28,7,0,21,ITA
eccbe56a,32,23,6,16,10,12,30,18,20,2,18,9,41,12,0,21,ITA
ed5886d2,21,8,8,11,2,8,20,12,20,6,14,14,35,31,0,21,ITA
ed90babd,12,6,7,4,1,0,18,18,17,1,16,6,18,4,0,21,ITA
eda40760,4,4,0,4,0,1,2,1,2,0,2,7,11,8,0,21,ITA
ee251371,43,26,20,18,5,19,60,41,29,1,28,25,68,6,0,21,ITA
ee4f2f3b,12,8,4,4,4,2,19,17,14,1,13,7,19,10,0,21,ITA
ee6e2b92,0,0,0,0,0,0,0,0,0,0,0,0,0,1,1,21,ITA
ee93c1a9,9,4,3,5,1,4,20,16,6,2,4,14,23,7,1,21,ITA
ef2e5e1a,30,18,13,15,2,14,32,18,35,3,32,25,55,18,0,21,ITA
ef619b0b,22,14,8,13,1,8,25,17,13,2,11,7,29,8,2,21,ITA
ef94dc2f,3,4,1,1,1,1,6,5,3,0,3,0,3,10,0,21,ITA
f058ed1f,0,0,0,0,0,0,0,0,0,0,0,0,0,1,0,21,ITA
f0f7f62f,1,0,1,0,0,1,2,1,1,0,1,1,2,11,0,21,ITA
f1cfc209,68,38,27,33,8,36,71,35,32,7,25,31,99,44,0,21,ITA
f1f1f238,20,10,10,9,1,4,9,5,27,21,6,70,90,87,0,21,ITA
f49c4ae9,60,35,26,24,10,22,70,48,32,12,20,35,95,40,0,21,ITA
f503ea63,56,29,21,32,3,23,65,42,31,12,19,49,105,35,0,21,ITA
f5409698,0,0,0,0,0,0,0,0,1,0,1,0,0,0,0,21,ITA
f554e29b,0,0,0,0,0,0,1,1,0,0,0,1,1,10,0,21,ITA
f61c7c4e,24,11,4,9,11,5,29,24,11,2,9,3,27,1,0,21,ITA
f6a06749,0,0,0,0,0,0,0,0,0,0,0,0,0,0,0,21,ITA
f6dfa5b8,39,23,25,8,6,21,45,24,23,4,19,28,67,47,0,21,ITA
f7036e1c,25,12,5,11,9,7,24,17,31,1,30,27,52,16,0,21,ITA
f7223718,30,16,15,11,4,13,24,11,13,3,10,18,48,51,1,21,ITA
f794b426,1,0,1,0,0,1,1,0,0,0,0,0,1,2,1,21,ITA
f7e2af2c,34,23,23,11,0,15,28,13,15,4,11,14,48,52,0,21,ITA
f8d41a8c,0,0,0,0,0,0,0,0,5,0,5,1,1,0,0,21,ITA
f91e81c9,17,11,14,3,0,8,25,17,26,11,15,24,41,65,0,21,ITA
f95f49d2,0,0,0,0,0,0,0,0,0,0,0,0,0,0,0,21,ITA
f9758dae,30,16,16,10,4,9,31,22,13,2,11,14,44,8,0,21,ITA
fb77bfef,32,21,24,6,2,8,23,15,33,20,13,50,82,85,1,21,ITA
fba81826,0,0,0,0,0,0,0,0,0,0,0,0,0,0,0,21,ITA
fc4f85b1,60,32,51,9,0,24,39,15,41,24,17,56,116,117,0,21,ITA
fdf4b948,38,25,13,22,3,8,27,19,24,6,18,18,56,13,0,21,ITA
fe012aca,11,9,5,0,6,3,11,8,10,0,10,8,19,7,0,21,ITA
fec5accc,1,0,0,1,0,0,1,1,1,0,1,0,1,0,0,21,ITA
fed5f993,33,24,23,10,0,8,29,21,58,36,22,51,84,127,2,21,ITA
ff120e44,0,0,0,0,0,0,0,0,0,0,0,0,0,0,0,21,ITA
ff800ed8,13,8,8,2,3,6,12,6,6,3,3,6,19,9,0,21,ITA
0033fb1b,28,14,9,12,7,11,24,13,20,1,19,23,51,16,0,21,FRA
005c0807,36,21,18,9,9,18,39,21,22,0,22,32,68,38,0,21,FRA
0118c54c,80,46,47,27,6,35,69,34,30,4,26,55,135,65,1,21,FRA
032f894e,13,7,4,8,1,5,25,20,13,2,11,13,26,8,0,21,FRA
037f2523,5,3,1,4,0,2,4,2,5,0,5,1,6,3,0,21,FRA
0557ff4f,6,3,5,1,0,4,6,2,2,1,1,2,8,11,2,21,FRA
0630eb63,6,5,1,2,3,2,12,10,8,0,8,3,9,1,0,21,FRA
065dc209,13,8,0,8,5,4,19,15,5,2,3,4,17,8,0,21,FRA
06c48679,60,39,26,28,6,22,38,16,37,19,18,56,116,81,1,21,FRA
06df8256,24,17,15,9,0,13,28,15,21,12,9,58,82,102,4,21,FRA
08082af0,14,7,9,5,0,13,28,15,22,19,3,31,45,52,0,21,FRA
08534272,2,2,0,1,1,0,5,5,1,0,1,0,2,3,0,21,FRA
09507ffa,1,1,0,1,0,0,0,0,2,1,1,0,1,2,0,21,FRA
095e4199,20,10,11,1,8,8,22,14,12,1,11,3,23,8,0,21,FRA
0a8d6b91,5,4,1,4,0,4,5,1,0,0,0,3,8,0,0,21,FRA
0ad37003,58,31,24,33,1,25,60,35,34,5,29,31,89,13,1,21,FRA
0b0cbe5b,52,28,22,24,6,16,58,42,32,3,29,20,72,36,0,21,FRA
0b4d8274,12,7,5,6,1,4,24,20,17,1,16,7,19,11,0,21,FRA
0bb6e193,30,20,20,8,2,7,19,12,6,2,4,9,39,13,0,21,FRA
0be95d34,30,11,5,14,11,5,25,20,6,0,6,3,33,4,1,21,FRA
0c2ac3cb,54,26,18,28,8,28,49,21,18,3,15,13,67,6,0,21,FRA
0cbc8baa,38,21,24,14,0,15,32,17,24,16,8,30,68,70,0,21,FRA
0d2158d5,34,17,9,23,2,23,56,33,14,5,9,23,57,12,2,21,FRA
0d3585b5,4,2,0,3,1,0,3,3,2,0,2,1,5,2,0,21,FRA
0d7b6576,4,3,2,1,1,1,6,5,4,0,4,2,6,5,0,21,FRA
0d99c6e1,0,0,0,0,0,0,0,0,0,0,0,0,0,0,0,21,FRA
0e46fa2f,0,0,0,0,0,0,0,0,0,0,0,0,0,0,0,21,FRA
0e7ccfc4,55,30,29,17,9,33,60,27,28,10,18,38,93,40,1,21,FRA
0f26fd24,4,1,2,0,2,1,1,0,0,0,0,0,4,0,0,21,FRA
0f8418aa,68,48,25,35,8,28,68,40,22,5,17,48,116,44,0,21,FRA
0f86995c,4,3,2,2,0,2,9,7,2,0,2,3,7,6,0,21,FRA
0f9b8301,5,2,1,4,0,2,9,7,0,0,0,4,9,5,0,21,FRA
1001ae82,9,4,1,7,1,4,8,4,3,0,3,5,14,5,0,21,FRA
10efd0e1,17,9,3,12,2,4,15,11,8,2,6,12,29,7,0,21,FRA
10f0fdd3,56,39,22,25,9,14,23,9,20,2,18,19,75,16,0,21,FRA
114bbdee,57,34,47,10,0,30,55,25,43,17,26,74,131,135,2,21,FRA
11ff3d56,14,9,2,9,3,4,8,4,4,0,4,3,17,3,0,21,FRA
12bd0579,12,6,6,3,3,7,12,5,2,1,1,12,24,16,1,21,FRA
132a82f1,6,4,6,0,0,3,4,1,3,3,0,8,14,14,1,21,FRA
1467af0d,53,30,17,25,11,24,72,48,22,5,17,26,79,4,1,21,FRA
14b8fcdf,0,0,0,0,0,0,1,1,1,1,0,1,1,1,0,21,FRA
1545cf15,28,19,19,5,4,16,28,12,14,2,12,14,42,35,0,21,FRA
15944afd,11,5,6,5,0,3,7,4,1,0,1,1,12,2,0,21,FRA
16324e1d,12,7,9,3,0,9,19,10,19,12,7,33,45,57,2,21,FRA
165a2e40,13,6,3,7,3,4,30,26,7,0,7,5,18,22,0,21,FRA
166a981d,0,0,0,0,0,0,0,0,0,0,0,0,0,0,0,21,FRA
16aa7d4c,51,29,31,19,1,27,41,14,54,41,13,64,115,151,0,21,FRA
1787195f,18,8,7,5,6,8,20,12,9,0,9,6,24,5,0,21,FRA
17f29fb0,0,0,0,0,0,0,2,2,0,0,0,0,0,0,0,21,FRA
18ebca4b,24,15,6,11,7,12,32,20,15,1,14,9,33,19,0,21,FRA
19053e31,49,34,17,25,7,18,53,35,25,1,24,31,80,15,0,21,FRA
19a12bed,65,39,40,16,9,27,49,22,39,12,27,55,120,61,1,21,FRA
19ba6c6d,15,11,3,11,1,3,28,25,18,3,15,12,27,40,0,21,FRA
19cda00b,26,17,6,8,12,11,45,34,14,1,13,6,32,7,0,21,FRA
1a4b9094,1,1,0,0,1,1,1,0,1,1,0,1,2,1,0,21,FRA
1a992676,13,6,5,6,2,5,20,15,4,0,4,14,27,0,0,21,FRA
1ad8cb67,10,7,7,3,0,7,7,0,6,4,2,11,21,28,0,21,FRA
1b6862e8,15,7,7,3,5,5,14,9,7,1,6,7,22,3,0,21,FRA
1bfe34dc,11,8,7,4,0,4,9,5,2,0,2,4,15,11,0,21,FRA
1d2d5cc8,0,0,0,0,0,0,1,1,0,0,0,2,2,8,6,21,FRA
1ddbc7ca,12,8,7,4,1,6,11,5,10,2,8,6,18,14,0,21,FRA
1df4a109,3,1,0,3,0,2,3,1,1,0,1,0,3,0,0,21,FRA
1ec7e1c5,22,13,13,8,1,12,18,6,17,13,4,44,66,99,1,21,FRA
1f6298f2,0,0,0,0,0,0,0,0,0,0,0,0,0,0,0,21,FRA
20094685,1,1,1,0,0,0,2,2,0,0,0,2,3,2,0,21,FRA
2054d037,3,2,2,1,0,0,0,0,2,0,2,1,4,2,0,21,FRA
20de219a,0,0,0,0,0,0,0,0,0,0,0,0,0,1,0,21,FRA
20e73fac,40,23,17,16,7,21,71,50,37,1,36,19,59,25,0,21,FRA
2145368f,66,36,30,25,11,30,65,35,48,19,29,59,125,39,2,21,FRA
22721b88,11,9,9,1,1,9,12,3,12,2,10,27,38,33,1,21,FRA
2306bfde,0,0,0,0,0,0,0,0,0,0,0,1,1,0,0,21,FRA
2321ea6e,42,29,16,24,2,18,49,31,27,5,22,44,86,44,0,21,FRA
23bf644d,0,0,0,0,0,0,4,4,0,0,0,5,5,1,0,21,FRA
23c63b7f,4,3,0,2,2,3,12,9,7,1,6,6,10,3,0,21,FRA
2434f24a,1,1,1,0,0,1,3,2,1,0,1,1,2,17,0,21,FRA
243f4a0b,54,31,33,19,2,26,55,29,20,5,15,26,80,36,0,21,FRA
244bc2c8,23,12,3,11,9,4,22,18,19,5,14,12,35,37,1,21,FRA
24eb7ed6,41,29,20,14,7,26,38,12,27,14,13,39,80,46,0,21,FRA
2500cef9,35,20,12,14,9,11,34,23,25,3,22,20,55,14,0,21,FRA
25146df0,0,0,0,0,0,0,0,0,0,0,0,0,0,0,0,21,FRA
2515040a,35,18,21,13,1,16,21,5,33,24,9,52,87,123,1,21,FRA
2591b066,25,15,16,6,3,13,32,19,17,2,15,9,34,18,0,21,FRA
26777636,74,37,30,33,11,35,92,57,27,2,25,39,113,17,2,21,FRA
2677a1de,24,15,12,7,5,12,24,12,10,1,9,4,28,11,0,21,FRA
2693f6bc,1,0,0,0,1,0,0,0,0,0,0,0,1,0,0,21,FRA
2736b85e,6,3,3,3,0,3,7,4,3,0,3,2,8,0,0,21,FRA
275e2c51,47,25,34,11,2,20,35,15,35,20,15,50,97,138,0,21,FRA
279ddf6a,92,50,47,38,7,26,74,48,43,9,34,43,135,29,1,21,FRA
288e1e13,37,30,28,9,0,21,33,12,34,22,12,47,84,102,0,21,FRA
28a65a2c,2,1,2,0,0,2,3,1,0,0,0,2,4,9,2,21,FRA
28dabd43,1,1,1,0,0,1,2,1,0,0,0,2,3,23,1,21,FRA
28f66c2e,21,15,16,5,0,10,16,6,3,0,3,6,27,12,0,21,FRA
2945f4b7,7,4,1,1,5,2,12,10,2,0,2,2,9,4,0,21,FRA
295ba708,22,14,10,11,1,9,21,12,12,3,9,12,34,7,0,21,FRA
29939a1d,0,0,0,0,0,0,7,7,6,1,5,4,4,1,0,21,FRA
29aee77c,0,0,0,0,0,0,0,0,0,0,0,1,1,0,0,21,FRA
29c02c9f,23,11,4,17,2,14,19,5,18,5,13,16,39,18,1,21,FRA
29d8ad3f,17,11,13,4,0,8,14,6,17,12,5,25,42,46,1,21,FRA
29ef0f49,6,4,2,3,1,0,4,4,4,2,2,0,6,6,0,21,FRA
2a657da0,40,17,15,19,6,13,43,30,11,0,11,17,57,12,0,21,FRA
2ab14aaa,5,3,5,0,0,3,6,3,3,2,1,6,11,11,0,21,FRA
2acf0cd7,35,19,19,14,2,21,41,20,33,25,8,57,92,85,3,21,FRA
2aeb43f1,2,1,2,0,0,1,1,0,1,0,1,0,2,1,0,21,FRA
2b1bed19,69,39,32,28,9,31,66,35,26,5,21,57,126,34,0,21,FRA
2b5a35e5,2,2,1,1,0,0,1,1,2,0,2,1,3,0,0,21,FRA
2b9b37b2,0,0,0,0,0,0,0,0,0,0,0,0,0,0,1,21,FRA
2b9fdeea,40,22,14,21,5,20,54,34,26,2,24,14,54,11,0,21,FRA
2c127b6f,0,0,0,0,0,0,0,0,0,0,0,0,0,1,0,21,FRA
2d22cea7,30,10,10,19,1,7,26,19,21,0,21,15,45,4,0,21,FRA
2d70dbe5,0,0,0,0,0,0,1,1,1,0,1,0,0,15,2,21,FRA
2d9f280e,2,0,0,0,2,1,3,2,0,0,0,1,3,1,0,21,FRA
2fa2a875,0,0,0,0,0,0,2,2,1,0,1,2,2,20,1,21,FRA
3010aefb,36,21,17,15,4,16,36,20,16,3,13,20,56,17,0,21,FRA
30144daa,18,5,7,10,1,8,23,15,12,0,12,14,32,6,0,21,FRA
3043d33f,20,12,8,8,4,7,38,31,20,2,18,8,28,10,0,21,FRA
3071a619,7,3,1,4,2,3,8,5,6,0,6,5,12,4,0,21,FRA
309937e7,0,0,0,0,0,0,2,2,0,0,0,2,2,7,0,21,FRA
30af8b93,50,34,25,20,5,31,51,20,20,3,17,16,66,37,0,21,FRA
31626657,145,84,64,69,12,54,162,108,64,6,58,46,191,12,0,21,FRA
31a62dc7,72,33,30,30,12,44,81,37,32,6,26,38,110,52,0,21,FRA
3225654e,3,1,2,1,0,2,2,0,1,1,0,3,6,1,0,21,FRA
329e7a13,0,0,0,0,0,0,0,0,0,0,0,0,0,0,0,21,FRA
32c2d95f,59,37,36,23,0,26,42,16,34,15,19,61,120,132,0,21,FRA
32f3d97e,18,3,7,8,3,11,18,7,10,0,10,7,25,4,1,21,FRA
33508c78,20,12,6,9,5,9,22,13,11,1,10,13,33,3,0,21,FRA
33887998,0,0,0,0,0,0,0,0,0,0,0,0,0,0,0,21,FRA
3423f250,5,2,1,3,1,1,4,3,5,0,5,3,8,4,0,21,FRA
34e4343c,2,1,0,2,0,1,4,3,3,1,2,0,2,3,0,21,FRA
3544641e,5,3,1,3,1,2,10,8,0,0,0,1,6,1,0,21,FRA
3681cfff,19,13,12,6,1,10,12,2,13,9,4,31,50,41,2,21,FRA
3708e9fa,28,16,6,18,4,8,39,31,21,0,21,11,39,3,0,21,FRA
375622c5,58,40,34,22,2,31,103,72,30,5,25,8,66,18,1,21,FRA
380a15e2,0,0,0,0,0,0,0,0,0,0,0,1,1,2,0,21,FRA
3814120d,1,1,1,0,0,1,3,2,0,0,0,1,2,2,1,21,FRA
39c0c75b,0,0,0,0,0,0,0,0,1,1,0,1,1,0,0,21,FRA
3befc2b6,65,41,50,15,0,39,70,31,34,15,19,59,124,103,0,21,FRA
3c6bbbab,104,68,64,30,10,43,73,30,62,17,45,112,216,119,1,21,FRA
3cd7820a,32,22,18,11,3,15,28,13,10,0,10,24,56,18,0,21,FRA
3d50bcdb,11,8,2,6,3,3,12,9,7,1,6,8,19,10,0,21,FRA
3dd738a1,63,37,32,21,10,32,52,20,30,3,27,47,110,43,1,21,FRA
3ef0fa48,41,26,12,16,13,15,37,22,20,0,20,13,54,8,0,21,FRA
3ef68782,13,6,1,8,4,2,9,7,7,1,6,2,15,7,0,21,FRA
3f5b4635,59,35,45,12,2,36,70,34,50,33,17,69,128,144,3,21,FRA
4047c976,3,1,0,2,1,1,7,6,1,0,1,0,3,2,0,21,FRA
40774c6b,5,3,3,2,0,2,4,2,2,0,2,0,5,0,0,21,FRA
414e1f69,3,3,1,0,2,0,1,1,2,0,2,0,3,1,0,21,FRA
41e7ef1c,26,19,10,10,6,9,28,19,20,5,15,28,54,26,1,21,FRA
42dcf26d,26,17,20,6,0,19,31,12,30,18,12,33,59,119,1,21,FRA
42eaa028,18,12,3,8,7,9,22,13,16,1,15,7,25,9,0,21,FRA
42fd9c7f,4,2,0,1,3,2,9,7,7,1,6,3,7,4,1,21,FRA
433dc9a2,5,3,0,4,1,3,5,2,4,0,4,1,6,6,0,21,FRA
436a9dd0,53,35,17,26,10,30,77,47,31,5,26,31,84,22,1,21,FRA
43b78598,6,2,1,2,3,4,13,9,3,1,2,3,9,7,0,21,FRA
43e7a164,60,41,45,13,2,32,52,20,28,10,18,91,151,104,0,21,FRA
44f8c299,47,32,20,22,5,16,49,33,20,3,17,20,67,30,4,21,FRA
450e277f,11,6,8,3,0,8,23,15,13,11,2,21,32,40,0,21,FRA
45bb4303,1,0,1,0,0,0,2,2,0,0,0,0,1,0,0,21,FRA
45c1c326,22,12,10,9,3,6,18,12,10,0,10,11,33,8,0,21,FRA
462475ed,30,18,6,18,6,7,31,24,14,5,9,11,41,54,0,21,FRA
46359159,26,13,8,14,4,11,36,25,8,0,8,12,38,6,0,21,FRA
46750e9c,33,19,9,13,11,8,28,20,17,0,17,14,47,10,0,21,FRA
468fdbad,11,9,5,4,2,5,14,9,11,2,9,13,24,2,1,21,FRA
46907171,1,1,1,0,0,1,6,5,0,0,0,2,3,2,0,21,FRA
469d3d84,8,2,5,0,3,3,12,9,6,2,4,4,12,5,0,21,FRA
46a7b605,12,10,6,4,2,4,10,6,5,0,5,1,13,0,0,21,FRA
46faabfa,1,1,0,0,1,1,2,1,3,0,3,0,1,8,0,21,FRA
475583ff,21,12,12,7,2,12,29,17,10,3,7,16,37,28,0,21,FRA
47af88b8,25,16,16,9,0,6,13,7,36,25,11,27,52,91,1,21,FRA
47c609d5,22,12,3,16,3,8,18,10,8,3,5,6,28,10,1,21,FRA
48b28bfd,47,25,18,26,3,20,51,31,17,5,12,54,101,33,0,21,FRA
49070d66,7,4,4,3,0,5,12,7,5,4,1,8,15,16,0,21,FRA
49136c42,26,17,17,9,0,13,28,15,44,31,13,59,85,118,4,21,FRA
4914ed4a,7,6,7,0,0,1,2,1,4,1,3,6,13,8,0,21,FRA
4a537185,0,0,0,0,0,0,1,1,0,0,0,0,0,0,0,21,FRA
4a57580c,11,7,7,2,2,5,10,5,5,0,5,6,17,7,0,21,FRA
4a987ffa,6,4,2,2,2,1,7,6,6,0,6,5,11,7,0,21,FRA
4b6960d2,23,16,12,8,3,9,18,9,14,3,11,29,52,43,0,21,FRA
4b96c347,22,13,4,12,6,12,34,22,17,0,17,15,37,9,0,21,FRA
4bd00a50,5,3,5,0,0,3,7,4,1,1,0,3,8,12,0,21,FRA
4be0b467,15,10,3,9,3,4,18,14,6,3,3,5,20,16,0,21,FRA
4bf69118,21,12,15,4,2,14,27,13,15,3,12,26,47,27,0,21,FRA
4c4ffacc,25,11,17,8,0,7,31,24,14,2,12,18,43,36,0,21,FRA
4c5b714f,58,34,26,29,3,37,52,15,20,5,15,50,108,37,2,21,FRA
4e0afc5d,50,33,35,13,2,27,48,21,15,6,9,17,67,34,0,21,FRA
4e7db402,1,0,1,0,0,1,1,0,1,0,1,0,1,14,0,21,FRA
4e9957ff,0,0,0,0,0,0,0,0,2,1,1,1,1,3,0,21,FRA
4eb0686f,6,1,2,2,2,2,9,7,9,0,9,1,7,2,0,21,FRA
4ef705ab,6,3,1,4,1,3,3,0,2,0,2,1,7,2,0,21,FRA
4f255115,127,68,47,62,18,48,92,44,39,11,28,60,187,47,0,21,FRA
5046b7d4,9,6,1,7,1,4,12,8,9,0,9,9,18,9,0,21,FRA
514270e8,2,0,1,1,0,1,5,4,1,0,1,6,8,1,0,21,FRA
5148dcc5,33,15,5,15,13,10,36,26,23,0,23,16,49,7,0,21,FRA
5167c97e,48,32,21,21,6,23,37,14,29,6,23,35,83,60,0,21,FRA
51b41c5c,51,31,21,24,6,20,54,34,21,11,10,53,104,46,0,21,FRA
51c30111,3,2,0,3,0,2,5,3,4,3,1,4,7,2,1,21,FRA
51dbeea9,31,26,17,11,3,10,26,16,16,4,12,15,46,37,1,21,FRA
5219ab4a,43,20,12,20,11,17,38,21,24,1,23,45,88,46,0,21,FRA
5313ed43,16,8,3,10,3,4,26,22,16,5,11,34,50,23,1,21,FRA
5314e067,53,33,30,16,7,29,45,16,17,2,15,21,74,38,0,21,FRA
539b4f25,4,2,3,1,0,4,6,2,5,4,1,6,10,30,1,21,FRA
53f6306f,23,15,7,10,6,5,18,13,15,2,13,9,32,5,0,21,FRA
542cc80f,46,26,25,19,2,17,40,23,25,5,20,47,93,17,2,21,FRA
54d51e22,74,45,39,33,2,36,89,53,25,1,24,27,101,35,0,21,FRA
5515376c,45,26,32,13,0,24,50,26,20,7,13,69,114,56,0,21,FRA
562a4799,60,35,45,15,0,32,58,26,44,27,17,60,120,132,1,21,FRA
5722eced,24,11,2,15,7,10,33,23,13,1,12,3,27,4,0,21,FRA
574aa9ec,33,20,20,10,3,16,22,6,25,10,15,27,60,52,0,21,FRA
57a46f3f,11,4,2,6,3,4,5,1,5,1,4,1,12,0,1,21,FRA
58ad9383,2,1,2,0,0,2,5,3,1,0,1,2,4,17,3,21,FRA
58ae47b2,27,17,4,16,7,17,40,23,19,2,17,8,35,10,0,21,FRA
59948ef7,4,4,1,2,1,2,3,1,2,0,2,0,4,4,0,21,FRA
5b146df3,19,10,12,4,3,7,11,4,13,6,7,23,42,38,1,21,FRA
5b1bf5e3,38,23,10,18,10,8,44,36,24,3,21,17,55,4,0,21,FRA
5b5724d2,37,25,18,14,5,16,29,13,3,1,2,38,75,28,0,21,FRA
5b92d896,1,1,0,0,1,0,1,1,0,0,0,0,1,0,0,21,FRA
5c61496e,2,1,2,0,0,0,1,1,1,0,1,0,2,0,0,21,FRA
5c9ac7f0,0,0,0,0,0,0,1,1,2,0,2,0,0,1,0,21,FRA
5ceba7fc,16,10,5,3,8,8,32,24,20,1,19,26,42,8,0,21,FRA
5d0e0a1f,38,18,18,12,8,13,24,11,26,5,21,18,56,38,1,21,FRA
5d5219b1,10,8,3,5,2,4,12,8,7,3,4,2,12,2,0,21,FRA
5d8d7454,37,19,23,11,3,21,34,13,14,1,13,33,70,32,0,21,FRA
5d93ccee,12,7,8,4,0,8,14,6,7,2,5,10,22,17,1,21,FRA
5e080f73,10,5,3,6,1,4,22,18,17,3,14,9,19,23,2,21,FRA
5e22e2a4,9,6,3,5,1,2,7,5,4,0,4,7,16,8,0,21,FRA
5ea9ebd4,26,20,10,14,2,11,39,28,6,0,6,2,28,8,0,21,FRA
5ee6e943,0,0,0,0,0,0,0,0,0,0,0,0,0,2,0,21,FRA
5f0241b2,0,0,0,0,0,0,0,0,0,0,0,0,0,1,0,21,FRA
5f26e0c5,46,27,37,8,1,28,38,10,24,10,14,42,88,78,1,21,FRA
5f3eaaf5,27,14,11,9,7,17,36,19,24,1,23,15,42,15,1,21,FRA
5fdcb075,11,6,8,3,0,6,15,9,8,1,7,6,17,16,0,21,FRA
602fc7b5,0,0,0,0,0,0,2,2,2,0,2,0,0,0,0,21,FRA
6043997c,12,10,2,8,2,4,6,2,8,5,3,10,22,32,1,21,FRA
60f58477,4,3,1,3,0,3,4,1,2,0,2,0,4,0,0,21,FRA
61590953,27,19,15,9,3,13,22,9,17,4,13,26,53,38,2,21,FRA
6191093d,58,30,18,37,3,23,54,31,33,4,29,21,79,19,0,21,FRA
62e02107,11,7,8,2,1,3,9,6,7,2,5,21,32,12,0,21,FRA
6481421d,10,6,4,4,2,4,22,18,5,1,4,10,20,4,0,21,FRA
64ba07c0,60,40,42,16,2,35,52,17,17,7,10,30,90,57,0,21,FRA
64c14d49,1,1,0,1,0,0,0,0,0,0,0,2,3,1,0,21,FRA
64f69877,33,16,11,19,3,8,34,26,23,0,23,4,37,4,0,21,FRA
6554bb97,1,0,0,1,0,1,3,2,3,1,2,2,3,3,0,21,FRA
6605d143,12,7,3,7,2,8,19,11,12,2,10,13,25,17,0,21,FRA
667b65da,0,0,0,0,0,0,0,0,0,0,0,0,0,3,0,21,FRA
6690ef25,21,19,16,5,0,14,21,7,23,13,10,34,55,58,0,21,FRA
677ee102,26,12,12,10,4,9,27,18,18,5,13,33,59,72,0,21,FRA
67b7357e,33,21,23,10,0,12,24,12,18,12,6,30,63,89,0,21,FRA
68a26d51,26,8,7,13,6,14,49,35,23,4,19,41,67,19,0,21,FRA
69384e5d,14,11,1,6,7,8,37,29,8,0,8,9,23,0,0,21,FRA
6a827d8e,25,12,11,14,0,13,26,13,10,2,8,26,51,12,0,21,FRA
6b2c894b,57,32,35,17,5,32,56,24,25,11,14,30,87,67,0,21,FRA
6b4436ba,0,0,0,0,0,0,0,0,0,0,0,1,1,0,0,21,FRA
6bde367b,49,33,16,25,8,22,73,51,28,6,22,38,87,15,0,21,FRA
6be41a31,6,3,3,1,2,3,8,5,1,0,1,1,7,3,1,21,FRA
6c8ddd52,57,43,32,24,1,30,59,29,25,5,20,43,100,64,0,21,FRA
6d075c67,0,0,0,0,0,0,1,1,0,0,0,0,0,1,0,21,FRA
6de23ab0,10,7,8,1,1,5,14,9,19,15,4,33,43,53,1,21,FRA
6dfd8f05,60,34,42,16,2,24,45,21,36,3,33,45,105,76,0,21,FRA
6e2c94ad,0,0,0,0,0,0,2,2,0,0,0,0,0,0,0,21,FRA
6e5b5a45,36,20,20,13,3,11,37,26,17,8,9,29,65,33,1,21,FRA
6e7f1353,21,12,6,12,3,9,28,19,12,0,12,9,30,5,0,21,FRA
6f5ec8bb,39,22,22,15,2,24,38,14,25,9,16,39,78,51,3,21,FRA
6f806d99,51,28,23,23,5,27,73,46,30,6,24,25,76,10,0,21,FRA
6fbde63a,10,5,5,3,2,2,10,8,3,0,3,6,16,2,0,21,FRA
706a60e1,13,8,4,4,5,4,11,7,6,1,5,6,19,4,0,21,FRA
70c52749,49,31,27,15,7,33,50,17,43,9,34,36,85,70,0,21,FRA
7155e3e1,49,21,25,19,5,15,45,30,25,6,19,47,96,34,0,21,FRA
72a0fb65,52,38,46,6,0,29,40,11,50,33,17,57,109,165,3,21,FRA
72c812f3,63,35,20,34,9,26,50,24,26,7,19,20,83,9,3,21,FRA
741418c3,40,19,17,14,9,14,48,34,16,2,14,14,54,3,0,21,FRA
743fd71f,16,9,5,5,6,2,15,13,6,0,6,4,20,1,1,21,FRA
745ca0a3,54,27,26,23,5,21,54,33,30,0,30,30,84,18,0,21,FRA
74733221,0,0,0,0,0,0,1,1,0,0,0,1,1,6,3,21,FRA
74dc806c,11,7,1,7,3,2,9,7,3,0,3,2,13,0,0,21,FRA
754d5c33,0,0,0,0,0,0,0,0,1,0,1,0,0,0,0,21,FRA
75a63397,15,8,2,8,5,3,10,7,14,2,12,1,16,1,0,21,FRA
7615f332,3,0,3,0,0,3,5,2,1,0,1,0,3,0,0,21,FRA
767212e6,16,11,6,8,2,11,25,14,12,4,8,9,25,10,0,21,FRA
76806215,0,0,0,0,0,0,0,0,0,0,0,0,0,0,0,21,FRA
770d7eb8,22,13,13,8,1,11,22,11,12,6,6,23,45,33,1,21,FRA
775185ae,9,5,3,4,2,2,6,4,6,0,6,6,15,3,0,21,FRA
779847d6,58,36,42,14,2,38,72,34,44,20,24,37,95,155,1,21,FRA
77d7c96f,2,0,1,1,0,0,0,0,0,0,0,2,4,0,0,21,FRA
7909ffa4,12,8,5,6,1,6,31,25,12,3,9,11,23,15,0,21,FRA
792a9d41,6,4,4,2,0,3,6,3,2,0,2,1,7,0,0,21,FRA
79685569,8,5,5,1,2,7,13,6,12,5,7,17,25,19,1,21,FRA
796b1c41,19,11,7,6,6,7,16,9,8,0,8,12,31,1,0,21,FRA
79b2399c,53,28,24,17,12,31,79,48,25,1,24,47,100,32,0,21,FRA
7a0b1e96,1,0,1,0,0,0,0,0,0,0,0,1,2,1,0,21,FRA
7a42d0df,31,20,3,20,8,6,22,16,27,0,27,9,40,24,0,21,FRA
7b075c75,1,0,0,0,1,0,0,0,1,1,0,2,3,2,0,21,FRA
7b9a9e25,14,8,5,5,4,6,21,15,13,2,11,9,23,10,0,21,FRA
7b9c2d84,98,58,39,48,11,38,77,39,36,2,34,23,121,15,1,21,FRA
7c2965bb,20,14,4,13,3,6,27,21,14,3,11,8,28,6,0,21,FRA
7c3ed041,29,18,19,7,3,14,31,17,17,9,8,28,57,65,3,21,FRA
7cbf91b2,4,2,0,2,2,2,2,0,0,0,0,2,6,1,0,21,FRA
7cdda3bf,43,22,21,17,5,16,60,44,29,3,26,16,59,25,1,21,FRA
7cf431a5,5,2,1,3,1,2,2,0,3,0,3,1,6,1,1,21,FRA
7d08063d,35,22,12,16,7,17,49,32,16,3,13,21,56,31,0,21,FRA
7d937aa1,23,14,10,8,5,9,15,6,4,1,3,2,25,1,0,21,FRA
7d9397f8,32,16,5,21,6,9,27,18,21,9,12,18,50,22,1,21,FRA
7d9b37bf,4,3,1,1,2,0,5,5,4,0,4,2,6,2,0,21,FRA
7d9f3d69,0,0,0,0,0,0,0,0,0,0,0,0,0,0,0,21,FRA
7e82a78f,20,15,7,11,2,12,47,35,18,4,14,32,52,9,1,21,FRA
7ef972c3,23,15,15,5,3,10,21,11,17,6,11,14,37,32,0,21,FRA
7f622eef,0,0,0,0,0,0,0,0,0,0,0,0,0,0,0,21,FRA
7fecbcdb,27,17,19,7,1,19,28,9,7,1,6,19,46,34,0,21,FRA
80556f08,33,22,15,16,2,16,58,42,21,5,16,32,65,42,1,21,FRA
8104e41e,4,3,1,1,2,1,3,2,5,1,4,4,8,1,0,21,FRA
822d51d7,90,51,31,51,8,42,82,40,43,7,36,34,124,14,2,21,FRA
82518f62,76,34,26,41,9,30,64,34,24,4,20,14,90,13,0,21,FRA
8332db56,32,18,19,11,2,20,35,15,22,5,17,24,56,30,1,21,FRA
833ce5f0,0,0,0,0,0,0,0,0,0,0,0,0,0,0,0,21,FRA
834b5c4c,0,0,0,0,0,0,0,0,0,0,0,0,0,4,0,21,FRA
8413ceb1,6,4,5,1,0,4,8,4,2,1,1,2,8,8,0,21,FRA
84c0768a,10,7,6,3,1,6,12,6,5,3,2,14,24,15,1,21,FRA
84d94b91,28,15,9,16,3,15,41,26,10,3,7,13,41,21,1,21,FRA
85613cf0,14,9,0,7,7,2,12,10,5,1,4,2,16,9,0,21,FRA
8577e60a,99,67,43,46,10,33,60,27,50,12,38,78,177,51,0,21,FRA
85847c67,0,0,0,0,0,0,0,0,0,0,0,0,0,1,0,21,FRA
85a44ecc,78,41,33,34,11,39,75,36,29,4,25,33,111,17,0,21,FRA
861227d2,58,34,43,13,2,31,54,23,36,20,16,80,138,146,1,21,FRA
873ce3a2,24,14,15,6,3,13,33,20,14,2,12,6,30,6,0,21,FRA
8746d5d0,25,11,14,10,1,13,26,13,10,3,7,24,49,41,1,21,FRA
87e9c7cd,15,8,9,2,4,7,20,13,9,0,9,4,19,6,0,21,FRA
8802c1d5,15,10,9,5,1,9,26,17,6,0,6,9,24,3,0,21,FRA
881cd6be,7,2,4,2,1,6,10,4,1,0,1,6,13,2,1,21,FRA
8846a40f,29,17,12,15,2,10,40,30,21,4,17,15,44,16,0,21,FRA
885b7aa7,53,32,22,30,1,25,70,45,35,7,28,37,90,40,0,21,FRA
88970207,1,0,1,0,0,0,8,8,2,0,2,2,3,2,0,21,FRA
88c4d190,15,10,9,4,2,7,21,14,14,1,13,8,23,11,0,21,FRA
88f130ed,25,15,16,9,0,16,31,15,13,7,6,19,44,48,1,21,FRA
8a2248b4,1,1,1,0,0,1,3,2,1,0,1,1,2,7,2,21,FRA
8b298f56,20,8,9,8,3,7,31,24,7,0,7,5,25,3,0,21,FRA
8bbe2df5,28,18,11,13,4,12,27,15,14,4,10,26,54,21,0,21,FRA
8bc373ea,15,13,10,5,0,6,10,4,7,4,3,27,42,87,0,21,FRA
8db95f95,0,0,0,0,0,0,0,0,0,0,0,0,0,0,0,21,FRA
8e697a8f,7,6,3,4,0,1,8,7,4,0,4,7,14,4,0,21,FRA
8eec784d,15,7,3,9,3,7,14,7,7,0,7,4,19,5,0,21,FRA
8f325097,39,30,27,11,1,20,40,20,20,11,9,26,65,62,0,21,FRA
8f4d116f,16,10,10,4,2,10,30,20,15,8,7,25,41,21,2,21,FRA
8f696594,4,3,0,3,1,1,20,19,11,1,10,5,9,3,0,21,FRA
8fd9996f,21,11,6,11,4,6,14,8,14,6,8,29,50,33,4,21,FRA
90a9cc01,1,1,0,1,0,0,4,4,1,0,1,3,4,2,0,21,FRA
90c99c5c,1,1,1,0,0,0,0,0,0,0,0,0,1,1,0,21,FRA
90eb507d,77,43,50,20,7,40,69,29,28,7,21,69,146,92,2,21,FRA
90f87966,40,29,28,10,2,27,33,6,36,23,13,36,76,137,1,21,FRA
91f2da4c,0,0,0,0,0,0,0,0,0,0,0,0,0,1,0,21,FRA
92232aad,58,33,37,17,4,40,62,22,27,9,18,45,103,61,0,21,FRA
923f4dda,4,1,1,3,0,1,3,2,10,1,9,5,9,17,0,21,FRA
9260926b,39,26,18,19,2,15,38,23,14,4,10,23,62,25,0,21,FRA
92b56413,0,0,0,0,0,0,1,1,0,0,0,0,0,0,0,21,FRA
93b8f9f4,7,4,4,3,0,3,9,6,6,1,5,2,9,3,0,21,FRA
942b4f90,18,9,2,10,6,3,13,10,16,0,16,13,31,3,0,21,FRA
94f8d10c,29,17,19,9,1,17,30,13,29,22,7,44,73,130,0,21,FRA
95192fe4,0,0,0,0,0,0,2,2,1,0,1,0,0,0,0,21,FRA
95981861,0,0,0,0,0,0,1,1,1,0,1,2,2,0,0,21,FRA
95bb6ddc,38,25,14,19,5,15,45,30,17,1,16,14,52,9,0,21,FRA
96726741,1,1,1,0,0,1,1,0,1,1,0,0,1,1,0,21,FRA
96e5168e,19,12,7,8,4,11,17,6,8,1,7,3,22,4,0,21,FRA
972aeb2a,15,9,8,5,2,5,6,1,17,16,1,26,41,80,2,21,FRA
9744ff80,15,11,6,6,3,10,38,28,9,1,8,5,20,8,0,21,FRA
97bfa797,2,0,0,2,0,2,2,0,0,0,0,0,2,0,0,21,FRA
9826ea33,1,1,1,0,0,1,1,0,0,0,0,0,1,0,0,21,FRA
9836e892,12,8,5,7,0,5,13,8,9,0,9,3,15,5,0,21,FRA
9980269a,3,1,0,1,2,2,8,6,3,1,2,2,5,12,0,21,FRA
999ceb5f,3,2,1,2,0,1,1,0,1,0,1,0,3,0,0,21,FRA
9ae9eaea,1,0,0,1,0,0,0,0,0,0,0,2,3,0,0,21,FRA
9b398aea,3,2,1,2,0,3,5,2,2,1,1,4,7,1,0,21,FRA
9b40a6ea,80,47,30,44,6,33,74,41,37,10,27,50,130,29,3,21,FRA
9b5237b1,0,0,0,0,0,0,0,0,0,0,0,0,0,0,0,21,FRA
9b6556d2,15,9,4,7,4,6,22,16,3,0,3,8,23,1,0,21,FRA
9b6f7fd5,70,36,30,28,12,23,66,43,28,3,25,20,90,16,1,21,FRA
9ba7b4fa,5,3,5,0,0,3,4,1,1,1,0,2,7,13,0,21,FRA
9c221d14,35,22,26,9,0,20,39,19,40,31,9,68,103,144,1,21,FRA
9c2b1f11,7,2,1,2,4,2,9,7,2,1,1,2,9,5,0,21,FRA
9d5dcc23,18,9,4,11,3,7,24,17,7,2,5,21,39,5,0,21,FRA
9daeac61,48,33,25,19,4,22,36,14,18,4,14,42,90,50,0,21,FRA
9ddf7fae,0,0,0,0,0,0,0,0,0,0,0,0,0,0,0,21,FRA
9f90c06b,5,2,5,0,0,2,2,0,3,2,1,5,10,14,0,21,FRA
a046fc35,3,1,1,1,1,2,2,0,0,0,0,0,3,0,0,21,FRA
a0791826,24,16,4,17,3,13,51,38,19,3,16,12,36,7,0,21,FRA
a0b65401,10,6,4,6,0,2,5,3,1,1,0,7,17,4,0,21,FRA
a0f9b535,26,11,11,12,3,10,32,22,17,3,14,13,39,2,0,21,FRA
a13028f6,1,1,1,0,0,1,2,1,0,0,0,0,1,0,0,21,FRA
a1f3f5a0,12,5,6,2,4,7,14,7,5,0,5,10,22,3,0,21,FRA
a27ecdc2,1,1,1,0,0,1,3,2,0,0,0,0,1,0,0,21,FRA
a2d873dd,14,6,5,8,1,6,25,19,17,2,15,8,22,14,0,21,FRA
a44d3a3c,2,1,0,2,0,0,0,0,1,0,1,0,2,0,0,21,FRA
a4527d33,1,0,1,0,0,1,1,0,0,0,0,0,1,4,2,21,FRA
a46472d0,9,6,5,4,0,5,8,3,4,3,1,15,24,36,0,21,FRA
a4b1028a,56,38,23,27,6,22,59,37,31,5,26,76,132,50,0,21,FRA
a4c3f7af,34,19,16,14,4,15,30,15,9,2,7,20,54,10,0,21,FRA
a59d55b1,2,0,1,1,0,1,1,0,1,0,1,1,3,2,0,21,FRA
a5db0bec,17,12,0,13,4,8,25,17,17,1,16,17,34,4,0,21,FRA
a634b9d2,7,0,3,3,1,4,9,5,3,1,2,6,13,8,0,21,FRA
a7e4760c,0,0,0,0,0,0,0,0,0,0,0,1,1,1,0,21,FRA
a84f9a4b,38,23,22,10,6,17,31,14,16,2,14,22,60,34,0,21,FRA
a8567629,38,30,15,14,9,17,26,9,22,2,20,22,60,20,0,21,FRA
a99138af,22,15,12,10,0,9,33,24,10,1,9,10,32,11,1,21,FRA
a99da9ec,15,8,3,9,3,1,6,5,12,1,11,10,25,6,0,21,FRA
aa21406e,1,0,1,0,0,0,2,2,0,0,0,0,1,1,0,21,FRA
aa67d758,0,0,0,0,0,0,0,0,0,0,0,0,0,0,0,21,FRA
aad56ca3,31,18,7,16,8,10,41,31,22,6,16,17,48,23,0,21,FRA
ab096c6f,28,15,23,5,0,19,27,8,24,15,9,36,64,80,1,21,FRA
abc06eb3,0,0,0,0,0,0,2,2,0,0,0,2,2,12,4,21,FRA
ad82197c,29,20,17,12,0,20,35,15,18,11,7,26,55,66,1,21,FRA
ae4e2852,29,17,15,11,3,18,27,9,13,4,9,27,56,44,0,21,FRA
ae59b359,44,29,16,25,3,14,29,15,14,6,8,39,83,21,0,21,FRA
ae7d0ecd,0,0,0,0,0,0,1,1,1,0,1,0,0,17,3,21,FRA
aef6e670,46,28,23,19,4,24,34,10,19,11,8,30,76,61,4,21,FRA
af0c835b,0,0,0,0,0,0,1,1,1,0,1,0,0,0,0,21,FRA
b052b8bf,0,0,0,0,0,0,1,1,0,0,0,0,0,9,3,21,FRA
b0547a87,19,14,7,6,6,9,42,33,15,0,15,13,32,7,0,21,FRA
b0c71810,17,11,8,6,3,8,28,20,8,0,8,3,20,1,0,21,FRA
b2336681,22,13,14,5,3,15,23,8,10,4,6,9,31,23,0,21,FRA
b2791a55,2,1,1,1,0,2,4,2,4,4,0,1,3,6,1,21,FRA
b2bd0f6c,45,23,15,19,11,24,84,60,24,2,22,24,69,15,0,21,FRA
b34c63a5,5,3,0,3,2,1,11,10,3,0,3,4,9,0,0,21,FRA
b49729cb,1,1,1,0,0,1,1,0,2,0,2,0,1,16,3,21,FRA
b4c816a9,0,0,0,0,0,0,1,1,1,0,1,0,0,2,0,21,FRA
b6047994,0,0,0,0,0,0,1,1,1,0,1,0,0,0,0,21,FRA
b666421b,32,14,23,9,0,20,37,17,27,13,14,40,72,107,0,21,FRA
b66d1d8a,14,13,12,2,0,9,17,8,21,13,8,45,59,66,1,21,FRA
b73f17f8,0,0,0,0,0,0,1,1,1,1,0,1,1,1,0,21,FRA
b748968d,59,40,37,21,1,30,50,20,28,3,25,72,131,58,0,21,FRA
b8d22478,21,12,11,8,2,4,13,9,14,0,14,9,30,2,0,21,FRA
b92edde2,10,7,9,1,0,2,6,4,7,3,4,11,21,5,0,21,FRA
b94b8be1,38,20,12,17,9,13,49,36,15,1,14,10,48,6,0,21,FRA
b99bec05,28,20,11,17,0,11,21,10,13,3,10,16,44,21,0,21,FRA
bc0bfc64,8,2,3,3,2,3,14,11,3,0,3,6,14,9,0,21,FRA
bc224243,4,3,1,3,0,1,5,4,4,0,4,1,5,0,0,21,FRA
bc7b4580,62,37,37,23,2,35,61,26,29,8,21,37,99,49,0,21,FRA
bc9479b9,2,0,0,2,0,0,2,2,0,0,0,1,3,5,0,21,FRA
bcf1b2e9,2,1,2,0,0,2,4,2,1,0,1,1,3,9,2,21,FRA
bdedd861,0,0,0,0,0,0,1,1,0,0,0,0,0,0,0,21,FRA
be13e5a8,0,0,0,0,0,0,0,0,0,0,0,0,0,1,0,21,FRA
be47b750,13,6,0,4,9,1,14,13,16,1,15,7,20,15,0,21,FRA
beae3a73,52,30,25,19,8,26,84,58,58,12,46,36,88,53,0,21,FRA
beb391dd,70,41,39,24,7,33,58,25,23,5,18,43,113,47,2,21,FRA
bef0a7ac,6,4,1,4,1,5,13,8,9,2,7,3,9,17,0,21,FRA
bf4c41f9,8,2,2,2,4,1,7,6,11,0,11,2,10,2,0,21,FRA
bfcef334,2,2,1,1,0,2,4,2,1,0,1,2,4,1,0,21,FRA
c05d65d1,0,0,0,0,0,0,0,0,1,0,1,0,0,0,0,21,FRA
c0b3669f,22,14,1,13,8,7,27,20,15,2,13,8,30,26,0,21,FRA
c0f706f3,0,0,0,0,0,0,1,1,2,0,2,2,2,0,0,21,FRA
c20bdcd7,79,43,39,32,8,35,58,23,26,3,23,45,124,53,0,21,FRA
c26a3918,42,27,23,17,2,30,63,33,23,2,21,35,77,61,0,21,FRA
c39b09e3,4,1,1,1,2,0,1,1,1,0,1,1,5,1,0,21,FRA
c4173f1a,0,0,0,0,0,0,0,0,0,0,0,0,0,3,1,21,FRA
c4bbea9f,15,10,10,4,1,3,14,11,34,26,8,38,53,104,3,21,FRA
c631f952,1,1,1,0,0,1,4,3,0,0,0,0,1,9,1,21,FRA
c64c01fc,2,2,0,1,1,1,3,2,2,0,2,0,2,0,0,21,FRA
c6e5d20f,37,22,13,20,4,18,38,20,33,7,26,39,76,21,2,21,FRA
c7526c18,34,16,15,16,3,12,31,19,24,10,14,16,50,26,0,21,FRA
c76b7567,36,17,8,16,12,12,58,46,44,5,39,22,58,2,0,21,FRA
c795c408,17,12,13,4,0,8,11,3,27,13,14,59,76,91,2,21,FRA
c801616a,54,37,25,26,3,30,90,60,31,8,23,38,92,39,0,21,FRA
caef7840,0,0,0,0,0,0,2,2,0,0,0,0,0,1,0,21,FRA
cb9ec45d,25,19,13,9,3,9,16,7,13,4,9,25,50,32,0,21,FRA
cc41f558,34,21,18,12,4,17,39,22,25,5,20,39,73,30,0,21,FRA
cc588cbe,0,0,0,0,0,0,0,0,0,0,0,0,0,0,0,21,FRA
cc77354e,88,51,31,49,8,40,74,34,36,13,23,34,122,51,0,21,FRA
cc83b74d,6,2,1,3,2,2,11,9,11,2,9,6,12,19,1,21,FRA
cc972842,0,0,0,0,0,0,0,0,0,0,0,0,0,0,0,21,FRA
ccb1c3af,7,2,6,0,1,4,8,4,3,0,3,5,12,2,0,21,FRA
ccce7025,31,21,18,12,1,14,26,12,31,21,10,57,88,126,2,21,FRA
cdc4458b,1,0,0,1,0,1,1,0,1,0,1,0,1,0,0,21,FRA
ce492295,9,6,8,0,1,5,10,5,8,5,3,17,26,22,0,21,FRA
ce4f40c7,87,47,40,42,5,32,65,33,20,4,16,52,139,26,1,21,FRA
ce50fd99,17,10,5,5,7,9,24,15,19,1,18,3,20,9,0,21,FRA
cecbce23,2,1,2,0,0,2,3,1,0,0,0,4,6,17,1,21,FRA
cf1ef7ec,5,4,3,2,0,4,7,3,3,0,3,4,9,12,0,21,FRA
d14229f3,6,3,2,2,2,2,8,6,7,0,7,1,7,2,0,21,FRA
d21e361a,9,5,5,4,0,2,13,11,12,0,12,6,15,2,0,21,FRA
d33c706e,12,7,1,9,2,8,18,10,11,1,10,4,16,34,0,21,FRA
d3ce9f1f,6,5,4,1,1,2,5,3,4,1,3,5,11,5,0,21,FRA
d4133fa1,0,0,0,0,0,0,2,2,0,0,0,1,1,0,0,21,FRA
d4d35152,24,12,10,13,1,20,40,20,6,1,5,14,38,8,0,21,FRA
d4fa7d01,16,11,14,2,0,11,14,3,8,7,1,10,26,57,0,21,FRA
d504b3e1,7,4,1,4,2,2,9,7,10,1,9,4,11,6,0,21,FRA
d5575935,40,23,19,17,4,11,47,36,14,2,12,25,65,21,1,21,FRA
d56b9520,0,0,0,0,0,0,0,0,0,0,0,0,0,0,0,21,FRA
d5f2f82b,27,21,14,10,3,15,26,11,21,9,12,27,54,75,2,21,FRA
d63e2912,81,48,34,35,12,39,51,12,21,5,16,54,135,65,0,21,FRA
d7bf3d19,4,2,3,1,0,1,3,2,2,1,1,1,5,1,0,21,FRA
d87e6889,1,1,1,0,0,1,2,1,0,0,0,2,3,0,0,21,FRA
d8992b84,36,24,17,15,4,17,42,25,17,4,13,19,55,9,1,21,FRA
d9764034,26,11,17,9,0,15,27,12,18,11,7,27,53,66,1,21,FRA
d9a66c60,3,2,1,2,0,0,5,5,4,2,2,0,3,4,0,21,FRA
da4d670f,0,0,0,0,0,0,0,0,0,0,0,0,0,0,0,21,FRA
db7849ca,28,13,12,10,6,14,37,23,15,3,12,11,39,24,0,21,FRA
db87a2c4,0,0,0,0,0,0,0,0,0,0,0,0,0,0,1,21,FRA
ddcc9e22,0,0,0,0,0,0,0,0,0,0,0,0,0,0,0,21,FRA
de40e38c,3,3,1,1,1,2,3,1,1,0,1,1,4,4,0,21,FRA
de488e56,53,34,30,17,6,27,54,27,26,5,21,36,89,65,0,21,FRA
dff153a4,30,18,12,15,3,19,39,20,17,5,12,17,47,13,1,21,FRA
e0f3a1f6,32,18,20,11,1,18,31,13,25,19,6,42,74,79,0,21,FRA
e1df6989,55,28,25,26,4,21,69,48,20,4,16,33,88,15,2,21,FRA
e288d4b3,24,16,9,9,6,12,29,17,7,1,6,17,41,25,0,21,FRA
e2f9bb5f,30,15,19,10,1,16,40,24,15,0,15,25,55,12,1,21,FRA
e34fc66d,2,1,1,1,0,2,2,0,1,1,0,2,4,6,0,21,FRA
e3ad3368,0,0,0,0,0,0,0,0,0,0,0,0,0,0,0,21,FRA
e3d0b0c4,44,29,30,12,2,26,37,11,35,25,10,49,93,122,2,21,FRA
e3e05edf,13,6,10,3,0,9,15,6,3,2,1,8,21,26,1,21,FRA
e4448c8c,0,0,0,0,0,0,1,1,0,0,0,1,1,1,0,21,FRA
e472a6f6,1,1,0,1,0,0,1,1,3,1,2,1,2,1,0,21,FRA
e4b72e34,47,29,25,14,8,23,43,20,19,4,15,30,77,34,1,21,FRA
e50623a0,3,2,0,3,0,1,3,2,0,0,0,6,9,2,0,21,FRA
e53ab10b,0,0,0,0,0,0,0,0,0,0,0,0,0,0,0,21,FRA
e54a9890,20,11,10,8,2,11,19,8,9,1,8,17,37,36,0,21,FRA
e6777e6b,36,27,29,7,0,24,37,13,23,13,10,31,67,108,5,21,FRA
e768de1f,81,52,36,40,5,42,85,43,37,6,31,49,130,36,0,21,FRA
e7986081,2,2,0,1,1,0,4,4,4,2,2,5,7,9,0,21,FRA
e90dc1d5,1,0,1,0,0,1,4,3,1,0,1,0,1,0,0,21,FRA
e97150c0,31,19,21,10,0,20,39,19,26,11,15,44,75,81,1,21,FRA
ea02beaf,34,16,22,7,5,15,36,21,22,2,20,51,85,40,1,21,FRA
ea0aa7e0,45,22,25,13,7,28,44,16,30,9,21,26,71,57,0,21,FRA
ea0ff634,8,6,2,4,2,3,11,8,7,2,5,11,19,22,0,21,FRA
ecada4fc,0,0,0,0,0,0,0,0,0,0,0,0,0,10,0,21,FRA
ed45c4a5,93,59,31,55,7,43,85,42,32,2,30,28,121,21,1,21,FRA
edbe46dc,3,2,3,0,0,3,5,2,0,0,0,1,4,14,4,21,FRA
edd1466a,39,24,29,8,2,16,35,19,19,10,9,21,60,41,0,21,FRA
edd81e2a,57,37,38,19,0,24,44,20,31,14,17,44,101,112,0,21,FRA
eedea60b,0,0,0,0,0,0,0,0,0,0,0,0,0,0,0,21,FRA
ef2e5e1a,9,6,5,4,0,4,8,4,5,2,3,5,14,7,0,21,FRA
ef7cd87a,28,12,10,16,2,14,31,17,17,2,15,22,50,19,0,21,FRA
ef9c1c95,114,68,47,61,6,53,122,69,39,10,29,76,190,49,0,21,FRA
f00de885,1,1,1,0,0,1,2,1,1,0,1,1,2,20,1,21,FRA
f066022d,65,39,48,16,1,42,74,32,34,23,11,65,130,125,0,21,FRA
f18d7ab2,18,12,12,5,1,9,12,3,11,3,8,20,38,35,0,21,FRA
f329ec76,1,1,1,0,0,1,2,1,2,0,2,1,2,0,0,21,FRA
f3600c02,33,17,14,15,4,16,43,27,14,2,12,20,53,18,0,21,FRA
f36c432f,8,4,2,3,3,3,13,10,1,0,1,3,11,3,0,21,FRA
f36d5624,5,4,3,1,1,4,9,5,5,1,4,7,12,4,0,21,FRA
f449640d,21,17,9,11,1,6,13,7,7,0,7,6,27,11,1,21,FRA
f45f9427,7,6,4,2,1,6,8,2,8,2,6,5,12,8,0,21,FRA
f4bc42b1,17,14,7,6,4,7,23,16,10,0,10,9,26,3,0,21,FRA
f5044e54,67,39,33,31,3,25,83,58,50,14,36,29,96,31,1,21,FRA
f54d2149,49,36,24,23,2,27,49,22,19,6,13,36,85,33,4,21,FRA
f5b6fb78,42,26,27,12,3,22,48,26,33,10,23,42,84,70,0,21,FRA
f5c8b425,12,5,6,2,4,1,24,23,5,1,4,2,14,2,0,21,FRA
f5efb153,29,17,18,11,0,16,24,8,44,34,10,54,83,115,1,21,FRA
f6496133,24,17,3,15,6,11,24,13,17,2,15,15,39,1,0,21,FRA
f6b94e8d,23,12,17,6,0,13,19,6,12,8,4,14,37,39,1,21,FRA
f76022e7,2,0,0,1,1,1,1,0,0,0,0,2,4,0,0,21,FRA
f7691f63,39,27,17,19,3,24,55,31,23,1,22,18,57,10,0,21,FRA
f81ef10d,72,45,17,39,16,35,106,71,35,3,32,23,95,5,2,21,FRA
f83c8d6c,7,3,3,2,2,1,1,0,2,0,2,1,8,3,0,21,FRA
f8405304,9,7,2,6,1,4,9,5,4,0,4,3,12,0,0,21,FRA
f86ca403,35,20,19,11,5,10,18,8,9,2,7,42,77,11,0,21,FRA
f8ce97ca,8,7,4,4,0,5,14,9,4,0,4,5,13,8,1,21,FRA
f98b15f0,12,7,7,3,2,7,14,7,6,0,6,12,24,3,0,21,FRA
f9921b7f,1,0,0,1,0,0,0,0,0,0,0,0,1,0,0,21,FRA
f9d5908e,52,35,20,24,8,26,68,42,14,4,10,23,75,26,1,21,FRA
fa18c72e,38,25,12,18,8,8,28,20,23,1,22,11,49,3,0,21,FRA
fb14aa28,23,9,4,13,6,9,22,13,16,1,15,4,27,26,0,21,FRA
fbbb9269,47,33,24,17,6,27,45,18,31,8,23,49,96,57,2,21,FRA
fbf76716,16,9,8,6,2,7,25,18,9,0,9,4,20,5,1,21,FRA
fbf83734,0,0,0,0,0,0,0,0,0,0,0,0,0,4,2,21,FRA
fc4cf6a7,35,25,19,11,5,20,34,14,19,7,12,33,68,52,1,21,FRA
fc62f087,16,11,9,5,2,8,13,5,15,8,7,25,41,36,0,21,FRA
fcb27134,32,22,21,6,5,9,18,9,17,11,6,31,63,41,0,21,FRA
fcb38f57,0,0,0,0,0,0,0,0,0,0,0,0,0,7,2,21,FRA
fcbcbd94,5,3,1,2,2,2,11,9,4,1,3,5,10,8,0,21,FRA
fd2bc67d,10,5,6,4,0,3,7,4,6,4,2,10,20,20,0,21,FRA
fe296c72,13,7,11,1,1,11,16,5,8,6,2,24,37,51,0,21,FRA
fe6c1add,0,0,0,0,0,0,0,0,0,0,0,0,0,0,0,21,FRA
feb5d3ab,55,34,33,15,7,32,59,27,23,6,17,25,80,43,0,21,FRA
feb5d972,45,29,19,21,5,20,38,18,24,4,20,27,72,16,0,21,FRA
ff0ab48c,38,26,19,16,3,18,36,18,27,9,18,31,69,69,2,21,FRA
ff3a6a60,1,1,1,0,0,0,1,1,1,0,1,1,2,0,0,21,FRA
ff800ed8,28,16,11,15,2,16,28,12,18,5,13,25,53,26,0,21,FRA
ffec9769,7,5,3,1,3,3,12,9,4,1,3,1,8,6,0,21,FRA
fffea3e5,44,25,9,24,11,11,26,15,18,1,17,11,55,1,0,21,FRA
00242715,40,23,25,13,2,20,33,13,37,11,26,50,90,69,1,22,GER
00242b75,63,32,23,27,13,29,50,21,23,6,17,32,95,23,0,22,GER
00672803,8,5,4,3,1,5,9,4,0,0,0,2,10,2,0,22,GER
00963611,57,39,35,21,1,30,51,21,46,23,23,69,126,174,2,22,GER
009a4f60,27,15,11,12,4,17,25,8,12,4,8,16,43,32,0,22,GER
0174ba21,14,8,6,5,3,3,21,18,18,1,17,5,19,4,0,22,GER
01834aa0,30,19,23,5,2,16,25,9,29,8,21,42,72,97,1,22,GER
037130ca,6,4,4,1,1,5,7,2,6,2,4,5,11,5,1,22,GER
042e8a49,14,8,1,9,4,5,16,11,14,0,14,8,22,5,0,22,GER
048a1cbc,35,19,19,12,4,16,31,15,18,2,16,25,60,14,1,22,GER
049751d7,4,1,3,1,0,0,5,5,7,1,6,2,6,4,0,22,GER
054849d2,49,29,25,19,5,15,34,19,28,6,22,27,76,62,0,22,GER
056d2d95,49,30,25,19,5,26,45,19,20,3,17,34,83,75,0,22,GER
05ba9d7c,27,15,14,11,2,9,19,10,14,2,12,4,31,10,0,22,GER
05d548d8,34,22,20,13,1,20,36,16,18,13,5,32,66,66,1,22,GER
05e2d5ea,1,1,1,0,0,0,1,1,0,0,0,0,1,0,0,22,GER
05f99a4a,17,8,0,10,7,6,25,19,31,5,26,8,25,16,0,22,GER
061e8e23,15,11,6,7,2,5,21,16,12,1,11,4,19,5,0,22,GER
07c7eb0c,65,39,29,30,6,34,69,35,32,9,23,70,135,53,1,22,GER
07d3bfec,0,0,0,0,0,0,0,0,1,0,1,0,0,1,0,22,GER
080440a4,45,28,28,16,1,28,43,15,36,16,20,42,87,78,3,22,GER
08593525,41,26,14,21,6,21,44,23,27,11,16,28,69,26,0,22,GER
088ca1bd,12,6,6,3,3,5,7,2,7,1,6,6,18,15,0,22,GER
091c86e2,3,1,1,1,1,0,2,2,2,0,2,7,10,6,0,22,GER
0a3d6d2b,26,15,10,15,1,11,18,7,22,9,13,22,48,50,1,22,GER
0a3f6cde,21,18,7,8,6,6,26,20,12,0,12,1,22,8,0,22,GER
0a89e877,30,21,18,6,6,12,22,10,16,1,15,19,49,14,0,22,GER
0b104510,53,35,22,22,9,24,37,13,38,19,19,47,100,64,1,22,GER
0b4f388a,16,11,1,12,3,3,8,5,14,2,12,6,22,7,0,22,GER
0c61c77c,9,5,5,2,2,2,13,11,7,0,7,15,24,4,0,22,GER
0c7a48f8,33,23,23,8,2,19,25,6,34,15,19,33,66,56,2,22,GER
0cc5f4a5,12,5,5,5,2,5,19,14,9,1,8,4,16,10,0,22,GER
0cddeaa7,7,3,1,4,2,3,3,0,6,1,5,1,8,0,0,22,GER
0cf778df,28,16,10,10,8,18,39,21,31,2,29,8,36,9,0,22,GER
0d55d942,0,0,0,0,0,0,1,1,0,0,0,2,2,18,3,22,GER
0d8a37c2,0,0,0,0,0,0,0,0,0,0,0,0,0,0,0,22,GER
0da32a38,3,2,1,1,1,0,1,1,0,0,0,0,3,0,0,22,GER
0e0102eb,26,17,6,14,6,4,20,16,9,1,8,7,33,6,0,22,GER
0e6bc38c,10,9,3,6,1,3,10,7,1,0,1,5,15,2,0,22,GER
0f59a7bf,28,19,14,13,1,15,38,23,24,5,19,51,79,25,0,22,GER
0fbecd11,40,20,18,19,3,16,42,26,21,2,19,35,75,22,0,22,GER
1025db8e,50,27,33,17,0,22,36,14,35,18,17,49,99,116,0,22,GER
10549b49,3,1,0,2,1,0,5,5,2,0,2,0,3,8,0,22,GER
106bca06,40,22,19,16,5,14,30,16,31,5,26,30,70,21,1,22,GER
10745192,3,2,0,2,1,2,5,3,4,1,3,1,4,1,0,22,GER
116c35df,13,10,4,5,4,7,13,6,10,0,10,10,23,11,0,22,GER
11d8aff0,0,0,0,0,0,0,0,0,0,0,0,0,0,0,0,22,GER
1238a3f9,5,4,1,3,1,1,3,2,6,1,5,1,6,11,0,22,GER
12c35abe,14,5,6,7,1,7,23,16,7,0,7,3,17,5,0,22,GER
13203c45,14,9,8,6,0,10,16,6,24,5,19,14,28,34,2,22,GER
13d23b29,0,0,0,0,0,0,0,0,1,0,1,0,0,0,0,22,GER
13ddc856,11,6,3,6,2,5,19,14,14,1,13,7,18,7,0,22,GER
13fe7b69,13,8,3,7,3,3,16,13,9,0,9,13,26,5,0,22,GER
15413fa5,42,30,14,23,5,22,51,29,37,5,32,51,93,35,1,22,GER
15b287da,40,21,7,26,7,11,40,29,18,0,18,8,48,10,0,22,GER
15f24fe7,10,6,2,5,3,3,11,8,5,0,5,2,12,14,0,22,GER
169fd162,0,0,0,0,0,0,0,0,0,0,0,1,1,0,0,22,GER
16daec92,3,3,1,1,1,3,3,0,1,0,1,1,4,2,0,22,GER
17376543,2,0,2,0,0,2,7,5,0,0,0,3,5,11,5,22,GER
17780d2b,8,3,3,5,0,3,11,8,7,2,5,7,15,3,0,22,GER
17f3620a,2,2,0,1,1,0,1,1,0,0,0,0,2,6,0,22,GER
18c2e247,0,0,0,0,0,0,2,2,0,0,0,0,0,1,0,22,GER
1940be91,0,0,0,0,0,0,0,0,0,0,0,0,0,0,0,22,GER
19a967ab,21,15,9,6,6,8,19,11,13,1,12,8,29,10,0,22,GER
1a4b9094,4,4,2,1,1,4,5,1,2,1,1,6,10,1,0,22,GER
1a83027b,1,1,1,0,0,0,0,0,1,0,1,0,1,0,0,22,GER
1ae836b1,41,20,17,19,5,19,40,21,41,6,35,27,68,15,0,22,GER
1b6d8083,5,3,3,1,1,2,3,1,0,0,0,0,5,1,0,22,GER
1cbe4984,14,10,7,4,3,8,15,7,11,6,5,4,18,9,0,22,GER
1d8e9add,21,12,15,6,0,11,21,10,18,7,11,13,34,101,1,22,GER
1df0c0b9,48,29,25,20,3,25,43,18,24,7,17,28,76,57,3,22,GER
1e274a0a,10,6,5,3,2,2,8,6,3,0,3,1,11,1,0,22,GER
1f2d714c,16,11,5,7,4,11,32,21,18,1,17,10,26,7,0,22,GER
1f3afdcb,23,17,16,6,1,15,25,10,36,14,22,26,49,66,0,22,GER
1f44ac21,2,1,0,1,1,0,1,1,8,1,7,1,3,31,0,22,GER
20030c06,32,22,20,11,1,13,25,12,40,24,16,44,76,123,2,22,GER
204dded0,43,31,21,19,3,25,43,18,40,19,21,53,96,95,0,22,GER
2077ae86,10,6,1,7,2,1,4,3,8,3,5,6,16,13,0,22,GER
22919e97,8,6,3,4,1,3,11,8,4,0,4,1,9,2,0,22,GER
229cd98a,4,3,2,2,0,1,2,1,4,0,4,0,4,4,0,22,GER
236f02cd,40,30,21,14,5,17,41,24,27,4,23,22,62,38,0,22,GER
24b8e7bd,1,1,0,1,0,0,1,1,0,0,0,0,1,0,0,22,GER
25ab9c9c,18,10,14,3,1,8,11,3,16,8,8,17,35,37,0,22,GER
25bdea4b,1,1,1,0,0,1,2,1,0,0,0,0,1,11,1,22,GER
25f50295,1,0,1,0,0,0,0,0,0,0,0,1,2,2,0,22,GER
271b8617,3,2,2,0,1,3,11,8,6,0,6,8,11,8,1,22,GER
27270af4,16,9,9,7,0,9,14,5,6,2,4,9,25,14,0,22,GER
277c49ed,59,33,41,16,2,29,40,11,35,16,19,60,119,144,0,22,GER
2903a856,30,20,6,17,7,17,42,25,23,0,23,12,42,10,0,22,GER
2979c05a,15,9,5,3,7,6,22,16,26,2,24,8,23,6,0,22,GER
29ddfb9c,3,1,2,1,0,2,4,2,5,5,0,3,6,2,0,22,GER
29f7cfd9,4,2,2,1,1,1,3,2,3,0,3,4,8,2,0,22,GER
2a29eb9b,62,35,38,16,8,28,49,21,24,8,16,44,106,70,0,22,GER
2a6cd437,17,10,13,4,0,6,10,4,11,5,6,17,34,32,2,22,GER
2b09d998,23,7,5,16,2,7,25,18,24,1,23,16,39,19,2,22,GER
2b114be3,28,16,5,19,4,9,24,15,18,0,18,12,40,2,1,22,GER
2b7c56b4,13,6,6,7,0,5,16,11,2,0,2,4,17,3,0,22,GER
2b83fa49,6,4,4,2,0,4,8,4,1,1,0,3,9,9,0,22,GER
2c0558b8,40,26,11,16,13,15,36,21,25,0,25,19,59,2,1,22,GER
2e7ff968,0,0,0,0,0,0,0,0,0,0,0,0,0,2,0,22,GER
2f3e911a,54,33,32,18,4,24,55,31,24,4,20,20,74,35,0,22,GER
2f7fec15,1,0,0,1,0,0,0,0,1,0,1,0,1,0,0,22,GER
302527b2,24,13,17,6,1,13,24,11,33,23,10,50,74,158,1,22,GER
30261ba1,6,3,0,5,1,3,9,6,4,2,2,7,13,5,0,22,GER
30941e96,28,21,14,13,1,14,30,16,24,3,21,29,57,40,0,22,GER
30ae134d,3,2,1,1,1,0,4,4,3,0,3,3,6,7,0,22,GER
313254a3,7,3,3,4,0,3,6,3,1,0,1,2,9,7,1,22,GER
32c016f8,1,0,1,0,0,1,2,1,1,0,1,0,1,0,0,22,GER
34a0f5ff,3,1,1,2,0,1,1,0,1,0,1,0,3,0,0,22,GER
34b0387f,30,12,8,14,8,6,27,21,20,2,18,18,48,18,0,22,GER
34b54da7,6,5,2,4,0,3,6,3,3,2,1,5,11,8,0,22,GER
34e12499,72,43,36,34,2,33,48,15,41,32,9,56,128,154,1,22,GER
34e4343c,10,6,4,5,1,3,18,15,11,2,9,4,14,29,0,22,GER
35d64857,46,28,20,22,4,26,47,21,43,15,28,41,87,76,1,22,GER
35f67a30,0,0,0,0,0,0,1,1,0,0,0,0,0,0,0,22,GER
36a3ff67,45,30,13,21,11,16,42,26,23,6,17,12,57,41,1,22,GER
36a59ba4,55,28,24,26,5,27,64,37,38,6,32,31,86,19,4,22,GER
36cf2caf,0,0,0,0,0,0,1,1,0,0,0,0,0,0,0,22,GER
3724baa1,12,10,7,4,1,7,9,2,6,2,4,6,18,8,0,22,GER
3745e8bd,9,3,1,4,4,2,11,9,15,5,10,2,11,24,0,22,GER
378825c7,42,30,24,15,3,27,44,17,33,7,26,39,81,77,1,22,GER
37998008,0,0,0,0,0,0,0,0,0,0,0,0,0,0,0,22,GER
37dc1a48,28,13,6,13,9,12,36,24,30,0,30,24,52,11,1,22,GER
37f606f0,34,23,9,20,5,17,30,13,15,1,14,14,48,7,1,22,GER
384d58d9,23,14,9,10,4,12,35,23,25,5,20,19,42,22,1,22,GER
3b1ed320,30,17,11,15,4,9,23,14,32,6,26,9,39,16,2,22,GER
3ba95f20,1,0,0,0,1,1,3,2,0,0,0,1,2,0,0,22,GER
3bb625ac,2,0,1,1,0,1,4,3,2,2,0,2,4,6,0,22,GER
3c569f37,2,0,1,0,1,1,2,1,0,0,0,1,3,0,0,22,GER
3c6089ab,35,20,7,16,12,16,54,38,32,1,31,15,50,12,0,22,GER
3cd9e95a,0,0,0,0,0,0,1,1,0,0,0,0,0,5,0,22,GER
3eb0f2df,32,18,15,13,4,13,32,19,22,3,19,20,52,17,2,22,GER
3eeb80e0,5,4,1,3,1,4,7,3,5,1,4,2,7,4,0,22,GER
3effaa34,13,9,2,3,8,4,13,9,20,2,18,2,15,15,0,22,GER
40b58bfc,4,2,2,0,2,2,7,5,8,3,5,5,9,19,0,22,GER
41bff4fa,10,4,8,2,0,8,18,10,16,6,10,20,30,33,2,22,GER
41df88b8,0,0,0,0,0,0,0,0,0,0,0,0,0,0,0,22,GER
420c18a1,0,0,0,0,0,0,2,2,0,0,0,3,3,8,3,22,GER
437f2b00,28,15,14,7,7,13,32,19,24,3,21,8,36,16,0,22,GER
441197b8,60,34,29,27,4,44,59,15,46,20,26,48,108,137,0,22,GER
442b56fa,62,37,30,24,8,25,65,40,43,1,42,21,83,52,1,22,GER
44a20f0c,28,15,17,10,1,11,28,17,24,14,10,29,57,99,0,22,GER
45a03961,35,20,21,13,1,19,29,10,28,16,12,36,71,50,1,22,GER
47064058,0,0,0,0,0,0,3,3,0,0,0,0,0,19,1,22,GER
48035304,40,24,23,17,0,22,36,14,33,22,11,34,74,83,1,22,GER
49296448,39,20,14,17,8,18,58,40,34,8,26,52,91,29,1,22,GER
493924a7,31,20,21,5,5,12,23,11,25,8,17,35,66,35,0,22,GER
496aeede,28,11,15,10,3,12,28,16,18,5,13,12,40,9,0,22,GER
4aea5077,19,11,9,7,3,12,28,16,24,5,19,14,33,31,0,22,GER
4bd00a50,0,0,0,0,0,0,0,0,0,0,0,1,1,0,1,22,GER
4c184730,1,0,0,1,0,1,1,0,1,0,1,0,1,0,0,22,GER
4c6facae,57,33,28,25,4,22,60,38,35,8,27,50,107,20,1,22,GER
4d6a842d,0,0,0,0,0,0,0,0,0,0,0,1,1,1,1,22,GER
4e204552,2,1,1,1,0,0,5,5,14,3,11,5,7,5,2,22,GER
50871bcc,23,13,8,10,5,15,40,25,23,1,22,6,29,4,0,22,GER
526ea7cc,58,29,38,19,1,32,51,19,37,23,14,50,108,132,1,22,GER
52afb588,9,7,6,2,1,3,10,7,15,3,12,3,12,16,0,22,GER
53070b63,22,13,6,13,3,13,27,14,14,1,13,6,28,7,0,22,GER
5360a956,0,0,0,0,0,0,0,0,0,0,0,0,0,0,0,22,GER
53e07d0b,3,2,0,2,1,0,2,2,2,0,2,0,3,0,0,22,GER
5458f670,4,4,2,0,2,2,7,5,2,0,2,1,5,0,0,22,GER
54b4dc4e,52,31,19,30,3,16,41,25,32,9,23,33,85,21,0,22,GER
54e4866f,27,15,9,13,5,9,26,17,12,2,10,13,40,28,0,22,GER
555d5edd,8,4,3,2,3,4,8,4,4,2,2,5,13,0,0,22,GER
5569bf9a,22,10,11,6,5,11,22,11,15,3,12,11,33,10,0,22,GER
5584552e,1,0,1,0,0,1,1,0,0,0,0,1,2,3,3,22,GER
56413b1f,45,25,18,21,6,22,52,30,24,4,20,33,78,21,0,22,GER
5722eced,1,1,0,1,0,0,0,0,0,0,0,0,1,0,0,22,GER
5723931e,5,4,2,1,2,0,4,4,3,1,2,0,5,4,0,22,GER
5762be5c,48,24,18,27,3,18,36,18,37,14,23,34,82,47,0,22,GER
57d88cf9,52,34,15,31,6,21,53,32,50,4,46,42,94,32,0,22,GER
582a5247,28,21,8,15,5,12,27,15,13,4,9,15,43,30,0,22,GER
5853ac44,11,7,7,3,1,7,11,4,7,2,5,7,18,17,0,22,GER
58a2e9f6,11,10,6,4,1,6,12,6,12,4,8,11,22,21,1,22,GER
591477c9,18,12,13,3,2,11,25,14,21,10,11,17,35,56,0,22,GER
59e4b92e,75,38,25,42,8,32,66,34,21,8,13,50,125,27,1,22,GER
5a8d6540,17,6,5,8,4,3,14,11,8,0,8,10,27,4,0,22,GER
5ad50391,47,31,28,17,2,22,39,17,30,11,19,51,98,62,2,22,GER
5ad8c360,20,14,13,4,3,12,20,8,10,1,9,14,34,18,0,22,GER
5c4bf6ba,2,2,2,0,0,2,2,0,0,0,0,2,4,21,1,22,GER
5c50fdbc,1,0,0,0,1,0,0,0,1,0,1,0,1,0,0,22,GER
5c899683,13,9,8,4,1,6,12,6,5,1,4,4,17,7,0,22,GER
5d4f7d61,5,2,2,2,1,1,9,8,6,1,5,3,8,28,0,22,GER
5d8e331f,73,42,37,29,7,28,62,34,50,21,29,46,119,42,0,22,GER
5dc15574,19,10,8,7,4,6,25,19,26,4,22,18,37,14,0,22,GER
5ddb8f9f,15,4,6,7,2,6,18,12,14,1,13,11,26,18,1,22,GER
5dfc6ad5,42,27,12,23,7,18,30,12,24,9,15,27,69,38,0,22,GER
5e22e2a4,0,0,0,0,0,0,1,1,0,0,0,1,1,1,0,22,GER
5e66fa06,40,26,22,15,3,19,32,13,27,16,11,32,72,116,1,22,GER
60097ff6,0,0,0,0,0,0,1,1,0,0,0,2,2,0,0,22,GER
603cb947,8,4,1,5,2,7,17,10,10,0,10,9,17,7,1,22,GER
610aa1e9,42,24,30,9,3,21,41,20,31,13,18,46,88,109,3,22,GER
611b1aae,0,0,0,0,0,0,0,0,0,0,0,2,2,0,0,22,GER
6190474d,15,9,6,7,2,5,15,10,8,1,7,7,22,11,0,22,GER
626fab5f,26,19,12,10,4,13,27,14,8,2,6,9,35,25,0,22,GER
62ab9184,42,20,18,17,7,22,36,14,24,1,23,25,67,25,1,22,GER
62ba5881,0,0,0,0,0,0,0,0,0,0,0,0,0,0,0,22,GER
635f2732,40,23,18,17,5,22,53,31,41,3,38,25,65,11,0,22,GER
63b9cc6d,46,25,18,22,6,12,37,25,29,1,28,20,66,13,0,22,GER
652d4c37,11,5,1,9,1,7,17,10,5,1,4,9,20,10,0,22,GER
66385c46,14,11,6,5,3,7,17,10,3,0,3,4,18,12,0,22,GER
677da306,9,6,6,3,0,6,11,5,13,8,5,9,18,33,0,22,GER
683dec01,1,1,1,0,0,1,2,1,1,0,1,0,1,0,0,22,GER
68829001,8,3,4,4,0,1,5,4,3,0,3,3,11,3,0,22,GER
69374ff5,3,1,2,1,0,1,2,1,1,0,1,2,5,0,0,22,GER
699fb8db,8,5,5,3,0,3,6,3,7,4,3,8,16,14,0,22,GER
6b21b7b5,5,3,4,0,1,1,1,0,3,0,3,0,5,0,0,22,GER
6b8887c2,4,3,1,2,1,2,3,1,3,1,2,0,4,3,0,22,GER
6bba916f,2,1,1,1,0,2,8,6,1,0,1,5,7,3,0,22,GER
6bd5cd5d,50,24,38,12,0,30,53,23,45,26,19,49,99,151,1,22,GER
6c731625,0,0,0,0,0,0,1,1,0,0,0,0,0,1,0,22,GER
6cafd68d,7,6,2,4,1,4,4,0,2,1,1,10,17,11,0,22,GER
6cc47ae1,4,2,1,0,3,1,1,0,1,0,1,1,5,2,0,22,GER
6ce43701,1,0,0,1,0,0,1,1,5,0,5,3,4,0,0,22,GER
6d7598d5,4,2,3,1,0,2,8,6,3,0,3,3,7,1,0,22,GER
6ea23758,27,16,18,8,1,17,35,18,16,7,9,19,46,44,0,22,GER
6ebbc28a,0,0,0,0,0,0,0,0,0,0,0,0,0,0,0,22,GER
6ec6fde0,33,19,16,11,6,16,28,12,32,2,30,20,53,29,2,22,GER
6ecbddf6,28,21,7,14,7,11,30,19,9,1,8,16,44,13,0,22,GER
6f8cd6d0,6,5,0,5,1,1,4,3,5,0,5,5,11,5,0,22,GER
6fb91ea9,1,1,1,0,0,0,1,1,1,0,1,0,1,2,0,22,GER
70678132,28,22,12,11,5,10,43,33,17,2,15,9,37,15,1,22,GER
706a60e1,7,4,5,1,1,3,9,6,5,0,5,1,8,6,0,22,GER
70dcf94d,14,8,5,6,3,7,19,12,11,4,7,16,30,11,0,22,GER
710fbdd1,46,29,10,31,5,21,72,51,27,1,26,11,57,3,1,22,GER
71ec39ef,42,25,15,22,5,10,34,24,30,6,24,35,77,55,0,22,GER
7242b495,24,17,10,11,3,15,38,23,26,4,22,18,42,29,1,22,GER
73000a79,6,2,4,0,2,3,7,4,3,1,2,3,9,6,0,22,GER
73d6a176,8,3,2,6,0,2,7,5,9,2,7,4,12,5,0,22,GER
73e2f6eb,0,0,0,0,0,0,0,0,0,0,0,0,0,0,0,22,GER
74f2e748,32,18,19,12,1,12,23,11,24,6,18,17,49,40,2,22,GER
75402e99,1,0,1,0,0,1,1,0,0,0,0,0,1,0,0,22,GER
763b8b37,0,0,0,0,0,0,1,1,1,0,1,0,0,2,0,22,GER
76b2817e,32,18,27,5,0,15,24,9,13,4,9,9,41,26,0,22,GER
76fa965f,20,13,4,12,4,11,26,15,12,1,11,3,23,2,0,22,GER
792ffa71,4,1,2,1,1,1,3,2,1,0,1,2,6,2,0,22,GER
79c90e45,11,10,6,3,2,5,16,11,18,6,12,13,24,22,0,22,GER
79ca3e23,23,16,4,12,7,6,23,17,14,2,12,17,40,9,0,22,GER
7aac47fe,0,0,0,0,0,0,0,0,0,0,0,0,0,0,0,22,GER
7ba1f1ef,0,0,0,0,0,0,2,2,0,0,0,3,3,3,1,22,GER
7c473e12,15,13,11,3,1,8,11,3,17,13,4,17,32,134,1,22,GER
7c56da38,23,10,10,11,2,9,35,26,23,2,21,15,38,15,0,22,GER
7cd6badb,23,15,6,14,3,9,33,24,28,2,26,10,33,14,0,22,GER
7d3e7da6,0,0,0,0,0,0,0,0,0,0,0,0,0,1,0,22,GER
7d450ed3,52,29,30,10,12,30,64,34,38,5,33,27,79,39,1,22,GER
7e12a98d,18,10,9,7,2,10,15,5,31,19,12,31,49,74,1,22,GER
7e629adc,0,0,0,0,0,0,0,0,1,0,1,0,0,0,0,22,GER
7ed08d5c,21,10,7,12,2,12,18,6,7,0,7,11,32,10,2,22,GER
7f609bfc,48,30,20,26,2,22,39,17,43,18,25,28,76,71,2,22,GER
7f73bdf4,76,47,47,23,6,30,60,30,34,12,22,35,111,36,3,22,GER
7fa4e703,7,4,2,4,1,3,9,6,6,0,6,1,8,3,0,22,GER
7fe12375,0,0,0,0,0,0,1,1,0,0,0,0,0,11,4,22,GER
80c9e555,0,0,0,0,0,0,0,0,0,0,0,0,0,0,0,22,GER
80f36c88,22,12,9,13,0,11,21,10,8,3,5,11,33,8,1,22,GER
815c314f,23,17,16,5,2,8,24,16,30,21,9,41,64,75,3,22,GER
816192f0,6,5,4,2,0,4,6,2,5,5,0,4,10,4,0,22,GER
8307b663,4,3,1,3,0,1,5,4,0,0,0,2,6,0,0,22,GER
834d0be5,6,5,0,2,4,2,5,3,5,0,5,1,7,6,0,22,GER
8356931a,1,0,1,0,0,1,1,0,0,0,0,0,1,0,0,22,GER
83e0eeb4,0,0,0,0,0,0,1,1,0,0,0,0,0,2,0,22,GER
8494acc4,14,8,7,6,1,5,10,5,6,2,4,6,20,15,1,22,GER
857a5abe,54,23,37,16,1,30,63,33,26,15,11,41,95,112,1,22,GER
8593f88c,34,20,16,15,3,18,50,32,23,6,17,17,51,49,2,22,GER
861e0116,37,27,22,13,2,20,26,6,19,6,13,31,68,43,0,22,GER
86314793,0,0,0,0,0,0,0,0,0,0,0,0,0,8,1,22,GER
86574238,60,37,29,28,3,25,42,17,27,4,23,34,94,12,0,22,GER
86adbcc7,0,0,0,0,0,0,0,0,0,0,0,1,1,0,0,22,GER
86e119e0,37,20,19,16,2,20,50,30,43,15,28,37,74,55,0,22,GER
87436846,0,0,0,0,0,0,0,0,0,0,0,0,0,8,1,22,GER
8778c910,2,1,2,0,0,1,2,1,0,0,0,0,2,7,1,22,GER
87ebd8c9,0,0,0,0,0,0,0,0,0,0,0,0,0,0,0,22,GER
87ebfdb8,0,0,0,0,0,0,0,0,0,0,0,0,0,0,0,22,GER
8872ed17,50,31,15,32,3,26,56,30,27,3,24,19,69,30,1,22,GER
88d4144a,52,33,30,12,10,26,50,24,28,5,23,46,98,37,0,22,GER
88e357ef,47,31,16,20,11,22,57,35,26,0,26,14,61,3,0,22,GER
89ac64a6,33,23,20,11,2,22,32,10,26,15,11,35,68,58,0,22,GER
8a6ab963,0,0,0,0,0,0,0,0,0,0,0,0,0,0,0,22,GER
8b6e0db2,27,14,16,9,2,15,31,16,42,33,9,72,99,172,1,22,GER
8d78e732,10,3,0,6,4,5,17,12,17,2,15,6,16,8,0,22,GER
8df328f4,6,4,3,3,0,5,7,2,5,2,3,4,10,1,0,22,GER
8e235926,19,8,4,10,5,2,15,13,18,2,16,6,25,29,0,22,GER
8eb55dbb,9,6,3,4,2,6,18,12,11,0,11,2,11,4,0,22,GER
8f056768,43,20,20,20,3,20,49,29,25,2,23,9,52,14,0,22,GER
8fe2a392,4,4,3,1,0,0,1,1,4,1,3,2,6,8,0,22,GER
8ff2354e,10,7,6,4,0,6,11,5,6,0,6,7,17,11,0,22,GER
901c0f97,59,26,23,31,5,23,60,37,28,3,25,39,98,33,0,22,GER
90339309,13,9,7,6,0,7,8,1,7,3,4,14,27,14,0,22,GER
9050ddc4,30,15,18,10,2,15,26,11,15,3,12,14,44,42,0,22,GER
90c1f9a4,4,3,2,2,0,3,6,3,2,0,2,2,6,3,0,22,GER
92432bc6,30,14,11,19,0,17,37,20,22,6,16,16,46,8,1,22,GER
924f9191,36,22,14,17,5,22,52,30,18,3,15,23,59,22,0,22,GER
92948149,1,1,1,0,0,1,5,4,1,0,1,2,3,2,0,22,GER
934e1968,17,12,5,9,3,8,27,19,30,3,27,10,27,15,0,22,GER
93a50d2c,0,0,0,0,0,0,1,1,0,0,0,0,0,1,0,22,GER
93c9e7d9,0,0,0,0,0,0,1,1,2,0,2,0,0,0,0,22,GER
94302c52,45,27,28,17,0,27,45,18,31,19,12,52,97,95,0,22,GER
943b9602,0,0,0,0,0,0,1,1,1,1,0,2,2,2,0,22,GER
94c18565,41,26,9,25,7,23,51,28,27,3,24,32,73,24,0,22,GER
9593331d,16,11,9,7,0,10,14,4,8,5,3,14,30,21,0,22,GER
962e54cb,4,2,2,1,1,1,3,2,2,0,2,1,5,4,0,22,GER
9662c9ec,9,6,3,5,1,3,7,4,7,1,6,11,20,8,0,22,GER
96d0b6f0,2,1,0,2,0,1,3,2,2,0,2,2,4,1,0,22,GER
99be8fb5,0,0,0,0,0,0,0,0,0,0,0,0,0,0,0,22,GER
99de6b6f,9,5,0,7,2,3,5,2,2,2,0,9,18,7,0,22,GER
99f7e9aa,24,11,15,5,4,17,33,16,13,3,10,11,35,25,0,22,GER
9a2e0ccc,21,12,2,11,8,7,22,15,18,0,18,2,23,2,1,22,GER
9ab16552,27,12,15,11,1,13,29,16,24,8,16,22,49,36,0,22,GER
9af1f9ff,46,27,32,13,1,23,39,16,18,5,13,15,61,52,2,22,GER
9cf4fd68,0,0,0,0,0,0,0,0,0,0,0,0,0,0,0,22,GER
9d12e142,0,0,0,0,0,0,0,0,0,0,0,0,0,0,0,22,GER
9f941969,1,0,1,0,0,1,4,3,0,0,0,1,2,12,3,22,GER
9f979eb2,9,6,3,6,0,4,7,3,6,4,2,10,19,19,0,22,GER
a1257b5e,7,2,7,0,0,5,6,1,4,1,3,8,15,21,0,22,GER
a167537f,37,19,13,20,4,17,54,37,19,2,17,24,61,14,1,22,GER
a2a85828,6,2,2,3,1,2,7,5,4,1,3,5,11,6,0,22,GER
a2b1ed42,4,2,1,3,0,1,8,7,7,0,7,3,7,8,0,22,GER
a2e7de6f,3,1,1,2,0,2,4,2,1,1,0,2,5,5,0,22,GER
a396fb61,35,20,21,13,1,21,33,12,28,19,9,34,69,64,1,22,GER
a39d11bc,34,20,25,9,0,18,28,10,21,16,5,42,76,84,2,22,GER
a3ddb1b9,32,20,9,14,9,15,49,34,27,1,26,14,46,13,0,22,GER
a3f30508,0,0,0,0,0,0,0,0,0,0,0,0,0,0,0,22,GER
a4effc55,13,7,11,1,1,7,10,3,14,4,10,15,28,38,2,22,GER
a53b661f,22,14,5,12,5,7,21,14,20,3,17,12,34,25,0,22,GER
a5420709,2,1,0,1,1,0,1,1,5,1,4,2,4,1,0,22,GER
a572e291,17,10,5,7,5,11,22,11,11,4,7,12,29,19,1,22,GER
a5bea1fb,43,26,17,18,8,19,42,23,33,4,29,12,55,26,0,22,GER
a5ce09f2,7,1,3,3,1,1,7,6,3,0,3,3,10,6,0,22,GER
a5ec3ede,52,26,35,17,0,29,46,17,31,14,17,51,103,95,1,22,GER
a65ce836,36,22,20,16,0,15,30,15,26,10,16,36,72,40,2,22,GER
a6c58494,1,0,1,0,0,1,3,2,0,0,0,0,1,0,0,22,GER
a70b8345,0,0,0,0,0,0,0,0,0,0,0,0,0,1,0,22,GER
a73c8f95,35,17,24,10,1,20,32,12,27,15,12,29,64,72,1,22,GER
a7813ac4,2,1,1,1,0,1,1,0,6,0,6,3,5,9,0,22,GER
a8090a41,0,0,0,0,0,0,0,0,0,0,0,0,0,0,0,22,GER
a8567629,33,22,16,12,5,20,34,14,13,2,11,23,56,42,3,22,GER
a8db7ebb,61,32,38,20,3,40,63,23,38,13,25,43,104,100,1,22,GER
a8ee54ad,37,22,10,21,6,15,62,47,33,3,30,21,58,25,1,22,GER
a9142dc3,5,3,3,1,1,4,4,0,1,0,1,2,7,2,0,22,GER
a92ab7be,0,0,0,0,0,0,2,2,1,0,1,2,2,10,1,22,GER
a93b6f4e,51,29,27,24,0,29,51,22,34,10,24,57,108,81,0,22,GER
a9a6fc08,0,0,0,0,0,0,0,0,0,0,0,0,0,2,2,22,GER
aad48be9,28,16,18,10,0,12,17,5,27,17,10,36,64,122,2,22,GER
ab700320,20,13,6,10,4,8,26,18,18,1,17,15,35,13,0,22,GER
ac73ec79,35,22,23,9,3,14,27,13,31,5,26,31,66,44,2,22,GER
aca0a525,7,7,7,0,0,4,4,0,5,4,1,6,13,11,0,22,GER
ad00b1a8,57,37,21,27,9,42,86,44,44,8,36,39,96,39,0,22,GER
ad1d6fa4,9,5,0,8,1,2,8,6,10,2,8,7,16,10,0,22,GER
ad2b068c,15,8,13,2,0,7,14,7,12,7,5,11,26,29,0,22,GER
ad3389d5,1,1,1,0,0,1,1,0,0,0,0,0,1,10,1,22,GER
ae44e8e2,14,6,5,7,2,5,18,13,5,1,4,4,18,1,0,22,GER
ae7058f9,8,3,4,4,0,2,5,3,4,2,2,3,11,5,1,22,GER
aeed5c06,20,11,8,9,3,5,38,33,11,0,11,8,28,2,0,22,GER
af0d79a9,22,12,14,5,3,12,26,14,30,3,27,26,48,61,0,22,GER
b0a0698b,29,18,18,9,2,14,28,14,23,13,10,19,48,53,2,22,GER
b18ef366,17,12,5,11,1,8,21,13,18,1,17,7,24,22,0,22,GER
b1cd37e6,44,17,26,9,9,20,53,33,24,1,23,15,59,24,0,22,GER
b3325a30,64,30,24,29,11,25,55,30,32,3,29,20,84,14,0,22,GER
b3b7f5a6,18,12,10,8,0,11,24,13,10,3,7,19,37,28,1,22,GER
b492126a,8,4,0,7,1,0,6,6,3,0,3,4,12,1,0,22,GER
b4b08774,3,2,2,1,0,2,3,1,2,0,2,2,5,0,0,22,GER
b4cf5806,11,7,0,3,8,3,9,6,8,0,8,3,14,14,0,22,GER
b500b384,0,0,0,0,0,0,0,0,0,0,0,0,0,0,0,22,GER
b50ec54b,16,10,7,7,2,11,20,9,17,3,14,3,19,3,0,22,GER
b77f44a4,31,13,24,7,0,19,27,8,18,10,8,28,59,73,0,22,GER
b825a650,41,19,16,20,5,10,42,32,24,5,19,24,65,17,0,22,GER
b90c4a43,0,0,0,0,0,0,0,0,0,0,0,0,0,3,0,22,GER
bbd86530,29,15,22,6,1,12,21,9,9,4,5,7,36,21,0,22,GER
bc249af8,3,1,1,1,1,1,2,1,3,0,3,0,3,1,0,22,GER
bc6bd723,18,14,6,9,3,7,20,13,9,1,8,4,22,9,0,22,GER
bcb2ccd8,0,0,0,0,0,0,0,0,0,0,0,1,1,15,1,22,GER
bd142efb,25,18,19,5,1,17,33,16,31,20,11,43,68,156,0,22,GER
bd527260,1,0,0,0,1,1,5,4,5,1,4,5,6,5,0,22,GER
bd7d2e6d,59,28,34,21,4,31,47,16,27,11,16,37,96,58,0,22,GER
bd992863,12,9,4,8,0,5,7,2,10,1,9,3,15,1,0,22,GER
be42a291,23,12,4,13,6,10,20,10,10,0,10,2,25,1,0,22,GER
be625686,0,0,0,0,0,0,0,0,0,0,0,0,0,0,0,22,GER
beb882a8,48,28,17,25,6,22,50,28,35,11,24,30,78,32,1,22,GER
bee0bab1,9,4,4,4,1,3,13,10,5,0,5,9,18,4,0,22,GER
bf075f6b,22,16,8,11,3,7,23,16,12,0,12,11,33,12,0,22,GER
c05f2f8c,109,71,61,39,9,56,84,28,63,9,54,62,171,65,2,22,GER
c0d3bd23,16,12,10,6,0,8,21,13,19,7,12,28,44,43,0,22,GER
c1242d4e,1,0,1,0,0,1,2,1,2,0,2,0,1,5,1,22,GER
c149016b,73,41,34,34,5,31,72,41,43,12,31,30,103,64,0,22,GER
c18d22f5,45,29,33,11,1,32,46,14,28,10,18,29,74,58,0,22,GER
c1b7847c,38,24,11,22,5,24,53,29,29,3,26,4,42,9,0,22,GER
c2009df3,76,39,36,26,14,29,74,45,59,8,51,50,126,68,1,22,GER
c2211709,55,33,25,26,4,22,41,19,41,7,34,37,92,35,1,22,GER
c283ddef,4,4,0,2,2,2,6,4,9,2,7,2,6,4,0,22,GER
c3ee18ef,50,31,20,24,6,26,42,16,22,11,11,28,78,54,1,22,GER
c41f7379,0,0,0,0,0,0,0,0,0,0,0,0,0,0,0,22,GER
c455a2b2,33,19,12,13,8,13,49,36,19,1,18,15,48,11,0,22,GER
c4e87b8b,13,7,3,3,7,7,17,10,10,3,7,2,15,11,1,22,GER
c562c5b4,37,19,24,13,0,20,26,6,36,23,13,56,93,143,1,22,GER
c64c01fc,18,13,4,8,6,6,17,11,29,1,28,6,24,11,1,22,GER
c68da769,31,22,4,13,14,7,33,26,24,4,20,5,36,9,0,22,GER
c6cf860f,0,0,0,0,0,0,0,0,0,0,0,0,0,0,0,22,GER
c89e8aae,0,0,0,0,0,0,0,0,0,0,0,0,0,3,0,22,GER
c8c60119,12,9,8,3,1,4,17,13,10,3,7,5,17,19,0,22,GER
ca618d23,41,25,10,17,14,13,28,15,25,4,21,17,58,39,2,22,GER
ca6f4846,7,3,1,3,3,3,4,1,4,0,4,3,10,2,0,22,GER
ca8033cb,29,16,11,15,3,13,19,6,16,3,13,26,55,58,0,22,GER
cadd666a,11,7,4,5,2,2,10,8,12,1,11,4,15,8,0,22,GER
cb11b429,53,31,13,31,9,22,61,39,30,1,29,27,80,13,0,22,GER
cb64672e,2,2,0,2,0,1,1,0,0,0,0,0,2,0,0,22,GER
cbac6ec9,0,0,0,0,0,0,1,1,1,0,1,0,0,13,2,22,GER
cc86b9a3,25,15,12,9,4,11,26,15,11,1,10,17,42,23,2,22,GER
ccc6d365,1,0,0,1,0,0,1,1,1,1,0,0,1,0,0,22,GER
cd59b9df,0,0,0,0,0,0,2,2,0,0,0,1,1,20,0,22,GER
cd82452e,36,20,9,15,12,17,50,33,38,5,33,15,51,43,0,22,GER
ce17b5eb,0,0,0,0,0,0,1,1,0,0,0,1,1,13,2,22,GER
cf623c78,13,7,6,5,2,10,13,3,8,1,7,10,23,7,0,22,GER
d01231f0,14,7,3,5,6,3,12,9,10,1,9,2,16,12,0,22,GER
d01b9ad6,0,0,0,0,0,0,0,0,0,0,0,0,0,0,0,22,GER
d1273f09,46,30,17,26,3,27,72,45,36,5,31,18,64,33,0,22,GER
d1661819,24,15,15,7,2,10,13,3,10,2,8,12,36,21,0,22,GER
d2416c2e,13,4,3,6,4,3,13,10,13,0,13,3,16,9,0,22,GER
d248cd8f,66,42,42,21,3,24,36,12,20,10,10,32,98,71,6,22,GER
d25fee56,35,21,14,20,1,15,32,17,17,2,15,19,54,27,1,22,GER
d28339cb,0,0,0,0,0,0,0,0,0,0,0,0,0,1,0,22,GER
d2c580ce,11,4,5,4,2,5,15,10,7,1,6,1,12,8,0,22,GER
d3096421,6,2,0,4,2,4,7,3,4,1,3,1,7,1,0,22,GER
d3112d86,31,17,12,15,4,15,42,27,15,2,13,25,56,31,1,22,GER
d4a2533d,0,0,0,0,0,0,0,0,0,0,0,0,0,0,0,22,GER
d6862409,6,5,1,3,2,4,13,9,9,0,9,4,10,7,0,22,GER
d686dbc0,17,10,11,6,0,6,10,4,14,3,11,10,27,28,0,22,GER
d781d855,34,17,17,8,9,13,31,18,27,1,26,23,57,26,1,22,GER
d9e196bf,0,0,0,0,0,0,1,1,1,0,1,1,1,1,0,22,GER
da27e268,9,7,2,4,3,2,8,6,6,0,6,6,15,4,0,22,GER
da76715c,3,2,2,1,0,1,3,2,5,1,4,6,9,11,1,22,GER
daa78200,14,9,8,3,3,6,14,8,9,2,7,2,16,7,0,22,GER
db401046,0,0,0,0,0,0,1,1,0,0,0,0,0,9,2,22,GER
db4ed67b,42,19,10,24,8,20,46,26,18,3,15,17,59,16,0,22,GER
db8c8860,1,1,0,1,0,0,0,0,0,0,0,0,1,0,0,22,GER
dc38e3bc,2,0,0,1,1,1,4,3,3,0,3,0,2,1,0,22,GER
dc62b55d,0,0,0,0,0,0,0,0,0,0,0,0,0,0,0,22,GER
dcfb17f4,27,14,10,14,3,8,15,7,26,2,24,11,38,12,0,22,GER
dd669209,20,16,10,10,0,9,16,7,7,0,7,13,33,14,0,22,GER
dd676a97,1,1,1,0,0,1,2,1,2,0,2,1,2,1,1,22,GER
dd7b6eb8,0,0,0,0,0,0,0,0,1,0,1,1,1,0,0,22,GER
de4cac2d,5,4,4,0,1,3,7,4,5,0,5,2,7,1,0,22,GER
dee3013b,0,0,0,0,0,0,0,0,0,0,0,0,0,2,0,22,GER
df8e7b62,2,0,0,2,0,1,2,1,3,0,3,4,6,0,0,22,GER
df9c3473,25,15,17,8,0,12,19,7,21,8,13,27,52,52,0,22,GER
dfb6490a,15,7,5,6,4,9,24,15,10,1,9,6,21,8,0,22,GER
dfc85b89,13,6,4,5,4,4,8,4,14,2,12,8,21,16,0,22,GER
e0b113a7,33,17,18,14,1,14,28,14,19,7,12,31,64,46,0,22,GER
e0d515ef,0,0,0,0,0,0,0,0,0,0,0,0,0,0,0,22,GER
e12b0b5b,15,7,5,8,2,5,17,12,11,1,10,13,28,8,0,22,GER
e162b013,29,19,13,12,4,16,33,17,10,2,8,12,41,25,1,22,GER
e21042ae,7,5,0,5,2,2,10,8,17,4,13,0,7,31,0,22,GER
e26fcca3,93,54,50,37,6,38,89,51,31,6,25,41,134,42,0,22,GER
e27da244,47,25,25,18,4,36,60,24,33,19,14,41,88,125,1,22,GER
e27de4fa,1,1,1,0,0,1,1,0,0,0,0,0,1,1,0,22,GER
e280527c,20,8,9,9,2,10,20,10,7,0,7,10,30,10,1,22,GER
e33c06cf,29,23,21,7,1,18,24,6,16,12,4,28,57,49,0,22,GER
e38f1636,32,23,25,7,0,24,34,10,31,22,9,37,69,119,1,22,GER
e5478b87,11,7,3,6,2,1,9,8,11,2,9,2,13,29,0,22,GER
e547d3cf,0,0,0,0,0,0,0,0,0,0,0,0,0,0,0,22,GER
e5649a78,10,5,5,5,0,4,10,6,6,0,6,5,15,1,1,22,GER
e5a35ae9,9,1,3,5,1,5,13,8,5,0,5,8,17,3,0,22,GER
e5f63987,0,0,0,0,0,0,0,0,0,0,0,0,0,0,0,22,GER
e6c15f6e,44,26,30,11,3,21,38,17,24,9,15,13,57,51,0,22,GER
e6c43eec,23,14,13,9,1,7,18,11,11,6,5,25,48,42,0,22,GER
e79269bd,24,11,12,10,2,11,40,29,24,4,20,13,37,33,1,22,GER
e7b899b8,46,25,19,22,5,18,43,25,52,16,36,68,114,56,0,22,GER
e7d22eae,11,6,3,7,1,6,18,12,11,2,9,6,17,8,0,22,GER
e7fcf289,25,10,6,16,3,10,28,18,12,1,11,13,38,4,0,22,GER
e82adcab,30,19,12,14,4,15,38,23,20,1,19,28,58,11,2,22,GER
ea003d07,0,0,0,0,0,0,0,0,0,0,0,0,0,0,0,22,GER
eac044ad,18,10,3,5,10,4,17,13,10,0,10,5,23,4,0,22,GER
eb61713c,2,1,0,0,2,0,2,2,4,0,4,2,4,1,0,22,GER
ebac0ace,6,6,1,2,3,0,3,3,7,0,7,1,7,9,0,22,GER
ed79b7d3,12,6,4,4,4,1,10,9,14,1,13,1,13,7,0,22,GER
eec1f7f4,2,2,2,0,0,0,0,0,0,0,0,0,2,0,0,22,GER
ef233486,5,2,1,2,2,1,6,5,3,0,3,2,7,4,0,22,GER
f0a37d36,51,35,29,20,2,25,49,24,27,10,17,43,94,84,0,22,GER
f168d9b9,0,0,0,0,0,0,0,0,0,0,0,0,0,0,0,22,GER
f24ea523,37,20,12,22,3,15,48,33,25,3,22,26,63,15,0,22,GER
f26834c7,18,10,4,6,8,7,22,15,27,2,25,7,25,8,0,22,GER
f26dee6b,0,0,0,0,0,0,0,0,0,0,0,0,0,1,0,22,GER
f27680d9,59,36,40,16,3,30,61,31,22,7,15,32,91,35,1,22,GER
f2dd9a21,22,11,10,10,2,8,21,13,11,2,9,9,31,15,0,22,GER
f36c432f,5,2,0,2,3,1,6,5,3,0,3,1,6,6,0,22,GER
f4c69aa6,0,0,0,0,0,0,4,4,2,0,2,1,1,0,0,22,GER
f4c7c708,2,0,1,1,0,1,1,0,1,0,1,0,2,0,0,22,GER
f4ec4fd0,6,5,1,4,1,3,9,6,7,2,5,6,12,11,0,22,GER
f521b80a,36,22,20,13,3,27,40,13,21,10,11,33,69,76,0,22,GER
f68b64fc,60,28,32,20,8,36,61,25,44,16,28,43,103,59,2,22,GER
f6bdc830,11,5,6,5,0,5,6,1,7,4,3,11,22,24,1,22,GER
f76022e7,2,0,0,2,0,0,1,1,0,0,0,1,3,1,0,22,GER
f7aa75bd,25,11,18,6,1,15,27,12,18,3,15,17,42,52,0,22,GER
f86cabbd,4,1,1,3,0,4,5,1,4,2,2,17,21,30,0,22,GER
f86cd5df,34,13,14,16,4,14,26,12,19,7,12,13,47,16,0,22,GER
f93e6e94,5,3,2,3,0,1,13,12,7,0,7,2,7,17,0,22,GER
f9446dcd,13,4,4,7,2,7,28,21,14,0,14,6,19,6,0,22,GER
f956479d,3,2,3,0,0,2,6,4,1,0,1,0,3,0,0,22,GER
f972644c,30,16,14,10,6,13,36,23,30,4,26,16,46,24,0,22,GER
f9b1b7bf,19,12,11,5,3,11,16,5,7,1,6,4,23,7,0,22,GER
f9e7c4ac,3,1,0,2,1,2,4,2,5,1,4,2,5,8,0,22,GER
f9f92b5f,3,1,0,3,0,2,10,8,12,1,11,2,5,13,0,22,GER
fa274d97,21,12,9,7,5,9,21,12,8,1,7,11,32,8,0,22,GER
fa661778,26,10,13,9,4,12,24,12,14,1,13,13,39,8,0,22,GER
fbbc8e15,5,2,2,2,1,3,4,1,8,2,6,1,6,4,0,22,GER
fc62fdf4,14,5,6,7,1,4,16,12,9,0,9,3,17,6,0,22,GER
fcb27134,48,27,25,21,2,27,41,14,22,11,11,40,88,46,1,22,GER
fd53759d,24,16,6,12,6,8,23,15,23,2,21,10,34,11,0,22,GER
fe641c1a,0,0,0,0,0,0,0,0,0,0,0,0,0,0,0,22,GER
fe888e39,5,3,1,3,1,1,6,5,5,2,3,2,7,5,0,22,GER
ff182fdc,9,6,4,4,1,4,8,4,9,1,8,5,14,16,0,22,GER
ff98492b,3,2,1,1,1,2,9,7,2,0,2,3,6,3,0,22,GER
ffbbc83b,37,19,15,21,1,17,31,14,18,7,11,29,66,36,1,22,GER
00f0482f,0,0,0,0,0,0,0,0,0,0,0,0,0,0,0,22,ENG
01226327,8,5,3,4,1,2,5,3,8,3,5,1,9,7,0,22,ENG
01962d0d,4,3,1,0,3,2,10,8,9,0,9,0,4,3,0,22,ENG
02b29014,75,43,30,37,8,32,71,39,33,8,25,28,103,32,0,22,ENG
0313a347,25,15,13,11,1,10,13,3,31,22,9,15,40,86,2,22,ENG
0420d84f,61,36,35,16,10,33,51,18,30,11,19,32,93,80,2,22,ENG
0442183b,21,10,11,9,1,10,20,10,7,2,5,15,36,32,0,22,ENG
0562b7f1,16,10,2,7,7,7,21,14,20,5,15,0,16,18,0,22,ENG
05e8ca6d,0,0,0,0,0,0,0,0,0,0,0,0,0,0,0,22,ENG
0745b37d,23,11,2,14,7,6,29,23,21,1,20,4,27,3,0,22,ENG
076bb352,0,0,0,0,0,0,0,0,1,0,1,0,0,0,0,22,ENG
07802f7f,23,16,2,16,5,13,37,24,31,2,29,6,29,22,0,22,ENG
099e666f,17,7,11,6,0,13,21,8,8,1,7,20,37,31,0,22,ENG
0b33f6ad,80,47,54,22,4,40,65,25,49,26,23,78,158,158,4,22,ENG
0d4ceb32,12,7,3,4,5,3,7,4,5,1,4,0,12,9,0,22,ENG
0db5d2c8,10,4,3,5,2,7,10,3,6,1,5,10,20,13,0,22,ENG
0ef89a37,17,12,4,11,2,6,21,15,11,1,10,7,24,4,0,22,ENG
0f134faf,33,18,12,16,5,22,63,41,32,3,29,22,55,13,0,22,ENG
0f933743,7,3,7,0,0,5,8,3,7,2,5,6,13,35,0,22,ENG
1000a059,0,0,0,0,0,0,0,0,0,0,0,0,0,0,0,22,ENG
101da2b5,21,10,7,10,4,9,27,18,8,2,6,8,29,13,1,22,ENG
111c3236,18,15,10,7,1,8,21,13,12,5,7,14,32,10,0,22,ENG
112c495e,36,21,17,17,2,24,36,12,22,6,16,19,55,41,1,22,ENG
1137759d,56,25,32,15,9,33,60,27,32,3,29,22,78,38,0,22,ENG
119b9a8e,33,15,22,10,1,14,20,6,15,10,5,20,53,64,2,22,ENG
11ff3d56,22,11,10,9,3,10,24,14,7,0,7,9,31,10,0,22,ENG
1265a93a,33,25,14,18,1,9,22,13,20,2,18,17,50,22,0,22,ENG
132a82f1,12,8,11,1,0,7,11,4,5,2,3,12,24,26,1,22,ENG
1544f145,67,44,31,28,8,30,69,39,36,7,29,24,91,28,0,22,ENG
1598599e,12,6,8,4,0,6,17,11,7,4,3,11,23,11,1,22,ENG
15ea812b,65,45,47,17,1,33,47,14,75,61,14,48,113,186,4,22,ENG
15f3ec41,14,10,5,6,3,8,23,15,8,0,8,2,16,6,1,22,ENG
16264a81,16,10,7,7,2,5,12,7,18,4,14,10,26,7,0,22,ENG
169fd162,27,13,9,16,2,14,44,30,10,0,10,13,40,7,1,22,ENG
172e52d8,40,21,32,8,0,22,34,12,37,27,10,52,92,187,0,22,ENG
17695062,14,7,7,7,0,4,20,16,18,1,17,15,29,10,1,22,ENG
1770bd68,16,6,11,4,1,9,20,11,10,0,10,5,21,11,0,22,ENG
17734ea0,0,0,0,0,0,0,0,0,0,0,0,0,0,0,0,22,ENG
178ae8f8,39,18,12,18,9,13,55,42,19,2,17,6,45,6,0,22,ENG
17d45fb2,3,2,1,1,1,1,5,4,2,0,2,2,5,4,0,22,ENG
18b896d6,48,28,29,15,4,36,48,12,20,11,9,28,76,91,1,22,ENG
1900032e,15,10,12,3,0,8,15,7,10,8,2,7,22,36,0,22,ENG
1961b2aa,16,4,6,6,4,8,32,24,8,2,6,1,17,7,1,22,ENG
197640fd,67,31,38,22,7,27,43,16,28,9,19,29,96,54,1,22,ENG
19a12bed,53,34,31,16,6,27,43,16,20,4,16,69,122,67,0,22,ENG
19a9cb70,1,0,0,0,1,0,0,0,0,0,0,0,1,0,0,22,ENG
19e50035,0,0,0,0,0,0,0,0,0,0,0,0,0,0,1,22,ENG
19f4d211,0,0,0,0,0,0,0,0,0,0,0,0,0,0,0,22,ENG
1a4ef233,26,13,19,7,0,19,29,10,30,22,8,21,47,93,4,22,ENG
1b4f1169,22,18,11,9,2,12,14,2,12,7,5,13,35,12,4,22,ENG
1b84dbe1,46,29,34,7,5,30,47,17,31,13,18,37,83,70,0,22,ENG
1bf33a9a,10,7,6,3,1,3,17,14,12,0,12,5,15,10,0,22,ENG
1bf811d4,24,15,17,6,1,19,27,8,21,11,10,22,46,48,0,22,ENG
1c0eea98,0,0,0,0,0,0,0,0,0,0,0,1,1,5,0,22,ENG
1c7012b8,80,42,45,32,3,38,71,33,45,21,24,63,143,52,1,22,ENG
1cb49278,14,8,9,4,1,4,7,3,14,6,8,29,43,57,1,22,ENG
1d5cab82,22,12,10,10,2,5,27,22,20,2,18,12,34,19,0,22,ENG
1daec722,93,62,43,32,18,44,71,27,42,14,28,30,123,74,0,22,ENG
1ecb65be,4,2,2,0,2,1,5,4,3,0,3,5,9,2,0,22,ENG
1ef37668,28,15,15,11,2,17,28,11,18,7,11,10,38,38,0,22,ENG
1fb1c435,20,9,7,6,7,4,32,28,12,0,12,11,31,27,1,22,ENG
21166ff4,47,30,32,12,3,26,42,16,44,27,17,32,79,115,1,22,ENG
21512407,17,10,8,8,1,10,16,6,10,3,7,10,27,10,0,22,ENG
21945a9e,0,0,0,0,0,0,0,0,0,0,0,0,0,0,0,22,ENG
21a66f6a,15,5,2,10,3,7,18,11,26,8,18,3,18,39,0,22,ENG
235a62f8,1,0,1,0,0,0,1,1,2,2,0,2,3,3,0,22,ENG
2389cdc2,89,50,52,34,3,47,78,31,54,16,38,49,138,100,2,22,ENG
240c8ab6,0,0,0,0,0,0,0,0,0,0,0,0,0,0,0,22,ENG
24f59bb2,61,29,30,26,5,31,59,28,22,6,16,24,85,37,0,22,ENG
24fae784,20,13,10,7,3,10,15,5,25,5,20,22,42,62,1,22,ENG
2500cef9,12,6,5,4,3,1,16,15,12,5,7,8,20,6,0,22,ENG
254147d4,9,3,3,5,1,3,11,8,6,1,5,2,11,6,1,22,ENG
2628fd2b,1,1,1,0,0,1,1,0,0,0,0,0,1,1,0,22,ENG
2691c772,11,2,2,7,2,2,9,7,8,1,7,2,13,5,0,22,ENG
26d3b5be,0,0,0,0,0,0,0,0,1,1,0,0,0,1,0,22,ENG
26f6dca8,28,15,10,11,7,10,35,25,16,0,16,19,47,10,0,22,ENG
27c01749,0,0,0,0,0,0,1,1,2,0,2,0,0,0,0,22,ENG
282679b4,47,25,18,23,6,25,66,41,22,4,18,11,58,20,0,22,ENG
282f75f3,10,8,5,5,0,5,11,6,32,28,4,27,37,113,3,22,ENG
28300a16,0,0,0,0,0,0,0,0,0,0,0,0,0,0,0,22,ENG
2886c9b5,14,4,9,4,1,6,15,9,10,0,10,11,25,12,0,22,ENG
28d596a0,0,0,0,0,0,0,0,0,0,0,0,0,0,4,0,22,ENG
291e3ec3,9,6,2,5,2,2,3,1,4,2,2,3,12,7,0,22,ENG
2928dca2,31,14,23,7,1,16,28,12,46,40,6,28,59,140,0,22,ENG
2944f86f,25,17,13,9,3,8,27,19,16,2,14,14,39,13,0,22,ENG
29733c72,6,4,2,3,1,3,5,2,1,0,1,1,7,1,0,22,ENG
2acd49b9,53,27,27,20,6,28,42,14,42,13,29,30,83,64,0,22,ENG
2b16cb1a,13,8,6,4,3,3,17,14,13,2,11,11,24,3,0,22,ENG
2b622f01,25,10,7,14,4,8,35,27,19,0,19,18,43,19,0,22,ENG
2b91cf8e,13,10,4,7,2,9,14,5,14,11,3,13,26,43,1,22,ENG
2baec6ce,5,3,3,2,0,2,5,3,5,4,1,5,10,12,1,22,ENG
2bc28bb9,0,0,0,0,0,0,2,2,0,0,0,3,3,0,0,22,ENG
2bd83368,54,32,20,30,4,21,59,38,49,3,46,22,76,17,0,22,ENG
2c44a35d,51,35,20,22,9,17,52,35,36,2,34,15,66,13,0,22,ENG
2ce2508a,18,9,9,6,3,10,16,6,6,1,5,11,29,15,0,22,ENG
2d5f03bf,6,3,5,1,0,3,4,1,0,0,0,1,7,4,0,22,ENG
2d61d13a,10,5,4,6,0,5,9,4,19,11,8,16,26,26,0,22,ENG
2d760d7b,1,1,1,0,0,0,0,0,0,0,0,0,1,5,0,22,ENG
2e4f5f03,36,21,16,15,5,20,35,15,24,3,21,23,59,61,0,22,ENG
2f6ec02a,18,7,8,7,3,9,32,23,10,1,9,7,25,4,0,22,ENG
2f7acede,15,10,4,9,2,8,21,13,14,3,11,16,31,10,2,22,ENG
2f8d27bc,0,0,0,0,0,0,0,0,0,0,0,0,0,0,0,22,ENG
2f90f6b8,28,16,12,11,5,12,29,17,19,5,14,17,45,20,0,22,ENG
2f965a72,0,0,0,0,0,0,0,0,0,0,0,0,0,1,0,22,ENG
2fba6108,26,20,12,12,2,15,29,14,17,1,16,9,35,7,0,22,ENG
2ff964a0,33,17,10,13,10,10,34,24,26,4,22,9,42,14,0,22,ENG
30d4a2e5,25,15,15,7,3,12,21,9,15,2,13,16,41,37,0,22,ENG
30db8574,8,7,6,2,0,6,7,1,9,6,3,6,14,25,0,22,ENG
31822f8c,1,1,0,0,1,0,0,0,1,0,1,0,1,1,0,22,ENG
31c69ef1,26,19,11,12,3,8,15,7,19,13,6,23,49,66,0,22,ENG
32f60ed8,0,0,0,0,0,0,0,0,1,0,1,0,0,0,0,22,ENG
3312f911,46,25,16,23,7,24,50,26,39,9,30,18,64,32,0,22,ENG
3353737a,40,24,15,18,7,22,43,21,20,8,12,31,71,45,1,22,ENG
33887998,1,0,1,0,0,1,3,2,0,0,0,0,1,13,4,22,ENG
3423f250,51,29,25,14,12,22,71,49,43,0,43,29,80,28,1,22,ENG
3515d404,41,24,12,24,5,19,70,51,43,15,28,40,81,45,1,22,ENG
35be8087,2,1,1,1,0,1,4,3,0,0,0,0,2,2,0,22,ENG
35e413f1,44,23,30,8,6,28,45,17,42,24,18,42,86,102,0,22,ENG
3631ad41,31,18,23,5,3,11,26,15,11,4,7,12,43,32,0,22,ENG
36c2ca73,0,0,0,0,0,0,0,0,0,0,0,0,0,4,0,22,ENG
3727dd3c,30,17,12,18,0,14,34,20,22,7,15,22,52,20,2,22,ENG
38c7feef,15,11,2,8,5,3,14,11,12,2,10,6,21,5,0,22,ENG
38ceb24a,34,20,12,9,13,4,31,27,33,4,29,15,49,10,0,22,ENG
3935e52e,0,0,0,0,0,0,0,0,0,0,0,4,4,1,0,22,ENG
3a233281,17,11,6,8,3,6,13,7,10,1,9,1,18,2,0,22,ENG
3a24769f,0,0,0,0,0,0,1,1,1,0,1,1,1,0,0,22,ENG
3a949a25,1,1,1,0,0,0,1,1,0,0,0,0,1,8,2,22,ENG
3ae14ed1,0,0,0,0,0,0,0,0,0,0,0,0,0,0,0,22,ENG
3b8674e6,36,18,14,14,8,16,32,16,24,9,15,20,56,35,0,22,ENG
3bb7b8b4,2,1,2,0,0,0,2,2,0,0,0,0,2,12,0,22,ENG
3c33f9d9,4,3,3,1,0,2,7,5,3,1,2,2,6,5,1,22,ENG
3d50bcdb,0,0,0,0,0,0,0,0,0,0,0,0,0,0,0,22,ENG
3dcef539,0,0,0,0,0,0,0,0,1,0,1,0,0,0,0,22,ENG
3e9e06cb,29,17,20,8,1,14,25,11,59,52,7,29,58,139,0,22,ENG
3ea50f67,31,16,9,11,11,7,23,16,24,1,23,5,36,7,0,22,ENG
3eb22ec9,57,29,19,19,19,31,67,36,24,2,22,20,77,19,0,22,ENG
3f70db80,0,0,0,0,0,0,0,0,0,0,0,0,0,0,0,22,ENG
3faa1780,9,4,5,3,1,4,15,11,11,1,10,9,18,7,0,22,ENG
3fe6bd8c,7,3,3,4,0,5,8,3,5,0,5,3,10,5,0,22,ENG
407db0d5,1,0,0,1,0,0,3,3,0,0,0,1,2,2,0,22,ENG
4115ce4e,32,15,18,13,1,19,33,14,48,27,21,72,104,141,0,22,ENG
420d7c7d,74,42,46,23,5,51,97,46,46,25,21,28,102,52,1,22,ENG
42130443,0,0,0,0,0,0,0,0,0,0,0,0,0,2,0,22,ENG
4315f30d,14,7,10,2,2,7,12,5,6,3,3,11,25,20,0,22,ENG
43458538,19,15,7,6,6,4,17,13,15,4,11,8,27,31,0,22,ENG
43a166b4,0,0,0,0,0,0,2,2,1,0,1,1,1,2,0,22,ENG
4468ec10,30,19,13,10,7,10,22,12,30,2,28,15,45,21,1,22,ENG
44781702,36,21,20,12,4,13,26,13,32,19,13,30,66,75,1,22,ENG
44bfb6c5,68,37,23,41,4,24,87,63,39,5,34,41,109,49,3,22,ENG
450ab6fc,15,7,9,5,1,4,12,8,38,28,10,22,37,121,1,22,ENG
45685411,0,0,0,0,0,0,1,1,3,0,3,1,1,0,0,22,ENG
45963054,6,5,0,4,2,1,7,6,9,0,9,1,7,17,0,22,ENG
4596da74,0,0,0,0,0,0,0,0,0,0,0,0,0,0,0,22,ENG
45db685d,64,33,27,31,6,29,83,54,27,4,23,36,100,21,1,22,ENG
4654e5f5,5,2,1,4,0,3,3,0,1,1,0,2,7,6,0,22,ENG
466fb2c5,2,1,2,0,0,1,2,1,0,0,0,0,2,26,3,22,ENG
471f16b3,42,22,18,20,4,17,59,42,29,7,22,34,76,54,0,22,ENG
47369df8,73,37,25,42,6,21,53,32,37,12,25,68,141,42,1,22,ENG
47a34c4f,16,8,10,5,1,7,12,5,7,1,6,14,30,13,0,22,ENG
4806ec67,1,1,1,0,0,0,1,1,1,0,1,1,2,14,1,22,ENG
48a5a5d6,27,19,7,14,6,10,29,19,26,1,25,20,47,15,0,22,ENG
495945ef,21,12,8,12,1,10,31,21,21,9,12,30,51,16,1,22,ENG
49fe9070,8,4,3,3,2,2,20,18,9,0,9,2,10,4,0,22,ENG
4a1a9578,9,7,3,5,1,2,8,6,7,0,7,4,13,2,0,22,ENG
4ab53cdb,20,12,8,8,4,4,14,10,19,1,18,4,24,12,0,22,ENG
4b40d9ca,0,0,0,0,0,0,2,2,0,0,0,2,2,30,3,22,ENG
4b511457,77,39,25,45,7,28,73,45,39,8,31,51,128,43,0,22,ENG
4bcf39f6,17,10,2,6,9,4,18,14,21,2,19,2,19,2,0,22,ENG
4c370d81,23,14,5,8,10,3,16,13,20,0,20,4,27,3,0,22,ENG
4e9a0555,9,5,1,4,4,4,12,8,18,6,12,2,11,12,0,22,ENG
4f565d77,54,25,24,25,5,24,57,33,37,9,28,24,78,18,0,22,ENG
4f974391,28,18,18,6,4,13,25,12,31,18,13,35,63,66,0,22,ENG
4fb9c88f,11,9,3,6,2,1,10,9,4,0,4,6,17,4,0,22,ENG
507c7bdf,54,28,26,22,6,26,91,65,36,0,36,17,71,42,2,22,ENG
50dc94ce,21,11,12,7,2,7,15,8,11,3,8,8,29,5,0,22,ENG
50e6dc35,8,4,2,5,1,3,18,15,11,3,8,4,12,13,0,22,ENG
51cf8561,20,14,7,10,3,11,20,9,11,3,8,14,34,15,1,22,ENG
5271c8f1,2,2,1,1,0,2,6,4,0,0,0,0,2,0,0,22,ENG
527f063d,4,1,0,3,1,2,8,6,6,0,6,2,6,8,0,22,ENG
529f49ab,43,29,22,17,4,18,44,26,22,4,18,23,66,35,2,22,ENG
531a4aa8,8,6,4,3,1,4,9,5,6,3,3,6,14,19,1,22,ENG
53af52f3,0,0,0,0,0,0,2,2,0,0,0,1,1,15,2,22,ENG
53cad200,51,28,18,27,6,16,35,19,32,9,23,23,74,65,1,22,ENG
5515376c,40,27,22,18,0,24,31,7,16,6,10,19,59,43,2,22,ENG
56f7a928,74,38,23,45,6,42,100,58,47,13,34,21,95,41,3,22,ENG
57c94db2,23,12,19,2,2,14,32,18,14,5,9,16,39,29,0,22,ENG
57df7a11,31,23,19,11,1,14,23,9,9,1,8,9,40,17,0,22,ENG
57e3f0c7,8,5,3,5,0,3,9,6,9,1,8,8,16,2,0,22,ENG
58eee997,15,9,9,1,5,3,9,6,5,0,5,1,16,6,0,22,ENG
59e6e5bf,11,8,1,6,4,3,8,5,5,2,3,3,14,12,0,22,ENG
5a04fd92,28,17,16,9,3,15,38,23,17,1,16,9,37,8,0,22,ENG
5a4280b1,3,2,1,2,0,1,2,1,4,1,3,1,4,20,0,22,ENG
5a7301ae,42,17,25,14,3,22,50,28,37,10,27,9,51,38,1,22,ENG
5aaef9ef,59,39,32,25,2,27,73,46,30,9,21,27,86,46,2,22,ENG
5c74c0f5,39,24,20,14,5,19,40,21,37,8,29,21,60,26,1,22,ENG
5cbd1eb0,104,57,67,26,11,46,67,21,47,5,42,41,145,101,0,22,ENG
5cdddffa,10,7,3,5,2,1,8,7,5,0,5,1,11,1,0,22,ENG
5e105217,4,4,2,2,0,1,3,2,4,0,4,2,6,0,0,22,ENG
5e74d6c8,55,37,35,18,2,36,64,28,26,6,20,44,99,50,0,22,ENG
5eae500a,2,1,0,1,1,1,5,4,11,1,10,0,2,20,0,22,ENG
5ed9b537,16,10,9,6,1,7,10,3,13,9,4,16,32,37,1,22,ENG
5eebbfdf,5,2,1,2,2,2,3,1,0,0,0,0,5,0,0,22,ENG
5eecec3d,5,3,3,2,0,2,3,1,3,3,0,11,16,27,1,22,ENG
60344e4f,2,1,0,1,1,1,2,1,3,0,3,1,3,7,0,22,ENG
6250083a,33,19,14,18,1,15,31,16,19,7,12,12,45,10,1,22,ENG
62d7ef38,1,1,1,0,0,1,1,0,0,0,0,0,1,1,0,22,ENG
6434f10d,72,43,24,38,10,32,59,27,28,5,23,28,100,45,0,22,ENG
653ee42d,4,1,0,3,1,3,8,5,4,1,3,1,5,1,0,22,ENG
6613c819,66,32,27,33,6,28,65,37,34,13,21,52,118,98,1,22,ENG
6622454d,19,10,5,12,2,10,36,26,11,1,10,10,29,10,0,22,ENG
66b76d44,38,18,16,13,9,21,51,30,21,3,18,9,47,11,0,22,ENG
67ac5bb8,50,30,36,12,2,30,41,11,34,26,8,13,63,112,4,22,ENG
67ca8566,93,55,58,31,4,56,105,49,45,14,31,57,150,63,2,22,ENG
68c720b5,10,4,2,2,6,0,6,6,13,1,12,3,13,6,0,22,ENG
68dc0dac,36,17,14,15,7,11,39,28,23,2,21,12,48,28,0,22,ENG
6a713852,2,1,2,0,0,1,1,0,1,0,1,0,2,11,4,22,ENG
6aa3e78b,25,19,14,7,4,11,22,11,18,3,15,7,32,26,0,22,ENG
6adbc307,19,12,13,5,1,6,16,10,12,7,5,19,38,42,0,22,ENG
6afaebf2,28,16,1,12,15,6,20,14,21,6,15,11,39,20,0,22,ENG
6b47c5db,60,32,32,27,1,22,55,33,36,8,28,42,102,54,1,22,ENG
6b625ac2,1,1,1,0,0,1,1,0,0,0,0,0,1,27,1,22,ENG
6bd603db,1,1,1,0,0,0,2,2,0,0,0,1,2,1,0,22,ENG
6c17e046,16,7,6,7,3,9,16,7,11,1,10,5,21,11,0,22,ENG
6c203af0,76,49,35,37,4,21,37,16,33,3,30,50,126,49,0,22,ENG
6c6a3300,31,19,12,12,7,11,30,19,22,3,19,15,46,23,0,22,ENG
6ca5ec4b,40,19,23,12,5,21,52,31,39,3,36,20,60,25,2,22,ENG
6cc47ae1,0,0,0,0,0,0,0,0,0,0,0,0,0,0,0,22,ENG
6cdd8245,37,20,19,17,1,18,33,15,23,6,17,18,55,19,3,22,ENG
6d5701f2,12,10,12,0,0,10,13,3,13,9,4,11,23,38,1,22,ENG
6dfd8f05,34,22,18,14,2,16,29,13,24,6,18,17,51,42,0,22,ENG
6e7f1353,12,8,7,2,3,3,7,4,13,0,13,10,22,2,1,22,ENG
6f711f67,1,1,0,1,0,0,0,0,0,0,0,0,1,0,0,22,ENG
6f7d826d,59,39,30,24,5,21,72,51,30,7,23,34,93,28,1,22,ENG
71b47ab9,13,5,5,5,3,5,27,22,13,1,12,5,18,9,0,22,ENG
71ef519e,22,15,10,10,2,10,27,17,10,2,8,13,35,26,0,22,ENG
7314bba4,15,12,12,3,0,8,14,6,24,18,6,16,31,76,1,22,ENG
74b2cd7e,7,4,5,2,0,3,7,4,5,4,1,11,18,29,0,22,ENG
74e12f1e,20,6,6,11,3,7,20,13,17,4,13,17,37,29,1,22,ENG
758dd7f0,39,29,28,10,1,21,36,15,15,6,9,10,49,32,0,22,ENG
75a72a99,37,20,19,13,5,21,40,19,13,1,12,17,54,39,0,22,ENG
76eca7e2,0,0,0,0,0,0,0,0,0,0,0,1,1,0,1,22,ENG
774cf58b,64,44,49,15,0,37,55,18,39,19,20,28,92,96,1,22,ENG
77cf6852,37,16,25,11,1,27,36,9,16,10,6,25,62,56,0,22,ENG
77e39b04,28,15,9,13,6,3,19,16,17,1,16,12,40,1,1,22,ENG
77e84962,48,29,14,24,10,10,42,32,22,2,20,26,74,13,2,22,ENG
79300479,49,21,6,24,19,22,61,39,18,1,17,11,60,11,1,22,ENG
7956236f,1,1,1,0,0,1,3,2,0,0,0,0,1,6,1,22,ENG
79c0821a,51,31,14,26,11,17,35,18,19,4,15,7,58,9,1,22,ENG
79c84d1c,36,20,20,11,5,17,44,27,29,2,27,21,57,14,0,22,ENG
7a11550b,10,6,5,2,3,5,9,4,4,1,3,5,15,6,0,22,ENG
7a1f2c08,1,1,0,1,0,1,2,1,1,0,1,1,2,2,0,22,ENG
7a2e46a8,3,1,3,0,0,3,5,2,1,0,1,0,3,28,1,22,ENG
7aa8adfe,0,0,0,0,0,0,1,1,0,0,0,0,0,0,0,22,ENG
7aee4dd3,7,5,5,2,0,4,4,0,4,2,2,2,9,8,0,22,ENG
7b4de647,0,0,0,0,0,0,0,0,0,0,0,0,0,3,0,22,ENG
7b5ab7f2,3,0,1,0,2,1,2,1,2,0,2,0,3,0,0,22,ENG
7ba2eaa9,4,4,2,0,2,0,9,9,0,0,0,6,10,1,0,22,ENG
7ba6d84e,0,0,0,0,0,0,0,0,0,0,0,0,0,11,2,22,ENG
7c104bb7,32,14,10,13,9,10,28,18,19,1,18,10,42,4,0,22,ENG
7d2d3329,9,3,4,4,1,3,5,2,0,0,0,12,21,10,0,22,ENG
7e003182,3,1,0,3,0,1,1,0,0,0,0,0,3,0,0,22,ENG
7ed4921e,18,9,11,6,1,10,15,5,24,14,10,7,25,82,1,22,ENG
7f3b388c,46,25,17,23,6,24,70,46,33,10,23,39,85,25,1,22,ENG
7fcc71d8,18,11,10,5,3,4,17,13,8,1,7,10,28,1,0,22,ENG
7fec31a0,2,1,1,1,0,2,6,4,2,0,2,0,2,3,0,22,ENG
810e3c74,9,7,4,3,2,2,6,4,4,0,4,0,9,1,0,22,ENG
819aa8e7,4,2,0,3,1,0,13,13,11,1,10,2,6,5,0,22,ENG
819b3158,23,9,10,12,1,12,31,19,11,1,10,15,38,10,0,22,ENG
82518f62,44,23,18,22,4,21,38,17,25,6,19,9,53,13,0,22,ENG
82927de4,54,28,21,21,12,22,84,62,49,2,47,27,81,16,1,22,ENG
82c215a0,3,3,0,2,1,2,4,2,5,0,5,1,4,0,0,22,ENG
82e34b69,0,0,0,0,0,0,1,1,0,0,0,0,0,2,0,22,ENG
8397a50c,23,12,17,3,3,14,22,8,47,30,17,46,69,153,2,22,ENG
839c14e1,38,26,23,9,6,16,25,9,18,7,11,16,54,31,1,22,ENG
83d074ff,65,40,23,30,12,29,68,39,37,7,30,13,78,22,0,22,ENG
8449d35e,61,32,26,27,8,27,53,26,23,7,16,28,89,35,0,22,ENG
849c826a,4,2,2,2,0,2,8,6,4,2,2,0,4,2,0,22,ENG
84c5ceea,5,4,2,3,0,1,1,0,0,0,0,2,7,1,0,22,ENG
862a1c15,47,29,23,17,7,11,44,33,14,1,13,20,67,13,0,22,ENG
867239d3,13,9,5,7,1,6,28,22,11,0,11,13,26,16,0,22,ENG
86dd77d1,15,6,7,7,1,8,17,9,14,4,10,14,29,16,1,22,ENG
86e7deaf,32,21,19,12,1,11,22,11,54,31,23,44,76,100,0,22,ENG
87f12e30,0,0,0,0,0,0,0,0,0,0,0,0,0,0,0,22,ENG
892d5bb1,11,3,5,4,2,5,19,14,15,1,14,6,17,6,0,22,ENG
8996350d,34,21,19,14,1,17,46,29,17,8,9,19,53,43,1,22,ENG
89d10e53,16,10,11,4,1,10,24,14,8,5,3,14,30,11,1,22,ENG
89e4b358,32,15,25,6,1,16,30,14,39,29,10,28,60,132,3,22,ENG
8a3c1dc7,28,20,18,8,2,12,34,22,31,10,21,26,54,76,1,22,ENG
8a7ff278,44,26,30,11,3,30,57,27,24,11,13,32,76,107,1,22,ENG
8aec0537,28,15,15,11,2,12,33,21,34,8,26,18,46,23,0,22,ENG
8b04d6c1,78,45,31,38,9,38,85,47,61,13,48,48,126,54,0,22,ENG
8b788c01,0,0,0,0,0,0,1,1,1,0,1,0,0,1,0,22,ENG
8c12f884,3,2,2,1,0,2,3,1,7,0,7,3,6,1,0,22,ENG
8d03ca5a,27,16,19,7,1,13,25,12,11,7,4,8,35,12,1,22,ENG
8d3c902d,52,38,28,22,2,18,39,21,40,14,26,38,90,39,0,22,ENG
8d62d31a,0,0,0,0,0,0,0,0,2,1,1,0,0,7,0,22,ENG
8df7a2fb,26,12,16,7,3,12,19,7,28,22,6,24,50,94,1,22,ENG
8f62b6ee,1,1,1,0,0,1,2,1,0,0,0,1,2,24,3,22,ENG
903b6e8b,2,1,2,0,0,2,4,2,0,0,0,2,4,19,5,22,ENG
90f91999,106,64,35,55,16,54,104,50,53,6,47,35,141,34,0,22,ENG
914ab9a1,11,5,10,1,0,7,10,3,20,16,4,14,25,67,1,22,ENG
9228b07c,3,1,1,1,1,2,5,3,2,1,1,2,5,9,0,22,ENG
92b4758e,24,11,18,6,0,8,19,11,21,11,10,43,67,85,3,22,ENG
92e7e919,15,6,5,7,3,5,23,18,27,6,21,13,28,8,0,22,ENG
9319781b,33,16,15,15,3,21,28,7,16,8,8,22,55,55,0,22,ENG
9328b835,0,0,0,0,0,0,0,0,0,0,0,0,0,11,0,22,ENG
935e6b8f,36,20,9,25,2,17,44,27,25,1,24,23,59,14,0,22,ENG
939bc634,0,0,0,0,0,0,0,0,0,0,0,0,0,1,0,22,ENG
93cf32a8,1,0,0,1,0,0,0,0,2,1,1,2,3,8,0,22,ENG
93feac6e,1,0,0,1,0,0,3,3,8,2,6,2,3,8,0,22,ENG
953c30b0,22,11,6,14,2,10,20,10,7,3,4,10,32,19,0,22,ENG
96593e89,0,0,0,0,0,0,2,2,0,0,0,0,0,0,0,22,ENG
9674002f,41,16,10,17,14,10,34,24,18,1,17,13,54,12,0,22,ENG
97220da2,12,5,2,7,3,2,9,7,17,1,16,3,15,11,0,22,ENG
97333cf5,27,19,15,6,6,9,23,14,10,1,9,8,35,15,0,22,ENG
980522ec,13,6,4,5,4,8,17,9,9,1,8,9,22,14,0,22,ENG
984a5a64,57,33,28,21,8,26,38,12,29,8,21,37,94,53,1,22,ENG
989d5705,1,1,0,1,0,1,1,0,0,0,0,0,1,1,0,22,ENG
98ea5115,0,0,0,0,0,0,0,0,1,0,1,0,0,10,1,22,ENG
99813635,34,17,14,14,6,12,41,29,16,6,10,16,50,13,1,22,ENG
9a104dee,0,0,0,0,0,0,0,0,0,0,0,0,0,0,0,22,ENG
9a28eba4,8,3,6,0,2,3,7,4,4,1,3,2,10,1,0,22,ENG
9a71e978,10,6,5,5,0,7,12,5,6,0,6,6,16,8,0,22,ENG
9a9c05db,38,24,20,10,8,20,37,17,25,11,14,26,64,68,0,22,ENG
9ae9eaea,42,22,27,14,1,21,37,16,25,4,21,28,70,52,0,22,ENG
9b398aea,64,36,46,15,3,22,44,22,24,2,22,22,86,39,1,22,ENG
9c94165b,21,13,9,9,3,12,21,9,22,11,11,9,30,22,2,22,ENG
9dbb75ca,27,10,8,13,6,7,21,14,12,1,11,5,32,6,0,22,ENG
9deaf2c8,0,0,0,0,0,0,0,0,0,0,0,0,0,0,0,22,ENG
9e1035f8,2,2,0,1,1,0,3,3,2,0,2,0,2,1,0,22,ENG
9e525177,49,36,25,18,6,14,20,6,24,14,10,34,83,41,2,22,ENG
9f1938ab,53,23,21,27,5,21,54,33,17,1,16,19,72,12,2,22,ENG
9f333379,5,3,3,1,1,2,9,7,3,0,3,1,6,1,0,22,ENG
9f472354,9,5,2,4,3,1,1,0,4,0,4,0,9,2,0,22,ENG
9f7c837d,47,32,29,14,4,24,39,15,41,19,22,15,62,100,2,22,ENG
9f8e9423,28,19,21,6,1,10,22,12,18,9,9,18,46,82,1,22,ENG
9fbbcf39,40,27,28,11,1,19,33,14,41,21,20,58,98,158,2,22,ENG
a0666d3e,29,14,10,16,3,7,16,9,13,7,6,8,37,10,0,22,ENG
a1232f4e,5,4,4,0,1,3,4,1,4,2,2,3,8,11,0,22,ENG
a179d516,0,0,0,0,0,0,0,0,0,0,0,0,0,2,1,22,ENG
a1d5bd30,6,5,1,4,1,2,13,11,10,1,9,5,11,5,1,22,ENG
a2081c6b,0,0,0,0,0,0,0,0,1,0,1,0,0,0,0,22,ENG
a29b1131,3,2,2,1,0,1,10,9,3,0,3,1,4,8,0,22,ENG
a2b105e0,54,34,18,31,5,24,65,41,18,6,12,9,63,18,0,22,ENG
a3b03921,64,37,30,28,6,29,68,39,37,6,31,21,85,10,1,22,ENG
a3d94a58,62,39,39,21,2,22,34,12,46,21,25,33,95,74,1,22,ENG
a4ac4b8f,25,19,18,7,0,8,15,7,14,6,8,14,39,35,0,22,ENG
a53649b7,9,4,1,4,4,1,4,3,9,2,7,4,13,5,0,22,ENG
a65c844b,21,14,10,7,4,8,18,10,15,5,10,9,30,33,1,22,ENG
a712ca2b,10,8,5,5,0,4,11,7,14,13,1,7,17,44,0,22,ENG
a8a3d139,0,0,0,0,0,0,0,0,0,0,0,0,0,0,0,22,ENG
a8c0acb7,29,18,21,6,2,13,21,8,19,11,8,26,55,74,0,22,ENG
a8c19eb8,37,15,27,8,2,17,27,10,38,25,13,24,61,83,2,22,ENG
a8d4428b,26,14,15,7,4,14,39,25,29,2,27,11,37,18,2,22,ENG
aa54ec6f,5,3,1,3,1,3,6,3,5,4,1,3,8,10,0,22,ENG
aa849a12,57,37,22,22,13,31,76,45,35,1,34,21,78,19,0,22,ENG
aa8e289e,11,7,4,6,1,5,20,15,4,0,4,2,13,1,0,22,ENG
ab070c55,3,2,1,2,0,2,6,4,7,3,4,2,5,33,0,22,ENG
ab13a5aa,1,0,1,0,0,1,1,0,0,0,0,1,2,8,1,22,ENG
ab651565,22,14,9,9,4,7,30,23,21,2,19,8,30,16,0,22,ENG
ac05f970,23,17,5,9,9,7,18,11,19,1,18,3,26,13,0,22,ENG
ac0d576d,1,1,0,0,1,0,2,2,2,0,2,0,1,0,0,22,ENG
ac861941,15,9,6,8,1,7,14,7,37,32,5,27,42,142,1,22,ENG
ad1f61f3,10,4,4,5,1,4,7,3,2,1,1,10,20,10,0,22,ENG
ae4fc6a4,10,6,5,2,3,6,11,5,4,1,3,5,15,1,0,22,ENG
ae59b359,19,13,10,8,1,8,17,9,13,1,12,14,33,18,0,22,ENG
aed3a70f,17,13,2,7,8,2,15,13,25,3,22,12,29,27,0,22,ENG
afed6722,54,28,30,18,6,27,45,18,23,9,14,47,101,50,1,22,ENG
b0b4fd3e,18,17,4,10,4,5,13,8,11,1,10,8,26,7,0,22,ENG
b217ef29,47,34,23,19,5,20,31,11,26,14,12,44,91,93,1,22,ENG
b28bbd58,31,17,15,6,10,15,40,25,28,2,26,14,45,6,1,22,ENG
b2bc3b1f,40,20,14,15,11,10,31,21,28,0,28,5,45,5,0,22,ENG
b2c66859,0,0,0,0,0,0,0,0,0,0,0,0,0,0,0,22,ENG
b2d31e83,38,23,24,12,2,13,26,13,36,24,12,44,82,152,0,22,ENG
b2f9c73e,7,1,2,5,0,3,5,2,3,0,3,1,8,2,1,22,ENG
b318a643,6,1,1,2,3,4,14,10,5,0,5,0,6,10,0,22,ENG
b391383a,0,0,0,0,0,0,0,0,1,0,1,1,1,1,0,22,ENG
b3af9be1,35,17,19,13,3,21,32,11,22,3,19,24,59,64,2,22,ENG
b400bde0,23,10,3,11,9,10,23,13,12,0,12,12,35,3,0,22,ENG
b561db50,29,14,6,16,7,6,30,24,31,5,26,13,42,26,0,22,ENG
b579e83d,11,8,7,4,0,3,8,5,3,1,2,5,16,5,0,22,ENG
b5bf1770,18,15,11,7,0,10,18,8,18,13,5,13,31,50,1,22,ENG
b66315ae,18,12,2,4,12,6,26,20,18,0,18,15,33,8,0,22,ENG
b827d5b3,31,19,16,9,6,10,47,37,15,3,12,14,45,20,0,22,ENG
b853e0ad,63,27,32,24,7,22,79,57,38,11,27,32,95,24,0,22,ENG
b8d22478,2,2,0,2,0,1,1,0,2,0,2,3,5,3,0,22,ENG
b9403c99,0,0,0,0,0,0,0,0,1,0,1,0,0,0,0,22,ENG
b9e1436c,3,0,1,1,1,0,6,6,8,1,7,4,7,2,0,22,ENG
b9fbae28,59,31,20,27,12,25,40,15,37,2,35,31,90,8,0,22,ENG
bb5fbd2b,30,17,11,9,10,7,22,15,22,3,19,17,47,25,0,22,ENG
bba30585,53,31,32,19,2,33,47,14,35,17,18,40,93,77,2,22,ENG
bc7dc64d,40,21,12,17,11,13,39,26,28,2,26,22,62,23,0,22,ENG
bcfb0142,23,16,17,6,0,7,12,5,36,30,6,27,50,139,2,22,ENG
bd6351cd,83,54,33,35,15,46,91,45,25,3,22,59,142,45,1,22,ENG
be927d03,18,6,9,6,3,11,16,5,10,4,6,13,31,25,1,22,ENG
beb391dd,16,9,7,5,4,7,15,8,13,4,9,10,26,14,0,22,ENG
bf8fad51,3,3,2,0,1,3,4,1,8,5,3,6,9,13,0,22,ENG
bfae110f,0,0,0,0,0,0,0,0,0,0,0,0,0,0,0,22,ENG
bfdb33aa,12,7,4,3,5,5,19,14,10,1,9,9,21,10,0,22,ENG
c067631c,2,2,2,0,0,0,1,1,2,1,1,4,6,6,0,22,ENG
c14bc029,20,9,11,9,0,9,16,7,14,3,11,7,27,10,1,22,ENG
c17bfb65,72,38,30,33,9,26,61,35,46,11,35,34,106,50,2,22,ENG
c1949191,4,1,3,1,0,3,8,5,3,2,1,1,5,20,0,22,ENG
c2731c10,69,38,35,20,14,21,69,48,58,9,49,29,98,26,0,22,ENG
c393a6c4,8,6,5,3,0,5,11,6,8,8,0,5,13,13,0,22,ENG
c3e39f12,1,0,1,0,0,0,1,1,0,0,0,0,1,23,2,22,ENG
c40b6180,26,8,17,7,2,13,20,7,25,17,8,17,43,66,2,22,ENG
c4486bac,22,18,8,11,3,7,24,17,17,0,17,6,28,6,0,22,ENG
c47541e0,3,3,0,1,2,1,2,1,0,0,0,0,3,1,0,22,ENG
c4e87b8b,17,9,3,9,5,6,19,13,16,5,11,6,23,13,0,22,ENG
c596fcb0,9,8,1,5,3,1,4,3,7,2,5,3,12,10,0,22,ENG
c5b7c315,46,25,32,13,1,28,45,17,33,28,5,62,108,128,2,22,ENG
c5bdb6e3,1,0,0,0,1,0,1,1,1,0,1,0,1,0,0,22,ENG
c691bfe2,33,20,7,14,12,8,26,18,30,1,29,8,41,15,0,22,ENG
c8aa95da,16,11,11,3,2,8,16,8,27,18,9,32,48,95,2,22,ENG
c92e1a31,10,7,2,5,3,3,14,11,19,0,19,4,14,10,0,22,ENG
c931d9f9,26,15,8,10,8,10,23,13,20,1,19,8,34,13,0,22,ENG
c951a6df,28,14,11,14,3,12,29,17,17,8,9,14,42,24,0,22,ENG
ca22ccb0,2,1,1,1,0,1,1,0,0,0,0,0,2,0,0,22,ENG
ca45605e,15,10,2,8,5,2,19,17,7,0,7,2,17,8,0,22,ENG
cc2d7ad5,45,26,31,11,3,26,44,18,42,20,22,58,103,95,2,22,ENG
cc3b8e78,4,3,0,4,0,1,1,0,0,0,0,1,5,1,0,22,ENG
cc700722,74,44,28,39,7,34,105,71,40,9,31,23,97,39,1,22,ENG
cc70a1d5,0,0,0,0,0,0,0,0,0,0,0,0,0,1,0,22,ENG
cd1acf9d,40,23,19,13,8,27,60,33,22,4,18,43,83,40,0,22,ENG
cd4256d3,1,0,0,0,1,0,8,8,1,0,1,1,2,1,0,22,ENG
cde3309f,0,0,0,0,0,0,0,0,0,0,0,0,0,5,1,22,ENG
ce4246f5,11,6,8,3,0,4,7,3,31,26,5,34,45,132,0,22,ENG
ce5143da,14,7,2,8,4,3,10,7,18,2,16,5,19,18,0,22,ENG
cea4ee8f,21,10,13,7,1,5,21,16,29,7,22,12,33,26,0,22,ENG
cee31595,33,23,13,19,1,16,44,28,23,9,14,30,63,27,0,22,ENG
d0042ab9,35,18,26,9,0,11,26,15,25,17,8,26,61,95,1,22,ENG
d04b94db,58,39,39,17,2,25,49,24,23,4,19,21,79,64,1,22,ENG
d0706b27,35,17,24,10,1,15,16,1,34,26,8,30,65,127,0,22,ENG
d0b3ceb9,0,0,0,0,0,0,3,3,0,0,0,0,0,9,4,22,ENG
d0f72bf1,50,26,38,10,2,24,37,13,36,21,15,45,95,113,3,22,ENG
d102b8a2,5,4,3,2,0,3,3,0,3,3,0,4,9,7,0,22,ENG
d2424d1b,8,3,2,6,0,2,5,3,7,0,7,4,12,14,1,22,ENG
d313e8ff,1,1,1,0,0,1,1,0,0,0,0,0,1,0,0,22,ENG
d3ce0e89,0,0,0,0,0,0,0,0,0,0,0,0,0,1,0,22,ENG
d557d734,18,12,5,11,2,8,14,6,11,2,9,13,31,20,0,22,ENG
d56543a0,10,3,5,3,2,5,13,8,11,1,10,11,21,11,0,22,ENG
d5dd5f1f,11,5,6,4,1,3,10,7,12,1,11,0,11,4,0,22,ENG
d7553721,8,4,4,2,2,4,10,6,6,1,5,1,9,0,1,22,ENG
d79a8c87,13,9,11,1,1,5,6,1,23,18,5,10,23,42,1,22,ENG
d86a1f3e,0,0,0,0,0,0,0,0,0,0,0,0,0,1,0,22,ENG
d8931174,34,21,22,8,4,19,31,12,36,29,7,32,66,101,3,22,ENG
d93c2511,65,33,32,24,9,30,61,31,45,10,35,31,96,60,1,22,ENG
d9565625,55,41,35,12,8,31,57,26,24,13,11,29,84,59,0,22,ENG
da052c14,47,30,20,20,7,17,31,14,33,3,30,15,62,15,0,22,ENG
da7b447d,41,22,25,14,2,19,28,9,24,16,8,30,71,54,3,22,ENG
da8b19e2,0,0,0,0,0,0,0,0,0,0,0,0,0,3,0,22,ENG
dad4b285,74,48,47,21,6,21,53,32,46,16,30,45,119,89,0,22,ENG
dbf053da,14,8,9,4,1,8,22,14,19,0,19,15,29,5,3,22,ENG
dc64b8b3,41,23,27,13,1,23,33,10,29,18,11,43,84,72,2,22,ENG
dc6c2f02,9,6,4,5,0,4,5,1,5,0,5,2,11,1,0,22,ENG
dc6f5bdd,21,11,13,7,1,7,10,3,20,11,9,5,26,52,0,22,ENG
dc7f8a28,2,1,1,1,0,0,2,2,3,0,3,1,3,0,0,22,ENG
dd323728,0,0,0,0,0,0,0,0,0,0,0,0,0,0,0,22,ENG
dd897ee7,0,0,0,0,0,0,0,0,0,0,0,0,0,0,0,22,ENG
de0f152c,24,13,11,10,3,12,29,17,18,6,12,18,42,45,0,22,ENG
de112b84,49,26,34,11,4,26,41,15,20,2,18,23,72,17,0,22,ENG
de5b5570,32,19,18,14,0,12,34,22,14,4,10,12,44,17,1,22,ENG
dea698d9,8,6,1,5,2,2,6,4,8,0,8,2,10,29,0,22,ENG
def899bd,5,5,3,1,1,2,3,1,4,4,0,3,8,8,0,22,ENG
df04eb4b,5,3,1,1,3,2,3,1,2,0,2,2,7,0,0,22,ENG
df0a4c90,109,60,42,58,9,52,101,49,48,9,39,64,173,58,1,22,ENG
df10e27c,41,21,16,21,4,14,52,38,21,4,17,17,58,29,0,22,ENG
df3cda47,19,13,7,10,2,5,23,18,14,0,14,13,32,3,0,22,ENG
df8b52a5,72,47,50,16,6,36,67,31,25,2,23,22,94,92,1,22,ENG
e0243d23,1,0,0,1,0,1,2,1,0,0,0,0,1,0,0,22,ENG
e06683ca,16,10,11,5,0,11,16,5,21,14,7,31,47,109,0,22,ENG
e082af5b,0,0,0,0,0,0,0,0,0,0,0,0,0,11,0,22,ENG
e09f279b,33,21,5,20,8,12,38,26,16,2,14,14,47,44,1,22,ENG
e0bc6fdc,0,0,0,0,0,0,0,0,0,0,0,0,0,0,0,22,ENG
e0d1510a,4,2,3,1,0,1,3,2,0,0,0,1,5,4,0,22,ENG
e1df6989,41,21,18,20,3,16,38,22,28,6,22,42,83,20,1,22,ENG
e28868f3,25,15,13,11,1,11,20,9,14,3,11,13,38,11,0,22,ENG
e342ad68,17,8,5,9,3,6,19,13,7,1,6,6,23,5,0,22,ENG
e34fc66d,30,23,21,9,0,16,27,11,29,19,10,37,67,125,3,22,ENG
e3a5814e,8,4,5,3,0,2,4,2,2,0,2,4,12,4,0,22,ENG
e46012d4,32,16,4,15,13,12,37,25,32,2,30,6,38,16,0,22,ENG
e514ab62,75,44,54,19,2,48,82,34,31,13,18,48,123,74,1,22,ENG
e541326e,51,35,37,12,2,25,38,13,30,11,19,44,95,154,1,22,ENG
e58a03c6,1,0,0,1,0,0,1,1,0,0,0,1,2,0,0,22,ENG
e5d01ecf,35,22,23,10,2,21,37,16,24,8,16,37,72,51,0,22,ENG
e61b8aee,32,18,16,12,4,16,41,25,21,6,15,21,53,31,0,22,ENG
e717705a,0,0,0,0,0,0,0,0,0,0,0,0,0,0,0,22,ENG
e73c9bb2,48,27,35,9,4,27,43,16,17,4,13,26,74,45,0,22,ENG
e7aa9d7c,3,2,0,2,1,0,8,8,2,0,2,1,4,1,0,22,ENG
e7ca0439,8,3,6,2,0,6,8,2,8,8,0,4,12,18,0,22,ENG
e7ee38c3,0,0,0,0,0,0,0,0,0,0,0,0,0,0,0,22,ENG
e814e1cf,2,1,0,1,1,1,2,1,0,0,0,0,2,0,0,22,ENG
e8832875,20,14,7,8,5,6,23,17,23,3,20,15,35,17,0,22,ENG
e9254eec,44,25,28,14,2,18,35,17,56,45,11,56,100,176,2,22,ENG
e97fd090,29,10,16,11,2,10,19,9,15,6,9,11,40,17,0,22,ENG
e9971f2d,14,8,7,6,1,9,19,10,13,5,8,9,23,31,0,22,ENG
ea6bc03a,21,13,9,10,2,9,34,25,26,10,16,20,41,44,0,22,ENG
eaeca114,16,9,7,8,1,6,8,2,7,5,2,8,24,23,0,22,ENG
eb7822d7,31,18,19,11,1,15,31,16,21,6,15,31,62,21,3,22,ENG
ed1e53f3,16,8,10,4,2,7,17,10,9,0,9,11,27,5,0,22,ENG
ee38d9c5,40,20,8,24,8,14,46,32,18,3,15,11,51,12,0,22,ENG
eeb6551f,2,1,1,1,0,1,1,0,1,1,0,0,2,0,0,22,ENG
efb9215a,8,6,6,1,1,3,4,1,3,2,1,3,11,8,0,22,ENG
f0caab96,11,7,10,1,0,7,9,2,6,3,3,8,19,15,0,22,ENG
f127d782,0,0,0,0,0,0,0,0,0,0,0,0,0,5,2,22,ENG
f13d02a6,0,0,0,0,0,0,0,0,1,0,1,0,0,0,0,22,ENG
f1e94cd6,13,9,5,7,1,6,17,11,13,0,13,6,19,9,0,22,ENG
f230bc30,42,25,18,17,7,23,42,19,25,2,23,10,52,22,1,22,ENG
f23f9d20,1,1,1,0,0,1,4,3,0,0,0,0,1,10,4,22,ENG
f25b010f,3,0,3,0,0,2,5,3,10,10,0,4,7,28,0,22,ENG
f25c8e3a,46,23,17,19,10,26,42,16,33,2,31,14,60,8,0,22,ENG
f2bf1b0f,13,6,5,5,3,2,16,14,18,2,16,8,21,18,0,22,ENG
f315ca93,27,12,12,8,7,12,16,4,6,2,4,10,37,22,2,22,ENG
f3354c07,8,5,0,5,3,4,7,3,3,0,3,2,10,1,0,22,ENG
f4290206,41,29,20,12,9,17,36,19,29,5,24,43,84,53,0,22,ENG
f4d296e4,61,39,34,23,4,30,50,20,35,23,12,33,94,60,2,22,ENG
f4e433d4,36,25,14,17,5,15,25,10,13,3,10,21,57,23,0,22,ENG
f5044e54,58,36,23,29,6,25,92,67,37,11,26,25,83,23,0,22,ENG
f5a00fa4,74,39,34,27,13,30,106,76,48,8,40,34,108,36,2,22,ENG
f5deef4c,16,11,9,7,0,9,14,5,26,17,9,25,41,96,0,22,ENG
f63d8a4b,15,13,8,6,1,6,17,11,2,0,2,3,18,2,0,22,ENG
f72293fc,16,6,7,7,2,5,20,15,11,2,9,12,28,22,0,22,ENG
f7b1d4e0,17,10,8,6,3,9,15,6,2,0,2,3,20,16,0,22,ENG
f833a830,3,2,1,1,1,2,8,6,2,0,2,1,4,2,0,22,ENG
f8fcd2a5,24,14,14,8,2,14,22,8,17,13,4,20,44,59,0,22,ENG
f9682888,0,0,0,0,0,0,0,0,0,0,0,0,0,0,0,22,ENG
f99b71de,21,13,11,9,1,8,16,8,6,1,5,9,30,13,0,22,ENG
fa031b34,40,23,18,15,7,15,31,16,42,4,38,12,52,34,0,22,ENG
fb614c44,22,13,11,8,3,7,15,8,16,4,12,17,39,34,0,22,ENG
fc027d02,50,31,33,13,4,28,65,37,35,14,21,40,90,55,0,22,ENG
fc15fb84,78,49,27,38,13,33,73,40,64,11,53,35,113,31,1,22,ENG
fce2302c,18,14,11,7,0,10,11,1,23,5,18,15,33,54,0,22,ENG
fdf3cb77,45,25,24,14,7,18,36,18,31,9,22,22,67,64,1,22,ENG
fed7cb61,17,8,5,7,5,4,14,10,28,1,27,4,21,32,1,22,ENG
ff527768,8,2,7,1,0,5,11,6,4,1,3,4,12,2,1,22,ENG
ffa90327,5,5,3,2,0,3,8,5,9,0,9,1,6,2,0,22,ENG
0076ab7f,1,0,1,0,0,1,3,2,3,3,0,0,1,11,0,22,EL
01226327,0,0,0,0,0,0,2,2,4,2,2,1,1,5,0,22,EL
0127419a,4,2,1,1,2,3,8,5,2,0,2,3,7,1,0,22,EL
01ccefab,0,0,0,0,0,0,0,0,0,0,0,1,1,0,0,22,EL
01da7812,5,3,1,3,1,3,6,3,4,1,3,0,5,0,0,22,EL
02caf6e0,6,2,2,3,1,5,9,4,4,0,4,2,8,3,1,22,EL
0331786b,0,0,0,0,0,0,0,0,0,0,0,0,0,2,0,22,EL
0362c29e,2,1,2,0,0,2,4,2,1,1,0,7,9,11,0,22,EL
03b6afa9,2,1,0,1,1,1,5,4,3,1,2,12,14,1,0,22,EL
03f946ed,2,0,0,2,0,1,2,1,1,0,1,0,2,2,0,22,EL
048a1cbc,2,2,1,1,0,2,2,0,0,0,0,1,3,0,0,22,EL
04e17fd5,4,2,1,2,1,2,2,0,1,0,1,1,5,1,0,22,EL
056269d7,9,3,2,0,7,2,3,1,2,0,2,0,9,2,0,22,EL
05bffdb1,1,0,1,0,0,1,1,0,0,0,0,1,2,6,0,22,EL
05d548d8,6,4,0,6,0,4,6,2,7,3,4,2,8,7,1,22,EL
0683f364,5,5,2,1,2,4,6,2,4,1,3,6,11,9,0,22,EL
068f4dec,2,2,1,1,0,2,5,3,2,1,1,0,2,1,1,22,EL
06df8256,8,4,3,5,0,5,7,2,6,3,3,12,20,28,0,22,EL
072e68ed,0,0,0,0,0,0,0,0,0,0,0,0,0,0,0,22,EL
0743d0ec,0,0,0,0,0,0,0,0,0,0,0,0,0,3,0,22,EL
080440a4,20,14,11,8,1,8,16,8,8,5,3,11,31,31,0,22,EL
08c982a0,6,4,5,1,0,5,10,5,5,0,5,1,7,10,0,22,EL
0a084b35,6,5,2,3,1,4,13,9,2,1,1,0,6,5,0,22,EL
0a215326,3,1,2,1,0,2,3,1,4,2,2,6,9,6,0,22,EL
0a89e877,12,9,8,3,1,5,7,2,2,0,2,9,21,3,0,22,EL
0a98ecc2,0,0,0,0,0,0,0,0,0,0,0,0,0,0,0,22,EL
0b243559,2,1,2,0,0,1,2,1,0,0,0,3,5,2,0,22,EL
0b5a292a,6,4,2,3,1,4,14,10,6,4,2,1,7,9,0,22,EL
0c2ac3cb,5,2,2,3,0,2,5,3,3,0,3,2,7,2,0,22,EL
0c5c94d0,2,2,2,0,0,1,3,2,3,2,1,0,2,4,0,22,EL
0c7a48f8,4,2,2,2,0,2,3,1,5,4,1,8,12,9,0,22,EL
0cadc46d,0,0,0,0,0,0,2,2,1,0,1,1,1,1,0,22,EL
0cb29e91,1,1,0,1,0,0,2,2,0,0,0,0,1,1,0,22,EL
0cc07deb,0,0,0,0,0,0,0,0,0,0,0,0,0,0,0,22,EL
0ceb43f6,5,3,3,2,0,3,13,10,4,1,3,7,12,12,0,22,EL
0d9b2d31,12,6,2,7,3,4,10,6,13,2,11,4,16,1,0,22,EL
0da6a13e,4,1,1,1,2,3,6,3,4,0,4,0,4,2,0,22,EL
0de73fa4,1,1,1,0,0,0,1,1,1,0,1,3,4,0,0,22,EL
0df2b165,22,10,13,7,2,13,28,15,15,2,13,24,46,29,0,22,EL
0eb83e1a,7,4,1,5,1,3,5,2,2,1,1,4,11,3,0,22,EL
0f888175,3,2,1,1,1,1,4,3,2,0,2,1,4,1,0,22,EL
10072610,0,0,0,0,0,0,1,1,0,0,0,0,0,0,0,22,EL
10549b49,0,0,0,0,0,0,0,0,0,0,0,1,1,0,0,22,EL
10b26721,0,0,0,0,0,0,0,0,0,0,0,0,0,0,0,22,EL
10fe831e,2,0,1,1,0,2,3,1,5,2,3,2,4,12,0,22,EL
1124ac8a,5,1,5,0,0,4,5,1,0,0,0,1,6,4,0,22,EL
116c35df,0,0,0,0,0,0,0,0,1,0,1,0,0,0,0,22,EL
118b60ce,0,0,0,0,0,0,0,0,0,0,0,0,0,0,0,22,EL
121101a4,2,1,1,1,0,0,0,0,2,2,0,1,3,4,0,22,EL
1295b5e3,15,11,6,9,0,10,17,7,6,2,4,15,30,5,0,22,EL
12c35abe,10,3,6,3,1,5,10,5,4,1,3,1,11,4,0,22,EL
1339039e,6,3,2,0,4,4,8,4,5,0,5,1,7,2,0,22,EL
133faa84,13,8,11,2,0,7,12,5,14,5,9,20,33,39,0,22,EL
13c8e5f6,2,1,1,1,0,1,5,4,3,0,3,3,5,1,0,22,EL
13ea2544,14,11,5,9,0,4,13,9,9,3,6,5,19,6,0,22,EL
1443ca7d,1,0,1,0,0,1,3,2,1,0,1,3,4,0,0,22,EL
149c5f5d,3,2,1,2,0,3,4,1,1,0,1,1,4,4,0,22,EL
14e8fe86,2,2,1,1,0,1,3,2,1,1,0,2,4,4,0,22,EL
15944afd,6,4,1,4,1,3,7,4,1,0,1,5,11,3,0,22,EL
15b287da,19,13,11,4,4,10,30,20,12,1,11,6,25,1,0,22,EL
15d0c248,10,7,6,3,1,7,7,0,15,13,2,5,15,22,0,22,EL
16380240,2,2,0,1,1,1,3,2,0,0,0,2,4,0,0,22,EL
169f5976,0,0,0,0,0,0,2,2,2,1,1,0,0,1,0,22,EL
16e9d0ea,7,6,5,0,2,3,5,2,3,1,2,12,19,11,0,22,EL
172bab0a,3,2,1,1,1,0,1,1,4,0,4,2,5,0,0,22,EL
173eb3cd,8,5,6,1,1,2,8,6,4,0,4,11,19,6,0,22,EL
1774c547,0,0,0,0,0,0,0,0,0,0,0,0,0,0,0,22,EL
182a8b9d,0,0,0,0,0,0,2,2,0,0,0,0,0,1,0,22,EL
1880614f,3,2,0,2,1,1,3,2,1,0,1,1,4,0,0,22,EL
1900032e,3,3,1,2,0,2,8,6,1,1,0,1,4,9,0,22,EL
19053e31,6,5,1,3,2,2,8,6,3,1,2,3,9,2,0,22,EL
1944818c,16,5,9,3,4,10,13,3,7,0,7,6,22,8,1,22,EL
1971591f,1,1,1,0,0,0,4,4,4,0,4,1,2,1,0,22,EL
197640fd,9,6,4,4,1,3,5,2,5,0,5,3,12,10,0,22,EL
19a967ab,17,10,12,4,1,9,15,6,11,0,11,15,32,12,1,22,EL
19cae58d,6,2,0,5,1,2,7,5,4,1,3,2,8,1,0,22,EL
1a4ef233,9,6,4,5,0,4,4,0,8,3,5,3,12,9,0,22,EL
1b280c66,2,1,1,0,1,0,1,1,1,0,1,1,3,1,0,22,EL
1bacc518,5,4,0,4,1,1,2,1,2,0,2,4,9,0,0,22,EL
1bda5842,4,2,3,1,0,2,5,3,5,2,3,2,6,0,0,22,EL
1c07b06e,5,3,1,4,0,3,6,3,3,1,2,6,11,6,0,22,EL
1c7012b8,24,12,9,14,1,12,20,8,20,7,13,22,46,14,1,22,EL
1c78737d,0,0,0,0,0,0,0,0,0,0,0,0,0,0,0,22,EL
1d2d5cc8,0,0,0,0,0,0,0,0,0,0,0,0,0,0,0,22,EL
1d54e8f8,5,1,3,2,0,0,6,6,2,0,2,3,8,1,0,22,EL
1dff86ec,2,1,0,2,0,1,1,0,2,0,2,0,2,2,0,22,EL
1e8dbb59,7,5,3,4,0,1,1,0,4,2,2,5,12,12,0,22,EL
1e9aa637,1,0,0,1,0,0,1,1,0,0,0,1,2,1,0,22,EL
1ec7e1c5,5,1,4,1,0,4,5,1,3,2,1,5,10,12,0,22,EL
1eecc0c6,8,6,4,3,1,1,10,9,2,0,2,5,13,9,0,22,EL
1f1229a9,1,1,0,1,0,0,2,2,1,0,1,1,2,1,0,22,EL
1f2d714c,2,1,1,0,1,1,4,3,0,0,0,1,3,1,0,22,EL
1f3afdcb,7,3,5,2,0,4,7,3,3,2,1,1,8,9,0,22,EL
1f9328da,3,2,1,2,0,2,3,1,1,0,1,3,6,4,0,22,EL
1fd1df9c,10,6,7,3,0,7,9,2,3,0,3,5,15,11,0,22,EL
20030c06,10,3,9,1,0,3,9,6,6,4,2,5,15,33,0,22,EL
200e89e1,0,0,0,0,0,0,0,0,0,0,0,0,0,1,0,22,EL
20b9f052,0,0,0,0,0,0,0,0,0,0,0,1,1,4,0,22,EL
20dbf9e0,1,1,0,1,0,0,0,0,0,0,0,0,1,2,0,22,EL
20de219a,0,0,0,0,0,0,0,0,0,0,0,0,0,1,0,22,EL
211589b8,0,0,0,0,0,0,0,0,0,0,0,0,0,0,0,22,EL
21164a21,7,3,4,3,0,3,7,4,7,3,4,5,12,8,0,22,EL
21166ff4,11,5,5,5,1,5,8,3,6,4,2,7,18,19,0,22,EL
222dfffb,28,17,10,14,4,13,21,8,8,0,8,11,39,2,0,22,EL
22798128,6,4,4,2,0,4,8,4,11,1,10,6,12,1,0,22,EL
228b0d9d,19,11,7,10,2,14,20,6,3,3,0,3,22,17,0,22,EL
230a2fac,20,10,9,9,2,8,14,6,9,3,6,3,23,15,2,22,EL
230f0471,6,4,2,4,0,5,9,4,3,0,3,0,6,0,1,22,EL
24051310,9,4,5,3,1,3,8,5,1,0,1,6,15,9,0,22,EL
240c8ab6,1,0,0,1,0,0,0,0,0,0,0,0,1,0,0,22,EL
24228180,9,7,3,4,2,2,8,6,1,1,0,1,10,4,0,22,EL
244a31b9,1,1,0,1,0,1,1,0,0,0,0,0,1,2,0,22,EL
24d9435b,3,2,0,2,1,2,5,3,4,2,2,1,4,3,0,22,EL
2506009f,5,1,1,4,0,3,8,5,3,1,2,6,11,12,0,22,EL
25146df0,2,1,0,2,0,0,0,0,6,3,3,3,5,11,0,22,EL
258aff54,0,0,0,0,0,0,4,4,1,0,1,2,2,7,0,22,EL
25b74470,13,9,10,3,0,7,8,1,2,2,0,0,13,0,0,22,EL
25e6f8cb,20,11,12,7,1,13,14,1,10,0,10,8,28,4,0,22,EL
25ef5b47,5,5,2,2,1,1,8,7,8,0,8,7,12,1,1,22,EL
262e5a82,4,1,0,3,1,1,3,2,0,0,0,2,6,0,0,22,EL
264b6d64,0,0,0,0,0,0,0,0,0,0,0,0,0,0,0,22,EL
2690dffa,3,1,3,0,0,3,3,0,0,0,0,3,6,3,0,22,EL
26f6dca8,14,9,5,4,5,11,21,10,4,0,4,5,19,0,0,22,EL
270c700c,0,0,0,0,0,0,0,0,0,0,0,0,0,0,0,22,EL
27e6fbbc,0,0,0,0,0,0,0,0,0,0,0,0,0,0,0,22,EL
27ff9bdb,2,1,0,1,1,1,2,1,1,0,1,0,2,0,0,22,EL
284f2ce6,4,3,2,2,0,1,1,0,6,0,6,2,6,8,0,22,EL
28b1f3ce,8,5,0,6,2,3,9,6,6,0,6,3,11,3,0,22,EL
28eaa0f3,6,3,0,5,1,1,3,2,7,4,3,19,25,15,1,22,EL
28eea0fc,1,0,0,1,0,1,4,3,2,0,2,3,4,0,0,22,EL
29d8ad3f,3,0,1,2,0,3,6,3,2,2,0,9,12,19,1,22,EL
29fbdc88,8,4,3,5,0,3,9,6,7,0,7,2,10,1,0,22,EL
2a0c8ba4,6,4,1,4,1,4,8,4,4,1,3,1,7,2,0,22,EL
2a1beb34,8,6,6,2,0,4,9,5,6,2,4,12,20,11,0,22,EL
2a70dcc9,0,0,0,0,0,0,0,0,1,0,1,0,0,0,0,22,EL
2ab7149e,5,3,4,0,1,3,4,1,2,2,0,2,7,8,1,22,EL
2b09d998,4,3,1,3,0,1,2,1,8,2,6,6,10,1,0,22,EL
2b1c4abd,1,1,0,1,0,0,1,1,2,0,2,3,4,1,0,22,EL
2ba38347,0,0,0,0,0,0,0,0,0,0,0,0,0,2,0,22,EL
2bed3eab,9,6,6,3,0,5,8,3,3,2,1,11,20,10,0,22,EL
2bef2bca,3,2,2,1,0,3,3,0,6,3,3,3,6,2,0,22,EL
2c320058,1,0,0,0,1,0,0,0,1,0,1,0,1,0,0,22,EL
2c56a792,3,1,0,0,3,1,3,2,6,1,5,1,4,1,1,22,EL
2c5f04ba,2,1,0,2,0,0,4,4,3,0,3,1,3,0,0,22,EL
2cb77ec6,6,1,5,1,0,3,3,0,2,2,0,4,10,7,0,22,EL
2ce71308,3,1,2,1,0,1,5,4,7,0,7,2,5,2,0,22,EL
2d54d501,0,0,0,0,0,0,0,0,0,0,0,0,0,1,0,22,EL
2d6e535f,4,1,1,3,0,1,2,1,1,1,0,4,8,6,0,22,EL
2db2fd7b,5,1,3,2,0,3,3,0,0,0,0,1,6,8,0,22,EL
2dce876a,0,0,0,0,0,0,0,0,0,0,0,0,0,0,0,22,EL
2de6641f,0,0,0,0,0,0,1,1,0,0,0,0,0,0,0,22,EL
2f3452eb,9,4,4,4,1,5,8,3,1,0,1,9,18,14,0,22,EL
2f557579,3,2,1,0,2,1,4,3,4,0,4,2,5,0,0,22,EL
2f965a72,1,1,1,0,0,1,1,0,0,0,0,0,1,6,0,22,EL
2fabebc0,0,0,0,0,0,0,0,0,0,0,0,0,0,0,1,22,EL
2ff76adc,12,6,8,4,0,8,13,5,4,0,4,6,18,3,0,22,EL
2ffa6348,3,2,3,0,0,2,4,2,1,0,1,6,9,8,1,22,EL
30941e96,8,5,6,2,0,5,8,3,3,1,2,3,11,5,0,22,EL
30af8b93,19,18,8,10,1,8,13,5,2,2,0,6,25,5,0,22,EL
30e03a25,4,3,4,0,0,1,2,1,5,5,0,4,8,15,0,22,EL
313d5ee5,13,5,6,4,3,5,20,15,5,0,5,4,17,3,0,22,EL
316de854,22,11,10,6,6,12,23,11,13,0,13,4,26,8,0,22,EL
31f5b89b,2,1,0,2,0,0,3,3,2,0,2,5,7,3,0,22,EL
32314605,9,6,4,5,0,8,20,12,5,1,4,6,15,3,0,22,EL
328f7d51,20,12,10,8,2,6,14,8,12,1,11,12,32,12,0,22,EL
32c0491f,8,6,3,5,0,3,5,2,2,0,2,4,12,4,0,22,EL
32fb87b4,7,6,2,3,2,3,6,3,7,2,5,0,7,2,0,22,EL
33182cb8,7,5,2,3,2,2,8,6,1,0,1,3,10,8,0,22,EL
332695f4,0,0,0,0,0,0,0,0,0,0,0,0,0,1,0,22,EL
33508c78,0,0,0,0,0,0,0,0,0,0,0,1,1,0,0,22,EL
33591ff0,6,2,2,1,3,0,2,2,1,0,1,2,8,1,0,22,EL
3376a776,0,0,0,0,0,0,0,0,0,0,0,0,0,1,0,22,EL
339fe0e8,0,0,0,0,0,0,0,0,0,0,0,0,0,1,1,22,EL
33a6a650,8,7,7,1,0,4,7,3,11,7,4,16,24,20,1,22,EL
33b11df6,3,1,0,2,1,2,3,1,0,0,0,2,5,0,0,22,EL
33bd3dae,5,5,1,2,2,3,6,3,4,0,4,0,5,2,0,22,EL
34ccf6fa,0,0,0,0,0,0,0,0,0,0,0,0,0,1,1,22,EL
34e393f2,29,20,11,17,1,13,19,6,20,3,17,13,42,22,0,22,EL
35862524,7,3,3,4,0,3,4,1,1,1,0,5,12,2,0,22,EL
3594a357,0,0,0,0,0,0,0,0,0,0,0,0,0,0,0,22,EL
35d64857,24,12,13,10,1,10,15,5,9,5,4,29,53,44,1,22,EL
35f67791,8,5,5,1,2,6,14,8,6,1,5,2,10,0,0,22,EL
360e3062,8,6,5,3,0,3,13,10,8,2,6,6,14,8,0,22,EL
3642b47f,7,5,1,5,1,2,10,8,1,0,1,5,12,2,0,22,EL
36463103,4,2,2,2,0,1,1,0,4,1,3,4,8,9,0,22,EL
36a3ff67,5,4,1,3,1,1,4,3,2,0,2,2,7,1,0,22,EL
36a79857,4,2,3,1,0,1,5,4,6,0,6,1,5,1,0,22,EL
3708e9fa,11,8,6,4,1,3,10,7,12,1,11,5,16,3,0,22,EL
374d5158,0,0,0,0,0,0,0,0,0,0,0,1,1,2,0,22,EL
374ee424,0,0,0,0,0,0,0,0,0,0,0,0,0,2,1,22,EL
37d0048f,17,8,8,7,2,9,18,9,8,3,5,6,23,9,0,22,EL
37dc1a48,8,3,2,3,3,4,9,5,11,1,10,4,12,2,0,22,EL
393a257c,0,0,0,0,0,0,0,0,5,3,2,1,1,11,0,22,EL
3b0108d6,0,0,0,0,0,0,0,0,0,0,0,0,0,2,0,22,EL
3b029691,6,4,1,3,2,2,8,6,2,2,0,8,14,2,0,22,EL
3b12b11f,0,0,0,0,0,0,0,0,0,0,0,1,1,0,0,22,EL
3b333ac3,7,6,5,0,2,6,9,3,6,0,6,2,9,10,0,22,EL
3ca7254a,4,4,3,1,0,3,10,7,4,0,4,4,8,2,0,22,EL
3cdfc63e,5,3,3,2,0,3,9,6,7,4,3,7,12,23,0,22,EL
3ce20eda,9,6,6,3,0,5,8,3,5,3,2,6,15,31,1,22,EL
3d6686f9,0,0,0,0,0,0,0,0,1,0,1,0,0,1,0,22,EL
3d6691dd,10,5,5,5,0,5,10,5,6,1,5,4,14,8,0,22,EL
3dd738a1,11,8,7,3,1,7,12,5,6,2,4,8,19,7,0,22,EL
3e9e06cb,4,3,4,0,0,4,6,2,16,15,1,5,9,27,0,22,EL
3ea50f67,2,1,2,0,0,1,4,3,1,0,1,1,3,1,0,22,EL
3ecc8c5f,6,3,5,1,0,2,4,2,21,17,4,16,22,37,0,22,EL
3ee0dd59,12,6,7,3,2,4,13,9,8,0,8,9,21,9,0,22,EL
3ef0fa48,5,3,1,2,2,4,5,1,2,0,2,2,7,1,0,22,EL
3efaa30d,4,2,3,0,1,1,1,0,2,0,2,6,10,4,0,22,EL
3effaa34,1,1,1,0,0,1,1,0,0,0,0,0,1,2,0,22,EL
3f10bd22,2,1,1,1,0,1,5,4,3,1,2,0,2,6,0,22,EL
4030c7ae,0,0,0,0,0,0,0,0,0,0,0,0,0,3,0,22,EL
4037db79,12,6,7,5,0,5,15,10,3,1,2,3,15,9,1,22,EL
403f5d20,7,4,1,6,0,4,13,9,9,3,6,10,17,12,1,22,EL
4044e8d8,0,0,0,0,0,0,1,1,0,0,0,0,0,0,0,22,EL
40774c6b,9,6,0,4,5,4,5,1,0,0,0,2,11,3,0,22,EL
40ab93b4,0,0,0,0,0,0,0,0,0,0,0,0,0,1,0,22,EL
414b2ce4,3,2,3,0,0,1,2,1,1,0,1,0,3,0,0,22,EL
41d3704d,0,0,0,0,0,0,0,0,1,1,0,0,0,1,0,22,EL
41eebdf5,7,6,5,2,0,3,5,2,2,0,2,1,8,24,0,22,EL
41f32541,2,1,1,1,0,0,2,2,3,0,3,2,4,1,0,22,EL
42a55711,3,2,0,0,3,1,8,7,5,0,5,1,4,2,0,22,EL
42dcf26d,1,1,1,0,0,1,2,1,3,2,1,3,4,4,0,22,EL
4352d221,9,6,4,4,1,3,11,8,7,0,7,2,11,1,0,22,EL
4374d81c,17,9,10,7,0,10,16,6,11,5,6,16,33,13,0,22,EL
43b23d3a,3,2,2,1,0,0,2,2,2,1,1,0,3,2,0,22,EL
441197b8,18,9,9,9,0,13,21,8,22,8,14,21,39,44,0,22,EL
44150beb,2,2,1,1,0,2,2,0,0,0,0,2,4,3,0,22,EL
4431aed2,2,2,2,0,0,1,2,1,1,0,1,2,4,2,0,22,EL
444940e2,17,9,8,7,2,6,15,9,11,1,10,8,25,8,0,22,EL
448a3608,1,1,0,0,1,1,2,1,0,0,0,0,1,4,0,22,EL
4535e4bb,0,0,0,0,0,0,1,1,0,0,0,0,0,2,1,22,EL
45954ec7,1,0,0,1,0,0,0,0,3,2,1,4,5,10,0,22,EL
45963054,0,0,0,0,0,0,0,0,0,0,0,1,1,2,0,22,EL
45bb4303,2,1,1,1,0,0,0,0,0,0,0,0,2,0,0,22,EL
4601e194,13,7,10,3,0,8,13,5,7,1,6,11,24,4,0,22,EL
46152b69,8,5,3,4,1,4,7,3,13,4,9,13,21,16,0,22,EL
4737cebe,1,1,1,0,0,0,2,2,3,0,3,5,6,1,0,22,EL
4760b2f2,5,2,3,2,0,4,6,2,12,10,2,5,10,33,0,22,EL
47681787,2,1,0,2,0,1,6,5,0,0,0,3,5,2,1,22,EL
47af88b8,6,5,3,3,0,2,3,1,9,8,1,2,8,15,0,22,EL
47dbe004,9,4,5,3,1,3,9,6,4,1,3,3,12,6,0,22,EL
47fd5136,1,0,1,0,0,1,1,0,0,0,0,0,1,0,1,22,EL
48d5bd33,1,0,0,1,0,0,2,2,2,1,1,2,3,1,0,22,EL
48df060a,0,0,0,0,0,0,0,0,0,0,0,0,0,0,0,22,EL
4980c6be,1,1,1,0,0,1,1,0,0,0,0,0,1,2,0,22,EL
49b45985,3,2,1,1,1,1,2,1,1,0,1,0,3,0,0,22,EL
49d028db,14,8,10,4,0,11,14,3,7,4,3,12,26,30,2,22,EL
49df363f,0,0,0,0,0,0,1,1,0,0,0,0,0,0,0,22,EL
4a5e83ad,13,7,4,9,0,4,17,13,6,1,5,10,23,7,2,22,EL
4b00cd47,16,11,10,6,0,11,19,8,12,6,6,10,26,36,0,22,EL
4b3e1a38,3,3,3,0,0,1,4,3,9,4,5,6,9,14,0,22,EL
4b5ed2f7,2,1,1,1,0,2,3,1,1,0,1,1,3,4,0,22,EL
4b77bb89,3,2,2,0,1,3,3,0,0,0,0,0,3,0,0,22,EL
4bd00a50,5,1,5,0,0,4,4,0,2,1,1,2,7,0,0,22,EL
4be0b467,3,3,1,1,1,2,2,0,0,0,0,0,3,4,0,22,EL
4c2a5d34,2,0,0,1,1,1,3,2,0,0,0,0,2,1,0,22,EL
4c5b14d2,6,3,3,0,3,4,9,5,7,1,6,2,8,2,0,22,EL
4c5b714f,11,9,4,7,0,5,8,3,0,0,0,1,12,7,0,22,EL
4c6facae,21,13,9,9,3,10,22,12,10,0,10,15,36,8,0,22,EL
4c78b5ed,15,8,10,4,1,7,13,6,1,0,1,11,26,5,0,22,EL
4c82730b,6,4,5,1,0,4,15,11,6,0,6,14,20,9,0,22,EL
4d1666ff,2,2,0,2,0,0,8,8,4,4,0,2,4,11,0,22,EL
4d982baf,2,2,1,1,0,1,4,3,4,2,2,3,5,2,0,22,EL
4da9191b,12,8,1,8,3,7,12,5,7,2,5,17,29,4,0,22,EL
4dedd469,10,7,4,5,1,5,11,6,5,4,1,7,17,9,0,22,EL
4e4b59a4,0,0,0,0,0,0,0,0,0,0,0,1,1,0,0,22,EL
4e6dbac4,2,2,2,0,0,1,7,6,8,2,6,4,6,3,0,22,EL
4f255115,14,9,9,4,1,8,17,9,7,3,4,16,30,1,0,22,EL
4f28a6ff,0,0,0,0,0,0,0,0,1,1,0,4,4,3,0,22,EL
4f974391,6,4,1,3,2,4,9,5,2,1,1,8,14,9,0,22,EL
4fac8f81,13,9,6,7,0,9,21,12,5,1,4,12,25,14,0,22,EL
4fdf1fd9,0,0,0,0,0,0,0,0,0,0,0,0,0,2,0,22,EL
50871bcc,0,0,0,0,0,0,0,0,2,0,2,0,0,0,0,22,EL
50c1ff86,2,1,1,1,0,0,0,0,4,4,0,10,12,7,0,22,EL
50ff205b,11,10,6,4,1,7,16,9,6,4,2,8,19,13,0,22,EL
510c6a3f,1,1,1,0,0,1,1,0,0,0,0,0,1,2,0,22,EL
51ffa295,8,4,3,5,0,6,16,10,6,0,6,4,12,4,0,22,EL
5294a83f,8,3,5,3,0,4,10,6,10,2,8,1,9,3,0,22,EL
52b8ea30,0,0,0,0,0,0,0,0,0,0,0,1,1,0,0,22,EL
52fdf512,1,0,0,1,0,1,5,4,7,6,1,9,10,24,0,22,EL
53070b63,5,3,2,3,0,0,6,6,4,0,4,1,6,2,0,22,EL
53af52f3,0,0,0,0,0,0,0,0,0,0,0,0,0,0,0,22,EL
53de807a,2,1,2,0,0,0,0,0,2,0,2,4,6,4,0,22,EL
53e360bb,0,0,0,0,0,0,0,0,0,0,0,0,0,1,2,22,EL
53e442e2,0,0,0,0,0,0,0,0,0,0,0,0,0,0,0,22,EL
53f1c5de,9,6,2,4,3,4,7,3,2,0,2,3,12,6,0,22,EL
540c9a17,4,1,1,1,2,1,1,0,5,2,3,1,5,5,0,22,EL
5458f670,0,0,0,0,0,0,1,1,0,0,0,0,0,0,0,22,EL
54b4dc4e,16,13,6,10,0,8,17,9,5,1,4,5,21,5,0,22,EL
5521f419,0,0,0,0,0,0,1,1,3,0,3,1,1,0,0,22,EL
555d5edd,1,1,0,1,0,1,1,0,0,0,0,0,1,0,0,22,EL
55b93ae0,0,0,0,0,0,0,0,0,0,0,0,0,0,1,0,22,EL
55c95c3e,4,4,3,1,0,3,5,2,1,0,1,2,6,3,0,22,EL
56208b05,7,5,3,3,1,4,10,6,10,4,6,10,17,15,1,22,EL
5631b735,10,4,4,5,1,4,9,5,0,0,0,5,15,6,0,22,EL
563cbac0,6,3,5,0,1,5,8,3,3,1,2,6,12,13,0,22,EL
56413b1f,7,2,1,3,3,2,8,6,5,1,4,5,12,2,0,22,EL
56545648,0,0,0,0,0,0,2,2,1,0,1,1,1,1,0,22,EL
56901a62,0,0,0,0,0,0,0,0,0,0,0,0,0,2,0,22,EL
56b1933d,2,0,1,1,0,0,0,0,1,0,1,0,2,0,0,22,EL
56f6f826,17,12,11,6,0,7,14,7,12,8,4,19,36,75,1,22,EL
56f7a928,2,1,0,1,1,0,3,3,4,1,3,1,3,2,0,22,EL
56f99ec7,0,0,0,0,0,0,0,0,0,0,0,0,0,0,0,22,EL
5715bb71,0,0,0,0,0,0,2,2,2,0,2,1,1,1,0,22,EL
574fff8c,3,2,2,1,0,1,2,1,3,2,1,5,8,5,0,22,EL
5777eca0,3,1,1,2,0,1,6,5,10,4,6,7,10,16,0,22,EL
577efaec,3,1,1,2,0,2,3,1,2,1,1,0,3,0,0,22,EL
57d88cf9,6,4,3,0,3,3,6,3,1,0,1,3,9,0,0,22,EL
57df7a11,3,3,1,2,0,1,4,3,3,0,3,5,8,3,0,22,EL
58027adc,0,0,0,0,0,0,0,0,1,0,1,0,0,0,0,22,EL
58a9a4d9,5,3,1,1,3,3,6,3,3,0,3,1,6,2,0,22,EL
58ae47b2,5,5,1,3,1,2,3,1,3,0,3,2,7,0,1,22,EL
58f077c0,0,0,0,0,0,0,1,1,0,0,0,0,0,2,0,22,EL
595e6f3e,3,3,0,1,2,1,3,2,3,1,2,0,3,2,0,22,EL
5976f83e,6,4,6,0,0,4,5,1,2,0,2,2,8,0,0,22,EL
5a04fd92,10,5,2,6,2,5,6,1,4,0,4,3,13,0,0,22,EL
5a068ec6,4,1,2,2,0,1,2,1,3,1,2,1,5,3,0,22,EL
5ab0ea87,9,7,2,5,2,3,9,6,6,1,5,11,20,2,0,22,EL
5ad50391,11,6,6,3,2,5,9,4,5,3,2,10,21,11,0,22,EL
5b3d1a7a,9,6,4,3,2,5,8,3,5,0,5,11,20,7,0,22,EL
5b479568,1,1,0,0,1,0,1,1,1,0,1,0,1,2,0,22,EL
5b5c2228,3,3,2,1,0,1,3,2,3,1,2,5,8,7,0,22,EL
5b9512c5,5,3,4,1,0,2,5,3,5,4,1,7,12,16,0,22,EL
5c397195,7,1,4,3,0,5,9,4,3,0,3,9,16,4,0,22,EL
5c74c0f5,4,3,1,2,1,2,5,3,3,0,3,1,5,2,0,22,EL
5c7845f6,13,5,6,7,0,5,5,0,3,3,0,4,17,20,1,22,EL
5c78cb9e,12,6,6,6,0,3,13,10,6,2,4,4,16,10,0,22,EL
5ca20b7a,10,9,4,6,0,5,9,4,3,1,2,8,18,19,0,22,EL
5caa62a7,3,3,0,3,0,2,4,2,1,0,1,0,3,2,0,22,EL
5cdddffa,9,5,5,3,1,6,11,5,3,0,3,9,18,1,0,22,EL
5ce0b5ba,0,0,0,0,0,0,0,0,0,0,0,0,0,0,0,22,EL
5ceba7fc,8,5,5,2,1,5,8,3,4,0,4,6,14,5,0,22,EL
5cec2487,4,4,2,2,0,2,5,3,2,1,1,9,13,11,0,22,EL
5cfec13d,3,2,1,2,0,0,0,0,4,4,0,4,7,5,0,22,EL
5d4f7d61,0,0,0,0,0,0,1,1,0,0,0,0,0,0,0,22,EL
5ddb8f9f,4,2,4,0,0,1,3,2,2,0,2,0,4,1,0,22,EL
5dfc6ad5,1,1,0,1,0,0,0,0,0,0,0,2,3,0,0,22,EL
5e167a35,4,3,1,3,0,3,8,5,3,2,1,2,6,1,0,22,EL
5e42afa3,5,3,1,4,0,1,8,7,10,4,6,3,8,3,0,22,EL
5e7fff2d,9,4,6,2,1,4,7,3,5,1,4,5,14,10,0,22,EL
5e861944,6,2,4,1,1,4,6,2,0,0,0,0,6,0,0,22,EL
5e8936be,0,0,0,0,0,0,0,0,0,0,0,2,2,0,0,22,EL
5ea8ef20,9,7,2,4,3,4,9,5,6,0,6,3,12,3,0,22,EL
5eb77bef,0,0,0,0,0,0,2,2,2,0,2,0,0,0,0,22,EL
5ef3d210,0,0,0,0,0,0,0,0,0,0,0,0,0,0,0,22,EL
5f09991f,17,9,13,4,0,7,18,11,6,2,4,11,28,13,0,22,EL
5f3d00d1,3,2,1,1,1,2,7,5,3,0,3,0,3,2,0,22,EL
5fcb90ac,11,6,5,4,2,5,9,4,7,4,3,4,15,6,1,22,EL
6011e63a,0,0,0,0,0,0,0,0,1,0,1,0,0,0,0,22,EL
60c07b31,2,2,2,0,0,0,1,1,0,0,0,5,7,6,0,22,EL
617f2e27,0,0,0,0,0,0,0,0,1,0,1,0,0,0,0,22,EL
62d0dcc5,2,1,0,2,0,0,2,2,0,0,0,0,2,3,0,22,EL
6412cc03,7,3,2,4,1,2,5,3,0,0,0,1,8,1,0,22,EL
6421ec64,2,0,0,2,0,1,3,2,5,1,4,2,4,0,1,22,EL
6438d426,4,3,2,2,0,2,3,1,3,2,1,1,5,6,0,22,EL
64748421,0,0,0,0,0,0,0,0,0,0,0,0,0,0,0,22,EL
64b08de7,7,5,2,4,1,2,4,2,5,1,4,2,9,5,0,22,EL
64f69877,3,0,0,1,2,1,4,3,4,1,3,2,5,1,0,22,EL
6510079f,6,4,3,2,1,4,11,7,5,0,5,3,9,3,0,22,EL
65159211,0,0,0,0,0,0,0,0,0,0,0,0,0,0,0,22,EL
6603fed7,10,3,3,6,1,2,7,5,4,1,3,1,11,5,0,22,EL
6613c819,17,10,5,10,2,7,20,13,7,5,2,19,36,26,0,22,EL
6637e6a7,3,2,2,1,0,0,5,5,8,0,8,3,6,2,0,22,EL
66c52a77,6,2,2,4,0,3,6,3,3,0,3,6,12,7,0,22,EL
6800f515,7,2,3,2,2,2,10,8,4,1,3,4,11,8,0,22,EL
683a8f5f,2,0,0,1,1,0,2,2,4,0,4,0,2,0,0,22,EL
6853490f,2,0,1,1,0,1,3,2,3,0,3,0,2,2,0,22,EL
688fcea2,3,2,2,0,1,0,2,2,1,1,0,2,5,0,0,22,EL
691f64f5,4,3,3,0,1,0,1,1,3,1,2,2,6,2,0,22,EL
692cd6de,13,8,9,4,0,12,16,4,5,2,3,8,21,12,0,22,EL
697dc00a,7,4,2,5,0,6,10,4,5,2,3,13,20,11,0,22,EL
6af56975,6,2,4,2,0,2,9,7,1,0,1,1,7,3,0,22,EL
6afcaaa3,18,10,7,10,1,9,15,6,6,0,6,7,25,6,0,22,EL
6b0802ea,1,0,1,0,0,1,1,0,0,0,0,0,1,0,0,22,EL
6b21b7b5,3,2,0,2,1,0,1,1,1,0,1,0,3,0,0,22,EL
6b47c5db,11,5,4,6,1,4,11,7,6,0,6,10,21,2,0,22,EL
6b8887c2,1,0,0,1,0,0,0,0,1,1,0,0,1,1,0,22,EL
6b88c810,4,2,0,3,1,1,5,4,4,0,4,1,5,0,0,22,EL
6b994195,10,9,5,5,0,6,7,1,9,6,3,8,18,22,1,22,EL
6bb2c084,7,6,3,2,2,2,5,3,10,1,9,7,14,3,0,22,EL
6be813ab,3,1,2,1,0,2,10,8,1,0,1,4,7,3,0,22,EL
6c249ea7,10,7,7,3,0,7,10,3,4,3,1,10,20,22,0,22,EL
6c8ddd52,15,8,8,7,0,10,14,4,6,2,4,4,19,10,0,22,EL
6cbf8d0d,6,5,2,3,1,0,2,2,6,0,6,2,8,6,0,22,EL
6ce43701,0,0,0,0,0,0,0,0,0,0,0,0,0,0,0,22,EL
6de23ab0,4,1,3,1,0,1,2,1,0,0,0,6,10,8,0,22,EL
6e4df551,2,1,0,1,1,2,6,4,1,0,1,1,3,0,0,22,EL
6eee05f1,4,2,2,2,0,1,7,6,4,1,3,3,7,9,0,22,EL
6f3cc2fe,4,4,1,1,2,0,2,2,2,0,2,0,4,0,0,22,EL
6f4e1c93,0,0,0,0,0,0,0,0,0,0,0,0,0,1,1,22,EL
6f51e382,0,0,0,0,0,0,0,0,0,0,0,0,0,0,0,22,EL
6f5f82c0,3,2,2,1,0,2,7,5,4,1,3,3,6,2,0,22,EL
6fd8a334,5,3,5,0,0,3,7,4,11,9,2,21,26,29,0,22,EL
6ff91a3a,2,0,2,0,0,0,4,4,3,1,2,1,3,1,0,22,EL
7120a04d,0,0,0,0,0,0,1,1,3,0,3,0,0,0,0,22,EL
712dd708,24,17,16,8,0,16,23,7,9,2,7,20,44,32,1,22,EL
7155e3e1,7,3,3,4,0,2,4,2,1,0,1,8,15,2,0,22,EL
716e7308,0,0,0,0,0,0,0,0,0,0,0,0,0,0,0,22,EL
7220ffd7,6,5,3,3,0,5,8,3,0,0,0,1,7,2,0,22,EL
72984eee,1,1,0,1,0,0,2,2,1,0,1,1,2,1,0,22,EL
72a99e38,2,1,1,1,0,2,5,3,7,1,6,2,4,0,0,22,EL
72c01cfb,8,6,4,3,1,2,2,0,3,2,1,13,21,16,0,22,EL
73000a79,4,3,1,0,3,3,5,2,4,2,2,3,7,1,0,22,EL
73b9fa8a,2,2,1,1,0,1,1,0,1,0,1,6,8,0,0,22,EL
73fc8cc3,0,0,0,0,0,0,0,0,0,0,0,0,0,0,0,22,EL
745ca0a3,5,3,2,1,2,3,5,2,4,0,4,1,6,1,0,22,EL
7483d9f9,4,3,3,0,1,2,8,6,6,3,3,6,10,13,0,22,EL
74d4cec6,12,8,4,6,2,2,9,7,3,1,2,1,13,4,0,22,EL
74f2e748,7,4,3,4,0,5,10,5,6,1,5,4,11,8,1,22,EL
751a0fb5,6,6,0,3,3,2,5,3,5,1,4,4,10,4,0,22,EL
75645f0e,1,0,0,1,0,0,0,0,6,1,5,1,2,4,0,22,EL
75a72a99,4,3,3,1,0,3,4,1,2,0,2,2,6,1,0,22,EL
76c98b58,8,4,7,1,0,4,5,1,0,0,0,5,13,4,0,22,EL
76ff8d0d,10,8,3,6,1,3,10,7,4,1,3,3,13,3,0,22,EL
770d7eb8,12,4,6,5,1,6,8,2,6,1,5,7,19,9,1,22,EL
778ef829,9,6,3,5,1,2,6,4,2,0,2,1,10,8,0,22,EL
77bf714c,1,1,0,1,0,1,5,4,1,0,1,2,3,2,0,22,EL
780e3631,2,0,1,0,1,2,4,2,1,0,1,1,3,2,0,22,EL
78e68b4d,21,9,14,7,0,6,10,4,12,5,7,14,35,26,1,22,EL
79083382,9,5,6,3,0,4,5,1,7,2,5,5,14,8,0,22,EL
794364d7,18,9,8,9,1,7,17,10,13,2,11,10,28,7,0,22,EL
79c84d1c,7,3,1,6,0,2,6,4,5,0,5,1,8,6,0,22,EL
7a2cf111,6,4,6,0,0,4,6,2,2,0,2,3,9,3,0,22,EL
7a4cea18,1,1,0,1,0,1,1,0,0,0,0,2,3,0,0,22,EL
7b456af7,0,0,0,0,0,0,1,1,0,0,0,0,0,1,0,22,EL
7b4c1f6e,4,3,2,0,2,3,5,2,2,1,1,2,6,3,0,22,EL
7b9ecf02,13,9,10,2,1,10,13,3,14,8,6,9,22,29,1,22,EL
7bb0fe4a,1,0,1,0,0,0,0,0,0,0,0,0,1,0,0,22,EL
7bcc0708,2,0,1,1,0,1,2,1,0,0,0,1,3,0,0,22,EL
7be09c86,3,2,0,2,1,0,2,2,4,1,3,0,3,7,0,22,EL
7bf8ad6c,5,5,0,5,0,2,4,2,1,0,1,2,7,1,0,22,EL
7c104bb7,3,1,2,1,0,1,3,2,3,0,3,5,8,1,0,22,EL
7c2965bb,1,1,1,0,0,1,1,0,0,0,0,0,1,0,0,22,EL
7c3ed041,0,0,0,0,0,0,2,2,1,1,0,2,2,1,0,22,EL
7c56da38,5,2,1,1,3,2,5,3,2,0,2,0,5,4,0,22,EL
7c7fdb0f,4,3,4,0,0,4,6,2,2,1,1,0,4,4,0,22,EL
7cb9de24,5,4,1,4,0,1,3,2,3,3,0,6,11,14,0,22,EL
7cd78926,17,11,15,1,1,9,15,6,3,2,1,11,28,13,0,22,EL
7d06360d,5,3,3,2,0,3,5,2,2,0,2,3,8,9,0,22,EL
7d08063d,1,0,1,0,0,1,4,3,1,0,1,5,6,1,0,22,EL
7d2d3329,1,0,1,0,0,0,0,0,1,0,1,1,2,0,0,22,EL
7e56d3db,8,5,4,4,0,5,8,3,2,0,2,8,16,3,0,22,EL
7ee64741,8,5,5,3,0,5,12,7,6,2,4,11,19,7,0,22,EL
7ef181cf,2,1,1,1,0,2,5,3,0,0,0,0,2,1,0,22,EL
7f40333d,0,0,0,0,0,0,0,0,0,0,0,0,0,3,1,22,EL
7fa4e703,0,0,0,0,0,0,0,0,0,0,0,0,0,0,0,22,EL
7fe90ccd,5,4,3,2,0,4,7,3,4,2,2,5,10,1,0,22,EL
80490d7f,3,3,2,1,0,2,7,5,4,3,1,8,11,12,1,22,EL
80556f08,5,2,2,2,1,3,7,4,3,0,3,3,8,1,0,22,EL
807cb743,0,0,0,0,0,0,0,0,0,0,0,0,0,0,0,22,EL
8104e41e,5,2,3,1,1,2,3,1,3,0,3,0,5,1,0,22,EL
81442ecb,4,3,2,2,0,3,4,1,2,0,2,2,6,4,0,22,EL
816bdfdd,2,2,2,0,0,2,3,1,4,1,3,2,4,1,1,22,EL
819aa8e7,1,1,0,0,1,0,2,2,5,0,5,3,4,2,0,22,EL
81a4c239,1,0,0,1,0,1,2,1,0,0,0,0,1,0,0,22,EL
81d3318f,8,3,2,5,1,2,3,1,1,0,1,1,9,1,0,22,EL
822d51d7,5,3,2,2,1,4,10,6,3,0,3,4,9,1,0,22,EL
82518f62,8,2,1,3,4,2,8,6,7,2,5,3,11,3,0,22,EL
82671804,7,5,5,2,0,3,5,2,1,0,1,2,9,0,0,22,EL
826e8b63,15,9,8,7,0,11,16,5,4,0,4,4,19,2,0,22,EL
82927de4,17,7,6,10,1,10,25,15,11,0,11,13,30,3,0,22,EL
82a39b66,5,2,1,2,2,2,9,7,0,0,0,3,8,6,1,22,EL
82b1198a,0,0,0,0,0,0,0,0,0,0,0,0,0,1,0,22,EL
82e9b1bb,3,3,1,2,0,3,4,1,3,1,2,2,5,1,0,22,EL
8321285a,2,0,1,1,0,2,4,2,1,0,1,0,2,0,0,22,EL
833a8fbc,5,3,1,4,0,2,2,0,0,0,0,1,6,4,0,22,EL
834d0be5,1,0,1,0,0,1,6,5,3,0,3,0,1,3,0,22,EL
83e4643e,2,2,0,2,0,1,5,4,0,0,0,4,6,1,0,22,EL
84399660,5,1,3,2,0,2,10,8,5,1,4,0,5,1,0,22,EL
8494acc4,2,2,0,2,0,0,0,0,0,0,0,0,2,3,0,22,EL
849c826a,4,2,0,2,2,1,7,6,1,0,1,1,5,2,0,22,EL
85613cf0,2,2,0,2,0,0,0,0,0,0,0,0,2,1,0,22,EL
85937928,9,5,5,2,2,4,8,4,2,0,2,3,12,1,0,22,EL
85bed4ee,3,2,2,1,0,3,6,3,0,0,0,1,4,0,0,22,EL
8696bc90,2,2,0,2,0,1,2,1,0,0,0,1,3,1,0,22,EL
86b575a7,1,0,0,1,0,0,2,2,1,0,1,0,1,0,0,22,EL
86bf27f0,0,0,0,0,0,0,0,0,0,0,0,0,0,0,0,22,EL
86dd16a8,6,2,2,4,0,4,8,4,7,2,5,7,13,10,0,22,EL
871961e8,7,2,3,4,0,6,12,6,3,0,3,1,8,1,0,22,EL
87d8b5a3,6,3,0,2,4,3,5,2,2,0,2,2,8,1,1,22,EL
87f12e30,2,1,0,2,0,1,3,2,1,0,1,0,2,0,0,22,EL
88015937,0,0,0,0,0,0,0,0,0,0,0,0,0,0,0,22,EL
88062e83,3,3,2,1,0,2,3,1,3,0,3,1,4,1,0,22,EL
8827bf46,5,4,1,3,1,1,3,2,3,0,3,2,7,1,0,22,EL
88ced02c,4,2,2,2,0,3,3,0,5,4,1,7,11,26,0,22,EL
89ac64a6,0,0,0,0,0,0,2,2,0,0,0,0,0,1,0,22,EL
89b2c8a9,2,2,0,1,1,0,4,4,0,0,0,0,2,1,0,22,EL
89f951b5,8,4,4,4,0,3,4,1,2,1,1,1,9,4,1,22,EL
8a3aabc1,6,3,5,1,0,4,5,1,4,3,1,4,10,6,1,22,EL
8a53d24b,1,1,0,0,1,1,1,0,4,0,4,0,1,3,0,22,EL
8a56c04c,7,3,0,7,0,2,3,1,2,0,2,2,9,6,0,22,EL
8a6ab963,0,0,0,0,0,0,0,0,0,0,0,0,0,0,0,22,EL
8b0b02c9,2,0,0,0,2,0,2,2,2,0,2,0,2,1,0,22,EL
8b150514,0,0,0,0,0,0,0,0,0,0,0,0,0,1,0,22,EL
8b47ce35,3,2,2,1,0,2,4,2,5,2,3,10,13,7,0,22,EL
8b529245,0,0,0,0,0,0,0,0,0,0,0,3,3,1,0,22,EL
8b788c01,1,1,1,0,0,1,3,2,2,0,2,1,2,3,0,22,EL
8b8e759d,6,3,2,4,0,3,4,1,3,1,2,2,8,4,0,22,EL
8b929ec2,2,1,2,0,0,2,4,2,3,1,2,5,7,20,0,22,EL
8babb812,5,1,3,2,0,3,12,9,2,0,2,4,9,0,0,22,EL
8bc373ea,15,11,12,2,1,10,12,2,4,4,0,11,26,31,1,22,EL
8c3c640c,6,3,3,1,2,2,9,7,6,2,4,1,7,3,0,22,EL
8c5f1522,2,1,0,2,0,0,4,4,0,0,0,2,4,3,0,22,EL
8c725b43,6,1,6,0,0,4,6,2,6,4,2,12,18,21,1,22,EL
8c90fd7a,0,0,0,0,0,0,1,1,1,0,1,0,0,3,0,22,EL
8cd49575,0,0,0,0,0,0,0,0,0,0,0,0,0,0,0,22,EL
8d3d3b0a,0,0,0,0,0,0,0,0,0,0,0,1,1,1,0,22,EL
8d46713e,6,4,4,0,2,4,9,5,1,0,1,3,9,2,0,22,EL
8d7fe72a,5,5,1,4,0,3,3,0,1,0,1,3,8,2,0,22,EL
8dcf77c0,4,2,1,3,0,2,4,2,7,0,7,3,7,5,0,22,EL
8df5b30f,2,1,1,1,0,0,2,2,1,1,0,0,2,1,0,22,EL
8e34b9f5,1,1,0,1,0,0,0,0,2,1,1,4,5,12,0,22,EL
8e48dc61,5,3,2,2,1,2,5,3,1,0,1,2,7,4,0,22,EL
8e7f49d3,5,3,3,1,1,3,4,1,4,2,2,5,10,0,0,22,EL
8e92be30,0,0,0,0,0,0,0,0,3,0,3,3,3,2,0,22,EL
8f696594,1,1,0,1,0,0,0,0,2,0,2,0,1,0,0,22,EL
8fb94908,1,0,0,0,1,0,4,4,1,0,1,4,5,0,0,22,EL
8ff2354e,6,3,5,1,0,3,3,0,3,0,3,1,7,3,0,22,EL
8ff4872e,7,4,5,2,0,6,10,4,4,0,4,7,14,5,1,22,EL
90d7dda6,6,5,3,3,0,2,7,5,8,3,5,6,12,10,1,22,EL
919dd4b1,1,1,1,0,0,1,4,3,2,0,2,2,3,1,0,22,EL
921f6058,1,0,0,1,0,0,2,2,2,0,2,12,13,19,0,22,EL
922da988,0,0,0,0,0,0,0,0,0,0,0,0,0,0,0,22,EL
92432bc6,2,0,1,1,0,0,0,0,1,0,1,0,2,0,0,22,EL
928a4a61,2,0,0,2,0,0,2,2,0,0,0,3,5,1,0,22,EL
93088fbb,0,0,0,0,0,0,0,0,0,0,0,0,0,0,0,22,EL
9319781b,19,10,12,7,0,10,12,2,9,5,4,6,25,23,0,22,EL
9328b835,0,0,0,0,0,0,0,0,0,0,0,0,0,0,0,22,EL
934e1968,2,2,0,0,2,1,5,4,7,0,7,1,3,0,0,22,EL
939bc634,0,0,0,0,0,0,0,0,0,0,0,0,0,3,0,22,EL
93e368f9,1,0,0,1,0,1,5,4,1,1,0,1,2,0,0,22,EL
93fffbcf,0,0,0,0,0,0,0,0,0,0,0,0,0,5,0,22,EL
9413b19f,0,0,0,0,0,0,0,0,0,0,0,0,0,4,0,22,EL
942b4f90,2,0,0,2,0,0,1,1,5,1,4,1,3,1,0,22,EL
94f8d10c,1,1,1,0,0,0,0,0,4,1,3,5,6,6,0,22,EL
951f1739,6,4,3,3,0,3,11,8,2,0,2,3,9,4,0,22,EL
95efdac2,0,0,0,0,0,0,1,1,1,0,1,0,0,0,0,22,EL
95f7099e,0,0,0,0,0,0,0,0,0,0,0,0,0,0,0,22,EL
9614b550,6,3,0,4,2,2,3,1,5,2,3,8,14,15,0,22,EL
962e54cb,2,1,1,0,1,0,0,0,1,0,1,2,4,1,0,22,EL
9719d14f,1,1,1,0,0,1,2,1,1,0,1,1,2,1,0,22,EL
972aeb2a,4,3,4,0,0,1,1,0,7,4,3,9,13,9,1,22,EL
972d595a,0,0,0,0,0,0,0,0,0,0,0,0,0,3,0,22,EL
976e1238,0,0,0,0,0,0,1,1,1,0,1,0,0,0,0,22,EL
97e2aa67,10,6,4,4,2,5,15,10,7,0,7,4,14,7,0,22,EL
97e996a7,9,3,7,2,0,6,9,3,4,3,1,8,17,24,1,22,EL
98ca4feb,3,1,1,2,0,3,4,1,0,0,0,0,3,1,0,22,EL
98d2c2c4,11,7,5,5,1,8,20,12,7,1,6,8,19,2,0,22,EL
99047b00,0,0,0,0,0,0,0,0,0,0,0,0,0,2,0,22,EL
99a8ddc9,11,4,4,7,0,6,21,15,8,0,8,9,20,5,0,22,EL
9a28eba4,2,1,0,2,0,1,2,1,1,0,1,0,2,0,0,22,EL
9a2e0ccc,2,1,0,2,0,0,1,1,1,0,1,0,2,0,0,22,EL
9a64e67e,3,2,2,1,0,1,4,3,3,3,0,5,8,23,0,22,EL
9ab16552,13,9,8,5,0,9,14,5,6,3,3,5,18,13,1,22,EL
9ade9ce1,6,3,1,5,0,3,8,5,3,0,3,2,8,4,0,22,EL
9b6f7fd5,10,6,2,6,2,3,12,9,4,0,4,2,12,7,0,22,EL
9bd73cce,1,0,1,0,0,1,3,2,1,0,1,0,1,2,0,22,EL
9c74fa25,4,3,3,0,1,1,10,9,4,3,1,8,12,15,0,22,EL
9ca07baf,0,0,0,0,0,0,0,0,0,0,0,1,1,0,0,22,EL
9ceb7642,0,0,0,0,0,0,2,2,0,0,0,1,1,0,0,22,EL
9d115f7a,0,0,0,0,0,0,1,1,0,0,0,0,0,0,0,22,EL
9d689a5b,9,5,6,3,0,6,14,8,4,1,3,5,14,5,0,22,EL
9d804092,0,0,0,0,0,0,1,1,0,0,0,0,0,0,0,22,EL
9d8cf204,2,1,0,2,0,2,3,1,2,0,2,1,3,1,0,22,EL
9e1035f8,1,1,0,1,0,0,6,6,4,0,4,5,6,2,0,22,EL
9efa1d25,9,5,3,3,3,4,10,6,3,0,3,2,11,1,0,22,EL
9f115e20,0,0,0,0,0,0,0,0,0,0,0,0,0,0,0,22,EL
9f1893b9,21,12,9,10,2,13,25,12,4,0,4,2,23,1,0,22,EL
9f6325f9,2,1,1,1,0,1,2,1,1,1,0,0,2,2,0,22,EL
9fd158d6,0,0,0,0,0,0,0,0,1,1,0,0,0,4,0,22,EL
9fec8860,6,3,5,1,0,4,4,0,1,0,1,2,8,1,0,22,EL
a0415710,4,2,2,1,1,1,2,1,3,0,3,1,5,3,0,22,EL
a08b974a,5,2,1,4,0,3,6,3,4,0,4,3,8,2,0,22,EL
a0d55a09,2,0,1,1,0,1,1,0,0,0,0,0,2,0,0,22,EL
a111cf41,0,0,0,0,0,0,0,0,0,0,0,0,0,3,1,22,EL
a11c995d,0,0,0,0,0,0,0,0,0,0,0,3,3,0,0,22,EL
a167537f,0,0,0,0,0,0,3,3,1,1,0,1,1,0,0,22,EL
a1c5b23e,7,3,5,2,0,2,5,3,5,1,4,0,7,4,0,22,EL
a26fb8aa,6,2,2,4,0,4,9,5,4,0,4,3,9,7,0,22,EL
a2950e2d,4,3,1,2,1,2,7,5,0,0,0,1,5,1,0,22,EL
a29e5244,0,0,0,0,0,0,1,1,4,2,2,2,2,4,0,22,EL
a2a85828,0,0,0,0,0,0,1,1,0,0,0,0,0,1,0,22,EL
a2abe631,1,0,1,0,0,1,2,1,0,0,0,0,1,2,0,22,EL
a36524bf,23,14,12,11,0,15,18,3,28,12,16,20,43,25,1,22,EL
a3b0ed18,0,0,0,0,0,0,0,0,0,0,0,0,0,3,0,22,EL
a3eabee0,9,5,4,3,2,6,11,5,3,1,2,2,11,8,0,22,EL
a4effc55,3,0,1,2,0,1,1,0,0,0,0,4,7,2,0,22,EL
a5296e55,5,4,2,3,0,0,4,4,3,0,3,0,5,2,0,22,EL
a5549ec1,16,11,9,3,4,6,13,7,5,0,5,16,32,10,0,22,EL
a55d8df5,18,13,5,11,2,9,30,21,6,1,5,6,24,8,1,22,EL
a5db0bec,7,5,5,1,1,1,5,4,8,0,8,3,10,0,0,22,EL
a5f5d094,3,3,3,0,0,2,2,0,2,1,1,7,10,8,0,22,EL
a65ce836,1,1,0,1,0,0,3,3,2,0,2,4,5,1,0,22,EL
a671316d,1,0,0,1,0,0,3,3,2,0,2,0,1,2,0,22,EL
a69e4806,2,1,2,0,0,0,2,2,5,0,5,2,4,5,0,22,EL
a6de370d,7,3,3,4,0,4,11,7,6,1,5,2,9,1,0,22,EL
a712ca2b,11,9,6,5,0,4,9,5,5,4,1,6,17,15,1,22,EL
a7220785,6,2,5,0,1,1,3,2,0,0,0,2,8,2,0,22,EL
a72c139d,6,2,5,0,1,4,5,1,3,2,1,6,12,12,0,22,EL
a73c8f95,9,7,7,2,0,7,13,6,6,4,2,7,16,11,0,22,EL
a802405e,1,1,0,1,0,0,1,1,2,0,2,1,2,2,0,22,EL
a81dba8c,3,1,0,2,1,0,8,8,2,0,2,1,4,1,0,22,EL
a8567629,7,6,4,3,0,2,3,1,3,0,3,3,10,3,0,22,EL
a8b8af8d,4,3,4,0,0,3,3,0,3,2,1,3,7,20,0,22,EL
a8ee54ad,24,12,11,11,2,13,31,18,13,2,11,15,39,12,0,22,EL
a8fbae1d,12,9,8,4,0,7,14,7,11,6,5,20,32,51,0,22,EL
a9142dc3,2,0,1,1,0,1,2,1,5,1,4,0,2,0,0,22,EL
a952a529,0,0,0,0,0,0,0,0,0,0,0,0,0,1,0,22,EL
a99138af,11,6,4,5,2,3,16,13,6,2,4,5,16,7,0,22,EL
a9a3b55d,0,0,0,0,0,0,1,1,0,0,0,0,0,4,0,22,EL
a9aa0d1d,0,0,0,0,0,0,0,0,2,0,2,0,0,0,0,22,EL
aa34ed38,4,3,2,2,0,2,6,4,4,0,4,1,5,4,1,22,EL
aa681ea5,3,3,1,2,0,0,1,1,0,0,0,3,6,0,0,22,EL
aa8e289e,8,3,2,5,1,2,11,9,2,0,2,1,9,0,0,22,EL
aaf1bf05,1,1,1,0,0,1,4,3,0,0,0,1,2,1,0,22,EL
ab2a6ae8,2,2,0,2,0,1,7,6,0,0,0,0,2,5,0,22,EL
abb3bb95,0,0,0,0,0,0,0,0,1,0,1,0,0,0,0,22,EL
ac05f970,8,6,0,4,4,4,10,6,9,2,7,1,9,2,0,22,EL
ac73ec79,0,0,0,0,0,0,0,0,0,0,0,0,0,0,0,22,EL
acf5410c,1,0,0,1,0,0,0,0,0,0,0,0,1,0,0,22,EL
ad3389d5,0,0,0,0,0,0,0,0,0,0,0,0,0,2,0,22,EL
ad81ba78,0,0,0,0,0,0,0,0,2,1,1,0,0,0,0,22,EL
ad82197c,9,6,4,5,0,6,13,7,6,4,2,5,14,12,1,22,EL
adfbe1f5,5,5,3,2,0,4,19,15,3,0,3,3,8,2,0,22,EL
adfc9123,5,4,4,1,0,4,4,0,4,0,4,6,11,5,0,22,EL
ae0a7ddf,17,5,7,8,2,6,10,4,2,0,2,8,25,4,0,22,EL
ae44e8e2,6,5,1,3,2,2,5,3,3,1,2,2,8,1,0,22,EL
ae59b359,6,4,0,4,2,2,4,2,5,1,4,3,9,2,0,22,EL
aeed5c06,5,2,1,3,1,3,9,6,1,0,1,2,7,0,0,22,EL
af3ddb2e,1,0,0,1,0,1,3,2,1,0,1,0,1,2,0,22,EL
af50141d,7,5,5,2,0,3,13,10,1,0,1,0,7,3,0,22,EL
afb0c500,0,0,0,0,0,0,0,0,0,0,0,0,0,2,1,22,EL
b088363d,3,3,2,0,1,2,2,0,2,2,0,0,3,8,0,22,EL
b088d5d3,5,4,4,1,0,4,6,2,1,0,1,3,8,8,0,22,EL
b0b902c8,1,0,1,0,0,0,1,1,0,0,0,0,1,2,0,22,EL
b105919e,1,1,0,0,1,1,3,2,2,1,1,1,2,1,0,22,EL
b1313ec4,11,7,4,4,3,4,12,8,11,1,10,9,20,5,0,22,EL
b182a240,1,0,1,0,0,0,2,2,2,1,1,4,5,1,0,22,EL
b19db005,0,0,0,0,0,0,3,3,2,1,1,0,0,0,0,22,EL
b1cd37e6,13,5,7,3,3,4,28,24,15,0,15,10,23,10,0,22,EL
b2a81fc6,0,0,0,0,0,0,0,0,2,0,2,1,1,0,0,22,EL
b34c63a5,5,3,2,2,1,3,5,2,2,0,2,3,8,0,0,22,EL
b391383a,4,3,2,2,0,3,3,0,0,0,0,0,4,5,0,22,EL
b3aed40d,1,1,0,0,1,0,0,0,0,0,0,0,1,4,0,22,EL
b3b7f5a6,4,3,0,3,1,4,9,5,2,0,2,2,6,4,0,22,EL
b3dc6eca,1,0,0,1,0,0,0,0,4,3,1,0,1,5,0,22,EL
b4705807,3,3,3,0,0,1,1,0,2,1,1,4,7,8,0,22,EL
b483167a,4,2,2,1,1,3,5,2,3,0,3,0,4,0,0,22,EL
b4a014b1,2,1,1,0,1,1,1,0,1,1,0,1,3,3,0,22,EL
b5920350,6,2,2,2,2,2,5,3,3,1,2,4,10,0,0,22,EL
b5f66351,11,5,3,4,4,9,13,4,4,1,3,6,17,5,0,22,EL
b648463f,3,2,2,1,0,3,3,0,1,0,1,1,4,6,0,22,EL
b682dcf6,6,4,6,0,0,3,6,3,8,5,3,10,16,22,0,22,EL
b69dfb42,1,1,1,0,0,1,2,1,1,0,1,1,2,0,1,22,EL
b742cc0d,5,3,3,2,0,4,7,3,5,4,1,7,12,9,0,22,EL
b77706dd,0,0,0,0,0,0,0,0,0,0,0,0,0,0,0,22,EL
b79d8e93,1,1,1,0,0,1,3,2,4,3,1,3,4,9,0,22,EL
b825a650,13,5,5,7,1,3,6,3,3,2,1,10,23,3,1,22,EL
b827d5b3,7,3,2,4,1,5,5,0,0,0,0,1,8,3,0,22,EL
b9139383,0,0,0,0,0,0,0,0,0,0,0,0,0,1,0,22,EL
b9392438,6,3,2,3,1,0,3,3,5,2,3,1,7,2,0,22,EL
b96b595c,5,3,3,1,1,2,4,2,4,3,1,8,13,12,0,22,EL
b997c3de,12,5,8,4,0,8,18,10,3,2,1,5,17,7,0,22,EL
ba3d3bea,8,7,6,2,0,5,13,8,5,2,3,4,12,5,0,22,EL
bab440b1,2,2,2,0,0,2,5,3,2,0,2,0,2,5,0,22,EL
bafcf742,9,7,5,2,2,4,12,8,11,2,9,4,13,13,0,22,EL
bbd74918,15,12,8,7,0,9,22,13,8,2,6,8,23,11,0,22,EL
bbd86530,3,2,3,0,0,2,4,2,0,0,0,0,3,1,0,22,EL
bbf5c11b,0,0,0,0,0,0,1,1,1,0,1,0,0,2,0,22,EL
bcb2ccd8,0,0,0,0,0,0,0,0,0,0,0,0,0,1,0,22,EL
bccc1bb4,3,3,0,2,1,1,3,2,2,0,2,3,6,0,0,22,EL
bced0375,14,11,8,6,0,7,10,3,3,0,3,7,21,3,0,22,EL
bd142efb,12,5,9,3,0,4,8,4,5,4,1,12,24,34,0,22,EL
bd20f4eb,4,3,4,0,0,2,3,1,0,0,0,1,5,4,0,22,EL
bd3fb505,0,0,0,0,0,0,5,5,2,0,2,0,0,0,0,22,EL
bd69355b,1,1,0,0,1,1,3,2,2,0,2,12,13,16,0,22,EL
be6a794c,2,1,0,1,1,0,4,4,5,0,5,1,3,4,0,22,EL
be765073,23,15,10,8,5,13,22,9,21,5,16,19,42,35,0,22,EL
be84c466,2,1,0,1,1,2,4,2,2,0,2,0,2,0,0,22,EL
be855308,0,0,0,0,0,0,0,0,0,0,0,0,0,0,0,22,EL
bec8a4ba,1,1,0,1,0,0,0,0,1,1,0,2,3,4,0,22,EL
bece776f,8,5,0,4,4,2,5,3,6,0,6,1,9,0,0,22,EL
bee0bab1,9,4,4,3,2,4,5,1,1,0,1,4,13,0,0,22,EL
bf12926c,1,1,1,0,0,0,1,1,6,1,5,0,1,2,0,22,EL
bf34eebd,2,1,0,1,1,1,2,1,0,0,0,0,2,0,0,22,EL
bf80db4d,3,3,3,0,0,2,5,3,8,7,1,1,4,29,1,22,EL
c01f247a,2,1,1,1,0,1,2,1,0,0,0,3,5,3,0,22,EL
c067631c,5,1,5,0,0,4,5,1,2,1,1,3,8,6,0,22,EL
c06d1086,1,0,1,0,0,0,0,0,3,0,3,0,1,5,0,22,EL
c08fc464,9,3,1,6,2,3,8,5,4,1,3,2,11,0,0,22,EL
c0c7ff58,6,3,4,1,1,4,12,8,6,1,5,11,17,4,0,22,EL
c1b7847c,11,7,8,3,0,8,19,11,9,0,9,3,14,4,0,22,EL
c1febb46,4,1,3,1,0,0,2,2,0,0,0,3,7,2,0,22,EL
c283ddef,1,0,0,0,1,0,2,2,4,0,4,0,1,2,0,22,EL
c459a650,5,3,1,2,2,2,4,2,1,0,1,2,7,1,0,22,EL
c4987edc,10,7,6,4,0,6,9,3,2,2,0,3,13,11,0,22,EL
c50e5bba,10,7,7,2,1,3,4,1,2,0,2,4,14,6,0,22,EL
c56dc39e,6,4,2,4,0,6,8,2,2,0,2,5,11,1,0,22,EL
c5adc293,2,0,0,0,2,1,1,0,0,0,0,0,2,0,0,22,EL
c603091a,0,0,0,0,0,0,1,1,1,0,1,1,1,2,0,22,EL
c63f6e46,0,0,0,0,0,0,1,1,2,0,2,0,0,0,0,22,EL
c68da769,12,7,5,6,1,1,20,19,11,4,7,4,16,6,0,22,EL
c6e5d20f,13,9,6,5,2,7,19,12,11,3,8,19,32,22,0,22,EL
c707411f,7,4,3,3,1,3,5,2,4,2,2,3,10,22,0,22,EL
c7842dab,9,3,4,4,1,8,11,3,6,0,6,5,14,1,1,22,EL
c8160af7,0,0,0,0,0,0,2,2,1,0,1,1,1,0,0,22,EL
c8a953f6,0,0,0,0,0,0,1,1,0,0,0,0,0,0,0,22,EL
c8c60119,17,9,12,4,1,10,13,3,8,3,5,12,29,33,0,22,EL
c8e65157,0,0,0,0,0,0,0,0,2,1,1,2,2,14,0,22,EL
c904f3d5,1,0,1,0,0,1,2,1,0,0,0,0,1,4,0,22,EL
c906ce0f,4,2,3,1,0,3,4,1,4,3,1,1,5,13,1,22,EL
c924b17d,1,0,1,0,0,1,1,0,0,0,0,0,1,4,0,22,EL
c9280e51,2,1,0,2,0,2,3,1,1,0,1,0,2,6,0,22,EL
c92c24f0,6,3,5,1,0,4,4,0,8,5,3,4,10,20,0,22,EL
c92e1a31,2,1,1,1,0,1,3,2,0,0,0,1,3,1,0,22,EL
ca45605e,0,0,0,0,0,0,1,1,5,0,5,0,0,1,0,22,EL
ca8033cb,16,9,7,9,0,5,8,3,6,1,5,6,22,8,0,22,EL
caaf2ed1,3,2,1,2,0,1,4,3,10,2,8,3,6,5,0,22,EL
cabb3a1d,8,6,4,2,2,8,11,3,1,1,0,7,15,4,0,22,EL
cb4f24c6,0,0,0,0,0,0,0,0,0,0,0,0,0,4,0,22,EL
cbbfa2e7,2,1,1,1,0,1,6,5,3,0,3,3,5,5,0,22,EL
cc1c5035,0,0,0,0,0,0,0,0,0,0,0,0,0,1,1,22,EL
cc588cbe,2,2,0,1,1,0,8,8,2,0,2,10,12,1,0,22,EL
cc77354e,9,3,1,5,3,4,6,2,4,1,3,6,15,4,0,22,EL
ccbbe661,0,0,0,0,0,0,1,1,1,0,1,1,1,2,0,22,EL
ccbf1b54,1,0,1,0,0,1,1,0,0,0,0,0,1,0,0,22,EL
cd59b9df,0,0,0,0,0,0,0,0,0,0,0,0,0,0,0,22,EL
cd6a1a59,21,14,13,7,1,9,24,15,14,4,10,22,43,13,0,22,EL
cdafb19d,11,5,6,4,1,6,14,8,4,1,3,5,16,6,0,22,EL
ce17b5eb,1,1,1,0,0,0,0,0,0,0,0,1,2,8,0,22,EL
ce4246f5,5,4,5,0,0,2,3,1,7,7,0,8,13,35,0,22,EL
cf007308,9,8,1,2,6,4,10,6,4,1,3,2,11,4,0,22,EL
cf15bbb1,9,4,4,4,1,4,12,8,5,0,5,4,13,9,1,22,EL
cf1ef7ec,2,1,1,1,0,2,2,0,4,1,3,2,4,10,0,22,EL
cf623c78,3,3,2,1,0,3,5,2,1,1,0,0,3,0,0,22,EL
cf8ef0a1,5,1,3,1,1,3,9,6,8,0,8,7,12,3,0,22,EL
d01bbb6f,2,0,1,1,0,0,2,2,3,0,3,0,2,1,0,22,EL
d080ed5e,17,8,4,11,2,7,18,11,8,1,7,4,21,16,1,22,EL
d0d98611,0,0,0,0,0,0,0,0,0,0,0,0,0,0,0,22,EL
d189e48f,0,0,0,0,0,0,0,0,0,0,0,0,0,1,0,22,EL
d1943c8b,5,3,5,0,0,2,6,4,5,4,1,7,12,20,0,22,EL
d1a08b5a,0,0,0,0,0,0,0,0,0,0,0,0,0,1,0,22,EL
d1bf91e0,1,0,1,0,0,1,1,0,3,1,2,0,1,0,0,22,EL
d1eda5f0,2,0,1,1,0,2,3,1,0,0,0,0,2,1,0,22,EL
d2416c2e,0,0,0,0,0,0,2,2,0,0,0,0,0,2,0,22,EL
d2795011,2,2,2,0,0,1,4,3,2,0,2,1,3,2,0,22,EL
d2800f47,3,3,0,3,0,1,3,2,1,0,1,1,4,0,0,22,EL
d2a83712,1,1,1,0,0,1,4,3,0,0,0,0,1,0,0,22,EL
d2d74d9c,3,2,1,1,1,1,3,2,1,0,1,0,3,1,0,22,EL
d32daf5d,0,0,0,0,0,0,5,5,0,0,0,1,1,0,0,22,EL
d3de9af0,1,1,0,0,1,0,0,0,2,1,1,0,1,1,0,22,EL
d4133fa1,4,2,2,2,0,2,6,4,5,1,4,11,15,6,0,22,EL
d4535821,5,2,2,2,1,4,5,1,3,3,0,6,11,10,0,22,EL
d4aa40b8,4,3,2,2,0,3,3,0,1,0,1,0,4,2,0,22,EL
d4e93bab,1,1,1,0,0,0,1,1,2,0,2,2,3,0,0,22,EL
d504b3e1,0,0,0,0,0,0,0,0,0,0,0,0,0,0,0,22,EL
d5127c3f,4,4,2,1,1,1,10,9,2,0,2,4,8,1,0,22,EL
d51d1d9d,7,3,6,0,1,4,7,3,2,1,1,5,12,10,0,22,EL
d56b9520,9,6,6,3,0,7,11,4,8,2,6,2,11,8,1,22,EL
d571df78,1,0,0,1,0,0,2,2,1,0,1,0,1,2,0,22,EL
d5dd5f1f,2,1,0,0,2,1,4,3,3,0,3,1,3,3,0,22,EL
d6a889ea,4,1,2,2,0,3,3,0,2,1,1,3,7,2,0,22,EL
d6f6ce93,0,0,0,0,0,0,0,0,0,0,0,0,0,0,0,22,EL
d7c09951,4,3,3,1,0,1,7,6,12,5,7,6,10,10,0,22,EL
d7f99582,0,0,0,0,0,0,1,1,3,0,3,1,1,1,0,22,EL
d810c13b,12,9,6,6,0,8,18,10,8,2,6,11,23,18,0,22,EL
d85c238b,9,6,1,6,2,4,5,1,8,1,7,2,11,2,0,22,EL
d87e2cae,0,0,0,0,0,0,0,0,2,0,2,1,1,3,0,22,EL
d8feae4a,1,0,0,1,0,0,1,1,0,0,0,0,1,5,0,22,EL
d9764034,9,4,7,2,0,6,9,3,5,5,0,12,21,20,0,22,EL
d97cccc9,17,10,7,8,2,5,11,6,8,2,6,12,29,11,0,22,EL
d9ba39fc,1,1,1,0,0,1,2,1,0,0,0,4,5,3,0,22,EL
da7f2781,14,8,11,1,2,5,15,10,14,3,11,11,25,26,0,22,EL
da974c7b,14,7,10,4,0,8,12,4,6,4,2,4,18,22,0,22,EL
dae8623e,3,0,0,1,2,2,2,0,1,1,0,0,3,4,0,22,EL
db3cb6ee,0,0,0,0,0,0,0,0,0,0,0,0,0,1,0,22,EL
db4ed67b,4,2,0,4,0,2,8,6,2,0,2,3,7,1,0,22,EL
db90b737,15,8,8,7,0,10,19,9,12,2,10,6,21,18,0,22,EL
dbd3a428,9,3,3,3,3,5,8,3,5,0,5,1,10,1,0,22,EL
dc234f98,8,7,6,1,1,5,7,2,3,3,0,12,20,28,0,22,EL
dc38e3bc,0,0,0,0,0,0,0,0,0,0,0,0,0,0,0,22,EL
dc3fa3b5,14,8,10,3,1,5,14,9,3,2,1,2,16,4,0,22,EL
dccd127f,0,0,0,0,0,0,0,0,0,0,0,2,2,3,0,22,EL
dcfb17f4,5,3,0,3,2,4,7,3,3,0,3,3,8,2,0,22,EL
dda3969e,2,1,1,0,1,0,1,1,1,0,1,0,2,8,0,22,EL
ddc5a43e,1,0,0,0,1,1,1,0,0,0,0,0,1,0,0,22,EL
de8f6250,0,0,0,0,0,0,0,0,1,0,1,0,0,0,0,22,EL
dee86451,8,2,2,6,0,2,6,4,3,0,3,6,14,6,0,22,EL
dfb50e5c,1,0,0,1,0,1,1,0,1,0,1,0,1,0,0,22,EL
e0b113a7,5,3,2,3,0,1,2,1,9,4,5,4,9,10,0,22,EL
e0bc6fdc,8,6,4,4,0,4,5,1,8,1,7,4,12,17,0,22,EL
e0f613ad,4,2,2,2,0,3,6,3,4,3,1,6,10,9,0,22,EL
e0f8151c,10,5,6,4,0,5,7,2,9,5,4,9,19,27,0,22,EL
e12b0b5b,6,5,3,3,0,2,11,9,5,0,5,3,9,2,0,22,EL
e162b013,2,1,2,0,0,1,1,0,0,0,0,1,3,0,0,22,EL
e1cbb531,6,2,4,2,0,2,3,1,1,0,1,1,7,0,0,22,EL
e1e75690,0,0,0,0,0,0,0,0,0,0,0,0,0,0,0,22,EL
e23f56c1,0,0,0,0,0,0,1,1,0,0,0,0,0,0,0,22,EL
e2716bd0,2,1,0,2,0,1,3,2,0,0,0,0,2,0,0,22,EL
e28245d9,6,5,2,3,1,4,12,8,7,0,7,6,12,1,0,22,EL
e34e086c,0,0,0,0,0,0,0,0,0,0,0,0,0,0,0,22,EL
e373f1ec,10,4,5,4,1,6,9,3,2,0,2,4,14,3,0,22,EL
e3cceee6,13,7,5,8,0,8,8,0,11,6,5,12,25,24,0,22,EL
e426b012,2,2,2,0,0,1,2,1,4,3,1,2,4,10,0,22,EL
e45ee4bc,2,1,2,0,0,0,3,3,4,1,3,5,7,5,0,22,EL
e4ba67f2,0,0,0,0,0,0,0,0,0,0,0,0,0,0,0,22,EL
e4eea72d,0,0,0,0,0,0,0,0,0,0,0,1,1,0,0,22,EL
e53b5534,6,3,4,2,0,3,4,1,7,4,3,9,15,43,0,22,EL
e5711bd9,4,2,2,2,0,2,4,2,3,2,1,4,8,4,0,22,EL
e599253a,2,2,0,2,0,0,0,0,3,1,2,4,6,1,0,22,EL
e717705a,3,2,1,2,0,0,2,2,4,0,4,2,5,0,0,22,EL
e726e11e,15,7,11,3,1,7,9,2,7,3,4,5,20,9,0,22,EL
e73659d3,1,0,0,1,0,1,1,0,1,0,1,0,1,1,0,22,EL
e75dc411,2,2,0,2,0,2,10,8,2,0,2,2,4,7,0,22,EL
e76cb9cc,7,4,3,4,0,3,6,3,1,1,0,6,13,12,0,22,EL
e7986081,1,0,0,0,1,1,2,1,4,0,4,0,1,8,0,22,EL
e7d59f4f,1,0,0,0,1,0,2,2,1,0,1,0,1,0,0,22,EL
e7e0736b,0,0,0,0,0,0,1,1,0,0,0,1,1,0,0,22,EL
e7ef333b,3,2,1,2,0,2,3,1,3,2,1,6,9,27,0,22,EL
e7fcf289,1,0,0,1,0,0,4,4,5,0,5,1,2,0,0,22,EL
e82adcab,15,11,8,6,1,7,12,5,10,1,9,5,20,2,0,22,EL
e872ca65,4,3,2,1,1,0,4,4,4,0,4,1,5,3,0,22,EL
e8796ba6,10,7,3,7,0,2,14,12,4,0,4,5,15,1,0,22,EL
e8dcb664,2,1,1,1,0,1,4,3,1,0,1,0,2,1,0,22,EL
e8ef59da,2,1,1,0,1,1,3,2,1,0,1,2,4,0,0,22,EL
e90dc1d5,6,4,2,2,2,0,1,1,1,0,1,2,8,4,0,22,EL
e92cd3f7,2,2,2,0,0,0,0,0,1,0,1,0,2,0,0,22,EL
e9b0ccaf,5,3,2,3,0,2,7,5,3,0,3,1,6,1,0,22,EL
ea0893d6,4,4,1,2,1,0,1,1,1,0,1,1,5,1,0,22,EL
ea76b7e8,2,1,1,1,0,1,1,0,1,0,1,1,3,5,0,22,EL
ea770abf,14,13,9,5,0,6,7,1,5,5,0,9,23,29,1,22,EL
ea83bfa6,0,0,0,0,0,0,0,0,0,0,0,0,0,0,1,22,EL
ead61f73,7,4,5,1,1,3,9,6,5,1,4,7,14,8,0,22,EL
eadc8e4f,4,4,2,2,0,2,8,6,3,1,2,6,10,11,0,22,EL
eaeefc50,1,0,0,1,0,0,0,0,0,0,0,1,2,0,0,22,EL
eb2fe5b6,2,0,0,1,1,2,4,2,1,0,1,0,2,2,1,22,EL
eb6e14be,4,3,0,1,3,2,3,1,7,1,6,0,4,5,0,22,EL
eb907bfc,2,0,1,1,0,0,2,2,4,0,4,3,5,0,0,22,EL
eba42d2b,3,2,0,3,0,2,3,1,0,0,0,1,4,1,0,22,EL
ecc10d95,5,4,2,2,1,3,8,5,2,0,2,1,6,0,0,22,EL
ed1cc44a,9,4,6,2,1,7,10,3,5,3,2,3,12,27,0,22,EL
ed45c4a5,13,7,5,3,5,5,13,8,7,1,6,5,18,3,0,22,EL
ed87a229,5,2,2,2,1,3,8,5,7,0,7,3,8,3,0,22,EL
ed90babd,5,4,1,3,1,1,2,1,0,0,0,0,5,0,0,22,EL
ee38d9c5,4,2,0,3,1,0,2,2,4,0,4,3,7,2,0,22,EL
ee45fd85,3,2,0,3,0,2,3,1,3,1,2,2,5,1,0,22,EL
ee926a02,7,4,3,2,2,3,12,9,6,3,3,4,11,5,0,22,EL
ee950928,8,5,4,3,1,3,9,6,3,0,3,4,12,0,0,22,EL
eed332df,1,1,0,1,0,1,4,3,1,1,0,0,1,5,0,22,EL
ef322658,8,6,4,2,2,4,12,8,3,1,2,5,13,6,0,22,EL
ef3909cd,1,1,1,0,0,1,1,0,1,0,1,0,1,15,0,22,EL
ef619b0b,2,1,0,1,1,2,2,0,0,0,0,0,2,0,0,22,EL
ef88f778,4,2,0,4,0,0,5,5,9,1,8,0,4,7,0,22,EL
ef8cafeb,0,0,0,0,0,0,0,0,0,0,0,0,0,0,0,22,EL
efc33b33,0,0,0,0,0,0,0,0,0,0,0,1,1,7,0,22,EL
f00de885,0,0,0,0,0,0,0,0,0,0,0,0,0,4,0,22,EL
f014e1bd,12,9,6,6,0,4,8,4,9,7,2,5,17,35,0,22,EL
f04a3092,0,0,0,0,0,0,0,0,0,0,0,0,0,0,0,22,EL
f090a37a,1,1,0,1,0,1,1,0,0,0,0,1,2,0,0,22,EL
f0e3b343,0,0,0,0,0,0,2,2,0,0,0,0,0,0,0,22,EL
f11b1937,0,0,0,0,0,0,0,0,0,0,0,0,0,1,0,22,EL
f17ba2da,2,1,0,2,0,1,1,0,2,1,1,0,2,2,0,22,EL
f201798c,2,1,0,1,1,1,3,2,3,2,1,0,2,1,0,22,EL
f28474a4,5,4,4,0,1,4,7,3,6,1,5,4,9,11,0,22,EL
f28659fb,9,3,4,2,3,3,22,19,12,0,12,7,16,3,0,22,EL
f2d063ec,2,2,1,1,0,1,6,5,5,2,3,3,5,9,0,22,EL
f2de3a43,4,1,1,3,0,3,6,3,2,0,2,4,8,4,0,22,EL
f36d5624,0,0,0,0,0,0,0,0,0,0,0,0,0,0,0,22,EL
f3945e07,3,2,1,2,0,2,2,0,1,1,0,0,3,2,0,22,EL
f3a97d02,0,0,0,0,0,0,1,1,0,0,0,0,0,5,0,22,EL
f3fa599d,8,5,3,4,1,1,4,3,6,2,4,5,13,9,1,22,EL
f4d60499,12,5,3,8,1,8,22,14,6,1,5,6,18,3,0,22,EL
f4d8ce5a,8,4,4,3,1,3,4,1,1,0,1,1,9,3,0,22,EL
f533776b,10,7,5,5,0,5,7,2,10,4,6,5,15,7,0,22,EL
f5e7fdf9,24,14,12,8,4,10,18,8,9,3,6,6,30,24,0,22,EL
f6798fc3,0,0,0,0,0,0,0,0,0,0,0,0,0,2,0,22,EL
f719fae8,0,0,0,0,0,0,2,2,6,4,2,3,3,6,0,22,EL
f7223718,3,1,3,0,0,2,3,1,4,2,2,5,8,6,0,22,EL
f7a3ec21,0,0,0,0,0,0,0,0,0,0,0,0,0,0,0,22,EL
f7dc2ae5,9,5,9,0,0,3,4,1,9,6,3,11,20,25,0,22,EL
f804cfd9,1,1,0,0,1,0,0,0,0,0,0,2,3,0,0,22,EL
f80d03ca,0,0,0,0,0,0,0,0,0,0,0,0,0,0,0,22,EL
f81ef10d,20,13,6,13,1,12,28,16,4,0,4,9,29,3,0,22,EL
f820504e,11,6,7,4,0,5,14,9,5,4,1,14,25,22,0,22,EL
f874dd44,1,1,0,1,0,1,3,2,0,0,0,4,5,9,0,22,EL
f8817892,3,2,2,1,0,0,0,0,12,9,3,8,11,22,1,22,EL
f8fcd2a5,3,2,3,0,0,2,3,1,7,6,1,7,10,10,0,22,EL
f9dfb7ae,8,6,7,1,0,6,10,4,5,3,2,3,11,12,0,22,EL
f9e0c603,0,0,0,0,0,0,0,0,0,0,0,0,0,3,1,22,EL
f9edc384,1,0,0,0,1,1,1,0,0,0,0,0,1,1,0,22,EL
fa274d97,6,4,2,2,2,5,6,1,4,0,4,0,6,2,0,22,EL
fa661778,5,4,3,2,0,4,6,2,1,1,0,2,7,2,0,22,EL
faf55ce4,2,1,1,1,0,2,3,1,1,1,0,0,2,4,0,22,EL
fb22f7a0,1,0,1,0,0,1,2,1,0,0,0,0,1,0,0,22,EL
fb46125f,2,0,1,0,1,1,3,2,4,2,2,4,6,1,0,22,EL
fb485406,5,3,2,2,1,1,7,6,4,0,4,0,5,1,0,22,EL
fb5022e4,0,0,0,0,0,0,1,1,0,0,0,0,0,0,0,22,EL
fb938d24,1,1,1,0,0,0,4,4,2,0,2,2,3,0,0,22,EL
fbbb9269,6,1,3,3,0,4,5,1,7,5,2,3,9,13,0,22,EL
fc027d02,9,7,3,4,2,7,9,2,2,1,1,5,14,4,0,22,EL
fc4e7637,5,4,2,2,1,0,4,4,6,0,6,7,12,1,0,22,EL
fc9b373e,4,2,1,2,1,2,5,3,1,0,1,3,7,0,0,22,EL
fcb27134,10,7,6,4,0,5,10,5,2,1,1,3,13,10,0,22,EL
fd4d5f81,6,6,0,4,2,3,3,0,2,0,2,0,6,0,0,22,EL
fd834d1d,0,0,0,0,0,0,1,1,0,0,0,0,0,1,0,22,EL
fd9c4805,1,1,1,0,0,0,0,0,4,0,4,1,2,0,0,22,EL
fdae8b47,3,2,2,1,0,2,7,5,2,0,2,1,4,13,0,22,EL
fdd85f94,0,0,0,0,0,0,0,0,1,1,0,1,1,1,0,22,EL
fdf3cb77,5,3,3,2,0,1,4,3,2,0,2,4,9,3,0,22,EL
fdf4b948,2,1,1,1,0,0,0,0,4,2,2,1,3,1,0,22,EL
fe012aca,1,1,0,0,1,1,2,1,2,0,2,0,1,0,0,22,EL
fe641c1a,6,3,1,5,0,3,3,0,1,0,1,2,8,7,0,22,EL
ff0ab48c,6,5,3,3,0,4,5,1,4,1,3,6,12,6,0,22,EL
ff527768,7,4,4,2,1,1,6,5,3,1,2,3,10,2,0,22,EL
ff800ed8,2,1,2,0,0,1,6,5,6,1,5,1,3,2,0,22,EL
ffec9769,2,1,0,2,0,2,3,1,2,0,2,0,2,1,0,22,EL
004d185e,21,14,13,7,1,7,28,21,30,1,29,12,33,12,0,22,SPA
0076ab7f,16,7,10,4,2,5,8,3,14,9,5,22,38,37,0,22,SPA
00b28772,56,32,24,26,6,18,49,31,42,13,29,71,127,41,0,22,SPA
01da7812,7,4,6,1,0,0,2,2,13,1,12,10,17,7,0,22,SPA
01eb744d,16,8,5,10,1,7,29,22,25,2,23,10,26,4,0,22,SPA
02319ad7,7,5,3,1,3,1,9,8,4,1,3,1,8,5,0,22,SPA
02c15616,51,23,25,22,4,28,43,15,33,10,23,27,78,44,0,22,SPA
02d2c436,9,5,9,0,0,5,8,3,5,3,2,16,25,34,0,22,SPA
02ef8778,15,11,6,7,2,6,17,11,12,3,9,6,21,42,1,22,SPA
03049c8c,27,17,14,12,1,11,31,20,20,10,10,15,42,26,1,22,SPA
030ef8d6,1,1,0,0,1,1,1,0,0,0,0,0,1,0,0,22,SPA
036bba5f,41,20,14,24,3,22,45,23,10,2,8,13,54,14,0,22,SPA
037dbd30,28,18,16,7,5,17,34,17,11,5,6,19,47,33,1,22,SPA
04965583,31,25,17,9,5,19,39,20,19,6,13,25,56,35,2,22,SPA
04ac8285,0,0,0,0,0,0,1,1,0,0,0,1,1,6,0,22,SPA
04e17fd5,10,5,5,2,3,4,11,7,9,1,8,4,14,18,0,22,SPA
05439de2,23,13,15,6,2,9,19,10,26,15,11,22,45,70,1,22,SPA
056269d7,25,11,12,11,2,16,23,7,5,0,5,9,34,22,1,22,SPA
068f4dec,0,0,0,0,0,0,4,4,1,0,1,2,2,2,0,22,SPA
070a3904,45,22,16,19,10,18,54,36,16,1,15,26,71,32,1,22,SPA
0959c2a2,36,16,11,16,9,12,31,19,23,5,18,24,60,12,0,22,SPA
09a9e921,4,4,2,0,2,0,3,3,5,0,5,1,5,5,0,22,SPA
0a8fd9cb,3,1,0,3,0,2,4,2,0,0,0,3,6,2,0,22,SPA
0abc51f2,46,32,30,15,1,21,28,7,29,14,15,39,85,155,0,22,SPA
0ac94a23,14,5,6,1,7,6,15,9,9,1,8,9,23,9,0,22,SPA
0ae4e09a,23,14,3,13,7,8,30,22,14,0,14,2,25,8,0,22,SPA
0b2c8585,25,15,7,14,4,10,30,20,9,3,6,25,50,7,0,22,SPA
0b90bb97,27,17,8,15,4,5,32,27,28,2,26,6,33,22,0,22,SPA
0ba976e4,3,2,0,2,1,1,1,0,4,0,4,1,4,0,0,22,SPA
0bc4e720,10,3,2,5,3,4,14,10,7,0,7,0,10,5,0,22,SPA
0c2ac3cb,43,27,17,20,6,16,28,12,21,2,19,12,55,4,0,22,SPA
0c717ae6,0,0,0,0,0,0,0,0,1,1,0,1,1,0,1,22,SPA
0cadc46d,6,3,1,3,2,1,7,6,12,0,12,6,12,29,0,22,SPA
0cb29e91,24,11,4,19,1,8,14,6,16,4,12,9,33,11,0,22,SPA
0d9b2d31,20,12,9,8,3,7,20,13,13,0,13,5,25,7,1,22,SPA
0e4fef6e,71,40,25,38,8,29,57,28,32,11,21,47,118,55,0,22,SPA
0e50f929,7,3,5,2,0,4,10,6,1,0,1,6,13,1,0,22,SPA
0e5ddc7c,7,4,3,2,2,4,12,8,3,0,3,3,10,5,0,22,SPA
0ef89a37,6,3,3,3,0,3,11,8,3,0,3,4,10,3,0,22,SPA
10072610,0,0,0,0,0,0,0,0,0,0,0,0,0,6,2,22,SPA
106c142c,24,13,10,8,6,10,22,12,16,3,13,9,33,19,0,22,SPA
112521d1,58,30,38,14,6,26,57,31,25,7,18,25,83,92,2,22,SPA
11b9265b,13,7,5,7,1,5,18,13,13,1,12,27,40,15,0,22,SPA
11fd2b75,46,26,16,23,7,24,60,36,42,14,28,48,94,52,2,22,SPA
12c50af5,61,29,20,33,8,25,82,57,32,4,28,16,77,11,0,22,SPA
132ac341,12,9,10,2,0,3,13,10,11,9,2,20,32,71,0,22,SPA
15937e17,5,3,4,1,0,3,6,3,3,2,1,2,7,6,0,22,SPA
162efffd,55,30,22,25,8,30,60,30,24,3,21,21,76,17,2,22,SPA
16aa3654,31,19,12,14,5,10,24,14,24,3,21,8,39,4,0,22,SPA
16e9d0ea,76,40,53,15,8,33,60,27,28,6,22,34,110,82,1,22,SPA
174651c8,1,1,1,0,0,0,3,3,3,2,1,1,2,4,1,22,SPA
17a1299d,0,0,0,0,0,0,0,0,0,0,0,0,0,0,0,22,SPA
1827a42d,5,3,3,2,0,1,5,4,3,1,2,10,15,10,0,22,SPA
1840e36d,1,0,1,0,0,1,2,1,0,0,0,0,1,9,1,22,SPA
18abe173,39,26,28,10,1,17,31,14,23,13,10,38,77,96,3,22,SPA
18f0a9f0,0,0,0,0,0,0,0,0,0,0,0,0,0,0,0,22,SPA
19709006,20,14,7,11,2,6,15,9,9,1,8,16,36,13,1,22,SPA
19b776e9,29,18,12,10,7,6,36,30,22,1,21,23,52,18,0,22,SPA
19c36442,59,29,25,30,4,25,64,39,28,4,24,25,84,34,0,22,SPA
19cae58d,38,18,13,18,7,9,33,24,36,0,36,25,63,13,0,22,SPA
1bacc518,35,19,12,18,5,12,23,11,19,5,14,20,55,16,0,22,SPA
1bc432b7,1,0,0,0,1,0,3,3,0,0,0,0,1,0,0,22,SPA
1bda5842,16,7,2,6,8,3,19,16,21,3,18,7,23,8,0,22,SPA
1c2c55fc,19,9,15,4,0,8,16,8,20,14,6,13,32,59,1,22,SPA
1c5d79e2,1,1,1,0,0,1,1,0,1,0,1,0,1,0,1,22,SPA
1c96ad85,8,5,6,1,1,2,4,2,3,0,3,4,12,7,1,22,SPA
1ccd3dae,0,0,0,0,0,0,0,0,0,0,0,1,1,0,0,22,SPA
1daec722,0,0,0,0,0,0,0,0,0,0,0,0,0,0,0,22,SPA
1ea5f91c,11,7,5,5,1,10,17,7,4,0,4,4,15,7,0,22,SPA
1f079188,2,0,1,1,0,2,6,4,1,0,1,5,7,2,0,22,SPA
1f1c8a15,1,0,0,0,1,0,1,1,1,0,1,1,2,0,0,22,SPA
1f462f95,6,3,3,3,0,2,4,2,6,5,1,5,11,37,1,22,SPA
1fc474ae,9,3,4,4,1,3,5,2,7,2,5,4,13,14,0,22,SPA
1fe0492d,76,47,43,27,6,43,85,42,40,6,34,57,133,82,0,22,SPA
1fe67e86,33,24,15,15,3,25,43,18,27,4,23,21,54,79,0,22,SPA
200e89e1,15,10,9,6,0,8,18,10,7,0,7,2,17,2,0,22,SPA
21512407,22,12,12,5,5,12,21,9,12,1,11,10,32,11,0,22,SPA
228b0d9d,28,17,14,13,1,18,29,11,11,1,10,17,45,34,0,22,SPA
237a3851,8,6,1,3,4,0,10,10,6,1,5,3,11,4,0,22,SPA
240d3a0b,36,22,15,17,4,14,47,33,27,10,17,24,60,41,1,22,SPA
244bc2c8,8,6,3,4,1,2,5,3,6,1,5,5,13,4,0,22,SPA
253a06b9,17,7,6,7,4,7,21,14,14,2,12,13,30,15,1,22,SPA
2683eda7,24,14,18,5,1,12,37,25,18,2,16,11,35,24,0,22,SPA
274ab13c,39,23,24,15,0,25,42,17,26,19,7,30,69,168,3,22,SPA
2784f898,50,32,30,12,8,20,39,19,42,20,22,52,102,107,3,22,SPA
27a013f7,22,14,17,5,0,9,21,12,17,10,7,27,49,105,2,22,SPA
27dc1378,46,27,10,31,5,16,41,25,24,5,19,38,84,30,0,22,SPA
2946f9a1,18,14,9,9,0,12,22,10,22,15,7,34,52,50,0,22,SPA
29b61deb,26,18,4,20,2,7,21,14,10,1,9,6,32,11,0,22,SPA
2a0c8ba4,61,30,22,31,8,28,65,37,27,6,21,30,91,18,1,22,SPA
2a9f6b4d,2,1,0,1,1,0,1,1,2,0,2,1,3,1,0,22,SPA
2ad0e5e5,9,6,3,5,1,3,10,7,5,1,4,2,11,3,0,22,SPA
2ae30661,0,0,0,0,0,0,1,1,1,0,1,0,0,0,0,22,SPA
2bea832e,0,0,0,0,0,0,0,0,0,0,0,0,0,0,0,22,SPA
2bed3eab,27,18,13,13,1,11,26,15,22,12,10,44,71,53,3,22,SPA
2bef2bca,41,23,29,12,0,21,25,4,37,20,17,23,64,66,1,22,SPA
2c56a792,31,20,5,23,3,11,27,16,12,0,12,6,37,12,0,22,SPA
2dce876a,0,0,0,0,0,0,0,0,0,0,0,1,1,0,0,22,SPA
2fbe6af0,2,2,0,2,0,0,0,0,1,0,1,2,4,0,0,22,SPA
30061f53,0,0,0,0,0,0,0,0,0,0,0,0,0,0,0,22,SPA
3024e383,20,13,9,9,2,9,14,5,6,1,5,10,30,21,0,22,SPA
3061e1ec,0,0,0,0,0,0,0,0,0,0,0,0,0,2,0,22,SPA
31f5b89b,14,9,5,7,2,8,12,4,6,0,6,11,25,6,0,22,SPA
32974271,10,9,3,5,2,1,21,20,14,2,12,4,14,17,0,22,SPA
32c0491f,14,8,9,5,0,5,7,2,3,2,1,1,15,11,0,22,SPA
3318286e,3,1,3,0,0,3,6,3,0,0,0,1,4,16,2,22,SPA
335039a2,20,15,14,5,1,8,44,36,21,1,20,5,25,21,0,22,SPA
335fa267,5,1,2,3,0,3,5,2,2,0,2,4,9,6,0,22,SPA
3376a776,11,8,4,6,1,2,9,7,11,6,5,9,20,19,0,22,SPA
33a61a52,35,17,21,10,4,7,19,12,8,3,5,26,61,32,1,22,SPA
34269bdf,50,31,15,31,4,20,50,30,21,5,16,28,78,43,0,22,SPA
34caa4b3,9,4,3,5,1,4,16,12,9,0,9,4,13,6,0,22,SPA
34e393f2,97,53,46,45,6,54,98,44,55,12,43,31,128,56,0,22,SPA
3521abfe,4,1,4,0,0,4,6,2,2,1,1,4,8,21,0,22,SPA
355c883a,34,22,17,11,6,18,37,19,20,3,17,25,59,38,0,22,SPA
3594a357,7,3,2,2,3,4,8,4,3,0,3,2,9,2,0,22,SPA
35a6e5c7,5,4,0,4,1,3,12,9,2,0,2,4,9,1,0,22,SPA
35d4f151,6,1,4,2,0,4,7,3,0,0,0,2,8,4,0,22,SPA
360d70f8,3,2,3,0,0,3,5,2,0,0,0,2,5,2,0,22,SPA
3624ce4c,23,15,14,9,0,12,25,13,19,11,8,17,40,71,1,22,SPA
365113c0,12,6,10,2,0,4,8,4,7,2,5,4,16,8,2,22,SPA
3672b352,21,14,8,11,2,10,29,19,6,0,6,9,30,10,0,22,SPA
374d5158,15,4,8,5,2,12,24,12,8,2,6,10,25,22,0,22,SPA
374ee424,0,0,0,0,0,0,0,0,0,0,0,1,1,24,2,22,SPA
375ed9d7,1,1,0,1,0,0,0,0,0,0,0,1,2,3,0,22,SPA
379652be,11,5,4,4,3,3,13,10,4,1,3,1,12,10,0,22,SPA
37e103f8,25,19,11,13,1,15,38,23,24,2,22,4,29,20,1,22,SPA
37f1cf47,0,0,0,0,0,0,0,0,0,0,0,0,0,0,0,22,SPA
37f827ec,36,20,24,11,1,15,24,9,38,27,11,28,64,110,3,22,SPA
38126309,4,1,0,4,0,2,4,2,0,0,0,0,4,0,0,22,SPA
38699c72,8,4,2,3,3,5,18,13,16,2,14,2,10,7,0,22,SPA
38b0cf42,2,1,0,1,1,1,2,1,1,0,1,0,2,0,0,22,SPA
38ce1150,33,15,14,11,8,10,51,41,11,1,10,12,45,13,0,22,SPA
3902e91b,29,16,10,15,4,16,36,20,21,8,13,7,36,22,0,22,SPA
3a58d075,4,3,2,1,1,2,6,4,3,0,3,4,8,5,0,22,SPA
3a9c4b7b,83,47,49,25,9,39,77,38,32,14,18,58,141,79,0,22,SPA
3aa4a3be,7,5,2,3,2,1,13,12,11,1,10,2,9,9,0,22,SPA
3aa74860,0,0,0,0,0,0,0,0,0,0,0,0,0,0,0,22,SPA
3b3cbebb,0,0,0,0,0,0,0,0,0,0,0,0,0,0,0,22,SPA
3ca6106c,24,12,9,12,3,12,32,20,14,4,10,7,31,10,1,22,SPA
3cefcaef,24,14,11,10,3,8,14,6,8,2,6,18,42,27,3,22,SPA
3d688b46,6,3,3,2,1,3,7,4,7,3,4,4,10,6,1,22,SPA
3d7e48ce,33,15,21,10,2,15,44,29,12,0,12,8,41,17,0,22,SPA
3e42f707,28,14,15,11,2,12,22,10,27,21,6,52,80,168,0,22,SPA
3ecc11d8,24,14,15,8,1,10,18,8,21,16,5,45,69,97,0,22,SPA
3ee0dd59,52,25,19,30,3,22,44,22,30,13,17,49,101,48,1,22,SPA
3eed9821,2,2,2,0,0,1,2,1,1,1,0,0,2,4,0,22,SPA
3f10bd22,18,13,11,5,2,9,17,8,15,2,13,17,35,26,1,22,SPA
3f2d59fe,9,6,6,3,0,5,9,4,6,3,3,15,24,40,0,22,SPA
3f79a1c8,30,14,9,20,1,13,34,21,27,2,25,21,51,28,0,22,SPA
3fc45c73,28,13,18,7,3,14,23,9,22,10,12,39,67,143,0,22,SPA
405f267a,20,10,9,8,3,8,20,12,17,2,15,6,26,11,0,22,SPA
40883e3a,5,3,4,0,1,0,1,1,4,0,4,7,12,11,0,22,SPA
4112ace5,26,11,11,9,6,8,42,34,31,13,18,19,45,22,0,22,SPA
411fabd7,4,1,4,0,0,1,2,1,0,0,0,0,4,1,0,22,SPA
41b3069f,17,10,12,5,0,8,13,5,7,2,5,16,33,63,1,22,SPA
41c12f75,79,47,39,34,6,40,69,29,45,4,41,55,134,67,1,22,SPA
41f32541,24,17,14,9,1,12,33,21,21,13,8,29,53,32,2,22,SPA
42a028c5,7,4,2,4,1,4,5,1,1,0,1,3,10,1,0,22,SPA
43f71e77,4,2,2,1,1,2,18,16,13,2,11,6,10,11,0,22,SPA
44150beb,6,4,4,2,0,3,3,0,6,4,2,6,12,18,0,22,SPA
4442fbcd,3,2,2,1,0,0,1,1,2,0,2,2,5,1,0,22,SPA
452c3055,12,10,3,6,3,1,7,6,21,2,19,3,15,4,0,22,SPA
4535e4bb,0,0,0,0,0,0,0,0,0,0,0,0,0,2,0,22,SPA
45af8a54,12,8,6,4,2,4,18,14,8,1,7,12,24,6,1,22,SPA
45d96179,0,26,0,0,0,0,0,0,0,0,0,29,0,0,0,22,SPA
45e17712,36,17,17,15,4,21,35,14,21,4,17,30,66,51,0,22,SPA
45f771db,0,0,0,0,0,0,0,0,0,0,0,0,0,1,0,22,SPA
4601e194,47,34,12,26,9,27,47,20,26,6,20,33,80,41,1,22,SPA
466824fb,10,6,3,7,0,2,19,17,8,3,5,1,11,9,0,22,SPA
46a8347f,27,17,14,12,1,12,20,8,10,1,9,12,39,30,0,22,SPA
4737cebe,17,11,5,8,4,9,24,15,15,3,12,12,29,15,0,22,SPA
474ecac8,11,7,8,2,1,4,8,4,7,5,2,7,18,45,1,22,SPA
484ebdb0,5,3,2,1,2,4,9,5,1,0,1,1,6,1,0,22,SPA
487d9b09,21,14,13,7,1,11,17,6,5,3,2,17,38,34,0,22,SPA
4887118d,8,2,3,3,2,5,9,4,7,1,6,3,11,3,0,22,SPA
48e89655,9,4,5,3,1,3,8,5,5,1,4,2,11,3,0,22,SPA
4958bfb2,43,28,21,15,7,15,26,11,22,8,14,20,63,38,2,22,SPA
49d028db,25,19,15,8,2,17,24,7,17,11,6,23,48,82,0,22,SPA
49dbab27,42,28,20,19,3,18,59,41,31,3,28,13,55,22,0,22,SPA
4a478107,27,17,6,9,12,12,42,30,29,0,29,4,31,7,0,22,SPA
4a5f2032,0,0,0,0,0,0,0,0,1,0,1,1,1,3,1,22,SPA
4a633cfe,21,12,14,6,1,14,17,3,19,11,8,22,43,78,0,22,SPA
4aa253fd,6,4,2,3,1,1,8,7,2,0,2,1,7,0,0,22,SPA
4ac7608e,25,16,18,7,0,9,16,7,21,13,8,19,44,87,0,22,SPA
4accb7e0,35,22,19,14,2,14,40,26,25,8,17,25,60,15,0,22,SPA
4bd414c1,26,15,20,5,1,14,18,4,24,15,9,21,47,126,1,22,SPA
4c0a6a48,5,3,2,3,0,1,4,3,3,1,2,3,8,4,0,22,SPA
4c2e9442,5,3,1,2,2,5,8,3,5,1,4,3,8,22,0,22,SPA
4c2fa917,0,0,0,0,0,0,0,0,0,0,0,0,0,0,0,22,SPA
4c5b14d2,6,2,4,2,0,3,8,5,5,2,3,3,9,10,0,22,SPA
4cee5954,5,3,3,1,1,1,1,0,5,1,4,4,9,6,0,22,SPA
4d034881,1,1,0,0,1,0,2,2,0,0,0,0,1,0,0,22,SPA
4d1666ff,40,17,27,10,3,18,28,10,33,18,15,21,61,101,2,22,SPA
4d224fe8,79,51,45,30,4,30,67,37,65,19,46,38,117,65,3,22,SPA
4d753a3f,31,21,18,11,2,16,29,13,14,9,5,12,43,69,0,22,SPA
4d8cd038,1,1,0,1,0,0,1,1,3,0,3,1,2,4,0,22,SPA
4dbd0916,24,14,9,12,3,8,23,15,18,0,18,8,32,11,0,22,SPA
4e219ad2,4,3,1,3,0,3,13,10,4,0,4,0,4,0,0,22,SPA
4eae5bc4,0,0,0,0,0,0,0,0,0,0,0,0,0,0,0,22,SPA
4f28a6ff,20,11,11,7,2,8,13,5,7,3,4,13,33,21,0,22,SPA
505dce2b,0,0,0,0,0,0,0,0,0,0,0,0,0,0,0,22,SPA
5083a734,41,31,19,19,3,18,39,21,27,5,22,19,60,33,1,22,SPA
50cbc806,2,1,1,0,1,0,1,1,2,0,2,0,2,2,0,22,SPA
51a3c4c8,20,15,11,8,1,8,18,10,17,11,6,28,48,77,0,22,SPA
532e1e4f,32,19,23,7,2,18,25,7,32,23,9,19,51,105,2,22,SPA
53520a67,40,29,22,17,1,17,35,18,17,7,10,34,74,32,0,22,SPA
540ec57b,32,14,14,8,10,10,24,14,33,4,29,6,38,12,1,22,SPA
5496cc91,19,9,7,9,3,6,20,14,15,1,14,9,28,4,0,22,SPA
55126f3b,55,30,19,29,7,26,63,37,21,5,16,24,79,31,1,22,SPA
555f3a0b,30,15,23,4,3,20,38,18,18,3,15,29,59,49,2,22,SPA
56545648,5,4,3,2,0,4,6,2,5,0,5,1,6,1,0,22,SPA
57be54ec,4,3,2,1,1,1,2,1,3,1,2,1,5,7,0,22,SPA
58a9a4d9,22,12,8,7,7,8,25,17,10,1,9,6,28,4,0,22,SPA
58afe001,62,37,19,32,11,20,68,48,35,5,30,32,94,18,0,22,SPA
58bc7d18,0,0,0,0,0,0,1,1,0,0,0,1,1,2,2,22,SPA
592f3158,102,53,46,51,5,44,105,61,56,10,46,39,141,43,0,22,SPA
5976f83e,32,15,21,10,1,13,18,5,22,4,18,2,34,18,0,22,SPA
59b7d823,32,23,16,12,4,22,44,22,37,12,25,23,55,63,0,22,SPA
5a626448,15,7,8,3,4,5,17,12,5,0,5,6,21,6,0,22,SPA
5ab0ea87,93,49,31,48,14,46,83,37,44,8,36,45,138,31,0,22,SPA
5acc4a10,44,26,18,23,3,15,28,13,17,5,12,35,79,51,0,22,SPA
5ae499d0,87,56,45,33,9,40,104,64,46,6,40,33,120,30,0,22,SPA
5b28b2f6,36,22,23,9,4,26,44,18,11,4,7,10,46,21,0,22,SPA
5c2b4f07,14,9,11,2,1,4,7,3,14,7,7,11,25,25,0,22,SPA
5c4dc0ff,2,0,2,0,0,0,0,0,2,0,2,1,3,3,0,22,SPA
5c7845f6,20,10,12,8,0,12,18,6,16,6,10,27,47,53,0,22,SPA
5c96b017,43,26,12,23,8,16,49,33,31,4,27,24,67,16,0,22,SPA
5ca20b7a,31,22,20,8,3,16,22,6,14,4,10,13,44,35,0,22,SPA
5ccc9672,2,1,1,0,1,0,0,0,2,2,0,1,3,1,0,22,SPA
5ce0b5ba,9,5,5,3,1,1,10,9,5,1,4,4,13,12,0,22,SPA
5cec2487,20,12,11,7,2,15,26,11,6,0,6,11,31,20,0,22,SPA
5db04597,84,47,48,28,8,38,69,31,30,13,17,46,130,74,0,22,SPA
5dcf3e90,0,0,0,0,0,0,0,0,0,0,0,1,1,5,1,22,SPA
5e1028e5,73,41,35,22,16,33,77,44,38,2,36,21,94,19,0,22,SPA
5e95c000,7,4,4,2,1,5,8,3,5,3,2,3,10,3,0,22,SPA
5f0241b2,0,0,0,0,0,0,0,0,0,0,0,0,0,5,2,22,SPA
5f5501ed,6,3,3,2,1,4,7,3,3,0,3,3,9,0,0,22,SPA
5fa714d5,1,1,1,0,0,1,3,2,1,0,1,2,3,3,0,22,SPA
6025fab1,18,10,8,7,3,6,27,21,10,4,6,20,38,9,0,22,SPA
603116a7,8,4,2,3,3,5,10,5,7,2,5,1,9,11,0,22,SPA
605eb473,0,0,0,0,0,0,0,0,0,0,0,1,1,6,2,22,SPA
608f2092,46,25,34,7,5,23,31,8,22,3,19,25,71,61,3,22,SPA
61220da2,27,16,13,10,4,12,32,20,13,2,11,21,48,19,1,22,SPA
61b62b33,1,1,1,0,0,1,2,1,0,0,0,0,1,1,0,22,SPA
625c144a,0,0,0,0,0,0,4,4,0,0,0,1,1,15,5,22,SPA
6265208f,16,11,1,9,6,7,25,18,21,4,17,7,23,45,0,22,SPA
63b0ca6b,5,3,1,4,0,3,6,3,11,5,6,2,7,23,0,22,SPA
63f04c6c,34,16,17,12,5,10,28,18,12,3,9,31,65,32,0,22,SPA
64035864,0,0,0,0,0,0,0,0,0,0,0,0,0,1,0,22,SPA
647d39d2,2,1,2,0,0,1,3,2,0,0,0,0,2,5,0,22,SPA
64e8ed6d,7,5,2,3,2,1,2,1,10,4,6,4,11,3,0,22,SPA
66116290,2,1,0,1,1,1,4,3,4,1,3,2,4,11,0,22,SPA
6652cf96,52,35,27,20,5,25,46,21,33,9,24,19,71,33,2,22,SPA
66654daa,42,27,30,9,3,24,37,13,10,2,8,26,68,42,0,22,SPA
6763373d,7,3,1,5,1,2,15,13,6,0,6,1,8,7,0,22,SPA
67669ce7,0,0,0,0,0,0,1,1,0,0,0,0,0,4,0,22,SPA
683a1d81,0,0,0,0,0,0,0,0,0,0,0,0,0,1,0,22,SPA
697295b1,24,10,16,8,0,9,20,11,21,16,5,18,42,77,1,22,SPA
69c5633e,0,0,0,0,0,0,2,2,1,0,1,0,0,0,0,22,SPA
69cbc8b6,37,24,27,10,0,21,34,13,32,23,9,44,81,222,2,22,SPA
6a99e0b1,14,5,1,6,7,5,17,12,18,3,15,3,17,20,0,22,SPA
6c4776b1,3,1,3,0,0,3,4,1,0,0,0,1,4,21,4,22,SPA
6c7762c3,69,49,35,28,6,35,47,12,29,7,22,20,89,50,0,22,SPA
6c811eb7,27,19,11,13,3,9,48,39,21,2,19,15,42,16,0,22,SPA
6ce1f46f,34,26,13,17,4,14,36,22,16,3,13,12,46,13,1,22,SPA
6d8f8441,3,2,1,1,1,3,4,1,1,0,1,2,5,7,0,22,SPA
6e36226f,3,1,3,0,0,1,9,8,5,2,3,3,6,2,0,22,SPA
6e4df551,19,11,9,5,5,9,35,26,15,2,13,7,26,12,2,22,SPA
6eaed4eb,33,24,22,10,1,12,20,8,30,19,11,31,64,158,0,22,SPA
6ed1a2a2,18,9,6,9,3,9,27,18,8,2,6,13,31,4,0,22,SPA
6f392eb8,1,0,1,0,0,0,0,0,0,0,0,0,1,1,0,22,SPA
6f4c734d,14,7,3,10,1,7,8,1,4,1,3,7,21,2,0,22,SPA
6f51e382,0,0,0,0,0,0,1,1,0,0,0,1,1,13,5,22,SPA
6f5f82c0,47,31,32,9,6,25,47,22,16,3,13,18,65,49,0,22,SPA
70d74ece,11,9,5,3,3,2,9,7,10,0,10,4,15,13,0,22,SPA
70f8e0bd,53,31,20,24,9,15,46,31,28,3,25,20,73,27,0,22,SPA
7106f0a0,9,4,7,2,0,3,9,6,6,4,2,7,16,37,1,22,SPA
7111d552,46,24,23,19,4,15,50,35,25,0,25,6,52,6,0,22,SPA
719384c1,26,13,16,7,3,17,27,10,11,1,10,11,37,29,1,22,SPA
7226539b,60,35,44,12,4,39,73,34,34,8,26,45,105,53,0,22,SPA
72a84002,32,19,24,8,0,17,32,15,26,16,10,24,56,82,0,22,SPA
72a99e38,17,11,6,7,4,13,31,18,9,0,9,10,27,6,0,22,SPA
73683fa9,0,0,0,0,0,0,2,2,0,0,0,1,1,21,1,22,SPA
7460ca0d,43,29,15,15,13,20,52,32,32,7,25,29,72,19,1,22,SPA
755da865,3,3,1,2,0,3,8,5,4,0,4,2,5,6,0,22,SPA
75645f0e,6,4,1,2,3,0,8,8,11,1,10,4,10,7,0,22,SPA
759d8dd7,14,6,6,5,3,6,13,7,6,0,6,4,18,7,0,22,SPA
75bd85ea,18,12,8,8,2,6,17,11,12,6,6,14,32,11,0,22,SPA
766f48dd,12,6,3,3,6,2,12,10,15,2,13,6,18,9,0,22,SPA
7868c973,0,0,0,0,0,0,0,0,0,0,0,1,1,0,0,22,SPA
79f2a5f5,18,11,11,7,0,9,15,6,20,12,8,16,34,69,0,22,SPA
7a538238,73,34,48,21,4,42,79,37,28,10,18,36,109,62,0,22,SPA
7b5ab7f2,13,8,6,3,4,2,13,11,13,0,13,1,14,4,0,22,SPA
7b9c2d84,52,35,22,20,10,20,38,18,20,2,18,17,69,14,1,22,SPA
7dcf86f6,14,7,1,5,8,4,24,20,23,2,21,11,25,19,0,22,SPA
7e98cff1,7,5,5,0,2,3,5,2,0,0,0,2,9,2,0,22,SPA
7f203b54,0,0,0,0,0,0,1,1,0,0,0,0,0,0,0,22,SPA
7f4c7c9f,36,19,16,12,8,15,44,29,15,3,12,35,71,58,0,22,SPA
808d48f3,35,26,23,7,5,23,31,8,22,7,15,23,58,55,0,22,SPA
81442ecb,50,29,27,14,9,30,46,16,22,5,17,14,64,25,1,22,SPA
81d5c497,10,4,3,2,5,2,12,10,9,2,7,3,13,15,0,22,SPA
81f0781e,5,2,2,2,1,1,7,6,6,1,5,6,11,14,0,22,SPA
8249ff06,0,0,0,0,0,0,0,0,0,0,0,0,0,0,0,22,SPA
833fb62e,7,3,1,3,3,1,12,11,14,3,11,2,9,3,0,22,SPA
84399660,39,25,11,19,9,19,49,30,24,1,23,9,48,10,1,22,SPA
8455ad90,13,6,2,9,2,5,29,24,11,1,10,5,18,7,0,22,SPA
84f55b4a,3,2,3,0,0,1,1,0,0,0,0,0,3,1,0,22,SPA
857cb4f3,0,0,0,0,0,0,0,0,0,0,0,0,0,0,0,22,SPA
85bed4ee,10,7,4,5,1,5,22,17,11,0,11,3,13,4,0,22,SPA
85dace26,27,12,6,16,5,12,31,19,28,2,26,6,33,11,0,22,SPA
8696bc90,8,4,1,6,1,2,8,6,7,1,6,5,13,2,0,22,SPA
87b498b0,0,0,0,0,0,0,0,0,0,0,0,1,1,1,2,22,SPA
88050721,19,9,6,10,3,10,33,23,7,0,7,10,29,8,1,22,SPA
881cd6be,42,25,22,17,3,17,35,18,21,2,19,21,63,11,1,22,SPA
881ef58c,7,3,3,2,2,3,12,9,5,1,4,4,11,2,0,22,SPA
89f951b5,40,22,12,23,5,13,40,27,31,8,23,23,63,35,0,22,SPA
8aafd64f,5,2,1,4,0,1,5,4,4,1,3,7,12,8,0,22,SPA
8ac501f5,15,6,5,9,1,5,10,5,8,3,5,4,19,4,0,22,SPA
8b298f56,0,0,0,0,0,0,0,0,1,1,0,0,0,1,0,22,SPA
8b625720,6,3,3,3,0,5,7,2,4,3,1,1,7,9,0,22,SPA
8b788c01,2,1,0,0,2,2,6,4,4,0,4,0,2,3,0,22,SPA
8c3c640c,18,10,7,7,4,7,21,14,18,2,16,10,28,16,1,22,SPA
8c725b43,21,9,16,5,0,16,29,13,29,18,11,39,60,106,0,22,SPA
8cfc2f69,15,9,6,7,2,4,21,17,15,1,14,3,18,13,0,22,SPA
8d47bb39,31,19,24,7,0,16,28,12,27,9,18,32,63,81,0,22,SPA
8db394aa,28,19,21,6,1,13,27,14,11,5,6,22,50,56,2,22,SPA
8e088e04,17,12,12,3,2,9,16,7,6,0,6,8,25,14,0,22,SPA
8e48dc61,18,13,6,10,2,10,17,7,12,6,6,12,30,8,0,22,SPA
8e92be30,7,4,1,3,3,2,12,10,14,2,12,3,10,10,0,22,SPA
8f29e08b,0,0,0,0,0,0,1,1,0,0,0,0,0,1,1,22,SPA
8f3565b3,24,10,3,15,6,6,19,13,22,4,18,3,27,16,0,22,SPA
8f5e92a6,18,14,7,4,7,3,18,15,21,0,21,11,29,3,0,22,SPA
8f696594,10,4,2,4,4,3,13,10,9,1,8,3,13,4,0,22,SPA
8f898ba8,7,4,2,4,1,3,13,10,9,2,7,1,8,27,0,22,SPA
8f8c6934,1,0,1,0,0,1,2,1,0,0,0,0,1,22,2,22,SPA
90162357,10,4,7,3,0,5,9,4,1,0,1,4,14,7,0,22,SPA
9038c2a1,15,8,8,5,2,7,21,14,9,0,9,8,23,6,0,22,SPA
90bbd822,42,23,15,18,9,8,35,27,27,3,24,42,84,24,0,22,SPA
91f7631f,40,21,14,21,5,14,30,16,16,2,14,20,60,21,0,22,SPA
924ff27e,0,0,0,0,0,0,0,0,0,0,0,0,0,2,0,22,SPA
93090f69,18,14,9,9,0,6,11,5,27,20,7,22,40,82,0,22,SPA
93b054dc,0,0,0,0,0,0,0,0,0,0,0,0,0,0,0,22,SPA
94e01ec6,3,3,2,1,0,0,2,2,0,0,0,0,3,2,1,22,SPA
963829d0,45,25,16,18,11,23,66,43,19,3,16,13,58,17,0,22,SPA
968a1c2f,13,5,4,7,2,3,28,25,17,10,7,19,32,10,0,22,SPA
974322dc,19,10,11,8,0,7,17,10,8,2,6,10,29,28,0,22,SPA
97572117,3,1,2,1,0,2,2,0,2,1,1,2,5,7,0,22,SPA
97852360,2,1,2,0,0,2,2,0,0,0,0,0,2,18,1,22,SPA
97d08e60,12,9,4,7,1,4,8,4,8,2,6,4,16,6,0,22,SPA
981c1863,0,0,0,0,0,0,0,0,0,0,0,0,0,1,0,22,SPA
98529579,0,0,0,0,0,0,0,0,0,0,0,0,0,0,0,22,SPA
9939e168,40,20,18,18,4,17,44,27,26,9,17,20,60,43,0,22,SPA
9970da54,0,0,0,0,0,0,1,1,0,0,0,0,0,0,0,22,SPA
99bebd12,2,1,0,0,2,0,1,1,1,0,1,0,2,0,0,22,SPA
99ea2ddd,31,20,17,10,4,10,31,21,19,7,12,30,61,31,0,22,SPA
9a0408b6,31,15,20,8,3,12,26,14,16,6,10,30,61,27,0,22,SPA
9a28eba4,4,2,0,3,1,3,5,2,2,0,2,4,8,3,1,22,SPA
9a64e67e,49,32,36,8,5,28,36,8,34,22,12,48,97,125,0,22,SPA
9c36ed83,2,0,1,0,1,0,0,0,0,0,0,1,3,1,0,22,SPA
9c435456,1,0,1,0,0,0,1,1,0,0,0,1,2,1,0,22,SPA
9d66fbe3,3,1,0,1,2,1,3,2,4,0,4,1,4,7,0,22,SPA
9e098912,23,10,7,13,3,13,43,30,18,5,13,20,43,18,0,22,SPA
9e1035f8,10,5,3,4,3,3,7,4,12,3,9,6,16,7,0,22,SPA
9ed40a69,4,2,1,0,3,2,4,2,6,1,5,4,8,5,0,22,SPA
9f0ea33f,0,0,0,0,0,0,1,1,0,0,0,1,1,6,0,22,SPA
9f323c71,50,37,24,19,7,28,43,15,20,3,17,19,69,27,0,22,SPA
9fc0f253,7,7,3,4,0,2,7,5,14,12,2,11,18,55,1,22,SPA
9fec8860,18,14,11,3,4,8,13,5,10,3,7,5,23,21,0,22,SPA
a01c3d54,2,1,2,0,0,2,2,0,0,0,0,0,2,7,0,22,SPA
a0255c67,36,15,16,17,3,18,43,25,24,5,19,13,49,17,0,22,SPA
a08b974a,45,24,23,18,4,23,55,32,35,1,34,9,54,24,1,22,SPA
a0b4bb3e,9,5,4,4,1,5,12,7,1,0,1,2,11,1,0,22,SPA
a254bbe0,53,24,29,17,7,19,49,30,32,2,30,32,85,32,1,22,SPA
a2c1a8d3,0,0,0,0,0,0,0,0,0,0,0,0,0,2,0,22,SPA
a300ac7e,7,4,4,2,1,3,20,17,5,1,4,3,10,5,0,22,SPA
a35134ae,5,3,4,1,0,3,5,2,4,4,0,5,10,19,0,22,SPA
a39bb753,6,3,3,2,1,3,7,4,3,0,3,2,8,0,0,22,SPA
a3e4bf46,33,20,22,9,2,12,23,11,17,7,10,28,61,63,0,22,SPA
a4971d84,44,26,24,16,4,23,34,11,24,5,19,59,103,109,2,22,SPA
a4995f48,3,2,3,0,0,3,6,3,1,0,1,1,4,18,0,22,SPA
a4b00319,108,66,60,37,11,42,99,57,48,8,40,45,153,52,0,22,SPA
a55d8df5,21,15,13,3,5,10,34,24,8,0,8,8,29,6,0,22,SPA
a56da3ba,28,21,15,12,1,8,16,8,15,12,3,16,44,58,1,22,SPA
a58bb1e1,2,1,1,0,1,1,4,3,2,0,2,2,4,1,0,22,SPA
a6103274,24,13,9,11,4,8,19,11,21,1,20,8,32,12,0,22,SPA
a6154613,8,5,2,4,2,2,10,8,8,1,7,1,9,14,0,22,SPA
a6536561,0,0,0,0,0,0,0,0,0,0,0,0,0,0,0,22,SPA
a6951bf8,26,17,9,11,6,11,20,9,15,5,10,19,45,11,0,22,SPA
a6de370d,24,14,8,12,4,10,35,25,16,1,15,10,34,12,0,22,SPA
a7416105,0,0,0,0,0,0,1,1,0,0,0,0,0,0,0,22,SPA
a7a9d95a,9,3,2,4,3,1,5,4,7,0,7,6,15,1,0,22,SPA
a83d8b0c,0,0,0,0,0,0,2,2,0,0,0,1,1,0,1,22,SPA
a8542814,16,8,11,4,1,7,20,13,13,2,11,12,28,16,0,22,SPA
a952a529,4,3,3,0,1,1,2,1,6,1,5,1,5,1,0,22,SPA
a98f3cbf,0,0,0,0,0,0,0,0,0,0,0,0,0,0,0,22,SPA
a9dc785c,0,0,0,0,0,0,0,0,0,0,0,0,0,2,1,22,SPA
aa0ac32d,18,8,12,6,0,8,23,15,18,9,9,24,42,102,0,22,SPA
aa677a35,47,31,22,17,8,21,61,40,30,7,23,30,77,31,0,22,SPA
aad53e64,15,11,4,7,4,8,22,14,10,1,9,9,24,4,0,22,SPA
ab7bf91d,32,21,24,7,1,17,24,7,20,15,5,26,58,107,1,22,SPA
abb3bb95,9,7,1,5,3,1,2,1,4,0,4,0,9,12,0,22,SPA
abe66106,31,18,12,14,5,10,29,19,11,0,11,5,36,3,0,22,SPA
ac295d9e,0,0,0,0,0,0,0,0,0,0,0,0,0,3,1,22,SPA
ac454a4f,46,19,22,19,5,22,51,29,18,4,14,23,69,25,0,22,SPA
ac7e7b1c,9,5,4,3,2,1,10,9,13,2,11,6,15,7,0,22,SPA
ac8b2421,69,38,56,10,3,37,55,18,21,8,13,18,87,61,0,22,SPA
ace50e9f,1,1,0,1,0,1,1,0,0,0,0,0,1,0,0,22,SPA
acf5410c,0,0,0,0,0,0,0,0,0,0,0,0,0,0,0,22,SPA
ad1ffcfd,19,10,9,7,3,12,24,12,11,5,6,11,30,27,1,22,SPA
ad81ba78,0,0,0,0,0,0,0,0,0,0,0,0,0,0,0,22,SPA
adfc9123,22,12,18,4,0,11,14,3,19,16,3,34,56,86,1,22,SPA
ae48c5cb,1,1,1,0,0,0,1,1,2,0,2,1,2,1,0,22,SPA
ae86d473,15,11,4,6,5,5,16,11,15,0,15,7,22,13,0,22,SPA
aed746df,25,14,11,10,4,11,34,23,16,0,16,4,29,17,0,22,SPA
afdc14d7,20,10,6,11,3,10,31,21,18,2,16,5,25,9,0,22,SPA
b05e2dbd,35,21,24,10,1,16,34,18,17,3,14,19,54,37,0,22,SPA
b0616e3d,46,24,25,17,4,26,54,28,18,3,15,26,72,35,0,22,SPA
b0fce72c,27,14,7,18,2,11,31,20,16,5,11,20,47,34,2,22,SPA
b14f755d,24,14,17,6,1,12,24,12,8,3,5,12,36,13,0,22,SPA
b19db005,24,16,6,10,8,7,23,16,8,0,8,8,32,3,0,22,SPA
b233e8e4,15,10,13,2,0,9,13,4,11,8,3,17,32,37,0,22,SPA
b2d03887,2,1,1,1,0,0,1,1,2,1,1,2,4,2,0,22,SPA
b2d0ec1b,25,15,14,7,4,13,47,34,20,1,19,9,34,5,0,22,SPA
b3b62f94,1,0,0,1,0,0,2,2,2,1,1,1,2,9,0,22,SPA
b3dc6eca,11,9,7,2,2,6,9,3,18,13,5,29,40,71,1,22,SPA
b418dbd4,27,17,6,11,10,8,36,28,30,4,26,9,36,21,0,22,SPA
b4a014b1,35,24,20,13,2,16,24,8,48,33,15,24,59,120,5,22,SPA
b4c23f36,0,0,0,0,0,0,0,0,0,0,0,0,0,0,0,22,SPA
b51b1b9c,23,13,8,8,7,6,20,14,19,1,18,14,37,11,0,22,SPA
b5bdf144,0,0,0,0,0,0,0,0,0,0,0,0,0,0,0,22,SPA
b5dd3469,25,8,9,13,3,8,20,12,16,9,7,22,47,16,2,22,SPA
b5f63410,2,2,1,1,0,1,4,3,0,0,0,1,3,7,0,22,SPA
b6160ad0,0,0,0,0,0,0,0,0,0,0,0,0,0,10,5,22,SPA
b6e50615,25,11,10,11,4,7,14,7,19,6,13,13,38,25,0,22,SPA
b742cc0d,39,14,18,17,4,19,35,16,39,22,17,33,72,105,1,22,SPA
b75ac54b,19,10,10,9,0,13,31,18,14,9,5,27,46,73,1,22,SPA
b7c99b9b,29,16,21,8,0,19,30,11,36,24,12,27,56,151,1,22,SPA
b7ca5c51,21,12,16,5,0,14,20,6,18,12,6,39,60,88,0,22,SPA
b7d7f3bf,3,0,1,2,0,3,4,1,1,0,1,0,3,0,0,22,SPA
b7de5bad,0,0,0,0,0,0,0,0,0,0,0,0,0,0,0,22,SPA
b857bd29,16,7,10,4,2,5,6,1,17,14,3,18,34,81,0,22,SPA
b8a642fc,13,9,6,5,2,3,6,3,7,0,7,5,18,4,0,22,SPA
b8bd60fe,2,0,0,1,1,0,0,0,0,0,0,0,2,0,0,22,SPA
b8c1de25,43,28,17,22,4,14,39,25,33,10,23,18,61,29,0,22,SPA
b9d0446f,13,9,12,1,0,9,15,6,17,13,4,15,28,51,0,22,SPA
ba5004e1,74,47,34,30,10,42,91,49,46,5,41,31,105,30,0,22,SPA
bad38a94,7,5,2,5,0,4,9,5,2,1,1,3,10,8,0,22,SPA
bb08bce9,53,34,34,17,2,34,53,19,30,18,12,35,88,153,0,22,SPA
bbc19252,37,17,16,18,3,15,42,27,20,8,12,18,55,15,0,22,SPA
bbf5c11b,4,3,1,1,2,0,11,11,4,3,1,0,4,17,0,22,SPA
bc49fd34,2,2,1,1,0,0,2,2,1,0,1,0,2,1,0,22,SPA
bc61cc65,3,2,2,1,0,2,4,2,1,0,1,0,3,3,0,22,SPA
bc6f5f06,33,24,29,3,1,18,27,9,33,23,10,40,73,125,2,22,SPA
bdb624a3,12,7,2,8,2,5,20,15,2,0,2,5,17,13,0,22,SPA
bdc74a8f,5,3,4,1,0,2,5,3,4,1,3,1,6,1,0,22,SPA
be170419,4,4,2,2,0,3,6,3,9,8,1,8,12,26,2,22,SPA
be32269e,31,21,20,10,1,19,29,10,22,12,10,15,46,62,0,22,SPA
be3a0121,4,2,2,2,0,2,3,1,4,1,3,3,7,9,0,22,SPA
bece776f,43,29,5,25,13,7,36,29,14,0,14,7,50,7,0,22,SPA
bed68338,17,9,9,5,3,5,8,3,3,0,3,9,26,0,0,22,SPA
bef0a7ac,5,1,2,2,1,3,6,3,4,0,4,1,6,1,0,22,SPA
bf12926c,1,1,0,1,0,0,3,3,3,0,3,1,2,0,0,22,SPA
bfd381b3,57,30,31,23,3,25,43,18,19,5,14,24,81,34,1,22,SPA
c00097d2,36,20,27,7,2,23,39,16,25,15,10,30,66,90,1,22,SPA
c05dfb74,32,10,8,19,5,12,40,28,20,1,19,17,49,8,1,22,SPA
c0617e2b,7,5,4,3,0,1,5,4,8,2,6,4,11,2,0,22,SPA
c14bc029,7,2,0,6,1,3,4,1,7,1,6,0,7,3,0,22,SPA
c20bdcd7,45,25,30,14,1,22,30,8,18,9,9,21,66,38,0,22,SPA
c2111b45,7,5,7,0,0,5,6,1,9,8,1,6,13,16,0,22,SPA
c261b5dd,0,0,0,0,0,0,0,0,1,0,1,4,4,4,0,22,SPA
c31ea173,2,0,2,0,0,1,1,0,0,0,0,2,4,2,0,22,SPA
c4b888df,43,29,29,12,2,28,56,28,25,6,19,34,77,42,0,22,SPA
c67cd65c,41,29,28,12,1,26,41,15,41,25,16,36,77,105,1,22,SPA
c7069d87,16,6,7,8,1,7,21,14,10,2,8,8,24,17,0,22,SPA
c7429db3,3,3,2,0,1,1,2,1,1,0,1,1,4,1,0,22,SPA
c77a8043,34,20,18,12,4,17,44,27,33,3,30,11,45,36,0,22,SPA
c78b352d,35,23,26,6,3,14,29,15,20,5,15,19,54,27,0,22,SPA
c818c4d9,0,0,0,0,0,0,1,1,0,0,0,0,0,1,1,22,SPA
c997b942,5,3,1,1,3,3,5,2,2,0,2,2,7,2,0,22,SPA
c9cb972b,0,0,0,0,0,0,0,0,0,0,0,0,0,3,1,22,SPA
c9e39d91,68,35,24,35,9,26,87,61,52,6,46,37,105,30,0,22,SPA
c9e99e49,30,19,13,13,4,14,26,12,10,3,7,11,41,10,2,22,SPA
cac2537b,29,12,12,14,3,12,35,23,13,2,11,10,39,7,0,22,SPA
cb574619,45,25,24,19,2,16,31,15,23,9,14,20,65,53,0,22,SPA
cbdf7d5c,2,0,1,0,1,0,5,5,7,1,6,1,3,1,0,22,SPA
cbec0059,2,2,0,2,0,0,0,0,1,0,1,1,3,3,0,22,SPA
ccbbe661,5,4,1,3,1,3,10,7,5,0,5,1,6,7,0,22,SPA
cce181df,74,44,25,40,9,21,49,28,16,5,11,44,118,24,0,22,SPA
ce8039aa,15,6,9,5,1,11,34,23,14,2,12,7,22,3,0,22,SPA
cee88597,45,22,25,11,9,19,31,12,24,5,19,39,84,64,0,22,SPA
cf59e05f,0,0,0,0,0,0,0,0,0,0,0,0,0,0,0,22,SPA
d080ed5e,71,38,21,40,10,26,67,41,50,10,40,21,92,56,2,22,SPA
d1b060e2,2,2,1,0,1,1,5,4,5,0,5,1,3,6,0,22,SPA
d2110326,35,24,18,15,2,13,23,10,29,17,12,30,65,87,3,22,SPA
d38fdf53,36,22,20,11,5,17,24,7,13,5,8,25,61,29,2,22,SPA
d49f3e6b,27,13,5,15,7,9,24,15,24,1,23,2,29,23,0,22,SPA
d4b73232,0,0,0,0,0,0,0,0,0,0,0,0,0,6,1,22,SPA
d5dd5f1f,2,2,0,1,1,0,5,5,9,1,8,2,4,4,0,22,SPA
d637fc22,32,16,13,19,0,15,30,15,21,10,11,10,42,36,0,22,SPA
d6e3d7fb,0,0,0,0,0,0,0,0,0,0,0,0,0,1,0,22,SPA
d709cd5c,0,0,0,0,0,0,0,0,0,0,0,0,0,1,0,22,SPA
d733aa38,7,4,3,1,3,3,15,12,8,0,8,8,15,4,0,22,SPA
d7553721,22,12,8,10,4,9,22,13,4,0,4,5,27,3,0,22,SPA
d83bbc54,23,13,6,14,3,8,31,23,13,2,11,13,36,22,0,22,SPA
d83f09ff,2,2,1,1,0,0,0,0,1,0,1,0,2,5,0,22,SPA
d8712bf9,6,5,1,3,2,4,16,12,18,0,18,3,9,6,0,22,SPA
d87e2cae,15,13,2,10,3,2,8,6,10,2,8,3,18,16,0,22,SPA
d9ba39fc,41,20,19,17,5,22,45,23,29,4,25,30,71,54,0,22,SPA
da4e70e5,2,0,1,0,1,1,3,2,0,0,0,0,2,2,0,22,SPA
dafa5038,1,1,1,0,0,0,0,0,0,0,0,0,1,0,0,22,SPA
db001fa9,107,63,58,39,10,44,112,68,45,10,35,54,161,87,1,22,SPA
db750822,3,2,1,1,1,2,5,3,3,0,3,1,4,1,0,22,SPA
db8f0eba,44,29,22,15,7,26,69,43,35,3,32,19,63,30,0,22,SPA
dc008610,1,1,1,0,0,0,1,1,2,0,2,0,1,1,0,22,SPA
dc1c2fce,45,26,23,14,8,11,51,40,40,2,38,16,61,20,0,22,SPA
dc1ce4f5,4,2,3,0,1,3,6,3,1,0,1,3,7,1,1,22,SPA
dc62b55d,19,12,3,11,5,5,20,15,18,2,16,6,25,9,0,22,SPA
ddd5348b,2,1,2,0,0,2,6,4,2,0,2,0,2,1,0,22,SPA
de39485a,34,19,16,12,6,19,44,25,26,5,21,19,53,12,2,22,SPA
de627c8a,1,0,1,0,0,1,1,0,0,0,0,0,1,0,0,22,SPA
de903ae2,0,0,0,0,0,0,0,0,0,0,0,0,0,1,0,22,SPA
dea912dc,2,1,2,0,0,2,2,0,2,1,1,0,2,5,1,22,SPA
debc6b55,3,0,0,3,0,0,1,1,1,0,1,1,4,1,0,22,SPA
dee86451,49,33,20,25,4,15,40,25,18,7,11,16,65,20,0,22,SPA
df69b544,43,19,14,25,4,14,38,24,22,1,21,10,53,23,0,22,SPA
df8b52a5,3,3,2,1,0,1,2,1,1,0,1,2,5,1,0,22,SPA
e1846dde,1,1,1,0,0,0,3,3,0,0,0,1,2,19,0,22,SPA
e1e75690,1,0,0,1,0,1,1,0,0,0,0,3,4,1,0,22,SPA
e2716bd0,28,17,10,11,7,3,20,17,13,3,10,7,35,12,0,22,SPA
e3fabb0a,3,2,1,2,0,3,8,5,4,0,4,4,7,3,0,22,SPA
e4346678,0,0,0,0,0,0,0,0,0,0,0,0,0,16,2,22,SPA
e49ce451,13,9,8,3,2,7,8,1,9,6,3,7,20,23,0,22,SPA
e54bd0a2,28,16,13,11,4,14,29,15,12,3,9,22,50,23,0,22,SPA
e5ec95f8,3,3,1,1,1,0,2,2,2,0,2,5,8,8,0,22,SPA
e6777e6b,16,8,12,4,0,8,13,5,28,18,10,22,38,114,1,22,SPA
e6bc67d7,21,14,6,7,8,2,22,20,14,0,14,9,30,1,0,22,SPA
e7630876,0,0,0,0,0,0,0,0,0,0,0,0,0,0,0,22,SPA
e7ab4179,2,1,1,1,0,2,5,3,5,2,3,4,6,10,0,22,SPA
e897d8ba,11,7,3,4,4,3,23,20,10,1,9,3,14,12,0,22,SPA
e8deefd6,0,0,0,0,0,0,0,0,0,0,0,1,0,0,0,22,SPA
e92cd3f7,20,7,4,10,6,7,17,10,14,1,13,4,24,15,0,22,SPA
e94d79e3,2,2,2,0,0,1,5,4,2,2,0,11,13,16,1,22,SPA
e9ada8cf,8,6,6,2,0,4,6,2,7,1,6,4,12,15,0,22,SPA
ea6a7ab4,3,2,1,1,1,3,5,2,2,0,2,1,4,2,0,22,SPA
ea83bfa6,1,0,1,0,0,1,2,1,0,0,0,1,2,11,1,22,SPA
ea9b2ef9,27,19,18,9,0,11,20,9,19,16,3,28,55,137,0,22,SPA
ead61f73,21,11,16,4,1,12,22,10,10,4,6,15,36,22,0,22,SPA
eaefa2d0,0,0,0,0,0,0,1,1,0,0,0,0,0,0,0,22,SPA
eb3dd471,28,15,11,10,7,14,58,44,22,1,21,25,53,20,0,22,SPA
eb82b6f1,44,23,18,17,9,14,57,43,9,1,8,7,51,20,0,22,SPA
ec1a731e,19,10,14,4,1,11,17,6,20,8,12,16,35,87,0,22,SPA
ecc77652,15,8,7,8,0,4,13,9,6,3,3,15,30,5,0,22,SPA
ecd8c01e,21,13,7,8,6,8,28,20,11,1,10,6,27,5,1,22,SPA
ed3f5f4c,3,2,1,1,1,0,2,2,1,1,0,0,3,11,0,22,SPA
ed5c5fa3,56,41,27,23,6,28,68,40,29,5,24,32,88,39,0,22,SPA
ed6ea4d9,23,13,11,8,4,9,23,14,10,0,10,15,38,17,0,22,SPA
ed9f7cfe,31,18,14,13,4,11,27,16,22,4,18,13,44,19,1,22,SPA
ee37317d,0,20,0,0,0,0,0,0,0,0,0,36,0,0,0,22,SPA
ee8508c0,0,0,0,0,0,0,0,0,0,0,0,1,1,10,4,22,SPA
ee923664,34,24,12,13,9,14,28,14,20,7,13,36,70,34,0,22,SPA
eeba07f8,26,14,9,9,8,8,27,19,25,3,22,6,32,23,0,22,SPA
ef322658,30,13,12,17,1,13,34,21,18,4,14,21,51,29,1,22,SPA
efecd633,16,5,5,8,3,5,15,10,5,0,5,8,24,6,0,22,SPA
f03f284b,18,13,9,8,1,9,16,7,10,8,2,10,28,25,2,22,SPA
f08490a6,7,6,3,0,4,2,4,2,5,0,5,2,9,3,0,22,SPA
f090a37a,6,3,2,4,0,2,14,12,5,0,5,3,9,0,0,22,SPA
f0da930c,18,12,12,6,0,8,16,8,25,19,6,25,43,96,1,22,SPA
f13d02a6,27,16,11,9,7,14,41,27,12,1,11,3,30,9,0,22,SPA
f1bed920,15,11,8,7,0,6,10,4,10,1,9,7,22,6,0,22,SPA
f2308b33,10,8,4,4,2,7,12,5,4,0,4,3,13,7,0,22,SPA
f2a68b97,43,31,26,15,2,21,37,16,26,7,19,51,94,61,0,22,SPA
f2c6ac01,31,19,18,12,1,13,24,11,34,26,8,31,62,173,1,22,SPA
f3451c66,0,0,0,0,0,0,0,0,2,0,2,0,0,0,0,22,SPA
f38284bb,0,0,0,0,0,0,0,0,0,0,0,0,0,0,0,22,SPA
f3b1d9a2,21,11,11,6,4,7,17,10,12,0,12,7,28,7,0,22,SPA
f4c69aa6,26,18,10,13,3,14,35,21,15,0,15,12,38,14,0,22,SPA
f6798fc3,0,0,0,0,0,0,0,0,0,0,0,0,0,11,1,22,SPA
f6ac68c1,46,20,25,20,1,29,43,14,19,12,7,37,83,102,1,22,SPA
f7dc2ae5,21,14,16,5,0,10,20,10,19,13,6,29,50,86,0,22,SPA
f874dd44,52,32,29,20,3,31,44,13,11,2,9,23,75,57,1,22,SPA
f8eca1b6,37,22,2,18,17,5,42,37,25,5,20,5,42,36,0,22,SPA
f9358b61,0,0,0,0,0,0,0,0,0,0,0,0,0,1,0,22,SPA
f9acf8bf,6,3,5,0,1,3,4,1,3,0,3,2,8,10,0,22,SPA
fa265f6d,3,1,1,1,1,2,5,3,1,0,1,2,5,1,0,22,SPA
faed84db,32,18,9,19,4,12,33,21,16,6,10,16,48,21,0,22,SPA
fb5d47b3,10,4,2,5,3,6,10,4,6,3,3,6,16,15,0,22,SPA
fb938d24,12,7,7,5,0,3,6,3,4,0,4,8,20,6,0,22,SPA
fbbb9269,12,10,11,0,1,7,13,6,11,4,7,13,25,16,1,22,SPA
fbd6378b,11,5,2,8,1,3,6,3,17,14,3,13,24,49,3,22,SPA
fc076f78,0,0,0,0,0,0,0,0,0,0,0,0,0,0,0,22,SPA
fc3d2006,1,1,1,0,0,0,1,1,0,0,0,0,1,0,0,22,SPA
fc647b34,42,24,14,18,10,15,50,35,26,1,25,13,55,11,0,22,SPA
fc70e345,0,0,0,0,0,0,0,0,0,0,0,1,1,14,3,22,SPA
fc8b614b,2,2,0,2,0,2,3,1,1,0,1,0,2,1,0,22,SPA
fd51b456,43,22,24,9,10,17,35,18,25,7,18,20,63,41,1,22,SPA
fd771f95,1,1,0,0,1,0,0,0,2,0,2,1,2,1,0,22,SPA
fdd60087,12,5,8,3,1,4,9,5,8,4,4,5,17,10,0,22,SPA
fe05804b,9,4,9,0,0,8,17,9,12,6,6,12,21,56,0,22,SPA
fe641c1a,41,24,17,21,3,16,30,14,19,10,9,13,54,35,0,22,SPA
fed17f5a,29,19,10,15,4,11,37,26,19,4,15,14,43,28,0,22,SPA
ffacd3d5,72,34,41,22,9,43,79,36,28,3,25,18,90,43,0,22,SPA
005ca692,9,3,5,3,1,2,8,6,4,2,2,9,18,3,0,22,CL
00672021,3,1,1,1,1,2,4,2,2,0,2,2,5,1,0,22,CL
00844823,2,2,2,0,0,1,2,1,2,0,2,4,6,3,0,22,CL
00f0482f,1,1,1,0,0,0,0,0,1,0,1,0,1,0,0,22,CL
016ff750,5,4,3,2,0,3,4,1,0,0,0,0,5,3,0,22,CL
01834aa0,3,3,3,0,0,2,4,2,4,3,1,2,5,12,0,22,CL
0193a8bf,15,8,9,6,0,8,15,7,10,0,10,10,25,4,0,22,CL
01b8a2b2,0,0,0,0,0,0,0,0,1,0,1,0,0,2,1,22,CL
01c3aff5,8,6,4,3,1,2,6,4,8,0,8,7,15,5,1,22,CL
01eb744d,7,3,3,2,2,2,12,10,1,0,1,2,9,1,0,22,CL
02c15616,15,10,11,3,1,7,16,9,4,1,3,9,24,7,0,22,CL
032f894e,5,4,2,2,1,4,10,6,3,1,2,3,8,4,1,22,CL
03df04ff,1,1,1,0,0,1,2,1,0,0,0,0,1,1,0,22,CL
042e8a49,11,6,5,4,2,7,10,3,11,1,10,2,13,2,0,22,CL
048a1cbc,5,3,2,2,1,1,2,1,1,0,1,0,5,3,0,22,CL
049a888d,2,0,0,1,1,1,4,3,1,0,1,1,3,1,0,22,CL
04e17fd5,0,0,0,0,0,0,0,0,0,0,0,0,0,1,0,22,CL
05439de2,16,9,11,4,1,5,7,2,8,8,0,11,27,28,1,22,CL
056269d7,7,7,3,3,1,6,11,5,0,0,0,5,12,0,0,22,CL
05d548d8,14,9,9,5,0,5,6,1,7,3,4,7,21,17,0,22,CL
05e19d6a,4,2,2,2,0,2,5,3,6,1,5,5,9,4,0,22,CL
061e8e23,2,0,0,2,0,1,3,2,0,0,0,1,3,0,0,22,CL
0630eb63,0,0,0,0,0,0,0,0,0,0,0,0,0,0,0,22,CL
0670ee51,3,1,2,1,0,1,3,2,9,6,3,4,7,16,0,22,CL
06a1d642,0,0,0,0,0,0,0,0,0,0,0,1,1,1,0,22,CL
06d4b2e4,0,0,0,0,0,0,2,2,3,0,3,0,0,0,0,22,CL
06e5b0e4,4,3,3,1,0,2,5,3,9,5,4,11,15,23,0,22,CL
08d37c53,5,3,4,1,0,2,10,8,5,5,0,9,14,19,0,22,CL
08f5afaa,0,0,0,0,0,0,0,0,0,0,0,0,0,6,1,22,CL
091c86e2,0,0,0,0,0,0,0,0,0,0,0,0,0,0,0,22,CL
0959c2a2,20,12,9,8,3,7,19,12,17,2,15,9,29,13,0,22,CL
0a396655,3,0,3,0,0,2,10,8,6,0,6,1,4,3,0,22,CL
0a6dbbf7,5,2,5,0,0,3,4,1,7,4,3,4,9,4,0,22,CL
0a89e877,2,0,0,0,2,2,3,1,0,0,0,3,5,2,0,22,CL
0a8fd9cb,0,0,0,0,0,0,0,0,0,0,0,0,0,3,0,22,CL
0ab1f153,7,3,5,2,0,4,9,5,6,1,5,5,12,11,0,22,CL
0aeeed3f,5,3,1,4,0,2,5,3,3,0,3,7,12,0,0,22,CL
0ba976e4,1,1,0,1,0,1,2,1,2,0,2,1,2,0,0,22,CL
0c09c984,0,0,0,0,0,0,0,0,1,0,1,0,0,2,0,22,CL
0c152537,9,5,2,6,1,3,8,5,2,0,2,4,13,0,0,22,CL
0c61c77c,5,3,3,1,1,4,8,4,2,0,2,1,6,1,0,22,CL
0cc5f4a5,5,1,4,0,1,3,5,2,5,1,4,1,6,5,0,22,CL
0d267745,13,10,10,3,0,8,14,6,16,7,9,19,32,56,0,22,CL
0d82903c,18,9,11,2,5,8,13,5,4,0,4,6,24,7,0,22,CL
0d9b2d31,4,3,2,2,0,3,5,2,2,0,2,1,5,1,0,22,CL
0db169ae,11,8,5,4,2,3,6,3,3,0,3,3,14,7,0,22,CL
0e5b695f,0,0,0,0,0,0,0,0,0,0,0,0,0,0,0,22,CL
0e6bc38c,0,0,0,0,0,0,1,1,0,0,0,0,0,0,0,22,CL
0e96a5e1,13,5,7,5,1,5,13,8,3,1,2,10,23,7,0,22,CL
0eb83e1a,6,4,4,2,0,2,7,5,7,1,6,1,7,4,0,22,CL
0ef89a37,2,1,0,1,1,2,4,2,0,0,0,0,2,0,0,22,CL
0f41e2ee,3,0,2,1,0,2,3,1,2,2,0,2,5,5,0,22,CL
101da2b5,9,6,1,7,1,2,4,2,2,2,0,9,18,1,1,22,CL
10549b49,4,1,1,3,0,0,1,1,1,0,1,2,6,4,0,22,CL
108fe016,5,4,4,1,0,2,4,2,2,1,1,3,8,0,0,22,CL
116c35df,1,1,1,0,0,0,4,4,1,0,1,3,4,0,0,22,CL
119b9a8e,12,7,8,4,0,7,9,2,4,2,2,11,23,20,0,22,CL
11b9265b,2,1,2,0,0,2,5,3,1,0,1,5,7,3,0,22,CL
11c7fa75,0,0,0,0,0,0,0,0,0,0,0,0,0,2,0,22,CL
11d8aff0,0,0,0,0,0,0,0,0,0,0,0,0,0,0,0,22,CL
1265a93a,14,8,10,3,1,7,7,0,2,0,2,7,21,6,0,22,CL
129af0db,6,4,2,1,3,2,5,3,3,1,2,0,6,7,0,22,CL
12dcbdcc,11,5,5,5,1,6,12,6,11,2,9,3,14,5,0,22,CL
13203c45,8,3,5,2,1,4,7,3,7,1,6,3,11,12,1,22,CL
1338e42b,25,16,17,7,1,16,28,12,12,2,10,21,46,18,0,22,CL
1467af0d,13,8,7,5,1,6,9,3,11,4,7,6,19,5,0,22,CL
149c5f5d,1,1,0,0,1,0,0,0,0,0,0,0,1,3,0,22,CL
14b8fcdf,6,3,1,5,0,1,1,0,4,2,2,1,7,3,0,22,CL
15f3ec41,6,3,1,2,3,1,4,3,5,0,5,1,7,0,0,22,CL
15fd5593,7,6,2,2,3,3,9,6,4,1,3,2,9,1,0,22,CL
162efffd,19,12,5,8,6,12,26,14,13,2,11,7,26,11,0,22,CL
165a2e40,0,0,0,0,0,0,1,1,4,2,2,0,0,2,0,22,CL
16ceb862,2,2,1,0,1,0,1,1,0,0,0,2,4,3,0,22,CL
17370b95,0,0,0,0,0,0,0,0,1,1,0,0,0,0,0,22,CL
178ae8f8,8,5,4,3,1,2,8,6,5,0,5,6,14,3,0,22,CL
17e3e467,17,9,7,10,0,4,19,15,6,0,6,9,26,3,1,22,CL
1840e36d,0,0,0,0,0,0,0,0,0,0,0,0,0,3,1,22,CL
18a88e3e,0,0,0,0,0,0,0,0,0,0,0,0,0,0,0,22,CL
18b896d6,13,9,9,3,1,7,11,4,7,2,5,6,19,13,1,22,CL
19709006,0,0,0,0,0,0,0,0,1,0,1,0,0,0,0,22,CL
19a967ab,3,2,1,2,0,1,3,2,0,0,0,1,4,0,0,22,CL
19cae58d,10,6,1,6,3,5,12,7,5,0,5,3,13,1,0,22,CL
19cda00b,6,2,2,4,0,4,9,5,5,0,5,0,6,1,0,22,CL
1a2935f6,2,0,2,0,0,2,3,1,3,1,2,0,2,17,0,22,CL
1a4b9094,1,0,1,0,0,1,2,1,1,0,1,2,3,2,0,22,CL
1a799243,19,10,12,7,0,11,28,17,4,0,4,12,31,9,0,22,CL
1a992676,2,0,0,1,1,1,4,3,1,0,1,1,3,2,0,22,CL
1adcf39e,2,1,0,1,1,0,1,1,4,4,0,7,9,12,0,22,CL
1b81794d,1,0,0,1,0,0,2,2,0,0,0,1,2,0,0,22,CL
1bacc518,13,4,5,6,2,5,9,4,1,0,1,5,18,4,0,22,CL
1bd5735a,2,0,1,1,0,2,2,0,2,1,1,1,3,6,0,22,CL
1bf33a9a,3,3,1,1,1,2,5,3,4,0,4,1,4,0,0,22,CL
1c78737d,1,1,1,0,0,0,1,1,2,0,2,0,1,1,0,22,CL
1cb49278,8,3,1,6,1,3,5,2,5,2,3,7,15,10,0,22,CL
1cbe4984,5,3,3,2,0,2,10,8,6,1,5,4,9,3,0,22,CL
1e064bfb,0,0,0,0,0,0,0,0,0,0,0,0,0,1,0,22,CL
1e1378e1,13,7,5,7,1,11,24,13,4,0,4,4,17,2,0,22,CL
1e4319ac,0,0,0,0,0,0,0,0,1,1,0,1,1,0,0,22,CL
1f079188,2,1,1,1,0,2,2,0,1,0,1,0,2,1,0,22,CL
1f44ac21,0,0,0,0,0,0,2,2,1,0,1,0,0,5,0,22,CL
1fbbfbde,11,6,7,4,0,7,12,5,9,6,3,9,20,25,0,22,CL
20030c06,11,6,3,6,2,9,10,1,5,4,1,6,17,8,0,22,CL
20730eae,6,3,1,5,0,4,6,2,2,0,2,1,7,4,0,22,CL
2146785a,14,7,10,4,0,8,15,7,7,1,6,2,16,13,0,22,CL
21512407,8,1,3,5,0,6,6,0,6,1,5,0,8,1,0,22,CL
24051310,14,9,11,2,1,8,12,4,7,0,7,4,18,9,1,22,CL
244bc2c8,1,0,1,0,0,1,2,1,2,0,2,1,2,3,0,22,CL
2475dcc6,8,6,3,4,1,3,8,5,5,0,5,5,13,3,0,22,CL
24fc70d3,9,4,9,0,0,6,10,4,6,3,3,7,16,8,0,22,CL
2567b7b6,13,5,10,3,0,8,17,9,7,4,3,5,18,18,0,22,CL
277c49ed,8,4,7,1,0,5,7,2,6,3,3,14,22,25,0,22,CL
2784f898,25,11,19,5,1,16,31,15,19,15,4,26,51,33,2,22,CL
27d0a506,12,5,9,3,0,7,20,13,7,0,7,11,23,6,0,22,CL
28b1f3ce,14,9,5,7,2,4,13,9,10,1,9,1,15,3,0,22,CL
28c6e925,26,13,7,12,7,15,35,20,23,3,20,4,30,9,0,22,CL
28d596a0,0,0,0,0,0,0,1,1,0,0,0,0,0,0,0,22,CL
292a652a,2,2,1,0,1,2,4,2,0,0,0,3,5,10,0,22,CL
292f1130,14,9,8,6,0,9,14,5,9,3,6,6,20,11,0,22,CL
2946f9a1,10,7,7,2,1,8,11,3,7,5,2,11,21,16,0,22,CL
29733c72,3,1,1,2,0,2,2,0,1,0,1,0,3,0,0,22,CL
2973d8ff,3,3,1,1,1,1,3,2,1,0,1,1,4,2,0,22,CL
2a0c8ba4,5,3,2,3,0,5,14,9,3,1,2,3,8,1,0,22,CL
2a1beb34,16,9,6,5,5,8,14,6,5,0,5,15,31,9,1,22,CL
2a6cd437,0,0,0,0,0,0,0,0,1,0,1,3,3,6,0,22,CL
2b0852db,1,0,0,1,0,1,2,1,0,0,0,0,1,0,0,22,CL
2b09d998,9,4,5,2,2,3,8,5,5,3,2,2,11,4,1,22,CL
2b114be3,14,8,5,7,2,1,8,7,6,0,6,4,18,0,0,22,CL
2bab583c,0,0,0,0,0,0,0,0,0,0,0,0,0,0,0,22,CL
2bc28bb9,2,1,2,0,0,2,7,5,0,0,0,5,7,2,0,22,CL
2bed3eab,4,2,3,1,0,2,4,2,2,1,1,5,9,5,0,22,CL
2bef2bca,9,8,4,5,0,3,5,2,6,1,5,4,13,13,0,22,CL
2bf50b37,11,7,5,4,2,4,6,2,2,0,2,1,12,1,0,22,CL
2c0558b8,10,6,0,7,3,3,14,11,8,0,8,8,18,2,0,22,CL
2c0f8e9e,5,3,1,2,2,3,4,1,1,0,1,2,7,0,0,22,CL
2c56a792,4,1,1,2,1,2,6,4,4,0,4,3,7,2,0,22,CL
2ccd89a3,8,4,4,3,1,3,9,6,3,0,3,6,14,6,0,22,CL
2cf496fb,1,0,0,1,0,1,6,5,2,1,1,2,3,2,0,22,CL
2d970560,1,0,1,0,0,1,2,1,1,1,0,3,4,1,0,22,CL
2e4f5f03,9,5,3,4,2,3,13,10,13,3,10,12,21,14,0,22,CL
2ebc1b44,1,0,1,0,0,1,2,1,0,0,0,0,1,0,1,22,CL
2edbd8d5,0,0,0,0,0,0,0,0,0,0,0,0,0,1,0,22,CL
2ef7c612,8,4,2,5,1,2,4,2,3,1,2,1,9,2,0,22,CL
2f33776f,0,0,0,0,0,0,0,0,1,0,1,0,0,0,0,22,CL
2f72f79e,1,1,1,0,0,1,3,2,3,0,3,3,4,10,0,22,CL
2f7af524,3,3,2,1,0,2,5,3,1,1,0,4,7,4,0,22,CL
2f90f6b8,6,2,3,2,1,3,7,4,4,1,3,2,8,3,0,22,CL
2fabebc0,0,0,0,0,0,0,0,0,0,0,0,0,0,0,1,22,CL
2fba6108,4,3,1,3,0,2,2,0,0,0,0,3,7,0,0,22,CL
2fbe6af0,0,0,0,0,0,0,0,0,0,0,0,0,0,0,0,22,CL
30941e96,1,1,0,1,0,1,4,3,3,0,3,5,6,9,0,22,CL
30d4a2e5,2,2,2,0,0,2,7,5,9,4,5,7,9,8,0,22,CL
30e03a25,0,0,0,0,0,0,1,1,1,0,1,0,0,4,0,22,CL
30f5ffa9,15,9,6,6,3,7,11,4,16,12,4,9,24,22,0,22,CL
31a62dc7,22,14,9,11,2,13,20,7,8,1,7,3,25,11,0,22,CL
31c69ef1,11,2,8,3,0,8,11,3,9,4,5,8,19,15,0,22,CL
3260690c,1,1,1,0,0,1,3,2,1,0,1,2,3,1,0,22,CL
32f76907,2,1,0,1,1,0,0,0,0,0,0,0,2,0,0,22,CL
335fa267,0,0,0,0,0,0,1,1,2,1,1,1,1,2,0,22,CL
33651873,5,2,5,0,0,0,6,6,7,6,1,9,14,25,1,22,CL
3376a776,0,0,0,0,0,0,0,0,4,1,3,1,1,2,0,22,CL
33887998,0,0,0,0,0,0,0,0,0,0,0,0,0,1,1,22,CL
3392603d,1,0,1,0,0,1,1,0,0,0,0,0,1,0,1,22,CL
33b11df6,12,6,7,5,0,4,10,6,6,0,6,6,18,6,0,22,CL
33b8d077,19,10,8,7,4,5,18,13,4,1,3,14,33,9,0,22,CL
33fdf90d,2,1,2,0,0,0,4,4,2,0,2,0,2,1,0,22,CL
34693494,0,0,0,0,0,0,1,1,0,0,0,1,1,0,0,22,CL
346d51d9,11,8,3,7,1,4,12,8,9,3,6,12,23,16,0,22,CL
34a88e3e,0,0,0,0,0,0,0,0,1,0,1,0,0,0,0,22,CL
34c3b935,0,0,0,0,0,0,0,0,0,0,0,0,0,1,2,22,CL
35862524,3,2,2,1,0,0,0,0,2,0,2,1,4,0,0,22,CL
36a3ff67,12,6,2,7,3,8,13,5,9,0,9,2,14,5,0,22,CL
374d5158,6,4,4,0,2,5,6,1,2,0,2,2,8,4,0,22,CL
384d58d9,0,0,0,0,0,0,0,0,0,0,0,0,0,0,0,22,CL
387e1d35,0,0,0,0,0,0,0,0,0,0,0,0,0,0,0,22,CL
38c7feef,12,10,3,8,1,3,6,3,5,0,5,4,16,1,0,22,CL
392a7aea,6,4,3,1,2,2,13,11,4,0,4,8,14,4,0,22,CL
39769cff,37,24,22,12,3,25,39,14,9,2,7,10,47,20,0,22,CL
3a24769f,0,0,0,0,0,0,0,0,1,0,1,0,0,0,0,22,CL
3b029691,4,3,2,1,1,1,8,7,1,1,0,5,9,2,0,22,CL
3b333ac3,2,1,1,0,1,2,2,0,0,0,0,1,3,2,0,22,CL
3b61c9ec,0,0,0,0,0,0,0,0,0,0,0,0,0,1,0,22,CL
3b8674e6,14,8,7,4,3,4,6,2,6,1,5,4,18,1,0,22,CL
3b996663,2,2,1,1,0,1,3,2,1,0,1,0,2,2,0,22,CL
3bb7b8b4,0,0,0,0,0,0,0,0,1,0,1,1,1,3,0,22,CL
3bb7f478,0,0,0,0,0,0,1,1,3,2,1,2,2,7,0,22,CL
3c6089ab,7,2,1,2,4,2,13,11,11,2,9,2,9,4,1,22,CL
3cefcaef,11,7,7,4,0,8,9,1,10,3,7,7,18,19,0,22,CL
3d50bcdb,3,3,1,0,2,2,5,3,0,0,0,1,4,1,0,22,CL
3d62c18b,8,5,5,3,0,5,13,8,6,3,3,6,14,31,0,22,CL
3e1550ee,0,0,0,0,0,0,0,0,0,0,0,0,0,0,0,22,CL
3e96f3e7,7,4,6,1,0,3,7,4,12,6,6,8,15,17,0,22,CL
3ead85f9,8,5,5,2,1,4,5,1,7,4,3,9,17,20,0,22,CL
3eb22ec9,16,8,8,2,6,9,26,17,11,0,11,7,23,5,0,22,CL
3ef0af0d,0,0,0,0,0,0,1,1,0,0,0,0,0,0,0,22,CL
3effaa34,1,1,0,0,1,0,5,5,7,0,7,0,1,2,0,22,CL
3f034750,0,0,0,0,0,0,0,0,0,0,0,0,0,1,1,22,CL
3f10bd22,1,1,1,0,0,0,0,0,3,1,2,4,5,4,0,22,CL
3f359b33,3,1,3,0,0,1,1,0,4,4,0,4,7,4,0,22,CL
407feb71,3,0,0,3,0,0,3,3,2,0,2,0,3,2,0,22,CL
41034650,11,7,6,4,1,2,6,4,12,5,7,11,22,14,0,22,CL
4142f132,1,1,1,0,0,0,0,0,0,0,0,0,1,1,0,22,CL
415568b5,2,2,0,1,1,1,3,2,2,0,2,1,3,0,0,22,CL
41f0b196,0,0,0,0,0,0,0,0,0,0,0,0,0,1,2,22,CL
41f32541,5,3,2,3,0,3,9,6,7,2,5,15,20,5,0,22,CL
42130443,1,1,1,0,0,1,2,1,0,0,0,0,1,0,0,22,CL
42eaa028,2,1,1,0,1,1,2,1,3,0,3,0,2,1,0,22,CL
42fd9c7f,1,1,0,0,1,0,4,4,1,0,1,1,2,1,0,22,CL
4315f30d,4,2,2,1,1,2,5,3,3,2,1,1,5,7,0,22,CL
436a9dd0,11,6,7,3,1,4,14,10,5,2,3,7,18,4,0,22,CL
43a166b4,4,4,1,1,2,2,2,0,1,0,1,0,4,0,0,22,CL
43b78598,0,0,0,0,0,0,1,1,0,0,0,0,0,1,0,22,CL
442b56fa,10,6,5,4,1,6,10,4,5,2,3,2,12,9,0,22,CL
448a3608,0,0,0,0,0,0,1,1,3,0,3,1,1,6,0,22,CL
44ac04e9,2,1,0,2,0,0,1,1,1,0,1,1,3,1,0,22,CL
44eb9093,2,1,2,0,0,2,3,1,1,1,0,1,3,0,0,22,CL
45a03961,14,8,8,4,2,7,14,7,11,4,7,18,32,20,1,22,CL
45af8a54,4,2,0,3,1,1,5,4,0,0,0,0,4,1,0,22,CL
45b9b619,1,1,1,0,0,1,3,2,2,0,2,0,1,0,0,22,CL
45db685d,22,6,6,11,5,9,14,5,8,0,8,13,35,1,2,22,CL
4601e194,2,2,0,2,0,2,7,5,3,0,3,6,8,5,0,22,CL
46a8347f,11,8,5,6,0,8,12,4,4,3,1,8,19,13,0,22,CL
47aaf574,0,0,0,0,0,0,0,0,2,0,2,0,0,3,0,22,CL
47dc80f5,3,2,3,0,0,3,10,7,3,0,3,3,6,1,0,22,CL
47fd5136,4,2,3,0,1,3,8,5,2,1,1,9,13,16,0,22,CL
481c9ece,3,2,2,1,0,1,3,2,1,0,1,6,9,5,0,22,CL
484a3eae,0,0,0,0,0,0,0,0,0,0,0,0,0,0,0,22,CL
489e80e3,17,10,7,8,2,9,23,14,9,2,7,12,29,5,0,22,CL
48b3dd60,4,4,1,3,0,1,5,4,7,1,6,4,8,2,0,22,CL
48d5bd33,9,6,1,5,3,5,9,4,4,0,4,1,10,2,0,22,CL
48df060a,0,0,0,0,0,0,0,0,0,0,0,0,0,0,0,22,CL
49296448,19,11,8,8,3,8,18,10,5,0,5,16,35,8,0,22,CL
493924a7,7,3,5,1,1,3,5,2,3,0,3,5,12,11,1,22,CL
4958bfb2,16,12,11,5,0,9,24,15,18,10,8,12,28,29,0,22,CL
49fe9070,1,1,1,0,0,0,5,5,0,0,0,0,1,1,0,22,CL
4a1a9578,10,4,4,2,4,1,10,9,9,0,9,3,13,1,0,22,CL
4a5839fa,0,0,0,0,0,0,1,1,4,2,2,3,3,7,0,22,CL
4b803b3c,13,7,7,6,0,6,10,4,10,6,4,14,27,30,0,22,CL
4bd414c1,10,4,6,4,0,4,9,5,23,16,7,7,17,60,0,22,CL
4c184730,1,1,0,1,0,0,0,0,1,0,1,0,1,0,0,22,CL
4c2a5d34,6,4,1,3,2,3,16,13,7,0,7,3,9,8,0,22,CL
4c370d81,13,8,1,8,4,4,9,5,4,0,4,2,15,1,0,22,CL
4c62d0c8,0,0,0,0,0,0,0,0,0,0,0,0,0,0,0,22,CL
4cde5509,2,1,0,2,0,0,0,0,0,0,0,0,2,1,1,22,CL
4ce20e90,0,0,0,0,0,0,2,2,0,0,0,1,1,1,0,22,CL
4d034881,0,0,0,0,0,0,0,0,0,0,0,0,0,0,0,22,CL
4d1666ff,4,4,2,2,0,1,3,2,2,2,0,9,13,15,0,22,CL
4d224fe8,30,20,16,12,2,11,30,19,17,5,12,16,46,20,0,22,CL
4d77b365,6,0,1,2,3,3,7,4,7,0,7,0,6,10,0,22,CL
4d8cd038,0,0,0,0,0,0,0,0,0,0,0,0,0,0,0,22,CL
4dbd0916,6,4,0,5,1,0,4,4,2,0,2,6,12,3,0,22,CL
4e219ad2,1,0,0,0,1,1,6,5,1,0,1,2,3,0,0,22,CL
4e3f5992,3,1,3,0,0,0,4,4,1,0,1,2,5,0,0,22,CL
4f1e6a0b,2,1,0,1,1,1,4,3,4,0,4,1,3,0,0,22,CL
4f28a6ff,6,3,2,4,0,3,5,2,1,1,0,5,11,2,0,22,CL
4fb9c88f,2,1,0,1,1,2,2,0,2,0,2,0,2,1,0,22,CL
501055d8,3,0,2,1,0,1,4,3,3,0,3,2,5,0,0,22,CL
507c7bdf,12,7,2,9,1,8,17,9,5,0,5,2,14,8,0,22,CL
50871bcc,2,1,1,1,0,1,1,0,3,0,3,2,4,1,0,22,CL
50dc94ce,8,3,6,2,0,2,4,2,4,2,2,5,13,2,1,22,CL
515ebe8d,1,0,1,0,0,0,0,0,1,1,0,1,2,4,0,22,CL
51960957,4,3,3,0,1,2,2,0,1,0,1,0,4,1,0,22,CL
51a3c4c8,2,2,2,0,0,1,3,2,8,4,4,4,6,24,0,22,CL
51cf8561,13,5,5,3,5,7,11,4,1,0,1,11,24,5,0,22,CL
51dbeea9,0,0,0,0,0,0,0,0,1,0,1,0,0,4,0,22,CL
527f063d,1,1,1,0,0,1,1,0,0,0,0,0,1,2,0,22,CL
52b3c895,0,0,0,0,0,0,0,0,0,0,0,0,0,3,0,22,CL
52e101a8,1,0,1,0,0,0,0,0,2,2,0,0,1,4,0,22,CL
52ec54d0,8,5,5,3,0,2,4,2,9,9,0,15,23,17,0,22,CL
532e1e4f,15,9,11,4,0,8,12,4,12,9,3,10,25,62,1,22,CL
536cebe5,1,1,1,0,0,1,6,5,1,0,1,0,1,3,0,22,CL
539230cf,1,0,0,1,0,1,2,1,2,0,2,1,2,1,0,22,CL
53cad200,12,8,3,3,6,7,14,7,16,2,14,9,21,10,0,22,CL
540ec57b,8,2,5,1,2,4,9,5,9,1,8,8,16,5,0,22,CL
5458f670,0,0,0,0,0,0,1,1,0,0,0,0,0,0,0,22,CL
546bb36e,10,6,5,5,0,5,18,13,9,1,8,5,15,8,1,22,CL
54f5ce34,3,1,3,0,0,2,5,3,3,0,3,2,5,6,0,22,CL
55126f3b,14,9,9,5,0,8,27,19,5,0,5,5,19,4,0,22,CL
5515376c,0,0,0,0,0,0,2,2,1,0,1,3,3,6,0,22,CL
555f3a0b,11,5,10,0,1,8,13,5,2,2,0,10,21,23,0,22,CL
55abe554,14,7,9,3,2,9,15,6,7,2,5,11,25,7,0,22,CL
55b93ae0,0,0,0,0,0,0,0,0,0,0,0,2,2,2,0,22,CL
572498c7,1,1,1,0,0,1,5,4,4,0,4,1,2,5,0,22,CL
57760e66,1,1,0,1,0,0,0,0,0,0,0,0,1,0,0,22,CL
57a46f3f,1,0,1,0,0,0,0,0,0,0,0,0,1,0,0,22,CL
57d88cf9,12,8,4,8,0,6,12,6,10,1,9,7,19,7,0,22,CL
5853ac44,5,2,3,2,0,3,4,1,0,0,0,4,9,2,0,22,CL
58a9a4d9,3,1,2,1,0,2,8,6,5,0,5,0,3,1,0,22,CL
58eee997,5,2,2,0,3,3,7,4,4,0,4,2,7,2,0,22,CL
5976f83e,11,6,4,4,3,3,5,2,3,0,3,1,12,0,0,22,CL
59bf127b,3,3,1,2,0,1,3,2,2,0,2,2,5,0,0,22,CL
59fd245c,0,0,0,0,0,0,0,0,0,0,0,0,0,0,0,22,CL
5a626448,6,2,2,3,1,3,6,3,0,0,0,0,6,4,0,22,CL
5ab0ea87,15,8,6,3,6,11,22,11,5,2,3,11,26,5,0,22,CL
5acc4a10,14,10,8,6,0,7,14,7,17,5,12,24,38,25,2,22,CL
5ad50391,5,4,3,1,1,4,6,2,6,3,3,8,13,11,0,22,CL
5bc43860,14,6,2,6,6,8,22,14,6,1,5,2,16,4,0,22,CL
5c2b4f07,3,2,3,0,0,1,4,3,2,1,1,4,7,5,0,22,CL
5c4dc0ff,0,0,0,0,0,0,0,0,0,0,0,0,0,0,0,22,CL
5c899683,1,1,1,0,0,1,1,0,0,0,0,1,2,4,0,22,CL
5ccc9672,0,0,0,0,0,0,1,1,0,0,0,0,0,0,0,22,CL
5cec2c74,3,1,3,0,0,2,6,4,2,0,2,0,3,3,0,22,CL
5d51b074,6,2,1,2,3,2,3,1,0,0,0,4,10,0,0,22,CL
5dfc6ad5,8,4,4,3,1,4,11,7,5,3,2,7,15,5,0,22,CL
5eae500a,0,0,0,0,0,0,0,0,0,0,0,0,0,1,0,22,CL
5eaf85b5,5,2,5,0,0,1,3,2,6,3,3,8,13,15,0,22,CL
5ed9b537,16,11,13,2,1,10,15,5,10,4,6,13,29,24,1,22,CL
5eecec3d,3,3,2,1,0,2,2,0,6,3,3,3,6,8,1,22,CL
5ef3d210,0,0,0,0,0,0,2,2,2,0,2,1,1,0,0,22,CL
5fa57166,0,0,0,0,0,0,0,0,0,0,0,1,1,1,0,22,CL
6025fab1,15,9,5,6,4,7,20,13,5,1,4,16,31,5,0,22,CL
603116a7,2,1,0,0,2,1,1,0,0,0,0,2,4,2,0,22,CL
61590953,5,2,4,1,0,2,5,3,5,3,2,24,29,18,0,22,CL
615c4d8f,0,0,0,0,0,0,0,0,0,0,0,0,0,0,0,22,CL
625c144a,0,0,0,0,0,0,1,1,1,0,1,0,0,8,3,22,CL
62ab9184,6,5,3,3,0,3,5,2,1,0,1,0,6,0,0,22,CL
636247ca,7,4,3,2,2,5,8,3,4,1,3,2,9,2,0,22,CL
63f04c6c,9,3,3,4,2,2,6,4,5,0,5,4,13,8,0,22,CL
6412cc03,0,0,0,0,0,0,2,2,0,0,0,0,0,2,0,22,CL
6434f10d,26,17,13,11,2,17,24,7,8,1,7,14,40,7,0,22,CL
645a3363,6,5,1,2,3,4,9,5,3,1,2,1,7,1,0,22,CL
652d4c37,2,0,1,1,0,1,7,6,3,1,2,4,6,3,0,22,CL
65d62814,0,0,0,0,0,0,2,2,0,0,0,0,0,2,0,22,CL
6622454d,7,4,1,3,3,0,3,3,6,1,5,4,11,1,0,22,CL
6796e284,3,2,0,2,1,1,1,0,2,0,2,0,3,0,0,22,CL
67b3d74b,9,5,6,3,0,5,8,3,0,0,0,3,12,6,0,22,CL
67cdbc0e,20,13,9,7,4,5,12,7,5,1,4,4,24,6,0,22,CL
68252d6d,0,0,0,0,0,0,2,2,2,1,1,1,1,0,1,22,CL
683a8f5f,1,1,1,0,0,0,1,1,0,0,0,0,1,1,0,22,CL
6853490f,3,1,2,0,1,2,6,4,3,0,3,1,4,3,0,22,CL
6885cc44,13,7,9,2,2,5,16,11,9,2,7,11,24,6,0,22,CL
691bef82,12,5,6,6,0,6,12,6,12,3,9,5,17,11,0,22,CL
6928979a,15,6,2,6,7,7,16,9,3,0,3,5,20,0,0,22,CL
69384e5d,6,3,4,2,0,2,7,5,2,0,2,0,6,0,1,22,CL
6a829019,13,7,11,2,0,8,11,3,2,1,1,8,21,9,0,22,CL
6af56975,19,9,12,5,2,6,16,10,13,4,9,11,30,5,0,22,CL
6b21b7b5,3,1,0,3,0,1,1,0,2,0,2,0,3,2,0,22,CL
6b8887c2,1,0,0,0,1,1,3,2,2,1,1,0,1,0,0,22,CL
6b915aa1,6,4,3,1,2,4,11,7,3,0,3,11,17,3,0,22,CL
6c330f30,2,1,0,1,1,1,3,2,1,0,1,1,3,3,0,22,CL
6c7762c3,37,25,25,10,2,17,42,25,13,6,7,12,49,24,2,22,CL
6ce1f46f,23,14,9,13,1,7,22,15,6,2,4,6,29,3,0,22,CL
6ce43701,0,0,0,0,0,0,1,1,2,0,2,0,0,0,0,22,CL
6e4df551,2,1,1,0,1,0,3,3,5,0,5,0,2,1,0,22,CL
6eee05f1,4,4,1,1,2,0,2,2,3,1,2,7,11,5,0,22,CL
6f3cc2fe,2,0,1,0,1,2,3,1,4,0,4,0,2,4,0,22,CL
6f51e382,0,0,0,0,0,0,0,0,0,0,0,0,0,1,1,22,CL
6fa3c28e,0,0,0,0,0,0,0,0,0,0,0,0,0,0,0,22,CL
6fe90922,13,6,7,3,3,6,10,4,5,2,3,7,20,11,0,22,CL
708d068c,1,1,1,0,0,0,0,0,1,0,1,1,2,0,0,22,CL
70cf63ca,11,4,6,5,0,6,19,13,3,0,3,5,16,1,0,22,CL
70d74ece,3,2,0,2,1,0,7,7,11,0,11,1,4,11,0,22,CL
7111d552,21,11,7,7,7,6,17,11,10,0,10,2,23,1,0,22,CL
7120a04d,2,1,1,1,0,0,7,7,2,0,2,2,4,0,0,22,CL
713c144a,5,2,1,3,1,0,5,5,4,0,4,2,7,3,0,22,CL
728e9b2e,0,0,0,0,0,0,0,0,0,0,0,0,0,1,0,22,CL
72c812f3,14,8,9,2,3,2,6,4,5,1,4,7,21,6,0,22,CL
733e7ad8,4,4,1,3,0,3,9,6,5,1,4,6,10,1,0,22,CL
73affbb6,1,0,0,1,0,0,0,0,0,0,0,0,1,0,0,22,CL
74419746,1,1,1,0,0,0,0,0,0,0,0,0,1,1,0,22,CL
7460ca0d,20,9,9,7,4,8,16,8,10,1,9,9,29,5,1,22,CL
74b7375f,9,5,3,5,1,6,11,5,2,0,2,3,12,2,0,22,CL
74dc806c,0,0,0,0,0,0,0,0,0,0,0,0,0,0,0,22,CL
75b86fb3,7,5,5,2,0,3,9,6,13,1,12,6,13,16,0,22,CL
760fd987,1,0,1,0,0,0,1,1,3,3,0,2,3,4,0,22,CL
76c131da,1,1,0,1,0,0,0,0,0,0,0,1,2,1,0,22,CL
76c98b58,0,0,0,0,0,0,0,0,0,0,0,0,0,2,0,22,CL
770ebf00,2,0,1,1,0,2,5,3,2,0,2,4,6,2,0,22,CL
7713c72a,0,0,0,0,0,0,0,0,1,1,0,1,1,2,0,22,CL
77e84962,13,11,3,7,3,6,16,10,10,0,10,16,29,9,1,22,CL
780e3631,5,3,2,0,3,3,4,1,3,0,3,1,6,1,0,22,CL
79443529,0,0,0,0,0,0,0,0,0,0,0,0,0,0,0,22,CL
79c0821a,13,7,5,8,0,5,10,5,6,0,6,0,13,1,1,22,CL
7a11550b,4,1,1,2,1,3,3,0,2,1,1,7,11,6,0,22,CL
7a20d90a,1,1,1,0,0,1,3,2,3,3,0,1,2,11,0,22,CL
7a2e46a8,1,1,1,0,0,1,2,1,1,0,1,0,1,5,0,22,CL
7b4c1f6e,1,1,0,0,1,1,1,0,0,0,0,0,1,0,0,22,CL
7b9c2d84,14,7,3,8,3,5,14,9,7,1,6,0,14,6,0,22,CL
7ba6d84e,0,0,0,0,0,0,0,0,0,0,0,0,0,0,1,22,CL
7c56da38,11,6,3,6,2,6,10,4,9,2,7,4,15,0,0,22,CL
7d3e7da6,0,0,0,0,0,0,0,0,0,0,0,0,0,1,0,22,CL
7e98cff1,1,0,1,0,0,1,1,0,0,0,0,0,1,0,0,22,CL
7ea03b7d,0,0,0,0,0,0,0,0,0,0,0,0,0,0,0,22,CL
7ed08d5c,0,0,0,0,0,0,1,1,1,0,1,0,0,0,0,22,CL
7edfbb8a,5,2,3,2,0,2,5,3,14,11,3,5,10,21,2,22,CL
7f3b388c,30,18,6,18,6,16,24,8,17,0,17,18,48,4,0,22,CL
7fe90ccd,5,3,4,0,1,4,7,3,7,0,7,2,7,2,0,22,CL
801831fe,1,1,1,0,0,0,1,1,1,0,1,0,1,0,0,22,CL
810e3c74,2,2,2,0,0,0,3,3,1,0,1,1,3,0,1,22,CL
81442ecb,15,10,8,5,2,6,13,7,4,1,3,7,22,4,1,22,CL
817c6964,2,2,2,0,0,1,2,1,8,3,5,3,5,3,0,22,CL
819b3158,7,4,2,5,0,2,7,5,8,1,7,7,14,1,0,22,CL
81f0781e,8,5,3,3,2,4,14,10,1,1,0,3,11,5,0,22,CL
828657ff,9,6,6,2,1,4,5,1,2,0,2,0,9,3,0,22,CL
82a39b66,6,3,3,3,0,3,11,8,3,2,1,4,10,6,0,22,CL
82e12fe7,4,2,1,2,1,1,1,0,2,0,2,0,4,0,0,22,CL
8474cb83,0,0,0,0,0,0,4,4,0,0,0,2,2,6,0,22,CL
85686f86,0,0,0,0,0,0,0,0,0,0,0,0,0,0,0,22,CL
85f7d1be,7,3,6,1,0,2,3,1,1,1,0,3,10,2,0,22,CL
867239d3,7,3,1,5,1,2,5,3,3,1,2,1,8,2,1,22,CL
8696bc90,0,0,0,0,0,0,1,1,1,0,1,1,1,0,0,22,CL
86dd77d1,13,7,8,5,0,10,12,2,6,4,2,9,22,7,0,22,CL
86e119e0,11,6,4,5,2,5,14,9,6,2,4,5,16,7,0,22,CL
86e7deaf,7,5,4,3,0,4,5,1,8,6,2,12,19,14,0,22,CL
8778c910,0,0,0,0,0,0,0,0,0,0,0,0,0,2,1,22,CL
8794e251,14,11,7,5,2,4,9,5,9,1,8,7,21,7,0,22,CL
886f9aac,4,3,1,3,0,1,4,3,5,0,5,1,5,2,0,22,CL
88968486,13,7,12,1,0,8,13,5,9,5,4,10,23,29,0,22,CL
88e357ef,7,4,1,4,2,3,5,2,6,1,5,4,11,0,0,22,CL
89151b16,7,3,4,2,1,3,5,2,4,0,4,13,20,18,1,22,CL
892d5bb1,19,12,8,8,3,7,26,19,17,1,16,8,27,2,0,22,CL
89ac64a6,6,6,5,1,0,3,6,3,9,2,7,9,15,13,0,22,CL
89f951b5,3,1,0,3,0,2,5,3,3,1,2,5,8,0,0,22,CL
8aafd64f,3,0,1,1,1,2,8,6,2,0,2,8,11,8,0,22,CL
8b3ab7ad,17,13,6,9,2,10,21,11,8,1,7,4,21,11,0,22,CL
8b788c01,0,0,0,0,0,0,0,0,0,0,0,0,0,1,0,22,CL
8b8a56ce,5,1,2,3,0,4,9,5,5,4,1,3,8,16,0,22,CL
8b8e759d,8,6,4,3,1,4,7,3,2,0,2,2,10,6,0,22,CL
8bbe2df5,1,1,0,0,1,1,1,0,0,0,0,0,1,0,0,22,CL
8ce30c57,14,8,10,3,1,5,14,9,12,3,9,12,26,5,0,22,CL
8d46713e,10,5,5,2,3,2,13,11,8,1,7,5,15,6,0,22,CL
8d78e732,4,2,0,3,1,2,6,4,5,0,5,1,5,2,0,22,CL
8e034340,8,5,2,4,2,2,2,0,5,0,5,4,12,2,0,22,CL
8e7f49d3,15,10,11,4,0,10,17,7,8,0,8,9,24,11,0,22,CL
8eec784d,5,4,3,2,0,4,5,1,4,0,4,1,6,1,0,22,CL
8f0f2230,3,2,3,0,0,1,6,5,0,0,0,1,4,1,0,22,CL
8f5e92a6,8,6,3,1,4,4,11,7,6,2,4,11,19,5,0,22,CL
8f696594,3,2,0,2,1,1,2,1,2,0,2,1,4,0,0,22,CL
8fb94908,1,1,0,0,1,1,3,2,2,1,1,0,1,1,0,22,CL
8fd9996f,3,2,2,1,0,2,2,0,3,2,1,4,7,15,1,22,CL
90f87966,9,4,6,3,0,4,6,2,7,1,6,8,17,31,0,22,CL
9139bb12,2,1,1,1,0,2,5,3,1,0,1,0,2,1,0,22,CL
91748070,0,0,0,0,0,0,0,0,1,1,0,0,0,3,0,22,CL
921f6058,16,9,12,2,2,8,8,0,9,5,4,13,29,15,0,22,CL
92432bc6,10,4,4,4,2,4,7,3,2,0,2,3,13,1,0,22,CL
92ffb8f9,3,2,2,0,1,2,3,1,3,0,3,2,5,4,0,22,CL
934e1968,1,1,0,1,0,0,3,3,1,0,1,0,1,4,0,22,CL
935e6b8f,12,5,7,3,2,6,11,5,9,2,7,13,25,3,0,22,CL
93fffbcf,1,1,1,0,0,1,1,0,0,0,0,0,1,0,2,22,CL
94721522,4,3,4,0,0,1,1,0,4,1,3,4,8,3,0,22,CL
947e036f,9,6,3,5,1,3,10,7,4,2,2,4,13,3,0,22,CL
94b2001f,9,2,8,1,0,5,9,4,5,2,3,11,20,19,0,22,CL
953597a1,3,2,3,0,0,3,4,1,5,4,1,18,21,16,0,22,CL
95bb6ddc,0,0,0,0,0,0,0,0,0,0,0,0,0,0,0,22,CL
96094cbc,1,0,1,0,0,0,4,4,0,0,0,0,1,0,0,22,CL
963829d0,10,6,5,2,3,5,16,11,2,0,2,0,10,4,0,22,CL
96593e89,1,1,0,0,1,1,1,0,1,0,1,0,1,0,0,22,CL
9674002f,9,8,1,4,4,3,9,6,3,0,3,0,9,0,0,22,CL
96e0490d,7,3,2,2,3,2,4,2,4,0,4,2,9,2,0,22,CL
970b8574,7,4,1,6,0,3,8,5,2,1,1,3,10,5,0,22,CL
9744ff80,7,2,3,2,2,6,14,8,5,0,5,4,11,1,0,22,CL
98d2c2c4,8,1,4,4,0,4,10,6,9,2,7,7,15,8,0,22,CL
99127249,11,7,3,6,2,5,12,7,11,0,11,3,14,0,0,22,CL
9a2e0ccc,3,2,0,1,2,2,12,10,6,0,6,2,5,2,0,22,CL
9b6d9b53,12,6,7,3,2,7,13,6,7,0,7,9,21,10,0,22,CL
9c94165b,4,3,3,1,0,2,4,2,4,1,3,9,13,8,0,22,CL
9dc96f10,1,1,0,1,0,0,1,1,3,0,3,1,2,0,0,22,CL
9e1035f8,0,0,0,0,0,0,1,1,1,0,1,1,1,0,0,22,CL
9e525177,12,7,4,4,4,5,6,1,4,1,3,11,23,8,0,22,CL
9f8e9423,3,1,0,3,0,1,2,1,6,4,2,5,8,16,1,22,CL
9fec8860,1,0,0,1,0,1,1,0,0,0,0,3,4,2,0,22,CL
a04e2dd2,0,0,0,0,0,0,0,0,0,0,0,0,0,2,0,22,CL
a086ae11,1,0,0,0,1,0,0,0,0,0,0,0,1,0,0,22,CL
a08b974a,7,3,4,0,3,4,11,7,8,1,7,3,10,0,0,22,CL
a111cf41,1,0,1,0,0,1,1,0,0,0,0,0,1,2,1,22,CL
a1232f4e,3,2,3,0,0,1,2,1,6,4,2,5,8,7,0,22,CL
a167537f,6,4,3,2,1,5,16,11,8,0,8,4,10,2,0,22,CL
a1d5bd30,6,6,2,3,1,2,2,0,5,0,5,0,6,0,0,22,CL
a26fb8aa,5,2,3,1,1,1,3,2,5,2,3,0,5,1,0,22,CL
a2c51161,0,0,0,0,0,0,1,1,0,0,0,0,0,0,0,22,CL
a39bb753,1,1,0,1,0,1,3,2,1,0,1,0,1,0,0,22,CL
a45eac1f,0,0,0,0,0,0,0,0,0,0,0,0,0,1,0,22,CL
a4851d9e,3,0,2,1,0,1,1,0,0,0,0,3,6,5,0,22,CL
a4effc55,2,2,1,1,0,0,0,0,0,0,0,1,3,1,0,22,CL
a5420709,0,0,0,0,0,0,1,1,0,0,0,1,1,0,0,22,CL
a58bb1e1,0,0,0,0,0,0,0,0,0,0,0,0,0,0,0,22,CL
a6154613,1,1,0,0,1,1,1,0,0,0,0,1,2,2,0,22,CL
a62c16d0,3,2,1,0,2,2,9,7,4,0,4,5,8,5,0,22,CL
a63a995f,1,0,1,0,0,1,1,0,1,0,1,0,1,4,0,22,CL
a65ce836,1,1,1,0,0,0,2,2,1,0,1,0,1,0,0,22,CL
a6951bf8,6,4,2,4,0,3,10,7,9,4,5,10,16,7,0,22,CL
a6de6361,0,0,0,0,0,0,0,0,0,0,0,0,0,0,0,22,CL
a6ee4f55,0,0,0,0,0,0,6,6,1,0,1,1,1,0,0,22,CL
a78ff07f,22,13,4,15,3,10,21,11,8,2,6,7,29,7,0,22,CL
a793f5a8,1,1,0,1,0,0,1,1,0,0,0,0,1,0,0,22,CL
a7a9d95a,1,1,0,1,0,0,0,0,0,0,0,0,1,0,0,22,CL
a802405e,1,1,0,1,0,1,1,0,0,0,0,1,2,0,1,22,CL
a81ed730,0,0,0,0,0,0,2,2,0,0,0,1,1,0,0,22,CL
a8542814,6,4,4,2,0,3,5,2,7,1,6,1,7,2,0,22,CL
a8a874f1,13,7,8,4,1,2,9,7,11,6,5,9,22,3,0,22,CL
a9107589,0,0,0,0,0,0,0,0,0,0,0,0,0,2,0,22,CL
a9aa0d1d,1,0,1,0,0,0,0,0,1,0,1,0,1,0,0,22,CL
abb3bb95,0,0,0,0,0,0,1,1,3,1,2,1,1,0,0,22,CL
abe66106,6,2,4,0,2,3,6,3,2,1,1,0,6,2,0,22,CL
ac73ec79,15,5,10,4,1,7,14,7,5,2,3,8,23,10,0,22,CL
ad1ffcfd,0,0,0,0,0,0,0,0,0,0,0,2,2,0,0,22,CL
ad597bf7,5,4,3,2,0,3,6,3,1,0,1,2,7,1,0,22,CL
ad6df2d5,2,0,0,0,2,2,6,4,3,0,3,2,4,1,0,22,CL
ad9b2747,2,1,0,1,1,0,0,0,1,0,1,1,3,0,0,22,CL
adfc9123,7,5,4,3,0,3,7,4,5,4,1,10,17,14,0,22,CL
ae1159bf,9,6,6,3,0,5,10,5,8,3,5,10,19,10,0,22,CL
ae44e8e2,1,0,1,0,0,0,2,2,0,0,0,1,2,0,0,22,CL
ae4e2852,11,8,7,4,0,7,11,4,1,0,1,7,18,2,0,22,CL
ae530c73,4,4,2,2,0,3,3,0,3,0,3,2,6,0,0,22,CL
aef6e670,11,9,8,3,0,7,8,1,9,8,1,5,16,31,0,22,CL
b056e3da,0,0,0,0,0,0,0,0,0,0,0,0,0,2,0,22,CL
b0b4fd3e,9,3,4,2,3,3,4,1,3,0,3,3,12,1,0,22,CL
b0b902c8,6,4,4,2,0,4,9,5,3,1,2,1,7,7,0,22,CL
b0f7e36c,3,2,0,1,2,1,6,5,2,1,1,1,4,0,0,22,CL
b19db005,0,0,0,0,0,0,2,2,0,0,0,0,0,0,0,22,CL
b1cbc666,9,6,9,0,0,4,8,4,8,0,8,3,12,2,0,22,CL
b1dae700,0,0,0,0,0,0,1,1,0,0,0,0,0,0,0,22,CL
b1f4086c,20,12,18,2,0,12,29,17,13,7,6,7,27,21,0,22,CL
b217ef29,8,6,3,3,2,4,5,1,2,1,1,6,14,16,0,22,CL
b2336681,12,5,7,5,0,6,7,1,8,3,5,6,18,20,0,22,CL
b2bd0f6c,8,7,3,4,1,6,12,6,5,0,5,7,15,6,0,22,CL
b37c0a9f,0,0,0,0,0,0,1,1,1,0,1,1,1,2,0,22,CL
b400bde0,8,2,0,5,3,2,8,6,7,0,7,2,10,0,0,22,CL
b492126a,3,2,1,2,0,3,3,0,0,0,0,1,4,0,0,22,CL
b4a014b1,7,3,4,3,0,6,9,3,10,6,4,3,10,21,2,22,CL
b4c816a9,0,0,0,0,0,0,1,1,0,0,0,0,0,0,0,22,CL
b583aef5,0,0,0,0,0,0,0,0,0,0,0,0,0,0,0,22,CL
b5f7d10b,13,9,11,2,0,8,9,1,7,2,5,5,18,7,1,22,CL
b62878a5,0,0,0,0,0,0,0,0,0,0,0,0,0,0,0,22,CL
b66315ae,5,2,1,2,2,1,2,1,5,0,5,2,7,1,0,22,CL
b684a484,3,3,0,3,0,2,4,2,2,1,1,1,4,2,0,22,CL
b70bde8f,0,0,0,0,0,0,1,1,0,0,0,1,1,0,0,22,CL
b74277a0,28,20,7,14,7,10,17,7,10,4,6,4,32,13,0,22,CL
b797f558,4,4,2,2,0,0,5,5,0,0,0,1,5,0,0,22,CL
b825a650,6,4,3,3,0,1,5,4,5,2,3,6,12,2,0,22,CL
b853e0ad,13,7,4,7,2,5,13,8,4,1,3,7,20,4,0,22,CL
b8798a46,0,0,0,0,0,0,0,0,0,0,0,0,0,5,0,22,CL
b8814868,3,3,0,3,0,0,7,7,1,0,1,2,5,0,0,22,CL
b8a642fc,4,1,1,1,2,2,6,4,1,0,1,1,5,2,0,22,CL
b8e740fb,14,8,4,7,3,4,15,11,6,1,5,6,20,12,0,22,CL
b937e490,0,0,0,0,0,0,1,1,1,1,0,0,0,2,1,22,CL
b997c3de,11,7,4,7,0,4,12,8,4,0,4,9,20,2,0,22,CL
b9e1436c,1,0,0,0,1,1,1,0,0,0,0,0,1,0,0,22,CL
b9f92e76,0,0,0,0,0,0,0,0,0,0,0,0,0,0,0,22,CL
b9fbae28,10,5,3,5,2,2,9,7,9,1,8,5,15,2,0,22,CL
ba115a40,3,0,2,0,1,1,3,2,5,0,5,1,4,4,0,22,CL
ba23a904,15,7,7,8,0,4,6,2,11,7,4,12,27,42,1,22,CL
bac46a10,13,10,5,6,2,4,11,7,7,1,6,12,25,24,1,22,CL
bbd67769,0,0,0,0,0,0,0,0,0,0,0,0,0,0,0,22,CL
bbf5c11b,1,1,0,1,0,0,1,1,1,0,1,0,1,3,0,22,CL
bc8df459,4,2,1,1,2,3,12,9,3,1,2,0,4,0,0,22,CL
bcb2ccd8,0,0,0,0,0,0,0,0,1,0,1,1,1,0,0,22,CL
bd20f4eb,1,0,1,0,0,1,3,2,0,0,0,2,3,4,0,22,CL
bd6351cd,13,9,9,2,2,7,17,10,6,1,5,25,38,8,0,22,CL
be305255,0,0,0,0,0,0,0,0,0,0,0,0,0,1,0,22,CL
bec8a4ba,2,0,1,0,1,0,3,3,6,6,0,4,6,17,0,22,CL
bfae110f,0,0,0,0,0,0,0,0,0,0,0,0,0,0,0,22,CL
bfc5768b,9,3,4,2,3,2,8,6,2,0,2,3,12,1,0,22,CL
bfde3de5,1,1,0,1,0,0,6,6,4,0,4,1,2,2,0,22,CL
c0617e2b,5,1,3,2,0,2,6,4,0,0,0,1,6,1,0,22,CL
c14bc029,8,4,3,5,0,3,4,1,7,3,4,2,10,8,0,22,CL
c1b7847c,13,7,5,3,5,1,21,20,10,0,10,7,20,0,0,22,CL
c20bdcd7,34,23,24,10,0,24,27,3,15,7,8,10,44,16,0,22,CL
c2111b45,0,0,0,0,0,0,0,0,0,0,0,1,1,1,0,22,CL
c24544c7,3,2,3,0,0,3,5,2,2,1,1,1,4,0,0,22,CL
c275947b,6,4,0,4,2,2,9,7,4,0,4,3,9,0,0,22,CL
c2bd8585,7,6,2,3,2,4,9,5,5,1,4,6,13,3,1,22,CL
c3e4ecbb,5,3,4,1,0,3,6,3,1,0,1,5,10,5,0,22,CL
c3ee18ef,16,10,8,6,2,9,11,2,8,2,6,10,26,10,0,22,CL
c459a650,11,7,6,3,2,6,9,3,4,1,3,6,17,6,0,22,CL
c4e87b8b,2,1,1,1,0,1,5,4,6,0,6,0,2,4,0,22,CL
c50e5bba,16,10,11,4,1,7,9,2,8,2,6,10,26,17,0,22,CL
c56dc39e,14,11,6,7,1,9,12,3,3,1,2,4,18,5,0,22,CL
c5cbbcff,2,2,2,0,0,2,3,1,1,1,0,1,3,0,0,22,CL
c691bfe2,9,5,1,3,5,2,9,7,8,0,8,0,9,5,0,22,CL
c71e97ba,21,10,14,6,1,9,19,10,11,3,8,12,33,5,1,22,CL
c8112d1e,3,2,3,0,0,2,4,2,5,1,4,7,10,14,0,22,CL
c89e8aae,0,0,0,0,0,0,0,0,0,0,0,0,0,1,0,22,CL
c906ce0f,4,3,2,2,0,2,4,2,6,3,3,6,10,14,0,22,CL
c952f633,12,10,9,3,0,9,12,3,2,0,2,6,18,7,0,22,CL
c9817014,7,2,4,3,0,1,10,9,1,0,1,4,11,0,0,22,CL
ca2bc3df,0,0,0,0,0,0,0,0,0,0,0,0,0,0,0,22,CL
ca607d59,3,2,1,1,1,0,1,1,3,0,3,1,4,0,0,22,CL
ca8033cb,7,3,6,1,0,3,5,2,7,4,3,8,15,11,0,22,CL
cb641b9d,2,1,0,1,1,1,3,2,2,0,2,0,2,2,0,22,CL
cc86b9a3,12,8,4,6,2,6,13,7,6,2,4,7,19,5,0,22,CL
ccce7025,6,3,5,1,0,3,4,1,3,2,1,3,9,20,0,22,CL
cce181df,20,16,10,10,0,7,16,9,4,2,2,14,34,3,0,22,CL
cd0fa27b,5,2,1,4,0,3,7,4,4,0,4,2,7,2,0,22,CL
cd1acf9d,17,7,8,5,4,12,27,15,6,0,6,9,26,11,0,22,CL
cd59b9df,1,0,1,0,0,1,1,0,0,0,0,0,1,1,0,22,CL
cdf65d12,2,1,2,0,0,2,3,1,9,5,4,2,4,11,1,22,CL
ce30bfc8,4,2,4,0,0,2,2,0,2,0,2,1,5,3,0,22,CL
ce50fd99,6,2,1,4,1,3,6,3,7,3,4,3,9,2,0,22,CL
ce747d2a,1,1,1,0,0,1,2,1,0,0,0,0,1,1,0,22,CL
cf182add,6,3,2,3,1,0,3,3,8,4,4,5,11,14,0,22,CL
d0d8dd44,5,4,1,4,0,2,6,4,5,4,1,11,16,13,0,22,CL
d2416c2e,0,0,0,0,0,0,2,2,0,0,0,1,1,4,0,22,CL
d2424d1b,7,5,0,4,3,3,3,0,2,0,2,1,8,1,0,22,CL
d248cd8f,15,13,9,6,0,11,21,10,9,2,7,14,29,11,0,22,CL
d313e8ff,0,0,0,0,0,0,0,0,0,0,0,0,0,2,0,22,CL
d38fdf53,19,9,15,2,2,5,12,7,7,2,5,10,29,30,0,22,CL
d3de9af0,4,3,1,0,3,1,1,0,4,1,3,0,4,2,0,22,CL
d436eb94,0,0,0,0,0,0,0,0,0,0,0,0,0,5,0,22,CL
d4c9725f,6,5,6,0,0,3,6,3,2,2,0,3,9,12,0,22,CL
d4e93bab,5,4,2,2,1,1,4,3,4,1,3,3,8,3,0,22,CL
d4f034db,1,1,1,0,0,1,1,0,3,1,2,1,2,9,0,22,CL
d5d22a58,7,4,5,0,2,2,6,4,6,1,5,2,9,2,0,22,CL
d5f2f82b,10,7,7,3,0,3,4,1,16,9,7,4,14,41,1,22,CL
d6e53a3a,7,5,6,1,0,5,7,2,4,2,2,9,16,23,0,22,CL
d70ce98e,3,0,3,0,0,0,8,8,4,0,4,0,3,0,0,22,CL
d7553721,17,14,9,6,2,5,13,8,10,2,8,3,20,5,0,22,CL
d781d855,17,10,8,3,6,3,5,2,6,3,3,6,23,10,0,22,CL
d8931174,8,5,5,2,1,5,5,0,3,1,2,5,13,12,0,22,CL
d8c679be,2,1,0,2,0,1,1,0,1,0,1,0,2,0,0,22,CL
d93c2511,4,0,2,1,1,2,6,4,6,3,3,9,13,4,0,22,CL
d9565625,10,7,7,3,0,7,10,3,3,0,3,2,12,6,0,22,CL
d9d43555,8,8,2,2,4,3,8,5,1,0,1,2,10,1,0,22,CL
da27e268,3,0,0,1,2,0,0,0,2,0,2,1,4,0,0,22,CL
db092d3b,15,8,5,9,1,10,16,6,6,1,5,5,20,4,1,22,CL
db401046,0,0,0,0,0,0,0,0,0,0,0,0,0,1,0,22,CL
db4ed67b,7,4,3,2,2,2,9,7,2,0,2,0,7,0,0,22,CL
dbf053da,8,2,2,2,4,4,9,5,5,0,5,3,11,3,0,22,CL
dc3a9a0d,5,4,2,3,0,2,18,16,3,0,3,5,10,1,0,22,CL
dc52c72f,8,5,6,2,0,2,4,2,5,3,2,5,13,8,0,22,CL
dc62b55d,2,1,1,0,1,0,2,2,0,0,0,3,5,2,0,22,CL
dc7f8a28,2,0,1,0,1,0,2,2,0,0,0,0,2,0,0,22,CL
dc90cfbe,0,0,0,0,0,0,0,0,1,0,1,0,0,2,0,22,CL
dd323728,6,5,4,1,1,4,6,2,7,1,6,1,7,2,0,22,CL
dd669209,11,5,6,4,1,7,12,5,3,0,3,1,12,2,0,22,CL
dd7b6eb8,0,0,0,0,0,0,0,0,0,0,0,0,0,2,0,22,CL
dd897ee7,0,0,0,0,0,0,0,0,0,0,0,0,0,0,0,22,CL
de39485a,7,5,5,2,0,3,15,12,1,0,1,2,9,2,0,22,CL
de85e3cc,6,3,3,2,1,3,10,7,5,0,5,3,9,5,0,22,CL
dea698d9,3,1,1,1,1,2,3,1,6,0,6,0,3,7,0,22,CL
df3cda47,2,1,1,1,0,0,2,2,0,0,0,0,2,1,0,22,CL
df418fc0,3,2,1,2,0,3,5,2,11,5,6,12,15,34,0,22,CL
df69b544,15,8,5,9,1,7,17,10,5,0,5,4,19,5,0,22,CL
dfb50e5c,1,1,0,1,0,0,2,2,3,0,3,2,3,0,1,22,CL
dff153a4,8,2,4,2,2,5,12,7,5,2,3,5,13,2,0,22,CL
e06683ca,5,2,3,2,0,4,4,0,3,1,2,13,18,29,0,22,CL
e07398f8,0,0,0,0,0,0,0,0,0,0,0,1,1,0,0,22,CL
e0921a4f,3,1,0,0,3,1,5,4,1,0,1,0,3,0,0,22,CL
e150254d,6,2,2,2,2,3,6,3,3,1,2,0,6,0,0,22,CL
e1574c2d,0,0,0,0,0,0,0,0,0,0,0,0,0,1,0,22,CL
e162b013,13,8,9,2,2,5,12,7,5,1,4,11,24,10,0,22,CL
e1d4f20d,0,0,0,0,0,0,0,0,0,0,0,0,0,0,0,22,CL
e27da244,4,3,2,2,0,2,5,3,0,0,0,7,11,19,1,22,CL
e280527c,1,0,1,0,0,0,4,4,2,2,0,2,3,1,0,22,CL
e288d4b3,3,0,3,0,0,1,3,2,0,0,0,2,5,4,0,22,CL
e33c06cf,6,4,3,3,0,2,6,4,1,1,0,5,11,13,0,22,CL
e342ad68,7,3,1,2,4,2,8,6,4,0,4,2,9,0,0,22,CL
e34e086c,2,0,2,0,0,1,4,3,0,0,0,2,4,0,0,22,CL
e382905a,0,0,0,0,0,0,0,0,0,0,0,1,1,0,0,22,CL
e3cceee6,8,4,7,1,0,5,9,4,4,3,1,9,17,20,1,22,CL
e426b012,17,10,13,4,0,12,15,3,14,10,4,6,23,32,0,22,CL
e42d61c7,16,6,11,3,2,12,28,16,13,2,11,5,21,15,0,22,CL
e46012d4,7,4,1,6,0,5,17,12,8,1,7,5,12,1,0,22,CL
e54a9890,0,0,0,0,0,0,0,0,0,0,0,0,0,0,0,22,CL
e599253a,2,1,0,2,0,1,4,3,1,0,1,2,4,3,0,22,CL
e5a35ae9,1,1,0,0,1,0,0,0,1,0,1,2,3,1,0,22,CL
e5a76dfe,0,0,0,0,0,0,0,0,0,0,0,0,0,2,0,22,CL
e5f63987,0,0,0,0,0,0,0,0,0,0,0,0,0,0,0,22,CL
e613313c,3,2,1,2,0,2,2,0,1,0,1,3,6,3,0,22,CL
e61bdd69,0,0,0,0,0,0,0,0,0,0,0,0,0,0,0,22,CL
e6af02e0,12,9,5,7,0,5,13,8,6,1,5,7,19,9,0,22,CL
e6c43eec,8,6,4,4,0,4,9,5,8,5,3,15,23,18,0,22,CL
e7281ea9,0,0,0,0,0,0,0,0,0,0,0,2,2,0,0,22,CL
e73c9bb2,5,2,0,5,0,2,8,6,5,1,4,5,10,4,0,22,CL
e75129bd,4,1,0,3,1,0,0,0,2,1,1,3,7,0,0,22,CL
e76cb9cc,4,2,4,0,0,2,5,3,4,1,3,2,6,19,1,22,CL
e7af9060,6,4,2,4,0,1,7,6,4,0,4,1,7,4,0,22,CL
e81f0356,6,4,4,1,1,2,6,4,5,2,3,14,20,17,0,22,CL
e85fb9b8,0,0,0,0,0,0,0,0,0,0,0,0,0,3,0,22,CL
e8deefd6,0,0,0,0,0,0,0,0,0,0,0,0,0,0,0,22,CL
e97fd090,9,6,2,5,2,4,7,3,3,0,3,1,10,0,0,22,CL
e9c0c1b2,0,0,0,0,0,0,0,0,0,0,0,0,0,1,1,22,CL
ea3b4578,2,2,1,0,1,0,0,0,0,0,0,1,3,0,0,22,CL
ea6a7ab4,0,0,0,0,0,0,0,0,0,0,0,0,0,0,0,22,CL
eab957a3,2,2,2,0,0,0,0,0,7,4,3,13,15,19,0,22,CL
eaeca114,4,2,3,1,0,2,3,1,1,0,1,12,16,17,0,22,CL
eb2b33aa,0,0,0,0,0,0,0,0,0,0,0,0,0,4,1,22,CL
eb2fe5b6,2,1,0,2,0,1,3,2,0,0,0,1,3,0,0,22,CL
eb58eef0,0,0,0,0,0,0,2,2,3,0,3,1,1,5,0,22,CL
eb7822d7,3,2,1,2,0,1,3,2,0,0,0,4,7,4,2,22,CL
ecada4fc,0,0,0,0,0,0,0,0,0,0,0,0,0,1,0,22,CL
ed1e53f3,6,4,2,4,0,6,10,4,8,0,8,2,8,0,0,22,CL
ed9f7cfe,9,5,4,4,1,5,12,7,7,0,7,7,16,12,1,22,CL
eda40760,0,0,0,0,0,0,0,0,0,0,0,0,0,0,0,22,CL
eda8506a,11,8,7,4,0,5,11,6,3,1,2,8,19,1,0,22,CL
ee251371,13,5,6,5,2,5,16,11,9,1,8,5,18,3,1,22,CL
ee3519f5,4,2,3,1,0,3,7,4,2,1,1,2,6,6,0,22,CL
ee8508c0,0,0,0,0,0,0,0,0,0,0,0,0,0,3,0,22,CL
ee93c1a9,2,1,0,0,2,0,3,3,4,1,3,5,7,1,0,22,CL
ef619b0b,0,0,0,0,0,0,1,1,1,1,0,0,0,1,0,22,CL
ef9c1c95,18,8,8,6,4,11,26,15,13,1,12,8,26,8,1,22,CL
f0021247,6,2,1,5,0,3,6,3,2,0,2,6,12,1,0,22,CL
f0661424,6,5,0,4,2,1,4,3,3,1,2,1,7,1,0,22,CL
f08490a6,2,0,0,2,0,0,2,2,3,0,3,1,3,2,0,22,CL
f090a37a,1,1,1,0,0,0,1,1,0,0,0,0,1,0,0,22,CL
f0da930c,5,2,4,1,0,3,5,2,3,1,2,6,11,27,0,22,CL
f1b55719,3,2,2,1,0,1,4,3,2,0,2,1,4,0,0,22,CL
f20e4cc9,16,7,9,5,2,8,16,8,12,2,10,4,20,17,1,22,CL
f25c8e3a,15,8,4,9,2,6,18,12,12,0,12,3,18,7,0,22,CL
f315ca93,7,5,3,3,1,5,5,0,3,0,3,6,13,6,0,22,CL
f3600c02,5,0,2,2,1,1,14,13,10,1,9,5,10,5,0,22,CL
f38cc3b3,0,0,0,0,0,0,0,0,0,0,0,1,1,1,0,22,CL
f3945e07,2,1,0,1,1,2,2,0,0,0,0,0,2,1,0,22,CL
f4290206,10,6,6,2,2,6,13,7,8,0,8,8,18,5,0,22,CL
f449640d,8,3,4,4,0,3,6,3,0,0,0,3,11,2,0,22,CL
f4797849,1,0,0,1,0,0,0,0,0,0,0,0,1,0,0,22,CL
f49c4ae9,4,3,2,2,0,3,3,0,2,0,2,2,6,0,0,22,CL
f4b52308,0,0,0,0,0,0,4,4,2,0,2,2,2,6,0,22,CL
f4c69aa6,1,1,0,1,0,1,5,4,1,0,1,1,2,0,0,22,CL
f512a009,7,3,5,2,0,2,5,3,3,0,3,3,10,11,0,22,CL
f5c8b425,1,1,1,0,0,1,1,0,0,0,0,0,1,0,0,22,CL
f5deef4c,5,5,3,2,0,4,5,1,7,6,1,4,9,19,0,22,CL
f5dfc256,0,0,0,0,0,0,0,0,0,0,0,0,0,0,0,22,CL
f620b04f,0,0,0,0,0,0,1,1,0,0,0,0,0,1,0,22,CL
f63cda26,7,2,6,1,0,4,10,6,6,0,6,4,11,4,0,22,CL
f6798fc3,0,0,0,0,0,0,0,0,0,0,0,0,0,1,0,22,CL
f6ac68c1,7,5,6,1,0,3,10,7,7,6,1,10,17,17,0,22,CL
f7036e1c,3,3,1,2,0,3,4,1,7,1,6,6,9,1,0,22,CL
f7b10c66,0,0,0,0,0,0,0,0,0,0,0,1,1,0,0,22,CL
f7e87032,8,3,3,3,2,5,15,10,4,0,4,3,11,6,0,22,CL
f833a830,5,3,1,3,1,2,3,1,2,0,2,0,5,0,0,22,CL
f8342731,9,5,7,2,0,6,12,6,8,4,4,5,14,8,0,22,CL
f86cd5df,11,8,1,7,3,7,12,5,9,1,8,1,12,2,0,22,CL
f93c876b,5,4,2,2,1,3,6,3,4,2,2,2,7,5,0,22,CL
f9acca3a,7,5,3,3,1,4,4,0,3,0,3,2,9,2,0,22,CL
f9b1b7bf,8,4,4,3,1,3,4,1,0,0,0,1,9,1,0,22,CL
f9c927de,8,4,4,2,2,4,12,8,3,1,2,10,18,2,0,22,CL
f9edc384,8,6,3,4,1,2,11,9,6,2,4,6,14,7,0,22,CL
fa265f6d,2,1,1,1,0,0,4,4,1,0,1,0,2,0,0,22,CL
fa274d97,7,4,2,4,1,5,6,1,3,1,2,2,9,1,1,22,CL
fa661778,3,1,1,2,0,3,7,4,4,2,2,1,4,1,0,22,CL
fb46125f,9,4,6,2,1,6,14,8,7,6,1,11,20,14,0,22,CL
fb5d47b3,2,2,1,0,1,1,1,0,1,0,1,0,2,1,0,22,CL
fb6530de,19,11,13,6,0,8,20,12,9,1,8,15,34,7,0,22,CL
fb938d24,6,2,5,1,0,1,3,2,3,0,3,3,9,6,0,22,CL
fbd6378b,0,0,0,0,0,0,0,0,0,0,0,0,0,0,0,22,CL
fc4e7637,0,0,0,0,0,0,0,0,1,1,0,0,0,0,0,22,CL
fc62f087,6,2,5,1,0,1,3,2,6,3,3,5,11,9,0,22,CL
fcb27134,2,2,1,1,0,0,3,3,4,1,3,4,6,9,0,22,CL
fcb38f57,0,0,0,0,0,0,0,0,0,0,0,0,0,0,1,22,CL
fd51b456,11,9,4,4,3,5,9,4,5,1,4,0,11,6,0,22,CL
fe154b26,9,5,9,0,0,4,8,4,4,2,2,3,12,0,0,22,CL
fe29c96e,19,12,14,3,2,10,19,9,13,4,9,11,30,34,0,22,CL
fe641c1a,6,5,5,1,0,2,5,3,3,2,1,6,12,3,0,22,CL
fed7cb61,5,2,0,2,3,1,5,4,7,0,7,3,8,6,0,22,CL
ff74841d,0,0,0,0,0,0,0,0,0,0,0,0,0,3,1,22,CL
ffec9769,0,0,0,0,0,0,0,0,1,0,1,0,0,0,0,22,CL
ffed43e3,8,5,5,2,1,1,3,2,10,7,3,4,12,16,0,22,CL
0000acda,7,3,4,2,1,2,12,10,7,0,7,6,13,9,0,22,ITA
00459419,17,9,1,11,5,7,30,23,13,2,11,7,24,17,0,22,ITA
0154d290,10,3,1,6,3,4,7,3,4,0,4,3,13,0,0,22,ITA
01b8a2b2,1,1,1,0,0,1,2,1,0,0,0,0,1,8,1,22,ITA
01c3aff5,20,11,11,7,2,8,26,18,17,8,9,23,43,20,0,22,ITA
01efac19,18,8,9,8,1,5,17,12,32,5,27,6,24,26,0,22,ITA
023937a9,11,7,8,3,0,7,19,12,14,7,7,7,18,29,0,22,ITA
02caf6e0,28,14,13,15,0,16,26,10,10,2,8,12,40,16,1,22,ITA
0375723e,13,9,5,3,5,9,20,11,4,0,4,3,16,1,0,22,ITA
03f946ed,3,3,0,3,0,1,4,3,1,0,1,0,3,5,0,22,ITA
0489bb30,1,1,0,0,1,0,1,1,2,1,1,0,1,7,1,22,ITA
04b40c58,3,2,3,0,0,3,4,1,0,0,0,3,6,1,0,22,ITA
05e19d6a,41,23,12,24,5,17,26,9,39,10,29,23,64,22,0,22,ITA
0728bebe,25,17,15,6,4,12,23,11,18,4,14,11,36,6,0,22,ITA
07767f42,5,4,4,1,0,1,9,8,3,1,2,1,6,3,0,22,ITA
07ea0ef2,3,1,0,3,0,1,4,3,8,4,4,0,3,2,0,22,ITA
0821331c,23,13,17,6,0,14,18,4,19,11,8,20,43,76,0,22,ITA
0847b5a5,20,15,5,9,6,8,33,25,20,2,18,8,28,19,0,22,ITA
085e71a7,0,0,0,0,0,0,0,0,0,0,0,1,1,5,2,22,ITA
08990838,0,0,0,0,0,0,0,0,0,0,0,0,0,0,0,22,ITA
08aa9cd1,11,6,0,7,4,2,18,16,24,3,21,7,18,23,0,22,ITA
08eb3b58,46,30,27,14,5,29,59,30,26,3,23,25,71,33,0,22,ITA
09538fdb,13,7,4,5,4,4,15,11,16,0,16,3,16,7,0,22,ITA
0967845b,35,19,25,5,5,13,31,18,30,10,20,22,57,42,0,22,ITA
09899de8,28,12,14,12,2,15,20,5,34,28,6,9,37,86,0,22,ITA
0a3065c8,15,6,6,6,3,5,12,7,11,2,9,3,18,10,1,22,ITA
0a447501,3,2,0,1,2,1,4,3,11,4,7,2,5,10,0,22,ITA
0a483542,30,14,19,7,4,19,38,19,32,9,23,11,41,52,0,22,ITA
0ab1f153,48,23,30,13,5,30,55,25,23,5,18,29,77,34,0,22,ITA
0acda699,0,0,0,0,0,0,0,0,0,0,0,0,0,0,0,22,ITA
0b5a292a,68,43,32,28,8,39,84,45,31,7,24,40,108,50,0,22,ITA
0be276c6,53,32,40,11,2,33,50,17,38,24,14,44,97,126,1,22,ITA
0cadc46d,1,0,1,0,0,0,5,5,0,0,0,0,1,2,0,22,ITA
0ccac09c,6,3,3,2,1,3,9,6,5,1,4,3,9,12,0,22,ITA
0cf465f2,2,1,0,2,0,1,3,2,1,0,1,0,2,2,0,22,ITA
0d077b88,5,1,2,3,0,3,11,8,7,6,1,3,8,10,0,22,ITA
0d422df7,0,0,0,0,0,0,1,1,0,0,0,1,1,11,1,22,ITA
0d82903c,27,16,15,9,3,11,25,14,17,6,11,27,54,40,0,22,ITA
0db169ae,54,37,23,25,6,21,41,20,26,8,18,34,88,19,0,22,ITA
0dfce079,0,0,0,0,0,0,0,0,0,0,0,0,0,0,0,22,ITA
0fdcef0e,18,9,9,8,1,11,29,18,16,7,9,19,37,15,1,22,ITA
0fee6bda,28,16,18,10,0,10,18,8,54,39,15,28,56,122,1,22,ITA
102e2599,0,0,0,0,0,0,0,0,1,0,1,0,0,0,0,22,ITA
10b9fa99,67,43,37,27,3,24,58,34,49,19,30,51,118,76,0,22,ITA
10dc46f0,1,1,1,0,0,1,2,1,0,0,0,0,1,19,2,22,ITA
10e7f486,21,13,12,5,4,15,22,7,20,8,12,18,39,42,1,22,ITA
11962fe7,9,6,6,3,0,8,13,5,10,2,8,8,17,15,0,22,ITA
1295552e,52,35,43,7,2,27,49,22,25,6,19,24,76,44,1,22,ITA
129af0db,18,9,4,9,5,8,31,23,26,1,25,5,23,24,0,22,ITA
12e6d21a,1,1,0,0,1,0,0,0,0,0,0,0,1,1,0,22,ITA
130a7a3f,4,2,0,2,2,1,8,7,4,1,3,2,6,1,0,22,ITA
13b44b02,96,63,55,32,9,59,114,55,39,13,26,27,123,65,1,22,ITA
149c5f5d,28,13,15,7,6,8,18,10,13,5,8,9,37,16,0,22,ITA
14a96e1c,0,0,0,0,0,0,0,0,0,0,0,0,0,8,2,22,ITA
14b8fcdf,8,5,4,4,0,4,7,3,9,4,5,11,19,47,0,22,ITA
157d29b6,1,1,0,1,0,1,3,2,0,0,0,0,1,0,0,22,ITA
15d0c248,41,23,21,16,4,20,34,14,40,33,7,33,74,102,1,22,ITA
15e9c7e6,2,1,1,1,0,0,1,1,1,0,1,2,4,0,1,22,ITA
16463a79,2,1,0,2,0,0,0,0,0,0,0,0,2,0,0,22,ITA
16657b95,79,39,31,39,9,37,69,32,31,5,26,40,119,45,0,22,ITA
16b9d5cf,14,6,10,4,0,7,9,2,17,11,6,12,26,61,1,22,ITA
16bb656a,30,18,16,10,4,16,25,9,14,11,3,21,51,53,0,22,ITA
16ceb862,15,11,4,6,5,3,17,14,13,4,9,3,18,19,0,22,ITA
173061c0,23,12,16,4,3,16,27,11,15,8,7,28,51,52,0,22,ITA
1780bb4a,46,29,24,15,7,20,30,10,36,13,23,29,75,44,0,22,ITA
17f3620a,5,4,1,1,3,2,3,1,6,0,6,2,7,8,0,22,ITA
19e4eab9,81,46,49,30,2,34,60,26,45,20,25,42,123,89,3,22,ITA
1ac232b8,52,34,28,17,7,21,65,44,38,11,27,30,82,31,0,22,ITA
1c341b14,2,0,1,1,0,1,3,2,4,0,4,3,5,6,0,22,ITA
1c8c5aed,12,9,10,2,0,5,7,2,7,2,5,6,18,20,0,22,ITA
1cadaf34,3,1,0,1,2,0,2,2,1,0,1,1,4,1,1,22,ITA
1d00a56c,0,0,0,0,0,0,0,0,1,0,1,0,0,1,0,22,ITA
1d0bb7e4,20,13,11,6,3,8,16,8,10,5,5,17,37,39,0,22,ITA
1d1691ad,25,15,12,6,7,15,32,17,17,6,11,8,33,25,2,22,ITA
1e26e376,2,2,2,0,0,2,2,0,0,0,0,1,3,10,0,22,ITA
1e9aa637,22,11,13,8,1,9,19,10,12,1,11,22,44,16,0,22,ITA
1fca9171,16,5,2,8,6,9,23,14,17,1,16,9,25,11,0,22,ITA
20094685,69,36,40,27,2,35,87,52,33,7,26,42,111,38,1,22,ITA
20730eae,17,7,3,9,5,10,20,10,12,1,11,12,29,8,0,22,ITA
20b3a502,76,45,36,32,8,32,76,44,38,9,29,32,108,34,1,22,ITA
2110f96c,0,0,0,0,0,0,0,0,0,0,0,0,0,0,0,22,ITA
2146785a,62,37,31,23,8,37,72,35,25,5,20,23,85,40,1,22,ITA
215f3907,27,13,12,11,4,20,36,16,16,1,15,7,34,7,0,22,ITA
217875a4,9,5,7,2,0,3,5,2,5,2,3,7,16,14,0,22,ITA
217c93a1,13,9,4,7,2,7,26,19,6,0,6,2,15,2,0,22,ITA
2200181e,20,12,14,6,0,7,15,8,20,14,6,13,33,57,0,22,ITA
22ae86f9,8,4,4,4,0,3,3,0,5,1,4,4,12,5,0,22,ITA
22bfb57e,30,21,7,17,6,15,29,14,26,6,20,19,49,17,0,22,ITA
22cd43d2,21,13,7,11,3,11,29,18,27,8,19,24,45,42,0,22,ITA
2306bf5c,0,0,0,0,0,0,1,1,0,0,0,0,0,1,0,22,ITA
230a2fac,58,36,30,20,8,33,58,25,28,10,18,38,96,46,1,22,ITA
2334478a,43,26,16,16,11,22,48,26,25,1,24,15,58,29,2,22,ITA
23610943,41,24,17,21,3,16,48,32,24,3,21,22,63,44,2,22,ITA
2374aaca,21,16,6,8,7,9,28,19,26,2,24,21,42,4,1,22,ITA
246d153b,27,19,11,10,6,15,23,8,17,3,14,28,55,30,0,22,ITA
247ed022,46,20,28,14,4,18,32,14,33,8,25,23,69,37,1,22,ITA
26db8853,83,49,37,38,8,50,113,63,51,5,46,54,137,32,1,22,ITA
277da414,0,0,0,0,0,0,1,1,0,0,0,2,2,10,2,22,ITA
2873973b,2,2,2,0,0,0,0,0,2,2,0,0,2,2,0,22,ITA
28f66c2e,20,9,8,10,2,11,16,5,10,2,8,5,25,9,1,22,ITA
2967bcd0,1,0,0,1,0,0,0,0,0,0,0,0,1,0,0,22,ITA
2a1beb34,69,42,33,29,7,34,62,28,36,2,34,45,114,41,0,22,ITA
2a7d27c1,46,16,26,18,2,26,52,26,44,12,32,29,75,62,1,22,ITA
2a82aa85,30,19,9,19,2,7,23,16,21,5,16,22,52,8,0,22,ITA
2b7c18ae,0,0,0,0,0,0,1,1,0,0,0,0,0,0,0,22,ITA
2baec6ce,0,0,0,0,0,0,0,0,1,1,0,0,0,0,0,22,ITA
2c0f8e9e,9,8,0,6,3,2,11,9,4,0,4,2,11,3,0,22,ITA
2c38b327,7,4,1,4,2,3,8,5,10,2,8,4,11,2,0,22,ITA
2cb9486d,4,4,1,2,1,2,9,7,8,1,7,2,6,1,0,22,ITA
2cfae697,25,17,10,12,3,9,22,13,22,5,17,33,58,29,1,22,ITA
2d970560,10,4,4,6,0,4,8,4,9,2,7,12,22,4,0,22,ITA
2d9d9e42,3,2,1,2,0,2,2,0,2,0,2,0,3,0,0,22,ITA
2f3452eb,46,30,25,17,4,29,45,16,18,6,12,24,70,34,1,22,ITA
2f557579,23,14,8,12,3,8,44,36,30,1,29,20,43,3,1,22,ITA
305a3820,0,0,0,0,0,0,0,0,0,0,0,0,0,0,0,22,ITA
30f5ffa9,47,27,26,17,4,24,42,18,36,25,11,25,72,90,1,22,ITA
311027cb,1,1,0,1,0,0,6,6,2,0,2,1,2,2,0,22,ITA
33502726,1,1,0,1,0,0,0,0,0,0,0,0,1,1,0,22,ITA
339fe0e8,0,0,0,0,0,0,0,0,0,0,0,0,0,7,2,22,ITA
33b8d077,77,45,34,35,8,34,68,34,28,10,18,37,114,36,2,22,ITA
33ecf462,11,7,4,5,2,6,16,10,9,0,9,1,12,5,0,22,ITA
343c0d52,27,15,6,12,9,9,39,30,37,3,34,6,33,23,0,22,ITA
343f753a,0,0,0,0,0,0,0,0,0,0,0,1,1,3,0,22,ITA
34693494,4,2,2,2,0,2,9,7,3,1,2,2,6,3,0,22,ITA
356c9002,27,16,9,11,7,19,55,36,23,2,21,33,60,19,0,22,ITA
35a2557c,1,1,0,1,0,0,0,0,2,1,1,0,1,0,0,22,ITA
35b4bc62,3,2,1,1,1,2,3,1,2,0,2,3,6,1,0,22,ITA
35dd6d80,37,21,19,14,4,16,25,9,22,12,10,39,76,57,0,22,ITA
3626daea,0,0,0,0,0,0,1,1,4,1,3,0,0,3,0,22,ITA
36e88fbc,8,4,7,1,0,4,6,2,6,5,1,17,25,33,1,22,ITA
384d58d9,11,7,3,6,2,3,11,8,16,3,13,11,22,7,0,22,ITA
38d9ce53,18,11,6,6,6,5,13,8,7,1,6,4,22,6,0,22,ITA
39583cfd,11,6,2,3,6,7,29,22,14,0,14,9,20,4,0,22,ITA
39aa05a7,1,1,1,0,0,0,0,0,0,0,0,1,2,1,0,22,ITA
3b12b11f,10,7,6,3,1,3,5,2,2,1,1,4,14,16,0,22,ITA
3b333ac3,22,14,10,8,4,11,26,15,11,1,10,7,29,20,0,22,ITA
3b387cc7,1,1,1,0,0,1,2,1,0,0,0,2,3,0,0,22,ITA
3b61c9ec,23,10,13,5,5,12,19,7,9,1,8,5,28,23,0,22,ITA
3b8674e6,32,18,11,18,3,7,20,13,15,2,13,26,58,15,1,22,ITA
3bb7af3b,10,2,1,6,3,6,16,10,5,0,5,1,11,3,0,22,ITA
3bb7f478,14,8,7,4,3,8,25,17,22,5,17,4,18,35,0,22,ITA
3ca7254a,36,23,8,19,9,16,47,31,18,2,16,6,42,8,0,22,ITA
3cd3b384,36,20,22,8,6,17,29,12,19,4,15,29,65,68,1,22,ITA
3d50bcdb,9,4,2,5,2,6,16,10,5,0,5,3,12,8,1,22,ITA
3ead85f9,24,14,14,10,0,14,18,4,21,12,9,19,43,45,0,22,ITA
3ec3c1c9,36,25,23,11,2,21,34,13,22,9,13,19,55,46,0,22,ITA
3ef0a2d7,8,5,3,3,2,4,7,3,7,0,7,4,12,5,0,22,ITA
3ef965c1,2,2,1,0,1,0,2,2,0,0,0,0,2,0,0,22,ITA
3f5f38fb,46,30,25,19,2,21,37,16,31,12,19,49,95,95,0,22,ITA
3f79a1c8,1,0,1,0,0,1,1,0,2,1,1,1,2,0,0,22,ITA
405f6586,1,1,0,1,0,1,3,2,6,1,5,2,3,32,0,22,ITA
407feb71,23,17,3,11,9,8,22,14,11,0,11,8,31,4,0,22,ITA
414e1f69,0,0,0,0,0,0,2,2,0,0,0,1,1,0,0,22,ITA
42eaa028,7,3,2,3,2,3,10,7,10,2,8,1,8,2,0,22,ITA
4431aed2,10,5,4,4,2,1,15,14,7,1,6,3,13,16,0,22,ITA
444c89d9,36,20,24,10,2,14,36,22,16,8,8,20,56,16,0,22,ITA
44510fde,1,1,0,0,1,0,0,0,0,0,0,0,1,2,0,22,ITA
44ac04e9,7,5,2,3,2,3,9,6,10,1,9,4,11,7,0,22,ITA
44eb9093,30,15,21,8,1,11,22,11,21,10,11,8,38,20,0,22,ITA
45191c29,32,19,17,11,4,21,35,14,18,1,17,16,48,4,0,22,ITA
45392b06,2,2,1,1,0,1,2,1,1,1,0,0,2,1,0,22,ITA
457cb02f,0,0,0,0,0,0,0,0,0,0,0,0,0,2,0,22,ITA
45b9b619,11,5,2,6,3,1,13,12,8,1,7,3,14,2,0,22,ITA
4611e028,6,6,4,2,0,4,9,5,5,1,4,5,11,2,1,22,ITA
46fa7204,44,26,13,26,5,7,20,13,22,0,22,8,52,6,0,22,ITA
481c9ece,32,12,9,14,9,16,32,16,15,6,9,9,41,26,0,22,ITA
4830e0af,34,18,10,15,9,7,25,18,10,2,8,7,41,3,0,22,ITA
48b3dd60,25,12,10,14,1,13,24,11,11,2,9,7,32,8,1,22,ITA
48d5bd33,18,10,3,10,5,5,19,14,27,3,24,5,23,1,0,22,ITA
4a0b7f07,53,28,27,20,6,28,63,35,45,13,32,21,74,30,1,22,ITA
4a56052c,34,25,20,12,2,15,39,24,12,1,11,27,61,22,1,22,ITA
4a5a45c7,35,14,10,17,8,16,60,44,29,1,28,27,62,20,0,22,ITA
4ae67f27,20,9,9,8,3,9,13,4,12,6,6,31,51,44,0,22,ITA
4b029b31,12,5,7,5,0,4,11,7,8,5,3,22,34,23,0,22,ITA
4b3e1a38,21,11,15,5,1,15,19,4,36,25,11,19,40,89,0,22,ITA
4b55eb4d,14,8,5,9,0,10,23,13,13,3,10,8,22,12,0,22,ITA
4bd00a50,0,0,0,0,0,0,2,2,0,0,0,2,2,3,0,22,ITA
4c62d0c8,0,0,0,0,0,0,0,0,0,0,0,0,0,3,0,22,ITA
4c78b5ed,55,30,26,25,4,15,53,38,27,10,17,28,83,37,0,22,ITA
4c8845f7,27,16,8,13,6,12,25,13,14,1,13,6,33,2,0,22,ITA
4cde5509,0,0,0,0,0,0,2,2,2,1,1,3,3,9,0,22,ITA
4d1efb48,55,31,33,18,4,25,36,11,45,32,13,30,85,143,0,22,ITA
4e1d5e59,58,33,24,21,13,29,68,39,43,10,33,35,93,32,1,22,ITA
4e358a2d,17,11,10,6,1,9,12,3,21,16,5,27,44,67,1,22,ITA
4e6dbac4,67,44,20,32,15,29,67,38,50,9,41,34,101,43,1,22,ITA
4f2908e5,1,1,0,1,0,1,1,0,0,0,0,0,1,0,0,22,ITA
4f8ce0e1,0,0,0,0,0,0,0,0,0,0,0,0,0,9,1,22,ITA
509a4ccb,8,4,1,5,2,1,10,9,6,0,6,4,12,6,0,22,ITA
5128bde4,36,23,20,8,8,21,39,18,28,4,24,19,55,49,1,22,ITA
52611641,37,29,13,21,3,18,40,22,18,1,17,26,63,18,0,22,ITA
528492ea,34,19,13,16,5,11,32,21,32,3,29,10,44,7,0,22,ITA
5294a83f,29,17,8,11,10,8,52,44,32,4,28,13,42,7,0,22,ITA
52ec54d0,14,5,4,10,0,8,13,5,22,17,5,26,40,82,0,22,ITA
536cebe5,14,8,3,6,5,7,20,13,14,0,14,3,17,3,1,22,ITA
539230cf,8,4,5,1,2,1,3,2,4,3,1,4,12,16,0,22,ITA
53a0e358,32,19,9,16,7,15,57,42,39,2,37,31,63,23,0,22,ITA
53de807a,9,6,3,6,0,5,9,4,7,2,5,5,14,15,0,22,ITA
53e494ec,0,0,0,0,0,0,0,0,0,0,0,0,0,0,0,22,ITA
548fea2f,0,0,0,0,0,0,0,0,0,0,0,0,0,1,0,22,ITA
54e53b7e,43,25,10,22,11,17,51,34,32,0,32,4,47,7,0,22,ITA
54f6afe3,0,0,0,0,0,0,0,0,0,0,0,0,0,1,0,22,ITA
555d5edd,6,4,2,2,2,2,9,7,7,0,7,0,6,0,0,22,ITA
55a1cac2,48,30,17,20,11,21,40,19,32,3,29,25,73,38,0,22,ITA
55e098cd,1,1,0,1,0,0,0,0,2,0,2,0,1,0,0,22,ITA
563a68ad,39,23,27,11,1,16,36,20,30,21,9,44,83,112,0,22,ITA
570bb4b9,32,18,8,14,10,10,46,36,22,2,20,12,44,6,1,22,ITA
5722eced,23,9,7,12,4,10,28,18,14,0,14,12,35,5,0,22,ITA
57469b2d,5,4,0,4,1,1,10,9,8,0,8,2,7,5,0,22,ITA
59be3a74,2,0,1,1,0,0,2,2,1,0,1,2,4,1,0,22,ITA
59bf127b,19,13,9,7,3,5,16,11,8,1,7,9,28,10,2,22,ITA
59f2d958,0,0,0,0,0,0,1,1,0,0,0,0,0,1,0,22,ITA
5a2cb25d,24,13,9,13,2,11,19,8,25,8,17,5,29,6,1,22,ITA
5aa53281,41,25,22,18,1,18,33,15,38,19,19,39,80,69,0,22,ITA
5add9b29,2,0,0,1,1,0,0,0,0,0,0,0,2,0,0,22,ITA
5b418e15,0,0,0,0,0,0,1,1,1,0,1,0,0,0,0,22,ITA
5bd72174,5,2,1,3,1,1,6,5,5,0,5,2,7,10,0,22,ITA
5c522c88,0,0,0,0,0,0,1,1,1,0,1,0,0,0,0,22,ITA
5cbb5ad6,0,0,0,0,0,0,0,0,0,0,0,0,0,1,0,22,ITA
5dafcdce,0,0,0,0,0,0,0,0,0,0,0,0,0,0,0,22,ITA
5e861944,24,12,8,11,5,15,54,39,11,2,9,13,37,5,0,22,ITA
5eaed77a,79,46,44,32,3,48,75,27,32,10,22,42,121,85,0,22,ITA
5efc5389,19,12,16,1,2,11,20,9,18,8,10,31,50,73,0,22,ITA
5fa57166,28,19,17,11,0,8,21,13,25,12,13,35,63,51,0,22,ITA
5fd5ed86,49,24,27,22,0,18,28,10,54,23,31,105,154,137,0,22,ITA
601ef102,0,0,0,0,0,0,0,0,2,0,2,0,0,1,0,22,ITA
614c38fb,23,14,5,14,4,5,12,7,17,6,11,10,33,7,0,22,ITA
61b3978f,64,38,34,25,5,37,80,43,38,12,26,42,106,73,1,22,ITA
620922ed,9,7,4,5,0,6,16,10,15,7,8,23,32,50,0,22,ITA
6213fd82,31,19,21,3,7,20,30,10,20,7,13,32,63,47,2,22,ITA
62437b4f,17,9,2,9,6,2,10,8,18,2,16,4,21,13,0,22,ITA
649b01d8,3,1,3,0,0,3,5,2,0,0,0,2,5,17,2,22,ITA
64cd167d,31,16,19,9,3,17,24,7,16,9,7,16,47,26,0,22,ITA
64e8ed6d,0,0,0,0,0,0,0,0,0,0,0,0,0,0,0,22,ITA
65fd099c,11,4,4,7,0,8,11,3,14,0,14,4,15,5,0,22,ITA
6604165d,20,12,5,8,7,8,16,8,10,1,9,11,31,8,1,22,ITA
66784dee,14,10,8,4,2,6,18,12,14,1,13,5,19,3,0,22,ITA
67cdbc0e,26,10,16,9,1,9,26,17,13,5,8,7,33,7,1,22,ITA
67f649be,0,0,0,0,0,0,0,0,0,0,0,0,0,0,1,22,ITA
68252d6d,7,7,3,2,2,4,17,13,6,1,5,3,10,1,0,22,ITA
6928979a,63,42,17,35,11,29,55,26,26,2,24,21,84,8,2,22,ITA
69e11a01,3,2,0,2,1,2,5,3,1,0,1,0,3,2,0,22,ITA
6a1f66a7,1,1,1,0,0,1,1,0,0,0,0,0,1,4,0,22,ITA
6af30900,28,12,16,8,4,10,18,8,13,3,10,16,44,38,1,22,ITA
6b635f5c,13,9,8,4,1,5,14,9,21,11,10,24,37,80,0,22,ITA
6bb2c084,50,26,24,17,9,25,51,26,31,5,26,24,74,33,1,22,ITA
6cc97b6a,47,26,13,30,4,16,38,22,27,9,18,63,110,33,1,22,ITA
6cd33e2a,0,0,0,0,0,0,0,0,0,0,0,0,0,0,0,22,ITA
6d5e62b0,13,8,10,3,0,8,11,3,15,13,2,9,22,49,0,22,ITA
6d70c771,3,1,1,2,0,1,5,4,7,3,4,4,7,3,0,22,ITA
6e058f06,29,18,5,15,9,11,38,27,29,3,26,9,38,11,0,22,ITA
6eee05f1,43,24,21,20,2,29,46,17,21,11,10,31,74,56,0,22,ITA
6f30a1d5,0,0,0,0,0,0,0,0,0,0,0,0,0,0,0,22,ITA
6f5ead86,20,10,8,9,3,13,32,19,17,4,13,13,33,5,1,22,ITA
6fe90922,38,22,18,11,9,28,50,22,39,7,32,47,85,42,0,22,ITA
7152082d,1,0,1,0,0,0,1,1,0,0,0,0,1,1,0,22,ITA
71dc23da,17,12,8,6,3,9,14,5,11,5,6,10,27,12,1,22,ITA
72f87f25,1,1,0,0,1,1,1,0,0,0,0,0,1,0,0,22,ITA
73affbb6,0,0,0,0,0,0,1,1,0,0,0,0,0,0,0,22,ITA
74419746,1,0,1,0,0,1,2,1,1,0,1,0,1,6,3,22,ITA
7452c7a8,3,3,1,2,0,1,2,1,0,0,0,1,4,1,0,22,ITA
75438a9a,28,16,16,9,3,15,24,9,28,25,3,29,57,69,1,22,ITA
75b86fb3,44,25,28,13,3,17,34,17,22,12,10,35,79,59,1,22,ITA
75e60d75,10,6,6,4,0,5,10,5,5,2,3,6,16,5,1,22,ITA
75f2c59f,18,12,7,6,5,7,23,16,26,5,21,12,30,11,0,22,ITA
7703afb6,19,12,3,11,5,6,26,20,16,0,16,4,23,13,0,22,ITA
77d6fd4d,1,1,1,0,0,1,1,0,1,0,1,1,2,21,1,22,ITA
780e3631,27,14,10,11,6,14,33,19,22,3,19,13,40,7,0,22,ITA
78841da9,15,6,6,6,3,13,31,18,6,0,6,3,18,1,1,22,ITA
79083382,25,17,14,11,0,12,18,6,21,16,5,9,34,34,0,22,ITA
79443529,5,0,0,2,3,2,15,13,9,2,7,1,6,23,0,22,ITA
79b0d6a0,0,0,0,0,0,0,0,0,1,0,1,0,0,10,3,22,ITA
79d60e74,1,0,1,0,0,1,2,1,0,0,0,0,1,1,0,22,ITA
7ae36711,9,7,5,3,1,2,5,3,4,0,4,3,12,4,0,22,ITA
7afbd2c3,19,12,2,12,5,7,23,16,19,5,14,9,28,6,0,22,ITA
7b075c75,15,5,5,8,2,4,9,5,22,16,6,34,49,95,0,22,ITA
7b5f516f,0,0,0,0,0,0,0,0,0,0,0,0,0,0,0,22,ITA
7cd520e8,64,40,30,27,7,33,60,27,39,6,33,27,91,42,0,22,ITA
7d50454d,23,12,13,10,0,16,27,11,21,14,7,25,48,54,0,22,ITA
7eb97a8e,13,7,5,6,2,3,15,12,1,0,1,4,17,2,0,22,ITA
7ec7738e,13,5,7,4,2,5,18,13,12,1,11,1,14,8,0,22,ITA
7edfbb8a,73,44,36,34,3,18,26,8,37,23,14,45,118,84,1,22,ITA
7f267d66,47,22,15,25,7,23,58,35,28,10,18,26,73,45,0,22,ITA
7f78ad23,36,21,11,23,2,18,33,15,22,8,14,41,77,48,1,22,ITA
7f9d956a,0,0,0,0,0,0,0,0,0,0,0,0,0,0,0,22,ITA
7fac99d4,42,21,16,22,4,24,54,30,23,5,18,10,52,17,1,22,ITA
7fe90ccd,32,22,12,13,7,19,37,18,32,2,30,12,44,22,0,22,ITA
801831fe,8,3,4,3,1,2,6,4,4,0,4,1,9,0,0,22,ITA
80556f08,12,8,3,9,0,5,17,12,13,4,9,4,16,21,0,22,ITA
80dbbd10,5,5,0,4,1,4,10,6,8,3,5,3,8,10,0,22,ITA
81255c03,15,12,2,8,5,4,18,14,23,5,18,8,23,18,1,22,ITA
817c6964,33,18,16,14,3,15,31,16,19,2,17,16,49,17,0,22,ITA
81a4c239,1,1,0,1,0,0,1,1,2,0,2,0,1,0,0,22,ITA
82598b71,21,15,9,7,5,11,19,8,14,2,12,7,28,33,0,22,ITA
82b1198a,0,0,0,0,0,0,0,0,0,0,0,1,1,11,1,22,ITA
82efe6fa,54,32,31,19,4,26,43,17,26,7,19,62,116,104,2,22,ITA
854ee61a,15,9,4,8,3,6,16,10,11,1,10,4,19,11,0,22,ITA
85a44ecc,58,32,29,26,3,24,62,38,40,13,27,22,80,27,0,22,ITA
85f7d1be,61,36,36,21,4,17,22,5,36,15,21,26,87,54,0,22,ITA
86383d0e,1,0,0,0,1,1,1,0,0,0,0,0,1,0,0,22,ITA
8650af85,16,11,10,6,0,10,23,13,37,27,10,43,59,114,2,22,ITA
86695068,19,10,6,8,5,8,22,14,12,1,11,3,22,4,0,22,ITA
875d65d1,1,0,1,0,0,0,1,1,0,0,0,0,1,0,0,22,ITA
8790f988,19,14,2,5,12,5,21,16,16,1,15,5,24,22,1,22,ITA
8794e251,64,43,32,24,8,15,34,19,34,8,26,20,84,41,1,22,ITA
880fcdbb,0,0,0,0,0,0,0,0,0,0,0,0,0,0,0,22,ITA
88895312,7,2,3,3,1,4,15,11,13,3,10,5,12,11,0,22,ITA
88f53b75,0,0,0,0,0,0,1,1,0,0,0,0,0,0,0,22,ITA
89976232,16,9,14,2,0,9,11,2,5,4,1,17,33,21,0,22,ITA
89b2c8a9,16,7,1,11,4,3,16,13,8,2,6,9,25,2,0,22,ITA
8abd0c03,15,11,6,8,1,5,14,9,12,4,8,12,27,22,1,22,ITA
8abd174d,33,17,26,6,1,18,32,14,27,15,12,10,43,61,5,22,ITA
8b609c34,55,35,24,24,7,24,34,10,26,6,20,23,78,47,0,22,ITA
8b8a56ce,20,12,9,8,3,6,12,6,17,13,4,9,29,39,0,22,ITA
8b95acda,47,36,32,14,1,22,32,10,31,19,12,80,127,135,2,22,ITA
8c63fae5,38,21,23,11,4,19,33,14,18,8,10,22,60,67,0,22,ITA
8c65eb5f,24,14,14,7,3,11,23,12,7,0,7,11,35,5,0,22,ITA
8c90fd7a,10,5,1,2,7,2,6,4,16,3,13,3,13,17,0,22,ITA
8c964914,0,0,0,0,0,0,1,1,0,0,0,0,0,0,0,22,ITA
8cabdc1e,0,0,0,0,0,0,2,2,0,0,0,0,0,23,3,22,ITA
8cc29864,17,9,11,4,2,6,13,7,14,8,6,19,36,28,2,22,ITA
8da74c05,52,29,24,21,7,20,59,39,40,5,35,52,104,41,0,22,ITA
8daee720,0,0,0,0,0,0,1,1,0,0,0,0,0,0,0,22,ITA
8f866fe8,6,4,3,2,1,1,7,6,5,2,3,3,9,10,0,22,ITA
8fef5412,4,2,2,1,1,3,6,3,4,0,4,7,11,4,0,22,ITA
9085dd7c,1,1,1,0,0,0,0,0,2,0,2,0,1,0,0,22,ITA
90e1d9dc,1,1,1,0,0,1,1,0,2,2,0,0,1,6,0,22,ITA
919dd4b1,3,3,0,2,1,1,5,4,2,0,2,0,3,0,0,22,ITA
91d0fabf,21,15,11,8,2,11,16,5,15,6,9,10,31,24,0,22,ITA
921f6058,78,40,42,33,3,32,50,18,43,21,22,100,178,80,2,22,ITA
92948398,13,6,5,6,2,7,19,12,6,2,4,8,21,15,0,22,ITA
92b4758e,36,16,22,13,1,15,25,10,21,7,14,42,78,62,0,22,ITA
92d83c27,39,15,15,16,8,16,54,38,31,9,22,28,67,34,0,22,ITA
933d3b51,48,29,21,23,4,14,18,4,20,9,11,34,82,60,0,22,ITA
93b891d1,3,3,0,2,1,0,1,1,2,0,2,0,3,4,0,22,ITA
9413b19f,0,0,0,0,0,0,0,0,0,0,0,0,0,3,1,22,ITA
947e036f,27,14,11,14,2,15,30,15,13,0,13,10,37,7,0,22,ITA
94816803,9,4,4,4,1,3,9,6,3,0,3,1,10,2,0,22,ITA
94b2001f,37,26,20,13,4,18,28,10,21,12,9,32,69,53,1,22,ITA
952a03fe,5,1,4,1,0,1,9,8,6,5,1,1,6,9,0,22,ITA
956a78ea,0,0,0,0,0,0,0,0,0,0,0,0,0,0,0,22,ITA
957e4c87,58,32,20,32,6,31,77,46,30,5,25,29,87,33,0,22,ITA
958a601f,10,5,7,3,0,5,7,2,4,0,4,10,20,19,0,22,ITA
9592289a,2,2,1,1,0,1,1,0,3,0,3,0,2,3,0,22,ITA
95facda1,39,21,16,15,8,18,33,15,16,1,15,9,48,15,1,22,ITA
963a328b,35,20,15,16,4,19,50,31,17,4,13,13,48,23,1,22,ITA
96960855,0,0,0,0,0,0,0,0,0,0,0,0,0,0,0,22,ITA
96e0490d,32,16,17,9,6,16,41,25,16,1,15,19,51,25,0,22,ITA
970b8574,28,15,10,15,3,13,24,11,6,1,5,19,47,19,0,22,ITA
97e8ea97,0,0,0,0,0,0,0,0,0,0,0,0,0,0,0,22,ITA
9823be92,41,23,21,15,5,22,39,17,31,6,25,45,86,27,0,22,ITA
983ff2c7,25,10,13,10,2,14,24,10,13,4,9,5,30,27,0,22,ITA
98a84572,1,1,0,1,0,1,2,1,1,0,1,0,1,0,0,22,ITA
98d2c2c4,69,39,22,33,14,30,70,40,48,8,40,35,104,26,1,22,ITA
9907b1c8,24,15,0,15,9,6,28,22,19,0,19,7,31,6,0,22,ITA
997fff07,29,17,17,10,2,10,20,10,32,26,6,45,74,132,0,22,ITA
9bb1ad91,21,13,11,6,4,13,27,14,14,4,10,11,32,12,0,22,ITA
9d4c45d6,57,30,27,22,8,17,56,39,37,3,34,22,79,32,0,22,ITA
9d60028d,16,10,7,8,1,9,21,12,16,3,13,13,29,8,0,22,ITA
9e1577aa,37,24,17,15,5,22,53,31,28,10,18,19,56,31,1,22,ITA
9ef42479,9,4,2,3,4,5,13,8,11,5,6,2,11,25,0,22,ITA
9f1893b9,71,45,30,33,8,27,99,72,65,6,59,20,91,16,0,22,ITA
9f5a610b,0,0,0,0,0,0,0,0,0,0,0,1,1,5,0,22,ITA
9f84febe,53,38,33,13,7,28,50,22,22,5,17,34,87,26,1,22,ITA
9f9b9269,7,5,2,2,3,2,4,2,6,5,1,7,14,12,0,22,ITA
9fa26bc2,0,0,0,0,0,0,1,1,0,0,0,0,0,7,2,22,ITA
a111cf41,1,1,1,0,0,0,0,0,0,0,0,0,1,17,1,22,ITA
a2565f79,0,0,0,0,0,0,0,0,0,0,0,0,0,1,0,22,ITA
a26fb8aa,40,24,10,19,11,22,54,32,31,2,29,15,55,19,0,22,ITA
a2d9f138,10,3,6,3,1,6,24,18,14,2,12,7,17,12,1,22,ITA
a378a02a,7,4,7,0,0,3,4,1,6,5,1,2,9,24,1,22,ITA
a39b9ef6,2,2,2,0,0,0,0,0,0,0,0,1,3,1,0,22,ITA
a40819d9,21,13,13,7,1,8,15,7,17,8,9,16,37,26,0,22,ITA
a40d5a0c,11,5,7,1,3,4,13,9,1,0,1,2,13,6,0,22,ITA
a44d3a3c,3,3,0,2,1,0,5,5,0,0,0,0,3,6,0,22,ITA
a4948e67,2,2,0,0,2,1,6,5,8,0,8,0,2,13,0,22,ITA
a4e85758,53,31,34,16,3,30,40,10,37,19,18,31,84,46,4,22,ITA
a4fe8cda,5,2,0,3,2,1,9,8,11,1,10,5,10,1,0,22,ITA
a5296e55,19,12,5,9,5,6,21,15,13,2,11,8,27,4,0,22,ITA
a69cc629,18,6,7,11,0,9,19,10,14,7,7,15,33,15,0,22,ITA
a69e4806,28,20,12,11,5,8,30,22,24,0,24,9,37,9,0,22,ITA
a796492f,2,1,1,0,1,0,1,1,0,0,0,0,2,0,0,22,ITA
a820e429,9,5,2,5,2,4,7,3,4,1,3,1,10,8,0,22,ITA
a8a874f1,44,25,21,16,7,21,47,26,43,21,22,22,66,33,0,22,ITA
a8f21b9f,8,3,3,1,4,3,12,9,10,0,10,2,10,2,0,22,ITA
a9202def,29,18,11,14,4,14,26,12,11,2,9,19,48,8,0,22,ITA
a96e5dc0,18,10,12,4,2,13,20,7,12,5,7,12,30,41,0,22,ITA
a9aa0d1d,11,7,3,7,1,4,12,8,3,0,3,1,12,7,0,22,ITA
aa25ce92,8,5,6,2,0,5,6,1,6,4,2,4,12,11,0,22,ITA
aa5322d5,39,28,18,18,3,21,26,5,17,5,12,30,69,70,0,22,ITA
aa54ec6f,16,8,8,6,2,8,16,8,18,12,6,21,37,72,0,22,ITA
aae9d04a,62,40,38,21,3,29,62,33,38,5,33,23,85,62,1,22,ITA
ab1ca213,23,15,4,17,2,10,16,6,18,5,13,11,34,18,1,22,ITA
ab4449d6,0,0,0,0,0,0,1,1,0,0,0,0,0,17,0,22,ITA
ac277993,11,5,4,6,1,5,14,9,19,9,10,5,16,22,0,22,ITA
ac4003af,0,0,0,0,0,0,0,0,0,0,0,0,0,2,0,22,ITA
ac7e640b,48,28,30,15,3,20,34,14,49,37,12,62,110,147,1,22,ITA
acf7e795,20,12,8,11,1,9,20,11,15,13,2,23,43,42,0,22,ITA
ad263695,0,0,0,0,0,0,0,0,0,0,0,0,0,0,0,22,ITA
aded8e6f,6,4,2,2,2,2,7,5,5,1,4,5,11,5,0,22,ITA
ae4e2852,24,12,7,9,8,11,24,13,10,0,10,10,34,30,0,22,ITA
ae7058f9,12,10,8,4,0,8,10,2,7,4,3,9,21,28,1,22,ITA
ae94a6c5,1,1,1,0,0,0,2,2,1,0,1,1,2,0,0,22,ITA
ae9898c5,8,4,5,2,1,7,10,3,6,1,5,2,10,25,0,22,ITA
afbf187b,18,6,12,5,1,8,14,6,19,14,5,23,41,42,0,22,ITA
b056e3da,0,0,0,0,0,0,1,1,0,0,0,0,0,2,1,22,ITA
b0f7e36c,26,19,9,9,8,12,26,14,7,0,7,4,30,3,0,22,ITA
b1236c63,0,0,0,0,0,0,3,3,0,0,0,0,0,4,0,22,ITA
b1f0b916,0,0,0,0,0,0,0,0,0,0,0,0,0,0,0,22,ITA
b35a7399,16,9,8,7,1,9,11,2,17,10,7,8,24,55,1,22,ITA
b3af9be1,0,0,0,0,0,0,0,0,1,0,1,1,1,0,0,22,ITA
b5c3ff9f,17,7,5,10,2,9,25,16,16,8,8,22,39,25,0,22,ITA
b64073a0,1,1,0,1,0,0,0,0,2,2,0,2,3,1,0,22,ITA
b6964eb6,36,23,28,8,0,18,25,7,32,24,8,26,62,92,1,22,ITA
b6a1cdf9,4,4,2,2,0,0,5,5,2,0,2,1,5,0,0,22,ITA
b6b2b820,5,3,1,2,2,1,8,7,6,1,5,1,6,3,0,22,ITA
b70bde8f,22,12,11,9,2,12,27,15,4,0,4,6,28,6,0,22,ITA
b79858d5,5,3,2,1,2,3,8,5,2,0,2,5,10,4,0,22,ITA
b7a5bc86,4,2,1,3,0,0,4,4,8,3,5,8,12,11,0,22,ITA
b804c280,0,0,0,0,0,0,0,0,0,0,0,0,0,0,0,22,ITA
b85bf253,14,8,5,6,3,4,8,4,6,2,4,4,18,16,1,22,ITA
b96b595c,25,12,15,9,1,12,19,7,37,28,9,34,59,92,0,22,ITA
ba3d3bea,36,17,15,17,4,12,38,26,24,12,12,17,53,19,1,22,ITA
bb376bed,39,18,16,19,4,20,54,34,34,12,22,22,61,55,0,22,ITA
bbafc0c4,20,9,11,7,2,10,13,3,9,1,8,6,26,10,0,22,ITA
bcc81786,66,42,43,18,5,30,41,11,39,21,18,32,98,75,0,22,ITA
be2706c0,38,23,23,11,4,20,36,16,27,8,19,20,58,51,0,22,ITA
be6c1ccc,0,0,0,0,0,0,0,0,1,0,1,0,0,0,0,22,ITA
bee704fc,54,32,31,20,3,29,34,5,30,15,15,39,93,94,0,22,ITA
bf309d24,7,2,5,2,0,1,3,2,2,0,2,0,7,1,0,22,ITA
bf356094,6,1,3,2,1,1,7,6,8,0,8,3,9,2,0,22,ITA
bf39bdec,2,1,1,0,1,1,2,1,0,0,0,0,2,1,0,22,ITA
bf57eaab,24,12,9,8,7,6,25,19,17,1,16,6,30,7,0,22,ITA
c0c7ff58,55,33,22,29,4,29,67,38,34,1,33,22,77,32,0,22,ITA
c13ddd3e,0,0,0,0,0,0,1,1,0,0,0,0,0,0,0,22,ITA
c1d95617,0,0,0,0,0,0,0,0,0,0,0,1,1,16,3,22,ITA
c1e8e74e,1,1,0,1,0,0,3,3,0,0,0,1,2,1,0,22,ITA
c235e803,4,3,1,3,0,0,4,4,2,2,0,8,12,12,0,22,ITA
c283ddef,1,0,0,0,1,0,0,0,0,0,0,0,1,0,0,22,ITA
c316607a,28,15,19,9,0,10,21,11,34,21,13,41,69,71,4,22,ITA
c375dfa5,2,0,0,0,2,1,2,1,3,1,2,1,3,6,0,22,ITA
c459a650,21,11,6,9,6,12,27,15,18,2,16,14,35,13,0,22,ITA
c50cee19,12,10,4,4,4,5,11,6,9,1,8,3,15,11,0,22,ITA
c56dc39e,38,15,12,15,11,24,39,15,23,11,12,26,64,35,0,22,ITA
c5adc293,3,1,1,2,0,0,3,3,2,1,1,3,6,10,0,22,ITA
c6e8cf1f,51,34,17,27,7,19,43,24,34,6,28,24,75,41,0,22,ITA
c707411f,2,2,1,1,0,2,3,1,2,1,1,4,6,10,1,22,ITA
c7259b83,21,10,3,16,2,12,21,9,18,4,14,10,31,13,0,22,ITA
c730da00,1,0,1,0,0,1,1,0,0,0,0,0,1,2,0,22,ITA
c83c203f,15,9,4,9,2,10,20,10,17,3,14,12,27,14,0,22,ITA
c8c0dccd,46,28,9,26,11,14,34,20,26,2,24,17,63,22,0,22,ITA
c8d7131c,36,20,26,4,6,11,21,10,34,12,22,29,65,57,1,22,ITA
c976160c,15,12,8,5,2,7,20,13,9,0,9,11,26,9,0,22,ITA
c9c32262,0,0,0,0,0,0,0,0,1,0,1,0,0,0,0,22,ITA
ca3db240,21,9,12,6,3,6,24,18,15,5,10,14,35,28,0,22,ITA
ca6edaa0,2,1,0,1,1,0,2,2,0,0,0,1,3,0,0,22,ITA
caaf2ed1,0,0,0,0,0,0,1,1,4,0,4,2,2,7,0,22,ITA
caffaf5a,17,10,8,9,0,8,15,7,27,20,7,28,45,72,1,22,ITA
cb678320,6,3,6,0,0,4,8,4,3,2,1,6,12,21,0,22,ITA
cc1a0c57,1,0,1,0,0,1,1,0,0,0,0,0,1,4,0,22,ITA
cce9f582,14,9,9,5,0,9,17,8,7,5,2,17,31,58,0,22,ITA
cd0fa27b,41,23,16,19,6,11,40,29,29,5,24,25,66,12,0,22,ITA
ce1806be,24,14,9,11,4,12,32,20,15,1,14,10,34,9,0,22,ITA
ce1a6c7e,0,0,0,0,0,0,1,1,1,0,1,0,0,1,0,22,ITA
ce30bfc8,12,6,7,4,1,1,13,12,14,5,9,9,21,7,0,22,ITA
cf007308,25,15,10,10,5,12,28,16,13,2,11,8,33,17,0,22,ITA
cf043a33,1,1,0,1,0,0,0,0,0,0,0,1,2,0,1,22,ITA
cf1c23d8,0,0,0,0,0,0,0,0,0,0,0,0,0,2,1,22,ITA
cf961d8d,39,26,29,7,3,22,34,12,48,24,24,49,88,132,1,22,ITA
cfbf9881,1,1,1,0,0,1,2,1,1,1,0,1,2,6,0,22,ITA
d023d70f,14,8,3,4,7,6,18,12,8,0,8,3,17,2,0,22,ITA
d0d8dd44,38,29,22,16,0,12,17,5,17,8,9,32,70,52,0,22,ITA
d0dbca9f,40,22,28,9,3,19,33,14,31,22,9,39,79,63,1,22,ITA
d125f22f,16,10,4,9,3,3,20,17,19,3,16,10,26,20,0,22,ITA
d183e9d6,22,17,10,11,1,8,13,5,17,3,14,7,29,20,1,22,ITA
d1b49282,46,26,15,23,8,28,56,28,37,12,25,25,71,39,0,22,ITA
d2e8fd9b,6,4,4,2,0,5,14,9,6,2,4,4,10,14,0,22,ITA
d3298c99,11,4,8,2,1,9,20,11,17,2,15,18,29,8,0,22,ITA
d37b0350,10,6,2,5,3,3,9,6,9,5,4,2,12,12,0,22,ITA
d3aaad90,13,8,4,9,0,4,6,2,10,2,8,11,24,8,0,22,ITA
d3b888e3,2,2,2,0,0,1,4,3,0,0,0,0,2,0,0,22,ITA
d3d758d8,3,1,0,2,1,0,7,7,4,1,3,1,4,4,0,22,ITA
d3de9af0,6,2,0,4,2,4,8,4,8,1,7,3,9,5,0,22,ITA
d3e0c826,1,1,1,0,0,1,1,0,0,0,0,2,3,1,0,22,ITA
d44360be,33,20,10,17,6,15,31,16,22,5,17,10,43,37,2,22,ITA
d4535821,30,18,16,12,2,13,32,19,19,8,11,41,71,71,0,22,ITA
d4931a5a,2,0,0,1,1,1,2,1,2,0,2,0,2,2,0,22,ITA
d4a2533d,9,5,5,1,3,3,21,18,16,1,15,4,13,7,1,22,ITA
d4c9725f,53,35,34,14,5,29,40,11,16,3,13,23,76,29,3,22,ITA
d541e703,7,2,4,3,0,5,6,1,10,5,5,4,11,19,0,22,ITA
d60c26fc,0,0,0,0,0,0,1,1,1,0,1,0,0,1,0,22,ITA
d697a2d0,2,0,1,1,0,1,4,3,2,0,2,1,3,3,0,22,ITA
d6a889ea,4,2,4,0,0,2,2,0,3,0,3,8,12,6,0,22,ITA
d6e53a3a,34,19,21,13,0,15,18,3,31,21,10,26,60,103,0,22,ITA
d6f88a1d,24,12,14,5,5,9,33,24,15,5,10,23,47,23,0,22,ITA
d705ba44,7,3,2,2,3,3,12,9,12,4,8,2,9,9,0,22,ITA
d711d04f,2,0,1,0,1,0,9,9,3,1,2,2,4,0,0,22,ITA
d7918b13,22,13,7,8,7,9,31,22,14,4,10,9,31,13,0,22,ITA
d7a35008,0,0,0,0,0,0,0,0,0,0,0,0,0,0,0,22,ITA
d7d32194,9,4,1,4,4,1,6,5,14,1,13,2,11,16,0,22,ITA
d80b1835,0,0,0,0,0,0,1,1,1,0,1,1,1,0,0,22,ITA
d85c238b,36,17,11,13,12,12,21,9,18,2,16,24,60,5,0,22,ITA
d8800a46,17,10,11,6,0,10,16,6,29,23,6,19,36,47,0,22,ITA
d9624b51,32,16,19,10,3,19,33,14,13,8,5,50,82,76,1,22,ITA
d97ec0d1,0,0,0,0,0,0,1,1,0,0,0,0,0,0,0,22,ITA
d97f2e8d,15,8,7,6,2,1,9,8,11,3,8,9,24,16,0,22,ITA
d995ed27,33,17,12,16,5,21,46,25,20,2,18,14,47,9,1,22,ITA
d9cfca3d,1,0,0,1,0,0,0,0,2,0,2,0,1,0,0,22,ITA
da5a981b,22,11,10,10,2,13,30,17,6,0,6,14,36,11,0,22,ITA
da77b60b,8,3,4,3,1,2,6,4,1,0,1,2,10,2,0,22,ITA
da974c7b,39,23,31,6,2,25,38,13,41,25,16,29,68,90,1,22,ITA
db092d3b,44,30,22,15,7,21,50,29,20,4,16,25,69,15,0,22,ITA
dc3e663e,50,27,25,19,6,26,57,31,38,15,23,40,90,53,0,22,ITA
dc3fa3b5,21,12,4,13,4,10,21,11,11,2,9,9,30,2,0,22,ITA
dd0daf32,45,29,11,27,7,17,52,35,33,2,31,22,67,33,0,22,ITA
dd403465,28,12,6,16,6,12,35,23,16,2,14,8,36,9,1,22,ITA
dd86e8e4,15,6,8,4,3,8,8,0,7,2,5,8,23,9,0,22,ITA
de135234,3,2,1,2,0,2,3,1,2,1,1,0,3,1,0,22,ITA
dea698d9,1,0,0,1,0,1,1,0,0,0,0,0,1,0,0,22,ITA
deb748c9,16,12,10,5,1,13,29,16,10,6,4,9,25,15,0,22,ITA
df3cda47,15,12,9,6,0,8,21,13,14,0,14,5,20,5,0,22,ITA
df85d472,2,1,1,1,0,1,1,0,0,0,0,0,2,0,0,22,ITA
df8d6029,33,19,26,3,4,14,31,17,29,16,13,42,75,69,0,22,ITA
e0314d87,5,3,4,1,0,4,7,3,8,4,4,11,16,20,1,22,ITA
e0921a4f,30,13,7,14,9,8,35,27,19,0,19,9,39,4,3,22,ITA
e14ec482,21,13,9,11,1,13,29,16,9,4,5,5,26,14,0,22,ITA
e1b0a70d,0,0,0,0,0,0,4,4,0,0,0,2,2,20,1,22,ITA
e1cbb531,39,24,16,20,3,14,36,22,9,1,8,12,51,13,1,22,ITA
e288d4b3,28,14,14,7,7,14,32,18,9,2,7,27,55,10,1,22,ITA
e2a302a8,27,18,8,16,3,13,25,12,8,4,4,8,35,11,0,22,ITA
e33f36d5,38,24,24,13,1,15,34,19,42,31,11,22,60,101,0,22,ITA
e34e086c,2,1,1,0,1,0,0,0,1,1,0,1,3,1,0,22,ITA
e358587b,0,0,0,0,0,0,1,1,0,0,0,0,0,1,1,22,ITA
e3756e72,29,15,14,12,3,6,27,21,39,8,31,21,50,51,0,22,ITA
e3a5814e,8,6,5,0,3,5,14,9,7,0,7,6,14,7,0,22,ITA
e3cceee6,31,17,18,12,1,15,28,13,26,14,12,58,89,68,1,22,ITA
e4ba67f2,0,0,0,0,0,0,0,0,0,0,0,1,1,0,0,22,ITA
e58cbfd5,37,26,16,14,7,15,40,25,21,1,20,20,57,20,0,22,ITA
e599253a,27,12,8,13,6,12,30,18,27,6,21,20,47,14,0,22,ITA
e5bf73f3,12,4,4,4,4,6,20,14,20,1,19,6,18,8,0,22,ITA
e63e122d,4,1,2,2,0,1,2,1,2,1,1,1,5,1,1,22,ITA
e74f0e59,23,14,13,8,2,9,31,22,25,7,18,26,49,52,0,22,ITA
e85fb9b8,22,13,17,4,1,7,13,6,24,18,6,22,44,59,0,22,ITA
e8c930bb,64,37,25,30,9,34,80,46,39,7,32,85,149,43,0,22,ITA
e921b9db,0,0,0,0,0,0,1,1,0,0,0,1,1,0,0,22,ITA
e94d79e3,13,7,5,5,3,4,12,8,12,3,9,14,27,21,0,22,ITA
ea06dd97,9,8,5,1,3,3,11,8,2,0,2,3,12,7,0,22,ITA
ea0893d6,14,7,5,7,2,9,19,10,22,1,21,1,15,7,0,22,ITA
eade5337,0,0,0,0,0,0,0,0,0,0,0,0,0,0,0,22,ITA
eb0ec070,46,27,26,15,5,24,60,36,16,8,8,32,78,62,1,22,ITA
eb2fe5b6,15,4,2,7,6,3,19,16,12,0,12,4,19,5,0,22,ITA
eb76987d,32,18,15,9,8,12,25,13,24,12,12,18,50,46,0,22,ITA
ec1f737d,0,0,0,0,0,0,0,0,0,0,0,0,0,0,0,22,ITA
ec5dae45,12,7,5,7,0,6,13,7,2,0,2,2,14,5,0,22,ITA
ec6773f5,0,0,0,0,0,0,0,0,0,0,0,0,0,0,0,22,ITA
eccbe56a,13,10,7,1,5,5,13,8,7,1,6,4,17,1,0,22,ITA
ed5c0319,21,6,2,14,5,9,19,10,16,1,15,5,26,25,1,22,ITA
ed90babd,6,1,0,3,3,3,7,4,3,0,3,2,8,3,0,22,ITA
eda40760,1,1,1,0,0,1,1,0,0,0,0,1,2,2,0,22,ITA
ee251371,43,22,12,17,14,15,51,36,19,0,19,15,58,8,0,22,ITA
ee3c4b3f,1,0,0,1,0,0,3,3,0,0,0,0,1,0,0,22,ITA
ee4f2f3b,6,2,2,2,2,2,15,13,14,1,13,3,9,12,0,22,ITA
ee833569,0,0,0,0,0,0,0,0,0,0,0,0,0,4,0,22,ITA
ee9040b4,1,0,0,1,0,1,1,0,1,0,1,0,1,0,0,22,ITA
ee93c1a9,16,10,7,4,5,6,13,7,12,4,8,5,21,15,0,22,ITA
ef2e5e1a,8,4,2,4,2,5,12,7,11,2,9,10,18,15,0,22,ITA
ef301f96,2,1,1,1,0,0,1,1,1,0,1,3,5,1,0,22,ITA
ef619b0b,0,0,0,0,0,0,0,0,0,0,0,1,1,0,0,22,ITA
ef7cd87a,12,4,3,8,1,5,11,6,6,1,5,4,16,6,0,22,ITA
ef94dc2f,0,0,0,0,0,0,0,0,0,0,0,0,0,0,0,22,ITA
f02dde20,0,0,0,0,0,0,0,0,0,0,0,0,0,0,0,22,ITA
f058ed1f,0,0,0,0,0,0,0,0,0,0,0,0,0,0,1,22,ITA
f1cfc209,24,15,11,10,3,13,37,24,18,3,15,20,44,15,0,22,ITA
f1d25de7,0,0,0,0,0,0,0,0,0,0,0,0,0,0,0,22,ITA
f1f1f238,32,18,19,11,2,16,32,16,27,21,6,69,101,110,1,22,ITA
f209b81e,1,1,0,1,0,1,2,1,2,0,2,1,2,0,0,22,ITA
f35430a4,1,1,1,0,0,1,1,0,1,1,0,5,6,11,0,22,ITA
f42d6c13,21,14,5,13,3,4,14,10,11,0,11,3,24,8,0,22,ITA
f449640d,18,14,5,13,0,4,9,5,6,2,4,3,21,5,0,22,ITA
f45f9427,43,23,23,16,4,11,35,24,28,5,23,24,67,34,0,22,ITA
f49c4ae9,34,18,11,14,9,15,34,19,11,1,10,17,51,17,0,22,ITA
f4d60499,40,24,19,13,8,13,29,16,19,2,17,17,57,7,1,22,ITA
f503ea63,43,28,17,21,5,26,56,30,27,7,20,29,72,25,0,22,ITA
f554e29b,3,3,2,1,0,3,3,0,0,0,0,1,4,14,1,22,ITA
f573a8bf,5,2,0,3,2,1,5,4,2,0,2,2,7,6,0,22,ITA
f586779e,27,13,7,14,6,9,22,13,17,3,14,5,32,27,0,22,ITA
f5f21026,2,1,2,0,0,2,2,0,0,0,0,2,4,0,0,22,ITA
f61c7c4e,17,10,6,6,5,8,13,5,12,0,12,3,20,1,0,22,ITA
f6a06749,0,0,0,0,0,0,0,0,0,0,0,0,0,0,0,22,ITA
f7036e1c,20,10,3,10,7,6,11,5,21,1,20,18,38,6,0,22,ITA
f7223718,21,15,17,4,0,9,20,11,22,11,11,12,33,44,2,22,ITA
f7c491f1,44,21,21,21,2,16,25,9,27,9,18,21,65,47,0,22,ITA
f7e2af2c,53,24,33,16,4,19,42,23,42,15,27,27,80,87,0,22,ITA
f8342731,50,30,23,22,5,32,58,26,20,4,16,20,70,34,1,22,ITA
f8d41a8c,0,0,0,0,0,0,1,1,0,0,0,0,0,0,0,22,ITA
f91e81c9,5,2,3,1,1,2,3,1,2,0,2,4,9,17,0,22,ITA
f944979d,1,1,1,0,0,0,0,0,0,0,0,0,1,0,0,22,ITA
f95f49d2,15,11,5,6,4,3,11,8,7,1,6,1,16,5,0,22,ITA
f9758dae,47,30,31,9,7,21,41,20,22,4,18,16,63,43,1,22,ITA
f9c927de,14,5,5,8,1,6,11,5,4,1,3,6,20,3,0,22,ITA
fa449bba,35,22,15,10,10,17,39,22,24,4,20,9,44,17,1,22,ITA
fb77bfef,25,16,16,7,2,13,14,1,22,7,15,16,41,35,0,22,ITA
fc4f85b1,18,7,13,3,2,10,15,5,7,5,2,13,31,46,0,22,ITA
fcb38f57,2,1,2,0,0,2,2,0,0,0,0,1,3,4,2,22,ITA
fdcdb521,6,3,4,2,0,2,5,3,6,6,0,4,10,26,0,22,ITA
fdf4b948,17,10,7,9,1,7,12,5,4,2,2,2,19,6,0,22,ITA
fe012aca,14,7,1,6,7,6,9,3,9,0,9,3,17,4,2,22,ITA
fec5accc,1,1,1,0,0,0,0,0,1,0,1,0,1,0,0,22,ITA
ff37d2ef,5,2,2,2,1,2,5,3,2,0,2,3,8,2,0,22,ITA
00638016,31,17,23,8,0,21,29,8,33,17,16,22,53,86,0,22,FRA
007faf7a,30,18,7,15,8,15,29,14,15,0,15,2,32,5,0,22,FRA
00891164,33,17,20,12,1,16,24,8,23,12,11,34,67,76,0,22,FRA
00a8d210,57,39,22,27,8,36,74,38,27,0,27,28,85,52,0,22,FRA
0118c54c,65,34,35,24,6,33,55,22,22,3,19,33,98,49,1,22,FRA
01870104,12,5,4,3,5,3,24,21,7,1,6,7,19,14,0,22,FRA
02bcaf8e,2,2,0,2,0,0,5,5,1,0,1,3,5,2,0,22,FRA
032f894e,19,7,8,10,1,9,26,17,14,3,11,14,33,7,0,22,FRA
037f2523,7,5,0,5,2,2,10,8,7,1,6,0,7,1,0,22,FRA
03e91055,29,14,5,17,7,12,34,22,14,2,12,8,37,4,1,22,FRA
04bb2b06,7,4,0,3,4,2,3,1,8,3,5,1,8,3,0,22,FRA
0512a60a,0,0,0,0,0,0,0,0,0,0,0,0,0,1,0,22,FRA
0557ff4f,0,0,0,0,0,0,0,0,1,1,0,2,2,10,0,22,FRA
0630eb63,0,0,0,0,0,0,0,0,0,0,0,0,0,0,0,22,FRA
065dc209,17,10,3,12,2,9,32,23,11,2,9,4,21,22,0,22,FRA
06c48679,60,28,24,28,8,25,45,20,39,27,12,65,125,106,0,22,FRA
06df8256,36,19,21,15,0,14,23,9,18,12,6,28,64,68,1,22,FRA
06f33dc8,1,0,0,0,1,0,0,0,0,0,0,0,1,1,0,22,FRA
080de72a,0,0,0,0,0,0,0,0,0,0,0,0,0,1,0,22,FRA
08511d65,12,5,6,6,0,8,15,7,4,2,2,8,20,27,0,22,FRA
08f5afaa,0,0,0,0,0,0,0,0,0,0,0,0,0,9,2,22,FRA
095e4199,1,0,0,0,1,1,5,4,0,0,0,1,2,1,0,22,FRA
0ad37003,29,13,14,12,3,9,27,18,8,3,5,23,52,13,0,22,FRA
0af4dcf0,2,0,1,0,1,0,3,3,2,0,2,0,2,1,0,22,FRA
0b0cbe5b,46,25,14,13,19,22,63,41,30,0,30,8,54,34,1,22,FRA
0b2c9aec,8,5,7,0,1,6,15,9,9,0,9,4,12,7,0,22,FRA
0b4d8274,10,7,1,5,4,2,13,11,8,0,8,4,14,1,0,22,FRA
0bb6e193,41,22,24,14,3,16,42,26,18,4,14,18,59,27,0,22,FRA
0be95d34,29,17,3,18,8,14,33,19,12,0,12,8,37,3,0,22,FRA
0bfca6a1,45,28,19,20,6,26,49,23,25,4,21,27,72,29,2,22,FRA
0c2ac3cb,14,8,3,9,2,7,11,4,3,0,3,4,18,0,0,22,FRA
0cbc8baa,71,44,43,21,7,42,90,48,40,5,35,53,124,92,0,22,FRA
0d7b6576,18,10,9,6,3,6,16,10,7,0,7,4,22,4,0,22,FRA
0e46fa2f,0,0,0,0,0,0,0,0,2,0,2,0,0,1,0,22,FRA
0e7ccfc4,33,20,17,11,5,24,42,18,24,3,21,13,46,36,0,22,FRA
0ed063d6,6,5,2,4,0,3,3,0,1,0,1,7,13,5,0,22,FRA
0f26fd24,8,7,4,2,2,2,6,4,3,0,3,0,8,1,0,22,FRA
0f697e02,0,0,0,0,0,0,0,0,1,0,1,0,0,0,0,22,FRA
0f8418aa,47,23,18,20,9,19,46,27,32,11,21,35,82,31,0,22,FRA
0f86995c,18,12,8,7,3,9,21,12,5,2,3,5,23,6,0,22,FRA
0ff630d0,72,44,34,29,9,37,71,34,32,8,24,58,130,48,0,22,FRA
1001ae82,27,15,11,12,4,12,29,17,17,2,15,10,37,5,0,22,FRA
104b4ad3,19,10,5,5,9,11,25,14,9,0,9,7,26,10,0,22,FRA
10f0fdd3,51,32,21,21,9,17,41,24,29,4,25,27,78,19,0,22,FRA
114bbdee,6,5,4,2,0,3,5,2,12,10,2,12,18,48,0,22,FRA
12bd0579,2,0,2,0,0,1,1,0,0,0,0,0,2,2,0,22,FRA
1467af0d,60,40,16,30,14,32,64,32,36,10,26,18,78,14,2,22,FRA
148e136f,15,7,4,8,3,5,15,10,7,0,7,5,20,1,0,22,FRA
14d2670e,19,10,10,9,0,11,22,11,7,2,5,10,29,19,0,22,FRA
14df1d7f,11,5,6,4,1,6,9,3,6,3,3,5,16,9,0,22,FRA
1545cf15,58,28,37,18,3,40,57,17,41,21,20,41,99,128,4,22,FRA
15944afd,8,7,4,4,0,2,11,9,11,3,8,13,21,9,0,22,FRA
165a2e40,7,2,0,2,5,2,17,15,8,1,7,2,9,11,0,22,FRA
16aa7d4c,44,25,32,11,1,29,40,11,42,29,13,55,99,141,0,22,FRA
1787195f,1,1,1,0,0,1,1,0,0,0,0,0,1,0,0,22,FRA
1880614f,18,13,5,6,7,5,18,13,13,2,11,14,32,9,0,22,FRA
19053e31,38,20,12,19,7,15,47,32,10,0,10,23,61,4,0,22,FRA
1956b948,18,13,8,8,2,5,18,13,11,0,11,6,24,4,0,22,FRA
199ff86e,0,0,0,0,0,0,2,2,0,0,0,0,0,2,0,22,FRA
19a12bed,13,10,4,6,3,5,8,3,10,2,8,9,22,4,0,22,FRA
19ba6c6d,17,6,3,12,2,4,27,23,13,1,12,6,23,12,0,22,FRA
19cda00b,29,18,6,13,10,14,37,23,17,0,17,6,35,3,0,22,FRA
1a066e69,27,18,22,4,1,15,27,12,31,24,7,22,49,69,1,22,FRA
1a248246,2,1,0,0,2,2,9,7,5,1,4,7,9,4,0,22,FRA
1a6b7ea4,59,37,18,32,9,26,66,40,33,7,26,38,97,43,0,22,FRA
1a992676,3,2,0,3,0,0,4,4,3,0,3,5,8,3,0,22,FRA
1bfe34dc,12,9,9,3,0,9,11,2,1,0,1,4,16,6,0,22,FRA
1d2d5cc8,0,0,0,0,0,0,1,1,1,0,1,1,1,4,1,22,FRA
1ddbc7ca,59,37,38,17,4,41,63,22,33,10,23,51,110,56,0,22,FRA
1df4a109,13,9,5,5,3,9,19,10,7,2,5,4,17,2,0,22,FRA
1e93fc5d,0,0,0,0,0,0,0,0,0,0,0,0,0,0,0,22,FRA
1ec7e1c5,13,9,7,5,1,5,9,4,15,10,5,22,35,53,1,22,FRA
1f6298f2,0,0,0,0,0,0,0,0,0,0,0,0,0,0,0,22,FRA
2054d037,4,0,0,2,2,0,4,4,9,1,8,1,5,4,0,22,FRA
20b9f052,0,0,0,0,0,0,1,1,0,0,0,0,0,12,1,22,FRA
20e73fac,46,24,16,18,12,24,67,43,33,3,30,30,76,44,0,22,FRA
2180c761,0,0,0,0,0,0,0,0,0,0,0,0,0,2,0,22,FRA
22721b88,22,15,11,8,3,15,27,12,4,1,3,16,38,10,0,22,FRA
2306bfde,0,0,0,0,0,0,0,0,0,0,0,0,0,0,0,22,FRA
2321ea6e,61,38,38,19,4,37,62,25,18,3,15,37,98,50,0,22,FRA
23c63b7f,3,2,1,2,0,2,6,4,4,0,4,2,5,3,0,22,FRA
2434f24a,1,0,1,0,0,1,2,1,0,0,0,0,1,6,3,22,FRA
243f4a0b,36,23,13,21,2,16,39,23,9,3,6,18,54,11,0,22,FRA
249ac66d,66,45,38,23,5,36,63,27,28,7,21,29,95,30,0,22,FRA
24eb7ed6,22,13,12,7,3,13,22,9,22,3,19,21,43,31,0,22,FRA
25146df0,23,16,8,13,2,8,12,4,5,3,2,9,32,15,0,22,FRA
2515040a,1,1,0,1,0,0,0,0,0,0,0,0,1,1,0,22,FRA
25749008,40,21,15,21,4,17,55,38,34,3,31,11,51,20,0,22,FRA
2591b066,7,4,2,3,2,2,8,6,3,0,3,2,9,4,0,22,FRA
26777636,43,27,22,14,7,19,68,49,33,3,30,37,80,11,2,22,FRA
2677a1de,33,18,7,17,9,9,34,25,21,0,21,12,45,7,0,22,FRA
2693f6bc,1,0,0,0,1,0,1,1,0,0,0,1,2,0,0,22,FRA
275e2c51,49,37,28,21,0,30,57,27,35,19,16,44,93,126,0,22,FRA
279ddf6a,53,30,21,26,6,13,58,45,34,5,29,44,97,38,1,22,FRA
288e1e13,27,18,16,11,0,14,24,10,24,14,10,24,51,127,1,22,FRA
28a65a2c,0,0,0,0,0,0,0,0,0,0,0,1,1,7,0,22,FRA
28dabd43,3,2,3,0,0,3,4,1,0,0,0,0,3,22,3,22,FRA
295ba708,18,13,11,5,2,9,24,15,14,4,10,9,27,20,1,22,FRA
29939a1d,11,9,7,3,1,5,10,5,4,0,4,7,18,1,0,22,FRA
29aee77c,3,1,1,2,0,0,2,2,3,0,3,4,7,5,0,22,FRA
29c02c9f,4,2,2,2,0,3,6,3,4,2,2,2,6,1,0,22,FRA
2a00c6c0,6,2,2,4,0,2,3,1,3,0,3,3,9,0,0,22,FRA
2a657da0,4,2,3,1,0,0,7,7,2,0,2,3,7,1,0,22,FRA
2acf0cd7,34,17,21,11,2,17,39,22,39,13,26,43,77,72,2,22,FRA
2aeb43f1,4,4,2,1,1,2,4,2,5,3,2,1,5,3,0,22,FRA
2b1bed19,46,23,21,21,4,18,39,21,26,6,20,48,94,30,1,22,FRA
2b471f99,62,35,25,33,4,28,38,10,32,9,23,48,110,37,0,22,FRA
2b5a35e5,1,1,0,1,0,1,2,1,0,0,0,0,1,1,0,22,FRA
2c127b6f,0,0,0,0,0,0,0,0,0,0,0,0,0,4,0,22,FRA
2d22cea7,33,18,9,16,8,11,30,19,27,2,25,15,48,3,0,22,FRA
2d70dbe5,1,0,1,0,0,1,2,1,0,0,0,0,1,10,2,22,FRA
2db2fd7b,20,15,11,9,0,9,17,8,20,10,10,20,40,73,0,22,FRA
2f9e4435,21,15,9,11,1,11,23,12,10,1,9,14,35,15,1,22,FRA
3010aefb,34,14,17,11,6,8,18,10,11,1,10,10,44,15,0,22,FRA
30144daa,24,13,11,7,6,14,39,25,23,2,21,8,32,11,0,22,FRA
30af8b93,53,30,31,18,4,28,59,31,30,6,24,27,80,37,3,22,FRA
31626657,110,60,44,53,13,71,166,95,58,1,57,55,165,13,0,22,FRA
316e70c7,1,1,1,0,0,0,0,0,0,0,0,0,1,0,0,22,FRA
3189f61a,42,24,15,20,7,16,29,13,24,9,15,28,70,13,0,22,FRA
31a62dc7,64,37,43,17,4,36,63,27,32,9,23,43,107,62,2,22,FRA
321a71a7,17,8,16,1,0,8,10,2,9,5,4,14,31,32,0,22,FRA
32c2d95f,48,27,34,14,0,16,32,16,50,25,25,68,116,104,0,22,FRA
33508c78,1,0,0,1,0,1,1,0,0,0,0,1,2,0,0,22,FRA
34a0f5ff,13,4,2,8,3,7,24,17,14,1,13,11,24,5,0,22,FRA
34a88e3e,14,5,2,8,4,5,6,1,4,1,3,2,16,2,0,22,FRA
3544641e,8,4,1,1,6,1,8,7,7,0,7,2,10,6,0,22,FRA
3681cfff,48,28,30,16,2,17,26,9,20,15,5,44,92,84,1,22,FRA
3708e9fa,40,22,10,18,12,18,41,23,26,1,25,12,52,8,0,22,FRA
375622c5,55,35,28,23,4,29,87,58,21,5,16,30,85,35,0,22,FRA
37d04e90,31,15,13,10,8,12,44,32,16,0,16,13,44,3,0,22,FRA
380a15e2,0,0,0,0,0,0,1,1,0,0,0,0,0,5,1,22,FRA
3814b753,12,9,2,6,4,1,17,16,8,1,7,0,12,2,0,22,FRA
381d7d54,0,0,0,0,0,0,1,1,3,1,2,0,0,0,0,22,FRA
3935e52e,7,6,2,3,2,5,8,3,4,0,4,0,7,7,1,22,FRA
397ba086,3,2,1,1,1,0,6,6,6,0,6,0,3,1,0,22,FRA
3befc2b6,85,52,49,32,4,52,103,51,67,33,34,69,154,143,0,22,FRA
3c6bbbab,33,21,22,9,2,13,32,19,37,8,29,32,65,51,0,22,FRA
3cc4bb19,30,18,13,15,2,13,31,18,11,2,9,6,36,21,0,22,FRA
3cd7820a,45,26,22,18,5,21,36,15,22,3,19,13,58,9,2,22,FRA
3d214e5f,3,1,3,0,0,3,5,2,1,0,1,0,3,24,1,22,FRA
3d738df0,0,0,0,0,0,0,0,0,0,0,0,1,1,2,0,22,FRA
3dd738a1,78,53,39,32,7,43,68,25,19,4,15,44,122,57,0,22,FRA
3e092724,33,17,12,18,3,13,32,19,16,6,10,10,43,14,2,22,FRA
3eaf8817,8,4,4,3,1,2,5,3,3,0,3,2,10,0,0,22,FRA
3ef0fa48,42,27,10,26,6,21,59,38,26,1,25,17,59,4,0,22,FRA
3f034750,0,0,0,0,0,0,0,0,0,0,0,0,0,14,1,22,FRA
3f3a2cba,6,6,3,2,1,3,3,0,0,0,0,1,7,6,0,22,FRA
40221fa7,28,19,13,11,4,14,24,10,20,8,12,14,42,15,0,22,FRA
40774c6b,17,11,5,5,7,4,14,10,7,0,7,5,22,8,0,22,FRA
42276181,19,10,5,9,5,6,18,12,22,1,21,6,25,1,0,22,FRA
42dcf26d,1,1,1,0,0,1,1,0,0,0,0,1,2,9,0,22,FRA
42eaa028,11,3,6,4,1,4,11,7,13,1,12,5,16,4,0,22,FRA
42fd9c7f,11,8,1,4,6,7,13,6,6,0,6,5,16,13,0,22,FRA
433dc9a2,24,14,10,10,4,13,18,5,8,0,8,8,32,16,0,22,FRA
436a9dd0,29,17,7,16,6,14,39,25,22,8,14,14,43,8,0,22,FRA
43b78598,5,3,1,3,1,3,7,4,3,0,3,5,10,12,0,22,FRA
43e7a164,50,37,33,13,4,18,35,17,30,13,17,61,111,90,2,22,FRA
4534a352,33,17,22,10,1,15,23,8,20,13,7,31,64,94,5,22,FRA
462475ed,36,25,5,19,12,7,40,33,28,3,25,8,44,31,1,22,FRA
46359159,81,44,59,15,7,47,83,36,29,0,29,32,113,30,0,22,FRA
46750e9c,14,13,4,7,3,2,8,6,14,0,14,11,25,4,0,22,FRA
468fdbad,35,20,12,21,2,19,53,34,17,3,14,22,57,28,1,22,FRA
46907171,5,3,2,3,0,5,10,5,2,0,2,0,5,1,0,22,FRA
469d3d84,0,0,0,0,0,0,1,1,2,0,2,0,0,0,0,22,FRA
46a7b605,0,0,0,0,0,0,0,0,0,0,0,0,0,0,0,22,FRA
46faabfa,1,1,0,1,0,0,5,5,6,1,5,3,4,16,0,22,FRA
4788cb6b,0,0,0,0,0,0,0,0,0,0,0,0,0,0,0,22,FRA
47af88b8,11,4,8,3,0,6,7,1,8,7,1,16,27,52,0,22,FRA
47c609d5,13,6,4,6,3,2,7,5,10,3,7,6,19,19,0,22,FRA
48b28bfd,16,9,4,9,3,5,19,14,8,1,7,19,35,7,0,22,FRA
49070d66,43,32,24,17,2,26,45,19,28,11,17,42,85,67,0,22,FRA
49136c42,32,24,19,13,0,17,27,10,25,15,10,33,65,83,1,22,FRA
4914ed4a,12,7,7,2,3,9,13,4,9,3,6,18,30,13,0,22,FRA
4937a9f7,9,5,5,3,1,3,4,1,8,4,4,12,21,34,0,22,FRA
49712367,3,3,0,3,0,2,6,4,7,4,3,1,4,2,0,22,FRA
4a987ffa,2,1,0,2,0,2,6,4,3,1,2,0,2,7,0,22,FRA
4ade359f,0,0,0,0,0,0,0,0,0,0,0,0,0,0,0,22,FRA
4b77bb89,11,7,8,2,1,7,11,4,5,0,5,2,13,4,0,22,FRA
4b96c347,35,25,8,18,9,14,44,30,21,5,16,22,57,5,1,22,FRA
4bf69118,54,35,31,19,4,33,72,39,17,4,13,43,97,48,1,22,FRA
4c3a6744,19,9,6,12,1,5,21,16,13,1,12,14,33,6,0,22,FRA
4c4ffacc,1,1,0,1,0,1,2,1,2,1,1,1,2,2,0,22,FRA
4c5b714f,24,13,13,8,3,9,24,15,10,1,9,16,40,13,0,22,FRA
4e0afc5d,56,35,30,17,9,32,65,33,21,7,14,34,90,60,1,22,FRA
4e47507a,5,2,1,3,1,1,3,2,3,1,2,3,8,8,0,22,FRA
4e7db402,3,3,3,0,0,3,8,5,1,0,1,1,4,25,2,22,FRA
4eb0686f,0,0,0,0,0,0,0,0,0,0,0,0,0,0,0,22,FRA
4f093689,5,5,0,3,2,1,4,3,3,0,3,0,5,1,0,22,FRA
4f255115,86,45,33,49,4,29,55,26,39,7,32,101,187,34,0,22,FRA
5046b7d4,13,8,2,7,4,1,9,8,15,0,15,3,16,3,0,22,FRA
5065d67d,3,3,1,2,0,1,1,0,3,1,2,3,6,5,0,22,FRA
507d7569,0,0,0,0,0,0,0,0,0,0,0,0,0,0,0,22,FRA
50ac8941,10,8,5,4,1,4,8,4,7,2,5,4,14,6,0,22,FRA
5148dcc5,55,33,22,16,17,25,43,18,29,3,26,18,73,17,0,22,FRA
5167c97e,28,21,18,7,3,15,24,9,18,4,14,22,50,31,0,22,FRA
51b41c5c,21,12,9,11,1,6,13,7,8,2,6,20,41,18,0,22,FRA
51c30111,47,28,14,27,6,14,29,15,18,3,15,47,94,19,0,22,FRA
51dbeea9,21,14,9,11,1,9,21,12,19,11,8,24,45,29,0,22,FRA
5219ab4a,63,34,33,20,10,22,55,33,43,1,42,73,136,51,0,22,FRA
5313ed43,27,19,11,13,3,12,58,46,24,2,22,26,53,17,1,22,FRA
5314e067,7,4,3,4,0,2,5,3,4,0,4,1,8,4,0,22,FRA
53f6306f,0,0,0,0,0,0,1,1,1,1,0,2,2,0,0,22,FRA
5413ef36,9,7,8,1,0,5,8,3,5,1,4,10,19,5,0,22,FRA
542cc80f,26,12,6,16,4,8,18,10,11,2,9,24,50,10,0,22,FRA
546bb36e,27,16,10,16,1,11,26,15,11,3,8,16,43,14,0,22,FRA
54d51e22,35,22,20,14,1,17,41,24,21,4,17,14,49,24,1,22,FRA
562a4799,84,50,56,28,0,48,77,29,63,33,30,79,163,217,3,22,FRA
5630a6e0,0,0,0,0,0,0,1,1,0,0,0,2,2,2,0,22,FRA
574aa9ec,2,0,2,0,0,1,2,1,2,1,1,0,2,4,0,22,FRA
57a46f3f,3,3,1,1,1,1,5,4,1,0,1,2,5,0,0,22,FRA
58ad9383,2,2,2,0,0,2,3,1,1,0,1,1,3,21,1,22,FRA
58ae47b2,16,8,4,10,2,7,31,24,9,0,9,9,25,3,0,22,FRA
59948ef7,22,12,9,6,7,11,26,15,12,0,12,13,35,5,0,22,FRA
59d93937,0,0,0,0,0,0,0,0,0,0,0,0,0,0,0,22,FRA
5b146df3,40,24,23,13,4,10,21,11,31,21,10,32,72,86,0,22,FRA
5b1bf5e3,22,14,2,13,7,4,20,16,10,0,10,4,26,3,0,22,FRA
5b3cfa12,0,0,0,0,0,0,0,0,0,0,0,0,0,0,0,22,FRA
5b479568,9,7,2,3,4,1,5,4,6,0,6,2,11,1,0,22,FRA
5b92d896,18,10,8,6,4,4,11,7,9,2,7,6,24,15,0,22,FRA
5b9512c5,34,19,27,7,0,15,23,8,18,9,9,38,72,64,2,22,FRA
5c42e7ce,1,1,1,0,0,1,1,0,0,0,0,0,1,1,0,22,FRA
5c61496e,5,3,3,0,2,2,4,2,1,0,1,0,5,0,0,22,FRA
5c7895a0,0,0,0,0,0,0,0,0,0,0,0,0,0,0,0,22,FRA
5c9ac7f0,1,0,0,1,0,0,4,4,2,1,1,0,1,1,0,22,FRA
5cdddffa,25,14,5,17,3,12,19,7,8,3,5,3,28,6,2,22,FRA
5ceba7fc,13,7,4,6,3,4,21,17,26,0,26,20,33,5,0,22,FRA
5d0e0a1f,29,21,17,9,3,11,24,13,25,5,20,19,48,30,0,22,FRA
5d8d7454,69,39,33,24,12,32,62,30,37,11,26,55,124,39,0,22,FRA
5e080f73,13,7,5,4,4,3,16,13,10,0,10,5,18,17,0,22,FRA
5e22e2a4,52,27,15,31,6,24,44,20,33,12,21,33,85,42,0,22,FRA
5ea8ef20,45,30,10,26,9,13,47,34,15,1,14,16,61,18,0,22,FRA
5ee6e943,0,0,0,0,0,0,2,2,0,0,0,2,2,9,1,22,FRA
5f011e05,39,26,23,12,4,18,33,15,26,16,10,38,77,103,2,22,FRA
5f0241b2,0,0,0,0,0,0,0,0,0,0,0,0,0,1,0,22,FRA
5f26e0c5,25,12,17,8,0,14,25,11,27,14,13,35,60,48,0,22,FRA
5f3eaaf5,17,11,6,5,6,11,23,12,14,3,11,12,29,5,0,22,FRA
6043997c,35,21,24,9,2,20,27,7,25,16,9,25,60,90,1,22,FRA
60740e70,0,0,0,0,0,0,0,0,1,1,0,3,3,6,0,22,FRA
60f58477,12,4,3,5,4,3,20,17,6,0,6,6,18,3,0,22,FRA
6191093d,33,18,7,20,6,15,44,29,33,3,30,31,64,6,1,22,FRA
62124972,0,0,0,0,0,0,0,0,0,0,0,1,1,14,2,22,FRA
62e02107,2,2,1,1,0,0,0,0,1,1,0,2,4,5,0,22,FRA
6388e356,15,10,14,1,0,13,16,3,11,7,4,4,19,18,2,22,FRA
639ca1cf,18,11,6,10,2,10,18,8,8,2,6,5,23,2,1,22,FRA
6421ec64,7,3,0,5,2,2,10,8,2,0,2,2,9,2,0,22,FRA
642f9f79,2,1,0,1,1,1,1,0,0,0,0,0,2,0,0,22,FRA
645a3363,23,13,6,12,5,10,15,5,4,0,4,3,26,4,0,22,FRA
6481421d,0,0,0,0,0,0,1,1,0,0,0,0,0,0,0,22,FRA
64ba07c0,79,45,52,21,6,42,73,31,22,7,15,48,127,74,0,22,FRA
64c14d49,53,29,22,24,7,21,53,32,20,4,16,22,75,17,0,22,FRA
64f69877,24,10,2,18,4,6,31,25,20,0,20,3,27,9,0,22,FRA
654f49ca,2,2,0,0,2,0,1,1,1,0,1,3,5,2,0,22,FRA
65bbfba3,17,9,8,7,2,10,24,14,9,2,7,6,23,17,1,22,FRA
6605d143,9,5,0,8,1,0,8,8,13,4,9,4,13,11,0,22,FRA
667b65da,1,1,1,0,0,0,0,0,0,0,0,1,2,9,0,22,FRA
6690ef25,1,1,1,0,0,0,0,0,1,1,0,0,1,2,0,22,FRA
6751b938,0,0,0,0,0,0,0,0,0,0,0,0,0,0,0,22,FRA
6763f716,1,0,0,1,0,0,0,0,1,0,1,0,1,0,0,22,FRA
677ee102,5,2,2,3,0,0,5,5,8,2,6,9,14,12,0,22,FRA
68a26d51,49,31,14,26,9,25,70,45,23,2,21,37,86,11,0,22,FRA
69384e5d,29,19,5,12,12,12,36,24,9,1,8,4,33,2,1,22,FRA
6993927b,31,17,18,12,1,17,31,14,41,27,14,37,68,89,0,22,FRA
6a04bb7c,3,2,2,1,0,0,1,1,2,0,2,1,4,0,0,22,FRA
6a2b9aee,1,0,0,1,0,0,1,1,0,0,0,0,1,0,0,22,FRA
6a827d8e,29,19,17,10,2,14,25,11,13,2,11,32,61,21,0,22,FRA
6b2c894b,35,19,19,15,1,16,30,14,35,8,27,28,63,45,0,22,FRA
6ba71da5,14,6,10,4,0,7,22,15,24,14,10,37,51,68,1,22,FRA
6bde367b,46,27,18,19,9,21,59,38,23,1,22,25,71,12,1,22,FRA
6d075c67,0,0,0,0,0,0,0,0,0,0,0,1,1,2,0,22,FRA
6d0fe035,2,1,1,1,0,1,1,0,0,0,0,0,2,0,0,22,FRA
6de23ab0,6,3,4,2,0,5,6,1,6,6,0,12,18,26,0,22,FRA
6e33125f,41,29,29,12,0,23,34,11,38,25,13,40,81,111,0,22,FRA
6f5ec8bb,61,42,34,23,4,38,62,24,24,8,16,37,98,78,3,22,FRA
6f806d99,70,44,25,36,9,41,90,49,25,1,24,29,99,18,0,22,FRA
706a60e1,1,0,0,1,0,0,0,0,1,0,1,0,1,0,0,22,FRA
70c52749,43,27,25,11,7,23,31,8,23,7,16,22,65,40,0,22,FRA
7120a04d,10,5,4,5,1,3,13,10,4,0,4,3,13,1,0,22,FRA
7155e3e1,38,19,15,22,1,16,31,15,15,3,12,24,62,16,0,22,FRA
72c812f3,60,36,24,24,12,18,44,26,23,4,19,24,84,13,0,22,FRA
741418c3,2,0,1,0,1,1,4,3,7,0,7,3,5,1,0,22,FRA
743fd71f,2,1,0,2,0,1,1,0,0,0,0,1,3,0,0,22,FRA
745ca0a3,40,22,14,19,7,16,43,27,15,0,15,16,56,12,0,22,FRA
74733221,0,0,0,0,0,0,0,0,0,0,0,0,0,0,0,22,FRA
74dc806c,4,2,2,1,1,2,4,2,3,0,3,0,4,1,0,22,FRA
75186a6a,3,3,1,2,0,2,2,0,1,0,1,1,4,2,0,22,FRA
7587446d,15,11,5,8,2,8,16,8,0,0,0,11,26,6,0,22,FRA
75a63397,21,14,9,6,6,5,14,9,13,3,10,2,23,9,0,22,FRA
767212e6,10,6,3,3,4,6,13,7,12,1,11,5,15,6,0,22,FRA
76a4233b,10,6,8,2,0,4,9,5,11,4,7,16,26,22,1,22,FRA
779847d6,51,33,40,11,0,34,59,25,40,19,21,53,104,116,1,22,FRA
7909ffa4,59,30,33,23,3,36,78,42,27,15,12,42,101,56,0,22,FRA
792a9d41,17,8,2,13,2,8,17,9,8,1,7,7,24,0,0,22,FRA
796b1c41,19,10,5,10,4,9,18,9,9,0,9,14,33,5,0,22,FRA
79ab7593,7,5,3,2,2,4,10,6,8,0,8,4,11,5,0,22,FRA
79b2399c,36,24,16,17,3,18,52,34,12,1,11,16,52,20,0,22,FRA
7a42d0df,31,19,7,20,4,12,51,39,31,4,27,25,56,41,0,22,FRA
7a72e960,0,0,0,0,0,0,0,0,0,0,0,0,0,0,0,22,FRA
7b082ec2,26,15,20,5,1,19,36,17,19,5,14,17,43,28,0,22,FRA
7b9a9e25,21,11,8,8,5,8,22,14,19,0,19,6,27,8,0,22,FRA
7b9c2d84,4,1,2,1,1,2,5,3,1,1,0,1,5,3,0,22,FRA
7c3ed041,9,6,9,0,0,5,14,9,11,4,7,19,28,30,0,22,FRA
7cab69b5,37,25,30,7,0,18,26,8,23,8,15,25,62,33,1,22,FRA
7cc00776,4,1,1,2,1,2,2,0,3,0,3,1,5,7,0,22,FRA
7cdda3bf,21,9,6,9,6,5,26,21,32,3,29,13,34,21,0,22,FRA
7d08063d,7,5,2,2,3,4,13,9,7,0,7,4,11,1,1,22,FRA
7d937aa1,1,0,0,1,0,0,0,0,0,0,0,1,2,0,0,22,FRA
7d9397f8,33,19,11,18,4,17,35,18,31,11,20,28,61,19,0,22,FRA
7d9b37bf,9,6,4,4,1,3,6,3,5,0,5,1,10,0,0,22,FRA
7d9f3d69,4,2,2,2,0,1,1,0,1,0,1,0,4,0,0,22,FRA
7e82a78f,31,22,14,12,5,14,57,43,27,4,23,24,55,13,0,22,FRA
7ef972c3,46,31,26,17,3,34,43,9,13,7,6,14,60,34,1,22,FRA
7f622eef,1,1,1,0,0,1,1,0,0,0,0,0,1,0,0,22,FRA
7fecbcdb,6,5,6,0,0,4,11,7,5,1,4,9,15,13,0,22,FRA
7ffaf233,0,0,0,0,0,0,0,0,2,0,2,0,0,2,0,22,FRA
80556f08,2,2,1,0,1,0,4,4,4,1,3,2,4,0,0,22,FRA
8104e41e,3,2,1,0,2,1,3,2,2,0,2,1,4,0,0,22,FRA
810edef9,1,0,0,0,1,1,1,0,0,0,0,0,1,1,0,22,FRA
8197a269,0,0,0,0,0,0,0,0,0,0,0,0,0,0,0,22,FRA
81ac108d,4,3,2,2,0,1,3,2,3,0,3,1,5,1,0,22,FRA
822d51d7,69,43,19,41,9,29,56,27,29,7,22,32,101,22,2,22,FRA
82464ce3,43,23,25,16,2,20,57,37,18,1,17,42,85,15,0,22,FRA
82518f62,50,31,20,25,5,23,59,36,21,4,17,21,71,11,1,22,FRA
828657ff,48,31,17,27,4,18,25,7,10,3,7,30,78,19,0,22,FRA
829aa60c,2,1,1,1,0,0,0,0,0,0,0,1,3,2,0,22,FRA
83299cc0,39,22,16,22,1,11,40,29,19,1,18,26,65,13,0,22,FRA
8332db56,48,35,34,12,2,22,42,20,20,7,13,27,75,31,0,22,FRA
834b5c4c,1,1,1,0,0,0,0,0,0,0,0,1,2,22,0,22,FRA
84d94b91,41,25,19,17,5,20,57,37,21,10,11,22,63,51,1,22,FRA
85613cf0,9,2,0,5,4,4,18,14,9,1,8,3,12,10,1,22,FRA
8577e60a,101,57,39,50,12,39,70,31,44,8,36,57,158,35,1,22,FRA
86383d0e,5,2,1,1,3,2,7,5,8,0,8,2,7,3,0,22,FRA
868eaba0,56,34,26,25,5,27,74,47,45,11,34,53,109,49,1,22,FRA
86a2ba20,47,22,24,20,3,19,58,39,33,5,28,46,93,22,2,22,FRA
87935cf3,34,22,26,8,0,16,26,10,41,34,7,41,75,134,4,22,FRA
87e9c7cd,15,10,8,7,0,8,18,10,4,1,3,10,25,9,0,22,FRA
8827bf46,42,17,16,20,6,8,35,27,26,4,22,16,58,16,2,22,FRA
8846a40f,21,7,10,7,4,8,30,22,18,7,11,21,42,22,0,22,FRA
88c4d190,11,5,4,4,3,1,17,16,15,0,15,4,15,14,0,22,FRA
88f130ed,59,37,43,15,1,39,60,21,45,21,24,51,110,130,2,22,FRA
890bc029,0,0,0,0,0,0,0,0,0,0,0,0,0,0,0,22,FRA
8a2248b4,0,0,0,0,0,0,2,2,1,0,1,0,0,12,2,22,FRA
8a53d24b,3,1,0,1,2,0,1,1,4,1,3,2,5,1,0,22,FRA
8bbe2df5,11,9,8,2,1,7,12,5,5,2,3,10,21,7,1,22,FRA
8bc8829a,51,31,24,20,7,23,45,22,30,9,21,52,103,27,1,22,FRA
8ca9415f,0,0,0,0,0,0,1,1,0,0,0,0,0,0,0,22,FRA
8dbff17c,10,9,6,4,0,7,8,1,17,9,8,16,26,43,0,22,FRA
8e697a8f,0,0,0,0,0,0,2,2,4,0,4,0,0,0,0,22,FRA
8eec784d,19,7,8,8,3,10,20,10,16,1,15,10,29,7,0,22,FRA
8eef18aa,8,7,8,0,0,4,11,7,5,3,2,27,35,34,0,22,FRA
8f325097,80,47,50,23,7,35,65,30,35,19,16,38,118,82,1,22,FRA
8f7e6783,16,7,6,9,1,7,20,13,10,0,10,8,24,6,0,22,FRA
8fd9996f,33,17,10,20,3,14,28,14,19,10,9,37,70,29,1,22,FRA
9004f318,7,5,2,3,2,5,8,3,2,0,2,5,12,9,0,22,FRA
90eb507d,28,19,12,13,3,18,40,22,26,4,22,33,61,35,0,22,FRA
90f87966,23,12,14,7,2,11,25,14,39,32,7,44,67,159,1,22,FRA
90fcf472,10,5,1,8,1,1,9,8,4,0,4,2,12,0,0,22,FRA
91f2da4c,5,1,1,4,0,2,5,3,2,0,2,1,6,0,0,22,FRA
9226aa22,8,2,2,5,1,5,13,8,9,3,6,3,11,3,0,22,FRA
923f4dda,4,2,1,2,1,1,7,6,4,0,4,1,5,8,0,22,FRA
9260926b,16,8,10,6,0,8,15,7,4,2,2,14,30,26,0,22,FRA
928a4a61,10,6,6,2,2,6,17,11,7,2,5,5,15,6,0,22,FRA
92b56413,23,11,10,12,1,10,18,8,7,1,6,9,32,3,0,22,FRA
93b8f9f4,1,1,0,1,0,0,1,1,2,1,1,2,3,2,0,22,FRA
942b4f90,18,8,1,11,6,6,15,9,12,1,11,0,18,1,0,22,FRA
94b442c0,0,0,0,0,0,0,0,0,0,0,0,0,0,0,0,22,FRA
94f8d10c,21,8,15,6,0,11,14,3,11,7,4,24,45,55,2,22,FRA
95192fe4,8,7,4,4,0,2,4,2,0,0,0,1,9,1,0,22,FRA
95bb6ddc,9,4,3,4,2,2,3,1,5,3,2,2,11,1,0,22,FRA
96f4ebc0,2,1,0,1,1,0,6,6,0,0,0,1,3,0,0,22,FRA
96fcd380,0,0,0,0,0,0,0,0,0,0,0,0,0,0,0,22,FRA
972aeb2a,54,32,36,16,2,27,35,8,24,16,8,48,102,85,0,22,FRA
9744ff80,0,0,0,0,0,0,1,1,0,0,0,0,0,0,0,22,FRA
97bfa797,1,0,0,0,1,0,3,3,1,0,1,0,1,0,0,22,FRA
9836e892,8,5,4,2,2,5,12,7,5,0,5,6,14,5,0,22,FRA
9980269a,5,1,1,1,3,0,4,4,2,2,0,0,5,11,0,22,FRA
999ceb5f,43,26,18,23,2,10,39,29,29,5,24,25,68,11,1,22,FRA
9af3613f,0,0,0,0,0,0,0,0,0,0,0,0,0,0,0,22,FRA
9b5237b1,1,1,1,0,0,1,1,0,1,0,1,0,1,0,0,22,FRA
9b6f7fd5,68,38,24,26,18,17,51,34,43,5,38,9,77,22,0,22,FRA
9ba7b4fa,25,14,19,6,0,11,19,8,19,9,10,15,40,42,0,22,FRA
9bdd8118,37,24,19,12,6,18,38,20,11,2,9,16,53,21,0,22,FRA
9c221d14,40,24,30,9,1,25,33,8,47,37,10,53,93,169,2,22,FRA
9c2b1f11,1,1,1,0,0,1,3,2,0,0,0,0,1,1,0,22,FRA
9d5dcc23,5,5,1,1,3,3,7,4,4,0,4,6,11,1,0,22,FRA
9daeac61,30,20,16,9,5,13,27,14,25,4,21,39,69,51,0,22,FRA
9ddf7fae,6,3,1,4,1,2,2,0,1,0,1,0,6,1,0,22,FRA
9e17ccff,0,0,0,0,0,0,0,0,0,0,0,0,0,9,1,22,FRA
9f0f4b49,6,4,4,2,0,2,11,9,6,1,5,7,13,17,0,22,FRA
9f1c2822,4,0,0,3,1,0,2,2,2,1,1,3,7,3,0,22,FRA
9f29c204,22,11,12,6,4,15,23,8,12,6,6,22,44,28,0,22,FRA
9f90c06b,2,0,1,0,1,0,1,1,3,3,0,2,4,4,0,22,FRA
a0415710,32,16,14,15,3,16,35,19,16,1,15,17,49,31,0,22,FRA
a0791826,18,10,7,9,2,14,38,24,8,2,6,12,30,5,0,22,FRA
a0d55a09,7,4,2,3,2,1,8,7,7,1,6,2,9,1,0,22,FRA
a0f9b535,28,19,13,9,6,13,40,27,15,4,11,19,47,13,1,22,FRA
a17a94d6,58,32,28,26,4,26,55,29,49,19,30,62,120,43,0,22,FRA
a1dbfcb1,36,17,15,14,7,15,43,28,14,0,14,5,41,7,0,22,FRA
a2d873dd,10,4,4,4,2,4,13,9,9,1,8,5,15,18,0,22,FRA
a30cb0d4,0,0,0,0,0,0,0,0,0,0,0,0,0,0,0,22,FRA
a3c8b4d3,3,1,1,2,0,1,5,4,0,0,0,2,5,0,0,22,FRA
a3e1d20d,17,8,14,1,2,8,11,3,9,1,8,10,27,35,0,22,FRA
a4527d33,0,0,0,0,0,0,0,0,0,0,0,0,0,0,0,22,FRA
a4b1028a,63,36,25,26,12,41,59,18,29,8,21,37,100,81,1,22,FRA
a5549ec1,65,35,33,25,7,36,52,16,26,12,14,43,108,64,1,22,FRA
a5db0bec,46,30,9,25,12,27,54,27,26,1,25,20,66,5,0,22,FRA
a62f8bf1,23,12,7,9,7,10,17,7,10,1,9,4,27,5,0,22,FRA
a634b9d2,0,0,0,0,0,0,0,0,0,0,0,1,1,0,0,22,FRA
a671316d,0,0,0,0,0,0,4,4,1,0,1,0,0,0,0,22,FRA
a6b6fa6e,57,35,37,18,2,23,38,15,29,15,14,60,117,84,0,22,FRA
a84f9a4b,3,1,1,2,0,2,5,3,4,1,3,4,7,7,0,22,FRA
a99138af,43,25,14,24,5,17,40,23,15,5,10,13,56,4,1,22,FRA
a99da9ec,11,6,0,5,6,5,7,2,2,1,1,2,13,0,0,22,FRA
aad56ca3,22,13,2,13,7,10,32,22,22,5,17,11,33,17,1,22,FRA
ab096c6f,43,24,22,14,7,20,36,16,29,7,22,60,103,72,1,22,FRA
abd56820,0,0,0,0,0,0,0,0,0,0,0,0,0,0,0,22,FRA
ad513a6b,2,1,0,1,1,0,0,0,0,0,0,0,2,0,0,22,FRA
ad82197c,42,27,20,21,1,23,39,16,40,30,10,26,68,75,0,22,FRA
ae5b93a0,0,0,0,0,0,0,0,0,0,0,0,0,0,0,0,22,FRA
ae7d0ecd,0,0,0,0,0,0,1,1,1,0,1,1,1,17,2,22,FRA
aef6e670,34,19,18,15,1,14,23,9,20,14,6,38,72,73,1,22,FRA
aefa3050,1,0,1,0,0,1,2,1,0,0,0,0,1,2,0,22,FRA
af0c835b,48,32,20,20,8,23,62,39,14,2,12,17,65,16,0,22,FRA
afb0c500,0,0,0,0,0,0,1,1,0,0,0,0,0,11,1,22,FRA
afe39ca8,2,1,1,1,0,1,2,1,2,0,2,0,2,1,0,22,FRA
b003239d,29,11,20,8,1,11,18,7,21,14,7,21,50,40,1,22,FRA
b026bbf6,15,10,11,3,1,5,9,4,3,1,2,11,26,19,0,22,FRA
b0547a87,17,8,7,8,2,3,19,16,12,4,8,5,22,11,0,22,FRA
b0c71810,44,29,19,16,9,18,38,20,19,2,17,7,51,1,0,22,FRA
b229aa13,3,1,1,0,2,1,3,2,3,1,2,1,4,7,0,22,FRA
b2336681,60,39,39,19,2,26,39,13,26,10,16,24,84,71,0,22,FRA
b2bd0f6c,30,12,13,9,8,13,36,23,24,1,23,21,51,10,0,22,FRA
b34c63a5,6,2,1,3,2,4,9,5,2,0,2,1,7,0,0,22,FRA
b3f8bdef,16,14,11,1,4,12,14,2,9,1,8,3,19,12,1,22,FRA
b5bb8188,70,49,33,33,4,35,86,51,37,5,32,36,106,23,1,22,FRA
b625b241,2,0,0,2,0,0,1,1,2,0,2,0,2,0,0,22,FRA
b666421b,28,17,16,11,1,13,28,15,25,17,8,44,72,122,1,22,FRA
b73f17f8,9,8,2,5,2,3,8,5,4,0,4,0,9,1,0,22,FRA
b85e57bb,0,0,0,0,0,0,1,1,1,1,0,2,2,1,0,22,FRA
b8d22478,8,5,3,4,1,2,5,3,2,0,2,3,11,1,0,22,FRA
b94b8be1,13,6,5,5,3,5,33,28,18,1,17,17,30,4,0,22,FRA
b98cea65,0,0,0,0,0,0,1,1,0,0,0,1,1,9,5,22,FRA
bbdb2789,0,0,0,0,0,0,0,0,1,1,0,0,0,0,0,22,FRA
bbdd999a,2,1,0,2,0,0,0,0,0,0,0,0,2,0,0,22,FRA
bc0bfc64,0,0,0,0,0,0,0,0,1,0,1,0,0,0,0,22,FRA
bc7b4580,61,40,31,23,7,36,74,38,29,7,22,35,96,31,1,22,FRA
bce37ac0,0,0,0,0,0,0,1,1,0,0,0,0,0,1,0,22,FRA
be13e5a8,0,0,0,0,0,0,0,0,0,0,0,0,0,4,0,22,FRA
be47b750,2,1,0,0,2,0,2,2,1,0,1,1,3,2,0,22,FRA
beae3a73,38,21,18,15,5,18,50,32,21,1,20,19,57,21,1,22,FRA
beb391dd,3,1,1,0,2,3,4,1,0,0,0,1,4,1,0,22,FRA
bec3d251,0,0,0,0,0,0,5,5,1,0,1,0,0,4,0,22,FRA
bef0a7ac,0,0,0,0,0,0,0,0,2,0,2,0,0,0,0,22,FRA
bf4c41f9,9,8,1,3,5,2,7,5,6,1,5,8,17,0,0,22,FRA
c066d1a5,45,22,22,14,9,20,38,18,27,2,25,20,65,38,1,22,FRA
c0b3669f,28,14,7,10,11,10,25,15,14,3,11,6,34,31,0,22,FRA
c20bdcd7,43,23,29,11,3,32,51,19,13,4,9,37,80,55,0,22,FRA
c252c705,1,1,1,0,0,1,1,0,0,0,0,0,1,15,1,22,FRA
c26a3918,32,19,18,13,1,14,37,23,23,6,17,32,64,72,0,22,FRA
c2e5f306,4,3,1,2,1,3,4,1,2,0,2,0,4,0,0,22,FRA
c3725db2,58,33,44,11,3,26,34,8,30,14,16,40,98,94,0,22,FRA
c5908bc4,2,1,2,0,0,1,1,0,1,1,0,0,2,0,0,22,FRA
c631f952,2,1,2,0,0,2,3,1,0,0,0,0,2,12,3,22,FRA
c678ddd7,0,0,0,0,0,0,0,0,0,0,0,0,0,0,0,22,FRA
c6e5d20f,36,22,18,16,2,12,30,18,24,5,19,34,70,56,1,22,FRA
c76b7567,64,31,18,27,19,30,93,63,56,4,52,29,93,16,1,22,FRA
c801616a,58,30,23,34,1,31,68,37,38,11,27,36,94,29,0,22,FRA
caa7aaea,53,31,22,26,5,24,42,18,17,7,10,20,73,36,0,22,FRA
caef7840,37,21,21,9,7,22,45,23,21,0,21,24,61,17,0,22,FRA
cc41f558,23,14,11,10,2,12,18,6,20,7,13,31,54,29,1,22,FRA
cc588cbe,0,0,0,0,0,0,0,0,0,0,0,0,0,0,0,22,FRA
cc77354e,68,38,27,36,5,26,47,21,29,10,19,46,114,44,1,22,FRA
cc83b74d,9,4,4,3,2,3,9,6,15,1,14,6,15,17,0,22,FRA
cc972842,0,0,0,0,0,0,0,0,4,0,4,0,0,0,0,22,FRA
ccce7025,24,11,13,11,0,12,18,6,32,21,11,26,50,116,0,22,FRA
cdc4458b,0,0,0,0,0,0,0,0,1,0,1,1,1,1,0,22,FRA
ce492295,14,10,11,3,0,11,17,6,12,7,5,21,35,60,2,22,FRA
ce4f40c7,75,43,34,34,7,35,79,44,30,7,23,68,143,24,0,22,FRA
ce50fd99,24,9,7,11,6,9,30,21,14,4,10,5,29,15,0,22,FRA
ce84946a,0,0,0,0,0,0,0,0,1,0,1,0,0,0,0,22,FRA
cea59f02,34,20,20,13,1,16,27,11,25,11,14,34,68,49,1,22,FRA
cecbce23,1,0,1,0,0,1,2,1,0,0,0,1,2,8,2,22,FRA
ced1d98f,6,3,2,3,1,1,3,2,5,0,5,0,6,0,0,22,FRA
cf1ef7ec,3,2,1,2,0,2,7,5,3,3,0,1,4,6,1,22,FRA
cfa49cc1,22,12,16,5,1,12,24,12,12,2,10,4,26,10,0,22,FRA
d1828392,2,1,1,1,0,0,0,0,3,0,3,0,2,0,0,22,FRA
d21e361a,0,0,0,0,0,0,1,1,1,0,1,0,0,1,0,22,FRA
d33c706e,17,9,3,6,8,7,13,6,14,4,10,9,26,18,0,22,FRA
d4d35152,50,34,27,20,3,22,50,28,14,3,11,25,75,13,0,22,FRA
d504b3e1,5,3,4,1,0,4,5,1,2,0,2,0,5,0,1,22,FRA
d5575935,10,7,2,5,3,2,10,8,9,0,9,4,14,3,0,22,FRA
d56b9520,55,35,29,21,5,24,40,16,21,6,15,33,88,41,1,22,FRA
d5d22a58,43,31,24,16,3,17,35,18,15,3,12,20,63,13,0,22,FRA
d5f2f82b,37,14,25,11,1,20,35,15,35,19,16,16,53,102,0,22,FRA
d6f6ce93,0,0,0,0,0,0,0,0,0,0,0,1,1,1,0,22,FRA
d70ce98e,10,3,1,5,4,3,13,10,5,0,5,4,14,0,0,22,FRA
d75f3980,28,15,15,10,3,14,24,10,12,3,9,16,44,21,0,22,FRA
d8c19a60,0,0,0,0,0,0,1,1,0,0,0,0,0,0,0,22,FRA
d9764034,36,24,27,9,0,20,40,20,21,14,7,25,61,66,1,22,FRA
da4d670f,1,1,0,1,0,1,2,1,3,0,3,0,1,0,0,22,FRA
db013c7d,0,0,0,0,0,0,1,1,1,1,0,2,2,0,0,22,FRA
db23d9fc,21,12,17,4,0,8,15,7,9,7,2,9,30,30,0,22,FRA
db3164e1,3,0,3,0,0,1,1,0,0,0,0,2,5,12,1,22,FRA
db7849ca,54,38,25,13,16,27,47,20,24,2,22,15,69,25,0,22,FRA
db87a2c4,0,0,0,0,0,0,0,0,0,0,0,0,0,0,0,22,FRA
dbde4959,16,11,6,9,1,4,25,21,9,2,7,8,24,4,0,22,FRA
de40e38c,70,42,44,22,4,40,69,29,23,8,15,53,123,71,1,22,FRA
de488e56,16,12,10,4,2,2,13,11,11,4,7,15,31,30,0,22,FRA
deba6b05,24,10,8,12,4,12,43,31,18,6,12,23,47,23,0,22,FRA
dff0c299,0,0,0,0,0,0,0,0,0,0,0,1,1,0,0,22,FRA
dff153a4,23,13,9,11,3,12,24,12,10,6,4,10,33,5,2,22,FRA
e0bc6fdc,46,25,16,22,8,22,34,12,23,8,15,27,73,66,0,22,FRA
e0f3a1f6,45,24,27,17,1,25,35,10,38,27,11,30,75,73,0,22,FRA
e2f9bb5f,48,26,21,25,2,14,34,20,11,3,8,17,65,13,0,22,FRA
e3d0b0c4,13,8,7,6,0,8,12,4,7,5,2,17,30,56,1,22,FRA
e3e05edf,13,4,7,4,2,9,15,6,5,1,4,6,19,17,0,22,FRA
e3e32fbb,27,16,16,8,3,15,43,28,17,2,15,25,52,28,0,22,FRA
e4114f5d,14,6,6,8,0,0,4,4,2,1,1,4,18,3,0,22,FRA
e42d61c7,74,51,38,27,9,40,72,32,26,5,21,28,102,23,2,22,FRA
e4448c8c,8,6,3,2,3,2,8,6,1,0,1,1,9,1,1,22,FRA
e472a6f6,49,28,21,22,6,23,45,22,37,6,31,34,83,40,0,22,FRA
e4b72e34,25,18,16,8,1,12,22,10,13,4,9,23,48,17,0,22,FRA
e4bb1f08,12,6,6,4,2,6,8,2,2,0,2,2,14,7,0,22,FRA
e50623a0,10,8,3,5,2,3,20,17,24,5,19,19,29,21,0,22,FRA
e5c1e0ca,37,22,29,8,0,20,26,6,26,18,8,34,71,87,1,22,FRA
e6c43eec,39,16,18,17,4,14,29,15,16,8,8,36,75,23,0,22,FRA
e6eadfb8,30,18,21,8,1,19,30,11,8,3,5,10,40,25,0,22,FRA
e768de1f,47,28,29,13,5,24,48,24,20,7,13,14,61,18,0,22,FRA
e7986081,18,9,5,5,8,6,15,9,13,0,13,8,26,30,1,22,FRA
e7d59f4f,18,11,9,9,0,9,17,8,10,0,10,4,22,2,0,22,FRA
e8c5dd4d,0,0,0,0,0,0,3,3,0,0,0,0,0,1,3,22,FRA
e97150c0,13,9,8,4,1,6,6,0,9,7,2,7,20,31,0,22,FRA
ea02beaf,34,18,19,13,2,18,32,14,14,3,11,27,61,21,0,22,FRA
ea0aa7e0,44,32,26,16,2,25,43,18,16,6,10,17,61,48,0,22,FRA
ea0ff634,23,14,6,11,6,8,31,23,13,1,12,9,32,27,0,22,FRA
eab85789,18,8,7,6,5,8,22,14,8,0,8,8,26,1,0,22,FRA
eab957a3,38,26,27,9,2,20,31,11,16,8,8,22,60,44,0,22,FRA
eaf71a5e,6,5,4,2,0,3,5,2,4,2,2,1,7,10,0,22,FRA
eb58eef0,15,9,2,12,1,11,19,8,13,3,10,9,24,7,0,22,FRA
ecada4fc,0,0,0,0,0,0,0,0,0,0,0,0,0,5,1,22,FRA
ed39121c,58,25,31,21,6,31,71,40,31,9,22,42,100,38,0,22,FRA
ed45c4a5,77,51,36,36,5,28,60,32,26,5,21,33,110,14,0,22,FRA
edbe46dc,0,0,0,0,0,0,0,0,1,0,1,1,1,11,1,22,FRA
edd81e2a,47,29,33,13,1,20,31,11,32,19,13,40,87,78,1,22,FRA
ee158be5,5,2,4,1,0,3,3,0,1,0,1,0,5,1,0,22,FRA
ee45fd85,35,19,10,19,6,15,23,8,17,4,13,13,48,12,0,22,FRA
ee644761,26,12,18,6,2,11,24,13,19,11,8,28,54,55,0,22,FRA
ee95585f,15,9,13,2,0,8,12,4,5,4,1,12,27,15,0,22,FRA
eef2d8ce,35,22,22,8,5,26,41,15,18,4,14,25,60,47,3,22,FRA
ef9c1c95,123,69,49,65,9,51,113,62,49,11,38,50,173,56,0,22,FRA
f00de885,0,0,0,0,0,0,0,0,0,0,0,3,3,12,3,22,FRA
f066022d,63,45,35,26,2,32,64,32,37,22,15,54,117,174,0,22,FRA
f20e4cc9,48,29,23,18,7,25,47,22,27,5,22,21,69,17,1,22,FRA
f28474a4,13,7,10,1,2,5,16,11,13,1,12,22,35,14,0,22,FRA
f3600c02,47,27,18,24,5,27,56,29,23,3,20,24,71,26,1,22,FRA
f36d5624,4,3,2,1,1,2,5,3,2,0,2,5,9,1,0,22,FRA
f4bc42b1,13,8,5,8,0,6,14,8,9,0,9,10,23,8,0,22,FRA
f520049f,17,12,12,5,0,8,12,4,11,8,3,17,34,61,1,22,FRA
f54d2149,12,6,7,4,1,3,19,16,10,5,5,9,21,5,0,22,FRA
f5b6fb78,0,0,0,0,0,0,0,0,0,0,0,1,1,3,1,22,FRA
f5c8b425,10,5,3,6,1,1,9,8,4,0,4,2,12,1,0,22,FRA
f5dfc256,0,0,0,0,0,0,0,0,0,0,0,1,1,10,0,22,FRA
f5efb153,14,9,10,3,1,8,13,5,17,12,5,12,26,39,0,22,FRA
f6496133,19,11,6,10,3,8,17,9,15,0,15,6,25,5,0,22,FRA
f6b94e8d,28,17,21,6,1,16,21,5,15,5,10,23,51,34,0,22,FRA
f7691f63,71,43,40,21,10,46,77,31,12,0,12,21,92,28,0,22,FRA
f7d3a773,0,0,0,0,0,0,0,0,0,0,0,0,0,9,0,22,FRA
f81ef10d,73,40,29,36,8,30,80,50,38,10,28,43,116,26,2,22,FRA
f83c8d6c,2,0,2,0,0,0,2,2,0,0,0,1,3,2,0,22,FRA
f8405304,10,5,1,4,5,5,17,12,17,1,16,8,18,0,1,22,FRA
f86ca403,86,56,35,47,4,20,46,26,33,6,27,51,137,38,0,22,FRA
f8ce97ca,20,8,8,10,2,10,29,19,12,3,9,16,36,24,0,22,FRA
f98b15f0,1,1,0,1,0,0,0,0,0,0,0,0,1,0,0,22,FRA
f9d5908e,31,18,15,10,6,13,36,23,17,4,13,18,49,15,0,22,FRA
fb14aa28,40,28,16,14,10,8,26,18,32,1,31,5,45,9,0,22,FRA
fbf83734,1,1,1,0,0,1,1,0,0,0,0,0,1,9,0,22,FRA
fc46aab1,32,21,9,14,9,11,42,31,26,2,24,11,43,9,0,22,FRA
fc4cf6a7,33,17,21,9,3,16,30,14,17,4,13,12,45,28,0,22,FRA
fc62f087,22,14,10,9,3,8,14,6,6,2,4,10,32,19,1,22,FRA
fcc84a07,31,21,17,11,3,12,34,22,20,4,16,8,39,8,0,22,FRA
fd2bc67d,42,29,30,12,0,23,33,10,43,27,16,49,91,96,1,22,FRA
fe6c1add,0,0,0,0,0,0,2,2,2,0,2,1,1,2,0,22,FRA
feb5d3ab,55,34,35,18,2,28,48,20,30,13,17,27,82,74,0,22,FRA
feb5d972,45,26,21,23,1,18,39,21,33,3,30,29,74,22,0,22,FRA
ff0ab48c,43,27,22,14,7,27,46,19,27,3,24,22,65,35,1,22,FRA
ff20acfe,2,2,0,2,0,2,3,1,1,1,0,1,3,2,0,22,FRA
ff44d058,0,0,0,0,0,0,0,0,0,0,0,0,0,1,0,22,FRA
ff800ed8,28,16,15,9,4,13,28,15,15,0,15,13,41,22,0,22,FRA
ffec9769,3,2,0,1,2,1,6,5,4,0,4,2,5,5,0,22,FRA
fffea3e5,10,5,3,5,2,3,6,3,4,0,4,3,13,0,0,22,FRA
00242b75,60,38,19,28,13,22,49,27,38,13,25,41,101,39,1,23,GER
00963611,50,27,32,15,3,28,38,10,39,18,21,63,113,99,0,23,GER
009a4f60,55,32,34,17,4,34,62,28,28,5,23,20,75,47,0,23,GER
00f518d8,8,5,3,4,1,3,9,6,3,0,3,1,9,3,0,23,GER
0118c54c,58,33,32,20,6,28,42,14,28,4,24,54,112,40,0,23,GER
01834aa0,29,17,17,10,2,16,22,6,27,12,15,31,60,83,1,23,GER
042e8a49,11,8,3,5,3,7,17,10,19,1,18,2,13,7,0,23,GER
048a1cbc,36,20,13,15,8,21,34,13,21,2,19,36,72,23,0,23,GER
049751d7,21,9,7,12,2,6,14,8,12,2,10,4,25,11,0,23,GER
054849d2,34,16,20,10,4,11,29,18,18,5,13,17,51,53,0,23,GER
056d2d95,31,16,16,12,3,20,31,11,14,1,13,25,56,48,0,23,GER
05ba9d7c,12,9,9,1,2,5,12,7,10,0,10,3,15,0,0,23,GER
05d548d8,62,34,38,22,2,32,55,23,30,16,14,33,95,100,1,23,GER
05e2d5ea,3,3,1,1,1,2,3,1,2,0,2,0,3,2,0,23,GER
05f99a4a,3,1,0,1,2,1,4,3,6,1,5,1,4,1,0,23,GER
061e8e23,8,6,4,3,1,2,10,8,8,1,7,3,11,4,0,23,GER
07c7eb0c,76,49,32,34,10,38,77,39,39,12,27,37,113,67,0,23,GER
07d3bfec,15,10,8,3,4,7,10,3,5,1,4,1,16,1,0,23,GER
08593525,1,0,0,1,0,0,1,1,0,0,0,0,1,0,0,23,GER
088ca1bd,1,1,1,0,0,0,0,0,1,0,1,1,2,1,1,23,GER
091c86e2,41,24,11,23,7,16,34,18,26,10,16,25,66,31,0,23,GER
099e666f,46,34,27,16,3,24,42,18,38,9,29,46,92,74,0,23,GER
0a084b35,9,7,5,2,2,7,18,11,9,3,6,6,15,22,1,23,GER
0a16eb36,23,18,13,5,5,12,23,11,12,5,7,10,33,8,0,23,GER
0a1cb833,1,0,1,0,0,1,5,4,1,0,1,3,4,21,1,23,GER
0a3f6cde,23,15,7,8,8,10,29,19,17,0,17,5,28,16,0,23,GER
0a89e877,73,46,41,29,3,43,66,23,48,4,44,35,108,46,0,23,GER
0b45a8d7,0,0,0,0,0,0,0,0,0,0,0,0,0,0,0,23,GER
0c61c77c,18,11,7,8,3,6,27,21,23,5,18,13,31,17,0,23,GER
0c7a48f8,51,34,28,20,3,25,38,13,41,20,21,31,82,83,1,23,GER
0c88efca,0,0,0,0,0,0,0,0,0,0,0,0,0,0,0,23,GER
0cc5f4a5,5,3,0,2,3,3,3,0,5,1,4,3,8,4,0,23,GER
0cf778df,36,14,15,14,7,24,44,20,29,2,27,7,43,13,0,23,GER
0d55d942,0,0,0,0,0,0,2,2,0,0,0,1,1,6,3,23,GER
0d8a37c2,0,0,0,0,0,0,0,0,0,0,0,0,0,1,1,23,GER
0e0102eb,16,10,8,2,6,4,16,12,21,1,20,7,23,4,0,23,GER
0e6bc38c,10,7,2,6,2,1,2,1,8,0,8,0,10,5,0,23,GER
0f59a7bf,27,21,10,15,2,16,38,22,28,2,26,41,68,25,0,23,GER
0fbecd11,59,33,23,31,5,29,61,32,46,9,37,34,93,26,1,23,GER
1025db8e,42,27,19,17,6,24,49,25,41,23,18,50,92,141,2,23,GER
10549b49,6,3,1,4,1,1,7,6,4,0,4,2,8,14,0,23,GER
10745192,8,4,2,5,1,2,7,5,1,0,1,1,9,2,0,23,GER
116c35df,13,5,3,4,6,5,12,7,14,1,13,4,17,11,0,23,GER
1238a3f9,2,1,1,1,0,0,5,5,7,2,5,1,3,16,0,23,GER
13203c45,16,9,6,8,2,8,12,4,7,2,5,4,20,22,0,23,GER
13d23b29,0,0,0,0,0,0,0,0,0,0,0,1,1,0,0,23,GER
13ddc856,14,9,4,4,6,7,16,9,17,1,16,8,22,8,0,23,GER
13fe7b69,5,3,2,2,1,3,5,2,3,0,3,1,6,0,0,23,GER
14a7af33,56,25,20,34,2,29,60,31,20,5,15,23,79,38,1,23,GER
15413fa5,31,18,10,16,5,16,39,23,24,2,22,28,59,19,1,23,GER
15b287da,51,31,10,37,4,31,57,26,31,2,29,16,67,17,1,23,GER
15f24fe7,3,2,0,1,2,1,3,2,1,0,1,0,3,0,0,23,GER
15f3ec41,5,3,4,0,1,1,1,0,0,0,0,2,7,4,0,23,GER
17376543,2,2,2,0,0,2,3,1,0,0,0,0,2,15,5,23,GER
1866b0f1,0,0,0,0,0,0,0,0,0,0,0,0,0,0,0,23,GER
19a967ab,36,25,22,11,3,15,34,19,19,1,18,15,51,26,0,23,GER
1a4b9094,0,0,0,0,0,0,0,0,0,0,0,0,0,0,0,23,GER
1a5d7cb9,0,0,0,0,0,0,1,1,0,0,0,0,0,0,0,23,GER
1ae836b1,51,30,18,24,9,29,59,30,40,13,27,17,68,40,0,23,GER
1c86aa16,0,0,0,0,0,0,0,0,0,0,0,0,0,0,0,23,GER
1cbe4984,72,46,46,17,9,44,66,22,42,6,36,30,102,70,1,23,GER
1d8e9add,15,10,10,5,0,9,22,13,18,11,7,26,41,67,0,23,GER
1df0c0b9,34,24,13,15,6,11,27,16,21,7,14,26,60,62,1,23,GER
1e274a0a,9,5,1,5,3,4,8,4,5,1,4,0,9,4,0,23,GER
1e43fad8,1,0,1,0,0,1,1,0,0,0,0,0,1,10,2,23,GER
1f2c7b55,1,0,1,0,0,0,0,0,0,0,0,0,1,1,0,23,GER
1f3afdcb,21,14,12,7,2,8,16,8,26,11,15,24,45,58,1,23,GER
1fc4f3d1,44,27,16,25,3,18,31,13,23,6,17,22,66,21,1,23,GER
1fffae99,34,17,15,18,1,10,37,27,34,11,23,16,50,37,0,23,GER
20030c06,51,30,33,18,0,26,43,17,42,24,18,39,90,129,1,23,GER
202b3b68,36,25,15,13,8,20,40,20,37,2,35,8,44,15,0,23,GER
204dded0,40,29,24,14,2,18,35,17,38,17,21,40,80,94,0,23,GER
2077ae86,14,6,2,7,5,5,10,5,14,4,10,1,15,10,0,23,GER
220ace7e,24,15,5,13,6,10,22,12,21,3,18,7,31,12,0,23,GER
22798128,14,7,6,8,0,5,17,12,22,4,18,9,23,3,0,23,GER
22919e97,14,7,5,3,6,7,17,10,12,0,12,4,18,5,0,23,GER
231c67ff,2,0,0,0,2,1,3,2,2,0,2,0,2,1,0,23,GER
236f02cd,31,20,25,5,1,24,31,7,17,6,11,8,39,61,0,23,GER
25ab9c9c,14,8,10,4,0,2,4,2,5,1,4,19,33,25,0,23,GER
271b8617,4,1,0,2,2,1,10,9,9,1,8,4,8,10,0,23,GER
27270af4,2,1,2,0,0,1,3,2,2,1,1,2,4,4,0,23,GER
2770726a,6,4,2,4,0,3,6,3,4,0,4,2,8,6,0,23,GER
277be51d,0,0,0,0,0,0,1,1,0,0,0,0,0,0,0,23,GER
277c49ed,22,13,15,7,0,8,16,8,22,11,11,26,48,85,0,23,GER
2903a856,31,16,17,8,6,15,52,37,36,2,34,16,47,21,0,23,GER
2979c05a,14,7,6,7,1,12,21,9,15,1,14,2,16,4,0,23,GER
29ddfb9c,3,1,2,1,0,1,1,0,1,1,0,1,4,2,0,23,GER
29f7cfd9,11,4,2,8,1,4,12,8,14,1,13,6,17,21,0,23,GER
2a29eb9b,37,25,24,9,4,18,30,12,25,11,14,29,66,50,0,23,GER
2b114be3,38,30,11,19,8,18,36,18,11,1,10,3,41,1,2,23,GER
2b83fa49,2,1,1,1,0,1,1,0,1,0,1,3,5,2,0,23,GER
2c0558b8,34,23,9,16,9,13,35,22,30,3,27,19,53,3,0,23,GER
2d61d13a,51,34,27,21,3,17,30,13,35,23,12,45,96,83,0,23,GER
2e77d607,35,23,24,7,4,22,39,17,16,8,8,33,68,77,2,23,GER
2f3e911a,42,27,25,11,6,21,40,19,22,1,21,15,57,31,0,23,GER
2f7fec15,12,10,4,5,3,4,6,2,2,0,2,1,13,1,0,23,GER
302527b2,29,18,19,10,0,13,27,14,29,15,14,35,64,97,0,23,GER
30261ba1,11,6,7,3,1,5,9,4,9,0,9,4,15,12,0,23,GER
30941e96,40,24,19,18,3,23,37,14,32,6,26,25,65,67,0,23,GER
30ae134d,11,7,4,4,3,4,18,14,18,3,15,5,16,25,0,23,GER
30c220c3,71,43,38,24,9,38,75,37,50,7,43,28,99,38,1,23,GER
313254a3,33,20,10,19,4,18,30,12,24,9,15,21,54,47,1,23,GER
33182cb8,13,5,2,8,3,4,13,9,6,0,6,2,15,1,0,23,GER
33b554b7,17,13,8,8,1,5,17,12,16,1,15,5,22,15,0,23,GER
346d51d9,43,16,21,21,1,23,41,18,23,2,21,18,61,32,0,23,GER
34b0387f,38,17,9,21,8,16,36,20,29,5,24,17,55,21,0,23,GER
34b54da7,2,1,1,1,0,1,1,0,5,3,2,0,2,5,0,23,GER
34e12499,59,34,34,24,1,37,53,16,38,21,17,32,91,71,1,23,GER
34e4343c,4,4,2,0,2,2,5,3,7,0,7,2,6,22,0,23,GER
35d64857,53,35,27,19,7,33,57,24,47,14,33,49,102,134,2,23,GER
35f67a30,0,0,0,0,0,0,4,4,2,0,2,3,3,3,0,23,GER
36578017,2,2,0,2,0,2,2,0,0,0,0,0,2,0,0,23,GER
36a3ff67,30,17,12,14,4,7,24,17,12,4,8,8,38,8,0,23,GER
36a59ba4,19,9,9,5,5,8,27,19,20,3,17,12,31,5,0,23,GER
36d9dabe,20,8,13,5,2,6,10,4,17,4,13,13,33,27,0,23,GER
3745e8bd,4,3,0,4,0,1,4,3,4,0,4,1,5,6,0,23,GER
378825c7,34,21,21,10,3,26,39,13,44,14,30,36,70,98,1,23,GER
37998008,0,0,0,0,0,0,1,1,0,0,0,0,0,1,1,23,GER
37dc1a48,26,11,15,7,4,7,22,15,25,3,22,9,35,9,0,23,GER
37f606f0,45,25,15,28,2,22,35,13,27,3,24,24,69,18,2,23,GER
3b1ed320,26,12,9,13,4,8,12,4,12,2,10,10,36,14,0,23,GER
3b61c9ec,13,8,10,3,0,8,8,0,8,2,6,7,20,11,1,23,GER
3bb625ac,35,25,26,5,4,18,34,16,37,16,21,54,89,87,2,23,GER
3c200e05,0,0,0,0,0,0,0,0,0,0,0,0,0,0,0,23,GER
3c6089ab,21,12,5,9,7,6,16,10,19,3,16,4,25,16,0,23,GER
3eb0f2df,1,1,0,1,0,0,0,0,1,0,1,0,1,0,0,23,GER
3eeb80e0,15,10,8,3,4,5,10,5,12,5,7,4,19,12,0,23,GER
3effaa34,12,6,2,5,5,3,8,5,11,1,10,3,15,3,0,23,GER
3f6c3ae0,0,0,0,0,0,0,0,0,0,0,0,0,0,1,0,23,GER
41bff4fa,17,8,9,8,0,9,18,9,14,9,5,11,28,45,1,23,GER
420c18a1,1,0,1,0,0,1,1,0,0,0,0,1,2,13,1,23,GER
437f2b00,36,19,12,17,7,9,52,43,57,5,52,15,51,19,1,23,GER
441197b8,25,18,10,11,4,18,32,14,47,19,28,31,56,150,0,23,GER
442b56fa,50,26,29,17,4,32,58,26,44,6,38,21,71,59,0,23,GER
44a20f0c,31,17,18,12,1,17,34,17,25,9,16,23,54,79,1,23,GER
458e3479,0,0,0,0,0,0,0,0,0,0,0,0,0,0,0,23,GER
45a03961,70,41,36,26,8,36,48,12,35,16,19,44,114,83,0,23,GER
45e95f21,14,10,2,11,1,6,12,6,5,0,5,12,26,21,0,23,GER
462475ed,6,5,1,4,1,1,9,8,8,2,6,1,7,8,0,23,GER
463503e2,6,4,4,0,2,2,4,2,8,7,1,9,15,28,0,23,GER
46750e9c,1,0,0,1,0,0,0,0,0,0,0,0,1,0,0,23,GER
47064058,0,0,0,0,0,0,0,0,0,0,0,0,0,15,1,23,GER
48035304,46,24,32,12,2,27,41,14,31,16,15,35,81,149,3,23,GER
48780156,0,0,0,0,0,0,0,0,1,0,1,2,2,4,0,23,GER
49296448,78,49,24,46,8,38,72,34,36,7,29,41,119,39,2,23,GER
496aeede,44,33,24,15,5,22,55,33,34,2,32,17,61,40,0,23,GER
49fe9070,10,5,4,3,3,4,12,8,12,0,12,7,17,5,0,23,GER
4aea5077,16,8,10,5,1,10,23,13,8,1,7,14,30,34,1,23,GER
4b96c347,6,5,2,3,1,5,12,7,5,0,5,5,11,7,0,23,GER
4c6facae,41,25,13,25,3,22,44,22,22,4,18,28,69,23,0,23,GER
4ccd8957,5,5,2,1,2,2,6,4,2,0,2,0,5,2,0,23,GER
4cd41883,6,5,2,2,2,2,3,1,2,1,1,0,6,2,0,23,GER
4e204552,4,3,0,1,3,3,4,1,3,1,2,1,5,0,0,23,GER
4f16405e,9,4,0,6,3,3,13,10,13,4,9,1,10,24,0,23,GER
4f627629,15,9,8,7,0,7,11,4,7,6,1,7,22,28,0,23,GER
501055d8,16,11,6,6,4,8,30,22,18,1,17,7,23,3,0,23,GER
50871bcc,17,6,5,11,1,12,17,5,6,0,6,5,22,5,0,23,GER
5154b2ba,5,4,4,1,0,0,2,2,3,0,3,6,11,17,0,23,GER
526ea7cc,46,28,25,19,2,24,40,16,23,11,12,30,76,94,1,23,GER
52afb588,6,4,3,2,1,3,5,2,0,0,0,0,6,2,0,23,GER
53070b63,0,0,0,0,0,0,0,0,1,0,1,0,0,2,0,23,GER
5360a956,0,0,0,0,0,0,0,0,0,0,0,0,0,0,0,23,GER
5458f670,8,2,1,3,4,4,7,3,4,0,4,1,9,0,0,23,GER
54b4dc4e,36,18,16,17,3,18,34,16,26,6,20,16,52,11,0,23,GER
54e4866f,29,16,6,15,8,13,31,18,18,1,17,19,48,19,0,23,GER
5521f419,9,4,4,3,2,3,9,6,9,2,7,6,15,9,0,23,GER
554bcc91,20,9,9,10,1,8,19,11,17,5,12,15,35,12,1,23,GER
555d5edd,15,6,5,8,2,9,20,11,12,1,11,6,21,10,2,23,GER
56413b1f,17,7,7,10,0,12,20,8,4,0,4,7,24,4,0,23,GER
56e6a1c9,0,0,0,0,0,0,0,0,1,0,1,0,0,0,0,23,GER
5762be5c,49,30,18,25,6,24,47,23,39,11,28,31,80,44,0,23,GER
57d88cf9,76,42,28,34,14,34,51,17,51,4,47,35,111,30,0,23,GER
57ec75bf,2,1,2,0,0,1,1,0,3,2,1,1,3,8,1,23,GER
582a5247,44,23,31,11,2,22,33,11,32,9,23,20,64,41,1,23,GER
591477c9,10,8,7,3,0,6,9,3,5,3,2,13,23,41,0,23,GER
59e4b92e,60,33,21,32,7,25,50,25,33,10,23,40,100,33,0,23,GER
5ad50391,23,17,15,8,0,9,22,13,34,17,17,34,57,76,1,23,GER
5c4bf6ba,0,0,0,0,0,0,4,4,0,0,0,0,0,17,1,23,GER
5c50fdbc,13,9,6,3,4,9,12,3,7,0,7,6,19,8,0,23,GER
5c899683,4,3,0,4,0,1,1,0,1,1,0,0,4,1,0,23,GER
5d4f7d61,0,0,0,0,0,0,1,1,4,1,3,1,1,7,0,23,GER
5d8e331f,66,35,28,35,3,27,61,34,40,13,27,58,124,49,0,23,GER
5dc15574,4,2,4,0,0,3,5,2,3,0,3,0,4,5,0,23,GER
5ddb8f9f,20,16,7,8,5,12,20,8,22,3,19,9,29,26,0,23,GER
5e080f73,1,1,1,0,0,1,5,4,3,0,3,4,5,8,0,23,GER
5e66fa06,49,27,27,19,3,27,51,24,44,16,28,38,87,123,2,23,GER
603cb947,5,2,2,1,2,1,11,10,14,2,12,6,11,13,0,23,GER
610aa1e9,22,16,14,7,1,12,21,9,16,8,8,11,33,48,0,23,GER
61590953,22,13,14,7,1,12,22,10,22,5,17,24,46,34,0,23,GER
6190474d,7,3,4,2,1,2,5,3,7,1,6,1,8,7,0,23,GER
626fab5f,10,6,6,4,0,3,5,2,2,1,1,2,12,5,0,23,GER
62ab9184,29,15,10,11,8,12,30,18,26,5,21,7,36,24,0,23,GER
62c7067a,0,0,0,0,0,0,0,0,0,0,0,1,1,0,0,23,GER
635f2732,30,16,19,9,2,8,25,17,25,5,20,14,44,10,0,23,GER
638a4d71,8,3,2,4,2,3,16,13,13,2,11,9,17,41,1,23,GER
65857fdf,14,8,3,8,3,8,11,3,6,0,6,0,14,4,0,23,GER
65bf7e2b,0,0,0,0,0,0,1,1,0,0,0,1,1,0,0,23,GER
66385c46,0,0,0,0,0,0,1,1,0,0,0,0,0,0,0,23,GER
663e080e,0,0,0,0,0,0,0,0,0,0,0,0,0,10,0,23,GER
677da306,30,20,14,13,3,15,29,14,27,14,13,29,59,61,1,23,GER
689c9cf4,23,15,13,8,2,12,20,8,24,10,14,11,34,33,1,23,GER
691bef82,2,0,2,0,0,0,1,1,4,2,2,2,4,6,0,23,GER
69374ff5,15,4,5,6,4,6,19,13,4,2,2,4,19,15,0,23,GER
697dc00a,4,2,2,2,0,0,2,2,4,1,3,5,9,4,0,23,GER
699fb8db,13,9,5,7,1,6,17,11,11,7,4,12,25,34,0,23,GER
6a52a6c6,1,1,1,0,0,1,1,0,0,0,0,0,1,0,0,23,GER
6b8887c2,12,7,1,8,3,4,14,10,13,2,11,8,20,17,0,23,GER
6bd5cd5d,45,29,29,12,4,24,47,23,35,18,17,38,83,140,0,23,GER
6c731625,2,2,0,1,1,0,0,0,0,0,0,0,2,3,0,23,GER
6ce43701,13,7,3,6,4,3,6,3,9,0,9,2,15,1,0,23,GER
6e17c802,16,13,6,9,1,10,16,6,6,2,4,8,24,5,0,23,GER
6ec6fde0,75,44,45,27,3,32,45,13,45,16,29,24,99,70,1,23,GER
6ecbddf6,15,7,6,7,2,5,11,6,8,2,6,6,21,16,1,23,GER
6f8cd6d0,14,7,3,6,5,6,13,7,20,3,17,6,20,22,0,23,GER
706a60e1,1,1,1,0,0,1,2,1,0,0,0,0,1,1,0,23,GER
70dcf94d,29,17,8,18,3,17,48,31,35,2,33,14,43,25,0,23,GER
71ec39ef,73,38,35,28,10,27,60,33,42,6,36,48,121,75,1,23,GER
7242b495,21,11,9,9,3,13,31,18,17,5,12,9,30,28,0,23,GER
72984eee,8,5,1,7,0,2,9,7,9,0,9,4,12,3,0,23,GER
73000a79,10,7,7,3,0,7,9,2,8,4,4,5,15,7,0,23,GER
74f2e748,53,27,22,26,5,23,44,21,24,3,21,16,69,40,0,23,GER
76b2817e,0,0,0,0,0,0,0,0,1,0,1,2,2,1,0,23,GER
76fa965f,31,19,11,15,5,12,40,28,22,0,22,6,37,6,0,23,GER
778ccc44,0,0,0,0,0,0,0,0,1,0,1,0,0,0,0,23,GER
779aa25c,0,0,0,0,0,0,0,0,1,0,1,0,0,1,0,23,GER
792ffa71,6,4,3,1,2,3,5,2,5,0,5,1,7,4,0,23,GER
79c90e45,26,20,10,9,7,15,23,8,12,2,10,14,40,37,1,23,GER
79ca3e23,9,8,2,5,2,4,11,7,7,1,6,2,11,3,0,23,GER
79f7302a,9,6,3,4,2,6,11,5,6,0,6,5,14,18,0,23,GER
7aac47fe,8,4,6,1,1,2,6,4,4,3,1,5,13,14,0,23,GER
7bf9400b,5,4,2,2,1,1,4,3,8,5,3,13,18,33,2,23,GER
7c56da38,6,4,2,1,3,1,6,5,8,3,5,8,14,11,0,23,GER
7cd6badb,24,14,4,17,3,10,28,18,24,5,19,11,35,19,0,23,GER
7d31f1cb,6,3,4,2,0,5,6,1,4,2,2,0,6,2,0,23,GER
7d3e7da6,1,1,1,0,0,1,1,0,0,0,0,0,1,0,1,23,GER
7d450ed3,39,25,23,12,4,17,29,12,24,6,18,16,55,26,1,23,GER
7e12a98d,9,7,6,3,0,4,5,1,7,4,3,18,27,26,1,23,GER
7e82a78f,4,1,0,4,0,2,7,5,7,1,6,1,5,1,0,23,GER
7ec723b7,5,3,3,2,0,1,3,2,3,2,1,0,5,3,0,23,GER
7ed08d5c,19,11,14,2,3,12,17,5,9,1,8,7,26,11,3,23,GER
7f609bfc,0,0,0,0,0,0,0,0,0,0,0,0,0,0,0,23,GER
7f73bdf4,21,12,8,11,2,9,16,7,9,3,6,6,27,9,0,23,GER
7fa4e703,14,7,2,5,7,5,10,5,8,2,6,3,17,5,0,23,GER
809940aa,25,17,12,10,3,9,22,13,18,2,16,8,33,12,0,23,GER
80f252f6,0,0,0,0,0,0,0,0,0,0,0,0,0,0,0,23,GER
80f36c88,26,12,10,16,0,13,27,14,27,7,20,11,37,13,0,23,GER
815c314f,44,27,29,14,1,16,22,6,42,32,10,51,95,143,0,23,GER
826e8b63,12,9,4,7,1,5,16,11,10,2,8,3,15,11,0,23,GER
829aa60c,2,2,0,1,1,1,1,0,5,1,4,0,2,2,0,23,GER
834d0be5,3,2,1,0,2,0,1,1,0,0,0,2,5,13,0,23,GER
83b9c48f,6,3,3,3,0,4,6,2,4,0,4,3,9,5,0,23,GER
83e1f40e,1,1,1,0,0,0,1,1,4,0,4,1,2,5,0,23,GER
857a5abe,43,28,32,10,1,22,44,22,42,15,27,44,87,133,0,23,GER
8593f88c,29,21,18,9,2,13,43,30,22,4,18,16,45,41,0,23,GER
861e0116,27,16,13,8,6,10,24,14,21,8,13,20,47,31,1,23,GER
863ff1ee,15,8,4,7,4,3,14,11,6,2,4,6,21,9,0,23,GER
86574238,74,39,37,33,4,24,47,23,44,12,32,32,106,21,0,23,GER
86adbcc7,10,5,4,4,2,5,8,3,6,1,5,2,12,3,0,23,GER
86c75897,31,19,21,9,1,16,28,12,34,17,17,57,88,139,0,23,GER
86e119e0,62,31,25,28,9,28,54,26,34,11,23,26,88,65,2,23,GER
87436846,1,0,1,0,0,1,1,0,0,0,0,2,3,8,2,23,GER
8778c910,0,0,0,0,0,0,0,0,0,0,0,0,0,4,1,23,GER
8779ddf8,2,1,0,2,0,1,4,3,4,1,3,0,2,2,0,23,GER
877bc844,18,11,0,13,5,5,12,7,20,8,12,6,24,48,0,23,GER
8872ed17,17,8,9,4,4,8,18,10,6,0,6,6,23,7,0,23,GER
88d4144a,39,20,31,6,2,17,39,22,13,2,11,26,65,27,0,23,GER
88e357ef,35,23,11,14,10,17,43,26,24,1,23,11,46,5,1,23,GER
89b3bc5e,1,1,1,0,0,0,1,1,2,0,2,0,1,1,0,23,GER
8a6ab963,0,0,0,0,0,0,0,0,0,0,0,0,0,0,0,23,GER
8b6e0db2,1,1,1,0,0,0,0,0,4,3,1,1,2,5,0,23,GER
8bf58a80,0,0,0,0,0,0,1,1,0,0,0,0,0,1,0,23,GER
8ce30c57,5,4,2,3,0,2,6,4,0,0,0,3,8,4,0,23,GER
8e235926,19,12,6,9,4,3,21,18,23,4,19,5,24,10,0,23,GER
8eb55dbb,15,5,1,7,7,2,11,9,13,1,12,3,18,7,1,23,GER
8f056768,41,24,13,26,2,20,43,23,19,2,17,17,58,23,0,23,GER
8f0f2230,11,8,3,5,3,3,12,9,9,1,8,3,14,9,0,23,GER
8f325097,3,3,1,2,0,2,3,1,3,1,2,0,3,0,0,23,GER
8fe2a392,45,30,26,18,1,28,39,11,42,24,18,26,71,108,2,23,GER
8ff2354e,40,21,20,15,5,23,41,18,22,1,21,21,61,29,0,23,GER
90c1f9a4,1,1,0,1,0,1,1,0,0,0,0,1,2,2,0,23,GER
90d88154,0,0,0,0,0,0,1,1,1,0,1,1,1,3,0,23,GER
923f4dda,4,1,2,2,0,1,2,1,7,2,5,0,4,14,0,23,GER
92432bc6,25,11,15,10,0,13,34,21,26,6,20,26,51,20,0,23,GER
924f9191,27,19,14,11,2,9,25,16,22,4,18,8,35,23,0,23,GER
92a16062,66,41,29,30,7,30,60,30,29,9,20,33,99,49,0,23,GER
92d83c27,25,16,8,16,1,10,30,20,27,5,22,21,46,25,1,23,GER
934e1968,45,28,12,20,13,17,42,25,43,2,41,17,62,27,0,23,GER
93cba339,7,6,3,3,1,4,8,4,3,0,3,0,7,5,0,23,GER
94302c52,43,28,35,8,0,24,52,28,27,13,14,58,101,153,0,23,GER
943b9602,0,0,0,0,0,0,0,0,0,0,0,0,0,0,0,23,GER
94c18565,21,10,7,12,2,8,26,18,27,6,21,32,53,30,1,23,GER
95bb6ddc,30,19,16,14,0,16,33,17,18,5,13,11,41,20,0,23,GER
9642c929,12,3,7,5,0,4,14,10,9,3,6,4,16,18,0,23,GER
9662c9ec,20,17,8,10,2,11,16,5,17,6,11,12,32,25,0,23,GER
97d545ae,29,17,18,7,4,16,30,14,41,25,16,27,56,95,0,23,GER
99f7e9aa,12,8,8,4,0,5,9,4,9,2,7,5,17,6,0,23,GER
9a2e0ccc,16,11,1,8,7,6,20,14,25,2,23,3,19,7,0,23,GER
9a2e3a23,7,6,3,2,2,2,13,11,15,2,13,1,8,14,0,23,GER
9ab16552,18,12,16,2,0,7,22,15,22,9,13,17,35,45,0,23,GER
9b688ae1,0,0,0,0,0,0,0,0,0,0,0,0,0,1,0,23,GER
9ceb7642,12,6,3,8,1,6,14,8,7,1,6,7,19,9,0,23,GER
9dff291c,0,0,0,0,0,0,0,0,0,0,0,0,0,0,1,23,GER
9ec9c8b6,8,5,3,5,0,2,7,5,14,5,9,8,16,19,0,23,GER
9efa1d25,42,25,13,22,7,14,47,33,25,0,25,13,55,12,0,23,GER
9f77012e,112,68,39,62,11,51,100,49,39,6,33,36,148,35,0,23,GER
9f941969,3,2,3,0,0,3,5,2,1,0,1,5,8,23,7,23,GER
9ff8ec4a,2,2,0,2,0,0,0,0,4,0,4,0,2,0,0,23,GER
a1257b5e,2,2,1,1,0,0,2,2,1,1,0,0,2,7,0,23,GER
a167537f,29,20,6,14,9,12,43,31,23,0,23,15,44,9,1,23,GER
a2a85828,18,8,10,5,3,5,10,5,7,0,7,3,21,9,0,23,GER
a2b1ed42,1,1,1,0,0,1,1,0,1,0,1,0,1,1,0,23,GER
a396fb61,50,31,28,21,1,30,51,21,30,14,16,27,77,79,0,23,GER
a3ddb1b9,0,0,0,0,0,0,0,0,0,0,0,0,0,0,0,23,GER
a45241d5,0,0,0,0,0,0,0,0,0,0,0,0,0,0,0,23,GER
a4effc55,14,9,10,4,0,5,14,9,19,16,3,21,35,81,1,23,GER
a53b661f,19,16,8,7,4,11,17,6,9,2,7,7,26,15,0,23,GER
a5ae8f8e,30,19,17,13,0,18,29,11,32,16,16,33,63,103,0,23,GER
a5ec3ede,30,18,21,9,0,19,33,14,18,5,13,24,54,45,1,23,GER
a65ce836,57,28,25,27,5,22,43,21,16,6,10,25,82,39,1,23,GER
a6c58494,17,11,7,7,3,8,20,12,16,5,11,8,25,7,0,23,GER
a70b8345,0,0,0,0,0,0,5,5,0,0,0,0,0,9,1,23,GER
a73c8f95,51,30,35,12,4,30,42,12,40,17,23,36,87,109,1,23,GER
a8567629,16,8,9,7,0,6,15,9,20,2,18,15,31,20,2,23,GER
a8ee54ad,33,21,19,12,2,22,41,19,32,10,22,14,47,49,1,23,GER
a9142dc3,7,5,3,3,1,4,4,0,2,0,2,0,7,1,0,23,GER
a92ab7be,0,0,0,0,0,0,1,1,1,0,1,0,0,9,5,23,GER
a93b6f4e,24,18,11,11,2,17,35,18,11,5,6,19,43,44,1,23,GER
aad48be9,56,36,29,24,3,27,42,15,24,13,11,37,93,110,0,23,GER
ab096c6f,0,0,0,0,0,0,1,1,0,0,0,1,1,1,0,23,GER
ab3f1bdf,43,23,28,12,3,26,60,34,28,11,17,23,66,57,1,23,GER
ab5b7dc1,22,11,8,7,7,12,32,20,34,1,33,10,32,20,0,23,GER
ab700320,31,22,17,11,3,10,18,8,21,0,21,15,46,22,0,23,GER
ad00b1a8,64,42,31,28,5,42,82,40,34,4,30,26,90,57,0,23,GER
ad3389d5,0,0,0,0,0,0,0,0,0,0,0,0,0,3,3,23,GER
ae44e8e2,15,9,1,10,4,6,14,8,15,0,15,6,21,6,0,23,GER
ae7058f9,36,23,19,14,3,20,35,15,30,18,12,41,77,105,0,23,GER
ae9b998d,0,0,0,0,0,0,0,0,0,0,0,0,0,0,0,23,GER
aeed5c06,14,8,4,8,2,7,14,7,8,0,8,5,19,3,0,23,GER
af0d79a9,27,21,18,8,1,21,32,11,20,5,15,19,46,37,0,23,GER
af104654,1,0,1,0,0,0,2,2,0,0,0,0,1,22,2,23,GER
af842091,38,23,29,8,1,14,22,8,18,13,5,36,74,88,2,23,GER
b06a7ae9,1,1,0,1,0,1,1,0,0,0,0,0,1,0,0,23,GER
b116c6e3,23,9,8,11,4,10,25,15,16,2,14,4,27,5,0,23,GER
b1cd37e6,2,0,1,1,0,0,0,0,0,0,0,1,3,0,0,23,GER
b3325a30,51,23,14,30,7,20,41,21,48,12,36,29,80,24,0,23,GER
b3b7f5a6,2,2,2,0,0,2,2,0,1,0,1,0,2,3,0,23,GER
b4705807,33,19,15,13,5,15,27,12,18,1,17,9,42,34,0,23,GER
b492126a,10,4,2,4,4,8,13,5,9,2,7,1,11,5,0,23,GER
b4c816a9,5,4,2,1,2,2,4,2,14,3,11,2,7,13,0,23,GER
b56dd813,0,0,0,0,0,0,1,1,0,0,0,0,0,1,0,23,GER
b684a484,15,7,3,4,8,2,17,15,17,5,12,4,19,15,0,23,GER
b74277a0,29,21,9,9,11,15,24,9,13,2,11,10,39,25,0,23,GER
b77f44a4,17,11,13,3,1,10,13,3,14,6,8,11,28,52,0,23,GER
b825a650,21,11,6,14,1,6,27,21,26,9,17,22,43,11,0,23,GER
b8e740fb,17,8,4,10,3,7,13,6,9,1,8,9,26,10,0,23,GER
b90c4a43,0,0,0,0,0,0,0,0,0,0,0,0,0,1,0,23,GER
b9ae8560,25,10,12,11,2,13,28,15,10,0,10,5,30,12,0,23,GER
ba115a40,5,4,2,1,2,0,4,4,8,0,8,1,6,10,0,23,GER
bbd79358,0,0,0,0,0,0,5,5,1,0,1,0,0,6,0,23,GER
bbd86530,29,21,17,7,5,16,37,21,16,3,13,21,50,34,0,23,GER
bc249af8,14,9,7,4,3,6,14,8,6,1,5,1,15,4,0,23,GER
bc6bd723,16,8,5,7,4,8,26,18,23,3,20,12,28,14,0,23,GER
bcb2ccd8,0,0,0,0,0,0,0,0,0,0,0,0,0,2,0,23,GER
bd142efb,25,12,21,4,0,12,18,6,30,18,12,40,65,118,0,23,GER
bd527260,23,12,13,8,2,18,28,10,14,2,12,15,38,24,0,23,GER
bd6351cd,23,14,9,10,4,10,23,13,14,2,12,15,38,22,0,23,GER
bd7d2e6d,11,6,5,4,2,5,18,13,12,4,8,2,13,14,0,23,GER
bdedffac,0,0,0,0,0,0,0,0,0,0,0,0,0,0,0,23,GER
be42a291,11,8,4,5,2,5,13,8,3,0,3,3,14,9,0,23,GER
beb882a8,51,29,21,24,6,17,35,18,37,8,29,36,87,27,0,23,GER
bee0bab1,2,0,1,1,0,2,3,1,0,0,0,0,2,0,0,23,GER
bf075f6b,11,8,4,3,4,4,10,6,7,1,6,2,13,11,0,23,GER
c05f2f8c,72,46,42,23,7,43,72,29,29,6,23,30,102,56,1,23,GER
c0b3669f,14,10,3,3,8,1,9,8,19,2,17,3,17,13,0,23,GER
c149016b,70,37,30,31,9,38,85,47,44,6,38,26,96,63,0,23,GER
c18d22f5,4,3,4,0,0,4,6,2,6,2,4,4,8,7,0,23,GER
c1b7847c,60,31,23,30,7,30,54,24,31,4,27,18,78,8,0,23,GER
c2009df3,112,66,59,43,10,66,113,47,61,9,52,39,151,74,1,23,GER
c2211709,79,44,29,42,8,26,66,40,52,12,40,56,135,48,0,23,GER
c3ee18ef,6,4,3,3,0,5,6,1,2,1,1,5,11,7,0,23,GER
c455a2b2,25,14,7,14,4,13,40,27,20,1,19,8,33,8,1,23,GER
c4987edc,35,20,21,14,0,21,34,13,23,14,9,26,61,99,1,23,GER
c631f952,1,1,1,0,0,1,3,2,1,0,1,0,1,9,1,23,GER
c64c01fc,7,4,1,4,2,1,3,2,10,2,8,5,12,6,0,23,GER
c6608135,3,2,2,1,0,2,3,1,1,0,1,0,3,0,0,23,GER
c68b1b13,1,0,1,0,0,0,0,0,0,0,0,0,1,1,0,23,GER
c68da769,25,15,4,13,8,4,17,13,10,2,8,2,27,9,0,23,GER
c691bfe2,11,5,3,3,5,1,9,8,15,2,13,0,11,4,0,23,GER
c6cf860f,2,2,2,0,0,2,2,0,1,0,1,0,2,0,0,23,GER
c8b3a472,3,1,3,0,0,0,3,3,0,0,0,0,3,1,0,23,GER
c8c60119,13,7,7,5,1,5,9,4,9,2,7,10,23,8,0,23,GER
c967f6b8,8,7,6,2,0,5,10,5,11,4,7,6,14,38,0,23,GER
ca618d23,19,14,5,7,7,6,22,16,22,5,17,10,29,17,0,23,GER
ca8033cb,16,8,7,9,0,8,15,7,6,3,3,13,29,31,0,23,GER
caffaf5a,34,22,19,13,2,18,29,11,40,29,11,46,80,132,2,23,GER
cb11b429,39,26,18,11,10,12,38,26,27,2,25,15,54,15,0,23,GER
cb64672e,3,1,1,2,0,1,1,0,0,0,0,0,3,1,0,23,GER
cb6d81b3,1,0,0,1,0,0,0,0,1,1,0,0,1,0,0,23,GER
cbac6ec9,0,0,0,0,0,0,0,0,0,0,0,0,0,7,4,23,GER
cc83b74d,7,5,1,4,2,4,6,2,6,2,4,0,7,5,0,23,GER
cc86b9a3,43,24,21,16,6,27,48,21,40,3,37,30,73,32,0,23,GER
cc971106,0,0,0,0,0,0,0,0,0,0,0,0,0,0,0,23,GER
cd59b9df,0,0,0,0,0,0,1,1,1,0,1,0,0,7,2,23,GER
cd61c7af,1,1,0,0,1,0,0,0,0,0,0,0,1,0,0,23,GER
cd682b6b,1,0,1,0,0,1,4,3,1,0,1,0,1,2,1,23,GER
cd82452e,9,5,4,4,1,8,12,4,9,2,7,4,13,14,0,23,GER
ce17b5eb,1,1,1,0,0,0,2,2,2,0,2,0,1,10,0,23,GER
ce81d82d,0,0,0,0,0,0,0,0,0,0,0,0,0,0,0,23,GER
d01bbb6f,61,29,19,29,13,25,54,29,40,1,39,14,75,12,0,23,GER
d1273f09,8,5,5,3,0,4,5,1,3,2,1,3,11,2,0,23,GER
d1b49282,22,10,9,11,2,13,21,8,11,5,6,3,25,20,0,23,GER
d1db4b83,2,1,2,0,0,2,2,0,1,0,1,0,2,3,0,23,GER
d2416c2e,6,4,1,4,1,2,5,3,3,1,2,0,6,5,0,23,GER
d248cd8f,65,37,43,22,0,28,45,17,26,6,20,27,92,71,4,23,GER
d28339cb,1,1,1,0,0,1,1,0,0,0,0,0,1,4,2,23,GER
d2c580ce,11,7,4,6,1,3,5,2,6,3,3,13,24,8,0,23,GER
d3d77413,6,3,1,2,3,1,2,1,3,0,3,0,6,0,0,23,GER
d4a2533d,2,1,2,0,0,0,4,4,0,0,0,2,4,2,0,23,GER
d6862409,19,12,7,8,4,6,15,9,23,2,21,4,23,19,0,23,GER
d6e53a3a,32,23,15,16,1,15,24,9,31,20,11,23,55,85,0,23,GER
d75f3980,14,10,6,6,2,6,10,4,5,2,3,8,22,13,0,23,GER
d781d855,45,28,25,13,7,18,39,21,28,4,24,24,69,24,4,23,GER
d82a310a,0,0,0,0,0,0,0,0,0,0,0,0,0,0,0,23,GER
db401046,0,0,0,0,0,0,0,0,0,0,0,1,1,10,1,23,GER
db4ed67b,11,9,3,4,4,7,7,0,6,2,4,7,18,3,0,23,GER
dc366c36,0,0,0,0,0,0,0,0,0,0,0,0,0,7,0,23,GER
dc62fbee,53,28,20,25,8,25,62,37,13,0,13,10,63,15,0,23,GER
dcfb17f4,18,10,4,6,8,5,17,12,28,2,26,6,24,7,0,23,GER
dd2e62da,10,2,4,6,0,4,7,3,4,0,4,5,15,8,0,23,GER
dd5bbe0d,4,1,1,1,2,2,2,0,8,0,8,4,8,3,0,23,GER
dd676a97,11,6,3,7,1,2,7,5,4,0,4,6,17,8,0,23,GER
de4cac2d,25,17,5,14,6,6,20,14,17,2,15,8,33,1,0,23,GER
de838f86,46,27,19,20,7,31,58,27,30,6,24,22,68,63,0,23,GER
dee3013b,0,0,0,0,0,0,0,0,0,0,0,0,0,3,0,23,GER
dfb6490a,6,2,4,1,1,2,4,2,2,0,2,2,8,1,0,23,GER
e0b113a7,61,38,30,27,4,26,45,19,27,9,18,42,103,55,2,23,GER
e110ea4b,11,5,5,5,1,7,13,6,9,0,9,1,12,4,0,23,GER
e12b0b5b,38,24,7,28,3,14,45,31,18,2,16,16,54,12,0,23,GER
e162b013,16,7,8,5,3,10,17,7,7,2,5,9,25,16,0,23,GER
e18098de,38,20,16,21,1,16,24,8,17,5,12,13,51,19,1,23,GER
e1830c52,0,0,0,0,0,0,0,0,0,0,0,0,0,0,0,23,GER
e27da244,18,12,10,8,0,13,18,5,17,12,5,10,28,105,0,23,GER
e280527c,27,14,11,10,6,10,17,7,3,0,3,10,37,9,0,23,GER
e33c06cf,25,19,18,3,4,14,23,9,28,19,9,17,42,53,0,23,GER
e3d3fbeb,0,0,0,0,0,0,0,0,2,0,2,0,0,2,0,23,GER
e52d33d0,1,1,1,0,0,1,1,0,0,0,0,0,1,0,0,23,GER
e547d3cf,10,5,4,5,1,3,9,6,4,0,4,2,12,8,0,23,GER
e5649a78,84,45,38,32,14,31,94,63,27,4,23,26,110,21,1,23,GER
e5a35ae9,5,2,2,1,2,2,10,8,6,0,6,3,8,5,0,23,GER
e5d85da8,18,12,5,11,2,7,30,23,19,0,19,5,23,9,0,23,GER
e61bdd69,8,6,3,4,1,3,12,9,7,0,7,2,10,3,0,23,GER
e6c43eec,18,11,7,10,1,6,17,11,19,13,6,23,41,52,0,23,GER
e717705a,34,24,10,22,2,17,37,20,31,6,25,17,51,53,0,23,GER
e75129bd,0,0,0,0,0,0,0,0,0,0,0,0,0,0,0,23,GER
e79269bd,25,13,19,3,3,19,32,13,5,1,4,6,31,27,0,23,GER
e7f3e8a7,5,4,1,4,0,1,5,4,4,0,4,4,9,1,0,23,GER
e7fcf289,18,10,9,7,2,8,16,8,15,1,14,1,19,6,0,23,GER
e82adcab,59,36,20,33,6,29,48,19,29,2,27,33,92,28,0,23,GER
e92cd3f7,0,0,0,0,0,0,0,0,0,0,0,0,0,0,0,23,GER
ea003d07,0,0,0,0,0,0,0,0,0,0,0,0,0,0,0,23,GER
ea0893d6,6,4,2,4,0,2,5,3,7,0,7,1,7,2,0,23,GER
ea42c03f,18,9,13,5,0,11,17,6,15,8,7,11,29,74,1,23,GER
eac044ad,11,8,4,5,2,3,9,6,8,0,8,5,16,0,0,23,GER
eb6e14be,11,6,4,3,4,4,14,10,16,1,15,0,11,19,0,23,GER
ebb32f3a,0,0,0,0,0,0,0,0,0,0,0,1,1,0,0,23,GER
ed79b7d3,31,14,9,12,10,9,22,13,31,4,27,14,45,37,0,23,GER
ee644761,14,11,8,5,1,5,8,3,16,10,6,8,22,53,1,23,GER
f0a37d36,39,27,26,11,2,30,45,15,24,7,17,43,82,79,0,23,GER
f1bc3876,0,0,0,0,0,0,0,0,0,0,0,0,0,0,0,23,GER
f1e855eb,6,4,3,3,0,4,6,2,5,0,5,3,9,3,0,23,GER
f24ea523,28,15,8,17,3,7,25,18,20,3,17,11,39,15,0,23,GER
f26834c7,19,12,3,10,6,4,21,17,19,0,19,2,21,7,0,23,GER
f27680d9,42,24,27,14,1,21,31,10,20,7,13,16,58,34,1,23,GER
f2dd9a21,21,12,12,9,0,9,16,7,13,4,9,10,31,15,0,23,GER
f36c432f,3,2,2,1,0,1,11,10,2,1,1,2,5,10,0,23,GER
f4ec4fd0,8,6,4,2,2,3,9,6,11,3,8,3,11,5,0,23,GER
f503ef6e,5,1,4,1,0,2,3,1,4,1,3,1,6,0,0,23,GER
f521b80a,43,20,29,12,2,26,40,14,40,24,16,35,78,153,3,23,GER
f582d5c1,0,0,0,0,0,0,0,0,0,0,0,0,0,0,0,23,GER
f5c4fd91,1,1,1,0,0,0,0,0,0,0,0,0,1,0,0,23,GER
f631c17f,1,0,0,0,1,0,0,0,2,0,2,0,1,0,0,23,GER
f67c9d29,38,23,21,17,0,14,26,12,27,12,15,29,67,93,0,23,GER
f68b64fc,26,17,15,10,1,20,39,19,22,8,14,31,57,28,0,23,GER
f6bdc830,17,9,12,5,0,9,11,2,12,6,6,16,33,51,0,23,GER
f76022e7,23,16,9,10,4,12,19,7,20,3,17,12,35,7,0,23,GER
f7aa75bd,43,33,24,15,4,29,47,18,25,11,14,15,58,82,0,23,GER
f86ad3f5,62,46,40,22,0,41,68,27,46,17,29,58,120,127,1,23,GER
f86cd5df,0,0,0,0,0,0,0,0,0,0,0,0,0,1,0,23,GER
f93e6e94,6,4,0,3,3,2,5,3,11,2,9,1,7,6,0,23,GER
f9446dcd,1,1,0,1,0,0,1,1,2,1,1,0,1,1,0,23,GER
f972644c,43,23,18,17,8,19,48,29,29,2,27,24,67,25,0,23,GER
f9dfb7ae,10,5,4,5,1,5,12,7,7,3,4,3,13,16,0,23,GER
fa4cabd1,0,0,0,0,0,0,1,1,1,0,1,0,0,1,0,23,GER
fa661778,25,18,9,12,4,16,29,13,40,10,30,18,43,22,1,23,GER
fb377d11,26,15,12,11,3,15,27,12,20,2,18,8,34,29,1,23,GER
fbbc8e15,0,0,0,0,0,0,1,1,1,0,1,0,0,0,0,23,GER
fc3697dd,16,8,5,9,2,9,24,15,16,1,15,7,23,13,0,23,GER
fc62f087,6,5,5,1,0,1,3,2,8,5,3,8,14,22,0,23,GER
fc8fcbd1,9,6,4,3,2,7,9,2,20,6,14,7,16,29,1,23,GER
fcb27134,21,14,12,5,4,14,21,7,21,4,17,16,37,55,0,23,GER
fd53759d,9,8,3,4,2,2,11,9,16,3,13,9,18,7,0,23,GER
fe46e261,25,18,14,9,2,11,24,13,11,0,11,10,35,15,0,23,GER
fe641c1a,6,3,3,2,1,3,8,5,5,0,5,1,7,4,0,23,GER
ff3d391c,5,4,0,2,3,2,4,2,2,1,1,1,6,3,0,23,GER
ff5ea0bf,3,1,2,1,0,1,2,1,4,3,1,9,12,24,1,23,GER
ff98492b,22,11,14,7,1,10,26,16,22,8,14,8,30,20,2,23,GER
00242715,18,9,15,3,0,11,22,11,18,8,10,19,37,60,0,23,ENG
007414dd,17,10,6,10,1,3,8,5,7,0,7,6,23,6,0,23,ENG
01962d0d,6,2,1,3,2,3,5,2,5,0,5,0,6,4,0,23,ENG
01c3aff5,30,13,5,18,7,10,29,19,22,3,19,22,52,26,0,23,ENG
01ce9e70,14,11,2,9,3,5,16,11,12,5,7,1,15,26,0,23,ENG
01e5f06e,9,4,6,1,2,5,8,3,5,3,2,2,11,9,1,23,ENG
02b29014,31,20,9,15,7,12,37,25,26,3,23,13,44,11,0,23,ENG
0313a347,42,20,25,15,2,18,26,8,41,23,18,26,68,120,3,23,ENG
0420d84f,35,26,21,10,4,19,29,10,14,7,7,22,57,58,2,23,ENG
0442183b,27,16,13,9,5,14,23,9,22,4,18,19,46,34,0,23,ENG
049a888d,11,9,2,4,5,4,13,9,7,1,6,0,11,3,0,23,ENG
0562b7f1,25,13,7,12,6,7,13,6,17,5,12,3,28,22,0,23,ENG
05e8ca6d,0,0,0,0,0,0,0,0,0,0,0,0,0,0,0,23,ENG
06df8256,14,8,10,4,0,9,14,5,5,2,3,16,30,34,1,23,ENG
07802f7f,19,13,1,10,8,6,20,14,20,3,17,4,23,16,0,23,ENG
089667a5,16,9,4,11,1,6,12,6,13,2,11,5,21,9,0,23,ENG
08eb3b58,19,11,9,8,2,14,30,16,13,1,12,4,23,22,0,23,ENG
0a3d6d2b,9,6,8,1,0,5,7,2,10,1,9,8,17,31,0,23,ENG
0a6cb1b1,15,9,10,5,0,7,18,11,16,12,4,12,27,45,0,23,ENG
0b33f6ad,51,29,33,16,2,24,34,10,56,25,31,31,82,122,1,23,ENG
0bdda685,0,0,0,0,0,0,0,0,0,0,0,0,0,0,0,23,ENG
0bdeb013,0,0,0,0,0,0,0,0,0,0,0,0,0,0,0,23,ENG
0cd31129,34,20,18,8,8,8,28,20,30,1,29,5,39,7,1,23,ENG
0db5d2c8,17,8,9,8,0,9,21,12,19,12,7,16,33,39,1,23,ENG
0ef89a37,19,14,8,8,3,9,15,6,11,1,10,4,23,2,0,23,ENG
0f134faf,70,35,28,30,12,34,97,63,54,5,49,32,102,24,1,23,ENG
0f7533cd,42,24,14,14,14,16,36,20,25,3,22,20,62,28,1,23,ENG
10a10454,20,13,7,12,1,7,21,14,14,3,11,9,29,7,0,23,ENG
10d221cd,0,0,0,0,0,0,0,0,0,0,0,0,0,6,1,23,ENG
10ec4169,0,0,0,0,0,0,1,1,0,0,0,0,0,0,0,23,ENG
1137759d,0,0,0,0,0,0,2,2,3,1,2,0,0,1,0,23,ENG
119b9a8e,11,8,6,4,1,7,11,4,10,4,6,3,14,30,1,23,ENG
11f54bd5,3,1,2,1,0,0,1,1,1,0,1,1,4,1,0,23,ENG
11ff3d56,25,15,14,10,1,8,14,6,11,1,10,6,31,11,0,23,ENG
1265a93a,31,20,10,18,3,15,19,4,17,2,15,12,43,23,0,23,ENG
132a82f1,34,20,20,9,5,14,29,15,18,11,7,29,63,38,2,23,ENG
1544f145,69,39,23,35,11,32,69,37,48,8,40,23,92,34,0,23,ENG
1598599e,13,9,7,6,0,8,15,7,20,4,16,13,26,2,0,23,ENG
15ab5a2b,26,16,3,13,10,9,30,21,13,0,13,2,28,6,0,23,ENG
15ea812b,51,26,36,13,2,20,38,18,99,78,21,51,102,201,3,23,ENG
15f24fe7,0,0,0,0,0,0,0,0,0,0,0,1,1,0,0,23,ENG
16264a81,100,50,41,47,12,40,68,28,43,7,36,56,156,31,3,23,ENG
169fd162,20,9,7,8,5,6,19,13,18,2,16,5,25,5,0,23,ENG
16e9d0ea,23,14,15,5,3,13,36,23,18,3,15,7,30,37,2,23,ENG
172e52d8,5,3,4,1,0,3,5,2,13,9,4,9,14,38,0,23,ENG
17695062,1,1,1,0,0,1,3,2,1,0,1,0,1,2,0,23,ENG
1780bb4a,38,26,27,11,0,18,32,14,18,7,11,17,55,32,1,23,ENG
178ae8f8,23,15,8,8,7,12,37,25,5,0,5,3,26,11,0,23,ENG
17acc2ed,0,0,0,0,0,0,0,0,0,0,0,0,0,1,1,23,ENG
18b999f4,17,9,8,6,3,9,18,9,14,0,14,1,18,8,0,23,ENG
1971591f,26,15,4,13,9,13,38,25,13,1,12,4,30,2,0,23,ENG
197640fd,87,44,53,27,7,41,84,43,50,13,37,43,130,110,0,23,ENG
1a4ef233,19,8,13,5,1,12,14,2,24,17,7,8,27,71,0,23,ENG
1b4f1169,14,11,7,4,3,8,14,6,9,3,6,12,26,12,0,23,ENG
1b804500,0,0,0,0,0,0,0,0,0,0,0,0,0,0,0,23,ENG
1b84dbe1,30,12,20,9,1,20,33,13,18,5,13,18,48,45,0,23,ENG
1bf33a9a,11,6,3,6,2,3,5,2,8,1,7,4,15,4,0,23,ENG
1c7012b8,79,38,44,31,4,31,50,19,45,15,30,63,142,58,0,23,ENG
1d5cab82,10,5,1,6,3,3,4,1,3,1,2,1,11,1,0,23,ENG
1daec722,66,33,40,15,11,30,60,30,28,8,20,16,82,48,1,23,ENG
1ecb65be,13,6,8,4,1,8,27,19,8,1,7,9,22,7,0,23,ENG
1f44ac21,3,2,0,2,1,1,5,4,12,4,8,3,6,14,0,23,ENG
1fb1c435,24,10,2,15,7,8,19,11,16,4,12,6,30,21,1,23,ENG
20b104bc,49,29,27,19,3,29,60,31,30,13,17,25,74,81,1,23,ENG
21166ff4,14,9,10,4,0,7,10,3,9,8,1,7,21,30,0,23,ENG
21512407,71,49,36,27,8,46,90,44,45,15,30,43,114,84,2,23,ENG
215f3907,31,21,13,13,5,15,42,27,20,2,18,10,41,14,0,23,ENG
21a66f6a,15,12,1,6,8,7,21,14,27,7,20,2,17,18,0,23,ENG
230f0471,49,24,32,13,4,29,53,24,24,4,20,15,64,45,0,23,ENG
2389cdc2,55,32,36,15,4,26,37,11,20,5,15,26,81,43,0,23,ENG
24f59bb2,47,25,27,15,5,24,46,22,23,7,16,24,71,40,0,23,ENG
2500cef9,17,12,4,7,6,6,13,7,10,0,10,6,23,15,0,23,ENG
254147d4,19,11,13,5,1,11,27,16,19,2,17,11,30,7,0,23,ENG
2628fd2b,0,0,0,0,0,0,3,3,0,0,0,0,0,18,1,23,ENG
26ce2263,34,22,10,23,1,14,49,35,16,4,12,26,60,20,0,23,ENG
26d3b5be,0,0,0,0,0,0,0,0,0,0,0,0,0,1,0,23,ENG
26f6dca8,2,2,1,1,0,2,6,4,2,0,2,2,4,0,0,23,ENG
27d0a506,25,16,8,15,2,14,39,25,25,2,23,15,40,24,1,23,ENG
282679b4,12,8,3,4,5,7,13,6,4,0,4,0,12,1,0,23,ENG
282f75f3,30,19,19,9,2,18,41,23,37,27,10,34,64,81,1,23,ENG
28300a16,0,0,0,0,0,0,1,1,0,0,0,0,0,6,1,23,ENG
2886c9b5,15,9,6,6,3,7,17,10,10,2,8,7,22,10,0,23,ENG
288e1e13,27,18,18,8,1,13,20,7,26,24,2,18,45,79,2,23,ENG
289601e6,62,38,43,15,4,44,65,21,49,13,36,53,115,83,3,23,ENG
28b40c9c,30,16,15,12,3,13,26,13,45,24,21,41,71,116,3,23,ENG
28d596a0,2,2,2,0,0,2,3,1,0,0,0,1,3,16,2,23,ENG
2928dca2,14,9,8,6,0,7,15,8,21,17,4,14,28,88,3,23,ENG
2944f86f,19,14,11,7,1,10,25,15,16,3,13,10,29,16,0,23,ENG
2964fd20,5,2,3,1,1,2,5,3,4,0,4,0,5,3,0,23,ENG
2afc7272,37,22,10,22,5,18,42,24,29,10,19,23,60,31,0,23,ENG
2b09d998,89,46,44,35,10,50,77,27,48,8,40,35,124,29,0,23,ENG
2b16cb1a,10,3,3,6,1,2,11,9,4,0,4,5,15,2,0,23,ENG
2b471f99,38,24,22,13,3,20,38,18,26,8,18,14,52,24,1,23,ENG
2b622f01,8,5,1,3,4,1,4,3,0,0,0,2,10,1,1,23,ENG
2bd83368,48,34,22,17,9,17,43,26,28,1,27,6,54,12,1,23,ENG
2c44a35d,17,11,5,5,7,8,17,9,13,1,12,2,19,6,0,23,ENG
2c6835e5,0,0,0,0,0,0,0,0,1,0,1,0,0,0,0,23,ENG
2ce2508a,13,7,7,4,2,7,10,3,13,4,9,12,25,10,1,23,ENG
2e4f5f03,38,21,12,16,10,21,41,20,32,5,27,18,56,50,3,23,ENG
2f90f6b8,26,16,11,11,4,15,34,19,14,2,12,12,38,15,0,23,ENG
2f965a72,0,0,0,0,0,0,0,0,0,0,0,0,0,0,0,23,ENG
2f9e4435,28,15,20,6,2,13,32,19,20,3,17,13,41,29,1,23,ENG
2fba6108,3,0,0,2,1,1,2,1,4,0,4,2,5,4,0,23,ENG
30d4a2e5,58,34,36,19,3,28,51,23,50,16,34,46,104,99,0,23,ENG
30db8574,0,0,0,0,0,0,0,0,0,0,0,1,1,1,0,23,ENG
31c69ef1,21,13,10,10,1,11,18,7,21,13,8,18,39,56,1,23,ENG
328f7d51,31,20,15,12,4,11,20,9,14,1,13,10,41,11,0,23,ENG
32e8417f,9,6,5,3,1,8,27,19,7,0,7,9,18,4,0,23,ENG
32f60ed8,29,15,10,7,12,13,35,22,25,4,21,15,44,18,0,23,ENG
3312f911,66,46,28,29,9,22,43,21,39,8,31,23,89,38,0,23,ENG
33887998,0,0,0,0,0,0,0,0,0,0,0,0,0,3,3,23,ENG
35141f4c,50,35,28,22,0,23,43,20,38,20,18,43,93,146,2,23,ENG
3515d404,65,37,31,27,7,21,61,40,30,10,20,55,120,48,0,23,ENG
3544641e,14,10,5,8,1,3,9,6,11,0,11,1,15,5,0,23,ENG
35e413f1,60,31,23,30,7,42,70,28,47,11,36,22,82,79,1,23,ENG
36c2ca73,0,0,0,0,0,0,1,1,0,0,0,1,1,3,1,23,ENG
3727dd3c,3,1,1,1,1,1,10,9,8,2,6,5,8,10,1,23,ENG
384d58d9,9,5,5,2,2,2,8,6,4,1,3,3,12,10,0,23,ENG
38c7feef,5,4,1,2,2,1,5,4,5,2,3,1,6,4,0,23,ENG
38ceb24a,22,13,11,3,8,7,26,19,35,0,35,12,34,4,1,23,ENG
3925dbd6,14,7,8,4,2,5,12,7,22,5,17,3,17,20,1,23,ENG
39769cff,62,35,35,21,6,42,76,34,32,14,18,35,97,61,0,23,ENG
3a233281,14,6,6,7,1,5,20,15,13,0,13,6,20,12,0,23,ENG
3a949a25,0,0,0,0,0,0,1,1,0,0,0,0,0,1,0,23,ENG
3b8674e6,45,28,15,21,9,16,28,12,28,15,13,20,65,22,0,23,ENG
3bb7b8b4,3,1,3,0,0,1,2,1,0,0,0,1,4,10,2,23,ENG
3e5e4e63,8,4,4,4,0,5,7,2,16,11,5,12,20,51,0,23,ENG
3e9e06cb,20,13,15,5,0,9,14,5,40,29,11,18,38,100,2,23,ENG
3ea50f67,26,14,8,14,4,14,42,28,32,1,31,8,34,12,0,23,ENG
3eb22ec9,44,23,11,25,8,18,45,27,23,6,17,16,60,6,0,23,ENG
3f847d95,0,0,0,0,0,0,0,0,0,0,0,0,0,1,0,23,ENG
4115ce4e,30,24,20,10,0,13,17,4,41,28,13,51,81,92,0,23,ENG
414184f7,2,2,0,1,1,1,4,3,0,0,0,2,4,2,0,23,ENG
41e7ef1c,3,2,1,1,1,3,3,0,1,1,0,2,5,4,0,23,ENG
41f08ac8,1,0,0,1,0,0,0,0,5,1,4,0,1,2,0,23,ENG
420d7c7d,66,37,42,15,9,42,85,43,34,11,23,26,92,52,2,23,ENG
422862ea,1,1,1,0,0,1,1,0,0,0,0,0,1,2,0,23,ENG
4468ec10,33,24,9,14,10,17,31,14,23,3,20,13,46,18,0,23,ENG
44781702,28,11,13,13,2,14,26,12,17,8,9,18,46,72,0,23,ENG
44bfb6c5,79,43,31,33,15,32,74,42,59,22,37,50,129,85,1,23,ENG
4506aec5,0,0,0,0,0,0,0,0,0,0,0,0,0,0,0,23,ENG
450ab6fc,1,0,1,0,0,1,1,0,3,2,1,0,1,17,0,23,ENG
45963054,10,5,4,3,3,1,7,6,17,3,14,2,12,30,0,23,ENG
4596da74,6,3,1,3,2,1,7,6,11,1,10,2,8,6,0,23,ENG
45db685d,60,36,28,24,8,27,70,43,25,5,20,30,90,15,0,23,ENG
466fb2c5,1,1,1,0,0,1,1,0,0,0,0,0,1,20,6,23,ENG
468a7a91,2,1,1,1,0,1,22,21,5,2,3,4,6,3,0,23,ENG
47a34c4f,1,1,1,0,0,1,1,0,0,0,0,0,1,0,0,23,ENG
4806ec67,0,0,0,0,0,0,1,1,0,0,0,4,4,15,3,23,ENG
48a5a5d6,31,18,13,12,6,9,22,13,24,1,23,9,40,14,0,23,ENG
493924a7,3,2,2,1,0,1,3,2,2,0,2,3,6,3,0,23,ENG
4a1a9578,17,11,4,8,5,8,15,7,8,0,8,6,23,2,0,23,ENG
4abac767,10,5,2,7,1,6,22,16,14,5,9,1,11,11,0,23,ENG
4b40d9ca,1,0,1,0,0,1,3,2,0,0,0,0,1,27,2,23,ENG
4b511457,1,0,0,1,0,0,0,0,1,0,1,1,2,1,0,23,ENG
4b803b3c,25,18,9,15,1,16,24,8,32,14,18,27,52,67,1,23,ENG
4bcf39f6,11,5,3,4,4,2,4,2,8,0,8,5,16,0,0,23,ENG
4c370d81,17,12,2,12,3,4,21,17,16,1,15,7,24,2,0,23,ENG
4d224fe8,89,46,43,35,11,48,92,44,49,11,38,34,123,64,0,23,ENG
4d77b365,11,5,2,4,5,4,17,13,10,0,10,3,14,13,0,23,ENG
4d90ce8c,0,0,0,0,0,0,1,1,0,0,0,0,0,0,0,23,ENG
4d960fc3,0,0,0,0,0,0,0,0,0,0,0,0,0,1,0,23,ENG
4e015693,16,13,4,8,4,9,19,10,9,1,8,12,28,13,0,23,ENG
4e5a4cbc,12,7,7,3,2,6,10,4,20,14,6,12,24,85,1,23,ENG
4e9a0555,5,4,0,3,2,3,6,3,4,3,1,2,7,9,0,23,ENG
4f28a6ff,38,23,18,15,5,16,34,18,26,11,15,18,56,68,2,23,ENG
4f565d77,6,4,3,3,0,2,10,8,7,3,4,5,11,10,0,23,ENG
4f974391,21,11,12,7,2,12,31,19,21,11,10,27,48,56,0,23,ENG
4fb9c88f,34,17,8,12,14,18,31,13,12,2,10,3,37,9,0,23,ENG
4fd08daa,8,6,3,4,1,5,5,0,8,5,3,6,14,9,0,23,ENG
505486d6,38,23,18,16,4,22,30,8,16,4,12,3,41,26,1,23,ENG
507c7bdf,68,42,24,25,19,30,71,41,37,5,32,25,93,40,1,23,ENG
50dc94ce,0,0,0,0,0,0,1,1,2,1,1,1,1,1,0,23,ENG
50e6dc35,7,1,2,4,1,1,3,2,3,1,2,3,10,18,0,23,ENG
515ebe8d,2,1,0,2,0,2,2,0,0,0,0,2,4,1,0,23,ENG
51a3c4c8,42,23,29,13,0,24,41,17,34,13,21,36,78,90,0,23,ENG
51cf8561,40,18,14,17,9,21,40,19,20,2,18,22,62,38,2,23,ENG
51dbeea9,43,24,25,14,4,21,45,24,16,6,10,34,77,76,1,23,ENG
529f49ab,70,40,20,35,15,25,52,27,26,5,21,28,98,41,1,23,ENG
52afb588,12,8,7,2,3,5,10,5,7,0,7,4,16,6,0,23,ENG
531a4aa8,0,0,0,0,0,0,0,0,1,0,1,0,0,3,0,23,ENG
53552942,0,0,0,0,0,0,0,0,1,0,1,0,0,0,0,23,ENG
53cad200,43,25,23,15,5,22,37,15,26,5,21,19,62,54,1,23,ENG
5515376c,31,20,22,6,3,24,35,11,17,7,10,24,55,56,1,23,ENG
558807c0,5,4,3,1,1,2,5,3,3,1,2,5,10,15,0,23,ENG
56628958,0,0,0,0,0,0,0,0,0,0,0,1,1,0,0,23,ENG
56d838f7,2,2,1,1,0,0,0,0,2,0,2,0,2,0,0,23,ENG
56f7a928,66,39,27,30,9,23,61,38,35,8,27,28,94,24,1,23,ENG
570bb4b9,17,11,5,9,3,6,18,12,9,0,9,2,19,1,0,23,ENG
57c94db2,22,12,19,3,0,16,33,17,14,5,9,9,31,38,0,23,ENG
59878425,0,0,0,0,0,0,0,0,0,0,0,0,0,0,0,23,ENG
59e6e5bf,4,2,1,0,3,1,5,4,5,1,4,3,7,18,0,23,ENG
5a04fd92,25,15,11,7,7,11,27,16,23,1,22,9,34,13,0,23,ENG
5a7301ae,23,11,11,9,3,13,24,11,21,4,17,19,42,16,0,23,ENG
5bc43860,45,18,16,22,7,15,46,31,43,3,40,5,50,6,1,23,ENG
5c0da4a4,33,22,19,11,3,11,32,21,25,4,21,9,42,23,0,23,ENG
5c2b4f07,64,41,41,18,5,23,33,10,34,11,23,29,93,75,0,23,ENG
5c74c0f5,53,29,14,34,5,19,47,28,55,13,42,28,81,21,0,23,ENG
5cbd1eb0,71,49,43,23,5,30,53,23,48,11,37,42,113,78,0,23,ENG
5cc3ce65,4,0,4,0,0,1,1,0,0,0,0,1,5,2,0,23,ENG
5dbefa9d,5,3,0,4,1,2,4,2,6,1,5,0,5,7,0,23,ENG
5ed9b537,38,26,25,13,0,16,27,11,12,5,7,26,64,61,4,23,ENG
5eecec3d,23,13,11,8,4,7,10,3,17,10,7,9,32,40,0,23,ENG
5ff4ab71,45,27,25,17,3,21,56,35,32,2,30,16,61,12,1,23,ENG
60344e4f,18,9,6,6,6,6,16,10,22,6,16,5,23,7,1,23,ENG
6250083a,34,17,18,15,1,16,33,17,17,8,9,17,51,19,1,23,ENG
62d7ef38,0,0,0,0,0,0,0,0,0,0,0,0,0,0,0,23,ENG
6412cc03,6,4,3,0,3,3,5,2,5,0,5,4,10,2,0,23,ENG
6434f10d,67,41,28,28,11,26,53,27,40,14,26,33,100,43,1,23,ENG
65983e4d,0,0,0,0,0,0,0,0,0,0,0,0,0,0,0,23,ENG
65c3efa2,1,1,1,0,0,0,2,2,0,0,0,0,1,1,0,23,ENG
6612cd8c,1,0,1,0,0,0,0,0,1,0,1,0,1,0,0,23,ENG
6613c819,77,37,41,29,7,28,58,30,42,17,25,53,130,71,3,23,ENG
6622454d,20,12,12,5,3,4,9,5,8,0,8,5,25,5,1,23,ENG
6639e500,18,9,3,6,9,8,33,25,21,3,18,6,24,8,0,23,ENG
66b76d44,52,23,20,20,12,21,74,53,20,2,18,20,72,17,0,23,ENG
6722d4f0,0,0,0,0,0,0,0,0,0,0,0,0,0,1,0,23,ENG
67ac5bb8,48,30,29,15,4,18,27,9,49,26,23,32,80,125,3,23,ENG
68c720b5,14,9,6,5,3,3,10,7,15,3,12,5,19,6,0,23,ENG
68db6358,1,1,1,0,0,1,1,0,0,0,0,0,1,0,1,23,ENG
68dc0dac,46,28,22,20,4,19,43,24,40,3,37,27,73,37,0,23,ENG
6992791d,0,0,0,0,0,0,0,0,2,1,1,0,0,0,0,23,ENG
69fdb896,16,9,4,10,2,6,12,6,15,2,13,7,23,6,0,23,ENG
6a713852,1,0,1,0,0,0,0,0,0,0,0,3,4,9,2,23,ENG
6aa3e78b,16,11,9,7,0,6,12,6,8,1,7,6,22,17,1,23,ENG
6ad43f9a,0,0,0,0,0,0,0,0,1,0,1,0,0,1,0,23,ENG
6adbc307,17,13,12,4,1,7,11,4,24,17,7,17,34,55,0,23,ENG
6afaebf2,26,18,5,13,8,8,42,34,24,1,23,13,39,21,0,23,ENG
6b47c5db,61,42,34,24,3,17,43,26,32,14,18,38,99,48,3,23,ENG
6b625ac2,2,1,2,0,0,2,4,2,0,0,0,1,3,30,3,23,ENG
6b6c793c,46,33,33,12,1,14,25,11,13,3,10,25,71,49,0,23,ENG
6c203af0,16,13,6,6,4,2,7,5,15,6,9,12,28,10,0,23,ENG
6ca5ec4b,69,37,37,28,4,33,65,32,41,2,39,25,94,29,0,23,ENG
6d5701f2,15,8,9,6,0,9,11,2,7,4,3,6,21,28,0,23,ENG
6dfd8f05,54,33,23,23,8,28,52,24,24,6,18,20,74,42,0,23,ENG
6e7f1353,2,1,1,1,0,1,1,0,0,0,0,0,2,0,0,23,ENG
6f711f67,2,1,1,1,0,0,1,1,2,0,2,1,3,0,0,23,ENG
6f7d826d,73,42,31,32,10,30,63,33,36,7,29,40,113,27,2,23,ENG
6fe90922,42,24,25,10,7,27,47,20,29,7,22,22,64,49,1,23,ENG
700783e7,8,7,4,4,0,4,9,5,5,3,2,15,23,37,1,23,ENG
7120a04d,14,8,5,7,2,6,21,15,9,0,9,2,16,3,0,23,ENG
71ef519e,1,1,0,1,0,1,3,2,0,0,0,1,2,0,0,23,ENG
72c812f3,97,57,49,35,13,31,60,29,50,12,38,56,153,34,3,23,ENG
7314bba4,0,0,0,0,0,0,0,0,0,0,0,0,0,0,1,23,ENG
73341ace,0,0,0,0,0,0,0,0,2,0,2,0,0,0,0,23,ENG
733f1a7d,3,2,1,2,0,1,1,0,1,0,1,0,3,0,0,23,ENG
74618572,44,27,15,16,13,20,41,21,25,0,25,17,61,10,0,23,ENG
74b2cd7e,11,4,7,4,0,5,10,5,11,7,4,17,28,74,1,23,ENG
758dd7f0,3,2,2,1,0,2,2,0,1,0,1,1,4,1,0,23,ENG
75a72a99,11,7,8,3,0,7,17,10,8,2,6,4,15,20,0,23,ENG
75fdd638,27,17,7,15,5,10,30,20,24,1,23,5,32,7,0,23,ENG
76eca7e2,1,0,1,0,0,1,1,0,0,0,0,0,1,2,0,23,ENG
77cf6852,0,0,0,0,0,0,0,0,0,0,0,0,0,0,0,23,ENG
77d7c96f,83,46,41,29,13,38,50,12,48,17,31,52,135,81,1,23,ENG
77e84962,43,24,20,21,2,14,23,9,15,3,12,21,64,13,2,23,ENG
79300479,36,23,12,14,10,14,47,33,20,5,15,6,42,12,1,23,ENG
7956236f,0,0,0,0,0,0,2,2,0,0,0,1,1,23,1,23,ENG
79c0821a,36,24,16,14,6,14,36,22,10,1,9,19,55,16,0,23,ENG
79c84d1c,39,16,14,11,14,16,58,42,47,9,38,36,75,25,0,23,ENG
7a11550b,28,21,15,11,2,11,19,8,17,11,6,24,52,51,2,23,ENG
7a1f2c08,2,1,2,0,0,0,1,1,2,0,2,0,2,4,0,23,ENG
7a2e46a8,0,0,0,0,0,0,3,3,3,0,3,0,0,20,0,23,ENG
7aa8adfe,5,2,2,0,3,1,11,10,5,0,5,5,10,3,0,23,ENG
7b4de647,0,0,0,0,0,0,0,0,0,0,0,0,0,1,0,23,ENG
7b5ab7f2,3,1,3,0,0,0,3,3,3,0,3,1,4,1,0,23,ENG
7ba2eaa9,11,6,4,2,5,7,17,10,5,1,4,4,15,4,0,23,ENG
7ba6d84e,0,0,0,0,0,0,1,1,0,0,0,1,1,15,3,23,ENG
7f3b388c,65,38,18,40,7,24,62,38,38,11,27,37,102,40,0,23,ENG
7f94982c,0,0,0,0,0,0,0,0,1,0,1,0,0,0,0,23,ENG
7fcc71d8,27,17,13,9,5,6,31,25,19,0,19,7,34,6,0,23,ENG
803ae100,44,27,17,21,6,16,51,35,54,12,42,19,63,36,0,23,ENG
810e3c74,4,4,2,2,0,1,7,6,11,0,11,5,9,4,0,23,ENG
819aa8e7,11,8,5,4,2,8,19,11,6,0,6,2,13,3,0,23,ENG
819b3158,30,18,7,13,10,12,34,22,18,3,15,20,50,13,0,23,ENG
82518f62,78,40,27,46,5,38,65,27,28,4,24,36,114,22,1,23,ENG
828657ff,72,43,24,42,6,30,42,12,25,6,19,37,109,39,0,23,ENG
82927de4,30,15,9,12,9,13,34,21,16,2,14,14,44,9,0,23,ENG
8397a50c,15,7,10,5,0,9,20,11,40,21,19,54,69,163,2,23,ENG
839c14e1,8,5,4,3,1,3,4,1,4,1,3,1,9,6,0,23,ENG
83d074ff,70,39,22,40,8,34,71,37,26,2,24,22,92,10,1,23,ENG
8449d35e,54,27,20,24,10,21,49,28,29,9,20,29,83,26,0,23,ENG
85322440,0,0,0,0,0,0,0,0,0,0,0,0,0,1,0,23,ENG
862a1c15,46,30,16,19,11,18,42,24,25,2,23,10,56,17,0,23,ENG
86695068,12,9,5,6,1,6,11,5,12,2,10,5,17,6,0,23,ENG
86dd77d1,13,9,8,5,0,4,24,20,12,2,10,18,31,22,0,23,ENG
86e7deaf,41,27,24,17,0,21,31,10,38,29,9,34,75,111,3,23,ENG
8790f988,10,5,1,3,6,2,2,0,3,0,3,4,14,5,0,23,ENG
87966294,0,0,0,0,0,0,0,0,0,0,0,0,0,0,0,23,ENG
886f9aac,20,12,12,6,2,9,16,7,8,0,8,5,25,3,0,23,ENG
88968486,4,2,4,0,0,3,7,4,7,2,5,3,7,14,0,23,ENG
892d5bb1,30,14,8,13,9,13,39,26,27,1,26,9,39,5,0,23,ENG
89ac64a6,36,25,15,18,3,23,36,13,27,9,18,16,52,33,1,23,ENG
8a3c1dc7,57,31,20,28,9,22,41,19,29,8,21,30,87,84,1,23,ENG
8a7ff278,50,36,30,11,9,30,41,11,32,16,16,25,75,80,1,23,ENG
8aafd64f,14,7,5,6,3,4,12,8,3,0,3,1,15,1,1,23,ENG
8aec0537,59,38,23,27,9,25,55,30,32,10,22,13,72,21,1,23,ENG
8b04d6c1,56,30,28,22,6,26,67,41,46,17,29,49,105,64,1,23,ENG
8b529245,4,1,0,2,2,0,4,4,7,0,7,0,4,10,0,23,ENG
8b57ad2c,29,13,14,14,1,13,23,10,12,3,9,4,33,11,0,23,ENG
8b788c01,5,3,0,2,3,1,4,3,11,2,9,1,6,4,0,23,ENG
8b9ebd03,13,8,8,3,2,7,25,18,13,0,13,9,22,9,0,23,ENG
8c3078cd,0,0,0,0,0,0,0,0,0,0,0,0,0,0,0,23,ENG
8d3c902d,29,21,18,8,3,9,13,4,14,2,12,10,39,24,0,23,ENG
8df7a2fb,45,24,28,13,4,20,37,17,54,42,12,48,93,122,2,23,ENG
8e16dd48,21,14,8,9,4,11,18,7,11,1,10,8,29,2,0,23,ENG
8e92be30,18,8,4,7,7,10,28,18,21,2,19,4,22,8,0,23,ENG
8f62b6ee,1,1,1,0,0,1,3,2,0,0,0,1,2,13,5,23,ENG
903b6e8b,1,0,1,0,0,1,1,0,0,0,0,0,1,10,6,23,ENG
90f91999,66,36,27,29,10,34,71,37,43,4,39,24,90,19,0,23,ENG
9228b07c,15,9,5,9,1,7,14,7,10,1,9,4,19,7,1,23,ENG
92868cb5,1,1,1,0,0,0,0,0,0,0,0,0,1,0,0,23,ENG
92e7e919,24,12,7,8,9,9,30,21,23,2,21,13,37,6,0,23,ENG
9319781b,20,14,12,4,4,12,18,6,12,4,8,9,29,28,1,23,ENG
9328b835,2,0,2,0,0,1,2,1,1,0,1,0,2,10,1,23,ENG
935e6b8f,32,23,10,18,4,15,36,21,21,3,18,21,53,16,1,23,ENG
93feac6e,9,6,0,6,3,4,20,16,12,5,7,5,14,13,0,23,ENG
94f8d10c,14,10,9,4,1,6,9,3,15,11,4,15,29,65,1,23,ENG
963a9201,18,13,12,6,0,5,8,3,3,0,3,3,21,9,0,23,ENG
966e28d0,8,8,3,3,2,3,6,3,6,0,6,6,14,0,0,23,ENG
9674002f,33,19,6,16,11,14,27,13,24,6,18,8,41,9,0,23,ENG
97220da2,4,1,0,3,1,1,1,0,10,1,9,1,5,1,0,23,ENG
972aeb2a,34,20,23,9,2,15,18,3,13,10,3,19,53,85,4,23,ENG
97333cf5,32,21,15,13,4,14,39,25,18,0,18,10,42,9,2,23,ENG
9744ff80,12,6,4,5,3,6,15,9,7,0,7,2,14,4,0,23,ENG
980522ec,22,18,10,7,5,10,32,22,23,9,14,11,33,20,1,23,ENG
984a5a64,61,32,34,24,3,22,43,21,47,8,39,27,88,52,0,23,ENG
98d2c2c4,43,23,23,15,5,19,43,24,36,9,27,29,72,45,0,23,ENG
98ea5115,0,0,0,0,0,0,2,2,1,0,1,1,1,10,3,23,ENG
99127249,22,9,9,9,4,8,28,20,18,0,18,11,33,6,0,23,ENG
99813635,9,4,6,2,1,0,7,7,6,0,6,2,11,1,0,23,ENG
999ceb5f,12,5,4,5,3,3,7,4,4,2,2,7,19,1,0,23,ENG
9a28eba4,14,7,7,4,3,4,9,5,8,1,7,3,17,17,0,23,ENG
9b398aea,33,20,25,7,1,9,15,6,3,0,3,9,42,28,0,23,ENG
9b5ce51a,50,30,23,23,4,20,45,25,32,15,17,47,97,91,2,23,ENG
9b6f7fd5,71,53,23,36,12,27,67,40,41,4,37,16,87,31,0,23,ENG
9bc9a519,0,0,0,0,0,0,0,0,0,0,0,0,0,0,0,23,ENG
9c221d14,56,33,28,26,2,28,44,16,53,37,16,41,97,113,2,23,ENG
9c94165b,55,36,31,22,2,32,45,13,51,17,34,36,91,55,2,23,ENG
9cfbad36,13,4,3,6,4,8,13,5,9,0,9,4,17,2,0,23,ENG
9d8cf204,0,0,0,0,0,0,1,1,0,0,0,0,0,0,0,23,ENG
9e525177,40,25,20,17,3,23,25,2,24,8,16,22,62,41,0,23,ENG
9e5708be,0,0,0,0,0,0,0,0,0,0,0,0,0,5,0,23,ENG
9eedf0e0,0,0,0,0,0,0,1,1,0,0,0,0,0,0,0,23,ENG
9f1938ab,12,9,5,7,0,7,17,10,9,1,8,4,16,2,0,23,ENG
9f7c837d,20,11,13,5,2,11,29,18,12,6,6,8,28,33,1,23,ENG
9f8e9423,24,9,18,6,0,7,17,10,24,17,7,11,35,91,0,23,ENG
9fec8860,1,1,1,0,0,0,0,0,0,0,0,0,1,1,0,23,ENG
a0666d3e,29,16,11,16,2,11,20,9,16,7,9,16,45,9,0,23,ENG
a105d46a,17,8,10,4,3,10,14,4,16,8,8,10,27,33,0,23,ENG
a190d597,3,1,3,0,0,2,9,7,6,1,5,2,5,17,0,23,ENG
a1d5bd30,20,10,7,8,5,9,24,15,31,4,27,7,27,14,0,23,ENG
a2081c6b,0,0,0,0,0,0,0,0,0,0,0,0,0,2,0,23,ENG
a2b105e0,42,21,16,20,6,20,52,32,35,8,27,16,58,23,0,23,ENG
a39d11bc,37,17,28,9,0,15,20,5,29,12,17,44,81,110,0,23,ENG
a3b03921,51,30,13,26,12,25,58,33,54,8,46,25,76,17,0,23,ENG
a3d94a58,68,36,42,24,2,29,46,17,40,18,22,44,112,102,3,23,ENG
a4ac4b8f,13,6,8,3,2,8,13,5,13,4,9,12,25,45,0,23,ENG
a5212312,53,25,39,12,2,25,35,10,33,23,10,26,79,111,1,23,ENG
a53649b7,13,9,6,2,5,2,10,8,7,1,6,1,14,7,0,23,ENG
a572e291,28,20,16,10,2,12,29,17,21,7,14,23,51,15,0,23,ENG
a5ca9127,0,0,0,0,0,0,0,0,0,0,0,0,0,0,0,23,ENG
a62f8bf1,15,9,4,7,4,4,14,10,16,0,16,6,21,6,0,23,ENG
a6b461e7,7,3,3,3,1,1,3,2,4,0,4,2,9,6,0,23,ENG
a6c58494,3,2,3,0,0,1,3,2,2,0,2,0,3,0,0,23,ENG
a712ca2b,28,19,18,9,1,17,32,15,24,17,7,35,63,86,0,23,ENG
a78ff07f,148,83,59,65,24,71,135,64,48,5,43,46,194,61,2,23,ENG
a816dbfb,18,7,7,9,2,6,25,19,26,6,20,9,27,19,0,23,ENG
a8748947,17,6,4,8,5,7,10,3,18,3,15,5,22,3,0,23,ENG
a8c0acb7,11,8,5,4,2,9,16,7,6,5,1,7,18,22,0,23,ENG
a8c19eb8,27,15,19,8,0,15,24,9,35,28,7,21,48,84,0,23,ENG
a9dc785c,3,1,3,0,0,3,3,0,0,0,0,0,3,10,3,23,ENG
aa849a12,41,17,5,15,21,12,52,40,47,2,45,22,63,25,0,23,ENG
ab13a5aa,0,0,0,0,0,0,0,0,0,0,0,0,0,9,1,23,ENG
ab651565,0,0,0,0,0,0,0,0,0,0,0,0,0,0,0,23,ENG
ac05f970,14,7,1,8,5,3,12,9,13,5,8,5,19,9,0,23,ENG
ac0d576d,6,3,4,1,1,2,5,3,2,0,2,1,7,0,0,23,ENG
ac7e7b1c,1,1,0,1,0,0,0,0,0,0,0,0,1,3,0,23,ENG
ac861941,30,19,16,12,2,9,19,10,41,24,17,35,65,112,2,23,ENG
ae4fc6a4,42,24,17,18,7,18,38,20,22,0,22,13,55,10,0,23,ENG
ae59b359,57,34,29,26,2,23,43,20,15,4,11,33,90,27,1,23,ENG
aed3a70f,19,13,3,13,3,10,27,17,21,4,17,10,29,39,0,23,ENG
afed6722,2,1,2,0,0,0,0,0,0,0,0,2,4,3,0,23,ENG
b017b770,5,0,1,3,1,1,4,3,5,2,3,0,5,7,0,23,ENG
b0b4fd3e,25,16,10,12,3,13,23,10,17,3,14,7,32,9,0,23,ENG
b217ef29,14,8,12,2,0,11,23,12,8,3,5,21,35,45,3,23,ENG
b2626673,0,0,0,0,0,0,2,2,4,1,3,1,1,1,0,23,ENG
b2856bc0,0,0,0,0,0,0,0,0,0,0,0,0,0,0,0,23,ENG
b2bc3b1f,32,20,12,12,8,8,21,13,21,1,20,16,48,9,0,23,ENG
b2d31e83,60,38,29,23,8,34,67,33,42,16,26,32,92,120,2,23,ENG
b2f9c73e,13,7,7,6,0,3,5,2,7,0,7,6,19,1,0,23,ENG
b318a643,0,0,0,0,0,0,0,0,1,1,0,0,0,0,0,23,ENG
b3af9be1,27,18,12,10,5,13,18,5,7,0,7,14,41,15,1,23,ENG
b400bde0,18,10,5,4,9,8,14,6,17,0,17,2,20,5,0,23,ENG
b4a014b1,1,0,0,1,0,0,1,1,2,2,0,1,2,2,0,23,ENG
b561db50,9,6,3,5,1,3,6,3,9,0,9,0,9,8,0,23,ENG
b57e066e,16,9,9,5,2,6,11,5,8,4,4,6,22,13,1,23,ENG
b5bf1770,24,16,15,9,0,12,18,6,30,25,5,20,44,65,2,23,ENG
b66315ae,33,25,16,8,9,15,31,16,27,3,24,11,44,15,1,23,ENG
b827d5b3,4,1,0,2,2,1,8,7,6,2,4,1,5,5,0,23,ENG
b853e0ad,47,30,24,20,3,15,38,23,38,2,36,19,66,19,0,23,ENG
b937e490,2,2,1,1,0,1,2,1,0,0,0,0,2,1,0,23,ENG
b9403c99,0,0,0,0,0,0,1,1,1,1,0,0,0,0,0,23,ENG
b9e1436c,27,18,6,12,9,9,36,27,26,1,25,15,42,8,0,23,ENG
b9fbae28,16,10,4,10,2,4,8,4,11,0,11,6,22,2,0,23,ENG
bac46a10,54,28,33,18,3,30,43,13,51,27,24,33,87,103,0,23,ENG
bb5fbd2b,53,31,16,17,20,8,28,20,34,3,31,24,77,32,0,23,ENG
bba30585,13,10,8,5,0,4,8,4,6,2,4,15,28,24,2,23,ENG
bc7dc64d,63,34,22,15,26,20,44,24,38,0,38,14,77,19,0,23,ENG
bc914523,4,1,2,2,0,0,0,0,0,0,0,0,4,0,0,23,ENG
bd6351cd,29,21,16,9,4,17,24,7,7,1,6,19,48,9,1,23,ENG
bd8a5d95,5,2,1,3,1,3,4,1,5,0,5,0,5,2,1,23,ENG
bd9553e6,0,0,0,0,0,0,0,0,0,0,0,1,1,0,0,23,ENG
be927d03,50,27,34,15,1,37,49,12,25,11,14,21,71,65,0,23,ENG
beb391dd,7,3,5,0,2,4,6,2,6,0,6,2,9,3,0,23,ENG
bf34eebd,12,8,5,4,3,6,13,7,13,2,11,4,16,7,0,23,ENG
bfc3b3a0,33,16,23,6,4,17,33,16,14,1,13,10,43,36,0,23,ENG
c067631c,3,2,2,0,1,1,4,3,7,2,5,1,4,27,0,23,ENG
c06d1086,3,2,1,1,1,1,3,2,4,1,3,0,3,4,0,23,ENG
c07b7c5c,5,3,4,1,0,3,4,1,3,1,2,6,11,11,0,23,ENG
c1242d4e,0,0,0,0,0,0,0,0,0,0,0,0,0,0,0,23,ENG
c17bfb65,70,49,36,26,8,26,62,36,52,7,45,48,118,39,0,23,ENG
c1fe2a48,38,19,19,16,3,14,22,8,26,8,18,10,48,44,0,23,ENG
c2731c10,46,33,17,19,10,10,37,27,41,10,31,23,69,18,1,23,ENG
c3e39f12,1,0,1,0,0,0,0,0,1,0,1,0,1,3,1,23,ENG
c40b6180,22,12,10,9,3,11,19,8,30,19,11,19,41,55,4,23,ENG
c4486bac,58,34,28,26,4,25,60,35,46,1,45,26,84,17,0,23,ENG
c4720845,0,0,0,0,0,0,0,0,1,0,1,0,0,0,0,23,ENG
c47541e0,1,1,1,0,0,1,4,3,5,0,5,2,3,0,0,23,ENG
c4e87b8b,11,5,6,1,4,2,9,7,7,2,5,7,18,9,0,23,ENG
c596fcb0,9,3,0,8,1,0,3,3,8,0,8,1,10,5,0,23,ENG
c5b7c315,7,4,5,2,0,5,8,3,12,7,5,14,21,55,1,23,ENG
c5bdb6e3,4,1,2,1,1,2,4,2,3,0,3,0,4,4,0,23,ENG
c6220452,0,0,0,0,0,0,0,0,1,1,0,0,0,0,0,23,ENG
c64c01fc,10,9,5,3,2,5,8,3,5,0,5,3,13,3,0,23,ENG
c6dc9ecd,21,13,9,9,3,8,18,10,17,2,15,6,27,14,0,23,ENG
c6e8cf1f,8,3,1,4,3,3,7,4,6,2,4,5,13,3,0,23,ENG
c81d773d,30,13,22,6,2,16,23,7,20,15,5,26,56,140,1,23,ENG
c8aa95da,47,22,31,13,3,24,39,15,34,19,15,52,99,139,0,23,ENG
c91441dc,1,0,1,0,0,1,1,0,0,0,0,1,2,24,2,23,ENG
c92e1a31,7,2,0,3,4,3,10,7,9,1,8,0,7,8,0,23,ENG
c931d9f9,16,8,5,8,3,7,15,8,9,1,8,3,19,7,0,23,ENG
ca45605e,14,8,6,8,0,3,12,9,14,2,12,7,21,7,0,23,ENG
cc77354e,58,25,25,23,10,27,56,29,38,12,26,19,77,24,3,23,ENG
ccce7025,38,24,31,7,0,22,28,6,44,24,20,34,72,126,2,23,ENG
cd1acf9d,57,40,32,16,9,42,79,37,25,7,18,43,100,41,2,23,ENG
cda0b317,0,0,0,0,0,0,1,1,0,0,0,0,0,2,1,23,ENG
ce4246f5,9,4,4,5,0,5,8,3,17,14,3,30,39,120,1,23,ENG
ce4f40c7,77,46,40,33,4,29,52,23,47,13,34,56,133,48,0,23,ENG
ce5143da,15,7,0,7,8,4,11,7,24,2,22,5,20,20,0,23,ENG
cea4ee8f,0,0,0,0,0,0,0,0,0,0,0,0,0,0,0,23,ENG
cee31595,1,1,1,0,0,1,1,0,2,1,1,1,2,2,0,23,ENG
cf7fb13a,7,6,6,1,0,5,5,0,2,0,2,3,10,4,0,23,ENG
d0042ab9,11,7,8,3,0,3,11,8,7,3,4,7,18,28,0,23,ENG
d00d45ab,0,0,0,0,0,0,0,0,0,0,0,0,0,0,0,23,ENG
d04b94db,71,42,48,19,4,33,64,31,42,15,27,29,100,83,2,23,ENG
d0706b27,52,27,39,11,2,26,42,16,45,24,21,45,97,134,3,23,ENG
d0f72bf1,36,20,26,9,1,16,30,14,70,42,28,19,55,164,1,23,ENG
d2424d1b,21,17,12,8,1,13,25,12,21,2,19,18,39,26,0,23,ENG
d328a254,63,36,21,33,9,11,40,29,48,8,40,31,94,58,1,23,ENG
d38fdf53,61,31,36,19,6,35,60,25,30,8,22,37,98,37,1,23,ENG
d3ce0e89,1,1,1,0,0,1,3,2,0,0,0,0,1,14,2,23,ENG
d557d734,16,10,12,3,1,8,10,2,11,6,5,8,24,14,1,23,ENG
d56543a0,2,2,0,0,2,2,5,3,3,1,2,0,2,3,0,23,ENG
d5dd5f1f,1,0,1,0,0,0,1,1,2,0,2,2,3,4,2,23,ENG
d79a8c87,8,5,4,4,0,3,6,3,6,5,1,3,11,27,1,23,ENG
d8931174,8,6,6,1,1,4,5,1,18,11,7,13,21,41,0,23,ENG
d93c2511,32,19,16,10,6,13,22,9,15,6,9,14,46,45,1,23,ENG
d9565625,54,41,40,13,1,33,45,12,25,7,18,37,91,55,2,23,ENG
da011f18,23,12,19,4,0,15,22,7,8,0,8,11,34,11,1,23,ENG
da052c14,66,41,23,20,23,21,53,32,35,4,31,15,81,31,0,23,ENG
da27e268,66,40,27,34,5,20,65,45,34,10,24,23,89,24,2,23,ENG
da7b447d,24,11,17,6,1,14,20,6,16,10,6,12,36,41,0,23,ENG
da974c7b,45,31,34,8,3,26,40,14,30,13,17,29,74,77,0,23,ENG
dad4b285,62,32,44,14,4,37,57,20,27,8,19,19,81,51,0,23,ENG
dbf053da,16,10,7,5,4,8,28,20,25,2,23,7,23,6,0,23,ENG
dc3e663e,7,5,6,1,0,5,8,3,5,3,2,6,13,10,0,23,ENG
dc4cae05,1,0,1,0,0,0,1,1,2,0,2,2,3,5,0,23,ENG
dc62b55d,7,4,0,5,2,2,10,8,15,3,12,9,16,11,0,23,ENG
dc64b8b3,38,23,27,9,2,23,36,13,16,8,8,34,72,57,3,23,ENG
dc6f5bdd,9,6,7,2,0,6,8,2,5,4,1,7,16,10,1,23,ENG
dc7f8a28,5,1,0,3,2,3,5,2,2,1,1,1,6,2,0,23,ENG
dd323728,72,47,49,17,6,38,71,33,33,8,25,33,105,48,0,23,ENG
dd549382,7,4,2,2,3,2,8,6,4,1,3,0,7,1,0,23,ENG
de112b84,15,7,3,8,4,8,20,12,17,0,17,7,22,3,0,23,ENG
de31038e,11,5,5,3,3,6,12,6,11,2,9,6,17,2,0,23,ENG
de40e38c,2,1,2,0,0,1,1,0,0,0,0,1,3,0,0,23,ENG
dea698d9,2,2,1,0,1,1,2,1,0,0,0,1,3,9,0,23,ENG
df04eb4b,30,20,14,14,2,11,23,12,20,2,18,13,43,11,0,23,ENG
df0a4c90,52,30,21,29,2,18,48,30,32,9,23,34,86,41,2,23,ENG
df10e27c,5,2,2,2,1,2,8,6,5,2,3,6,11,5,0,23,ENG
df3cda47,38,15,23,7,8,16,44,28,19,0,19,13,51,7,0,23,ENG
df8b52a5,54,33,38,12,4,27,40,13,17,3,14,18,72,75,0,23,ENG
e06683ca,27,14,13,11,3,8,19,11,24,16,8,31,58,138,3,23,ENG
e09f279b,23,13,4,9,10,7,23,16,24,9,15,14,37,36,0,23,ENG
e0bc6fdc,26,14,9,15,2,12,24,12,17,4,13,15,41,36,0,23,ENG
e0d1510a,5,4,0,4,1,2,3,1,0,0,0,1,6,1,0,23,ENG
e280527c,12,8,3,8,1,2,11,9,6,2,4,8,20,11,0,23,ENG
e28868f3,34,15,23,10,1,18,37,19,26,5,21,14,48,28,2,23,ENG
e342ad68,21,12,4,5,12,10,26,16,21,0,21,6,27,4,0,23,ENG
e34fc66d,42,22,30,12,0,16,32,16,28,13,15,24,66,188,1,23,ENG
e3a5814e,45,24,23,18,4,28,44,16,28,7,21,22,67,45,1,23,ENG
e4238fb1,30,17,15,9,6,8,24,16,30,3,27,10,40,19,0,23,ENG
e46012d4,28,12,3,12,13,14,39,25,27,2,25,9,37,10,0,23,ENG
e514ab62,13,10,8,3,2,9,24,15,8,3,5,9,22,16,0,23,ENG
e541326e,52,28,33,12,7,18,24,6,41,31,10,35,87,215,2,23,ENG
e5478b87,17,10,2,10,5,6,10,4,18,4,14,4,21,20,0,23,ENG
e5a76dfe,0,0,0,0,0,0,0,0,0,0,0,0,0,12,1,23,ENG
e61b8aee,34,27,11,18,5,16,41,25,28,10,18,15,49,45,1,23,ENG
e6af02e0,67,43,36,22,9,28,61,33,35,4,31,16,83,35,2,23,ENG
e6bc67d7,8,6,4,3,1,5,8,3,4,0,4,1,9,2,0,23,ENG
e77dc3b2,15,9,8,3,4,5,22,17,26,7,19,6,21,46,0,23,ENG
e7ca0439,4,2,2,1,1,1,3,2,3,2,1,5,9,19,0,23,ENG
e7ee38c3,0,0,0,0,0,0,2,2,0,0,0,0,0,1,0,23,ENG
e8271ad9,39,24,24,14,1,23,43,20,31,9,22,16,55,32,0,23,ENG
e82900ef,3,1,1,1,1,1,1,0,1,0,1,0,3,0,0,23,ENG
e97fd090,25,14,8,14,3,12,22,10,15,2,13,12,37,23,0,23,ENG
e98211e7,1,0,1,0,0,0,0,0,0,0,0,0,1,0,0,23,ENG
e9971f2d,3,2,3,0,0,1,5,4,1,0,1,2,5,8,0,23,ENG
ea6bc03a,53,30,32,16,5,24,56,32,44,21,23,43,96,152,1,23,ENG
eaeca114,26,12,15,9,2,11,15,4,20,10,10,20,46,48,0,23,ENG
ecad9aa5,60,35,27,29,4,21,53,32,47,11,36,33,93,23,1,23,ENG
ecada4fc,0,0,0,0,0,0,0,0,0,0,0,1,1,11,2,23,ENG
ed1e53f3,16,10,9,5,2,8,19,11,25,2,23,5,21,12,0,23,ENG
ed8d597c,0,0,0,0,0,0,0,0,0,0,0,1,1,0,0,23,ENG
ed9f7cfe,52,39,38,8,6,33,66,33,25,6,19,33,85,74,0,23,ENG
ee38d9c5,51,26,25,19,7,19,50,31,19,1,18,13,64,6,1,23,ENG
ee950928,1,1,1,0,0,0,0,0,0,0,0,0,1,0,0,23,ENG
efb9215a,0,0,0,0,0,0,0,0,0,0,0,0,0,0,0,23,ENG
efd2ec23,1,0,0,0,1,1,6,5,10,1,9,2,3,4,0,23,ENG
f08490a6,2,0,1,1,0,0,0,0,1,0,1,0,2,0,0,23,ENG
f0caab96,15,9,11,4,0,9,13,4,16,8,8,11,26,51,0,23,ENG
f173303a,2,2,1,1,0,0,4,4,1,0,1,0,2,0,0,23,ENG
f25c8e3a,5,4,2,3,0,1,4,3,1,0,1,2,7,3,0,23,ENG
f2bf1b0f,17,13,7,8,2,7,12,5,13,4,9,4,21,22,0,23,ENG
f315ca93,14,9,10,2,2,10,16,6,8,1,7,12,26,15,0,23,ENG
f31def1e,33,18,23,9,1,13,19,6,26,15,11,26,59,101,1,23,ENG
f3354c07,15,7,7,8,0,8,21,13,10,2,8,1,16,1,0,23,ENG
f4d296e4,84,57,43,31,10,49,75,26,32,12,20,32,116,70,1,23,ENG
f4e433d4,11,6,6,4,1,5,7,2,7,3,4,7,18,2,0,23,ENG
f5a00fa4,51,30,24,21,6,19,46,27,22,6,16,18,69,20,0,23,ENG
f5deef4c,22,17,10,9,3,9,17,8,18,9,9,21,43,63,1,23,ENG
f7b1d4e0,2,1,0,1,1,1,3,2,5,1,4,4,6,2,0,23,ENG
f8fcd2a5,13,5,12,1,0,7,11,4,15,11,4,18,31,51,0,23,ENG
fa031b34,21,16,13,5,3,12,27,15,14,1,13,5,26,10,0,23,ENG
fa9fa773,1,1,1,0,0,0,1,1,2,0,2,0,1,0,0,23,ENG
fb614c44,20,18,7,12,1,9,14,5,24,6,18,15,35,47,0,23,ENG
fc027d02,23,19,15,5,3,15,32,17,20,4,16,27,50,35,0,23,ENG
fc15fb84,64,41,35,14,15,27,62,35,46,7,39,31,95,41,0,23,ENG
fce2302c,20,11,9,9,2,12,16,4,8,2,6,11,31,25,0,23,ENG
fdf3cb77,58,31,37,15,6,36,51,15,24,6,18,38,96,70,0,23,ENG
fe558029,0,0,0,0,0,0,0,0,1,0,1,0,0,6,0,23,ENG
feb5d972,7,6,4,2,1,4,8,4,3,2,1,6,13,6,0,23,ENG
fed7cb61,34,16,4,20,10,10,30,20,28,0,28,7,41,41,0,23,ENG
fed96827,45,22,37,8,0,19,30,11,40,27,13,30,75,152,0,23,ENG
0076ab7f,23,16,14,8,1,12,17,5,9,7,2,8,31,31,0,23,EL
00844823,1,1,1,0,0,1,2,1,3,3,0,3,4,2,0,23,EL
009a4f60,13,7,3,9,1,5,9,4,8,0,8,2,15,8,0,23,EL
00b86f5e,1,0,1,0,0,1,1,0,0,0,0,0,1,3,0,23,EL
00c9a283,4,4,0,4,0,1,2,1,5,0,5,1,5,6,1,23,EL
01b8a2b2,0,0,0,0,0,0,0,0,0,0,0,0,0,4,0,23,EL
02b952ce,3,1,3,0,0,2,4,2,2,2,0,0,3,8,0,23,EL
02caf6e0,3,3,2,1,0,3,4,1,0,0,0,1,4,2,0,23,EL
031ebd52,0,0,0,0,0,0,0,0,0,0,0,2,2,2,0,23,EL
0362c29e,7,4,6,1,0,3,3,0,6,3,3,1,8,18,1,23,EL
03998238,2,2,2,0,0,2,3,1,0,0,0,0,2,1,0,23,EL
03b6afa9,10,5,6,3,1,5,6,1,3,1,2,5,15,2,1,23,EL
03e7a498,2,2,1,1,0,2,2,0,1,0,1,0,2,1,0,23,EL
0412b9cd,0,0,0,0,0,0,0,0,0,0,0,0,0,2,0,23,EL
04964f4f,0,0,0,0,0,0,3,3,2,0,2,1,1,0,0,23,EL
049751d7,4,3,3,1,0,1,6,5,2,0,2,4,8,1,0,23,EL
04e17fd5,10,3,1,6,3,2,6,4,1,0,1,0,10,8,0,23,EL
04f661ea,0,0,0,0,0,0,1,1,0,0,0,1,1,1,0,23,EL
056d2d95,12,8,5,5,2,5,12,7,3,0,3,9,21,13,1,23,EL
05e19d6a,3,3,1,1,1,0,0,0,2,0,2,0,3,0,0,23,EL
0670ee51,2,0,2,0,0,1,2,1,4,1,3,4,6,11,0,23,EL
0683f364,9,7,5,3,1,4,7,3,10,2,8,7,16,2,0,23,EL
068f4dec,6,4,2,2,2,3,8,5,0,0,0,2,8,2,0,23,EL
06df8256,8,6,6,2,0,5,7,2,2,1,1,8,16,15,0,23,EL
06e5b0e4,5,2,4,1,0,3,6,3,1,0,1,4,9,10,0,23,EL
072e68ed,0,0,0,0,0,0,1,1,0,0,0,0,0,4,0,23,EL
08452314,7,7,2,2,3,4,14,10,12,1,11,5,12,5,0,23,EL
086d7db3,1,1,0,0,1,0,0,0,0,0,0,0,1,1,0,23,EL
0880e10b,0,0,0,0,0,0,0,0,0,0,0,0,0,1,0,23,EL
089c7323,4,0,1,1,2,2,5,3,1,1,0,4,8,3,0,23,EL
08eb3b58,5,4,3,2,0,3,4,1,2,0,2,5,10,4,0,23,EL
0959184b,3,2,2,1,0,2,6,4,2,0,2,2,5,2,0,23,EL
095ec83c,4,3,2,2,0,1,2,1,4,1,3,0,4,1,0,23,EL
0a084b35,6,4,4,2,0,2,2,0,3,0,3,4,10,4,0,23,EL
0ab1f153,14,10,9,4,1,8,11,3,3,1,2,7,21,10,0,23,EL
0afff3b7,4,4,3,0,1,1,6,5,2,0,2,2,6,3,1,23,EL
0b243559,1,1,1,0,0,0,0,0,3,1,2,0,1,1,0,23,EL
0b4f388a,4,2,0,2,2,2,4,2,2,0,2,0,4,0,0,23,EL
0ba976e4,0,0,0,0,0,0,0,0,0,0,0,0,0,0,0,23,EL
0bfca6a1,6,4,2,2,2,3,9,6,2,1,1,6,12,6,0,23,EL
0c09c984,3,3,2,0,1,3,6,3,2,1,1,2,5,7,0,23,EL
0c3f7197,7,4,0,4,3,2,6,4,3,0,3,1,8,0,0,23,EL
0c7a48f8,24,16,12,10,2,7,11,4,11,4,7,15,39,20,0,23,EL
0caa2fd4,6,3,2,3,1,3,4,1,5,0,5,2,8,0,0,23,EL
0d82903c,10,8,4,5,1,5,10,5,4,2,2,5,15,18,1,23,EL
0d9b2d31,0,0,0,0,0,0,0,0,0,0,0,0,0,0,0,23,EL
0da5076f,5,4,3,2,0,1,4,3,4,0,4,7,12,2,0,23,EL
0e46fa2f,1,1,0,1,0,0,1,1,2,0,2,1,2,2,0,23,EL
0e7ccfc4,6,4,3,2,1,3,9,6,5,1,4,7,13,11,0,23,EL
0eb83e1a,2,1,0,2,0,0,1,1,0,0,0,0,2,0,0,23,EL
0ed60738,13,10,7,5,1,10,22,12,12,2,10,7,20,6,1,23,EL
0f6e3474,8,4,4,3,1,1,4,3,7,6,1,4,12,15,0,23,EL
0f816ae5,0,0,0,0,0,0,0,0,0,0,0,0,0,0,0,23,EL
10072610,0,0,0,0,0,0,0,0,1,0,1,1,1,0,0,23,EL
10161491,0,0,0,0,0,0,1,1,0,0,0,0,0,0,0,23,EL
10549b49,6,4,3,2,1,1,4,3,4,0,4,0,6,2,0,23,EL
108fe016,2,2,1,1,0,0,1,1,3,2,1,0,2,0,0,23,EL
10f1cd17,1,0,1,0,0,1,4,3,3,0,3,4,5,13,0,23,EL
114bbdee,13,6,9,4,0,8,13,5,9,7,2,6,19,22,0,23,EL
11c0fa9d,3,2,0,1,2,1,4,3,0,0,0,0,3,1,0,23,EL
12dcbdcc,8,5,7,0,1,5,18,13,9,1,8,6,14,6,1,23,EL
13203c45,2,2,2,0,0,1,1,0,1,0,1,2,4,0,0,23,EL
133faa84,0,0,0,0,0,0,3,3,3,2,1,1,1,2,0,23,EL
136958ad,0,0,0,0,0,0,1,1,1,1,0,0,0,2,0,23,EL
13c8e5f6,2,2,1,1,0,1,3,2,1,0,1,2,4,1,0,23,EL
13ea2544,5,3,0,5,0,3,5,2,2,0,2,2,7,1,0,23,EL
13fe7b69,3,1,2,1,0,2,3,1,1,0,1,0,3,0,0,23,EL
1443ca7d,3,3,3,0,0,3,4,1,1,1,0,2,5,2,0,23,EL
1469d291,1,1,1,0,0,1,1,0,0,0,0,0,1,0,0,23,EL
149895bf,0,0,0,0,0,0,0,0,2,0,2,0,0,0,0,23,EL
14a04bea,3,2,2,1,0,3,3,0,5,1,4,1,4,2,0,23,EL
15317e60,0,0,0,0,0,0,0,0,0,0,0,0,0,0,0,23,EL
1581e8db,5,4,1,4,0,2,4,2,2,0,2,1,6,4,0,23,EL
15944afd,0,0,0,0,0,0,2,2,3,0,3,2,2,1,0,23,EL
15d0c248,3,2,1,2,0,2,4,2,14,6,8,9,12,23,0,23,EL
15f3ec41,0,0,0,0,0,0,0,0,0,0,0,0,0,0,0,23,EL
15fd5593,1,1,0,1,0,0,1,1,1,0,1,1,2,0,0,23,EL
16322a52,5,2,1,2,2,1,4,3,3,1,2,1,6,5,0,23,EL
16657b95,39,22,15,22,2,15,36,21,23,5,18,18,57,26,0,23,EL
16839b27,2,0,0,2,0,0,1,1,2,0,2,1,3,1,0,23,EL
16aa3654,4,1,2,0,2,3,5,2,6,0,6,0,4,0,0,23,EL
16e9d0ea,4,4,2,1,1,4,6,2,2,0,2,1,5,3,0,23,EL
16ea3bb1,10,9,8,2,0,5,5,0,2,1,1,4,14,9,0,23,EL
1707d9c6,0,0,0,0,0,0,0,0,1,0,1,0,0,0,0,23,EL
17370b95,2,2,1,1,0,2,2,0,3,1,2,1,3,2,0,23,EL
173eb3cd,15,8,5,8,2,4,12,8,13,7,6,9,24,14,1,23,EL
17695062,0,0,0,0,0,0,1,1,0,0,0,0,0,0,0,23,EL
1774c547,0,0,0,0,0,0,1,1,0,0,0,0,0,0,0,23,EL
17e3e467,3,3,2,1,0,2,2,0,1,0,1,1,4,2,0,23,EL
184ad240,3,1,2,1,0,1,4,3,2,0,2,0,3,0,0,23,EL
184ea16a,1,0,1,0,0,0,0,0,0,0,0,0,1,0,0,23,EL
185a2732,4,3,2,2,0,1,1,0,0,0,0,5,9,4,0,23,EL
18dd3219,6,3,4,2,0,4,4,0,7,4,3,2,8,24,0,23,EL
18fae4ac,12,5,8,4,0,8,14,6,10,1,9,5,17,10,0,23,EL
1971591f,4,2,2,1,1,3,7,4,1,0,1,3,7,1,0,23,EL
19cae58d,4,4,0,2,2,2,5,3,4,0,4,1,5,1,0,23,EL
19cda00b,6,4,1,3,2,4,11,7,6,1,5,3,9,0,0,23,EL
1a799243,3,2,1,2,0,1,3,2,3,0,3,5,8,3,0,23,EL
1a7fcf39,4,3,3,1,0,3,4,1,2,0,2,4,8,3,1,23,EL
1ac58ba6,2,2,2,0,0,2,3,1,8,6,2,2,4,10,2,23,EL
1adcf39e,4,2,4,0,0,2,4,2,2,1,1,8,12,20,0,23,EL
1b4f1169,5,1,1,3,1,2,4,2,0,0,0,4,9,4,0,23,EL
1bacc518,4,3,2,0,2,2,2,0,3,2,1,0,4,2,0,23,EL
1bd5735a,1,0,0,1,0,0,0,0,0,0,0,0,1,1,0,23,EL
1c07b06e,2,0,1,1,0,2,4,2,6,2,4,3,5,3,0,23,EL
1c341b14,0,0,0,0,0,0,0,0,3,0,3,2,2,1,0,23,EL
1c59240b,9,5,3,3,3,3,12,9,2,0,2,1,10,4,0,23,EL
1cb49278,3,1,2,0,1,0,0,0,3,1,2,0,3,1,0,23,EL
1d2c3e5e,12,7,5,6,1,6,13,7,13,1,12,4,16,3,0,23,EL
1d2d5cc8,0,0,0,0,0,0,0,0,0,0,0,0,0,2,0,23,EL
1d438d6c,1,0,1,0,0,1,1,0,0,0,0,0,1,1,0,23,EL
1da13ab9,3,1,3,0,0,2,4,2,4,1,3,4,7,8,0,23,EL
1df4a109,14,9,4,8,2,4,7,3,10,1,9,8,22,7,0,23,EL
1e064bfb,0,0,0,0,0,0,0,0,0,0,0,0,0,1,0,23,EL
1e1378e1,3,3,1,1,1,3,6,3,2,0,2,1,4,0,0,23,EL
1e274a0a,4,2,1,3,0,0,2,2,2,0,2,2,6,1,0,23,EL
1e4319ac,2,0,1,0,1,1,1,0,1,0,1,0,2,0,1,23,EL
1e8dbb59,0,0,0,0,0,0,0,0,0,0,0,0,0,1,0,23,EL
1f3afdcb,4,3,3,1,0,2,2,0,0,0,0,3,7,7,0,23,EL
1fbbfbde,9,4,7,2,0,5,7,2,3,2,1,6,15,19,0,23,EL
200e89e1,0,0,0,0,0,0,1,1,1,0,1,0,0,0,0,23,EL
20e73fac,11,4,4,6,1,5,11,6,6,1,5,1,12,11,0,23,EL
211589b8,0,0,0,0,0,0,1,1,1,0,1,0,0,0,0,23,EL
2116f524,0,0,0,0,0,0,0,0,0,0,0,0,0,0,0,23,EL
218e344d,5,3,1,3,1,2,4,2,5,1,4,6,11,5,0,23,EL
2249e65b,2,2,0,2,0,2,3,1,1,0,1,0,2,2,0,23,EL
22798128,17,13,8,8,1,8,18,10,12,2,10,7,24,7,0,23,EL
228b0d9d,5,4,2,2,1,4,4,0,1,0,1,0,5,2,0,23,EL
232b3da4,0,0,0,0,0,0,0,0,5,0,5,0,0,2,0,23,EL
235a646b,4,3,2,2,0,2,5,3,1,0,1,2,6,5,0,23,EL
23c63b7f,2,2,0,1,1,2,4,2,0,0,0,0,2,1,0,23,EL
242e1043,13,9,9,4,0,7,10,3,4,3,1,7,20,9,0,23,EL
244a31b9,9,6,6,3,0,7,8,1,7,5,2,8,17,21,0,23,EL
2475dcc6,4,3,1,2,1,2,2,0,2,0,2,1,5,2,0,23,EL
24baba9d,12,8,7,3,2,5,10,5,6,2,4,5,17,6,0,23,EL
25146df0,0,0,0,0,0,0,1,1,3,2,1,0,0,2,0,23,EL
254b831b,6,3,6,0,0,2,2,0,3,1,2,2,8,9,0,23,EL
25ab9c9c,1,0,0,0,1,0,0,0,1,1,0,2,3,0,0,23,EL
27504df8,5,3,1,4,0,2,2,0,5,0,5,2,7,3,0,23,EL
2770726a,4,4,0,3,1,1,2,1,2,0,2,2,6,0,0,23,EL
277da414,0,0,0,0,0,0,0,0,0,0,0,0,0,5,2,23,EL
2794a536,1,0,1,0,0,0,0,0,1,1,0,0,1,4,0,23,EL
283699b4,0,0,0,0,0,0,0,0,0,0,0,0,0,0,0,23,EL
28c6e925,8,5,5,3,0,6,8,2,2,0,2,1,9,5,0,23,EL
2973d8ff,0,0,0,0,0,0,0,0,1,0,1,0,0,4,0,23,EL
29b61deb,13,5,6,6,1,4,8,4,4,2,2,4,17,2,0,23,EL
29e298a8,8,6,4,3,1,6,6,0,2,1,1,3,11,8,0,23,EL
2a0c8ba4,3,2,0,3,0,0,4,4,5,2,3,3,6,3,0,23,EL
2a29eb9b,8,6,3,2,3,4,11,7,2,1,1,5,13,6,1,23,EL
2a70dcc9,3,2,2,1,0,3,3,0,3,1,2,1,4,0,0,23,EL
2ab7149e,0,0,0,0,0,0,1,1,0,0,0,0,0,3,0,23,EL
2acd49b9,12,6,2,10,0,5,8,3,4,0,4,5,17,7,0,23,EL
2b0852db,0,0,0,0,0,0,2,2,0,0,0,1,1,1,0,23,EL
2b1c4abd,0,0,0,0,0,0,1,1,4,0,4,1,1,3,0,23,EL
2b53f7a5,5,2,1,3,1,3,9,6,1,0,1,1,6,3,0,23,EL
2bc17985,4,3,2,1,1,2,5,3,2,0,2,3,7,1,0,23,EL
2bef2bca,2,1,2,0,0,1,1,0,6,2,4,0,2,3,0,23,EL
2bf50b37,2,1,1,1,0,2,3,1,0,0,0,0,2,0,0,23,EL
2c5f04ba,0,0,0,0,0,0,0,0,0,0,0,0,0,0,0,23,EL
2ca35213,1,1,1,0,0,0,1,1,3,2,1,1,2,8,0,23,EL
2cb77ec6,8,5,5,2,1,4,8,4,3,1,2,9,17,19,0,23,EL
2dc925d5,2,2,0,0,2,1,1,0,0,0,0,0,2,0,0,23,EL
2edbd8d5,0,0,0,0,0,0,0,0,0,0,0,0,0,0,0,23,EL
2f18d0b8,0,0,0,0,0,0,0,0,0,0,0,0,0,1,0,23,EL
2f3452eb,9,4,4,4,1,6,11,5,6,1,5,6,15,8,0,23,EL
2f72f79e,4,4,3,1,0,2,5,3,0,0,0,2,6,4,0,23,EL
2f88752d,11,6,6,3,2,6,7,1,4,3,1,5,16,5,0,23,EL
2fba6108,3,2,0,2,1,1,3,2,2,0,2,1,4,1,0,23,EL
2ff76adc,14,7,10,4,0,8,19,11,3,2,1,3,17,7,0,23,EL
2ffa6348,5,2,3,2,0,1,5,4,4,2,2,5,10,12,0,23,EL
3010aefb,3,2,1,1,1,1,1,0,1,0,1,0,3,1,0,23,EL
302527b2,12,9,8,4,0,10,11,1,7,6,1,5,17,14,0,23,EL
3098c0df,2,1,0,2,0,0,2,2,0,0,0,2,4,1,0,23,EL
30ae134d,2,1,0,0,2,1,6,5,3,2,1,0,2,8,0,23,EL
30af8b93,18,13,11,6,1,12,15,3,6,1,5,9,27,9,0,23,EL
30e03a25,13,7,9,4,0,8,12,4,13,9,4,13,26,27,0,23,EL
30fab1ee,6,3,3,2,1,0,3,3,0,0,0,1,7,0,0,23,EL
31139973,0,0,0,0,0,0,0,0,0,0,0,0,0,0,0,23,EL
313254a3,11,8,6,2,3,6,15,9,5,2,3,12,23,8,0,23,EL
31a62dc7,5,2,1,4,0,2,6,4,5,1,4,5,10,12,0,23,EL
31b7d437,3,3,0,2,1,2,2,0,0,0,0,0,3,0,0,23,EL
31f5b89b,5,2,0,3,2,3,7,4,5,0,5,7,12,3,0,23,EL
3260690c,0,0,0,0,0,0,0,0,0,0,0,0,0,0,0,23,EL
32f3d97e,3,3,1,1,1,1,3,2,2,0,2,3,6,0,0,23,EL
33591ff0,1,0,0,1,0,1,6,5,1,0,1,0,1,0,0,23,EL
335fa267,1,1,0,0,1,0,0,0,0,0,0,0,1,0,0,23,EL
33651873,9,4,6,2,1,6,15,9,4,3,1,7,16,14,0,23,EL
3376a776,0,0,0,0,0,0,1,1,0,0,0,0,0,1,0,23,EL
3423f250,5,4,3,1,1,3,5,2,3,0,3,2,7,0,0,23,EL
34693494,3,2,1,2,0,1,2,1,5,0,5,2,5,4,0,23,EL
34a0f5ff,3,2,2,1,0,1,4,3,2,0,2,2,5,2,1,23,EL
34abb664,3,2,2,0,1,1,1,0,2,0,2,0,3,0,0,23,EL
34caa4b3,9,7,1,3,5,5,12,7,5,2,3,1,10,3,0,23,EL
34e393f2,22,9,10,11,1,13,19,6,5,1,4,7,29,8,1,23,EL
350ad032,3,2,1,1,1,1,3,2,1,0,1,3,6,6,0,23,EL
3543ef90,0,0,0,0,0,0,0,0,0,0,0,0,0,0,0,23,EL
35bd124a,4,3,2,2,0,3,6,3,6,6,0,6,10,11,1,23,EL
35e413f1,8,3,1,5,2,5,10,5,5,2,3,4,12,3,0,23,EL
3626daea,11,5,6,2,3,10,17,7,8,1,7,4,15,7,0,23,EL
3642b47f,8,4,2,3,3,4,11,7,4,1,3,5,13,4,0,23,EL
366be751,8,7,4,1,3,3,11,8,6,1,5,3,11,1,0,23,EL
36a6f28d,7,5,0,6,1,4,9,5,1,0,1,5,12,3,0,23,EL
36a79857,3,0,0,3,0,3,6,3,3,0,3,2,5,5,0,23,EL
3708e9fa,13,5,6,3,4,5,14,9,11,0,11,10,23,1,0,23,EL
37143438,1,1,0,1,0,0,1,1,0,0,0,0,1,0,1,23,EL
37337aea,4,2,0,1,3,3,5,2,4,1,3,1,5,5,0,23,EL
3741ca58,10,5,1,3,6,4,7,3,2,0,2,4,14,0,0,23,EL
374d5158,4,1,4,0,0,3,6,3,4,1,3,6,10,11,0,23,EL
374ee424,0,0,0,0,0,0,0,0,0,0,0,0,0,1,1,23,EL
37557ec4,5,3,2,3,0,2,4,2,1,0,1,1,6,4,0,23,EL
37998008,0,0,0,0,0,0,0,0,0,0,0,0,0,0,0,23,EL
37aa57c0,10,6,7,3,0,6,8,2,11,5,6,15,25,34,0,23,EL
37d0048f,7,4,2,4,1,2,5,3,5,2,3,3,10,6,0,23,EL
37f341f0,4,3,3,1,0,1,3,2,2,1,1,9,13,4,0,23,EL
38ceb24a,0,0,0,0,0,0,0,0,1,0,1,0,0,0,0,23,EL
38fc10d2,1,0,0,1,0,0,0,0,0,0,0,1,2,0,0,23,EL
390eb94b,6,4,3,3,0,3,7,4,6,0,6,5,11,1,0,23,EL
394be156,8,7,8,0,0,3,7,4,2,2,0,1,9,8,1,23,EL
39e1138f,11,8,5,4,2,5,7,2,8,1,7,14,25,11,0,23,EL
3ae14ed1,5,3,2,2,1,2,5,3,6,0,6,4,9,1,0,23,EL
3b216df2,0,0,0,0,0,0,0,0,0,0,0,0,0,0,0,23,EL
3b996663,2,2,1,1,0,0,0,0,5,1,4,3,5,5,0,23,EL
3bd65247,3,3,1,2,0,1,2,1,0,0,0,1,4,0,0,23,EL
3befc2b6,14,8,9,5,0,8,15,7,9,6,3,10,24,31,0,23,EL
3c6bbbab,8,5,6,1,1,7,9,2,1,0,1,5,13,5,0,23,EL
3ca7254a,5,3,1,3,1,5,7,2,1,0,1,1,6,0,0,23,EL
3cd7820a,5,3,3,2,0,3,3,0,3,1,2,2,7,4,0,23,EL
3d3ac5b8,5,3,2,2,1,4,5,1,1,0,1,2,7,1,0,23,EL
3d50bcdb,2,1,1,1,0,0,1,1,0,0,0,0,2,5,0,23,EL
3d62c18b,6,5,4,2,0,2,3,1,6,1,5,6,12,14,0,23,EL
3da8cba0,1,0,1,0,0,1,2,1,0,0,0,2,3,3,0,23,EL
3dd738a1,1,1,1,0,0,1,7,6,3,1,2,1,2,0,0,23,EL
3e9bd29d,9,5,6,3,0,5,11,6,3,1,2,5,14,3,0,23,EL
3ead85f9,4,2,4,0,0,3,3,0,2,2,0,2,6,6,0,23,EL
3ec9f005,5,4,1,3,1,2,10,8,4,0,4,2,7,2,0,23,EL
3ee0dd59,3,1,2,1,0,1,5,4,5,0,5,12,15,6,0,23,EL
3ef0fa48,1,0,1,0,0,1,2,1,1,0,1,0,1,0,0,23,EL
3f10bd22,12,9,7,3,2,9,14,5,5,2,3,3,15,10,0,23,EL
3f30f12a,11,7,8,1,2,7,12,5,5,0,5,10,21,10,0,23,EL
3f5f38fb,0,0,0,0,0,0,0,0,0,0,0,1,1,3,0,23,EL
3fa66cb2,0,0,0,0,0,0,0,0,1,1,0,0,0,1,0,23,EL
3fba18d3,1,0,1,0,0,0,2,2,1,0,1,1,2,3,0,23,EL
4030c7ae,0,0,0,0,0,0,0,0,0,0,0,0,0,2,0,23,EL
4047c976,0,0,0,0,0,0,0,0,2,0,2,1,1,2,0,23,EL
40dc75f0,0,0,0,0,0,0,0,0,0,0,0,0,0,0,0,23,EL
41034650,2,0,1,1,0,1,2,1,2,1,1,1,3,5,0,23,EL
4123bc9a,2,1,1,1,0,1,2,1,2,0,2,4,6,1,0,23,EL
415568b5,6,4,5,1,0,4,11,7,9,3,6,3,9,2,1,23,EL
41f0b196,0,0,0,0,0,0,0,0,0,0,0,0,0,3,0,23,EL
41f32541,14,8,9,5,0,10,27,17,17,4,13,14,28,26,0,23,EL
42f8775b,7,4,2,4,1,1,3,2,8,1,7,2,9,2,0,23,EL
4315f30d,4,2,3,1,0,1,3,2,3,3,0,11,15,7,0,23,EL
43458538,6,4,4,2,0,3,4,1,2,0,2,2,8,0,0,23,EL
4352d221,14,8,8,4,2,9,19,10,12,1,11,5,19,4,0,23,EL
44150beb,3,2,3,0,0,2,2,0,7,2,5,6,9,13,1,23,EL
4431aed2,2,0,1,0,1,2,3,1,1,0,1,0,2,4,0,23,EL
44400941,5,2,2,2,1,1,3,2,3,0,3,9,14,5,0,23,EL
44ac04e9,3,2,1,2,0,2,6,4,1,0,1,4,7,1,0,23,EL
44f050bc,2,1,1,1,0,2,3,1,1,1,0,1,3,5,0,23,EL
45191c29,15,9,7,6,2,11,29,18,11,1,10,15,30,10,0,23,EL
4534a352,0,0,0,0,0,0,1,1,1,1,0,1,1,2,0,23,EL
45c29ae7,2,1,1,0,1,1,4,3,1,0,1,0,2,1,0,23,EL
45db685d,4,0,1,3,0,1,6,5,0,0,0,4,8,1,0,23,EL
4601e194,1,1,0,0,1,0,0,0,3,2,1,2,3,3,0,23,EL
466824fb,5,2,3,2,0,1,2,1,6,1,5,2,7,11,0,23,EL
466fb2c5,0,0,0,0,0,0,0,0,0,0,0,0,0,1,1,23,EL
46a8347f,7,4,4,2,1,7,8,1,3,2,1,6,13,6,0,23,EL
4736039a,2,2,2,0,0,2,3,1,0,0,0,0,2,2,0,23,EL
47420f02,5,3,2,3,0,2,8,6,4,0,4,0,5,0,0,23,EL
4760b2f2,2,1,1,1,0,1,1,0,2,2,0,0,2,6,0,23,EL
47a34c4f,2,0,1,1,0,2,2,0,0,0,0,1,3,0,0,23,EL
47aaf574,3,0,3,0,0,2,2,0,4,0,4,2,5,4,0,23,EL
47dbe004,12,9,5,7,0,5,17,12,4,1,3,6,18,9,0,23,EL
47fd5136,1,1,1,0,0,1,1,0,0,0,0,0,1,5,0,23,EL
4876c9ab,5,1,0,4,1,1,8,7,8,2,6,9,14,10,1,23,EL
489e80e3,16,8,11,3,2,9,27,18,10,0,10,6,22,0,0,23,EL
48a5a5d6,5,1,1,2,2,2,8,6,6,0,6,1,6,1,0,23,EL
49d028db,11,6,7,4,0,8,12,4,4,3,1,3,14,15,0,23,EL
4a1abff3,4,2,1,3,0,1,3,2,6,0,6,8,12,2,0,23,EL
4a51ba65,0,0,0,0,0,0,0,0,0,0,0,0,0,5,2,23,EL
4a5a45c7,21,10,6,9,6,8,21,13,6,4,2,8,29,16,0,23,EL
4a7078f9,5,3,2,3,0,3,12,9,7,3,4,5,10,8,0,23,EL
4b00cd47,8,5,7,1,0,5,10,5,6,3,3,2,10,36,0,23,EL
4bd00a50,4,3,4,0,0,4,4,0,1,1,0,5,9,12,0,23,EL
4c184730,0,0,0,0,0,0,0,0,2,0,2,0,0,1,0,23,EL
4c1e579e,0,0,0,0,0,0,0,0,0,0,0,0,0,0,0,23,EL
4c2e9442,0,0,0,0,0,0,0,0,0,0,0,0,0,1,0,23,EL
4c5039bd,0,0,0,0,0,0,0,0,0,0,0,0,0,3,0,23,EL
4c5b14d2,3,2,0,1,2,0,2,2,0,0,0,3,6,0,0,23,EL
4c62d0c8,0,0,0,0,0,0,0,0,0,0,0,0,0,0,0,23,EL
4c6e2ab5,0,0,0,0,0,0,0,0,0,0,0,0,0,0,0,23,EL
4c82730b,2,2,1,0,1,1,7,6,6,2,4,2,4,6,0,23,EL
4d0be953,0,0,0,0,0,0,0,0,0,0,0,1,1,8,0,23,EL
4d1666ff,3,1,3,0,0,3,8,5,3,0,3,2,5,5,0,23,EL
4d224fe8,32,14,19,12,1,13,40,27,37,11,26,17,49,22,0,23,EL
4db2157a,7,4,3,3,1,2,7,5,7,2,5,6,13,11,0,23,EL
4dcec659,6,3,3,1,2,5,7,2,3,0,3,4,10,2,0,23,EL
4dedd469,5,3,1,3,1,3,5,2,7,2,5,11,16,18,1,23,EL
4e219ad2,10,7,3,4,3,6,8,2,1,0,1,1,11,0,0,23,EL
4e3f5992,1,1,0,1,0,0,2,2,0,0,0,3,4,2,0,23,EL
4e4b59a4,0,0,0,0,0,0,0,0,0,0,0,0,0,0,0,23,EL
4e6dbac4,6,2,0,3,3,4,7,3,5,0,5,2,8,0,0,23,EL
4e7db402,0,0,0,0,0,0,0,0,0,0,0,0,0,4,1,23,EL
4f5a953e,4,1,2,2,0,2,3,1,2,2,0,5,9,21,1,23,EL
4f9f721c,2,1,0,1,1,1,3,2,3,0,3,1,3,1,0,23,EL
4fac8f81,16,7,9,5,2,10,16,6,13,8,5,12,28,43,2,23,EL
50385760,15,9,9,4,2,8,16,8,3,2,1,11,26,10,0,23,EL
507c7bdf,15,8,7,6,2,7,28,21,15,0,15,7,22,13,0,23,EL
50871bcc,1,1,1,0,0,0,2,2,2,0,2,0,1,0,0,23,EL
50c1ff86,3,1,0,2,1,0,1,1,1,1,0,4,7,9,0,23,EL
50cddd19,1,1,0,1,0,0,1,1,1,0,1,0,1,3,0,23,EL
50dc94ce,1,1,0,1,0,0,0,0,1,0,1,0,1,0,0,23,EL
50ff205b,13,10,9,4,0,7,10,3,6,2,4,10,23,19,0,23,EL
510c6a3f,0,0,0,0,0,0,0,0,0,0,0,0,0,0,0,23,EL
5148dcc5,12,4,5,7,0,4,5,1,3,0,3,3,15,4,0,23,EL
51cf8561,4,2,0,2,2,2,6,4,2,1,1,3,7,2,0,23,EL
51ffa295,3,0,0,2,1,1,2,1,4,0,4,3,6,3,0,23,EL
52061089,21,15,6,14,1,7,14,7,13,3,10,7,28,8,0,23,EL
52522325,2,1,2,0,0,1,1,0,0,0,0,1,3,0,0,23,EL
5294a83f,4,3,3,1,0,1,2,1,1,1,0,1,5,0,0,23,EL
529f49ab,4,2,1,3,0,1,2,1,1,0,1,3,7,2,0,23,EL
52afb588,1,1,0,0,1,0,1,1,1,0,1,0,1,2,0,23,EL
52ec54d0,0,0,0,0,0,0,0,0,1,1,0,0,0,9,0,23,EL
5333d7de,2,2,2,0,0,0,0,0,0,0,0,1,3,1,0,23,EL
53342701,8,1,6,2,0,4,8,4,5,2,3,16,24,20,0,23,EL
53d93280,0,0,0,0,0,0,0,0,0,0,0,0,0,5,0,23,EL
53de807a,1,0,1,0,0,0,0,0,1,1,0,2,3,1,0,23,EL
53e442e2,3,1,1,1,1,0,4,4,1,0,1,2,5,3,0,23,EL
541127d5,5,0,3,2,0,3,8,5,2,1,1,0,5,2,0,23,EL
54b4dc4e,12,5,6,5,1,4,7,3,6,0,6,4,16,2,0,23,EL
54bb5c3f,0,0,0,0,0,0,1,1,0,0,0,0,0,1,0,23,EL
54e4866f,7,5,1,3,3,4,8,4,3,0,3,0,7,4,0,23,EL
5521f419,1,1,0,1,0,0,0,0,2,0,2,3,4,2,0,23,EL
5529a99a,0,0,0,0,0,0,0,0,0,0,0,1,1,0,0,23,EL
555d5edd,6,3,2,4,0,2,4,2,1,0,1,3,9,0,0,23,EL
55e81c76,1,0,0,1,0,0,0,0,1,0,1,0,1,2,0,23,EL
563cbac0,10,7,7,2,1,7,10,3,6,5,1,11,21,27,0,23,EL
56bcde74,1,1,1,0,0,0,0,0,2,1,1,4,5,7,0,23,EL
56dd5e10,5,3,3,0,2,3,8,5,1,0,1,2,7,5,0,23,EL
5715bb71,4,1,0,2,2,0,6,6,5,0,5,1,5,1,0,23,EL
572498c7,3,2,2,0,1,2,6,4,2,0,2,1,4,4,0,23,EL
57469b2d,1,1,0,0,1,0,0,0,0,0,0,0,1,0,0,23,EL
57760e66,6,4,1,1,4,1,7,6,2,0,2,1,7,1,0,23,EL
57d9707f,4,1,2,2,0,3,6,3,1,0,1,2,6,1,0,23,EL
582beb9d,11,8,7,1,3,7,13,6,7,2,5,4,15,6,0,23,EL
5832ebfe,5,2,4,1,0,4,4,0,5,4,1,3,8,13,1,23,EL
5853ac44,9,6,4,5,0,4,7,3,5,1,4,6,15,7,0,23,EL
58a3a572,12,9,8,3,1,8,16,8,7,3,4,2,14,9,0,23,EL
58a9a4d9,7,3,3,3,1,3,12,9,9,0,9,1,8,1,0,23,EL
595ccab1,0,0,0,0,0,0,0,0,0,0,0,0,0,2,1,23,EL
595e6f3e,3,1,1,2,0,0,1,1,6,1,5,2,5,14,0,23,EL
59671448,6,2,4,1,1,6,9,3,7,3,4,5,11,12,0,23,EL
596cc50e,6,4,1,3,2,3,6,3,8,3,5,3,9,5,0,23,EL
59878425,4,3,1,0,3,3,4,1,2,0,2,3,7,0,0,23,EL
59e4b92e,23,10,6,13,4,10,19,9,5,0,5,9,32,7,0,23,EL
5aa53281,16,11,9,5,2,8,10,2,15,6,9,16,32,36,0,23,EL
5ab0ea87,5,5,3,2,0,4,5,1,2,0,2,4,9,3,0,23,EL
5b479568,0,0,0,0,0,0,2,2,0,0,0,1,1,0,0,23,EL
5c26ca51,22,12,7,13,2,11,27,16,18,1,17,13,35,3,0,23,EL
5c46e908,8,6,5,3,0,2,2,0,1,0,1,1,9,8,0,23,EL
5c7845f6,8,7,5,2,1,4,5,1,1,1,0,1,9,7,0,23,EL
5c78cb9e,0,0,0,0,0,0,0,0,0,0,0,1,1,0,0,23,EL
5ccc9672,2,0,1,1,0,2,3,1,4,0,4,1,3,0,0,23,EL
5ce0b5ba,4,1,1,3,0,2,3,1,6,0,6,3,7,1,0,23,EL
5ceba7fc,5,2,2,2,1,1,2,1,1,0,1,1,6,0,0,23,EL
5d0e0a1f,8,4,4,4,0,2,3,1,6,1,5,1,9,9,0,23,EL
5d4e9f31,2,0,1,1,0,1,4,3,1,0,1,2,4,2,0,23,EL
5d4f7d61,0,0,0,0,0,0,0,0,0,0,0,0,0,0,0,23,EL
5d873dfb,14,9,8,5,1,10,15,5,2,2,0,7,21,10,0,23,EL
5d8e331f,12,11,6,4,2,5,17,12,6,4,2,13,25,8,0,23,EL
5db7ba90,3,3,2,1,0,1,1,0,2,1,1,0,3,1,0,23,EL
5e22e2a4,1,1,0,1,0,0,0,0,3,2,1,3,4,1,0,23,EL
5e42afa3,9,6,5,2,2,3,8,5,2,0,2,3,12,9,0,23,EL
5e8936be,1,1,1,0,0,1,1,0,0,0,0,0,1,3,2,23,EL
5ef3d210,0,0,0,0,0,0,0,0,0,0,0,0,0,0,0,23,EL
5f09991f,1,1,1,0,0,1,3,2,2,0,2,2,3,4,0,23,EL
5f3eaaf5,2,1,0,1,1,2,4,2,4,0,4,0,2,0,0,23,EL
5fa714d5,7,5,3,3,1,3,10,7,0,0,0,3,10,1,0,23,EL
5fcb90ac,3,2,1,1,1,1,2,1,1,1,0,5,8,5,0,23,EL
5fd5ed86,7,6,4,3,0,5,6,1,14,7,7,7,14,38,0,23,EL
603116a7,0,0,0,0,0,0,0,0,0,0,0,0,0,0,0,23,EL
60713cb3,0,0,0,0,0,0,0,0,1,0,1,0,0,0,1,23,EL
60831426,0,0,0,0,0,0,0,0,0,0,0,0,0,3,0,23,EL
60c07b31,0,0,0,0,0,0,0,0,4,3,1,4,4,14,2,23,EL
6115fddd,0,0,0,0,0,0,0,0,0,0,0,1,1,5,0,23,EL
6190474d,2,1,1,1,0,0,3,3,0,0,0,2,4,0,0,23,EL
6191093d,4,2,1,3,0,0,4,4,4,0,4,4,8,0,0,23,EL
625c144a,0,0,0,0,0,0,0,0,0,0,0,1,1,0,1,23,EL
62de9d42,7,2,2,3,2,3,12,9,7,0,7,1,8,0,0,23,EL
62f7c156,4,1,4,0,0,4,5,1,3,3,0,5,9,18,0,23,EL
63567ebc,14,5,6,6,2,7,16,9,6,2,4,4,18,4,0,23,EL
6358cb11,9,7,6,3,0,7,9,2,3,1,2,5,14,13,0,23,EL
6412cc03,4,2,1,2,1,0,1,1,6,0,6,3,7,1,0,23,EL
6445d6fe,2,1,2,0,0,0,2,2,1,1,0,1,3,1,0,23,EL
6456e745,8,3,3,4,1,6,8,2,3,0,3,3,11,0,0,23,EL
64f69877,3,3,0,2,1,1,3,2,4,1,3,0,3,0,0,23,EL
6510079f,2,1,2,0,0,0,5,5,0,0,0,1,3,1,0,23,EL
651fa4db,1,0,0,0,1,0,0,0,0,0,0,0,1,0,0,23,EL
6578600f,1,1,0,0,1,1,1,0,5,0,5,1,2,0,0,23,EL
65857fdf,1,1,0,0,1,0,0,0,1,0,1,0,1,0,0,23,EL
65d62814,1,1,1,0,0,1,1,0,0,0,0,0,1,3,1,23,EL
6603fed7,4,0,0,2,2,1,8,7,5,0,5,1,5,2,0,23,EL
6637e6a7,9,6,1,6,2,4,14,10,10,1,9,4,13,4,0,23,EL
66c52a77,13,12,9,1,3,10,15,5,5,0,5,3,16,4,0,23,EL
6747869d,1,0,1,0,0,0,1,1,3,0,3,0,1,0,0,23,EL
67ac5bb8,8,6,6,1,1,5,5,0,5,3,2,5,13,20,0,23,EL
67b054d1,10,6,5,3,2,6,9,3,6,5,1,9,19,12,0,23,EL
67f0703d,4,3,2,2,0,1,2,1,5,1,4,2,6,9,2,23,EL
686cbe7d,0,0,0,0,0,0,1,1,0,0,0,0,0,1,0,23,EL
6885cc44,5,3,2,3,0,4,10,6,3,0,3,2,7,1,0,23,EL
68a26d51,7,6,0,7,0,3,11,8,5,0,5,4,11,2,1,23,EL
6aafdc27,2,1,2,0,0,1,1,0,8,3,5,12,14,25,0,23,EL
6b658db0,1,0,1,0,0,0,0,0,0,0,0,0,1,0,0,23,EL
6b6c793c,23,15,13,5,5,13,21,8,12,3,9,8,31,8,1,23,EL
6bd5cd5d,23,13,16,7,0,12,20,8,13,8,5,11,34,22,1,23,EL
6bd603db,3,3,2,1,0,2,3,1,3,0,3,1,4,6,0,23,EL
6c249ea7,13,3,8,4,1,8,11,3,2,1,1,3,16,11,0,23,EL
6c5af908,12,6,5,7,0,5,10,5,3,1,2,9,21,3,0,23,EL
6caffe81,0,0,0,0,0,0,0,0,0,0,0,0,0,2,0,23,EL
6cbf8d0d,2,1,1,1,0,1,1,0,3,1,2,0,2,2,0,23,EL
6d86d9cd,3,2,0,2,1,1,1,0,2,0,2,2,5,3,0,23,EL
6db16dda,0,0,0,0,0,0,2,2,0,0,0,0,0,1,0,23,EL
6e2c94ad,2,1,1,1,0,2,2,0,1,0,1,0,2,0,1,23,EL
6e2e6e4e,0,0,0,0,0,0,0,0,0,0,0,0,0,0,0,23,EL
6e44569a,2,0,1,0,1,0,0,0,7,1,6,1,3,1,0,23,EL
6e4df551,3,1,0,3,0,1,1,0,1,0,1,0,3,1,0,23,EL
6f51e382,0,0,0,0,0,0,0,0,0,0,0,0,0,0,0,23,EL
6f5f82c0,2,1,2,0,0,1,6,5,3,1,2,2,4,2,0,23,EL
6fd8a334,6,3,3,3,0,2,2,0,7,6,1,9,15,15,0,23,EL
6ff91a3a,1,0,1,0,0,0,1,1,2,2,0,2,3,2,0,23,EL
706a337d,1,1,1,0,0,1,4,3,1,0,1,0,1,3,0,23,EL
70c52749,15,9,8,5,2,12,15,3,9,1,8,7,22,4,0,23,EL
70dcf94d,11,4,2,9,0,4,9,5,18,1,17,5,16,1,0,23,EL
71115017,7,5,4,3,0,6,12,6,4,1,3,2,9,26,0,23,EL
713c144a,3,3,2,0,1,1,3,2,1,0,1,0,3,0,0,23,EL
718a3a5c,6,3,2,4,0,4,5,1,13,7,6,10,16,33,0,23,EL
720ebb4e,0,0,0,0,0,0,0,0,0,0,0,0,0,0,0,23,EL
7242b495,3,2,2,1,0,2,3,1,1,0,1,2,5,2,0,23,EL
7287ea6b,0,0,0,0,0,0,0,0,2,2,0,0,0,0,0,23,EL
72c01cfb,3,1,2,1,0,2,3,1,2,2,0,3,6,11,0,23,EL
72f87f25,2,2,1,1,0,0,0,0,1,0,1,0,2,0,0,23,EL
731302dc,3,2,1,0,2,3,5,2,5,0,5,2,5,1,0,23,EL
7328bee5,5,3,4,1,0,4,6,2,1,0,1,3,8,11,0,23,EL
73b1d487,3,1,2,1,0,2,10,8,6,0,6,5,8,1,0,23,EL
743ffce1,0,0,0,0,0,0,2,2,3,0,3,1,1,5,0,23,EL
746b64a7,3,1,2,1,0,1,3,2,10,6,4,11,14,19,0,23,EL
7483d9f9,12,7,10,2,0,9,13,4,9,9,0,6,18,29,0,23,EL
74d4cec6,2,0,0,0,2,2,10,8,3,0,3,0,2,3,0,23,EL
74f2e748,11,9,2,8,1,6,16,10,6,1,5,2,13,13,0,23,EL
75229233,1,1,0,1,0,0,1,1,1,0,1,3,4,1,0,23,EL
75645f0e,2,2,0,1,1,0,1,1,0,0,0,1,3,2,0,23,EL
756959aa,4,2,2,1,1,2,7,5,4,0,4,2,6,0,0,23,EL
7673e4bc,0,0,0,0,0,0,1,1,0,0,0,1,1,2,0,23,EL
770ebf00,3,0,0,3,0,3,8,5,7,0,7,5,8,0,0,23,EL
7713c72a,5,1,4,1,0,2,4,2,5,5,0,7,12,5,0,23,EL
779847d6,17,12,12,3,2,10,19,9,8,5,3,13,30,21,0,23,EL
77ac1d89,4,3,1,2,1,2,4,2,5,1,4,1,5,3,0,23,EL
77e39b04,4,3,2,0,2,1,4,3,2,0,2,1,5,3,0,23,EL
78f13530,4,3,0,2,2,2,5,3,1,0,1,0,4,4,0,23,EL
79300479,5,0,1,4,0,2,2,0,1,0,1,2,7,0,0,23,EL
79443529,0,0,0,0,0,0,3,3,3,0,3,1,1,3,0,23,EL
79b0d6a0,0,0,0,0,0,0,0,0,0,0,0,0,0,2,1,23,EL
7a2cf111,13,7,5,5,3,7,13,6,7,1,6,5,18,8,0,23,EL
7a4cea18,3,1,1,2,0,1,2,1,1,0,1,0,3,0,0,23,EL
7aa8adfe,2,2,2,0,0,1,3,2,3,0,3,3,5,2,0,23,EL
7af31216,9,4,4,5,0,5,9,4,8,5,3,3,12,11,0,23,EL
7b456af7,0,0,0,0,0,0,0,0,0,0,0,0,0,0,0,23,EL
7b5ab7f2,8,4,2,4,2,2,8,6,3,0,3,5,13,2,0,23,EL
7b9ecf02,5,4,4,1,0,4,4,0,3,1,2,10,15,17,0,23,EL
7ba6d84e,0,0,0,0,0,0,0,0,0,0,0,1,1,7,2,23,EL
7bf8ad6c,9,4,3,2,4,5,12,7,5,0,5,2,11,1,0,23,EL
7c106fcf,2,0,2,0,0,0,2,2,2,0,2,2,4,2,0,23,EL
7ca9f0f0,13,5,6,5,2,5,9,4,2,0,2,5,18,11,0,23,EL
7cb9de24,2,2,2,0,0,1,1,0,2,1,1,7,9,18,1,23,EL
7cc5bd9c,0,0,0,0,0,0,0,0,3,1,2,1,1,1,0,23,EL
7cd78926,14,7,8,3,3,5,8,3,8,4,4,15,29,8,0,23,EL
7d31f1cb,0,0,0,0,0,0,0,0,0,0,0,1,1,1,0,23,EL
7d7660da,3,1,3,0,0,1,1,0,1,0,1,2,5,1,0,23,EL
7e6b3664,1,1,1,0,0,1,1,0,2,1,1,3,4,1,0,23,EL
7e82a78f,0,0,0,0,0,0,0,0,1,0,1,2,2,0,0,23,EL
7f8fb807,1,1,0,1,0,0,0,0,2,0,2,0,1,2,0,23,EL
7f9c5d2d,1,1,1,0,0,1,4,3,5,1,4,0,1,6,0,23,EL
7fdb872a,0,0,0,0,0,0,0,0,1,0,1,0,0,1,0,23,EL
803e7aca,9,3,3,4,2,3,8,5,6,1,5,6,15,5,0,23,EL
80556f08,4,4,3,1,0,0,1,1,2,0,2,1,5,1,0,23,EL
8059806f,11,8,7,3,1,6,12,6,12,3,9,2,13,5,0,23,EL
808035bd,6,3,4,2,0,2,3,1,6,5,1,9,15,31,0,23,EL
8104e41e,3,3,0,2,1,1,6,5,10,0,10,7,10,1,0,23,EL
81069528,8,5,5,2,1,4,7,3,3,1,2,5,13,13,0,23,EL
81255c03,1,0,1,0,0,0,0,0,2,0,2,1,2,0,0,23,EL
81442ecb,24,16,9,13,2,7,17,10,11,2,9,5,29,13,0,23,EL
819aa8e7,1,0,0,1,0,1,3,2,1,0,1,0,1,1,0,23,EL
822d51d7,18,13,7,10,1,6,18,12,8,3,5,7,25,4,0,23,EL
826e8b63,7,3,3,3,1,3,10,7,2,0,2,5,12,9,0,23,EL
82cfae2a,8,5,5,3,0,5,6,1,7,5,2,6,14,40,0,23,EL
82e12fe7,2,1,2,0,0,1,1,0,1,1,0,2,4,0,0,23,EL
82e9b1bb,11,6,9,2,0,6,8,2,3,2,1,6,17,17,0,23,EL
82efe6fa,20,11,13,6,1,11,17,6,20,12,8,29,49,48,0,23,EL
830a34ec,0,0,0,0,0,0,1,1,1,1,0,0,0,1,0,23,EL
83300259,0,0,0,0,0,0,0,0,0,0,0,0,0,1,0,23,EL
8382b207,3,2,1,0,2,2,2,0,1,0,1,0,3,0,0,23,EL
839c14e1,0,0,0,0,0,0,0,0,0,0,0,0,0,0,0,23,EL
83c06f3a,0,0,0,0,0,0,0,0,0,0,0,0,0,0,0,23,EL
83e4643e,1,1,0,1,0,1,1,0,0,0,0,1,2,2,0,23,EL
84399660,4,4,4,0,0,1,4,3,2,0,2,0,4,0,0,23,EL
85613cf0,2,1,1,1,0,0,2,2,0,0,0,0,2,1,0,23,EL
8593f88c,17,5,9,8,0,13,20,7,8,2,6,4,21,5,0,23,EL
85bed4ee,7,6,2,2,3,2,3,1,5,0,5,3,10,1,0,23,EL
85c76f0a,0,0,0,0,0,0,0,0,1,0,1,0,0,0,0,23,EL
85f476cc,4,4,1,3,0,4,6,2,6,3,3,3,7,4,0,23,EL
8614496d,2,1,1,0,1,1,2,1,8,6,2,5,7,16,0,23,EL
867239d3,0,0,0,0,0,0,2,2,0,0,0,2,2,0,0,23,EL
8794e251,15,11,10,3,2,7,20,13,14,2,12,7,22,23,0,23,EL
88968486,12,5,5,6,1,8,11,3,7,4,3,4,16,12,1,23,EL
890f108d,2,2,0,1,1,1,2,1,1,0,1,1,3,2,0,23,EL
89c63f8c,0,0,0,0,0,0,0,0,3,1,2,2,2,5,0,23,EL
89f951b5,19,9,7,9,3,9,21,12,11,4,7,5,24,6,0,23,EL
8a2248b4,0,0,0,0,0,0,0,0,0,0,0,0,0,1,0,23,EL
8a56c04c,3,2,1,1,1,1,3,2,5,0,5,1,4,8,0,23,EL
8b0d9f35,5,2,0,4,1,3,7,4,5,2,3,5,10,3,0,23,EL
8b3ab7ad,5,4,2,3,0,1,1,0,5,2,3,1,6,7,1,23,EL
8b5504e1,18,12,13,3,2,13,28,15,14,0,14,10,28,14,0,23,EL
8b788c01,0,0,0,0,0,0,0,0,0,0,0,0,0,1,0,23,EL
8bc373ea,7,5,7,0,0,5,7,2,3,2,1,4,11,15,1,23,EL
8c3c640c,1,0,0,0,1,0,0,0,1,0,1,0,1,0,0,23,EL
8c5506ec,12,11,8,3,1,7,10,3,7,1,6,6,18,15,0,23,EL
8c6239f2,5,2,3,1,1,3,5,2,4,3,1,1,6,5,0,23,EL
8c725b43,4,3,4,0,0,3,5,2,11,3,8,8,12,15,0,23,EL
8cd49575,0,0,0,0,0,0,0,0,0,0,0,0,0,1,0,23,EL
8d62d31a,4,0,3,1,0,2,2,0,7,5,2,5,9,20,0,23,EL
8d7323e8,6,3,2,3,1,3,8,5,4,0,4,3,9,1,0,23,EL
8d78e732,2,1,0,2,0,2,2,0,0,0,0,1,3,3,0,23,EL
8dcf77c0,0,0,0,0,0,0,0,0,2,0,2,2,2,3,0,23,EL
8df5b30f,1,0,0,1,0,0,2,2,2,0,2,0,1,3,0,23,EL
8e235926,4,2,0,2,2,0,4,4,3,0,3,1,5,3,0,23,EL
8e34b9f5,10,5,4,5,1,8,9,1,4,0,4,3,13,12,0,23,EL
8e456005,1,1,0,1,0,0,0,0,1,0,1,0,1,0,0,23,EL
8e48dc61,6,3,4,2,0,3,5,2,4,0,4,2,8,4,0,23,EL
8eb55dbb,5,2,1,2,2,1,5,4,7,1,6,2,7,0,0,23,EL
8eeb8ba4,9,5,5,2,2,7,9,2,4,1,3,4,13,14,0,23,EL
8eef18aa,0,0,0,0,0,0,0,0,0,0,0,2,2,2,0,23,EL
8f5bfaac,0,0,0,0,0,0,3,3,2,0,2,3,3,1,0,23,EL
90339309,3,2,3,0,0,2,2,0,4,1,3,5,8,7,0,23,EL
903b3b77,10,7,9,0,1,4,9,5,4,3,1,1,11,27,0,23,EL
9052e98c,0,0,0,0,0,0,1,1,0,0,0,0,0,0,0,23,EL
90b70194,4,2,1,3,0,3,7,4,5,2,3,2,6,5,0,23,EL
90d7dda6,4,2,3,1,0,1,6,5,2,1,1,3,7,5,0,23,EL
90def3ab,1,0,1,0,0,1,1,0,0,0,0,0,1,1,0,23,EL
922dfade,17,12,4,9,4,6,15,9,4,1,3,3,20,6,0,23,EL
92d6bdc9,0,0,0,0,0,0,0,0,0,0,0,0,0,0,0,23,EL
92fa5d28,5,3,3,2,0,1,3,2,2,1,1,7,12,2,0,23,EL
939bc634,0,0,0,0,0,0,0,0,0,0,0,0,0,4,1,23,EL
942b4f90,3,2,0,2,1,2,2,0,4,0,4,1,4,0,0,23,EL
94b2001f,24,17,20,3,1,14,16,2,8,3,5,17,41,44,1,23,EL
951f1739,4,2,3,1,0,2,7,5,3,0,3,5,9,4,0,23,EL
952afd27,2,2,2,0,0,0,2,2,4,2,2,1,3,22,0,23,EL
958ede06,5,3,2,3,0,2,4,2,1,0,1,2,7,2,0,23,EL
9614b550,9,5,6,3,0,3,4,1,10,7,3,10,19,22,0,23,EL
972aeb2a,3,1,3,0,0,2,5,3,0,0,0,3,6,8,0,23,EL
975eda74,2,0,1,0,1,2,3,1,2,1,1,0,2,0,0,23,EL
97e2aa67,2,1,1,1,0,1,1,0,0,0,0,0,2,2,0,23,EL
980522ec,5,3,3,2,0,3,6,3,3,0,3,3,8,2,0,23,EL
9866afec,3,2,2,0,1,1,3,2,2,1,1,3,6,6,0,23,EL
988dfee2,8,4,7,1,0,3,6,3,9,6,3,11,19,25,0,23,EL
9907b1c8,1,1,1,0,0,1,1,0,1,0,1,1,2,0,0,23,EL
99127249,10,6,5,5,0,1,8,7,8,0,8,3,13,5,0,23,EL
99351886,0,0,0,0,0,0,1,1,0,0,0,0,0,4,2,23,EL
9937ce4a,2,1,2,0,0,1,4,3,1,0,1,2,4,1,0,23,EL
9980269a,0,0,0,0,0,0,1,1,0,0,0,0,0,0,0,23,EL
9a64e67e,1,1,1,0,0,0,0,0,2,1,1,3,4,6,0,23,EL
9a71e978,4,4,3,1,0,4,6,2,0,0,0,1,5,1,0,23,EL
9a794238,0,0,0,0,0,0,0,0,0,0,0,0,0,1,0,23,EL
9b3ab988,9,7,5,2,2,3,4,1,5,2,3,10,19,14,0,23,EL
9bc9a519,0,0,0,0,0,0,0,0,3,1,2,3,3,2,0,23,EL
9bf914b4,16,7,7,8,1,8,13,5,8,1,7,3,19,5,0,23,EL
9c2b4382,1,0,0,1,0,0,0,0,0,0,0,0,1,0,0,23,EL
9c2e7413,1,0,0,1,0,1,1,0,0,0,0,0,1,0,0,23,EL
9c435456,8,3,8,0,0,6,9,3,7,3,4,2,10,12,1,23,EL
9c4f39b3,3,2,1,1,1,0,4,4,1,0,1,1,4,1,0,23,EL
9c74fa25,7,7,2,4,1,2,6,4,4,0,4,9,16,10,0,23,EL
9c94165b,10,6,3,5,2,4,9,5,5,2,3,6,16,9,0,23,EL
9ceb7642,10,6,4,5,1,7,16,9,6,0,6,2,12,2,0,23,EL
9d21da85,11,7,7,3,1,10,14,4,12,7,5,8,19,26,0,23,EL
9d689a5b,5,5,4,1,0,0,5,5,3,0,3,0,5,1,0,23,EL
9d7d5334,0,0,0,0,0,0,0,0,0,0,0,0,0,2,0,23,EL
9d9e69df,3,0,1,2,0,1,2,1,1,0,1,0,3,1,0,23,EL
9e1035f8,1,0,1,0,0,0,0,0,0,0,0,0,1,0,0,23,EL
9e17ccff,0,0,0,0,0,0,0,0,0,0,0,0,0,0,0,23,EL
9e525177,8,5,3,5,0,3,5,2,6,1,5,8,16,14,1,23,EL
9e7483ff,2,0,0,2,0,1,5,4,5,0,5,1,3,2,0,23,EL
9f115e20,16,11,11,5,0,9,15,6,5,0,5,8,24,7,0,23,EL
9f1893b9,9,5,3,2,4,3,6,3,2,0,2,2,11,2,0,23,EL
9f84febe,2,2,1,0,1,1,2,1,1,0,1,1,3,0,0,23,EL
9f8e9423,3,3,2,1,0,1,3,2,3,0,3,4,7,20,0,23,EL
a0415710,0,0,0,0,0,0,2,2,2,0,2,1,1,2,0,23,EL
a04e2dd2,0,0,0,0,0,0,0,0,0,0,0,0,0,0,0,23,EL
a08b974a,18,8,6,8,4,11,19,8,6,0,6,3,21,2,0,23,EL
a0b730dc,3,2,1,1,1,2,6,4,3,0,3,2,5,2,0,23,EL
a0c590b9,1,0,0,1,0,0,0,0,1,0,1,0,1,0,0,23,EL
a0f9b535,11,8,4,5,2,4,9,5,5,0,5,3,14,3,0,23,EL
a18c2d65,0,0,0,0,0,0,0,0,0,0,0,0,0,0,0,23,EL
a1c63a01,0,0,0,0,0,0,0,0,0,0,0,0,0,0,0,23,EL
a1d5bd30,6,4,2,3,1,2,6,4,9,0,9,0,6,1,0,23,EL
a29b1131,0,0,0,0,0,0,3,3,0,0,0,0,0,1,0,23,EL
a29e5244,5,3,3,2,0,2,3,1,3,1,2,0,5,3,0,23,EL
a2d873dd,1,1,1,0,0,0,1,1,3,0,3,3,4,4,0,23,EL
a2f2d806,2,1,0,1,1,1,2,1,2,0,2,0,2,3,0,23,EL
a36524bf,3,2,3,0,0,1,2,1,1,0,1,2,5,6,0,23,EL
a372a9f2,12,7,5,5,2,7,14,7,2,0,2,4,16,2,0,23,EL
a40819d9,2,0,0,2,0,0,3,3,0,0,0,2,4,2,0,23,EL
a4b1028a,10,7,6,3,1,6,9,3,2,0,2,4,14,10,0,23,EL
a53649b7,1,0,0,0,1,0,2,2,6,0,6,0,1,1,0,23,EL
a5549ec1,2,2,2,0,0,0,0,0,0,0,0,5,7,3,0,23,EL
a55ba2f8,2,1,2,0,0,0,1,1,4,4,0,1,3,11,0,23,EL
a55d8df5,21,10,11,8,2,12,25,13,9,1,8,13,34,11,0,23,EL
a62c16d0,4,2,0,2,2,2,3,1,1,0,1,1,5,3,0,23,EL
a62f8bf1,4,3,2,2,0,3,6,3,1,0,1,3,7,1,1,23,EL
a650c75b,5,3,2,3,0,1,10,9,6,4,2,8,13,4,0,23,EL
a6979b0f,1,1,0,1,0,1,1,0,1,0,1,3,4,2,0,23,EL
a6de370d,5,1,1,4,0,4,7,3,3,0,3,3,8,1,0,23,EL
a6ee4f55,5,5,2,3,0,5,7,2,0,0,0,5,10,2,0,23,EL
a70b8345,0,0,0,0,0,0,0,0,0,0,0,0,0,1,1,23,EL
a73c8f95,17,9,6,9,2,10,20,10,12,3,9,9,26,28,0,23,EL
a74ea18d,4,1,1,3,0,2,3,1,2,0,2,2,6,3,0,23,EL
a793f5a8,1,1,0,1,0,1,8,7,4,0,4,2,3,7,0,23,EL
a7d48b00,1,1,0,1,0,0,1,1,3,1,2,0,1,0,0,23,EL
a81dba8c,6,4,3,0,3,4,8,4,2,1,1,1,7,0,0,23,EL
a81ed730,1,0,1,0,0,0,2,2,2,0,2,5,6,4,0,23,EL
a83c19cf,0,0,0,0,0,0,1,1,2,0,2,0,0,0,0,23,EL
a8567629,5,2,3,1,1,2,8,6,13,0,13,1,6,4,0,23,EL
a8a874f1,16,10,8,8,0,7,20,13,6,2,4,11,27,17,0,23,EL
a8f41212,0,0,0,0,0,0,2,2,2,0,2,1,1,0,0,23,EL
a8fbae1d,2,1,2,0,0,2,5,3,6,4,2,4,6,23,1,23,EL
a9107589,0,0,0,0,0,0,0,0,0,0,0,0,0,0,0,23,EL
a9142dc3,0,0,0,0,0,0,0,0,1,0,1,0,0,0,0,23,EL
a919be14,2,1,1,0,1,0,1,1,2,0,2,1,3,0,0,23,EL
a92ab7be,0,0,0,0,0,0,1,1,0,0,0,0,0,4,0,23,EL
a93b6f4e,4,3,1,2,1,3,4,1,4,0,4,4,8,4,0,23,EL
a99138af,4,4,1,2,1,2,4,2,2,0,2,1,5,0,0,23,EL
aa982b0f,6,4,1,3,2,1,4,3,5,0,5,1,7,0,0,23,EL
aad56ca3,5,3,3,2,0,1,1,0,4,2,2,3,8,0,0,23,EL
ab57e591,0,0,0,0,0,0,0,0,0,0,0,0,0,0,0,23,EL
abb3bb95,3,2,0,1,2,0,2,2,3,0,3,0,3,6,0,23,EL
abe66106,5,5,1,3,1,3,9,6,8,1,7,1,6,1,0,23,EL
ac295d9e,0,0,0,0,0,0,0,0,0,0,0,0,0,2,1,23,EL
ac4961c8,6,2,3,3,0,1,4,3,2,0,2,1,7,3,0,23,EL
ac7e7b1c,2,1,1,0,1,1,2,1,1,0,1,1,3,0,0,23,EL
ad3389d5,0,0,0,0,0,0,0,0,0,0,0,0,0,2,1,23,EL
ad82197c,5,4,2,3,0,3,6,3,8,2,6,26,31,17,0,23,EL
ad9b2747,2,2,0,1,1,1,4,3,2,0,2,3,5,5,0,23,EL
adfbe1f5,11,6,6,4,1,8,18,10,3,0,3,2,13,8,0,23,EL
ae05689a,10,5,6,2,2,4,12,8,8,0,8,6,16,1,0,23,EL
ae1159bf,3,2,3,0,0,3,6,3,6,0,6,2,5,5,0,23,EL
ae4e2852,3,2,1,1,1,2,2,0,1,0,1,1,4,4,0,23,EL
ae94a6c5,8,7,7,1,0,7,10,3,7,2,5,3,11,4,0,23,EL
aee634bf,11,4,7,2,2,9,15,6,6,1,5,3,14,6,0,23,EL
aeed5c06,0,0,0,0,0,0,6,6,5,0,5,1,1,0,0,23,EL
af0c835b,11,4,6,5,0,5,13,8,6,0,6,3,14,7,0,23,EL
af50141d,9,5,4,5,0,7,11,4,2,0,2,5,14,0,1,23,EL
af686bed,7,5,5,1,1,3,8,5,8,1,7,10,17,8,0,23,EL
afb0c500,0,0,0,0,0,0,0,0,0,0,0,0,0,2,1,23,EL
b003239d,0,0,0,0,0,0,0,0,1,1,0,3,3,4,0,23,EL
b026bbf6,6,2,2,4,0,0,3,3,4,0,4,5,11,8,0,23,EL
b0f7e36c,6,4,5,1,0,1,5,4,3,1,2,2,8,1,0,23,EL
b146275b,6,2,0,5,1,3,5,2,0,0,0,2,8,4,0,23,EL
b1cd37e6,5,4,2,1,2,2,9,7,3,0,3,2,7,10,0,23,EL
b396a0b1,4,2,2,0,2,3,4,1,1,0,1,0,4,2,0,23,EL
b3af9be1,11,8,5,4,2,6,6,0,2,0,2,4,15,7,0,23,EL
b3dc6eca,1,0,1,0,0,1,1,0,3,2,1,7,8,4,0,23,EL
b5f66351,11,4,5,4,2,7,14,7,4,1,3,3,14,6,0,23,EL
b625b241,0,0,0,0,0,0,0,0,0,0,0,0,0,0,0,23,EL
b62878a5,3,2,0,2,1,0,0,0,1,0,1,1,4,2,0,23,EL
b66315ae,5,2,1,1,3,0,4,4,3,0,3,0,5,0,0,23,EL
b682dcf6,2,1,2,0,0,1,2,1,1,0,1,3,5,8,0,23,EL
b684a484,2,0,0,2,0,1,1,0,4,0,4,0,2,4,0,23,EL
b6964eb6,14,10,10,4,0,8,9,1,19,15,4,14,28,50,0,23,EL
b69dfb42,0,0,0,0,0,0,0,0,1,0,1,0,0,5,0,23,EL
b6a1cdf9,10,3,2,7,1,5,7,2,3,0,3,1,11,1,0,23,EL
b73f17f8,4,2,4,0,0,3,5,2,1,0,1,7,11,2,0,23,EL
b742cc0d,15,9,8,6,1,7,8,1,12,7,5,8,23,22,1,23,EL
b79d8e93,0,0,0,0,0,0,0,0,1,1,0,0,0,0,0,23,EL
b7b27de0,1,0,1,0,0,0,1,1,4,0,4,0,1,0,0,23,EL
b7de5bad,7,5,3,2,2,5,5,0,1,0,1,0,7,1,0,23,EL
b853e0ad,22,7,9,7,6,8,23,15,12,1,11,6,28,4,1,23,EL
b8814868,8,5,1,5,2,4,5,1,1,0,1,1,9,1,0,23,EL
b91a6912,2,0,1,1,0,2,4,2,1,0,1,2,4,0,0,23,EL
b9392438,4,4,1,3,0,2,2,0,7,0,7,2,6,4,0,23,EL
b956af7d,2,0,0,1,1,0,0,0,4,1,3,1,3,5,0,23,EL
ba3d3bea,3,1,0,3,0,2,3,1,6,3,3,4,7,3,0,23,EL
ba492306,6,3,5,0,1,3,5,2,1,0,1,2,8,5,0,23,EL
ba6d9ff6,3,1,2,1,0,1,3,2,0,0,0,1,4,0,0,23,EL
bac46a10,26,16,23,3,0,19,22,3,9,5,4,12,38,30,0,23,EL
bb598858,12,6,9,1,2,7,10,3,0,0,0,2,14,4,0,23,EL
bb718263,18,7,5,6,7,10,20,10,11,0,11,4,22,4,0,23,EL
bba30585,1,0,1,0,0,0,1,1,2,0,2,1,2,2,0,23,EL
bbf5c11b,0,0,0,0,0,0,0,0,0,0,0,2,2,0,0,23,EL
bc08556f,2,0,2,0,0,1,1,0,1,1,0,0,2,1,0,23,EL
bc6e544a,7,5,7,0,0,5,7,2,3,1,2,1,8,7,0,23,EL
bc7b4580,3,1,3,0,0,2,3,1,2,1,1,3,6,5,0,23,EL
bc7dc64d,5,3,0,1,4,3,7,4,4,1,3,2,7,1,0,23,EL
bced0375,22,14,15,5,2,13,20,7,9,5,4,5,27,4,1,23,EL
bceda5ff,0,0,0,0,0,0,1,1,0,0,0,0,0,0,0,23,EL
bcf5058a,0,0,0,0,0,0,0,0,0,0,0,0,0,2,0,23,EL
bd142efb,14,10,10,4,0,5,5,0,10,3,7,8,22,31,0,23,EL
bd2f622a,0,0,0,0,0,0,3,3,1,0,1,0,0,0,0,23,EL
bdf8165d,3,0,1,2,0,1,5,4,3,1,2,2,5,2,0,23,EL
be47b750,1,0,0,1,0,1,1,0,0,0,0,0,1,1,0,23,EL
be855308,0,0,0,0,0,0,0,0,0,0,0,0,0,2,0,23,EL
beb882a8,5,4,2,2,1,4,8,4,3,2,1,5,10,3,0,23,EL
bece776f,0,0,0,0,0,0,0,0,1,0,1,0,0,0,0,23,EL
bee0bab1,0,0,0,0,0,0,0,0,0,0,0,0,0,0,0,23,EL
bf075f6b,5,2,2,2,1,4,5,1,0,0,0,0,5,1,0,23,EL
bf12926c,2,0,0,1,1,1,3,2,5,0,5,1,3,1,0,23,EL
bf25cb29,2,2,1,0,1,1,1,0,0,0,0,0,2,0,0,23,EL
bf34eebd,1,0,1,0,0,0,0,0,0,0,0,1,2,1,0,23,EL
bf4c41f9,1,1,1,0,0,0,1,1,0,0,0,1,2,3,0,23,EL
bf80db4d,11,7,9,2,0,7,7,0,7,3,4,11,22,41,1,23,EL
bfc5768b,6,2,2,3,1,1,5,4,6,0,6,2,8,4,0,23,EL
c0347e9b,3,3,3,0,0,3,3,0,2,0,2,1,4,3,0,23,EL
c0a38fb2,0,0,0,0,0,0,0,0,0,0,0,0,0,0,0,23,EL
c13ddd3e,1,1,0,1,0,1,1,0,0,0,0,0,1,1,0,23,EL
c1851bfd,8,4,5,3,0,5,5,0,7,2,5,4,12,11,0,23,EL
c1949191,3,2,2,0,1,1,1,0,4,3,1,2,5,9,0,23,EL
c275947b,12,10,6,6,0,4,20,16,2,1,1,3,15,1,0,23,EL
c4987edc,21,12,13,6,2,12,21,9,7,2,5,13,34,33,1,23,EL
c4e87b8b,6,1,1,4,1,2,7,5,8,3,5,2,8,5,0,23,EL
c4f5eb61,3,1,2,1,0,1,1,0,0,0,0,0,3,0,0,23,EL
c54638ba,0,0,0,0,0,0,0,0,0,0,0,0,0,0,0,23,EL
c5bdb6e3,6,2,2,3,1,1,2,1,2,0,2,1,7,2,0,23,EL
c5cbbcff,4,2,4,0,0,1,2,1,1,1,0,0,4,3,0,23,EL
c63f6e46,2,2,1,0,1,1,2,1,3,0,3,0,2,0,0,23,EL
c6486b01,3,1,1,2,0,2,4,2,2,0,2,4,7,4,0,23,EL
c678ddd7,1,0,1,0,0,0,0,0,4,4,0,1,2,6,0,23,EL
c68b1b13,0,0,0,0,0,0,2,2,0,0,0,1,1,0,0,23,EL
c6cf860f,2,1,2,0,0,2,3,1,1,0,1,2,4,4,0,23,EL
c707411f,0,0,0,0,0,0,0,0,0,0,0,0,0,8,0,23,EL
c71e97ba,23,11,13,7,3,10,20,10,8,0,8,12,35,10,0,23,EL
c75f04f4,0,0,0,0,0,0,0,0,0,0,0,0,0,0,0,23,EL
c7842dab,11,3,3,8,0,2,8,6,8,3,5,5,16,4,0,23,EL
c9817014,24,16,10,11,3,15,21,6,7,1,6,5,29,7,0,23,EL
c997b942,3,3,2,1,0,1,2,1,3,0,3,2,5,0,0,23,EL
c9e39d91,14,6,3,9,2,9,19,10,13,0,13,9,23,3,0,23,EL
ca3478f9,0,0,0,0,0,0,0,0,0,0,0,0,0,0,0,23,EL
ca607d59,0,0,0,0,0,0,1,1,0,0,0,1,1,2,0,23,EL
ca618d23,6,3,5,1,0,2,8,6,4,0,4,1,7,3,0,23,EL
ca6edaa0,2,1,0,2,0,1,3,2,0,0,0,1,3,0,0,23,EL
cac2537b,4,3,0,1,3,2,7,5,4,0,4,2,6,3,0,23,EL
cad3fd4d,0,0,0,0,0,0,0,0,1,1,0,2,2,1,0,23,EL
cbeed9e6,0,0,0,0,0,0,0,0,0,0,0,0,0,0,0,23,EL
ccd38335,3,3,3,0,0,1,3,2,2,0,2,2,5,4,0,23,EL
cd6a1a59,10,5,4,4,2,4,7,3,8,3,5,14,24,3,0,23,EL
cf1ef7ec,3,2,1,2,0,2,5,3,1,0,1,2,5,3,0,23,EL
cf8ef0a1,2,2,2,0,0,1,2,1,4,0,4,3,5,1,0,23,EL
cf9bdd43,16,10,8,7,1,10,13,3,4,1,3,9,25,30,0,23,EL
cfd68aa7,0,0,0,0,0,0,0,0,0,0,0,0,0,0,1,23,EL
d01bbb6f,13,6,4,7,2,5,12,7,10,0,10,3,16,5,0,23,EL
d03380ec,1,1,1,0,0,0,1,1,3,1,2,3,4,1,0,23,EL
d080ed5e,15,8,2,9,4,6,11,5,9,5,4,12,27,4,0,23,EL
d0a0858e,8,3,4,3,1,5,8,3,1,0,1,2,10,2,0,23,EL
d0a39bdf,3,2,1,0,2,1,5,4,1,0,1,2,5,5,0,23,EL
d1b49282,11,8,7,3,1,7,13,6,8,0,8,4,15,5,0,23,EL
d2795011,6,4,5,0,1,5,7,2,1,0,1,2,8,5,0,23,EL
d2800f47,10,6,2,4,4,3,10,7,3,0,3,2,12,2,0,23,EL
d29202c2,1,1,0,1,0,0,0,0,0,0,0,1,2,1,0,23,EL
d2c580ce,10,4,5,2,3,5,6,1,3,2,1,3,13,4,0,23,EL
d2ddff2d,3,1,2,1,0,2,3,1,2,0,2,0,3,3,0,23,EL
d33c706e,0,0,0,0,0,0,0,0,0,0,0,0,0,0,0,23,EL
d3aaad90,10,6,2,3,5,1,4,3,2,1,1,1,11,2,0,23,EL
d4133fa1,4,2,1,3,0,2,6,4,7,2,5,9,13,13,0,23,EL
d4535821,6,4,6,0,0,5,5,0,1,0,1,0,6,9,0,23,EL
d46d048f,6,5,4,2,0,3,6,3,1,0,1,4,10,3,0,23,EL
d4808594,0,0,0,0,0,0,0,0,0,0,0,0,0,1,0,23,EL
d4822868,0,0,0,0,0,0,0,0,0,0,0,0,0,0,0,23,EL
d4aa40b8,1,0,0,1,0,0,1,1,0,0,0,0,1,0,0,23,EL
d5127c3f,5,3,3,2,0,4,8,4,5,0,5,0,5,5,0,23,EL
d5161564,0,0,0,0,0,0,0,0,0,0,0,0,0,0,0,23,EL
d5efd527,7,3,4,2,1,1,2,1,13,7,6,9,16,26,0,23,EL
d682f554,2,0,0,1,1,0,2,2,3,0,3,0,2,0,0,23,EL
d6f866ba,5,1,1,4,0,2,5,3,3,2,1,2,7,5,0,23,EL
d705ba44,7,5,1,2,4,2,12,10,8,1,7,4,11,3,0,23,EL
d7354a36,19,10,11,8,0,6,9,3,4,1,3,1,20,5,0,23,EL
d79a8c87,6,4,0,6,0,3,4,1,7,4,3,6,12,20,1,23,EL
d7abc42e,14,10,4,6,4,5,7,2,4,0,4,7,21,2,0,23,EL
d85c238b,4,2,2,2,0,1,3,2,2,0,2,3,7,1,0,23,EL
d87e2cae,2,2,0,1,1,2,3,1,0,0,0,1,3,9,0,23,EL
d8931174,5,3,4,1,0,1,1,0,3,2,1,4,9,11,1,23,EL
d8bffa70,5,4,5,0,0,5,6,1,2,1,1,4,9,4,0,23,EL
d93c2511,6,2,2,4,0,3,6,3,2,0,2,0,6,0,1,23,EL
d9565625,18,8,11,7,0,10,10,0,9,2,7,9,27,5,0,23,EL
d9764034,4,1,2,2,0,1,2,1,5,1,4,6,10,16,0,23,EL
d99830de,2,2,0,2,0,2,4,2,2,0,2,0,2,0,0,23,EL
d9ac09e2,1,0,0,0,1,1,1,0,2,1,1,0,1,4,0,23,EL
d9ba39fc,15,10,7,6,2,8,16,8,9,0,9,6,21,6,0,23,EL
d9d43555,3,1,0,2,1,0,3,3,2,0,2,0,3,0,0,23,EL
da4d670f,15,11,7,5,3,4,6,2,6,1,5,1,16,3,0,23,EL
da7f2781,18,9,11,5,2,13,19,6,4,0,4,10,28,12,1,23,EL
dbd1b101,0,0,0,0,0,0,0,0,0,0,0,0,0,0,0,23,EL
dbf053da,8,6,1,5,2,4,10,6,9,0,9,3,11,0,0,23,EL
dc3e663e,0,0,0,0,0,0,1,1,0,0,0,0,0,0,0,23,EL
dc45ac24,5,1,0,2,3,2,5,3,3,0,3,0,5,2,0,23,EL
dc52c72f,6,5,3,3,0,3,7,4,5,2,3,2,8,8,0,23,EL
dcfb17f4,7,1,0,5,2,3,8,5,4,0,4,2,9,2,0,23,EL
dd676a97,5,2,3,1,1,1,2,1,1,0,1,0,5,1,0,23,EL
dd95af65,0,0,0,0,0,0,0,0,0,0,0,0,0,0,0,23,EL
de488e56,3,3,2,1,0,3,4,1,2,1,1,1,4,6,0,23,EL
de4fe7a2,1,1,1,0,0,0,1,1,3,0,3,0,1,0,0,23,EL
de89f3c3,0,0,0,0,0,0,0,0,0,0,0,0,0,0,0,23,EL
dea698d9,1,1,0,1,0,0,1,1,1,0,1,0,1,1,0,23,EL
dead55e5,6,5,3,2,1,2,7,5,3,0,3,2,8,4,0,23,EL
dee86451,6,5,3,3,0,4,7,3,2,0,2,2,8,3,1,23,EL
df4153d2,0,0,0,0,0,0,0,0,0,0,0,0,0,0,0,23,EL
df8d6029,4,1,3,1,0,4,5,1,4,1,3,6,10,12,0,23,EL
dff153a4,6,2,5,1,0,3,7,4,0,0,0,3,9,4,0,23,EL
e08647d6,3,3,0,2,1,1,2,1,2,0,2,0,3,0,0,23,EL
e0921a4f,5,2,4,0,1,3,12,9,9,2,7,3,8,3,0,23,EL
e09436fb,0,0,0,0,0,0,0,0,1,1,0,0,0,0,0,23,EL
e0b113a7,12,8,6,4,2,4,7,3,8,4,4,7,19,5,1,23,EL
e0b5ac38,1,0,0,1,0,1,3,2,0,0,0,0,1,0,0,23,EL
e0f3a1f6,10,4,7,1,2,7,8,1,4,1,3,8,18,29,1,23,EL
e150254d,10,7,3,7,0,3,5,2,5,2,3,1,11,3,0,23,EL
e1bbb68d,0,0,0,0,0,0,1,1,1,0,1,0,0,2,0,23,EL
e2716bd0,5,3,1,3,1,0,7,7,6,0,6,3,8,2,0,23,EL
e280527c,3,2,0,2,1,0,2,2,0,0,0,0,3,5,0,23,EL
e3d3fbeb,3,3,2,1,0,2,5,3,1,0,1,5,8,3,0,23,EL
e4114f5d,13,10,6,5,2,3,10,7,8,2,6,6,19,6,0,23,EL
e4d5e2ae,2,1,0,1,1,2,3,1,0,0,0,1,3,0,0,23,EL
e61b8aee,12,9,2,7,3,4,8,4,5,4,1,2,14,5,0,23,EL
e63c5181,11,5,4,6,1,4,14,10,13,1,12,5,16,5,0,23,EL
e65a7469,1,0,1,0,0,0,2,2,2,0,2,0,1,0,0,23,EL
e66e4ddc,1,1,0,1,0,0,0,0,2,1,1,0,1,2,0,23,EL
e6ad16b2,6,3,3,3,0,4,6,2,5,0,5,0,6,3,0,23,EL
e73c9bb2,7,4,4,3,0,5,7,2,4,2,2,5,12,8,0,23,EL
e7aa9d7c,2,0,1,1,0,0,0,0,1,0,1,0,2,2,0,23,EL
e7fcf289,7,4,2,4,1,1,9,8,12,1,11,0,7,2,0,23,EL
e82adcab,27,17,9,14,4,9,22,13,12,0,12,9,36,7,0,23,EL
e8ef59da,0,0,0,0,0,0,0,0,3,1,2,0,0,2,0,23,EL
e92cd3f7,2,2,0,1,1,0,1,1,3,2,1,0,2,4,0,23,EL
ea39a081,5,3,1,3,1,3,5,2,1,0,1,0,5,0,0,23,EL
ea770abf,15,10,9,5,1,4,7,3,6,4,2,11,26,18,0,23,EL
ea83bfa6,0,0,0,0,0,0,0,0,0,0,0,0,0,0,0,23,EL
eab85789,1,1,0,1,0,0,2,2,3,0,3,2,3,1,0,23,EL
ead61f73,11,6,6,3,2,8,12,4,6,1,5,2,13,12,0,23,EL
eb2b33aa,0,0,0,0,0,0,0,0,0,0,0,0,0,1,1,23,EL
eb58eef0,0,0,0,0,0,0,4,4,2,2,0,3,3,7,0,23,EL
eb7822d7,30,16,12,13,5,17,31,14,20,8,12,22,52,16,0,23,EL
ec48abb1,1,0,0,1,0,1,1,0,1,1,0,2,3,0,0,23,EL
ec61b68f,4,3,4,0,0,2,5,3,9,2,7,2,6,1,1,23,EL
eca2b6b8,0,0,0,0,0,0,0,0,1,0,1,1,1,0,0,23,EL
ed1cc44a,8,3,6,1,1,3,3,0,4,4,0,4,12,16,1,23,EL
ed45a7d7,1,0,1,0,0,1,1,0,0,0,0,0,1,1,0,23,EL
eda8506a,2,0,0,2,0,1,3,2,0,0,0,3,5,2,0,23,EL
ee3519f5,12,5,7,4,1,5,16,11,9,4,5,4,16,10,0,23,EL
ee45fd85,12,7,1,10,1,7,13,6,6,0,6,9,21,5,1,23,EL
ef2ad14e,1,0,1,0,0,1,2,1,1,1,0,3,4,5,0,23,EL
ef322658,13,10,5,8,0,8,12,4,3,0,3,7,20,1,0,23,EL
ef3909cd,0,0,0,0,0,0,0,0,0,0,0,0,0,3,0,23,EL
ef491564,1,1,0,0,1,1,2,1,0,0,0,0,1,0,0,23,EL
ef83dfcc,0,0,0,0,0,0,2,2,1,1,0,3,3,7,0,23,EL
efc33b33,0,0,0,0,0,0,0,0,0,0,0,1,1,0,0,23,EL
f0f64209,0,0,0,0,0,0,0,0,0,0,0,0,0,0,0,23,EL
f24ea523,6,3,2,1,3,1,5,4,1,0,1,3,9,0,0,23,EL
f28876e5,1,1,0,1,0,1,1,0,0,0,0,0,1,1,0,23,EL
f2c1300a,2,2,2,0,0,0,1,1,5,3,2,4,6,10,0,23,EL
f32a988d,2,0,1,0,1,1,3,2,2,0,2,2,4,0,0,23,EL
f360f047,1,0,0,0,1,0,1,1,0,0,0,0,1,0,0,23,EL
f38a247a,1,0,0,1,0,1,1,0,0,0,0,2,3,3,0,23,EL
f3fa599d,11,6,7,3,1,7,14,7,6,1,5,12,23,16,0,23,EL
f40dd3c7,24,16,13,5,6,12,24,12,16,5,11,23,47,24,0,23,EL
f4290206,0,0,0,0,0,0,0,0,2,2,0,1,1,1,0,23,EL
f47a530a,7,4,1,5,1,2,4,2,2,1,1,4,11,1,0,23,EL
f50a668a,6,4,5,1,0,2,3,1,5,4,1,7,13,23,0,23,EL
f512a009,12,7,4,5,3,6,7,1,2,1,1,2,14,1,0,23,EL
f521b80a,12,9,8,3,1,9,12,3,5,3,2,13,25,20,0,23,EL
f54d2149,7,3,2,5,0,3,8,5,8,3,5,5,12,3,0,23,EL
f586779e,12,6,3,5,4,3,4,1,9,1,8,0,12,4,0,23,EL
f5c8b425,0,0,0,0,0,0,2,2,1,0,1,0,0,0,0,23,EL
f5deef4c,9,5,6,3,0,5,7,2,3,3,0,2,11,17,0,23,EL
f5e7fdf9,7,6,4,3,0,4,6,2,7,2,5,3,10,4,0,23,EL
f620b04f,1,1,1,0,0,1,1,0,0,0,0,0,1,2,0,23,EL
f63a8347,1,1,1,0,0,1,1,0,0,0,0,0,1,2,0,23,EL
f6798fc3,0,0,0,0,0,0,0,0,0,0,0,0,0,1,0,23,EL
f67c9d29,19,15,7,12,0,8,9,1,6,1,5,13,32,24,0,23,EL
f6af14b0,8,5,2,4,2,2,5,3,5,3,2,4,12,4,0,23,EL
f6bdc830,6,2,4,2,0,2,2,0,1,1,0,0,6,5,0,23,EL
f7223718,1,1,1,0,0,1,2,1,2,1,1,2,3,7,1,23,EL
f7dc2ae5,9,5,7,2,0,7,10,3,5,4,1,4,13,6,1,23,EL
f7e87032,9,2,4,3,2,4,6,2,4,0,4,1,10,3,0,23,EL
f833a830,2,2,1,1,0,0,3,3,5,0,5,0,2,0,0,23,EL
f8405304,0,0,0,0,0,0,2,2,1,0,1,0,0,1,0,23,EL
f874dd44,4,1,3,0,1,4,4,0,0,0,0,2,6,0,0,23,EL
f8766ef9,8,4,5,3,0,3,9,6,13,6,7,13,21,55,0,23,EL
f893dba4,11,9,6,3,2,9,16,7,6,3,3,7,18,14,0,23,EL
f91e81c9,6,3,4,2,0,2,4,2,0,0,0,1,7,14,0,23,EL
f91fa277,1,1,1,0,0,1,1,0,0,0,0,0,1,1,0,23,EL
f93e6e94,5,2,3,0,2,3,6,3,1,0,1,3,8,9,0,23,EL
f99360b9,7,3,3,3,1,3,13,10,10,5,5,6,13,7,0,23,EL
f9de9c23,0,0,0,0,0,0,0,0,0,0,0,0,0,0,0,23,EL
f9edc384,11,6,5,5,1,3,4,1,5,2,3,3,14,7,0,23,EL
fa066690,2,0,1,1,0,2,2,0,2,1,1,5,7,9,0,23,EL
fa73ccc7,17,8,8,5,4,5,11,6,7,1,6,15,32,3,0,23,EL
fa94d227,0,0,0,0,0,0,0,0,0,0,0,0,0,0,0,23,EL
faed84db,5,2,1,3,1,3,5,2,3,1,2,0,5,10,0,23,EL
fb485406,2,1,0,1,1,2,4,2,4,0,4,0,2,0,0,23,EL
fbbb9269,6,5,5,1,0,4,4,0,3,1,2,6,12,7,0,23,EL
fc46aab1,10,6,4,4,2,7,12,5,6,1,5,5,15,2,0,23,EL
fc9b373e,3,2,1,2,0,1,2,1,1,0,1,3,6,2,0,23,EL
fce2302c,6,3,2,3,1,3,6,3,3,2,1,2,8,5,0,23,EL
fcea4f04,0,0,0,0,0,0,0,0,0,0,0,0,0,1,0,23,EL
fd9c4805,1,0,1,0,0,1,8,7,1,0,1,1,2,0,0,23,EL
fe6e7156,1,1,0,1,0,1,1,0,0,0,0,0,1,0,0,23,EL
feb5d3ab,10,7,9,1,0,2,8,6,5,1,4,4,14,5,0,23,EL
fef20ac5,7,7,4,2,1,4,4,0,0,0,0,1,8,2,0,23,EL
ff711ca2,10,5,5,3,2,5,11,6,3,0,3,3,13,3,1,23,EL
ff74841d,0,0,0,0,0,0,0,0,0,0,0,0,0,1,0,23,EL
ffa90327,2,0,1,1,0,2,3,1,3,0,3,1,3,3,0,23,EL
fffea3e5,3,3,1,1,1,1,4,3,1,0,1,0,3,0,0,23,EL
004d185e,33,21,18,13,2,15,36,21,23,3,20,25,58,28,0,23,SPA
0076ab7f,43,33,22,18,3,20,33,13,39,29,10,34,77,102,1,23,SPA
00b28772,41,30,17,18,6,19,32,13,36,14,22,34,75,27,0,23,SPA
00eba9c9,15,9,7,8,0,5,8,3,2,0,2,5,20,2,0,23,SPA
0107757e,0,0,0,0,0,0,1,1,0,0,0,0,0,0,0,23,SPA
014aa7bd,27,15,13,11,3,15,25,10,16,4,12,13,40,15,0,23,SPA
01a49bd2,19,11,11,5,3,10,12,2,14,5,9,13,32,30,1,23,SPA
01eb744d,12,6,6,3,3,5,16,11,17,0,17,10,22,6,1,23,SPA
02319ad7,13,10,4,5,4,7,22,15,7,2,5,3,16,6,0,23,SPA
02c15616,32,15,16,10,6,17,30,13,26,2,24,17,49,19,0,23,SPA
02d2c436,33,21,25,7,1,22,36,14,31,24,7,31,64,145,0,23,SPA
02ef8778,3,2,0,1,2,2,6,4,4,0,4,0,3,6,0,23,SPA
03049c8c,15,8,7,5,3,7,13,6,8,2,6,11,26,8,0,23,SPA
036bba5f,43,31,24,18,1,19,54,35,23,8,15,19,62,37,0,23,SPA
04965583,11,5,6,3,2,4,22,18,21,2,19,15,26,14,0,23,SPA
04e17fd5,16,8,3,7,6,4,14,10,6,2,4,4,20,16,0,23,SPA
04e531b6,2,1,0,1,1,2,4,2,1,0,1,2,4,1,0,23,SPA
05439de2,15,11,8,4,3,9,15,6,18,9,9,14,29,37,1,23,SPA
056269d7,37,21,27,9,1,25,32,7,10,4,6,12,49,25,0,23,SPA
05e19d6a,15,9,6,6,3,8,18,10,10,2,8,12,27,11,2,23,SPA
068f4dec,3,3,3,0,0,1,5,4,2,0,2,0,3,3,0,23,SPA
06efa9dc,27,16,19,6,2,12,22,10,22,6,16,14,41,41,0,23,SPA
070a3904,69,38,12,43,14,29,73,44,34,2,32,24,93,23,0,23,SPA
075fe5a3,28,18,20,8,0,15,32,17,34,22,12,29,57,124,1,23,SPA
0959c2a2,31,20,14,11,6,13,26,13,31,4,27,17,48,15,0,23,SPA
0a0cc13c,6,4,0,4,2,3,6,3,6,0,6,0,6,4,0,23,SPA
0a69de7b,1,1,1,0,0,0,0,0,4,3,1,5,6,23,0,23,SPA
0abc51f2,9,7,7,2,0,4,7,3,10,8,2,6,15,44,0,23,SPA
0ae4e09a,11,6,5,5,1,2,13,11,11,0,11,3,14,14,0,23,SPA
0b2c8585,18,12,8,9,1,8,18,10,10,3,7,8,26,6,0,23,SPA
0ba976e4,16,9,8,4,4,5,18,13,19,0,19,5,21,6,0,23,SPA
0bc4e720,4,1,1,2,1,1,6,5,2,0,2,1,5,3,0,23,SPA
0cadc46d,12,7,4,7,1,3,13,10,19,7,12,12,24,73,0,23,SPA
0d9b2d31,39,22,15,17,7,13,45,32,27,0,27,13,52,8,1,23,SPA
0da6a13e,28,20,11,14,3,17,40,23,21,2,19,6,34,14,0,23,SPA
0e4fef6e,48,32,28,15,5,18,42,24,24,3,21,42,90,64,1,23,SPA
0e5ddc7c,2,1,1,1,0,1,2,1,0,0,0,1,3,0,0,23,SPA
0f26ffd7,53,28,35,16,2,26,36,10,38,17,21,44,97,111,2,23,SPA
10072610,0,0,0,0,0,0,0,0,0,0,0,2,2,1,1,23,SPA
106c142c,13,8,9,1,3,6,11,5,4,0,4,1,14,8,0,23,SPA
112521d1,5,1,5,0,0,4,7,3,1,1,0,5,10,3,0,23,SPA
114bbdee,27,20,23,3,1,17,30,13,21,13,8,23,50,77,0,23,SPA
11b9265b,23,12,10,10,3,11,24,13,12,1,11,23,46,26,0,23,SPA
11fd2b75,53,26,32,19,2,31,64,33,51,19,32,45,98,54,1,23,SPA
129af0db,16,11,4,8,4,3,8,5,11,3,8,0,16,23,0,23,SPA
12c50af5,26,20,12,12,2,13,45,32,11,1,10,5,31,4,0,23,SPA
130a7a3f,21,12,8,9,4,8,40,32,21,2,19,9,30,2,0,23,SPA
132ac341,21,15,17,4,0,12,25,13,34,21,13,28,49,96,1,23,SPA
133faa84,2,2,1,1,0,1,1,0,3,3,0,6,8,14,0,23,SPA
139560df,3,2,3,0,0,1,2,1,1,0,1,1,4,6,0,23,SPA
13e0eb29,2,2,0,2,0,1,2,1,3,0,3,0,2,1,1,23,SPA
14d5b7ac,0,0,0,0,0,0,0,0,0,0,0,0,0,1,0,23,SPA
1545cf15,19,11,16,3,0,11,27,16,12,2,10,7,26,23,1,23,SPA
15937e17,35,23,24,10,1,17,33,16,23,8,15,29,64,76,1,23,SPA
15d0c248,34,23,23,11,0,18,34,16,43,24,19,28,62,106,0,23,SPA
162efffd,35,21,11,18,6,18,35,17,20,3,17,8,43,7,0,23,SPA
1633fc8a,19,11,10,9,0,11,17,6,12,9,3,10,29,60,1,23,SPA
1657f448,16,9,10,4,2,9,26,17,8,1,7,2,18,10,1,23,SPA
16aa3654,44,26,18,16,10,16,38,22,29,1,28,9,53,4,0,23,SPA
16e9d0ea,29,22,19,10,0,18,36,18,17,4,13,17,46,39,0,23,SPA
175ece4c,1,0,0,1,0,0,3,3,2,1,1,3,4,8,0,23,SPA
18017beb,0,0,0,0,0,0,1,1,0,0,0,0,0,0,0,23,SPA
1840e36d,1,0,1,0,0,1,1,0,0,0,0,3,4,7,1,23,SPA
184fe4b2,3,1,1,0,2,0,0,0,2,0,2,0,3,1,0,23,SPA
18abe173,51,36,33,17,1,16,28,12,26,14,12,31,82,150,0,23,SPA
18b896d6,18,16,12,5,1,14,23,9,23,13,10,19,37,74,0,23,SPA
192c89a6,5,2,2,1,2,2,5,3,2,1,1,2,7,1,0,23,SPA
1944818c,25,18,11,11,3,12,20,8,7,2,5,5,30,10,0,23,SPA
19709006,32,25,12,15,5,13,28,15,16,2,14,24,56,15,0,23,SPA
19b776e9,55,37,29,17,9,23,56,33,33,3,30,24,79,20,1,23,SPA
19c36442,48,30,21,18,9,19,44,25,13,1,12,32,80,25,1,23,SPA
19cae58d,47,31,7,30,10,21,55,34,32,5,27,18,65,22,0,23,SPA
1bacc518,46,26,16,21,9,17,41,24,11,1,10,35,81,22,1,23,SPA
1bda5842,28,21,14,10,4,18,42,24,23,3,20,17,45,20,1,23,SPA
1c2c55fc,10,5,8,2,0,4,8,4,8,6,2,10,20,33,0,23,SPA
1cb49278,20,15,9,11,0,10,16,6,14,12,2,21,41,47,0,23,SPA
1d1691ad,0,0,0,0,0,0,0,0,0,0,0,0,0,0,0,23,SPA
1e465e70,0,0,0,0,0,0,0,0,1,0,1,0,0,0,0,23,SPA
1f079188,32,18,10,18,4,20,41,21,23,8,15,17,49,31,0,23,SPA
1fc474ae,16,8,11,2,3,9,22,13,8,2,6,7,23,22,0,23,SPA
1fda2b14,0,0,0,0,0,0,0,0,0,0,0,0,0,0,0,23,SPA
1fe67e86,4,4,1,2,1,4,4,0,0,0,0,1,5,2,0,23,SPA
200e89e1,21,15,15,6,0,12,28,16,15,1,14,5,26,7,0,23,SPA
211589b8,1,0,0,1,0,0,0,0,2,0,2,0,1,0,0,23,SPA
220c11f1,13,6,2,7,4,5,14,9,10,0,10,2,15,5,0,23,SPA
22721b88,3,2,3,0,0,1,3,2,3,0,3,4,7,7,0,23,SPA
228b0d9d,38,23,17,17,4,22,47,25,26,5,21,9,47,38,0,23,SPA
23610943,69,43,38,18,13,39,91,52,38,7,31,18,87,63,1,23,SPA
237a3851,67,33,30,32,5,25,68,43,26,7,19,20,87,28,0,23,SPA
240d3a0b,46,27,17,25,4,29,47,18,21,6,15,19,65,21,1,23,SPA
2475cf9b,29,16,18,9,2,14,23,9,20,7,13,15,44,53,0,23,SPA
253a06b9,8,5,2,4,2,6,23,17,12,1,11,8,16,16,0,23,SPA
2683eda7,20,11,12,5,3,12,28,16,12,2,10,10,30,14,0,23,SPA
274ab13c,29,14,23,4,2,13,27,14,32,25,7,28,57,159,1,23,SPA
2784f898,46,32,25,18,3,26,33,7,67,39,28,42,88,104,2,23,SPA
283c7121,34,20,16,15,3,13,23,10,7,0,7,12,46,20,0,23,SPA
28e957d7,17,9,10,7,0,10,18,8,19,12,7,14,31,101,0,23,SPA
2946f9a1,24,16,17,5,2,12,29,17,11,6,5,18,42,37,0,23,SPA
29d0f2ac,48,34,31,13,4,29,47,18,32,8,24,15,63,60,0,23,SPA
2a0c8ba4,32,17,13,17,2,16,38,22,14,7,7,16,48,14,2,23,SPA
2a295d33,66,43,17,37,12,26,72,46,34,0,34,18,84,16,0,23,SPA
2ae30661,4,2,2,1,1,3,5,2,2,0,2,1,5,2,0,23,SPA
2bea832e,5,4,2,0,3,1,1,0,3,1,2,1,6,8,0,23,SPA
2bed3eab,24,16,16,5,3,9,20,11,23,10,13,19,43,36,1,23,SPA
2bef2bca,26,18,12,13,1,6,9,3,15,7,8,12,38,41,1,23,SPA
2c56a792,27,15,11,13,3,9,25,16,21,7,14,19,46,16,0,23,SPA
2dce876a,29,20,12,9,8,15,32,17,24,8,16,15,44,26,1,23,SPA
2dd7e29d,4,2,2,2,0,2,3,1,2,0,2,1,5,0,0,23,SPA
2e3995cd,18,15,12,5,1,8,21,13,13,0,13,3,21,3,0,23,SPA
2f456b86,0,0,0,0,0,0,0,0,1,0,1,0,0,0,0,23,SPA
2fa2a875,0,0,0,0,0,0,0,0,0,0,0,0,0,3,2,23,SPA
2fbe6af0,0,0,0,0,0,0,0,0,0,0,0,0,0,0,0,23,SPA
30061f53,0,0,0,0,0,0,0,0,0,0,0,0,0,0,0,23,SPA
3061e1ec,0,0,0,0,0,0,0,0,0,0,0,0,0,1,0,23,SPA
31f5b89b,16,9,13,3,0,13,20,7,2,2,0,12,28,17,1,23,SPA
32974271,21,14,6,11,4,5,16,11,11,0,11,5,26,14,0,23,SPA
335039a2,31,20,18,8,5,14,41,27,18,3,15,9,40,19,1,23,SPA
3353737a,7,5,5,2,0,5,7,2,3,0,3,2,9,4,0,23,SPA
335fa267,22,15,12,6,4,7,18,11,15,7,8,11,33,16,0,23,SPA
3376a776,11,5,8,3,0,4,5,1,12,5,7,10,21,24,0,23,SPA
33a61a52,75,51,55,16,4,31,50,19,29,7,22,28,103,94,1,23,SPA
3409de86,23,12,10,7,6,9,17,8,7,0,7,5,28,2,1,23,SPA
3423f250,29,19,10,7,12,11,31,20,33,1,32,14,43,11,1,23,SPA
34269bdf,47,25,21,21,5,18,37,19,29,11,18,19,66,37,0,23,SPA
34e393f2,115,75,59,50,6,54,101,47,58,14,44,42,157,76,1,23,SPA
3521abfe,1,1,0,1,0,1,2,1,1,1,0,0,1,7,0,23,SPA
35440884,0,0,0,0,0,0,0,0,2,0,2,2,2,0,0,23,SPA
35a6e5c7,43,19,14,25,4,16,52,36,30,3,27,21,64,6,0,23,SPA
35d4f151,30,15,18,9,3,20,29,9,14,4,10,18,48,18,0,23,SPA
35f6db55,32,20,13,16,3,13,33,20,17,2,15,19,51,12,0,23,SPA
360d70f8,1,0,0,1,0,1,1,0,0,0,0,0,1,0,0,23,SPA
3701906c,29,13,7,17,5,12,35,23,19,2,17,8,37,24,0,23,SPA
374d5158,26,15,12,14,0,15,29,14,25,7,18,19,45,38,0,23,SPA
374ee424,1,1,1,0,0,1,3,2,0,0,0,0,1,17,3,23,SPA
379dc075,2,1,1,1,0,0,4,4,8,0,8,1,3,7,0,23,SPA
37e103f8,15,12,2,6,7,7,17,10,11,1,10,2,17,7,1,23,SPA
37f1cf47,1,1,1,0,0,1,5,4,5,0,5,0,1,2,0,23,SPA
37f827ec,33,13,23,10,0,15,24,9,22,15,7,17,50,63,1,23,SPA
381dbcfc,1,1,0,1,0,1,1,0,4,2,2,3,4,8,0,23,SPA
3828f130,16,13,7,4,5,9,20,11,8,1,7,11,27,9,0,23,SPA
38699c72,6,4,1,4,1,1,7,6,12,1,11,3,9,17,0,23,SPA
38b0cf42,0,0,0,0,0,0,0,0,0,0,0,0,0,1,0,23,SPA
3902e91b,32,16,9,18,5,11,39,28,23,2,21,7,39,19,1,23,SPA
39352da2,22,14,10,7,5,12,17,5,7,0,7,11,33,6,0,23,SPA
3a9c4b7b,27,14,16,6,5,17,32,15,17,4,13,19,46,33,1,23,SPA
3aa4a3be,2,2,0,1,1,0,0,0,0,0,0,0,2,1,0,23,SPA
3aa74860,0,0,0,0,0,0,0,0,0,0,0,0,0,0,0,23,SPA
3c16d927,37,19,17,17,3,27,53,26,30,5,25,26,63,45,1,23,SPA
3ca6106c,10,6,6,3,1,3,11,8,5,0,5,4,14,3,0,23,SPA
3cefcaef,21,12,14,6,1,12,20,8,7,2,5,14,35,16,0,23,SPA
3d79a68c,1,1,1,0,0,0,3,3,0,0,0,0,1,1,0,23,SPA
3d7e48ce,32,21,19,9,4,17,37,20,18,3,15,5,37,12,1,23,SPA
3d99999d,4,4,1,2,1,1,2,1,2,0,2,0,4,1,0,23,SPA
3e42f707,34,20,22,12,0,19,22,3,28,13,15,45,79,151,0,23,SPA
3e93f8cf,11,8,4,6,1,5,18,13,9,3,6,6,17,15,0,23,SPA
3ecc11d8,34,23,26,7,1,24,31,7,23,13,10,48,82,101,0,23,SPA
3ee0dd59,59,33,23,30,6,24,45,21,44,17,27,37,96,55,4,23,SPA
3f034750,0,0,0,0,0,0,0,0,0,0,0,0,0,9,1,23,SPA
3f10bd22,19,12,8,3,8,11,22,11,18,7,11,22,41,52,1,23,SPA
3f79a1c8,36,24,15,20,1,15,29,14,18,4,14,17,53,26,1,23,SPA
3fc45c73,18,8,11,7,0,6,9,3,17,11,6,18,36,55,0,23,SPA
405f267a,13,8,5,5,3,2,8,6,0,0,0,2,15,2,0,23,SPA
4112ace5,3,1,0,3,0,1,6,5,5,0,5,1,4,1,0,23,SPA
41b3069f,46,29,27,15,4,21,34,13,31,13,18,13,59,52,0,23,SPA
41f32541,34,23,14,17,3,18,30,12,21,10,11,24,58,29,0,23,SPA
41fb0f4e,3,2,2,1,0,1,3,2,5,0,5,3,6,1,0,23,SPA
4242011c,6,2,2,4,0,3,9,6,17,10,7,12,18,70,2,23,SPA
436a9dd0,18,10,8,7,3,6,18,12,12,3,9,11,29,12,0,23,SPA
44150beb,16,10,10,6,0,6,10,4,9,6,3,12,28,37,1,23,SPA
44330c36,0,0,0,0,0,0,2,2,0,0,0,0,0,1,0,23,SPA
44e07fac,12,9,2,7,3,4,11,7,8,3,5,1,13,19,0,23,SPA
44e8521b,0,0,0,0,0,0,1,1,0,0,0,0,0,0,0,23,SPA
455c26a4,0,0,0,0,0,0,0,0,0,0,0,0,0,0,0,23,SPA
45736cec,19,10,3,10,6,8,15,7,12,2,10,9,28,6,1,23,SPA
45af8a54,16,10,8,6,2,8,19,11,8,3,5,5,21,4,0,23,SPA
45d96179,0,14,0,0,0,0,0,0,0,0,0,19,0,0,0,23,SPA
45e17712,31,19,17,8,6,20,28,8,19,3,16,14,45,40,0,23,SPA
4601e194,25,18,13,11,1,12,28,16,12,5,7,11,36,23,0,23,SPA
4737cebe,0,0,0,0,0,0,1,1,0,0,0,1,1,0,0,23,SPA
475a738b,0,0,0,0,0,0,0,0,0,0,0,0,0,0,0,23,SPA
47c609d5,4,3,2,1,1,0,3,3,6,1,5,1,5,23,0,23,SPA
485e4939,1,1,1,0,0,1,1,0,2,0,2,0,1,0,0,23,SPA
4958bfb2,32,18,15,12,5,18,35,17,24,6,18,15,47,49,0,23,SPA
49a6ecbb,2,1,1,0,1,1,1,0,0,0,0,0,2,1,0,23,SPA
49d028db,28,19,18,7,3,14,27,13,12,9,3,21,49,120,0,23,SPA
49dbab27,45,30,11,23,11,24,66,42,42,3,39,17,62,30,0,23,SPA
4a478107,7,6,1,2,4,5,17,12,12,1,11,2,9,2,0,23,SPA
4a5f2032,0,0,0,0,0,0,0,0,4,2,2,1,1,6,0,23,SPA
4a633cfe,23,13,13,8,2,12,17,5,23,14,9,19,42,60,2,23,SPA
4ac7608e,12,7,9,3,0,7,11,4,14,12,2,7,19,50,1,23,SPA
4accb7e0,29,20,12,10,7,12,23,11,14,2,12,12,41,9,0,23,SPA
4acd733a,12,6,4,6,2,5,9,4,8,1,7,10,22,9,1,23,SPA
4b511457,70,38,36,26,8,26,51,25,48,10,38,37,107,54,0,23,SPA
4bd414c1,25,17,17,6,2,14,18,4,17,13,4,14,39,111,0,23,SPA
4c2e9442,0,0,0,0,0,0,0,0,0,0,0,0,0,2,0,23,SPA
4c3a6744,17,14,7,4,6,6,12,6,4,0,4,7,24,4,0,23,SPA
4c5b14d2,3,3,2,1,0,1,3,2,7,2,5,4,7,5,0,23,SPA
4cee5954,24,14,12,10,2,17,26,9,20,8,12,14,38,34,0,23,SPA
4d1666ff,37,23,18,13,6,21,31,10,24,9,15,19,56,61,3,23,SPA
4d224fe8,0,0,0,0,0,0,0,0,0,0,0,0,0,1,0,23,SPA
4dbd0916,30,18,10,13,7,10,28,18,12,3,9,7,37,12,0,23,SPA
4e219ad2,16,10,5,7,4,10,22,12,7,1,6,2,18,3,0,23,SPA
4f255115,64,40,23,36,5,23,38,15,20,6,14,49,113,50,0,23,SPA
5083a734,26,9,9,14,3,6,15,9,14,1,13,4,30,12,0,23,SPA
50cbc806,4,3,0,3,1,2,4,2,0,0,0,2,6,4,0,23,SPA
5132b92c,39,18,23,10,6,12,20,8,12,2,10,15,54,24,0,23,SPA
518f2234,30,17,9,15,6,15,45,30,15,3,12,7,37,16,0,23,SPA
51a3c4c8,3,2,1,2,0,2,4,2,2,2,0,0,3,7,0,23,SPA
527f063d,7,4,3,3,1,3,15,12,10,3,7,2,9,11,0,23,SPA
532e1e4f,43,25,25,13,5,23,36,13,36,27,9,13,56,146,3,23,SPA
540ec57b,62,38,25,20,17,21,56,35,41,4,37,15,77,36,0,23,SPA
5487adcd,11,9,5,6,0,3,7,4,13,5,8,9,20,36,2,23,SPA
5496cc91,2,0,2,0,0,0,0,0,2,0,2,0,2,0,0,23,SPA
54bcdeb0,66,35,31,24,11,23,70,47,40,0,40,12,78,10,1,23,SPA
55126f3b,55,38,23,25,7,28,72,44,35,13,22,20,75,19,0,23,SPA
555f3a0b,22,15,14,6,2,9,30,21,19,9,10,19,41,85,1,23,SPA
55634fb8,5,5,5,0,0,3,7,4,18,10,8,11,16,28,0,23,SPA
56545648,0,0,0,0,0,0,1,1,0,0,0,1,1,0,0,23,SPA
56bcaaa0,1,1,0,1,0,0,0,0,0,0,0,0,1,0,0,23,SPA
5757adc3,2,1,1,0,1,1,1,0,1,0,1,0,2,0,0,23,SPA
57be54ec,0,0,0,0,0,0,0,0,0,0,0,0,0,1,0,23,SPA
5853ac44,20,15,10,9,1,8,11,3,8,5,3,16,36,44,3,23,SPA
58a9a4d9,39,23,12,13,14,18,59,41,26,5,21,10,49,10,0,23,SPA
58ad9383,0,0,0,0,0,0,2,2,0,0,0,0,0,16,1,23,SPA
58afe001,14,6,9,4,1,3,17,14,17,5,12,14,28,19,0,23,SPA
592f3158,92,51,29,50,13,46,121,75,60,9,51,44,136,30,0,23,SPA
59b7d823,24,17,20,4,0,12,19,7,16,2,14,13,37,31,1,23,SPA
5a626448,26,17,9,14,3,15,32,17,15,3,12,10,36,5,1,23,SPA
5ab0ea87,58,26,24,26,8,29,51,22,32,6,26,27,85,36,2,23,SPA
5acc4a10,21,12,6,13,2,10,18,8,12,5,7,19,40,20,1,23,SPA
5ae499d0,71,44,24,41,6,38,82,44,39,3,36,32,103,17,0,23,SPA
5b28b2f6,25,20,20,5,0,14,27,13,8,0,8,7,32,15,1,23,SPA
5b93209a,5,3,2,2,1,3,3,0,2,0,2,3,8,5,0,23,SPA
5c4dc0ff,1,0,0,1,0,0,0,0,1,0,1,0,1,0,0,23,SPA
5c7845f6,35,18,28,7,0,25,35,10,23,17,6,21,56,93,0,23,SPA
5c96b017,20,11,12,4,4,7,24,17,14,1,13,12,32,13,0,23,SPA
5ca20b7a,15,8,10,4,1,7,10,3,4,2,2,11,26,22,0,23,SPA
5ccc9672,42,30,22,16,4,24,41,17,25,3,22,12,54,17,1,23,SPA
5ce0b5ba,36,18,10,22,4,16,44,28,27,8,19,18,54,20,0,23,SPA
5cec2487,13,8,9,4,0,10,12,2,6,1,5,9,22,14,1,23,SPA
5d133e96,3,3,2,1,0,1,1,0,2,0,2,1,4,3,0,23,SPA
5db04597,75,46,54,16,5,45,78,33,38,11,27,26,101,76,0,23,SPA
5dcf3e90,2,0,2,0,0,1,1,0,1,0,1,0,2,9,3,23,SPA
5dfc6ad5,36,22,22,11,3,17,31,14,20,11,9,23,59,76,0,23,SPA
5e1028e5,76,46,29,36,11,33,66,33,33,1,32,36,112,16,0,23,SPA
5e95c000,20,11,9,9,2,7,14,7,14,7,7,14,34,23,1,23,SPA
5eebbfdf,6,2,3,3,0,2,4,2,2,0,2,1,7,0,0,23,SPA
5f21b94c,2,2,2,0,0,2,5,3,1,1,0,0,2,1,0,23,SPA
5fa714d5,18,9,14,3,1,7,10,3,7,2,5,7,25,10,0,23,SPA
6025fab1,19,9,6,6,7,10,25,15,15,5,10,10,29,7,0,23,SPA
60359288,43,26,27,15,1,17,26,9,32,22,10,46,89,116,0,23,SPA
608f2092,19,12,14,4,1,7,12,5,11,5,6,8,27,19,1,23,SPA
6091cf45,1,1,0,1,0,1,1,0,0,0,0,0,1,0,0,23,SPA
60abea75,37,20,17,18,2,19,37,18,26,6,20,13,50,37,0,23,SPA
625c144a,0,0,0,0,0,0,0,0,1,0,1,1,1,6,2,23,SPA
6265208f,13,11,3,4,6,4,17,13,25,4,21,8,21,43,0,23,SPA
62a583ee,2,1,0,0,2,0,0,0,0,0,0,0,2,0,0,23,SPA
636eae97,31,21,11,14,6,14,32,18,8,0,8,8,39,3,0,23,SPA
63b0ca6b,5,4,1,2,2,2,2,0,4,1,3,0,5,8,0,23,SPA
63c5e56b,6,4,2,1,3,1,5,4,8,0,8,2,8,8,0,23,SPA
63d17038,0,0,0,0,0,0,1,1,0,0,0,1,1,9,5,23,SPA
63f04c6c,35,26,20,10,5,19,29,10,19,1,18,18,53,31,0,23,SPA
64035864,2,2,0,2,0,2,3,1,0,0,0,1,3,0,0,23,SPA
647d39d2,4,2,4,0,0,4,9,5,5,3,2,1,5,9,0,23,SPA
64ba07c0,17,9,12,4,1,5,11,6,5,2,3,9,26,11,0,23,SPA
64e8ed6d,9,4,7,2,0,5,31,26,18,0,18,3,12,10,0,23,SPA
65154df0,20,8,8,8,4,9,35,26,16,0,16,11,31,5,0,23,SPA
66116290,4,4,1,3,0,1,8,7,5,1,4,2,6,10,0,23,SPA
661e2822,0,0,0,0,0,0,0,0,0,0,0,0,0,2,0,23,SPA
6652cf96,63,37,38,16,9,32,61,29,51,18,33,31,94,55,1,23,SPA
686cbe7d,1,1,0,0,1,0,2,2,4,0,4,0,1,3,0,23,SPA
688b96e3,0,0,0,0,0,0,0,0,0,0,0,1,1,7,1,23,SPA
697295b1,37,20,30,7,0,18,29,11,25,14,11,33,70,95,0,23,SPA
69cbc8b6,46,24,34,12,0,28,43,15,37,23,14,43,89,114,2,23,SPA
6a8a7af8,99,66,41,45,13,33,59,26,31,14,17,48,147,50,1,23,SPA
6a99e0b1,22,16,5,14,3,9,24,15,18,3,15,7,29,34,0,23,SPA
6b21b7b5,12,10,7,3,2,2,8,6,6,0,6,5,17,4,0,23,SPA
6b5ea2f4,24,20,6,12,6,11,24,13,23,2,21,4,28,8,0,23,SPA
6c4776b1,3,2,3,0,0,3,7,4,1,0,1,2,5,23,3,23,SPA
6c7762c3,73,48,49,22,2,41,57,16,32,11,21,20,93,68,0,23,SPA
6c811eb7,18,10,7,5,6,5,34,29,19,1,18,4,22,18,0,23,SPA
6ce1f46f,51,32,16,33,2,23,69,46,23,4,19,24,75,11,0,23,SPA
6db116ec,0,0,0,0,0,0,0,0,2,1,1,1,1,2,0,23,SPA
6e4df551,6,4,3,3,0,2,10,8,8,1,7,4,10,5,0,23,SPA
6eaed4eb,28,17,19,8,1,17,25,8,24,16,8,15,43,123,0,23,SPA
6f4c734d,16,7,12,3,1,10,16,6,3,1,2,5,21,9,0,23,SPA
6f51e382,0,0,0,0,0,0,0,0,0,0,0,1,1,7,3,23,SPA
6f5f82c0,41,25,23,9,9,26,43,17,21,2,19,17,58,23,0,23,SPA
70107d4d,20,14,8,8,4,10,27,17,14,1,13,8,28,4,0,23,SPA
70d74ece,9,5,2,4,3,2,11,9,11,0,11,2,11,5,0,23,SPA
70f8e0bd,42,23,18,22,2,21,46,25,31,8,23,21,63,14,0,23,SPA
7106f0a0,0,0,0,0,0,0,0,0,1,0,1,0,0,0,0,23,SPA
7111d552,30,21,10,12,8,14,39,25,24,1,23,6,36,1,0,23,SPA
7155e3e1,37,22,13,21,3,16,33,17,21,5,16,22,59,10,0,23,SPA
7226539b,84,54,53,23,8,55,96,41,49,8,41,44,128,66,0,23,SPA
72a84002,27,19,19,8,0,18,29,11,24,15,9,13,40,70,1,23,SPA
733aab44,1,1,0,0,1,0,0,0,0,0,0,0,1,0,0,23,SPA
73683fa9,0,0,0,0,0,0,0,0,0,0,0,0,0,0,1,23,SPA
7460ca0d,71,40,32,23,16,30,75,45,40,12,28,29,100,31,2,23,SPA
75645f0e,8,4,3,3,2,2,13,11,9,1,8,1,9,17,0,23,SPA
759d8dd7,9,8,7,1,1,6,21,15,11,1,10,2,11,15,1,23,SPA
76c2a023,61,31,35,20,6,29,61,32,29,7,22,37,98,64,4,23,SPA
79f2a5f5,0,0,0,0,0,0,0,0,0,0,0,0,0,0,0,23,SPA
7b5ab7f2,22,11,11,7,4,10,23,13,10,0,10,8,30,10,0,23,SPA
7b9c2d84,68,48,32,21,15,24,64,40,24,5,19,17,85,25,0,23,SPA
7c363088,26,14,8,10,8,8,30,22,24,1,23,24,50,6,0,23,SPA
7c388b20,40,25,9,17,14,12,37,25,26,2,24,29,69,23,0,23,SPA
7c4243d4,27,15,16,10,1,12,38,26,16,4,12,13,40,18,0,23,SPA
7d08063d,6,3,3,3,0,4,9,5,6,2,4,2,8,1,0,23,SPA
7dcf86f6,8,4,0,4,4,3,22,19,10,1,9,7,15,23,0,23,SPA
7e98cff1,41,23,23,13,5,23,37,14,23,5,18,18,59,42,1,23,SPA
7f271d74,3,1,3,0,0,2,3,1,5,4,1,0,3,3,0,23,SPA
7f9c5d2d,12,9,9,2,1,7,16,9,8,2,6,8,20,24,0,23,SPA
80211dc5,2,1,2,0,0,1,2,1,2,0,2,0,2,0,0,23,SPA
8059806f,48,34,27,15,6,20,44,24,22,0,22,14,62,17,0,23,SPA
805a2a11,0,0,0,0,0,0,0,0,1,0,1,0,0,1,0,23,SPA
808d48f3,50,34,26,17,7,29,51,22,13,5,8,22,72,44,1,23,SPA
81442ecb,57,36,34,17,6,30,42,12,16,5,11,23,80,36,0,23,SPA
819aa8e7,31,15,9,16,6,10,40,30,22,0,22,13,44,5,0,23,SPA
81d5c497,0,0,0,0,0,0,0,0,0,0,0,0,0,0,0,23,SPA
81f0781e,11,6,0,6,5,3,6,3,6,2,4,5,16,10,0,23,SPA
82cfae2a,9,6,4,5,0,4,4,0,5,4,1,3,12,27,0,23,SPA
82ec26c1,0,0,0,0,0,0,0,0,0,0,0,0,0,0,0,23,SPA
84399660,14,10,4,7,3,7,31,24,10,0,10,4,18,4,0,23,SPA
8455ad90,42,24,10,22,10,18,61,43,25,2,23,11,53,7,0,23,SPA
84a85b48,0,0,0,0,0,0,0,0,0,0,0,0,0,0,0,23,SPA
852ddfb8,38,30,24,9,5,23,42,19,15,5,10,15,53,35,0,23,SPA
853b7c48,0,0,0,0,0,0,1,1,0,0,0,0,0,7,0,23,SPA
85bed4ee,16,11,5,9,2,8,17,9,10,0,10,13,29,2,0,23,SPA
85dace26,26,14,13,11,2,8,13,5,12,1,11,2,28,4,0,23,SPA
8696bc90,12,7,3,7,2,2,10,8,23,2,21,9,21,7,0,23,SPA
86ff856b,4,3,3,0,1,3,15,12,16,1,15,2,6,1,0,23,SPA
873619c6,16,10,3,9,4,5,17,12,9,1,8,2,18,26,0,23,SPA
873ce3a2,0,0,0,0,0,0,1,1,0,0,0,0,0,0,0,23,SPA
87b498b0,0,0,0,0,0,0,0,0,0,0,0,0,0,0,0,23,SPA
88050721,32,20,10,17,5,13,37,24,12,1,11,15,47,6,1,23,SPA
881ef58c,0,0,0,0,0,0,0,0,0,0,0,0,0,0,0,23,SPA
89151b16,4,2,1,3,0,3,4,1,9,9,0,5,9,27,0,23,SPA
89f951b5,37,26,10,18,9,19,40,21,21,1,20,27,64,20,0,23,SPA
8aae94b9,10,7,7,3,0,6,8,2,10,8,2,7,17,50,1,23,SPA
8aafd64f,10,7,2,3,5,1,6,5,1,0,1,3,13,2,0,23,SPA
8ac501f5,50,29,20,21,9,19,46,27,28,11,17,18,68,22,1,23,SPA
8b298f56,20,8,6,12,2,10,20,10,9,1,8,6,26,7,0,23,SPA
8c3c640c,13,7,5,3,5,5,19,14,14,4,10,3,16,5,0,23,SPA
8c725b43,41,28,32,9,0,26,38,12,32,15,17,50,91,129,1,23,SPA
8cfc2f69,1,1,0,1,0,0,2,2,3,0,3,1,2,1,0,23,SPA
8d78e732,17,11,2,5,10,7,14,7,20,0,20,2,19,14,0,23,SPA
8e010ff4,13,6,4,5,4,3,16,13,7,1,6,7,20,8,0,23,SPA
8e088e04,23,11,9,12,2,9,21,12,10,1,9,6,29,14,0,23,SPA
8e48dc61,5,2,2,2,1,1,4,3,6,1,5,2,7,3,0,23,SPA
8e92be30,1,1,0,0,1,0,0,0,0,0,0,0,1,2,0,23,SPA
8f3565b3,19,9,0,12,7,2,10,8,10,0,10,5,24,19,0,23,SPA
8f5e92a6,17,10,3,7,7,4,23,19,23,0,23,8,25,5,0,23,SPA
8f696594,2,1,1,0,1,0,2,2,0,0,0,0,2,0,0,23,SPA
8f8c6934,0,0,0,0,0,0,1,1,0,0,0,1,1,20,4,23,SPA
8fae77ea,0,0,0,0,0,0,2,2,0,0,0,1,1,3,2,23,SPA
90162357,3,2,2,1,0,3,7,4,2,0,2,2,5,0,0,23,SPA
90bbd822,49,28,21,13,15,11,33,22,41,4,37,34,83,24,1,23,SPA
91f7631f,54,38,27,23,4,20,52,32,26,9,17,30,84,19,0,23,SPA
922da988,2,0,0,1,1,1,3,2,1,1,0,0,2,1,0,23,SPA
924ff27e,0,0,0,0,0,0,0,0,0,0,0,0,0,0,0,23,SPA
93090f69,26,18,21,5,0,19,26,7,29,23,6,39,65,145,0,23,SPA
937c6ae6,0,0,0,0,0,0,0,0,0,0,0,0,0,0,0,23,SPA
958d67bb,7,5,4,3,0,4,11,7,6,0,6,1,8,3,0,23,SPA
962e54cb,8,5,0,5,3,2,7,5,9,1,8,0,8,4,0,23,SPA
963829d0,20,14,9,5,6,9,22,13,9,2,7,5,25,4,0,23,SPA
968a1c2f,14,9,5,7,2,8,20,12,7,0,7,10,24,5,0,23,SPA
974322dc,61,35,40,18,3,33,65,32,40,5,35,21,82,91,1,23,SPA
97852360,0,0,0,0,0,0,1,1,0,0,0,1,1,12,0,23,SPA
9939e168,55,39,24,22,9,30,76,46,37,5,32,17,72,32,2,23,SPA
99ea2ddd,3,2,0,2,1,1,2,1,1,0,1,2,5,2,0,23,SPA
9a0408b6,39,29,11,23,5,15,34,19,23,10,13,22,61,34,0,23,SPA
9a26fa06,1,0,0,1,0,0,0,0,1,1,0,1,2,4,0,23,SPA
9a64e67e,36,23,25,9,2,14,27,13,22,14,8,33,69,93,0,23,SPA
9a76c2e9,21,12,12,7,2,13,21,8,10,5,5,7,28,38,0,23,SPA
9a93efc9,27,20,17,10,0,14,19,5,14,2,12,12,39,47,4,23,SPA
9c36ed83,14,11,2,10,2,2,8,6,18,2,16,2,16,4,0,23,SPA
9d33c71a,1,0,1,0,0,0,2,2,0,0,0,0,1,1,0,23,SPA
9e1035f8,13,7,4,5,4,5,20,15,11,2,9,3,16,5,0,23,SPA
9f0ea33f,0,0,0,0,0,0,0,0,0,0,0,0,0,10,2,23,SPA
9f323c71,67,33,34,22,11,40,76,36,42,6,36,29,96,59,0,23,SPA
9f979eb2,11,7,9,2,0,5,8,3,9,6,3,6,17,32,0,23,SPA
9fec8860,2,1,2,0,0,1,3,2,1,0,1,1,3,3,0,23,SPA
a01c3d54,1,1,1,0,0,0,1,1,0,0,0,2,3,17,0,23,SPA
a0255c67,25,11,14,9,2,16,27,11,13,7,6,6,31,11,0,23,SPA
a08b974a,22,14,9,9,4,8,31,23,17,2,15,8,30,5,0,23,SPA
a0b4bb3e,15,9,6,5,4,8,14,6,3,0,3,10,25,3,0,23,SPA
a10361d2,37,20,9,18,10,15,33,18,24,8,16,31,68,35,1,23,SPA
a21417e2,4,4,2,2,0,3,8,5,7,4,3,5,9,21,0,23,SPA
a254bbe0,19,8,13,4,2,10,34,24,18,0,18,22,41,14,1,23,SPA
a2c1a8d3,0,0,0,0,0,0,0,0,0,0,0,0,0,2,0,23,SPA
a2d9cf74,0,0,0,0,0,0,0,0,0,0,0,0,0,0,0,23,SPA
a300ac7e,3,2,2,1,0,1,3,2,2,0,2,1,4,3,0,23,SPA
a39bb753,0,0,0,0,0,0,2,2,1,0,1,1,1,0,0,23,SPA
a3e4bf46,47,27,30,12,5,17,26,9,26,6,20,22,69,67,0,23,SPA
a45eac1f,6,3,1,4,1,3,8,5,7,1,6,1,7,6,1,23,SPA
a461f098,4,2,2,1,1,4,4,0,1,0,1,2,6,1,0,23,SPA
a4971d84,41,28,23,17,1,22,38,16,25,10,15,42,83,81,1,23,SPA
a4995f48,2,0,2,0,0,2,2,0,1,0,1,1,3,6,2,23,SPA
a4b00319,104,72,60,40,4,48,98,50,54,5,49,41,145,63,1,23,SPA
a55d8df5,47,29,35,9,3,31,58,27,17,2,15,24,71,41,0,23,SPA
a56da3ba,24,14,17,4,3,13,23,10,21,8,13,13,37,58,0,23,SPA
a6103274,19,12,9,8,2,3,12,9,17,3,14,6,25,12,0,23,SPA
a62b4888,10,4,3,4,3,2,8,6,7,3,4,1,11,2,0,23,SPA
a6951bf8,18,13,7,9,2,7,7,0,8,2,6,9,27,7,0,23,SPA
a6de370d,25,14,10,8,7,14,33,19,18,0,18,14,39,8,0,23,SPA
a83c19cf,10,5,5,4,1,2,7,5,1,0,1,4,14,2,0,23,SPA
a8981944,50,28,20,21,9,28,64,36,45,7,38,46,96,46,1,23,SPA
a8f21b9f,39,23,12,17,10,22,66,44,29,3,26,6,45,9,0,23,SPA
aa677a35,13,7,6,4,3,4,14,10,14,1,13,8,21,19,0,23,SPA
aad53e64,15,9,6,5,4,8,24,16,7,0,7,4,19,3,0,23,SPA
ab7bf91d,57,32,36,16,5,36,45,9,27,14,13,24,81,90,3,23,SPA
abe66106,46,27,14,16,16,12,34,22,26,2,24,7,53,3,0,23,SPA
ac295d9e,0,0,0,0,0,0,0,0,0,0,0,0,0,6,0,23,SPA
ac454a4f,44,25,17,23,4,18,51,33,32,8,24,28,72,40,0,23,SPA
ac8b2421,38,20,21,15,2,19,26,7,26,12,14,20,58,55,0,23,SPA
acc1aefa,27,13,14,13,0,22,48,26,15,5,10,3,30,11,0,23,SPA
adfc9123,5,4,1,4,0,4,4,0,2,1,1,2,7,19,0,23,SPA
ae48c5cb,9,7,4,4,1,8,23,15,12,0,12,9,18,12,0,23,SPA
ae852b7d,22,14,16,3,3,16,22,6,13,2,11,11,33,40,0,23,SPA
ae86d473,4,1,1,1,2,1,2,1,4,1,3,0,4,0,0,23,SPA
af34f10d,3,3,2,1,0,3,4,1,3,1,2,1,4,9,0,23,SPA
afdc14d7,31,16,10,15,6,19,41,22,40,2,38,8,39,14,1,23,SPA
b05e2dbd,80,46,61,16,3,43,74,31,28,9,19,23,103,48,0,23,SPA
b0616e3d,33,19,21,8,4,15,35,20,26,6,20,26,59,46,0,23,SPA
b0fce72c,57,35,21,31,5,25,68,43,39,8,31,36,93,39,3,23,SPA
b151a3f2,0,0,0,0,0,0,0,0,0,0,0,1,1,0,0,23,SPA
b19db005,19,12,4,8,7,4,15,11,10,1,9,0,19,2,0,23,SPA
b3b9b8b8,0,0,0,0,0,0,0,0,0,0,0,0,0,0,0,23,SPA
b3dc6eca,5,3,3,2,0,3,3,0,10,7,3,6,11,34,0,23,SPA
b3f62bfc,0,0,0,0,0,0,0,0,0,0,0,0,0,0,0,23,SPA
b418dbd4,12,8,3,4,5,5,15,10,13,1,12,6,18,9,0,23,SPA
b51b1b9c,48,35,17,23,8,20,30,10,20,1,19,11,59,16,2,23,SPA
b6e50615,56,32,28,20,8,35,59,24,37,12,25,40,96,59,1,23,SPA
b75ac54b,2,1,2,0,0,0,1,1,5,0,5,3,5,5,0,23,SPA
b7c04927,44,24,26,12,6,27,38,11,13,4,9,16,60,29,0,23,SPA
b7ca5c51,17,9,13,4,0,13,19,6,22,14,8,32,49,79,2,23,SPA
b7d7f3bf,1,0,1,0,0,0,1,1,0,0,0,1,2,0,0,23,SPA
b857bd29,34,21,23,11,0,10,15,5,38,29,9,31,65,158,1,23,SPA
b85bf253,18,13,13,5,0,11,21,10,15,12,3,8,26,46,1,23,SPA
b86a64b2,35,28,20,11,4,19,30,11,31,22,9,27,62,98,1,23,SPA
b8a642fc,14,7,7,2,5,7,23,16,13,0,13,12,26,16,0,23,SPA
b906757a,7,6,4,2,1,6,11,5,11,7,4,14,21,26,0,23,SPA
b907d169,0,0,0,0,0,0,0,0,0,0,0,0,0,0,0,23,SPA
ba5004e1,49,33,23,19,7,26,48,22,40,0,40,15,64,36,0,23,SPA
bb08bce9,35,20,21,14,0,28,40,12,23,16,7,26,61,85,0,23,SPA
bbc19252,2,2,1,1,0,1,4,3,1,1,0,2,4,3,0,23,SPA
bbf5c11b,8,2,2,4,2,2,5,3,5,1,4,4,12,11,0,23,SPA
bc6f5f06,29,16,20,9,0,18,22,4,33,19,14,27,56,125,1,23,SPA
bdb624a3,27,16,2,19,6,11,37,26,10,0,10,4,31,9,1,23,SPA
bdc74a8f,10,5,1,6,3,6,14,8,9,2,7,6,16,5,0,23,SPA
be170419,47,35,29,15,3,18,34,16,27,17,10,72,119,135,1,23,SPA
be6faae0,0,0,0,0,0,0,0,0,0,0,0,0,0,0,0,23,SPA
bece776f,11,5,3,3,5,2,9,7,6,2,4,1,12,0,0,23,SPA
bed68338,29,19,13,12,4,13,23,10,20,0,20,4,33,6,0,23,SPA
bfd381b3,31,17,15,16,0,15,32,17,18,8,10,11,42,39,0,23,SPA
c05dfb74,21,16,7,11,3,6,17,11,10,1,9,4,25,2,0,23,SPA
c0617e2b,43,29,13,15,15,25,64,39,23,2,21,25,68,6,1,23,SPA
c0b1a6da,0,0,0,0,0,0,1,1,0,0,0,0,0,0,0,23,SPA
c14bc029,42,27,18,18,6,22,37,15,27,5,22,15,57,29,0,23,SPA
c20bdcd7,66,43,46,19,1,38,49,11,27,12,15,30,96,59,0,23,SPA
c2111b45,0,0,0,0,0,0,0,0,0,0,0,0,0,0,0,23,SPA
c3e66ffe,69,45,41,19,9,38,85,47,44,10,34,25,94,54,2,23,SPA
c487901c,2,2,1,1,0,2,15,13,9,0,9,3,5,5,0,23,SPA
c4b888df,69,51,41,22,6,41,63,22,35,11,24,19,88,80,1,23,SPA
c5642098,7,4,3,3,1,5,8,3,0,0,0,0,7,2,0,23,SPA
c78b352d,71,52,46,22,3,31,54,23,25,2,23,24,95,54,2,23,SPA
c93231dc,4,4,0,1,3,0,0,0,5,2,3,3,7,3,0,23,SPA
c997b942,5,4,4,0,1,1,2,1,7,0,7,2,7,2,0,23,SPA
c9e39d91,58,34,18,30,10,24,64,40,27,3,24,12,70,14,1,23,SPA
cb574619,53,29,34,14,5,28,42,14,28,7,21,24,77,73,0,23,SPA
cc1c5035,0,0,0,0,0,0,0,0,0,0,0,0,0,0,1,23,SPA
cc2dd8a5,1,0,0,1,0,1,3,2,1,0,1,0,1,0,0,23,SPA
cc83b74d,1,0,0,1,0,1,3,2,0,0,0,0,1,5,0,23,SPA
cc9256ef,15,9,6,3,6,8,27,19,11,0,11,15,30,10,0,23,SPA
ccbbe661,9,7,0,6,3,0,7,7,6,1,5,1,10,13,0,23,SPA
cce181df,40,23,19,20,1,17,25,8,9,1,8,26,66,12,1,23,SPA
cde52ef5,0,0,0,0,0,0,1,1,0,0,0,0,0,7,0,23,SPA
ce8039aa,18,13,5,9,4,11,30,19,19,1,18,5,23,1,0,23,SPA
cee88597,52,29,26,20,6,18,30,12,26,3,23,25,77,72,1,23,SPA
d080ed5e,77,49,28,33,16,31,62,31,38,8,30,20,97,51,1,23,SPA
d1b060e2,1,0,1,0,0,0,0,0,5,0,5,0,1,2,0,23,SPA
d2110326,30,16,19,11,0,13,20,7,30,17,13,20,50,111,2,23,SPA
d4808594,1,0,0,0,1,0,2,2,0,0,0,0,1,1,0,23,SPA
d49f3e6b,36,16,12,16,8,17,35,18,33,5,28,15,51,46,0,23,SPA
d4b73232,0,0,0,0,0,0,0,0,0,0,0,1,1,11,4,23,SPA
d557d734,0,0,0,0,0,0,0,0,2,0,2,0,0,0,0,23,SPA
d5dd5f1f,0,0,0,0,0,0,0,0,0,0,0,0,0,0,0,23,SPA
d61759ec,3,0,2,1,0,1,5,4,7,1,6,2,5,3,0,23,SPA
d637fc22,12,5,7,5,0,6,14,8,16,7,9,5,17,18,0,23,SPA
d733aa38,0,0,0,0,0,0,0,0,0,0,0,0,0,0,0,23,SPA
d7553721,32,28,7,15,10,12,21,9,14,2,12,6,38,5,0,23,SPA
d854c9d0,2,1,2,0,0,1,1,0,0,0,0,1,3,1,0,23,SPA
d8712bf9,0,0,0,0,0,0,2,2,1,0,1,0,0,0,0,23,SPA
d87e2cae,9,6,6,3,0,4,9,5,4,0,4,1,10,15,0,23,SPA
d9235a45,0,0,0,0,0,0,0,0,0,0,0,0,0,0,0,23,SPA
d9ba39fc,35,21,17,11,7,12,27,15,18,5,13,20,55,51,1,23,SPA
da76bab4,12,5,2,7,3,0,18,18,22,2,20,6,18,26,0,23,SPA
dabb2827,0,0,0,0,0,0,2,2,2,0,2,1,1,20,3,23,SPA
db001fa9,87,56,55,20,12,48,96,48,52,11,41,48,135,99,3,23,SPA
db8f0eba,51,27,21,27,3,23,47,24,24,0,24,9,60,9,0,23,SPA
dc1c2fce,58,37,17,25,16,23,60,37,37,4,33,10,68,6,0,23,SPA
dc1ce4f5,4,2,3,1,0,4,5,1,1,0,1,1,5,5,0,23,SPA
dc62b55d,4,1,1,3,0,0,3,3,4,1,3,2,6,3,0,23,SPA
de39485a,35,14,21,10,4,23,54,31,23,1,22,12,47,19,0,23,SPA
dee86451,43,27,18,23,2,17,44,27,27,6,21,16,59,22,0,23,SPA
df69b544,49,34,15,23,11,20,66,46,34,3,31,24,73,31,0,23,SPA
dfe5caa2,1,0,0,1,0,0,0,0,0,0,0,0,1,0,0,23,SPA
e08647d6,6,4,1,3,2,1,15,14,1,0,1,1,7,4,0,23,SPA
e0979e74,0,0,0,0,0,0,2,2,0,0,0,1,1,0,0,23,SPA
e19c989c,0,0,0,0,0,0,0,0,1,0,1,0,0,3,0,23,SPA
e1e75690,2,2,1,1,0,1,4,3,0,0,0,0,2,1,0,23,SPA
e2716bd0,36,21,11,18,7,11,19,8,17,2,15,15,51,16,0,23,SPA
e2dcc60e,1,0,0,1,0,0,0,0,0,0,0,0,1,0,0,23,SPA
e358587b,0,0,0,0,0,0,1,1,0,0,0,1,1,4,4,23,SPA
e4346678,1,0,1,0,0,1,2,1,0,0,0,0,1,19,3,23,SPA
e4738e91,10,6,5,4,1,4,5,1,4,2,2,1,11,14,0,23,SPA
e5d01ecf,18,9,14,3,1,13,18,5,15,6,9,20,38,22,0,23,SPA
e6697917,66,42,23,32,11,26,57,31,26,0,26,20,86,16,1,23,SPA
e6777e6b,14,6,12,2,0,7,11,4,12,10,2,17,31,90,2,23,SPA
e73c9bb2,21,13,15,6,0,13,25,12,17,5,12,20,41,38,0,23,SPA
e7af9060,9,3,2,4,3,3,7,4,6,3,3,0,9,15,0,23,SPA
e7d2a50b,0,0,0,0,0,0,0,0,0,0,0,0,0,0,0,23,SPA
e7f4603c,10,4,7,2,1,2,9,7,3,1,2,5,15,6,1,23,SPA
e897d8ba,6,3,0,4,2,2,5,3,6,1,5,1,7,13,0,23,SPA
e8deefd6,0,4,0,0,0,0,0,0,0,0,0,1,0,0,0,23,SPA
e9241b40,28,19,11,14,3,12,32,20,22,1,21,9,37,6,0,23,SPA
e92cd3f7,18,9,3,6,9,7,14,7,15,1,14,2,20,26,1,23,SPA
e96b2583,0,0,0,0,0,0,0,0,0,0,0,0,0,0,0,23,SPA
ea610f00,0,0,0,0,0,0,0,0,1,0,1,0,0,1,0,23,SPA
ea83bfa6,4,1,4,0,0,4,4,0,0,0,0,0,4,12,1,23,SPA
ead61f73,23,16,16,6,1,14,29,15,20,7,13,20,43,63,0,23,SPA
eb82b6f1,15,10,8,5,2,4,38,34,9,0,9,5,20,8,0,23,SPA
ec1a731e,9,6,7,2,0,4,7,3,8,3,5,10,19,53,0,23,SPA
ed5c5fa3,34,22,15,14,5,14,55,41,29,5,24,53,87,35,2,23,SPA
ed6ea4d9,3,2,0,2,1,1,8,7,5,0,5,3,6,4,0,23,SPA
edc98fac,63,38,43,19,1,24,36,12,34,22,12,31,94,105,2,23,SPA
ee45d138,19,9,11,6,2,6,11,5,10,4,6,7,26,18,0,23,SPA
ee8508c0,0,0,0,0,0,0,0,0,0,0,0,1,1,8,0,23,SPA
ee923664,13,8,5,7,1,8,12,4,4,1,3,2,15,8,0,23,SPA
eeba07f8,17,11,5,6,6,6,26,20,13,3,10,3,20,10,0,23,SPA
ef322658,41,25,17,20,4,18,43,25,14,5,9,23,64,29,0,23,SPA
efecd633,41,22,23,16,2,22,46,24,34,14,20,17,58,28,0,23,SPA
f03f284b,31,18,17,13,1,19,27,8,29,19,10,14,45,64,1,23,SPA
f08490a6,3,3,1,0,2,1,2,1,0,0,0,0,3,1,1,23,SPA
f0da930c,43,25,28,14,1,24,35,11,37,17,20,24,67,138,1,23,SPA
f0f4671c,0,0,0,0,0,0,0,0,0,0,0,0,0,0,0,23,SPA
f127d782,0,0,0,0,0,0,0,0,0,0,0,0,0,7,2,23,SPA
f25b010f,1,1,1,0,0,1,1,0,0,0,0,2,3,12,0,23,SPA
f2c6ac01,35,27,22,12,1,19,28,9,39,21,18,29,64,137,0,23,SPA
f35430a4,10,8,7,1,2,3,6,3,11,4,7,18,28,43,1,23,SPA
f36016a5,19,12,4,11,4,11,23,12,17,6,11,11,30,9,3,23,SPA
f3b1d9a2,29,19,14,8,7,14,22,8,13,1,12,5,34,5,0,23,SPA
f4290206,15,10,10,5,0,9,12,3,14,10,4,11,26,32,0,23,SPA
f4c69aa6,35,16,14,17,4,14,24,10,11,1,10,4,39,12,0,23,SPA
f553b2b3,15,7,3,5,7,7,30,23,14,5,9,3,18,24,0,23,SPA
f6798fc3,2,1,2,0,0,1,4,3,0,0,0,2,4,11,1,23,SPA
f6ac68c1,39,26,29,7,3,26,39,13,17,8,9,33,72,67,2,23,SPA
f6f6b6e8,17,11,10,7,0,6,11,5,27,19,8,37,54,101,0,23,SPA
f7dc2ae5,26,17,15,10,1,14,26,12,15,6,9,20,46,43,1,23,SPA
f7e87032,8,8,5,1,2,1,14,13,13,2,11,7,15,12,0,23,SPA
f8405304,13,10,6,5,2,4,10,6,9,0,9,2,15,2,0,23,SPA
f874dd44,2,0,0,2,0,2,3,1,2,0,2,3,5,2,0,23,SPA
f8eca1b6,26,14,5,19,2,7,25,18,19,2,17,6,32,35,0,23,SPA
f9358b61,0,0,0,0,0,0,0,0,0,0,0,0,0,0,0,23,SPA
f9a225f5,2,0,1,1,0,1,2,1,0,0,0,0,2,0,0,23,SPA
fb938d24,1,0,1,0,0,0,1,1,0,0,0,1,2,1,0,23,SPA
fbbb9269,45,23,29,14,2,22,33,11,35,8,27,19,64,52,1,23,SPA
fbd6378b,18,10,14,3,1,6,12,6,19,14,5,21,39,58,0,23,SPA
fc076f78,2,2,0,0,2,1,2,1,1,0,1,0,2,0,0,23,SPA
fc647b34,48,32,12,23,13,9,44,35,31,3,28,8,56,8,1,23,SPA
fc70e345,1,0,1,0,0,1,2,1,2,0,2,1,2,17,3,23,SPA
fc8b614b,2,2,0,2,0,0,0,0,0,0,0,1,3,1,0,23,SPA
fd47b4f2,30,21,26,4,0,18,25,7,46,33,13,31,61,203,1,23,SPA
fd51b456,34,23,22,10,2,20,28,8,10,0,10,7,41,13,0,23,SPA
fd771f95,12,2,2,4,6,5,14,9,10,0,10,5,17,11,0,23,SPA
fdd26d71,12,9,8,3,1,10,17,7,8,3,5,7,19,10,0,23,SPA
fe05804b,2,1,1,1,0,1,2,1,2,1,1,1,3,12,0,23,SPA
fe641c1a,4,2,0,4,0,3,5,2,3,2,1,4,8,3,0,23,SPA
fea23125,0,0,0,0,0,0,0,0,0,0,0,0,0,3,0,23,SPA
fed17f5a,2,0,0,1,1,2,3,1,1,0,1,0,2,2,0,23,SPA
ff800ed8,13,6,9,3,1,8,13,5,3,2,1,7,20,16,0,23,SPA
ffacd3d5,51,35,35,9,7,33,63,30,33,5,28,14,65,51,0,23,SPA
0076ab7f,3,2,2,0,1,1,8,7,4,2,2,2,5,14,0,23,CL
009a4f60,0,0,0,0,0,0,0,0,1,0,1,0,0,4,1,23,CL
00f518d8,4,4,2,2,0,2,3,1,5,0,5,1,5,0,0,23,CL
01b8a2b2,0,0,0,0,0,0,1,1,0,0,0,0,0,1,0,23,CL
01c3aff5,6,3,2,2,2,4,7,3,10,2,8,5,11,3,0,23,CL
01e5f06e,4,1,2,2,0,1,2,1,4,0,4,2,6,2,0,23,CL
01eb744d,2,0,0,1,1,2,3,1,9,2,7,0,2,0,1,23,CL
02c15616,2,1,1,1,0,1,1,0,3,0,3,2,4,3,0,23,CL
032f894e,3,0,2,1,0,2,3,1,3,1,2,1,4,0,0,23,CL
03998238,0,0,0,0,0,0,1,1,0,0,0,0,0,2,0,23,CL
03df04ff,0,0,0,0,0,0,1,1,1,0,1,0,0,5,0,23,CL
042e8a49,11,8,3,6,2,5,13,8,10,0,10,2,13,1,0,23,CL
048a1cbc,7,4,2,3,2,1,4,3,5,2,3,10,17,10,0,23,CL
049a888d,7,2,4,3,0,4,10,6,2,0,2,1,8,2,0,23,CL
04e17fd5,3,2,0,0,3,2,4,2,1,0,1,2,5,3,0,23,CL
04e531b6,2,2,0,2,0,0,0,0,1,1,0,1,3,0,1,23,CL
05439de2,8,3,2,5,1,5,12,7,12,8,4,7,15,12,0,23,CL
05d548d8,8,5,3,5,0,4,9,5,10,5,5,7,15,17,0,23,CL
05e19d6a,6,2,2,3,1,2,3,1,2,0,2,2,8,0,0,23,CL
0670ee51,5,4,3,1,1,2,2,0,7,3,4,3,8,13,0,23,CL
06a1d642,2,1,1,1,0,1,3,2,2,1,1,4,6,0,0,23,CL
08511d65,9,5,3,6,0,7,11,4,11,6,5,11,20,25,0,23,CL
08990838,3,1,3,0,0,2,3,1,7,6,1,7,10,22,0,23,CL
08f5afaa,0,0,0,0,0,0,0,0,0,0,0,0,0,7,1,23,CL
08fe932d,0,0,0,0,0,0,1,1,2,1,1,2,2,3,0,23,CL
0959c2a2,18,7,6,7,5,9,20,11,17,1,16,14,32,13,0,23,CL
0a084b35,12,7,8,3,1,9,11,2,4,2,2,5,17,9,0,23,CL
0a69de7b,5,3,4,1,0,4,4,0,4,1,3,1,6,3,0,23,CL
0a6dbbf7,11,7,6,5,0,3,9,6,7,5,2,11,22,38,0,23,CL
0a89e877,5,2,3,2,0,5,9,4,2,1,1,3,8,4,0,23,CL
0ab1f153,12,7,8,4,0,8,12,4,7,0,7,8,20,4,0,23,CL
0b5a292a,6,6,5,0,1,3,9,6,4,2,2,7,13,4,0,23,CL
0ba976e4,1,1,0,1,0,0,1,1,2,0,2,0,1,0,0,23,CL
0c7a48f8,19,11,10,8,1,11,15,4,4,2,2,6,25,14,0,23,CL
0ca476cc,4,2,0,3,1,4,6,2,1,0,1,1,5,0,0,23,CL
0d267745,17,11,15,2,0,9,17,8,15,5,10,15,32,32,0,23,CL
0d4fd3a0,10,6,7,3,0,4,6,2,6,4,2,4,14,24,0,23,CL
0d82903c,3,2,2,1,0,0,0,0,2,0,2,5,8,6,0,23,CL
0d9b2d31,7,2,2,5,0,2,8,6,7,0,7,5,12,1,1,23,CL
0db169ae,19,13,7,11,1,9,19,10,11,3,8,4,23,10,0,23,CL
0df2b165,6,3,2,4,0,5,15,10,4,1,3,9,15,12,0,23,CL
0e6bc38c,7,4,3,3,1,0,1,1,6,0,6,1,8,2,0,23,CL
0f41e2ee,0,0,0,0,0,0,1,1,4,3,1,1,1,3,0,23,CL
0fdcef0e,4,1,2,1,1,2,2,0,0,0,0,2,6,5,0,23,CL
10549b49,0,0,0,0,0,0,0,0,0,0,0,0,0,0,0,23,CL
10745192,0,0,0,0,0,0,1,1,1,0,1,0,0,1,0,23,CL
116c35df,1,0,1,0,0,0,0,0,3,0,3,2,3,1,0,23,CL
119b9a8e,0,0,0,0,0,0,2,2,0,0,0,3,3,4,0,23,CL
121101a4,8,4,7,1,0,5,5,0,10,7,3,14,22,54,1,23,CL
1265a93a,14,8,10,4,0,6,15,9,13,1,12,7,21,11,0,23,CL
129af0db,0,0,0,0,0,0,0,0,1,0,1,0,0,3,0,23,CL
12dcbdcc,8,5,4,3,1,7,9,2,2,0,2,0,8,1,0,23,CL
12e7ac0a,0,0,0,0,0,0,1,1,1,0,1,0,0,0,0,23,CL
132a82f1,15,9,8,7,0,10,17,7,2,0,2,4,19,9,0,23,CL
1338e42b,5,5,4,1,0,3,6,3,3,0,3,6,11,5,0,23,CL
1339039e,1,1,0,0,1,0,2,2,0,0,0,2,3,1,0,23,CL
133faa84,7,5,3,4,0,5,6,1,7,2,5,1,8,9,0,23,CL
13d23b29,0,0,0,0,0,0,0,0,0,0,0,0,0,0,0,23,CL
141b0bd2,12,8,9,3,0,8,11,3,7,4,3,5,17,11,0,23,CL
1467af0d,27,18,12,12,3,9,28,19,13,5,8,6,33,0,2,23,CL
148af9a8,0,0,0,0,0,0,0,0,0,0,0,0,0,0,0,23,CL
14b8fcdf,2,2,0,2,0,1,1,0,2,1,1,3,5,4,0,23,CL
15413fa5,8,4,3,5,0,4,15,11,6,0,6,12,20,7,0,23,CL
15ab5a2b,5,3,0,2,3,0,5,5,1,0,1,2,7,1,0,23,CL
15b287da,17,9,9,6,2,11,19,8,9,3,6,9,26,7,0,23,CL
15ea94de,0,0,0,0,0,0,1,1,0,0,0,0,0,2,0,23,CL
15f3ec41,2,1,1,0,1,2,4,2,0,0,0,3,5,1,0,23,CL
15fd5593,0,0,0,0,0,0,4,4,1,0,1,0,0,2,0,23,CL
162efffd,4,2,1,1,2,1,3,2,7,0,7,3,7,2,0,23,CL
163bbd4a,3,1,0,0,3,1,3,2,4,0,4,1,4,6,0,23,CL
16ceb862,7,6,1,5,1,3,9,6,7,0,7,2,9,15,0,23,CL
17370b95,10,6,9,1,0,4,7,3,6,3,3,5,15,16,1,23,CL
178ae8f8,3,2,2,1,0,1,2,1,2,0,2,0,3,1,0,23,CL
1840e36d,1,1,1,0,0,0,2,2,0,0,0,0,1,3,1,23,CL
184ad240,2,2,1,1,0,0,0,0,2,0,2,0,2,2,0,23,CL
1880614f,3,3,1,1,1,1,2,1,0,0,0,1,4,0,0,23,CL
18b896d6,10,6,5,5,0,6,6,0,7,2,5,6,16,26,0,23,CL
18dd3219,2,2,2,0,0,2,4,2,3,1,2,2,4,7,0,23,CL
1971591f,6,5,2,1,3,4,5,1,4,1,3,1,7,1,0,23,CL
19a967ab,9,6,7,2,0,0,6,6,3,1,2,6,15,1,0,23,CL
19cae58d,7,6,2,3,2,2,4,2,4,1,3,5,12,1,0,23,CL
19cda00b,1,0,0,0,1,0,0,0,0,0,0,0,1,0,0,23,CL
1a799243,7,1,2,3,2,3,9,6,3,0,3,4,11,13,0,23,CL
1a992676,1,0,1,0,0,0,1,1,0,0,0,0,1,0,0,23,CL
1adcf39e,10,4,9,1,0,6,9,3,13,4,9,9,19,35,0,23,CL
1b82f8df,8,4,4,3,1,3,9,6,6,0,6,14,22,5,0,23,CL
1bacc518,4,3,1,3,0,1,3,2,5,1,4,3,7,2,0,23,CL
1bf33a9a,2,1,0,1,1,1,2,1,2,0,2,2,4,0,0,23,CL
1cb49278,4,1,2,1,1,1,1,0,2,2,0,3,7,4,0,23,CL
1daec722,12,9,6,5,1,8,8,0,9,0,9,8,20,7,0,23,CL
1e1378e1,5,3,1,1,3,3,10,7,9,1,8,4,9,3,0,23,CL
1e4319ac,2,2,0,2,0,0,0,0,1,1,0,0,2,0,0,23,CL
1f3afdcb,10,6,7,3,0,5,5,0,3,1,2,4,14,20,0,23,CL
1f44ac21,1,0,0,1,0,1,2,1,5,0,5,2,3,3,0,23,CL
1f994616,0,0,0,0,0,0,0,0,0,0,0,0,0,0,1,23,CL
1fbbfbde,8,3,6,2,0,5,6,1,4,2,2,6,14,18,1,23,CL
20030c06,9,5,5,2,2,7,10,3,12,7,5,8,17,26,0,23,CL
20730eae,3,2,1,1,1,1,1,0,2,0,2,3,6,7,0,23,CL
20b9f052,0,0,0,0,0,0,0,0,0,0,0,0,0,1,0,23,CL
213f0daf,4,2,2,2,0,1,4,3,0,0,0,1,5,1,0,23,CL
2146785a,17,10,15,2,0,10,20,10,9,3,6,15,32,12,0,23,CL
2180c761,1,1,1,0,0,0,0,0,1,1,0,0,1,2,0,23,CL
21a66f6a,1,0,0,1,0,0,3,3,2,1,1,2,3,6,0,23,CL
230a2fac,18,10,12,6,0,10,15,5,9,3,6,12,30,22,0,23,CL
23610943,7,3,3,1,3,4,9,5,2,1,1,1,8,4,0,23,CL
23a10591,0,0,0,0,0,0,0,0,0,0,0,0,0,1,0,23,CL
24051310,13,9,8,4,1,6,9,3,6,1,5,11,24,20,0,23,CL
24228180,8,5,2,5,1,3,12,9,2,0,2,2,10,6,0,23,CL
2475dcc6,6,3,1,3,2,4,8,4,8,1,7,0,6,5,0,23,CL
25146df0,17,8,12,5,0,6,8,2,7,7,0,3,20,29,1,23,CL
25b74470,9,3,6,1,2,3,6,3,4,1,3,0,9,2,0,23,CL
262e5a82,11,6,5,3,3,3,7,4,5,2,3,7,18,4,0,23,CL
2784f898,10,5,7,3,0,8,13,5,11,7,4,9,19,37,0,23,CL
27d0a506,15,10,10,3,2,11,16,5,9,2,7,4,19,12,0,23,CL
28b1f3ce,17,13,8,8,1,6,16,10,10,0,10,1,18,2,0,23,CL
28c6e925,19,14,13,5,1,9,15,6,14,3,11,8,27,5,0,23,CL
28d596a0,0,0,0,0,0,0,1,1,0,0,0,1,1,2,0,23,CL
292a652a,0,0,0,0,0,0,0,0,0,0,0,0,0,0,0,23,CL
2946f9a1,9,5,5,4,0,4,12,8,5,4,1,17,26,16,0,23,CL
29b7b767,0,0,0,0,0,0,2,2,0,0,0,0,0,0,0,23,CL
29c91632,6,2,5,1,0,3,3,0,7,5,2,7,13,17,1,23,CL
29fbdc88,7,2,1,6,0,3,7,4,3,1,2,6,13,1,0,23,CL
2a0c8ba4,4,2,2,2,0,2,5,3,6,3,3,4,8,2,1,23,CL
2a9f6b4d,2,1,0,2,0,0,1,1,3,0,3,0,2,2,0,23,CL
2b0852db,21,11,6,10,5,9,18,9,10,2,8,4,25,2,0,23,CL
2b114be3,10,7,0,5,5,4,9,5,4,0,4,6,16,0,0,23,CL
2b622f01,3,2,1,1,1,1,1,0,2,0,2,0,3,0,0,23,CL
2bed3eab,4,2,3,1,0,2,3,1,1,0,1,4,8,5,0,23,CL
2bef2bca,1,0,1,0,0,0,0,0,2,1,1,0,1,0,0,23,CL
2c0558b8,4,3,1,2,1,0,7,7,6,0,6,6,10,1,0,23,CL
2c0f8e9e,7,3,0,6,1,0,0,0,3,0,3,0,7,0,0,23,CL
2ccd89a3,3,1,3,0,0,2,3,1,1,0,1,2,5,3,0,23,CL
2d65a822,0,0,0,0,0,0,0,0,0,0,0,0,0,4,0,23,CL
2d970560,20,13,13,5,2,10,14,4,1,0,1,5,25,10,0,23,CL
2dce876a,6,4,5,0,1,3,7,4,7,4,3,3,9,10,1,23,CL
2e4f5f03,2,0,1,1,0,1,4,3,2,0,2,2,4,5,0,23,CL
2ef08833,0,0,0,0,0,0,0,0,2,1,1,0,0,1,0,23,CL
2ef7c612,2,1,2,0,0,1,4,3,7,1,6,3,5,0,0,23,CL
2f33776f,0,0,0,0,0,0,0,0,0,0,0,0,0,0,0,23,CL
2f90f6b8,11,9,6,4,1,3,4,1,5,1,4,2,13,2,0,23,CL
3061e1ec,0,0,0,0,0,0,0,0,0,0,0,0,0,1,0,23,CL
307877be,3,1,1,1,1,0,1,1,3,1,2,1,4,8,0,23,CL
30d75bfb,14,9,4,7,3,9,12,3,8,4,4,7,21,6,0,23,CL
30f5ffa9,9,6,7,2,0,4,5,1,11,9,2,4,13,24,0,23,CL
316de854,6,3,3,1,2,1,3,2,4,0,4,1,7,0,0,23,CL
31c69ef1,26,18,13,11,2,15,18,3,14,8,6,7,33,25,0,23,CL
3235182a,6,3,4,2,0,5,9,4,3,0,3,2,8,2,0,23,CL
3260690c,3,1,0,1,2,1,1,0,4,1,3,0,3,2,0,23,CL
32e8417f,6,4,1,3,2,5,6,1,0,0,0,1,7,0,0,23,CL
32feb0cf,1,0,0,0,1,0,0,0,0,0,0,0,1,0,0,23,CL
33144cc5,1,1,1,0,0,0,1,1,1,0,1,2,3,0,0,23,CL
335fa267,5,1,2,3,0,3,4,1,2,0,2,4,9,1,0,23,CL
33651873,4,1,4,0,0,2,6,4,7,3,4,5,9,21,0,23,CL
3376a776,0,0,0,0,0,0,0,0,0,0,0,0,0,0,0,23,CL
33887998,0,0,0,0,0,0,0,0,0,0,0,0,0,0,0,23,CL
3392603d,0,0,0,0,0,0,0,0,0,0,0,0,0,5,2,23,CL
33a6a650,12,6,11,1,0,6,8,2,12,6,6,9,21,27,0,23,CL
33b8d077,18,11,12,4,2,7,18,11,9,5,4,9,27,5,1,23,CL
3423f250,8,7,3,3,2,2,6,4,4,1,3,4,12,3,0,23,CL
343c0d52,3,2,0,2,1,1,2,1,3,0,3,0,3,2,0,23,CL
34693494,3,2,2,1,0,2,2,0,1,1,0,0,3,0,0,23,CL
34e12499,10,8,6,4,0,4,7,3,5,3,2,3,13,16,1,23,CL
34e4343c,2,0,2,0,0,0,2,2,5,2,3,0,2,6,0,23,CL
353eb529,0,0,0,0,0,0,0,0,0,0,0,0,0,0,0,23,CL
35d64857,19,11,12,6,1,9,21,12,6,0,6,8,27,26,1,23,CL
366be751,2,0,1,1,0,0,3,3,4,0,4,1,3,0,0,23,CL
36a3ff67,4,2,1,1,2,1,4,3,4,1,3,3,7,1,0,23,CL
374d5158,5,5,0,5,0,3,5,2,2,0,2,4,9,6,1,23,CL
37557ec4,1,0,0,0,1,0,0,0,1,1,0,4,5,2,0,23,CL
37d39918,8,1,7,1,0,3,5,2,3,1,2,10,18,14,0,23,CL
37dc1a48,4,2,3,1,0,1,5,4,11,0,11,2,6,1,0,23,CL
384d58d9,1,1,1,0,0,1,2,1,0,0,0,2,3,1,0,23,CL
38c7feef,1,1,0,0,1,1,1,0,0,0,0,1,2,0,0,23,CL
38f8ce7f,4,3,2,1,1,3,3,0,1,0,1,0,4,0,0,23,CL
392a7aea,5,3,2,2,1,2,5,3,10,2,8,4,9,11,0,23,CL
3935e52e,5,3,3,2,0,3,4,1,1,0,1,1,6,3,0,23,CL
395451fc,7,3,0,5,2,1,4,3,9,2,7,7,14,1,0,23,CL
3aca6420,9,4,8,0,1,5,10,5,3,0,3,0,9,4,0,23,CL
3b0108d6,0,0,0,0,0,0,1,1,0,0,0,0,0,0,0,23,CL
3b029691,8,6,3,4,1,1,11,10,8,1,7,13,21,1,0,23,CL
3b12b11f,2,2,2,0,0,1,1,0,0,0,0,1,3,0,0,23,CL
3b387cc7,0,0,0,0,0,0,0,0,0,0,0,0,0,0,0,23,CL
3b61c9ec,7,3,1,5,1,4,7,3,4,0,4,3,10,5,0,23,CL
3b8674e6,12,7,4,7,1,6,8,2,5,2,3,5,17,4,0,23,CL
3bb7b8b4,0,0,0,0,0,0,0,0,0,0,0,0,0,5,0,23,CL
3bb7f478,4,2,2,1,1,3,7,4,11,2,9,0,4,16,0,23,CL
3c6089ab,4,3,1,2,1,1,6,5,8,2,6,2,6,2,0,23,CL
3cd7820a,12,6,2,10,0,5,9,4,3,0,3,4,16,1,0,23,CL
3ce20eda,5,2,4,1,0,1,5,4,2,1,1,4,9,16,0,23,CL
3cefcaef,3,2,2,0,1,3,3,0,1,0,1,3,6,4,0,23,CL
3d50bcdb,1,1,0,1,0,0,0,0,1,0,1,0,1,0,0,23,CL
3e9bd29d,7,2,5,2,0,5,7,2,3,0,3,7,14,16,0,23,CL
3eb22ec9,19,10,4,8,7,10,32,22,11,0,11,9,28,5,0,23,CL
3effaa34,6,3,2,1,3,3,4,1,7,0,7,1,7,1,0,23,CL
3f034750,0,0,0,0,0,0,1,1,0,0,0,0,0,0,0,23,CL
3f10bd22,2,1,2,0,0,1,2,1,5,1,4,5,7,5,0,23,CL
407feb71,7,3,4,3,0,2,4,2,5,1,4,6,13,0,0,23,CL
40d08dcd,7,5,4,2,1,4,7,3,0,0,0,2,9,3,0,23,CL
40f65c01,3,2,2,0,1,1,2,1,0,0,0,0,3,0,0,23,CL
41034650,4,1,1,3,0,1,1,0,9,6,3,8,12,14,1,23,CL
415568b5,14,4,10,2,2,5,9,4,1,0,1,7,21,6,0,23,CL
41c12f75,16,13,11,5,0,7,11,4,5,0,5,5,21,14,0,23,CL
41eebdf5,0,0,0,0,0,0,1,1,6,3,3,4,4,5,0,23,CL
41f0b196,0,0,0,0,0,0,1,1,0,0,0,0,0,1,1,23,CL
41f32541,0,0,0,0,0,0,1,1,0,0,0,1,1,0,0,23,CL
420c18a1,0,0,0,0,0,0,0,0,0,0,0,0,0,6,1,23,CL
4288f249,1,1,0,1,0,0,0,0,2,2,0,0,1,2,0,23,CL
42fd9c7f,0,0,0,0,0,0,1,1,0,0,0,0,0,3,0,23,CL
433dc9a2,11,7,9,1,1,7,10,3,3,1,2,1,12,2,0,23,CL
43a166b4,0,0,0,0,0,0,1,1,2,1,1,0,0,3,0,23,CL
441197b8,13,7,8,5,0,4,11,7,9,3,6,13,26,28,0,23,CL
44781702,7,6,0,5,2,3,6,3,3,2,1,5,12,13,1,23,CL
44eb9093,3,1,0,2,1,2,6,4,1,1,0,4,7,5,0,23,CL
4535e4bb,0,0,0,0,0,0,0,0,0,0,0,0,0,0,0,23,CL
4567a0b4,0,0,0,0,0,0,0,0,3,1,2,1,1,0,0,23,CL
45736cec,0,0,0,0,0,0,0,0,0,0,0,0,0,0,0,23,CL
45a03961,12,9,8,3,1,4,8,4,10,5,5,13,25,20,0,23,CL
45af8a54,1,0,0,1,0,1,2,1,4,0,4,5,6,3,0,23,CL
45b9b619,2,1,1,1,0,0,4,4,1,0,1,0,2,1,0,23,CL
45db685d,14,6,8,4,2,5,7,2,13,0,13,11,25,6,0,23,CL
4601e194,0,0,0,0,0,0,1,1,3,2,1,0,0,1,0,23,CL
46152b69,11,6,6,5,0,7,11,4,13,5,8,8,19,8,0,23,CL
4737cebe,2,1,1,1,0,1,1,0,0,0,0,1,3,1,0,23,CL
47420f02,0,0,0,0,0,0,1,1,0,0,0,0,0,0,0,23,CL
47b7e3af,0,0,0,0,0,0,1,1,0,0,0,1,1,3,0,23,CL
481c9ece,9,6,5,2,2,5,11,6,14,4,10,8,17,19,0,23,CL
48b3dd60,1,0,1,0,0,1,1,0,0,0,0,0,1,0,0,23,CL
49296448,19,11,9,9,1,8,27,19,18,5,13,20,39,7,0,23,CL
4958bfb2,18,11,10,6,2,10,19,9,15,4,11,7,25,20,0,23,CL
49fe9070,2,0,1,1,0,0,5,5,3,0,3,0,2,3,1,23,CL
4a1a9578,4,2,2,0,2,2,3,1,3,1,2,0,4,0,0,23,CL
4a56052c,16,9,5,10,1,6,9,3,4,1,3,2,18,5,0,23,CL
4a5839fa,7,3,5,1,1,4,6,2,3,1,2,3,10,15,0,23,CL
4ab12002,0,0,0,0,0,0,0,0,1,0,1,0,0,2,0,23,CL
4b3e1a38,9,6,6,2,1,5,9,4,9,4,5,2,11,27,1,23,CL
4b803b3c,9,6,6,2,1,3,5,2,3,1,2,0,9,5,0,23,CL
4c184730,0,0,0,0,0,0,0,0,0,0,0,0,0,0,0,23,CL
4c2a5d34,8,6,0,3,5,4,11,7,6,0,6,1,9,10,0,23,CL
4c370d81,8,2,3,5,0,1,2,1,7,0,7,6,14,2,0,23,CL
4c62d0c8,0,0,0,0,0,0,0,0,0,0,0,0,0,0,0,23,CL
4c6facae,14,8,4,8,2,7,12,5,10,1,9,18,32,3,0,23,CL
4d1666ff,7,3,5,2,0,7,8,1,1,1,0,3,10,2,0,23,CL
4d1c4a5d,1,0,1,0,0,0,0,0,0,0,0,0,1,0,0,23,CL
4d77b365,3,3,2,1,0,0,1,1,5,0,5,1,4,1,0,23,CL
4da9191b,0,0,0,0,0,0,1,1,2,1,1,4,4,1,1,23,CL
4dbd0916,1,1,0,0,1,0,1,1,2,0,2,1,2,0,0,23,CL
4e219ad2,3,2,0,2,1,0,4,4,2,1,1,1,4,1,0,23,CL
4f1e6a0b,11,7,3,5,3,2,6,4,11,2,9,1,12,1,0,23,CL
4f255115,10,7,4,5,1,5,5,0,5,0,5,7,17,3,0,23,CL
4f28a6ff,15,8,7,7,1,6,8,2,6,3,3,7,22,16,0,23,CL
4f565d77,0,0,0,0,0,0,0,0,1,0,1,1,1,0,0,23,CL
4fb9c88f,2,0,0,2,0,1,1,0,3,0,3,1,3,0,0,23,CL
501055d8,1,1,0,0,1,1,3,2,3,0,3,2,3,1,0,23,CL
505486d6,15,6,9,3,3,5,7,2,11,1,10,6,21,14,0,23,CL
50871bcc,3,1,1,2,0,3,6,3,3,1,2,3,6,3,0,23,CL
51a3c4c8,4,4,3,1,0,1,1,0,4,3,1,1,5,5,1,23,CL
51a56075,6,4,5,1,0,5,10,5,6,4,2,3,9,20,0,23,CL
5219ab4a,6,1,3,3,0,2,5,3,4,1,3,5,11,2,0,23,CL
52ec54d0,2,0,1,1,0,2,4,2,6,6,0,2,4,14,0,23,CL
53070b63,2,2,1,1,0,1,1,0,0,0,0,0,2,0,0,23,CL
536cebe5,7,3,2,3,2,2,6,4,2,0,2,1,8,0,0,23,CL
53cad200,7,5,5,1,1,5,5,0,5,0,5,3,10,6,1,23,CL
5458f670,0,0,0,0,0,0,0,0,0,0,0,0,0,0,0,23,CL
54b4dc4e,7,5,1,6,0,1,6,5,3,0,3,3,10,1,0,23,CL
55126f3b,2,1,1,1,0,0,3,3,2,1,1,1,3,0,0,23,CL
5515376c,8,6,6,2,0,5,10,5,4,4,0,5,13,17,0,23,CL
5521f419,2,2,2,0,0,0,3,3,2,0,2,0,2,7,0,23,CL
555d5edd,3,2,1,0,2,2,4,2,0,0,0,2,5,1,0,23,CL
555f3a0b,1,1,0,0,1,1,3,2,2,1,1,2,3,9,0,23,CL
55a1cac2,5,2,1,3,1,2,6,4,3,0,3,0,5,1,0,23,CL
55abe554,1,1,1,0,0,1,4,3,2,0,2,4,5,2,1,23,CL
56413b1f,4,2,1,1,2,1,2,1,3,2,1,2,6,3,0,23,CL
56f6f826,6,3,1,5,0,3,7,4,8,3,5,5,11,19,0,23,CL
57760e66,3,0,3,0,0,1,6,5,1,0,1,1,4,1,0,23,CL
577efaec,14,7,8,6,0,5,14,9,7,1,6,11,25,9,0,23,CL
57d88cf9,15,8,9,3,3,8,16,8,15,4,11,13,28,8,0,23,CL
5853ac44,2,1,1,1,0,0,1,1,0,0,0,2,4,5,0,23,CL
58ae47b2,1,1,0,0,1,1,2,1,0,0,0,1,2,0,0,23,CL
58c6b67c,1,1,1,0,0,0,0,0,0,0,0,0,1,0,0,23,CL
58f077c0,0,0,0,0,0,0,0,0,0,0,0,0,0,4,0,23,CL
5976f83e,4,1,2,1,1,2,4,2,3,1,2,1,5,0,0,23,CL
5ab0ea87,8,8,1,6,1,4,7,3,2,0,2,4,12,2,1,23,CL
5ad50391,9,6,5,4,0,4,10,6,3,2,1,4,13,25,1,23,CL
5b3d1a7a,3,1,2,1,0,2,4,2,14,3,11,10,13,5,0,23,CL
5b92d896,1,1,0,1,0,1,1,0,0,0,0,0,1,0,0,23,CL
5c4dc0ff,0,0,0,0,0,0,0,0,0,0,0,0,0,0,0,23,CL
5c899683,3,1,1,1,1,2,2,0,2,0,2,0,3,2,0,23,CL
5ccc9672,0,0,0,0,0,0,1,1,2,0,2,0,0,1,0,23,CL
5cdddffa,8,1,4,4,0,3,5,2,6,1,5,5,13,1,0,23,CL
5cfec13d,0,0,0,0,0,0,0,0,3,3,0,0,0,5,0,23,CL
5d4f7d61,2,2,0,1,1,0,2,2,3,0,3,1,3,3,0,23,CL
5db20508,0,0,0,0,0,0,1,1,0,0,0,0,0,1,0,23,CL
5dfc6ad5,6,3,4,2,0,3,6,3,10,9,1,3,9,8,0,23,CL
5e861944,9,6,2,5,2,4,5,1,3,0,3,1,10,6,0,23,CL
5ea8ef20,4,3,1,2,1,3,5,2,3,2,1,6,10,1,0,23,CL
5eae500a,3,3,0,1,2,1,1,0,1,0,1,0,3,3,0,23,CL
5eaf85b5,0,0,0,0,0,0,1,1,1,1,0,0,0,1,0,23,CL
5ed9b537,6,5,4,2,0,3,3,0,4,3,1,1,7,11,0,23,CL
5eecec3d,2,2,2,0,0,1,3,2,6,4,2,4,6,10,0,23,CL
5ef3d210,0,0,0,0,0,0,0,0,1,0,1,0,0,1,0,23,CL
5fd5ed86,6,3,5,1,0,2,5,3,6,2,4,5,11,13,0,23,CL
5ff4ab71,27,14,9,13,5,12,23,11,14,3,11,10,37,5,0,23,CL
6025fab1,4,2,2,1,1,2,5,3,2,1,1,7,11,7,0,23,CL
61f63784,8,3,7,0,1,1,2,1,9,7,2,7,15,22,0,23,CL
62182b1d,0,0,0,0,0,0,1,1,0,0,0,0,0,1,0,23,CL
6250083a,8,4,2,6,0,4,9,5,4,0,4,2,10,4,0,23,CL
6434f10d,24,15,13,9,2,12,17,5,11,3,8,13,37,9,1,23,CL
64b08de7,0,0,0,0,0,0,0,0,0,0,0,0,0,1,0,23,CL
65d62814,0,0,0,0,0,0,0,0,0,0,0,0,0,4,1,23,CL
6622454d,0,0,0,0,0,0,4,4,6,1,5,2,2,0,0,23,CL
663e080e,0,0,0,0,0,0,0,0,0,0,0,0,0,2,0,23,CL
6747869d,0,0,0,0,0,0,0,0,0,0,0,0,0,0,0,23,CL
67b09a18,0,0,0,0,0,0,0,0,1,0,1,0,0,1,0,23,CL
6800f515,3,1,2,1,0,2,5,3,2,0,2,5,8,4,0,23,CL
6885cc44,8,4,5,2,1,5,8,3,9,0,9,4,12,9,0,23,CL
688fcea2,2,1,0,1,1,0,1,1,4,2,2,4,6,0,0,23,CL
690d1049,3,1,1,1,1,1,6,5,8,2,6,3,6,2,0,23,CL
691bef82,17,10,6,6,5,10,14,4,6,2,4,4,21,9,1,23,CL
6928979a,23,14,10,11,2,9,24,15,14,1,13,2,25,11,0,23,CL
69384e5d,3,1,1,0,2,2,8,6,1,0,1,2,5,2,0,23,CL
6aa3e78b,9,7,4,3,2,2,4,2,1,0,1,2,11,8,1,23,CL
6b994195,2,2,1,1,0,2,2,0,1,1,0,1,3,1,0,23,CL
6b9960cf,2,2,1,1,0,2,5,3,0,0,0,0,2,0,0,23,CL
6bb2c084,14,8,4,5,5,4,8,4,5,1,4,14,28,5,0,23,CL
6bc49da7,1,0,1,0,0,1,1,0,2,0,2,0,1,0,0,23,CL
6c203af0,2,1,2,0,0,1,2,1,4,1,3,2,4,2,0,23,CL
6caffe81,0,0,0,0,0,0,0,0,0,0,0,0,0,0,0,23,CL
6ce1f46f,26,16,11,12,3,11,18,7,7,2,5,9,35,2,0,23,CL
6ce43701,2,1,1,0,1,0,0,0,0,0,0,0,2,0,0,23,CL
6db16dda,2,2,0,2,0,0,0,0,3,0,3,0,2,1,0,23,CL
6e058f06,4,3,0,3,1,0,1,1,1,0,1,2,6,1,0,23,CL
6e4df551,2,2,0,1,1,1,3,2,0,0,0,3,5,0,0,23,CL
6f1d7aa8,2,1,0,2,0,1,1,0,0,0,0,0,2,0,0,23,CL
6f3cc2fe,4,3,0,3,1,1,4,3,4,1,3,1,5,4,0,23,CL
6f51e382,0,0,0,0,0,0,0,0,0,0,0,0,0,0,0,23,CL
6f639ec7,1,1,1,0,0,1,3,2,1,0,1,1,2,0,0,23,CL
6fe90922,19,7,8,9,2,10,20,10,8,5,3,4,23,18,1,23,CL
6fee9966,1,1,1,0,0,1,1,0,0,0,0,0,1,1,0,23,CL
707b98f1,0,0,0,0,0,0,1,1,0,0,0,0,0,0,0,23,CL
70cf63ca,11,5,2,5,4,7,14,7,7,1,6,1,12,0,0,23,CL
70d74ece,2,2,1,0,1,0,1,1,5,0,5,0,2,8,0,23,CL
71031a25,2,1,0,2,0,0,3,3,5,0,5,1,3,2,0,23,CL
7111d552,10,7,7,3,0,4,12,8,8,0,8,1,11,1,0,23,CL
712dd708,9,3,4,4,1,4,8,4,11,7,4,3,12,5,0,23,CL
713c144a,13,9,2,8,3,7,10,3,5,0,5,4,17,0,0,23,CL
7155e3e1,1,0,1,0,0,0,0,0,0,0,0,1,2,0,0,23,CL
733e7ad8,1,1,1,0,0,1,1,0,0,0,0,0,1,1,0,23,CL
736157b7,12,6,4,6,2,3,4,1,3,2,1,4,16,8,0,23,CL
73b9fa8a,1,0,0,0,1,0,0,0,0,0,0,0,1,0,0,23,CL
74b7375f,12,7,6,5,1,3,7,4,3,0,3,4,16,5,1,23,CL
74f2e748,8,5,3,3,2,7,11,4,4,1,3,5,13,7,0,23,CL
751a0fb5,9,5,3,5,1,5,12,7,7,2,5,6,15,14,0,23,CL
75b86fb3,20,8,17,3,0,10,16,6,14,5,9,9,29,32,0,23,CL
75c2e240,0,0,0,0,0,0,0,0,0,0,0,0,0,2,0,23,CL
762179d9,2,1,1,1,0,1,4,3,3,0,3,7,9,2,0,23,CL
7713c72a,7,5,5,2,0,2,3,1,11,9,2,7,14,30,1,23,CL
77e39b04,5,4,1,4,0,2,4,2,3,0,3,2,7,3,0,23,CL
77e84962,15,8,5,6,4,5,9,4,4,0,4,7,22,0,0,23,CL
78f21137,14,9,8,5,1,6,12,6,13,3,10,17,31,11,0,23,CL
78f85621,5,1,2,3,0,2,3,1,4,0,4,3,8,5,0,23,CL
79083382,3,1,1,2,0,0,1,1,5,5,0,1,4,6,0,23,CL
79443529,1,1,0,1,0,0,2,2,2,1,1,0,1,4,0,23,CL
79c0821a,11,5,3,7,1,8,16,8,8,1,7,6,17,2,0,23,CL
7a11550b,4,2,2,2,0,3,3,0,2,1,1,5,9,6,2,23,CL
7a20d90a,2,1,2,0,0,1,4,3,6,4,2,4,6,12,0,23,CL
7a2e46a8,0,0,0,0,0,0,2,2,0,0,0,0,0,1,1,23,CL
7b4c1f6e,2,2,1,1,0,1,1,0,0,0,0,1,3,0,0,23,CL
7b5ab7f2,0,0,0,0,0,0,2,2,2,0,2,2,2,0,0,23,CL
7b9c2d84,26,17,17,6,3,11,32,21,12,0,12,6,32,11,0,23,CL
7be09c86,0,0,0,0,0,0,0,0,0,0,0,0,0,1,0,23,CL
7c3ed041,11,6,3,7,1,3,11,8,5,4,1,13,24,12,1,23,CL
7c473e12,1,0,1,0,0,1,1,0,1,1,0,7,8,7,0,23,CL
7c56da38,6,4,3,2,1,0,2,2,1,0,1,4,10,3,0,23,CL
7d3e7da6,0,0,0,0,0,0,0,0,0,0,0,0,0,0,0,23,CL
7d450ed3,13,7,8,4,1,10,22,12,7,1,6,7,20,15,0,23,CL
7e56d3db,6,2,4,1,1,2,6,4,7,4,3,6,12,8,0,23,CL
7ed08d5c,10,7,6,3,1,8,10,2,7,1,6,4,14,7,1,23,CL
7edfbb8a,22,16,13,9,0,11,14,3,12,8,4,10,32,29,0,23,CL
7f3b388c,13,8,4,8,1,2,11,9,8,3,5,9,22,5,0,23,CL
7fa4e703,3,2,0,2,1,1,5,4,2,0,2,3,6,2,1,23,CL
81442ecb,9,5,7,2,0,8,9,1,0,0,0,2,11,3,0,23,CL
817c6964,17,11,10,5,2,7,21,14,15,8,7,7,24,8,1,23,CL
819b3158,12,8,5,4,3,4,12,8,8,1,7,7,19,6,0,23,CL
826e8b63,1,1,0,0,1,1,4,3,3,0,3,1,2,1,0,23,CL
829aa60c,1,1,1,0,0,1,1,0,5,0,5,3,4,0,0,23,CL
82a39b66,8,4,2,4,2,4,7,3,4,2,2,3,11,5,1,23,CL
82c615f8,10,5,8,1,1,3,11,8,5,2,3,5,15,12,0,23,CL
82e12fe7,9,8,4,2,3,1,3,2,5,1,4,1,10,0,0,23,CL
83300259,1,0,0,1,0,1,1,0,1,0,1,2,3,4,0,23,CL
834d0be5,0,0,0,0,0,0,0,0,0,0,0,0,0,0,0,23,CL
8454388c,12,5,6,3,3,7,8,1,6,0,6,4,16,12,0,23,CL
85613cf0,2,1,0,1,1,1,3,2,2,0,2,1,3,0,0,23,CL
85f7d1be,15,8,11,4,0,4,9,5,12,6,6,7,22,17,0,23,CL
862fa9fb,2,1,2,0,0,2,3,1,4,3,1,10,12,21,0,23,CL
86dd77d1,9,7,4,3,2,7,9,2,1,1,0,3,12,8,0,23,CL
86df4d6b,1,1,1,0,0,0,0,0,0,0,0,0,1,0,0,23,CL
86e7deaf,8,6,6,1,1,3,4,1,8,6,2,9,17,32,0,23,CL
8778c910,0,0,0,0,0,0,0,0,0,0,0,0,0,0,0,23,CL
8794e251,16,8,7,7,2,6,8,2,9,2,7,5,21,3,0,23,CL
881cd6be,26,15,8,18,0,9,31,22,11,1,10,27,53,15,0,23,CL
8827bf46,1,1,1,0,0,0,0,0,2,0,2,0,1,0,0,23,CL
88ce7ddc,0,0,0,0,0,0,0,0,0,0,0,0,0,1,0,23,CL
88ced02c,3,2,2,1,0,2,4,2,2,1,1,4,7,15,0,23,CL
88e357ef,8,3,4,3,1,2,11,9,6,0,6,0,8,2,0,23,CL
892d5bb1,9,5,1,3,5,5,9,4,1,0,1,1,10,1,0,23,CL
89ac64a6,27,16,10,15,2,14,26,12,14,2,12,9,36,20,1,23,CL
89f951b5,9,4,2,4,3,2,8,6,5,2,3,4,13,3,0,23,CL
8aafd64f,4,1,2,1,1,3,6,3,1,0,1,0,4,0,0,23,CL
8b04d6c1,12,8,8,3,1,9,20,11,7,4,3,11,23,6,0,23,CL
8b3ab7ad,15,8,6,8,1,8,12,4,5,1,4,11,26,18,0,23,CL
8b8a56ce,6,4,4,2,0,5,8,3,10,5,5,6,12,24,0,23,CL
8b8e759d,5,5,4,0,1,2,3,1,4,1,3,4,9,11,0,23,CL
8b929ec2,0,0,0,0,0,0,0,0,0,0,0,1,1,1,0,23,CL
8c5f1522,1,0,0,1,0,0,3,3,3,0,3,3,4,0,0,23,CL
8c90fd7a,5,2,0,2,3,4,5,1,0,0,0,1,6,7,0,23,CL
8ce30c57,0,0,0,0,0,0,0,0,1,1,0,2,2,1,0,23,CL
8d3d3b0a,4,3,1,0,3,0,2,2,5,0,5,4,8,3,0,23,CL
8d78e732,5,4,0,1,4,1,1,0,3,0,3,1,6,6,0,23,CL
8e034340,7,3,3,2,2,1,4,3,3,0,3,0,7,1,0,23,CL
8e50599a,0,0,0,0,0,0,0,0,0,0,0,0,0,0,0,23,CL
8f0435c7,11,7,9,2,0,7,11,4,13,4,9,14,25,34,0,23,CL
8f056768,11,7,4,7,0,7,12,5,12,3,9,5,16,2,1,23,CL
8f5cdf66,4,3,3,1,0,2,4,2,1,0,1,0,4,1,0,23,CL
8f5e92a6,7,3,3,3,1,3,8,5,13,4,9,9,16,6,0,23,CL
8f62b6ee,0,0,0,0,0,0,0,0,0,0,0,1,1,2,0,23,CL
8f696594,0,0,0,0,0,0,0,0,0,0,0,0,0,0,0,23,CL
8fd9996f,10,7,7,3,0,7,8,1,3,2,1,6,16,12,0,23,CL
8ff2354e,1,0,0,1,0,0,3,3,2,0,2,6,7,2,0,23,CL
90339309,8,5,5,2,1,2,3,1,2,0,2,7,15,6,0,23,CL
90c1f9a4,0,0,0,0,0,0,0,0,4,1,3,1,1,4,0,23,CL
92432bc6,12,9,4,7,1,4,5,1,5,1,4,10,22,4,0,23,CL
92e7e919,10,4,5,2,3,2,8,6,2,0,2,1,11,3,0,23,CL
92fffd91,7,3,2,3,2,2,9,7,2,0,2,3,10,1,0,23,CL
934e1968,8,6,3,4,1,4,16,12,8,0,8,1,9,4,0,23,CL
935e6b8f,7,2,1,2,4,4,7,3,2,0,2,3,10,1,0,23,CL
93fffbcf,0,0,0,0,0,0,0,0,0,0,0,0,0,3,0,23,CL
9413b19f,0,0,0,0,0,0,0,0,0,0,0,0,0,3,1,23,CL
94721522,1,0,1,0,0,0,2,2,0,0,0,3,4,2,0,23,CL
94b2001f,7,2,6,1,0,3,6,3,3,0,3,7,14,11,0,23,CL
953597a1,1,1,0,1,0,0,0,0,1,1,0,0,1,2,0,23,CL
95bb6ddc,8,6,3,5,0,2,5,3,0,0,0,1,9,4,0,23,CL
95f5aae8,9,9,5,3,1,4,10,6,11,4,7,11,20,11,1,23,CL
9606f0b2,0,0,0,0,0,0,0,0,0,0,0,0,0,0,0,23,CL
966e28d0,2,1,0,2,0,0,4,4,3,1,2,0,2,0,0,23,CL
9674002f,13,6,4,6,3,5,12,7,7,1,6,4,17,2,0,23,CL
96e0490d,20,11,14,6,0,8,20,12,9,4,5,19,39,28,0,23,CL
970b8574,9,6,3,6,0,6,16,10,10,3,7,10,19,19,0,23,CL
97220da2,2,1,0,0,2,0,1,1,1,1,0,0,2,0,0,23,CL
9744ff80,1,1,1,0,0,1,1,0,1,0,1,0,1,0,0,23,CL
99a8ddc9,13,6,7,4,2,7,18,11,10,1,9,10,23,7,0,23,CL
9a2e0ccc,8,4,2,3,3,4,12,8,4,0,4,1,9,1,0,23,CL
9ab16552,2,2,1,1,0,1,2,1,7,2,5,2,4,9,0,23,CL
9dff291c,0,0,0,0,0,0,0,0,0,0,0,1,1,1,0,23,CL
9e1035f8,2,2,0,0,2,1,2,1,0,0,0,0,2,1,0,23,CL
9efa1d25,7,3,2,3,2,4,12,8,5,1,4,3,10,2,0,23,CL
a04e47f0,2,2,0,1,1,0,1,1,0,0,0,0,2,0,0,23,CL
a086ae11,0,0,0,0,0,0,0,0,0,0,0,0,0,0,0,23,CL
a08b974a,0,0,0,0,0,0,0,0,0,0,0,1,1,1,1,23,CL
a0b4bb3e,6,3,3,3,0,3,11,8,2,0,2,5,11,1,0,23,CL
a1232f4e,6,5,2,4,0,4,5,1,4,4,0,15,21,8,0,23,CL
a167537f,7,3,2,3,2,2,10,8,5,1,4,2,9,4,0,23,CL
a29b1131,3,1,0,1,2,1,1,0,2,0,2,1,4,1,0,23,CL
a2ea941d,2,2,1,0,1,1,1,0,1,0,1,1,3,0,0,23,CL
a30e23de,3,3,3,0,0,2,3,1,0,0,0,0,3,2,0,23,CL
a33a0dc0,2,1,0,1,1,0,0,0,1,0,1,2,4,0,0,23,CL
a36524bf,14,9,8,4,2,7,11,4,9,4,5,7,21,23,0,23,CL
a39bb753,0,0,0,0,0,0,1,1,1,0,1,1,1,0,0,23,CL
a3d94a58,14,9,3,10,1,9,17,8,7,3,4,10,24,12,0,23,CL
a427724f,0,0,0,0,0,0,1,1,0,0,0,0,0,0,0,23,CL
a5296e55,8,4,0,6,2,0,2,2,3,0,3,4,12,4,1,23,CL
a5420709,10,5,3,4,3,6,9,3,2,0,2,3,13,4,0,23,CL
a62c16d0,3,2,1,2,0,0,1,1,2,0,2,0,3,6,0,23,CL
a650c75b,5,1,3,1,1,1,1,0,3,1,2,2,7,3,0,23,CL
a65c844b,11,8,2,4,5,4,9,5,9,3,6,4,15,7,0,23,CL
a65ce836,16,12,7,8,1,7,11,4,13,4,9,13,29,6,1,23,CL
a69e4806,10,6,4,1,5,5,11,6,7,0,7,2,12,3,0,23,CL
a6ee4f55,7,5,7,0,0,6,7,1,4,1,3,2,9,8,0,23,CL
a73c8f95,6,5,4,2,0,4,5,1,2,1,1,4,10,18,0,23,CL
a793f5a8,9,6,7,1,1,4,7,3,1,0,1,6,15,5,1,23,CL
a8567629,9,5,2,3,4,7,8,1,6,0,6,4,13,5,0,23,CL
a8a874f1,9,5,2,3,4,4,6,2,6,0,6,2,11,2,0,23,CL
a8b8af8d,0,0,0,0,0,0,0,0,1,1,0,1,1,6,0,23,CL
a8ee54ad,20,9,11,8,1,11,23,12,7,3,4,3,23,18,2,23,CL
a9142dc3,1,1,0,0,1,0,0,0,0,0,0,1,2,0,0,23,CL
aa34ed38,1,0,1,0,0,0,2,2,2,1,1,0,1,0,0,23,CL
ab708880,0,0,0,0,0,0,0,0,0,0,0,0,0,1,0,23,CL
abe66106,4,1,3,1,0,2,3,1,6,0,6,2,6,0,0,23,CL
ac295d9e,0,0,0,0,0,0,0,0,1,0,1,0,0,0,0,23,CL
ac73ec79,1,1,0,1,0,1,1,0,3,1,2,1,2,2,0,23,CL
ac861941,7,5,1,6,0,2,5,3,4,3,1,8,15,23,2,23,CL
ad3389d5,0,0,0,0,0,0,0,0,0,0,0,0,0,1,1,23,CL
ad9b2747,6,3,3,3,0,3,6,3,4,0,4,4,10,3,0,23,CL
adfbe1f5,7,4,4,2,1,0,2,2,4,0,4,4,11,3,0,23,CL
adfc9123,3,2,0,3,0,1,2,1,3,2,1,3,6,8,0,23,CL
ae1159bf,10,7,5,5,0,6,7,1,4,2,2,3,13,17,0,23,CL
ae44e8e2,4,2,4,0,0,2,3,1,0,0,0,0,4,0,0,23,CL
ae4e2852,1,1,0,1,0,1,1,0,1,0,1,1,2,0,0,23,CL
aed44b64,5,2,2,2,1,2,5,3,3,2,1,2,7,5,0,23,CL
aee634bf,10,7,3,6,1,5,11,6,8,1,7,2,12,12,1,23,CL
aeed5c06,4,2,1,2,1,2,3,1,4,0,4,0,4,0,0,23,CL
aef6e670,2,2,1,1,0,0,0,0,1,0,1,2,4,2,0,23,CL
b056e3da,0,0,0,0,0,0,0,0,0,0,0,0,0,4,0,23,CL
b0b4fd3e,8,5,4,3,1,5,13,8,10,3,7,4,12,6,0,23,CL
b0f7e36c,0,0,0,0,0,0,0,0,2,0,2,0,0,0,0,23,CL
b1313ec4,4,1,0,4,0,1,6,5,4,1,3,1,5,1,0,23,CL
b19db005,11,7,3,4,4,4,5,1,1,0,1,2,13,0,0,23,CL
b1cd37e6,8,4,3,2,3,6,16,10,3,1,2,0,8,4,0,23,CL
b1f4086c,25,10,11,8,6,16,33,17,13,4,9,13,38,17,0,23,CL
b217ef29,8,3,4,4,0,5,6,1,0,0,0,3,11,3,0,23,CL
b244e804,12,7,9,2,1,4,10,6,7,3,4,5,17,12,0,23,CL
b35a7399,3,2,1,2,0,1,2,1,4,1,3,2,5,13,0,23,CL
b3a712de,9,8,7,1,1,4,6,2,4,2,2,9,18,8,0,23,CL
b3b7f5a6,0,0,0,0,0,0,0,0,0,0,0,0,0,0,0,23,CL
b400bde0,8,2,3,4,1,3,9,6,3,0,3,0,8,2,0,23,CL
b4705807,5,4,3,2,0,3,4,1,5,1,4,1,6,4,0,23,CL
b4ecc6b6,1,0,1,0,0,0,1,1,1,0,1,1,2,6,0,23,CL
b56dd813,0,0,0,0,0,0,0,0,0,0,0,0,0,0,0,23,CL
b57e066e,1,1,0,1,0,0,0,0,2,1,1,0,1,0,0,23,CL
b5b2e1ba,2,1,0,1,1,1,3,2,0,0,0,0,2,1,0,23,CL
b62878a5,4,2,1,3,0,2,4,2,3,0,3,5,9,3,0,23,CL
b74277a0,13,9,8,4,1,7,11,4,3,1,2,3,16,11,0,23,CL
b7c19c48,2,0,0,2,0,0,1,1,3,1,2,2,4,10,0,23,CL
b825a650,8,6,4,3,1,2,3,1,1,0,1,3,11,2,1,23,CL
b8e740fb,6,5,2,3,1,2,3,1,2,1,1,3,9,3,0,23,CL
b96b595c,10,8,8,2,0,4,7,3,8,2,6,11,21,46,0,23,CL
b997c3de,10,9,3,6,1,3,14,11,6,3,3,11,21,11,0,23,CL
b9beb6c5,5,2,3,0,2,2,7,5,2,0,2,4,9,0,0,23,CL
b9e1436c,8,5,2,6,0,4,8,4,10,0,10,5,13,4,0,23,CL
b9fbae28,3,2,0,0,3,2,4,2,2,0,2,2,5,0,0,23,CL
ba115a40,0,0,0,0,0,0,0,0,1,0,1,0,0,0,0,23,CL
ba492306,0,0,0,0,0,0,1,1,0,0,0,1,1,1,0,23,CL
bbd86530,6,2,3,3,0,4,6,2,4,0,4,4,10,4,0,23,CL
bbf5c11b,0,0,0,0,0,0,0,0,1,0,1,0,0,5,0,23,CL
bc6e544a,19,11,13,5,1,10,12,2,5,1,4,9,28,19,1,23,CL
bcb2ccd8,0,0,0,0,0,0,0,0,0,0,0,0,0,0,2,23,CL
bceda5ff,4,3,3,1,0,0,0,0,1,0,1,0,4,2,0,23,CL
bd142efb,8,6,3,5,0,4,8,4,8,5,3,2,10,26,0,23,CL
bd6351cd,14,9,6,6,2,7,15,8,6,0,6,3,17,3,0,23,CL
be6a794c,4,3,1,3,0,3,4,1,1,0,1,2,6,1,0,23,CL
be765073,11,5,6,5,0,8,11,3,7,4,3,6,17,13,1,23,CL
bfde3de5,0,0,0,0,0,0,3,3,0,0,0,1,1,2,0,23,CL
c0617e2b,4,1,0,4,0,1,1,0,6,0,6,0,4,0,0,23,CL
c066d1a5,4,3,1,1,2,1,2,1,1,0,1,0,4,0,0,23,CL
c0b3669f,4,4,1,2,1,0,0,0,4,2,2,2,6,0,0,23,CL
c0c7ff58,5,1,2,1,2,3,9,6,3,0,3,1,6,4,0,23,CL
c1242d4e,0,0,0,0,0,0,0,0,0,0,0,0,0,0,1,23,CL
c13ddd3e,0,0,0,0,0,0,1,1,0,0,0,0,0,1,0,23,CL
c14bc029,10,6,3,5,2,5,6,1,7,0,7,4,14,5,0,23,CL
c16c4e3b,4,0,2,1,1,3,4,1,5,0,5,2,6,3,0,23,CL
c19a2df1,1,1,1,0,0,1,1,0,0,0,0,0,1,0,0,23,CL
c1b7847c,10,6,4,4,2,3,12,9,4,0,4,2,12,2,0,23,CL
c20bdcd7,11,8,9,2,0,9,10,1,8,1,7,5,16,7,0,23,CL
c2111b45,2,2,1,0,1,2,2,0,1,1,0,0,2,2,0,23,CL
c235e803,3,1,2,1,0,3,3,0,1,0,1,3,6,10,0,23,CL
c2731c10,9,6,4,3,2,4,9,5,0,0,0,5,14,4,0,23,CL
c275947b,8,4,3,3,2,5,7,2,5,0,5,3,11,0,0,23,CL
c2a15a27,1,1,0,1,0,0,1,1,0,0,0,0,1,1,0,23,CL
c2a30c01,0,0,0,0,0,0,1,1,0,0,0,0,0,1,0,23,CL
c3e39f12,0,0,0,0,0,0,0,0,0,0,0,0,0,0,0,23,CL
c3ee18ef,3,2,3,0,0,2,3,1,3,2,1,8,11,2,0,23,CL
c50cee19,4,2,1,2,1,2,3,1,2,0,2,0,4,3,0,23,CL
c5cbbcff,14,9,8,6,0,11,14,3,4,0,4,4,18,10,0,23,CL
c68da769,2,1,0,0,2,0,7,7,3,0,3,0,2,1,0,23,CL
c691bfe2,10,6,1,4,5,4,5,1,10,1,9,4,14,2,0,23,CL
c693347d,1,1,0,1,0,0,0,0,3,0,3,0,1,1,0,23,CL
c738a5ec,0,0,0,0,0,0,0,0,0,0,0,0,0,0,0,23,CL
c8829a58,1,1,0,0,1,1,2,1,0,0,0,2,3,1,0,23,CL
c8d1c3a5,10,4,6,3,1,7,11,4,3,1,2,2,12,9,0,23,CL
c9009a1f,3,1,2,1,0,0,0,0,3,3,0,4,7,13,0,23,CL
c906ce0f,7,4,7,0,0,5,6,1,3,3,0,6,13,15,0,23,CL
c967f6b8,1,1,1,0,0,0,0,0,2,0,2,5,6,12,0,23,CL
c9817014,29,17,10,18,1,7,14,7,8,0,8,13,42,8,1,23,CL
ca002b1a,2,0,1,1,0,0,1,1,0,0,0,0,2,1,0,23,CL
ca607d59,4,0,0,3,1,3,4,1,4,0,4,0,4,0,0,23,CL
ca8033cb,3,1,3,0,0,2,2,0,3,1,2,0,3,0,0,23,CL
cb4f24c6,0,0,0,0,0,0,0,0,0,0,0,1,1,1,1,23,CL
cb641b9d,1,1,0,0,1,0,1,1,1,0,1,0,1,0,0,23,CL
cb64672e,0,0,0,0,0,0,0,0,0,0,0,1,1,0,0,23,CL
cc1c5035,0,0,0,0,0,0,0,0,0,0,0,0,0,0,0,23,CL
cc83b74d,0,0,0,0,0,0,0,0,2,0,2,1,1,1,0,23,CL
cc86b9a3,16,9,6,7,3,6,17,11,13,3,10,7,23,7,1,23,CL
cce181df,8,4,1,6,1,5,5,0,4,0,4,7,15,2,0,23,CL
cd0fa27b,16,11,5,8,3,8,20,12,5,3,2,8,24,7,0,23,CL
cd1629bc,5,5,4,1,0,3,5,2,5,4,1,5,10,5,0,23,CL
cd1acf9d,19,13,10,8,1,16,30,14,7,2,5,4,23,3,0,23,CL
cd59b9df,0,0,0,0,0,0,0,0,0,0,0,0,0,1,0,23,CL
ce17b5eb,0,0,0,0,0,0,0,0,0,0,0,0,0,1,0,23,CL
ce30bfc8,6,2,1,3,2,1,4,3,8,0,8,2,8,1,0,23,CL
cf007308,8,1,1,7,0,5,10,5,5,1,4,0,8,2,0,23,CL
cf15bbb1,5,4,2,2,1,1,1,0,4,0,4,2,7,3,0,23,CL
cfdacb90,11,2,7,2,2,3,11,8,1,0,1,7,18,3,0,23,CL
d00fd50a,4,1,3,1,0,2,8,6,2,0,2,6,10,4,0,23,CL
d0a39bdf,7,2,5,2,0,2,6,4,4,1,3,3,10,15,0,23,CL
d0b8e745,0,0,0,0,0,0,0,0,0,0,0,0,0,0,0,23,CL
d0d8dd44,10,4,9,1,0,4,5,1,6,4,2,4,14,21,0,23,CL
d19ef4ef,2,1,0,1,1,0,1,1,4,1,3,0,2,0,0,23,CL
d1eda5f0,3,1,2,0,1,2,2,0,1,0,1,0,3,0,0,23,CL
d2416c2e,1,0,0,1,0,1,3,2,3,0,3,0,1,1,0,23,CL
d2424d1b,12,8,4,6,2,4,7,3,8,4,4,4,16,5,0,23,CL
d248cd8f,14,8,10,4,0,8,11,3,7,3,4,14,28,22,2,23,CL
d2fd7c14,5,3,2,0,3,5,5,0,2,0,2,2,7,1,0,23,CL
d3dc62d1,0,0,0,0,0,0,0,0,0,0,0,0,0,0,0,23,CL
d436eb94,0,0,0,0,0,0,0,0,0,0,0,1,1,5,0,23,CL
d4c9725f,27,16,12,12,3,10,18,8,7,2,5,6,33,21,2,23,CL
d557d734,1,1,1,0,0,1,1,0,2,0,2,2,3,1,0,23,CL
d5dd5f1f,0,0,0,0,0,0,1,1,4,0,4,0,0,3,0,23,CL
d5f2f82b,5,3,2,3,0,4,7,3,7,4,3,3,8,20,0,23,CL
d697a2d0,0,0,0,0,0,0,0,0,0,0,0,0,0,0,0,23,CL
d6e53a3a,5,3,2,3,0,1,3,2,6,4,2,10,15,21,0,23,CL
d70ce98e,4,4,1,2,1,0,3,3,3,0,3,3,7,0,0,23,CL
d720e834,0,0,0,0,0,0,0,0,0,0,0,0,0,1,0,23,CL
d781d855,22,10,16,5,1,9,15,6,15,5,10,8,30,12,0,23,CL
d820a7c8,0,0,0,0,0,0,2,2,0,0,0,3,3,3,0,23,CL
d92ab59f,5,1,3,2,0,4,8,4,2,0,2,4,9,10,0,23,CL
d97cccc9,4,3,2,2,0,2,2,0,1,1,0,1,5,1,1,23,CL
d9d43555,1,0,0,0,1,1,2,1,3,0,3,1,2,0,0,23,CL
da7b447d,0,0,0,0,0,0,0,0,1,1,0,0,0,1,0,23,CL
da9018ca,23,17,12,10,1,7,20,13,5,0,5,9,32,6,0,23,CL
da974c7b,12,7,9,2,1,7,11,4,17,6,11,8,20,21,0,23,CL
db092d3b,26,13,11,10,5,5,10,5,5,0,5,7,33,2,0,23,CL
dbfbdf06,2,2,1,1,0,2,2,0,0,0,0,0,2,0,0,23,CL
dc62b55d,2,1,0,0,2,1,1,0,4,0,4,1,3,0,0,23,CL
dc7f8a28,1,0,0,1,0,1,1,0,3,0,3,0,1,0,0,23,CL
dccd127f,5,3,1,4,0,1,1,0,2,1,1,4,9,9,0,23,CL
dcfb17f4,3,1,1,2,0,0,1,1,6,0,6,0,3,0,0,23,CL
dd0daf32,26,17,15,9,2,12,29,17,12,2,10,16,42,11,0,23,CL
de39485a,7,4,3,3,1,4,8,4,6,0,6,1,8,1,0,23,CL
dea88efd,12,10,8,1,3,8,17,9,6,0,6,2,14,5,0,23,CL
df064106,13,5,6,5,2,4,16,12,9,0,9,14,27,5,0,23,CL
df3cda47,5,3,0,4,1,2,4,2,4,0,4,1,6,0,0,23,CL
df525574,0,0,0,0,0,0,0,0,0,0,0,0,0,0,0,23,CL
df69b544,7,5,3,3,1,4,7,3,5,1,4,2,9,1,0,23,CL
df8b52a5,18,11,4,6,8,7,14,7,4,0,4,3,21,13,0,23,CL
dff153a4,10,3,6,3,1,6,10,4,7,4,3,3,13,0,0,23,CL
e06683ca,4,2,3,1,0,1,4,3,4,4,0,4,8,22,0,23,CL
e0b113a7,10,7,3,6,1,5,6,1,13,7,6,5,15,10,0,23,CL
e0f8151c,12,9,11,0,1,6,6,0,9,8,1,22,34,32,0,23,CL
e12b0b5b,11,5,4,7,0,2,7,5,2,0,2,3,14,2,0,23,CL
e162b013,13,7,8,4,1,7,10,3,6,1,5,6,19,10,0,23,CL
e1cbb531,21,11,7,10,4,11,20,9,7,2,5,5,26,3,1,23,CL
e280527c,10,8,7,2,1,5,7,2,4,1,3,5,15,3,0,23,CL
e2ae54db,5,3,2,2,1,1,2,1,1,0,1,0,5,1,0,23,CL
e33c06cf,5,5,5,0,0,3,7,4,9,6,3,6,11,25,0,23,CL
e342ad68,3,1,2,1,0,2,5,3,3,0,3,2,5,1,0,23,CL
e34e086c,0,0,0,0,0,0,0,0,0,0,0,0,0,0,0,23,CL
e3756e72,2,1,2,0,0,1,3,2,2,0,2,1,3,2,0,23,CL
e42d61c7,9,6,4,4,1,3,12,9,2,0,2,8,17,7,0,23,CL
e46012d4,9,3,1,5,3,2,9,7,4,0,4,2,11,5,0,23,CL
e6bc67d7,0,0,0,0,0,0,0,0,0,0,0,0,0,1,0,23,CL
e7281ea9,3,2,3,0,0,0,2,2,0,0,0,1,4,3,0,23,CL
e73659d3,1,1,0,1,0,0,1,1,2,0,2,1,2,1,0,23,CL
e73c9bb2,8,4,3,1,4,4,7,3,7,2,5,4,12,10,1,23,CL
e76cb9cc,14,6,10,2,2,5,5,0,4,1,3,4,18,6,0,23,CL
e7af9060,0,0,0,0,0,0,0,0,0,0,0,0,0,0,0,23,CL
e7d59f4f,1,0,0,1,0,1,2,1,3,1,2,3,4,1,0,23,CL
e82adcab,3,1,0,2,1,1,2,1,4,0,4,1,4,2,1,23,CL
e97fd090,7,4,0,6,1,2,3,1,5,2,3,7,14,3,0,23,CL
e9971f2d,1,1,1,0,0,1,1,0,0,0,0,0,1,0,0,23,CL
e9b0ccaf,3,1,1,1,1,1,2,1,0,0,0,1,4,2,0,23,CL
e9c0c1b2,0,0,0,0,0,0,0,0,0,0,0,0,0,2,0,23,CL
e9fda01d,2,2,1,1,0,1,1,0,0,0,0,0,2,0,0,23,CL
eaeca114,12,6,3,6,3,3,5,2,2,1,1,7,19,13,0,23,CL
eaeefc50,2,1,2,0,0,1,1,0,0,0,0,0,2,2,0,23,CL
eaefa2d0,0,0,0,0,0,0,0,0,1,1,0,0,0,0,0,23,CL
eca17cf2,0,0,0,0,0,0,0,0,0,0,0,0,0,2,0,23,CL
ed1e53f3,5,4,2,1,2,2,3,1,3,0,3,5,10,0,0,23,CL
ed45c4a5,15,6,7,7,1,5,6,1,3,0,3,8,23,5,0,23,CL
edeb21ff,11,4,7,2,2,5,7,2,4,1,3,3,14,10,0,23,CL
ee251371,7,4,4,2,1,4,11,7,3,0,3,4,11,7,0,23,CL
ee3519f5,18,11,12,5,1,10,28,18,2,1,1,12,30,21,1,23,CL
ee644761,8,4,5,3,0,4,8,4,16,11,5,8,16,15,1,23,CL
ee8508c0,0,0,0,0,0,0,0,0,0,0,0,0,0,2,0,23,CL
ee926a02,16,11,10,6,0,7,13,6,5,3,2,3,19,3,0,23,CL
ee950928,5,4,1,4,0,2,6,4,1,0,1,2,7,0,0,23,CL
eeba07f8,1,0,0,1,0,1,1,0,2,0,2,0,1,1,0,23,CL
ef491564,1,0,1,0,0,1,1,0,2,1,1,0,1,2,0,23,CL
ef88f778,1,1,0,1,0,0,3,3,4,0,4,1,2,3,0,23,CL
f0021247,12,8,2,6,4,6,17,11,7,0,7,5,17,8,0,23,CL
f0677ed7,13,9,4,7,2,5,9,4,10,4,6,5,18,9,1,23,CL
f07a0fe5,7,7,6,0,1,5,7,2,9,5,4,4,11,18,0,23,CL
f08490a6,0,0,0,0,0,0,0,0,0,0,0,0,0,0,0,23,CL
f0da930c,6,3,4,2,0,4,7,3,3,2,1,6,12,20,0,23,CL
f15b778f,4,0,2,2,0,2,6,4,7,1,6,3,7,2,0,23,CL
f179ee11,13,7,7,3,3,6,7,1,7,4,3,4,17,10,0,23,CL
f20e4cc9,11,7,6,4,1,8,18,10,13,1,12,1,12,7,0,23,CL
f315ca93,5,3,1,4,0,2,3,1,5,3,2,2,7,6,0,23,CL
f3945e07,7,4,1,4,2,2,2,0,1,0,1,0,7,0,0,23,CL
f3a97d02,0,0,0,0,0,0,0,0,0,0,0,0,0,2,0,23,CL
f417a1fa,9,6,6,1,2,3,8,5,7,2,5,3,12,0,0,23,CL
f4290206,5,2,3,1,1,3,6,3,7,4,3,6,11,18,0,23,CL
f449640d,2,2,1,1,0,1,2,1,4,2,2,5,7,1,0,23,CL
f49c4ae9,8,3,1,2,5,2,6,4,3,0,3,3,11,1,1,23,CL
f4b52308,1,0,1,0,0,1,1,0,0,0,0,0,1,0,0,23,CL
f4d8ce5a,2,2,0,1,1,1,5,4,0,0,0,0,2,0,0,23,CL
f620b04f,0,0,0,0,0,0,0,0,0,0,0,0,0,3,0,23,CL
f63cda26,11,5,0,7,4,0,5,5,5,1,4,1,12,10,0,23,CL
f6798fc3,0,0,0,0,0,0,1,1,0,0,0,0,0,3,2,23,CL
f6a90edd,19,14,7,9,3,7,15,8,10,5,5,6,25,8,0,23,CL
f6ac68c1,3,1,2,0,1,2,3,1,1,0,1,2,5,7,0,23,CL
f7036e1c,16,12,4,5,7,6,14,8,12,1,11,9,25,8,0,23,CL
f7750aa0,11,2,6,4,1,7,9,2,11,5,6,7,18,18,0,23,CL
f874dd44,4,3,1,2,1,2,3,1,3,2,1,1,5,1,0,23,CL
f9acca3a,3,1,2,1,0,1,3,2,2,0,2,1,4,3,0,23,CL
f9bd541e,2,0,2,0,0,1,3,2,2,1,1,7,9,5,0,23,CL
fa031b34,3,1,1,2,0,3,5,2,4,2,2,2,5,0,0,23,CL
fa661778,3,3,1,1,1,2,4,2,3,0,3,2,5,6,0,23,CL
fb495bb8,18,7,4,10,4,4,13,9,9,2,7,11,29,4,0,23,CL
fc4e7637,14,9,13,1,0,6,15,9,5,2,3,5,19,10,0,23,CL
fc62f087,4,2,2,2,0,1,2,1,1,1,0,1,5,4,0,23,CL
fcb27134,16,9,5,9,2,10,17,7,2,0,2,12,28,7,0,23,CL
fcb38f57,0,0,0,0,0,0,0,0,0,0,0,0,0,3,0,23,CL
fcea4f04,6,2,4,2,0,3,7,4,4,0,4,4,10,2,0,23,CL
fd4d5f81,2,0,1,0,1,1,1,0,4,0,4,0,2,1,0,23,CL
fd51b456,4,1,1,3,0,0,4,4,1,0,1,3,7,4,0,23,CL
fe641c1a,2,2,0,2,0,1,3,2,2,1,1,1,3,5,0,23,CL
feb5d972,5,3,3,1,1,2,3,1,1,0,1,1,6,0,0,23,CL
fed17f5a,4,4,2,0,2,1,2,1,1,0,1,3,7,1,0,23,CL
fed7cb61,6,3,0,3,3,1,7,6,9,1,8,1,7,4,0,23,CL
ff5ea0bf,10,4,7,3,0,5,7,2,6,5,1,10,20,12,0,23,CL
ff74841d,1,0,1,0,0,1,1,0,0,0,0,0,1,1,0,23,CL
ffbbc83b,1,1,1,0,0,1,6,5,1,0,1,0,1,0,0,23,CL
ffed43e3,1,1,0,0,1,0,0,0,0,0,0,0,1,4,0,23,CL
0000acda,29,18,11,11,7,18,28,10,13,1,12,13,42,20,0,23,ITA
00459419,9,6,2,5,2,1,6,5,11,1,10,2,11,10,0,23,ITA
00a17eba,0,0,0,0,0,0,0,0,0,0,0,0,0,2,0,23,ITA
0154d290,7,3,4,1,2,2,10,8,5,1,4,1,8,6,0,23,ITA
016ff750,10,5,6,0,4,6,14,8,16,3,13,3,13,29,0,23,ITA
01b8a2b2,1,0,1,0,0,0,1,1,0,0,0,0,1,7,0,23,ITA
01c3aff5,14,5,3,9,2,5,8,3,15,4,11,11,25,15,1,23,ITA
01efac19,21,9,5,7,9,6,16,10,16,2,14,3,24,13,0,23,ITA
023937a9,12,4,8,4,0,4,10,6,9,3,6,7,19,9,1,23,ITA
028e70b9,4,2,1,1,2,2,7,5,4,1,3,4,8,4,0,23,ITA
02caf6e0,33,21,13,14,6,21,36,15,20,6,14,18,51,36,1,23,ITA
0375723e,15,10,7,5,3,6,17,11,8,1,7,0,15,2,0,23,ITA
039a4fb6,12,7,6,3,3,6,8,2,0,0,0,0,12,2,0,23,ITA
03f946ed,7,5,2,3,2,3,6,3,16,4,12,3,10,18,0,23,ITA
04df29a5,17,9,1,9,7,6,14,8,22,0,22,2,19,7,0,23,ITA
0588a092,10,8,3,6,1,3,9,6,7,1,6,8,18,9,0,23,ITA
060606ec,4,4,3,1,0,2,5,3,2,0,2,1,5,3,0,23,ITA
0630eb63,2,1,2,0,0,0,4,4,3,0,3,2,4,4,0,23,ITA
06b08c45,31,17,20,8,3,18,34,16,15,3,12,7,38,19,0,23,ITA
0728bebe,10,8,1,7,2,2,9,7,5,1,4,8,18,5,0,23,ITA
07f8bcc8,23,18,7,8,8,9,17,8,15,2,13,3,26,24,0,23,ITA
085e71a7,1,0,1,0,0,1,5,4,0,0,0,1,2,15,3,23,ITA
08aa9cd1,10,7,0,5,5,3,7,4,19,2,17,2,12,11,0,23,ITA
08eb3b58,3,1,1,1,1,1,3,2,5,1,4,2,5,5,0,23,ITA
09538fdb,12,6,7,3,2,6,14,8,17,1,16,5,17,13,0,23,ITA
0967845b,65,35,37,21,7,30,72,42,51,16,35,41,106,91,0,23,ITA
09899de8,6,5,3,3,0,2,2,0,4,1,3,1,7,11,0,23,ITA
0a447501,11,5,3,3,5,1,7,6,9,2,7,4,15,7,0,23,ITA
0a483542,34,14,11,14,9,20,37,17,21,3,18,15,49,22,1,23,ITA
0ab1f153,50,34,34,13,3,27,65,38,15,2,13,24,74,32,0,23,ITA
0acda699,0,0,0,0,0,0,0,0,0,0,0,0,0,0,0,23,ITA
0b5a292a,34,22,17,13,4,20,41,21,17,4,13,15,49,24,1,23,ITA
0be276c6,32,23,25,6,1,16,24,8,33,22,11,35,67,92,0,23,ITA
0d077b88,41,20,13,22,6,19,41,22,39,12,27,32,73,57,0,23,ITA
0d422df7,2,1,2,0,0,2,3,1,0,0,0,1,3,15,1,23,ITA
0d82903c,35,20,16,16,3,15,22,7,27,10,17,15,50,64,1,23,ITA
0db169ae,64,41,35,24,5,27,44,17,34,9,25,25,89,26,1,23,ITA
0def2376,1,0,1,0,0,0,0,0,1,0,1,0,1,0,0,23,ITA
0e0d6c53,0,0,0,0,0,0,0,0,0,0,0,1,1,0,0,23,ITA
0fdcef0e,11,5,1,8,2,7,10,3,3,1,2,6,17,4,0,23,ITA
0fee6bda,27,16,18,8,1,10,23,13,36,23,13,31,58,120,1,23,ITA
102e2599,25,12,9,13,3,7,32,25,21,1,20,2,27,5,0,23,ITA
108fe016,9,6,4,5,0,9,20,11,7,2,5,11,20,18,0,23,ITA
10b9fa99,66,37,33,28,5,17,41,24,48,23,25,36,102,98,0,23,ITA
10dc46f0,0,0,0,0,0,0,0,0,0,0,0,0,0,1,0,23,ITA
10e7f486,37,21,22,8,7,17,35,18,32,9,23,37,74,70,0,23,ITA
12806697,73,36,54,19,0,38,61,23,40,17,23,31,104,92,1,23,ITA
1295552e,0,0,0,0,0,0,0,0,0,0,0,0,0,0,0,23,ITA
13b44b02,42,22,28,10,4,26,43,17,17,5,12,11,53,55,0,23,ITA
13ea2544,13,10,3,7,3,5,15,10,5,1,4,10,23,8,0,23,ITA
149c5f5d,21,9,16,2,3,9,16,7,11,3,8,8,29,31,1,23,ITA
14ae023f,0,0,0,0,0,0,0,0,0,0,0,0,0,1,0,23,ITA
14b8fcdf,7,0,6,1,0,4,4,0,7,5,2,7,14,32,0,23,ITA
16463a79,5,2,3,2,0,2,3,1,3,1,2,1,6,1,0,23,ITA
16657b95,113,62,55,49,9,55,90,35,39,10,29,18,131,53,0,23,ITA
16bb656a,48,31,28,17,3,22,31,9,14,9,5,23,71,71,0,23,ITA
16ceb862,8,5,2,4,2,2,10,8,11,3,8,3,11,23,0,23,ITA
17f3620a,18,11,3,9,6,5,21,16,17,4,13,2,20,39,0,23,ITA
18dd3219,15,11,9,4,2,9,15,6,20,14,6,21,36,54,2,23,ITA
19cda00b,10,5,3,5,2,3,19,16,15,0,15,7,17,0,0,23,ITA
19e4eab9,70,36,50,17,3,40,53,13,44,24,20,26,96,68,2,23,ITA
1ac232b8,47,24,23,19,5,15,33,18,20,5,15,8,55,14,0,23,ITA
1b9c7401,10,8,7,1,2,5,11,6,7,2,5,11,21,8,0,23,ITA
1bfe5ac9,13,6,7,6,0,6,18,12,16,8,8,11,24,66,0,23,ITA
1cadaf34,2,1,2,0,0,0,5,5,6,1,5,1,3,11,0,23,ITA
1d4e63b6,2,1,2,0,0,0,2,2,3,0,3,0,2,0,0,23,ITA
1e9aa637,54,29,30,18,6,29,55,26,36,13,23,56,110,57,2,23,ITA
1e9bde92,0,0,0,0,0,0,2,2,0,0,0,0,0,9,1,23,ITA
1f2d714c,2,1,1,1,0,1,2,1,2,0,2,0,2,2,1,23,ITA
1faa06d5,0,0,0,0,0,0,1,1,1,1,0,1,1,1,0,23,ITA
1fca9171,28,16,7,11,10,9,19,10,16,0,16,8,36,14,0,23,ITA
20094685,42,18,26,12,4,16,56,40,24,6,18,22,64,21,0,23,ITA
204ac005,35,19,21,10,4,18,29,11,28,8,20,16,51,30,0,23,ITA
20730eae,8,7,2,3,3,6,14,8,9,2,7,15,23,8,0,23,ITA
20b3a502,79,49,34,33,12,39,76,37,29,3,26,21,100,29,1,23,ITA
2146785a,71,44,31,32,8,38,61,23,22,7,15,25,96,34,0,23,ITA
217875a4,9,6,7,2,0,4,6,2,10,9,1,7,16,30,0,23,ITA
217c93a1,33,16,9,20,4,17,43,26,13,0,13,11,44,16,0,23,ITA
2200181e,10,4,6,4,0,7,7,0,5,4,1,5,15,26,1,23,ITA
22051fbe,4,1,1,1,2,3,6,3,3,1,2,4,8,11,0,23,ITA
226008f1,26,14,19,4,3,13,26,13,32,18,14,25,51,66,1,23,ITA
22ae86f9,25,17,15,10,0,11,24,13,20,6,14,14,39,38,0,23,ITA
22bfb57e,16,13,7,7,2,5,9,4,8,2,6,9,25,3,0,23,ITA
22cd43d2,8,3,0,7,1,1,2,1,9,1,8,9,17,6,0,23,ITA
230a2fac,60,29,33,19,8,25,49,24,30,9,21,30,90,60,0,23,ITA
230c3f3a,19,13,10,7,2,6,12,6,8,2,6,14,33,15,0,23,ITA
2374aaca,17,10,3,10,4,5,16,11,14,0,14,4,21,6,0,23,ITA
244bc2c8,12,5,3,6,3,2,7,5,10,0,10,7,19,27,1,23,ITA
246d153b,17,13,5,8,4,9,15,6,12,2,10,11,28,26,0,23,ITA
247ed022,57,34,34,20,3,28,65,37,26,2,24,26,83,33,1,23,ITA
24eb7ed6,12,5,7,4,1,6,10,4,9,3,6,8,20,16,1,23,ITA
26777636,6,3,2,4,0,2,2,0,2,0,2,1,7,1,0,23,ITA
26c54058,10,6,6,4,0,3,9,6,3,1,2,15,25,29,0,23,ITA
26db8853,82,39,42,31,9,41,90,49,47,12,35,51,133,51,1,23,ITA
277da414,1,0,1,0,0,0,0,0,0,0,0,0,1,15,1,23,ITA
28f66c2e,9,6,4,5,0,3,9,6,14,0,14,4,13,8,0,23,ITA
2990c466,0,0,0,0,0,0,0,0,0,0,0,0,0,0,0,23,ITA
2a1beb34,77,39,37,35,5,37,81,44,37,4,33,36,113,58,0,23,ITA
2a6cd437,16,14,8,7,1,5,7,2,4,3,1,16,32,31,0,23,ITA
2a7d27c1,63,36,24,29,10,25,44,19,27,6,21,16,79,42,0,23,ITA
2a82aa85,39,23,18,19,2,16,40,24,20,6,14,8,47,8,0,23,ITA
2b8360f1,7,3,2,2,3,3,11,8,7,0,7,6,13,4,0,23,ITA
2b9fdeea,2,1,0,2,0,2,13,11,5,0,5,2,4,2,0,23,ITA
2bffcbf2,1,0,0,0,1,1,3,2,1,0,1,0,1,1,0,23,ITA
2c38b327,4,3,3,1,0,3,5,2,3,0,3,3,7,3,0,23,ITA
2cb9486d,2,2,0,1,1,2,2,0,0,0,0,0,2,0,0,23,ITA
2ce215f2,0,0,0,0,0,0,0,0,0,0,0,0,0,0,0,23,ITA
2cfae697,63,38,28,33,2,27,49,22,40,17,23,40,103,43,1,23,ITA
2d22cea7,21,15,5,7,9,8,21,13,20,0,20,12,33,8,0,23,ITA
2d3d7c0d,4,3,3,0,1,3,6,3,0,0,0,3,7,5,0,23,ITA
2d970560,34,18,15,10,9,15,25,10,16,2,14,23,57,15,0,23,ITA
2df7cc43,51,34,37,14,0,20,45,25,27,11,16,25,76,66,1,23,ITA
2e7dafe5,0,0,0,0,0,0,0,0,0,0,0,0,0,0,0,23,ITA
2ef7c612,26,12,7,14,5,13,30,17,14,2,12,4,30,9,0,23,ITA
2f3452eb,39,23,24,11,4,23,41,18,31,7,24,20,59,42,0,23,ITA
2f45300d,0,0,0,0,0,0,0,0,0,0,0,0,0,1,0,23,ITA
2f69d881,19,8,6,7,6,6,16,10,25,6,19,11,30,13,1,23,ITA
2f7acede,27,12,7,18,2,14,43,29,14,8,6,24,51,24,0,23,ITA
30223b33,0,0,0,0,0,0,0,0,0,0,0,0,0,0,0,23,ITA
30f5ffa9,29,18,14,11,4,18,32,14,18,13,5,13,42,46,3,23,ITA
31a62dc7,42,21,19,21,2,24,41,17,33,6,27,14,56,36,2,23,ITA
32ebfe1e,7,2,4,3,0,5,11,6,0,0,0,8,15,1,0,23,ITA
3318286e,0,0,0,0,0,0,0,0,0,0,0,0,0,0,0,23,ITA
33b8d077,37,22,13,22,2,11,37,26,23,7,16,22,59,28,0,23,ITA
33ecf462,14,7,6,5,3,8,17,9,9,1,8,9,23,3,0,23,ITA
343c0d52,12,3,3,5,4,3,8,5,2,1,1,1,13,4,0,23,ITA
343f753a,0,0,0,0,0,0,1,1,0,0,0,0,0,0,0,23,ITA
34693494,24,11,15,6,3,12,29,17,20,1,19,4,28,11,0,23,ITA
356c9002,17,7,13,2,2,11,38,27,7,3,4,17,34,32,0,23,ITA
3626daea,15,8,7,6,2,8,23,15,13,3,10,9,24,25,0,23,ITA
366be751,29,19,12,15,2,8,27,19,16,2,14,8,37,7,1,23,ITA
384d58d9,6,3,1,4,1,2,2,0,2,0,2,2,8,1,0,23,ITA
38d9ce53,1,0,1,0,0,1,1,0,0,0,0,0,1,0,0,23,ITA
3945ac70,0,0,0,0,0,0,0,0,0,0,0,0,0,1,1,23,ITA
39583cfd,8,5,5,1,2,5,15,10,8,1,7,2,10,1,0,23,ITA
3b12b11f,23,14,14,7,2,8,17,9,19,15,4,12,35,40,0,23,ITA
3b333ac3,21,13,11,8,2,11,27,16,23,4,19,12,33,25,0,23,ITA
3b387cc7,5,3,1,3,1,0,0,0,1,0,1,1,6,0,0,23,ITA
3b61c9ec,1,0,0,1,0,1,4,3,3,0,3,7,8,4,0,23,ITA
3b9858f5,3,2,3,0,0,1,3,2,5,4,1,4,7,13,0,23,ITA
3bb7af3b,10,5,3,6,1,5,9,4,7,1,6,5,15,9,1,23,ITA
3bb7f478,3,2,0,3,0,0,4,4,15,1,14,3,6,25,0,23,ITA
3ca7254a,35,24,14,10,11,11,30,19,18,2,16,6,41,4,1,23,ITA
3cb132e6,0,0,0,0,0,0,0,0,0,0,0,0,0,0,0,23,ITA
3cd3b384,17,14,13,2,2,9,20,11,23,7,16,17,34,61,1,23,ITA
3d13d9e4,11,7,3,4,4,6,13,7,3,0,3,0,11,4,0,23,ITA
3d50bcdb,8,6,2,5,1,3,7,4,4,0,4,5,13,2,0,23,ITA
3d6cee81,2,2,0,2,0,1,5,4,1,0,1,5,7,9,0,23,ITA
3ead85f9,33,15,19,14,0,11,22,11,33,26,7,38,71,108,0,23,ITA
3ec3c1c9,80,48,44,32,4,42,61,19,41,19,22,48,128,78,1,23,ITA
3eed9821,52,34,25,25,2,18,26,8,26,14,12,26,78,79,0,23,ITA
3ef0a2d7,16,9,9,4,3,11,21,10,13,4,9,5,21,16,0,23,ITA
3f5f38fb,42,20,28,14,0,22,34,12,25,17,8,17,59,73,1,23,ITA
3f79a1c8,16,8,8,8,0,10,13,3,7,1,6,10,26,4,0,23,ITA
405f6586,2,1,1,0,1,1,3,2,7,4,3,1,3,24,0,23,ITA
407feb71,32,15,5,22,5,5,15,10,11,0,11,7,39,6,0,23,ITA
41c12f75,39,23,16,16,7,22,43,21,28,2,26,22,61,26,0,23,ITA
4295f19c,1,1,0,0,1,1,1,0,0,0,0,0,1,0,0,23,ITA
42eaa028,16,8,5,6,5,5,14,9,18,1,17,4,20,3,0,23,ITA
43a166b4,10,5,4,3,3,5,10,5,6,2,4,0,10,13,0,23,ITA
4431aed2,11,5,4,4,3,6,9,3,10,2,8,1,12,14,0,23,ITA
44ac04e9,47,27,13,23,11,23,48,25,33,10,23,16,63,39,1,23,ITA
44eb9093,25,17,17,7,1,15,27,12,12,4,8,10,35,17,0,23,ITA
45191c29,45,26,25,15,5,22,71,49,27,1,26,31,76,23,0,23,ITA
45b9b619,12,7,3,6,3,4,15,11,4,1,3,3,15,0,0,23,ITA
46fa7204,71,38,22,30,19,25,59,34,39,5,34,10,81,6,0,23,ITA
481c9ece,35,18,17,13,5,22,34,12,33,9,24,12,47,26,0,23,ITA
4830e0af,18,7,5,9,4,4,13,9,18,4,14,2,20,5,0,23,ITA
48329ff8,0,0,0,0,0,0,0,0,0,0,0,0,0,0,0,23,ITA
48d5bd33,14,8,5,6,3,6,17,11,8,1,7,5,19,2,0,23,ITA
49136c42,3,3,0,3,0,0,0,0,4,2,2,9,12,16,0,23,ITA
491a433d,4,3,0,2,2,1,6,5,9,1,8,1,5,5,0,23,ITA
4a537185,2,0,0,2,0,0,1,1,3,1,2,1,3,2,0,23,ITA
4a5a45c7,52,29,24,24,4,22,48,26,27,4,23,26,78,22,0,23,ITA
4ae67f27,38,25,22,16,0,16,31,15,38,19,19,60,98,105,2,23,ITA
4b3e1a38,33,18,20,13,0,17,26,9,36,20,16,14,47,79,1,23,ITA
4b520f96,0,0,0,0,0,0,0,0,0,0,0,0,0,0,0,23,ITA
4b7a9fcc,1,1,0,1,0,0,0,0,4,2,2,0,1,5,0,23,ITA
4bd00a50,5,4,2,2,1,3,3,0,4,1,3,2,7,3,0,23,ITA
4c62d0c8,0,0,0,0,0,0,0,0,0,0,0,0,0,0,0,23,ITA
4c8845f7,20,9,3,10,7,6,18,12,25,1,24,6,26,13,0,23,ITA
4cde5509,0,0,0,0,0,0,0,0,1,1,0,0,0,2,0,23,ITA
4d1efb48,0,0,0,0,0,0,0,0,1,1,0,3,3,2,0,23,ITA
4d8cd038,6,3,1,4,1,2,8,6,7,2,5,2,8,10,0,23,ITA
4e0c8d66,0,0,0,0,0,0,3,3,1,0,1,4,4,18,3,23,ITA
4e1d5e59,9,3,4,4,1,2,15,13,9,2,7,4,13,6,0,23,ITA
4e358a2d,15,12,8,7,0,4,11,7,9,4,5,28,43,61,0,23,ITA
4e6dbac4,58,35,22,23,13,24,67,43,50,12,38,28,86,49,0,23,ITA
50841bef,6,2,5,1,0,4,18,14,5,3,2,6,12,31,0,23,ITA
5128bde4,24,13,9,12,3,13,29,16,14,3,11,16,40,19,0,23,ITA
528492ea,18,10,0,17,1,10,21,11,9,0,9,8,26,6,0,23,ITA
5294a83f,49,29,18,20,11,23,72,49,35,6,29,9,58,4,0,23,ITA
52ec54d0,5,4,1,4,0,2,4,2,12,8,4,13,18,29,0,23,ITA
536cebe5,10,8,1,3,6,3,11,8,6,1,5,1,11,5,0,23,ITA
539230cf,3,1,1,2,0,3,4,1,5,5,0,0,3,7,0,23,ITA
53a0e358,23,14,8,10,5,9,40,31,13,0,13,19,42,18,0,23,ITA
53de807a,0,0,0,0,0,0,0,0,0,0,0,0,0,0,0,23,ITA
548bd0de,3,1,0,2,1,1,2,1,0,0,0,0,3,1,0,23,ITA
54ab971f,6,5,2,4,0,4,5,1,4,2,2,1,7,2,0,23,ITA
54e53b7e,16,6,3,11,2,8,26,18,22,1,21,8,24,3,0,23,ITA
54f6afe3,1,0,1,0,0,1,1,0,0,0,0,0,1,0,0,23,ITA
55a1cac2,27,16,8,15,4,13,20,7,12,4,8,9,36,11,0,23,ITA
563a68ad,25,15,16,7,2,9,16,7,17,10,7,28,53,34,0,23,ITA
570bb4b9,11,6,4,6,1,4,11,7,4,0,4,2,13,0,1,23,ITA
5722eced,13,10,7,5,1,5,23,18,10,0,10,5,18,4,0,23,ITA
57469b2d,6,5,4,1,1,2,13,11,6,1,5,4,10,4,0,23,ITA
58a2e9f6,1,1,0,1,0,0,0,0,0,0,0,0,1,0,0,23,ITA
58e933d2,27,18,8,10,9,7,14,7,15,3,12,12,39,8,0,23,ITA
5976f83e,12,6,3,5,4,3,4,1,1,0,1,4,16,2,0,23,ITA
599d91d0,7,2,4,2,1,1,3,2,2,2,0,1,8,4,0,23,ITA
59bf127b,5,5,4,1,0,3,3,0,0,0,0,0,5,0,1,23,ITA
5a08ee41,40,30,35,5,0,22,36,14,45,29,16,36,76,192,0,23,ITA
5a2cb25d,39,24,15,17,7,16,29,13,23,5,18,21,60,18,2,23,ITA
5aa53281,37,19,27,9,1,18,34,16,38,17,21,46,83,67,0,23,ITA
5bd72174,5,3,0,1,4,0,4,4,7,2,5,3,8,11,0,23,ITA
5cbb5ad6,20,13,11,7,2,15,20,5,7,4,3,10,30,14,0,23,ITA
5cdddffa,14,8,4,8,2,4,7,3,10,1,9,7,21,7,1,23,ITA
5cec2c74,47,31,25,15,7,22,46,24,27,6,21,27,74,36,0,23,ITA
5cf5c9ad,15,12,8,5,2,5,21,16,9,1,8,11,26,18,0,23,ITA
5de3866c,31,18,20,10,1,17,33,16,24,2,22,7,38,32,0,23,ITA
5e834dce,21,13,11,6,4,8,21,13,9,0,9,9,30,5,0,23,ITA
5e861944,18,9,9,5,4,11,25,14,6,0,6,7,25,7,0,23,ITA
5eae500a,3,1,1,0,2,2,5,3,3,1,2,0,3,16,0,23,ITA
5eaed77a,41,26,34,7,0,18,39,21,27,20,7,45,86,93,1,23,ITA
5efc5389,16,8,5,6,5,5,13,8,9,4,5,15,31,30,0,23,ITA
5fa57166,17,14,14,3,0,10,25,15,8,5,3,13,30,33,2,23,ITA
5fd5ed86,29,20,23,5,1,19,26,7,44,22,22,42,71,120,2,23,ITA
60e3603d,0,0,0,0,0,0,0,0,0,0,0,0,0,0,0,23,ITA
61b3978f,31,20,16,12,3,19,28,9,22,4,18,24,55,28,0,23,ITA
6213fd82,44,28,22,12,10,19,32,13,21,5,16,24,68,54,0,23,ITA
62437b4f,6,3,2,3,1,3,4,1,4,0,4,0,6,3,0,23,ITA
6499048c,14,9,6,5,3,8,12,4,14,2,12,3,17,6,0,23,ITA
649b01d8,0,0,0,0,0,0,2,2,0,0,0,0,0,7,1,23,ITA
65fd099c,17,6,6,7,4,2,7,5,6,1,5,2,19,10,0,23,ITA
67f649be,0,0,0,0,0,0,0,0,0,0,0,0,0,1,3,23,ITA
6928979a,49,25,17,26,6,28,53,25,29,5,24,12,61,12,0,23,ITA
6af30900,22,14,11,7,4,9,13,4,23,12,11,12,34,79,1,23,ITA
6b635f5c,40,32,25,15,0,18,24,6,47,31,16,27,67,120,0,23,ITA
6bb2c084,53,32,16,29,8,16,64,48,50,4,46,49,102,25,0,23,ITA
6c4307ee,1,1,0,1,0,0,0,0,1,1,0,0,1,0,0,23,ITA
6caffe81,8,3,3,4,1,3,5,2,3,0,3,2,10,3,0,23,ITA
6cc97b6a,26,21,13,13,0,15,24,9,23,12,11,27,53,45,0,23,ITA
6e058f06,10,8,0,6,4,4,10,6,9,0,9,4,14,4,0,23,ITA
6eee05f1,34,19,21,13,0,17,25,8,17,7,10,36,70,74,1,23,ITA
6f1d7aa8,3,3,3,0,0,3,8,5,3,0,3,0,3,2,0,23,ITA
6fdac234,39,23,32,7,0,16,27,11,41,25,16,29,68,165,0,23,ITA
707b98f1,1,1,0,1,0,1,3,2,1,0,1,0,1,0,0,23,ITA
71005acd,8,5,4,2,2,2,9,7,10,1,9,1,9,2,0,23,ITA
71c620d7,0,0,0,0,0,0,0,0,0,0,0,0,0,0,0,23,ITA
71dc23da,16,11,10,3,3,10,23,13,9,4,5,4,20,12,0,23,ITA
72f87f25,3,2,1,1,1,0,2,2,2,0,2,2,5,0,0,23,ITA
74419746,0,0,0,0,0,0,0,0,0,0,0,0,0,5,0,23,ITA
75b86fb3,41,20,20,14,7,11,27,16,27,13,14,24,65,45,0,23,ITA
75e60d75,19,10,4,13,2,11,14,3,15,5,10,13,32,12,2,23,ITA
75f2c59f,36,20,21,12,3,16,44,28,20,5,15,16,52,28,0,23,ITA
76b2817e,47,31,28,13,6,29,45,16,21,3,18,10,57,42,1,23,ITA
76ff8d0d,16,7,4,9,3,6,17,11,19,5,14,14,30,13,0,23,ITA
771a2cfe,1,0,1,0,0,0,2,2,0,0,0,0,1,0,0,23,ITA
77d6fd4d,1,1,1,0,0,1,2,1,0,0,0,0,1,15,2,23,ITA
780e3631,57,36,28,21,8,26,62,36,50,15,35,37,94,33,1,23,ITA
78e6bf2c,3,0,3,0,0,1,1,0,1,1,0,1,4,2,0,23,ITA
78f13530,2,2,1,1,0,2,7,5,2,0,2,2,4,8,0,23,ITA
79083382,16,11,9,6,1,9,12,3,18,11,7,10,26,29,0,23,ITA
79370f8c,3,1,3,0,0,0,5,5,3,0,3,0,3,4,0,23,ITA
79443529,11,6,0,7,4,4,10,6,10,3,7,3,14,8,1,23,ITA
79b0d6a0,1,1,1,0,0,1,1,0,0,0,0,2,3,6,3,23,ITA
79ca3e23,22,14,7,12,3,9,16,7,11,0,11,13,35,8,0,23,ITA
7ae36711,12,6,7,4,1,8,10,2,6,3,3,3,15,6,0,23,ITA
7afb1573,28,19,10,11,7,9,27,18,14,3,11,13,41,17,0,23,ITA
7b075c75,25,17,11,12,2,5,7,2,18,13,5,15,40,75,1,23,ITA
7b5f516f,0,0,0,0,0,0,0,0,0,0,0,0,0,0,0,23,ITA
7c104bb7,13,5,2,6,5,3,15,12,18,0,18,4,17,1,0,23,ITA
7cd520e8,71,45,42,24,5,34,59,25,34,6,28,36,107,25,0,23,ITA
7d3cbc67,63,46,30,24,9,23,55,32,38,6,32,27,90,34,0,23,ITA
7eb97a8e,12,4,6,4,2,5,10,5,0,0,0,0,12,4,0,23,ITA
7ed4921e,11,3,7,4,0,6,7,1,7,4,3,6,17,10,0,23,ITA
7edfbb8a,70,34,44,25,1,22,34,12,46,25,21,29,99,88,1,23,ITA
7ef972c3,57,29,37,17,3,26,47,21,30,13,17,29,86,76,0,23,ITA
7f609bfc,81,43,41,29,11,44,75,31,44,15,29,35,116,69,0,23,ITA
7f78ad23,54,33,30,17,7,28,42,14,30,15,15,38,92,61,0,23,ITA
7f9d956a,1,0,0,1,0,0,0,0,0,0,0,0,1,0,0,23,ITA
7fac99d4,44,22,22,21,1,19,40,21,29,11,18,14,58,33,0,23,ITA
7fe90ccd,34,18,17,12,5,15,22,7,23,2,21,9,43,16,0,23,ITA
801831fe,12,5,3,4,5,4,11,7,9,0,9,1,13,8,0,23,ITA
80490d7f,53,37,39,13,1,24,43,19,43,26,17,35,88,100,1,23,ITA
80556f08,6,4,4,1,1,3,8,5,9,0,9,7,13,8,0,23,ITA
817c6964,40,28,18,18,4,16,50,34,31,11,20,16,56,21,0,23,ITA
822ed0ec,88,57,54,25,9,40,71,31,45,4,41,37,125,89,0,23,ITA
82598b71,25,13,15,9,1,12,18,6,14,4,10,4,29,25,0,23,ITA
82efe6fa,67,33,38,26,3,32,48,16,30,11,19,66,133,95,2,23,ITA
84594618,0,0,0,0,0,0,0,0,1,1,0,0,0,2,0,23,ITA
854ee61a,9,7,5,2,2,4,13,9,11,0,11,2,11,5,0,23,ITA
85613cf0,12,8,2,8,2,2,8,6,10,1,9,1,13,14,0,23,ITA
85a44ecc,84,50,42,35,7,30,73,43,35,7,28,25,109,33,2,23,ITA
85f7d1be,57,39,33,21,3,28,42,14,41,17,24,41,98,56,1,23,ITA
86383d0e,13,8,5,6,2,6,14,8,5,0,5,3,16,22,0,23,ITA
8650af85,23,16,11,10,2,10,17,7,29,20,9,23,46,81,4,23,ITA
867239d3,0,0,0,0,0,0,1,1,0,0,0,0,0,2,0,23,ITA
875d65d1,0,0,0,0,0,0,1,1,2,0,2,0,0,0,0,23,ITA
8794e251,65,35,31,23,11,30,57,27,37,7,30,26,91,44,1,23,ITA
88f53b75,1,0,0,1,0,0,1,1,1,1,0,1,2,4,0,23,ITA
89976232,73,50,44,27,2,29,45,16,29,17,12,50,123,87,1,23,ITA
8a6de8c7,30,20,13,14,3,15,41,26,24,2,22,8,38,5,0,23,ITA
8abd0c03,8,4,6,2,0,3,4,1,2,0,2,3,11,5,0,23,ITA
8b609c34,27,17,14,10,3,12,19,7,15,2,13,12,39,33,1,23,ITA
8b66d9cc,5,2,3,2,0,1,5,4,5,0,5,0,5,2,1,23,ITA
8b8a56ce,15,8,9,6,0,7,11,4,14,11,3,9,24,35,1,23,ITA
8b95acda,17,10,10,7,0,9,12,3,9,5,4,22,39,69,1,23,ITA
8bbe2df5,26,19,14,8,4,7,16,9,20,5,15,21,47,44,0,23,ITA
8c63fae5,9,4,6,3,0,6,9,3,5,3,2,11,20,15,1,23,ITA
8c65eb5f,0,0,0,0,0,0,1,1,0,0,0,0,0,2,0,23,ITA
8c90fd7a,10,6,1,2,7,0,7,7,6,1,5,6,16,29,0,23,ITA
8cabdc1e,1,0,1,0,0,0,1,1,0,0,0,0,1,13,3,23,ITA
8cc29864,0,0,0,0,0,0,1,1,0,0,0,0,0,0,0,23,ITA
8d3cd59d,73,38,42,23,8,33,54,21,24,6,18,24,97,85,1,23,ITA
8da74c05,51,30,21,26,4,28,63,35,51,14,37,37,88,55,2,23,ITA
8daee720,8,5,1,5,2,2,4,2,0,0,0,1,9,0,0,23,ITA
8dfed6e9,5,3,0,3,2,1,6,5,7,2,5,3,8,7,1,23,ITA
8ec109e6,21,17,14,6,1,10,25,15,10,5,5,30,51,44,3,23,ITA
8ec56e62,1,1,1,0,0,1,2,1,0,0,0,0,1,11,2,23,ITA
8f5cdf66,10,6,6,3,1,7,16,9,7,1,6,5,15,17,0,23,ITA
8f68aa41,6,5,3,3,0,1,5,4,5,4,1,4,10,14,1,23,ITA
8f866fe8,23,15,8,9,6,9,23,14,16,2,14,6,29,25,0,23,ITA
8fef5412,0,0,0,0,0,0,0,0,0,0,0,0,0,0,0,23,ITA
9142b22f,0,0,0,0,0,0,0,0,0,0,0,0,0,0,0,23,ITA
91d0fabf,2,2,1,1,0,2,4,2,2,0,2,2,4,8,0,23,ITA
91ff775f,30,22,11,12,7,8,27,19,19,1,18,9,39,8,0,23,ITA
921f6058,23,14,16,7,0,11,19,8,11,4,7,28,51,20,0,23,ITA
9250bcff,6,2,1,4,1,2,5,3,6,1,5,0,6,2,0,23,ITA
93088fbb,0,0,0,0,0,0,0,0,0,0,0,0,0,0,0,23,ITA
933d3b51,50,25,32,17,1,18,32,14,29,14,15,34,84,72,0,23,ITA
9413b19f,0,0,0,0,0,0,0,0,0,0,0,0,0,6,1,23,ITA
94816803,4,3,2,0,2,2,5,3,2,0,2,0,4,0,0,23,ITA
94b2001f,92,62,61,23,8,52,73,21,39,20,19,47,139,114,1,23,ITA
957e4c87,20,8,11,6,3,10,21,11,19,4,15,8,28,10,0,23,ITA
963a328b,29,18,13,15,1,14,39,25,19,0,19,12,41,9,1,23,ITA
96640846,0,0,0,0,0,0,0,0,0,0,0,0,0,0,0,23,ITA
966eea58,40,18,16,16,8,25,43,18,25,2,23,26,66,21,0,23,ITA
96e0490d,56,30,29,15,12,31,47,16,33,5,28,21,77,36,0,23,ITA
970b8574,31,25,6,18,7,9,19,10,15,4,11,18,49,20,0,23,ITA
9823be92,32,21,17,10,5,18,23,5,20,5,15,17,49,29,1,23,ITA
983ff2c7,18,7,6,11,1,11,18,7,7,2,5,5,23,17,2,23,ITA
98a84572,5,2,5,0,0,3,5,2,3,1,2,1,6,0,0,23,ITA
9907b1c8,7,5,2,4,1,2,7,5,11,0,11,2,9,0,0,23,ITA
997fff07,33,18,24,8,1,9,20,11,54,42,12,43,76,163,1,23,ITA
9ba7b4fa,15,9,11,4,0,9,13,4,27,6,21,11,26,29,0,23,ITA
9c435456,3,1,3,0,0,0,1,1,0,0,0,3,6,3,0,23,ITA
9d4c45d6,31,16,9,16,6,13,25,12,23,2,21,6,37,14,0,23,ITA
9d60028d,9,5,1,6,2,5,8,3,11,2,9,4,13,7,0,23,ITA
9e1577aa,65,38,29,29,7,32,65,33,32,7,25,14,79,42,1,23,ITA
9ef42479,5,3,1,1,3,1,5,4,6,2,4,0,5,14,0,23,ITA
9f1893b9,80,50,31,41,8,31,88,57,58,6,52,31,111,27,0,23,ITA
9f5a610b,2,0,2,0,0,2,2,0,0,0,0,2,4,21,3,23,ITA
9f84febe,21,13,11,7,3,13,22,9,0,0,0,7,28,15,1,23,ITA
9fa26bc2,2,1,2,0,0,2,2,0,0,0,0,1,3,19,1,23,ITA
a0aee24e,7,1,5,1,1,3,4,1,1,1,0,0,7,0,0,23,ITA
a111cf41,1,1,1,0,0,1,1,0,0,0,0,0,1,11,1,23,ITA
a14d0ab0,0,0,0,0,0,0,0,0,1,0,1,0,0,0,0,23,ITA
a2565f79,0,0,0,0,0,0,0,0,0,0,0,0,0,0,0,23,ITA
a26fb8aa,46,26,15,24,7,28,55,27,41,5,36,19,65,36,2,23,ITA
a2d9f138,26,12,9,11,6,12,24,12,15,4,11,12,38,10,0,23,ITA
a3695ac2,0,0,0,0,0,0,0,0,0,0,0,3,3,2,0,23,ITA
a378a02a,38,26,25,12,1,19,29,10,29,17,12,24,62,80,3,23,ITA
a40819d9,4,4,2,2,0,2,3,1,2,1,1,4,8,6,0,23,ITA
a44d3a3c,6,2,1,3,2,2,3,1,5,1,4,0,6,4,0,23,ITA
a47c6309,7,4,2,3,2,3,4,1,8,2,6,2,9,5,0,23,ITA
a4948e67,12,5,0,6,6,3,9,6,20,6,14,7,19,21,0,23,ITA
a4e85758,43,29,21,18,4,20,27,7,33,14,19,25,68,56,2,23,ITA
a5296e55,17,10,1,11,5,12,25,13,16,5,11,14,31,7,0,23,ITA
a69cc629,7,3,2,3,2,4,10,6,15,4,11,11,18,6,0,23,ITA
a69e4806,24,13,10,6,8,9,21,12,31,0,31,15,39,6,0,23,ITA
a820e429,9,2,1,4,4,4,8,4,10,1,9,1,10,12,0,23,ITA
a8a874f1,59,33,26,23,10,30,53,23,50,22,28,27,86,59,0,23,ITA
a9202def,67,34,18,42,7,29,66,37,56,7,49,36,103,31,0,23,ITA
a96e5dc0,36,23,17,14,5,22,33,11,31,14,17,18,54,60,1,23,ITA
a9aa0d1d,11,5,3,4,4,3,11,8,11,0,11,2,13,5,0,23,ITA
aa54ec6f,37,19,29,7,1,17,26,9,22,14,8,31,68,111,3,23,ITA
aa8e289e,32,21,9,16,7,15,34,19,25,2,23,10,42,14,0,23,ITA
aae9d04a,34,24,19,13,2,16,41,25,30,11,19,15,49,37,0,23,ITA
ab1ca213,33,10,20,12,1,16,26,10,26,6,20,6,39,14,0,23,ITA
ab4449d6,2,1,2,0,0,1,2,1,0,0,0,0,2,19,2,23,ITA
ab472696,6,3,0,5,1,1,4,3,5,1,4,3,9,3,0,23,ITA
ac4003af,1,0,1,0,0,1,3,2,0,0,0,0,1,2,0,23,ITA
ac4a4508,50,24,18,20,12,27,53,26,36,3,33,16,66,15,0,23,ITA
ac7e640b,23,14,10,11,2,9,20,11,23,16,7,17,40,88,2,23,ITA
acf7e795,9,5,5,4,0,3,4,1,7,2,5,9,18,11,2,23,ITA
ad92526f,46,21,20,24,2,18,54,36,14,4,10,15,61,22,0,23,ITA
ae4e2852,14,7,8,3,3,9,14,5,9,3,6,4,18,20,0,23,ITA
ae94a6c5,35,18,12,15,8,16,39,23,15,1,14,10,45,11,0,23,ITA
ae9898c5,17,12,5,9,3,8,16,8,14,3,11,12,29,16,0,23,ITA
b033f803,1,1,1,0,0,0,2,2,3,0,3,1,2,0,0,23,ITA
b056e3da,0,0,0,0,0,0,0,0,0,0,0,1,1,2,0,23,ITA
b09a3ecc,6,3,1,2,3,4,7,3,7,1,6,2,8,10,0,23,ITA
b0f7e36c,22,11,6,6,10,5,14,9,13,1,12,0,22,1,0,23,ITA
b1236c63,7,3,2,1,4,5,11,6,6,1,5,2,9,10,0,23,ITA
b136c945,15,6,5,8,2,9,15,6,9,0,9,7,22,7,1,23,ITA
b1cd37e6,41,26,17,20,4,21,47,26,30,4,26,16,57,32,0,23,ITA
b233e8e4,22,11,16,6,0,17,26,9,22,14,8,8,30,39,0,23,ITA
b2561711,0,0,0,0,0,0,0,0,1,1,0,0,0,0,0,23,ITA
b35a7399,4,1,3,1,0,1,1,0,3,3,0,6,10,18,1,23,ITA
b3a20f18,32,19,21,9,2,20,32,12,31,17,14,20,52,111,0,23,ITA
b3ef6517,1,1,0,0,1,0,1,1,1,0,1,0,1,0,0,23,ITA
b4101c2e,1,1,0,0,1,0,1,1,0,0,0,0,1,0,0,23,ITA
b5f7d10b,40,22,20,14,6,22,46,24,26,2,24,25,65,37,0,23,ITA
b6964eb6,26,15,16,10,0,13,21,8,51,36,15,43,69,123,0,23,ITA
b6a1cdf9,10,4,5,3,2,5,9,4,4,0,4,1,11,2,0,23,ITA
b6baba31,0,0,0,0,0,0,0,0,1,0,1,0,0,1,0,23,ITA
b70bde8f,41,26,25,13,3,18,48,30,13,3,10,20,61,4,0,23,ITA
b804c280,0,0,0,0,0,0,0,0,1,0,1,0,0,0,0,23,ITA
b85bf253,8,5,4,4,0,5,5,0,7,1,6,6,14,9,0,23,ITA
b959a0d1,0,0,0,0,0,0,0,0,0,0,0,0,0,2,0,23,ITA
b96b595c,33,19,22,7,4,20,27,7,25,18,7,41,74,85,2,23,ITA
b9e11c1d,0,0,0,0,0,0,0,0,0,0,0,0,0,0,0,23,ITA
ba1e04b3,26,17,12,12,2,10,18,8,12,2,10,8,34,15,0,23,ITA
ba3d3bea,25,16,7,15,3,14,40,26,23,9,14,24,49,33,0,23,ITA
ba492306,7,2,3,1,3,4,9,5,5,1,4,2,9,6,0,23,ITA
bb376bed,34,17,15,18,1,16,31,15,22,4,18,13,47,24,0,23,ITA
bba30585,10,5,6,4,0,5,12,7,4,2,2,11,21,20,0,23,ITA
bcc81786,54,32,33,12,9,24,31,7,34,12,22,22,76,87,1,23,ITA
bcf5058a,0,0,0,0,0,0,0,0,0,0,0,0,0,1,0,23,ITA
bdc74a8f,13,7,4,8,1,7,15,8,11,3,8,4,17,9,1,23,ITA
be2706c0,22,12,15,6,1,12,24,12,14,2,12,10,32,31,1,23,ITA
bee704fc,40,25,20,17,3,18,27,9,27,14,13,22,62,72,0,23,ITA
bf57eaab,5,3,0,3,2,0,9,9,9,1,8,3,8,0,0,23,ITA
bfc359ed,1,0,1,0,0,0,0,0,1,0,1,0,1,0,0,23,ITA
c13ddd3e,7,4,3,2,2,5,7,2,7,1,6,3,10,3,0,23,ITA
c1d95617,1,0,1,0,0,0,3,3,1,0,1,0,1,26,3,23,ITA
c20892ee,0,0,0,0,0,0,0,0,0,0,0,0,0,0,0,23,ITA
c2357b65,26,15,13,8,5,16,31,15,21,6,15,9,35,41,0,23,ITA
c235e803,17,10,12,5,0,6,8,2,8,3,5,5,22,29,0,23,ITA
c283ddef,32,15,7,16,9,13,26,13,14,4,10,9,41,19,0,23,ITA
c316607a,35,20,27,7,1,16,24,8,36,23,13,22,57,44,0,23,ITA
c39babc1,0,0,0,0,0,0,0,0,0,0,0,0,0,0,0,23,ITA
c414df9d,17,10,7,9,1,5,16,11,13,3,10,3,20,6,0,23,ITA
c459a650,32,18,12,7,13,22,39,17,29,6,23,24,56,26,0,23,ITA
c55967eb,4,2,1,3,0,0,3,3,2,1,1,2,6,0,0,23,ITA
c56dc39e,69,44,37,32,0,35,64,29,42,18,24,57,126,88,1,23,ITA
c609e90e,5,3,2,3,0,0,0,0,1,0,1,2,7,1,0,23,ITA
c69ef855,69,39,27,33,9,38,73,35,55,15,40,34,103,74,0,23,ITA
c6e8cf1f,21,14,10,10,1,9,15,6,17,7,10,13,34,10,0,23,ITA
c7069d87,44,22,16,23,5,20,50,30,17,7,10,18,62,21,0,23,ITA
c7259b83,42,24,12,22,8,23,52,29,25,3,22,16,58,21,0,23,ITA
c730da00,1,0,1,0,0,0,0,0,0,0,0,1,2,1,0,23,ITA
c74d63ac,56,36,35,12,9,38,57,19,37,6,31,13,69,71,0,23,ITA
c83c203f,25,13,15,8,2,12,23,11,25,7,18,17,42,21,0,23,ITA
c84dcc88,0,0,0,0,0,0,0,0,0,0,0,0,0,0,0,23,ITA
c8ad0857,45,19,30,11,4,22,31,9,31,10,21,22,67,89,0,23,ITA
ca6edaa0,0,0,0,0,0,0,3,3,4,0,4,3,3,1,0,23,ITA
ca73910d,1,0,0,0,1,0,1,1,2,1,1,0,1,1,0,23,ITA
caec77da,33,29,18,14,1,19,27,8,50,35,15,30,63,85,1,23,ITA
cc1a0c57,1,1,1,0,0,1,1,0,0,0,0,0,1,1,0,23,ITA
cce9f582,33,22,20,11,2,19,25,6,20,15,5,21,54,76,0,23,ITA
cd0fa27b,48,27,17,26,5,16,43,27,30,5,25,25,73,13,1,23,ITA
cdf65d12,35,21,20,14,1,15,29,14,13,4,9,18,53,50,0,23,ITA
ce1a6c7e,0,0,0,0,0,0,0,0,0,0,0,0,0,1,0,23,ITA
ce30bfc8,16,6,9,6,1,10,21,11,14,5,9,4,20,15,0,23,ITA
cf007308,24,13,8,12,4,11,23,12,18,2,16,11,35,5,0,23,ITA
cf961d8d,45,32,31,10,4,25,37,12,41,26,15,27,72,82,0,23,ITA
d023d70f,32,17,7,22,3,13,25,12,28,8,20,19,51,25,0,23,ITA
d0d8dd44,28,18,19,9,0,8,14,6,18,10,8,40,68,80,0,23,ITA
d0dbca9f,49,28,39,9,1,32,50,18,40,14,26,44,93,70,1,23,ITA
d125f22f,12,8,4,5,3,3,16,13,23,3,20,10,22,12,0,23,ITA
d183e9d6,24,14,15,8,1,7,13,6,17,7,10,10,34,21,0,23,ITA
d19ef4ef,10,5,4,5,1,4,8,4,2,0,2,2,12,2,0,23,ITA
d3298c99,4,4,3,0,1,3,7,4,6,0,6,8,12,4,0,23,ITA
d3aaad90,21,9,8,10,3,6,22,16,11,1,10,15,36,11,0,23,ITA
d3de9af0,8,4,1,3,4,3,5,2,6,2,4,4,12,17,1,23,ITA
d44360be,55,34,19,26,10,17,45,28,20,7,13,18,73,40,0,23,ITA
d4456fb3,90,52,49,40,1,37,67,30,43,11,32,72,162,54,0,23,ITA
d4535821,41,30,23,14,4,25,39,14,20,6,14,38,79,63,1,23,ITA
d4a2533d,2,1,0,1,1,1,4,3,1,0,1,1,3,1,0,23,ITA
d4c9725f,43,24,27,15,1,22,38,16,34,7,27,21,64,35,1,23,ITA
d65cf468,5,2,2,3,0,2,3,1,1,0,1,0,5,0,0,23,ITA
d705ba44,12,5,3,5,4,5,11,6,11,1,10,3,15,5,0,23,ITA
d7918b13,13,10,6,5,2,4,21,17,10,2,8,10,23,10,0,23,ITA
d7a35008,0,0,0,0,0,0,1,1,0,0,0,0,0,7,0,23,ITA
d7d32194,1,1,0,1,0,0,0,0,2,0,2,1,2,5,0,23,ITA
d810c13b,55,34,36,17,2,33,47,14,28,16,12,25,80,52,3,23,ITA
d85c238b,42,28,16,18,8,14,38,24,37,3,34,21,63,10,1,23,ITA
d8800a46,6,4,2,4,0,5,8,3,4,2,2,4,10,12,0,23,ITA
d9624b51,25,19,15,9,1,13,23,10,17,10,7,19,44,55,0,23,ITA
d97f2e8d,53,31,27,19,7,28,48,20,33,6,27,19,72,37,3,23,ITA
d995ed27,35,23,14,15,6,24,37,13,14,0,14,16,51,5,1,23,ITA
d9ebed1c,11,6,5,4,2,4,12,8,5,1,4,4,15,7,0,23,ITA
da5a981b,1,0,1,0,0,0,2,2,2,0,2,1,2,2,0,23,ITA
daa4c94c,0,0,0,0,0,0,1,1,0,0,0,0,0,0,0,23,ITA
db092d3b,59,33,26,31,2,30,51,21,25,7,18,26,85,16,1,23,ITA
dbfa4f16,15,10,8,7,0,4,10,6,5,0,5,2,17,5,0,23,ITA
dc3e663e,22,17,15,7,0,6,24,18,26,18,8,24,46,71,1,23,ITA
dc3fa3b5,1,0,1,0,0,0,4,4,2,0,2,0,1,1,0,23,ITA
dc765618,2,2,1,0,1,2,3,1,3,1,2,3,5,3,0,23,ITA
dcb38abe,11,4,4,4,3,2,6,4,14,2,12,3,14,5,0,23,ITA
dd0daf32,41,26,13,22,6,14,41,27,27,4,23,21,62,18,0,23,ITA
dd403465,14,10,8,3,3,5,33,28,13,2,11,10,24,13,0,23,ITA
dd7febd8,45,33,25,13,7,29,43,14,23,6,17,38,83,55,0,23,ITA
dd86e8e4,25,10,12,8,5,9,15,6,15,7,8,4,29,16,0,23,ITA
de0f152c,10,7,7,3,0,6,15,9,11,4,7,10,20,28,1,23,ITA
dea88efd,43,23,12,8,23,17,43,26,20,0,20,5,48,6,1,23,ITA
dee3d535,1,1,0,1,0,0,0,0,0,0,0,0,1,0,0,23,ITA
dfd24c07,4,2,3,0,1,3,6,3,0,0,0,0,4,2,1,23,ITA
dff153a4,19,13,7,11,1,10,22,12,8,0,8,17,36,22,0,23,ITA
e04dca4a,2,1,2,0,0,1,2,1,1,0,1,2,4,3,0,23,ITA
e0921a4f,14,4,1,8,5,8,26,18,12,1,11,8,22,4,0,23,ITA
e0f8151c,55,30,32,22,1,25,29,4,36,26,10,41,96,123,1,23,ITA
e14ec482,30,19,15,10,5,17,41,24,29,3,26,8,38,18,0,23,ITA
e1b0a70d,2,1,2,0,0,2,3,1,0,0,0,1,3,14,0,23,ITA
e1cbb531,83,44,35,35,13,43,73,30,29,7,22,23,106,16,0,23,ITA
e26fcca3,29,14,17,10,2,14,35,21,14,2,12,13,42,11,0,23,ITA
e288d4b3,6,4,3,2,1,4,7,3,1,0,1,4,10,2,0,23,ITA
e33f36d5,61,42,36,25,0,27,42,15,42,27,15,28,89,106,0,23,ITA
e3756e72,14,6,11,2,1,9,14,5,6,1,5,4,18,14,0,23,ITA
e3cceee6,41,29,30,11,0,26,36,10,24,7,17,24,65,57,1,23,ITA
e58cbfd5,46,30,22,22,2,14,37,23,20,1,19,40,86,17,0,23,ITA
e599253a,22,10,6,14,2,6,23,17,22,4,18,21,43,13,0,23,ITA
e5bf73f3,21,4,10,6,5,8,14,6,25,1,24,1,22,7,0,23,ITA
e613313c,51,25,29,17,5,14,26,12,28,16,12,28,79,102,0,23,ITA
e66ebabb,0,0,0,0,0,0,0,0,0,0,0,0,0,0,0,23,ITA
e74f0e59,3,2,2,0,1,3,7,4,6,5,1,3,6,20,0,23,ITA
e892c325,2,1,1,1,0,0,0,0,0,0,0,0,2,0,0,23,ITA
e9c0c1b2,0,0,0,0,0,0,1,1,0,0,0,0,0,5,0,23,ITA
ea02beaf,25,13,9,12,4,10,23,13,16,2,14,29,54,23,0,23,ITA
ea468ea8,0,0,0,0,0,0,2,2,2,2,0,0,0,4,1,23,ITA
eb0ec070,32,18,21,5,6,17,37,20,10,2,8,10,42,37,2,23,ITA
eb2fe5b6,9,6,2,3,4,5,16,11,9,0,9,2,11,2,0,23,ITA
eb3022c3,8,5,5,2,1,4,12,8,9,4,5,3,11,3,0,23,ITA
eb58eef0,4,3,1,3,0,0,2,2,7,1,6,2,6,3,0,23,ITA
eb76987d,4,2,2,2,0,1,3,2,3,1,2,1,5,4,0,23,ITA
eb7822d7,47,27,24,19,4,19,33,14,27,7,20,25,72,21,1,23,ITA
ec52b661,54,27,29,21,4,29,69,40,17,3,14,22,76,44,1,23,ITA
ec5dae45,6,4,4,2,0,2,4,2,2,0,2,3,9,1,0,23,ITA
eccbe56a,43,22,18,20,5,14,32,18,19,6,13,7,50,8,0,23,ITA
ed5c0319,16,9,0,9,7,4,17,13,18,3,15,6,22,30,0,23,ITA
ed90babd,0,0,0,0,0,0,0,0,0,0,0,1,1,0,0,23,ITA
edd81e2a,34,18,17,16,1,20,30,10,32,20,12,20,54,58,1,23,ITA
ee251371,31,20,12,16,3,19,41,22,13,1,12,19,50,11,0,23,ITA
ee4f2f3b,2,1,1,1,0,1,7,6,5,1,4,0,2,9,0,23,ITA
ee64a822,44,25,16,20,8,20,40,20,22,7,15,19,63,25,0,23,ITA
ee9040b4,5,3,2,3,0,1,3,2,3,0,3,4,9,3,0,23,ITA
ef6eef89,10,6,7,3,0,7,12,5,8,5,3,13,23,12,0,23,ITA
ef94dc2f,0,0,0,0,0,0,0,0,0,0,0,0,0,0,0,23,ITA
efc9e31f,8,7,1,3,4,2,10,8,5,1,4,6,14,25,0,23,ITA
efdeaff3,0,0,0,0,0,0,0,0,0,0,0,1,1,2,0,23,ITA
f025eade,48,28,20,18,10,17,51,34,37,8,29,16,64,28,0,23,ITA
f052fb01,0,0,0,0,0,0,0,0,0,0,0,1,1,0,0,23,ITA
f058ed1f,0,0,0,0,0,0,1,1,0,0,0,0,0,1,0,23,ITA
f0f7f62f,1,0,1,0,0,1,1,0,0,0,0,0,1,3,0,23,ITA
f1cfc209,56,27,22,26,8,29,61,32,37,7,30,30,86,18,0,23,ITA
f1f1f238,20,14,7,12,1,10,16,6,34,20,14,41,61,92,0,23,ITA
f3a9fa26,25,16,8,11,6,12,26,14,11,0,11,14,39,7,0,23,ITA
f42d6c13,20,11,9,5,6,9,17,8,14,1,13,14,34,10,0,23,ITA
f449640d,14,9,7,6,1,7,10,3,11,3,8,2,16,3,0,23,ITA
f4797849,14,9,11,3,0,5,13,8,14,12,2,6,20,65,0,23,ITA
f49c4ae9,24,18,9,9,6,5,19,14,20,4,16,7,31,28,0,23,ITA
f503ea63,37,20,14,20,3,19,45,26,24,2,22,26,63,36,0,23,ITA
f554e29b,0,0,0,0,0,0,1,1,0,0,0,0,0,0,0,23,ITA
f573a8bf,8,4,2,5,1,3,8,5,13,2,11,4,12,18,0,23,ITA
f586779e,17,10,4,8,5,3,16,13,10,4,6,3,20,14,0,23,ITA
f61c7c4e,0,0,0,0,0,0,0,0,1,0,1,0,0,0,0,23,ITA
f7036e1c,25,14,3,15,7,7,23,16,31,1,30,13,38,16,1,23,ITA
f71ad8cb,55,23,25,26,4,32,57,25,37,5,32,24,79,36,1,23,ITA
f7223718,17,11,12,3,2,11,16,5,17,12,5,11,28,53,1,23,ITA
f778fe3f,4,0,2,1,1,1,4,3,2,0,2,1,5,1,0,23,ITA
f794b426,0,0,0,0,0,0,0,0,0,0,0,0,0,0,0,23,ITA
f7c491f1,77,40,54,20,3,39,55,16,53,23,30,35,112,106,1,23,ITA
f7e2af2c,3,2,2,0,1,2,5,3,3,2,1,3,6,2,1,23,ITA
f86cd5df,3,2,0,2,1,2,7,5,3,1,2,2,5,1,0,23,ITA
f95f49d2,14,10,5,4,5,7,12,5,10,0,10,8,22,5,0,23,ITA
f9758dae,24,15,11,10,3,9,36,27,24,6,18,8,32,26,0,23,ITA
f9c927de,12,6,3,6,3,2,18,16,14,2,12,7,19,9,0,23,ITA
fa449bba,27,13,16,6,5,12,24,12,16,4,12,8,35,27,0,23,ITA
fb77bfef,13,8,7,6,0,6,12,6,11,8,3,12,25,39,0,23,ITA
fcb38f57,1,0,1,0,0,1,1,0,0,0,0,1,2,10,1,23,ITA
fdf4b948,53,37,25,19,9,23,42,19,35,4,31,13,66,27,0,23,ITA
fe012aca,9,5,3,2,4,2,5,3,6,0,6,1,10,1,0,23,ITA
ff579c7e,32,21,11,15,6,14,36,22,15,2,13,8,40,18,0,23,ITA
ff5ea0bf,31,26,22,9,0,11,20,9,11,5,6,12,43,65,1,23,ITA
ffed43e3,0,0,0,0,0,0,1,1,2,1,1,1,1,7,0,23,ITA
00891164,50,36,31,17,2,19,29,10,44,22,22,59,109,132,1,23,FRA
00a8d210,77,51,37,31,9,39,80,41,38,6,32,41,118,42,2,23,FRA
01870104,3,3,0,2,1,0,12,12,3,1,2,0,3,1,0,23,FRA
01becd60,3,2,1,1,1,0,4,4,0,0,0,2,5,1,0,23,FRA
01fd01e8,31,14,20,10,1,17,22,5,33,12,21,26,57,61,1,23,FRA
02bcaf8e,8,5,2,5,1,1,7,6,4,0,4,4,12,0,0,23,FRA
032f894e,8,1,1,3,4,5,14,9,13,3,10,9,17,4,0,23,FRA
03e91055,0,0,0,0,0,0,0,0,0,0,0,0,0,0,0,23,FRA
0400dd2f,13,9,2,7,4,7,14,7,4,0,4,1,14,2,0,23,FRA
04ac78d2,18,8,13,4,1,7,16,9,33,23,10,16,34,70,0,23,FRA
04bb2b06,24,13,3,13,8,5,11,6,13,0,13,4,28,18,0,23,FRA
0512a60a,48,24,23,21,4,20,34,14,26,8,18,27,75,54,0,23,FRA
061266cd,13,11,7,5,1,4,15,11,13,1,12,5,18,11,0,23,FRA
065dc209,20,11,1,10,9,5,17,12,14,3,11,5,25,15,0,23,FRA
06c48679,62,40,30,25,7,31,53,22,40,26,14,38,100,83,0,23,FRA
06df8256,10,8,6,4,0,5,10,5,9,6,3,17,27,40,1,23,FRA
07ace8c3,0,0,0,0,0,0,0,0,0,0,0,0,0,0,0,23,FRA
0810b6df,0,0,0,0,0,0,0,0,0,0,0,0,0,1,0,23,FRA
08511d65,34,26,14,18,2,23,44,21,29,13,16,34,68,93,3,23,FRA
08f5afaa,1,0,1,0,0,1,2,1,0,0,0,0,1,12,4,23,FRA
095e4199,9,3,3,3,3,5,12,7,8,0,8,2,11,2,0,23,FRA
0a63446f,35,23,20,11,4,20,33,13,17,5,12,35,70,44,1,23,FRA
0af4dcf0,2,1,2,0,0,2,2,0,0,0,0,0,2,0,0,23,FRA
0b2c9aec,18,8,6,7,5,8,20,12,8,2,6,6,24,11,0,23,FRA
0b4d8274,8,3,3,3,2,3,6,3,8,0,8,2,10,2,0,23,FRA
0b4f388a,15,9,2,7,6,5,10,5,14,3,11,5,20,12,0,23,FRA
0be95d34,39,24,13,17,9,16,36,20,14,1,13,11,50,5,0,23,FRA
0bfca6a1,31,19,19,8,4,18,38,20,27,4,23,24,55,30,0,23,FRA
0cbc8baa,72,38,44,24,4,42,73,31,33,5,28,28,100,65,1,23,FRA
0d7b6576,9,3,2,3,4,5,14,9,14,2,12,3,12,5,0,23,FRA
0e12089d,0,0,0,0,0,0,0,0,0,0,0,0,0,9,3,23,FRA
0e46fa2f,5,3,0,3,2,1,6,5,7,1,6,3,8,2,0,23,FRA
0e7ccfc4,16,6,10,2,4,11,22,11,9,3,6,14,30,21,0,23,FRA
0e8d7b6c,0,0,0,0,0,0,0,0,4,0,4,3,3,0,0,23,FRA
0ed063d6,23,13,13,8,2,15,24,9,15,1,14,26,49,46,0,23,FRA
0f8418aa,40,22,18,17,5,22,42,20,20,6,14,10,50,19,0,23,FRA
0f86995c,0,0,0,0,0,0,1,1,0,0,0,0,0,0,0,23,FRA
0ff630d0,36,22,22,10,4,18,34,16,20,3,17,25,61,57,1,23,FRA
102c9665,32,18,24,7,1,19,28,9,11,2,9,25,57,59,1,23,FRA
104b4ad3,4,3,1,2,1,1,7,6,1,0,1,1,5,2,0,23,FRA
10dd88f9,17,8,5,6,6,8,30,22,15,0,15,10,27,9,0,23,FRA
10f0fdd3,47,25,15,21,11,11,25,14,26,3,23,26,73,22,0,23,FRA
114bbdee,1,1,1,0,0,0,0,0,0,0,0,1,2,3,0,23,FRA
11f54bd5,10,6,4,3,3,4,12,8,2,0,2,1,11,2,0,23,FRA
1237c049,8,3,6,1,1,4,11,7,0,0,0,1,9,0,0,23,FRA
1361e5bc,19,12,10,7,2,13,22,9,7,1,6,13,32,8,1,23,FRA
1467af0d,76,49,34,36,6,38,89,51,42,6,36,27,103,11,3,23,FRA
148e136f,64,37,21,28,15,29,64,35,41,5,36,17,81,7,1,23,FRA
15944afd,26,12,11,13,2,11,26,15,18,4,14,15,41,11,1,23,FRA
16aa7d4c,45,27,27,18,0,20,38,18,40,19,21,63,108,86,1,23,FRA
17e25e72,2,2,1,1,0,0,0,0,1,0,1,2,4,0,0,23,FRA
1880614f,37,19,15,13,9,13,34,21,18,2,16,18,55,13,0,23,FRA
18ebca4b,2,1,0,2,0,0,4,4,2,0,2,0,2,5,0,23,FRA
19053e31,23,11,12,6,5,7,20,13,14,2,12,17,40,5,0,23,FRA
1956b948,39,24,24,11,4,19,62,43,24,2,22,24,63,26,1,23,FRA
1961b2aa,37,19,12,17,8,19,52,33,20,5,15,9,46,16,1,23,FRA
19ba6c6d,13,5,1,7,5,5,14,9,18,7,11,3,16,20,0,23,FRA
1a066e69,24,13,17,5,2,12,17,5,28,17,11,34,58,90,0,23,FRA
1a248246,23,12,6,11,6,10,27,17,12,1,11,6,29,5,0,23,FRA
1a2935f6,25,19,20,5,0,20,29,9,20,10,10,26,51,70,1,23,FRA
1a6b7ea4,46,26,22,20,4,18,34,16,15,5,10,23,69,32,1,23,FRA
1a85bcdb,72,44,41,24,7,38,61,23,32,8,24,65,137,70,0,23,FRA
1b5b32d2,1,0,0,1,0,1,1,0,0,0,0,0,1,0,0,23,FRA
1b729a98,0,0,0,0,0,0,0,0,0,0,0,0,0,1,0,23,FRA
1bd5bdc4,0,0,0,0,0,0,0,0,0,0,0,0,0,1,0,23,FRA
1bfb6fef,54,35,23,24,7,32,57,25,37,8,29,17,71,58,0,23,FRA
1d2d5cc8,0,0,0,0,0,0,2,2,0,0,0,0,0,9,3,23,FRA
1d383c10,0,0,0,0,0,0,1,1,1,0,1,0,0,1,0,23,FRA
1d5c96f8,71,38,36,27,8,43,67,24,35,6,29,36,107,48,2,23,FRA
1ddbc7ca,96,60,61,29,6,59,89,30,35,4,31,64,160,40,1,23,FRA
1df4a109,36,19,13,20,3,16,24,8,24,10,14,21,57,16,0,23,FRA
1e52971c,58,34,24,27,7,32,86,54,29,5,24,28,86,17,3,23,FRA
1e7aea56,0,0,0,0,0,0,2,2,0,0,0,1,1,16,2,23,FRA
1e93fc5d,1,1,1,0,0,1,1,0,0,0,0,0,1,0,0,23,FRA
1ec7e1c5,8,7,5,3,0,3,3,0,4,3,1,5,13,12,0,23,FRA
1f6298f2,0,0,0,0,0,0,0,0,1,0,1,0,0,0,0,23,FRA
2054d037,13,7,1,8,4,3,13,10,22,1,21,1,14,20,0,23,FRA
20b9f052,0,0,0,0,0,0,1,1,0,0,0,0,0,5,1,23,FRA
20e0dd86,53,37,16,20,17,23,47,24,20,3,17,25,78,21,0,23,FRA
20e73fac,45,29,16,23,6,21,65,44,38,3,35,31,76,32,0,23,FRA
2180c761,10,7,7,2,1,3,12,9,9,7,2,9,19,13,3,23,FRA
22396615,1,1,0,1,0,0,1,1,0,0,0,1,2,0,0,23,FRA
22bfb57e,16,8,5,10,1,6,20,14,8,5,3,10,26,13,1,23,FRA
2321ea6e,75,32,56,16,3,45,62,17,29,9,20,41,116,105,1,23,FRA
23c63b7f,9,7,2,3,4,4,7,3,13,1,12,2,11,13,0,23,FRA
2434f24a,2,0,2,0,0,2,4,2,0,0,0,0,2,5,0,23,FRA
25749008,39,26,13,19,7,13,39,26,27,2,25,21,60,19,0,23,FRA
2677a1de,26,13,13,7,6,6,25,19,17,1,16,9,35,20,0,23,FRA
279ddf6a,82,50,39,30,13,27,71,44,31,8,23,41,123,24,0,23,FRA
28dabd43,2,0,2,0,0,2,3,1,1,0,1,1,3,12,1,23,FRA
29939a1d,25,17,14,9,2,11,29,18,13,1,12,22,47,9,0,23,FRA
29c02c9f,32,20,17,10,5,19,26,7,18,2,16,17,49,19,0,23,FRA
2acd49b9,26,16,16,7,3,12,18,6,22,5,17,16,42,17,0,23,FRA
2acf0cd7,58,27,13,31,14,20,48,28,37,11,26,26,84,41,1,23,FRA
2b1bed19,80,48,35,40,5,44,85,41,32,6,26,52,132,21,3,23,FRA
2b471f99,32,21,11,14,7,12,18,6,13,5,8,11,43,20,0,23,FRA
2c0f8e9e,27,17,5,16,6,3,24,21,14,0,14,5,32,6,0,23,FRA
2c70d915,2,0,1,1,0,1,3,2,0,0,0,3,5,1,0,23,FRA
2c8a91b9,0,0,0,0,0,0,1,1,3,3,0,0,0,4,0,23,FRA
2ccd89a3,19,10,10,6,3,9,13,4,10,1,9,8,27,19,0,23,FRA
2d22cea7,8,7,3,4,1,3,7,4,5,1,4,4,12,1,0,23,FRA
2db2fd7b,3,0,2,1,0,2,6,4,8,5,3,6,9,16,0,23,FRA
2f9e4435,41,26,20,11,10,15,28,13,24,6,18,19,60,21,0,23,FRA
2fa2a875,0,0,0,0,0,0,2,2,0,0,0,0,0,6,0,23,FRA
300ec91c,0,0,0,0,0,0,1,1,1,0,1,0,0,0,0,23,FRA
3010aefb,24,15,11,9,4,11,23,12,13,3,10,14,38,7,0,23,FRA
30144daa,24,19,12,8,4,13,27,14,21,1,20,4,28,10,0,23,FRA
30af8b93,74,51,42,28,4,44,76,32,28,8,20,26,100,68,1,23,FRA
31626657,92,52,59,30,3,39,92,53,47,8,39,34,126,39,0,23,FRA
31822f8c,9,5,1,5,3,2,20,18,20,1,19,3,12,15,0,23,FRA
3189f61a,74,40,31,35,8,36,61,25,33,11,22,44,118,29,3,23,FRA
321a71a7,39,24,23,14,2,19,31,12,22,14,8,37,76,74,0,23,FRA
32c2d95f,82,50,47,33,2,39,52,13,65,27,38,64,146,116,1,23,FRA
32e2163d,9,5,5,2,2,5,16,11,4,1,3,4,13,5,0,23,FRA
32f3d97e,0,0,0,0,0,0,2,2,3,1,2,0,0,1,0,23,FRA
331c5a98,2,0,2,0,0,0,1,1,1,0,1,1,3,0,0,23,FRA
3322e296,22,13,16,5,1,9,15,6,6,1,5,2,24,16,0,23,FRA
34a88e3e,18,12,6,7,5,12,20,8,9,0,9,2,20,2,0,23,FRA
35516eac,20,14,10,7,3,9,25,16,11,0,11,15,35,5,0,23,FRA
357103bd,31,18,8,15,8,17,50,33,38,5,33,19,50,36,1,23,FRA
3670aa71,0,0,0,0,0,0,0,0,0,0,0,0,0,0,0,23,FRA
3681cfff,10,4,7,2,1,4,13,9,16,11,5,20,30,48,0,23,FRA
3708e9fa,62,36,19,32,11,28,72,44,28,1,27,37,99,10,0,23,FRA
37143438,13,8,3,3,7,7,15,8,7,1,6,4,17,1,0,23,FRA
374fbf7d,21,12,7,10,4,12,29,17,8,1,7,15,36,11,0,23,FRA
375622c5,55,35,32,19,4,30,89,59,22,6,16,26,81,21,0,23,FRA
3814120d,0,0,0,0,0,0,0,0,0,0,0,0,0,2,0,23,FRA
3916b09c,9,7,4,2,3,7,15,8,9,1,8,15,24,17,0,23,FRA
3935e52e,52,36,24,22,6,24,37,13,19,2,17,43,95,35,1,23,FRA
3975195f,27,14,19,4,4,18,30,12,15,3,12,23,50,39,0,23,FRA
397ba086,16,7,2,9,5,4,13,9,14,3,11,6,22,22,0,23,FRA
39b326ed,38,22,20,15,3,29,63,34,21,5,16,22,60,24,1,23,FRA
3a24769f,16,9,7,4,5,7,13,6,7,2,5,8,24,6,0,23,FRA
3b029691,58,25,21,27,10,27,83,56,27,4,23,25,83,15,0,23,FRA
3b676989,1,0,0,0,1,0,3,3,0,0,0,0,1,0,0,23,FRA
3bd65247,18,10,4,12,2,4,12,8,18,1,17,4,22,1,0,23,FRA
3befc2b6,122,73,71,45,6,74,132,58,55,24,31,73,195,176,1,23,FRA
3c6bbbab,58,37,30,22,6,30,42,12,24,7,17,44,102,55,1,23,FRA
3cdfc63e,8,6,8,0,0,7,15,8,25,19,6,22,30,80,1,23,FRA
3d214e5f,0,0,0,0,0,0,1,1,1,0,1,0,0,24,4,23,FRA
3dd738a1,19,9,7,7,5,8,22,14,13,1,12,18,37,28,1,23,FRA
3eaf8817,1,0,1,0,0,0,1,1,6,1,5,0,1,4,0,23,FRA
3ecc8c5f,41,23,28,13,0,19,33,14,44,28,16,56,97,97,4,23,FRA
3ef0fa48,15,8,6,4,5,4,13,9,4,1,3,3,18,2,0,23,FRA
3f319bb9,48,21,34,14,0,29,46,17,58,45,13,50,98,152,0,23,FRA
40221fa7,35,19,23,5,7,17,30,13,21,4,17,22,57,34,0,23,FRA
40774c6b,23,14,7,13,3,6,15,9,11,1,10,2,25,6,0,23,FRA
40ef7347,52,36,29,16,7,27,73,46,34,0,34,21,73,7,0,23,FRA
41eebdf5,46,24,22,21,3,12,15,3,24,7,17,45,91,85,1,23,FRA
42276181,20,10,6,10,4,8,28,20,10,1,9,9,29,0,0,23,FRA
42f0113f,2,1,0,2,0,0,0,0,2,0,2,1,3,0,0,23,FRA
42fd9c7f,10,4,0,5,5,5,16,11,5,0,5,5,15,6,0,23,FRA
4315f30d,6,3,5,1,0,1,5,4,11,7,4,15,21,29,2,23,FRA
433dc9a2,32,16,18,9,5,21,39,18,11,2,9,9,41,22,1,23,FRA
43e7a164,53,36,37,16,0,26,46,20,45,19,26,66,119,151,3,23,FRA
4534a352,20,11,14,6,0,14,28,14,13,7,6,17,37,43,1,23,FRA
45cce300,17,4,4,9,4,6,15,9,6,0,6,1,18,0,0,23,FRA
462475ed,5,4,1,4,0,3,9,6,3,1,2,2,7,7,0,23,FRA
46359159,20,12,10,8,2,12,26,14,5,0,5,4,24,12,0,23,FRA
46750e9c,2,1,2,0,0,2,2,0,0,0,0,0,2,0,0,23,FRA
468fdbad,9,7,4,5,0,5,14,9,3,1,2,7,16,3,0,23,FRA
46faabfa,6,2,1,4,1,1,6,5,8,2,6,1,7,9,0,23,FRA
477e50ce,0,0,0,0,0,0,0,0,0,0,0,0,0,0,0,23,FRA
47c609d5,0,0,0,0,0,0,0,0,2,0,2,0,0,1,0,23,FRA
489e80e3,83,45,38,39,6,48,92,44,45,6,39,27,110,14,1,23,FRA
48b28bfd,34,20,10,20,4,12,31,19,25,0,25,24,58,15,0,23,FRA
48d5bd33,21,11,3,12,6,10,26,16,13,1,12,3,24,9,0,23,FRA
49070d66,44,27,28,14,2,25,49,24,13,5,8,36,80,53,0,23,FRA
49136c42,16,8,9,6,1,8,13,5,18,9,9,21,37,36,0,23,FRA
4a021593,0,0,0,0,0,0,0,0,0,0,0,0,0,0,0,23,FRA
4a0c6555,0,0,0,0,0,0,0,0,0,0,0,1,1,0,0,23,FRA
4a56052c,56,35,17,32,7,25,53,28,22,7,15,36,92,40,2,23,FRA
4a5e83ad,16,5,6,9,1,4,15,11,9,1,8,12,28,6,0,23,FRA
4a987ffa,0,0,0,0,0,0,1,1,3,0,3,0,0,0,0,23,FRA
4b792f35,0,0,0,0,0,0,0,0,0,0,0,1,1,0,0,23,FRA
4b96c347,14,7,2,4,8,5,14,9,11,0,11,8,22,2,0,23,FRA
4be0b467,1,0,0,1,0,1,3,2,2,0,2,0,1,1,0,23,FRA
4ca4f263,4,3,4,0,0,4,5,1,2,0,2,1,5,7,0,23,FRA
4ca4f601,40,23,10,20,10,15,51,36,25,5,20,14,54,11,0,23,FRA
4db5915d,19,12,7,6,6,5,12,7,10,1,9,8,27,16,1,23,FRA
4e0afc5d,22,16,13,7,2,11,14,3,8,3,5,4,26,4,0,23,FRA
4e47507a,3,2,0,2,1,0,1,1,0,0,0,0,3,1,0,23,FRA
4e7db402,0,0,0,0,0,0,1,1,0,0,0,0,0,20,4,23,FRA
4fb18ca4,3,0,1,2,0,3,5,2,0,0,0,2,5,2,0,23,FRA
5065d67d,4,3,3,1,0,1,2,1,2,1,1,2,6,4,0,23,FRA
5069b796,21,14,15,5,1,14,20,6,16,10,6,19,40,65,2,23,FRA
508a9011,1,1,1,0,0,0,0,0,0,0,0,0,1,0,0,23,FRA
50ac8941,0,0,0,0,0,0,0,0,0,0,0,1,1,1,0,23,FRA
5148dcc5,25,11,7,9,9,13,24,11,15,2,13,14,39,6,0,23,FRA
5167c97e,24,16,9,9,6,12,24,12,26,9,17,36,60,39,1,23,FRA
51c30111,27,12,6,16,5,19,31,12,22,7,15,25,52,22,0,23,FRA
51c83a90,0,0,0,0,0,0,0,0,0,0,0,0,0,1,0,23,FRA
5219ab4a,46,28,21,16,9,23,52,29,29,4,25,31,77,40,2,23,FRA
52cd0e88,0,0,0,0,0,0,0,0,0,0,0,0,0,0,0,23,FRA
5313ed43,28,13,8,18,2,15,39,24,17,4,13,19,47,14,0,23,FRA
531a4aa8,54,39,28,20,6,20,37,17,35,15,20,34,88,82,0,23,FRA
53af52f3,1,0,1,0,0,1,4,3,1,0,1,1,2,11,1,23,FRA
546bb36e,28,17,13,14,1,11,36,25,22,5,17,26,54,31,0,23,FRA
547a72ad,6,4,5,0,1,4,6,2,3,0,3,2,8,5,0,23,FRA
562a4799,31,18,18,11,2,19,35,16,24,14,10,34,65,73,1,23,FRA
563fcd6b,27,20,13,11,3,18,48,30,10,0,10,6,33,10,0,23,FRA
5680bf3f,6,4,2,1,3,3,4,1,10,1,9,9,15,8,0,23,FRA
56ae428b,41,26,29,11,1,19,38,19,57,34,23,53,94,193,0,23,FRA
574aa9ec,0,0,0,0,0,0,0,0,0,0,0,0,0,0,0,23,FRA
576817b7,27,21,13,9,5,16,25,9,10,3,7,12,39,12,0,23,FRA
57e3f0c7,25,13,14,5,6,11,25,14,17,0,17,3,28,1,0,23,FRA
58ae47b2,6,4,2,2,2,3,10,7,4,0,4,0,6,4,0,23,FRA
595e6f3e,18,13,5,7,6,9,20,11,23,1,22,10,28,33,0,23,FRA
59948ef7,13,7,1,10,2,7,19,12,19,1,18,11,24,6,0,23,FRA
5a6b06cd,1,1,0,0,1,0,0,0,0,0,0,0,1,0,0,23,FRA
5b146df3,42,30,31,8,3,23,32,9,42,19,23,53,95,132,1,23,FRA
5b1bf5e3,0,0,0,0,0,0,0,0,0,0,0,0,0,1,0,23,FRA
5b3cfa12,0,0,0,0,0,0,2,2,2,0,2,3,3,0,0,23,FRA
5b479568,3,3,0,2,1,1,7,6,1,0,1,0,3,1,0,23,FRA
5b4bc323,33,21,21,10,2,19,35,16,13,2,11,24,57,29,2,23,FRA
5b92d896,12,4,1,10,1,4,12,8,12,0,12,9,21,3,0,23,FRA
5b9512c5,39,23,27,8,4,21,31,10,42,24,18,75,114,105,1,23,FRA
5bf26efc,0,0,0,0,0,0,0,0,0,0,0,0,0,0,0,23,FRA
5c42e7ce,6,5,5,1,0,1,5,4,2,2,0,2,8,8,1,23,FRA
5cb215fc,32,17,24,8,0,13,22,9,24,17,7,27,59,96,1,23,FRA
5ceba7fc,12,10,3,5,4,7,24,17,17,2,15,18,30,9,0,23,FRA
5d0e0a1f,62,32,36,17,9,31,46,15,32,8,24,22,84,55,0,23,FRA
5d8d7454,47,29,18,23,6,25,43,18,24,3,21,43,90,33,1,23,FRA
5d9577aa,6,4,1,5,0,2,4,2,3,0,3,7,13,2,0,23,FRA
5e080f73,2,0,1,1,0,0,3,3,3,0,3,2,4,2,0,23,FRA
5e22e2a4,41,22,13,23,5,21,41,20,21,5,16,21,62,23,0,23,FRA
5e5249c8,33,15,14,12,7,21,40,19,12,0,12,18,51,17,0,23,FRA
5e6355f8,2,0,1,0,1,1,2,1,0,0,0,1,3,0,0,23,FRA
5ea8ef20,39,18,9,21,9,14,38,24,12,5,7,21,60,18,0,23,FRA
5f3eaaf5,18,9,6,7,5,7,15,8,14,1,13,11,29,3,0,23,FRA
5fdcb075,24,17,10,14,0,11,37,26,28,5,23,20,44,40,1,23,FRA
6043997c,28,20,14,12,2,10,12,2,19,11,8,10,38,63,1,23,FRA
60d90c55,1,0,1,0,0,1,2,1,1,0,1,0,1,12,2,23,FRA
6191093d,47,30,17,19,11,17,49,32,26,1,25,19,66,8,0,23,FRA
61b77d0a,6,4,2,2,2,2,5,3,0,0,0,0,6,5,0,23,FRA
61f80c89,0,0,0,0,0,0,0,0,0,0,0,0,0,0,0,23,FRA
62124972,0,0,0,0,0,0,0,0,0,0,0,0,0,1,0,23,FRA
627b570a,1,0,0,0,1,1,2,1,0,0,0,0,1,1,0,23,FRA
62e02107,6,4,4,2,0,5,6,1,2,1,1,2,8,3,0,23,FRA
636247ca,13,7,5,4,4,7,21,14,12,2,10,7,20,1,0,23,FRA
6388e356,46,25,25,15,6,32,51,19,43,14,29,33,79,75,1,23,FRA
645a3363,41,19,12,21,8,18,49,31,22,2,20,13,54,11,1,23,FRA
64ba07c0,25,18,11,12,2,15,17,2,16,3,13,9,34,22,0,23,FRA
64c14d49,45,24,22,16,7,23,62,39,27,3,24,22,67,18,0,23,FRA
64f69877,8,4,1,5,2,2,8,6,8,0,8,2,10,0,0,23,FRA
652d4c37,44,27,16,23,5,25,66,41,25,5,20,24,68,23,1,23,FRA
654f49ca,1,0,0,1,0,0,2,2,3,1,2,0,1,1,0,23,FRA
65c55288,13,9,8,5,0,6,11,5,8,5,3,12,25,22,1,23,FRA
65fcf987,4,2,2,1,1,0,2,2,1,0,1,0,4,1,0,23,FRA
6605d143,18,10,8,7,3,6,16,10,19,4,15,12,30,26,0,23,FRA
6690ef25,0,0,0,0,0,0,0,0,0,0,0,0,0,0,1,23,FRA
6751b938,0,0,0,0,0,0,0,0,0,0,0,0,0,0,0,23,FRA
6763f716,11,5,8,3,0,4,9,5,6,1,5,18,29,27,1,23,FRA
67f649be,0,0,0,0,0,0,0,0,0,0,0,0,0,3,3,23,FRA
68a26d51,33,22,12,15,6,17,44,27,24,1,23,20,53,7,0,23,FRA
69384e5d,22,14,6,9,7,9,19,10,7,1,6,4,26,1,1,23,FRA
698f11e3,20,9,9,9,2,9,15,6,25,10,15,19,39,27,1,23,FRA
6993927b,33,16,20,12,1,22,39,17,22,13,9,18,51,64,1,23,FRA
6a827d8e,38,22,18,15,5,23,32,9,9,0,9,14,52,13,0,23,FRA
6a9e4913,0,0,0,0,0,0,0,0,0,0,0,0,0,2,0,23,FRA
6b4436ba,1,1,0,1,0,0,1,1,0,0,0,2,3,0,0,23,FRA
6b5edd5d,8,3,4,2,2,3,6,3,2,1,1,0,8,1,0,23,FRA
6b9960cf,17,10,5,10,2,8,29,21,11,0,11,12,29,17,0,23,FRA
6bde367b,46,30,16,19,11,23,70,47,30,2,28,30,76,12,1,23,FRA
6d0fe035,24,16,10,11,3,15,29,14,17,1,16,11,35,13,0,23,FRA
6d7ede84,2,1,0,1,1,1,2,1,3,0,3,0,2,5,0,23,FRA
6de23ab0,42,24,26,15,1,31,49,18,26,13,13,49,91,75,1,23,FRA
6e33125f,37,19,25,11,1,19,30,11,48,34,14,33,70,124,0,23,FRA
6e7f1353,36,25,10,16,10,17,56,39,21,1,20,22,58,9,0,23,FRA
6ea05ca7,2,1,1,0,1,0,1,1,1,0,1,2,4,0,0,23,FRA
6f5ec8bb,31,20,16,15,0,13,35,22,25,9,16,26,57,62,1,23,FRA
6f806d99,108,64,52,40,16,43,113,70,50,5,45,34,142,38,1,23,FRA
705a1642,8,6,5,3,0,3,5,2,5,1,4,2,10,0,0,23,FRA
706a60e1,8,3,2,5,1,5,12,7,1,0,1,2,10,0,0,23,FRA
7091324a,0,0,0,0,0,0,0,0,0,0,0,0,0,1,0,23,FRA
70c52749,24,15,9,12,3,12,25,13,18,2,16,23,47,26,0,23,FRA
70d4c949,7,3,1,3,3,4,7,3,4,0,4,0,7,0,0,23,FRA
7120a04d,21,10,8,5,8,10,19,9,9,0,9,13,34,2,0,23,FRA
7155e3e1,18,7,10,7,1,7,15,8,9,2,7,9,27,2,0,23,FRA
71d10572,3,1,1,1,1,1,2,1,5,3,2,2,5,8,0,23,FRA
72d4922b,2,1,1,0,1,2,5,3,0,0,0,1,3,7,0,23,FRA
7304f3b1,2,0,1,1,0,2,2,0,1,0,1,1,3,0,0,23,FRA
740f00ac,55,26,29,19,7,25,68,43,23,3,20,19,74,31,0,23,FRA
741418c3,17,11,7,9,1,9,19,10,6,0,6,4,21,2,0,23,FRA
745ca0a3,19,11,7,6,6,6,28,22,14,0,14,1,20,4,0,23,FRA
7495aba7,11,5,3,7,1,4,5,1,5,1,4,2,13,2,0,23,FRA
74d4cec6,15,7,0,6,9,3,11,8,3,0,3,2,17,6,0,23,FRA
75438a9a,4,2,1,1,2,2,5,3,9,3,6,8,12,22,0,23,FRA
7587446d,3,3,2,1,0,3,4,1,3,1,2,3,6,3,0,23,FRA
75f1ed80,71,49,53,16,2,42,65,23,30,14,16,32,103,107,3,23,FRA
770d7eb8,36,19,19,15,2,22,38,16,15,5,10,21,57,28,0,23,FRA
779847d6,69,44,51,16,2,42,70,28,35,18,17,30,99,131,2,23,FRA
7909ffa4,64,34,37,23,4,40,78,38,40,11,29,40,104,42,1,23,FRA
796b1c41,47,28,14,25,8,15,47,32,17,2,15,33,80,8,0,23,FRA
7978cbf0,64,38,22,32,10,31,67,36,30,1,29,28,92,15,0,23,FRA
79a793b7,11,9,6,3,2,7,10,3,3,1,2,3,14,5,0,23,FRA
79b2399c,36,21,17,15,4,22,55,33,24,3,21,15,51,24,0,23,FRA
7a3f8712,0,0,0,0,0,0,0,0,0,0,0,0,0,0,0,23,FRA
7a42d0df,39,19,11,17,11,15,40,25,41,2,39,29,68,51,0,23,FRA
7af655fe,0,0,0,0,0,0,0,0,0,0,0,0,0,0,0,23,FRA
7b082ec2,21,16,9,11,1,13,29,16,14,6,8,14,35,24,0,23,FRA
7b9a9e25,26,14,10,12,4,12,28,16,19,1,18,14,40,7,0,23,FRA
7be7c08b,2,2,0,1,1,1,2,1,1,0,1,3,5,0,0,23,FRA
7c2965bb,24,12,6,15,3,7,31,24,14,2,12,9,33,10,0,23,FRA
7c3ed041,57,37,43,12,2,32,45,13,48,29,19,63,120,91,1,23,FRA
7cdda3bf,46,26,14,17,15,18,41,23,28,2,26,9,55,14,0,23,FRA
7d3dfdfd,10,6,5,5,0,5,12,7,4,2,2,11,21,15,0,23,FRA
7d704e92,32,20,24,7,1,13,31,18,24,17,7,33,65,75,0,23,FRA
7d937aa1,0,0,0,0,0,0,0,0,1,0,1,0,0,0,0,23,FRA
7d9397f8,51,25,22,23,6,19,43,24,33,13,20,38,89,34,0,23,FRA
7dfbba27,22,10,10,10,2,7,16,9,14,2,12,12,34,13,0,23,FRA
7e3e825e,3,2,2,1,0,2,3,1,1,0,1,1,4,3,0,23,FRA
7e82a78f,14,6,5,4,5,7,24,17,12,1,11,10,24,11,0,23,FRA
7ef972c3,2,0,2,0,0,1,1,0,4,1,3,0,2,1,0,23,FRA
7f41ee30,1,0,1,0,0,1,1,0,0,0,0,0,1,3,0,23,FRA
7f783431,26,17,14,11,1,13,22,9,17,2,15,7,33,33,0,23,FRA
7fecbcdb,22,12,15,5,2,16,19,3,7,3,4,18,40,38,0,23,FRA
8104e41e,30,21,4,17,9,13,32,19,29,1,28,17,47,12,0,23,FRA
810edef9,0,0,0,0,0,0,1,1,1,0,1,1,1,1,0,23,FRA
822d51d7,81,41,31,42,8,38,74,36,50,6,44,56,137,32,1,23,FRA
82464ce3,46,26,18,23,5,29,52,23,38,9,29,36,82,26,0,23,FRA
8299e363,8,6,7,1,0,6,8,2,8,2,6,8,16,12,0,23,FRA
83299cc0,21,9,6,14,1,10,22,12,9,0,9,15,36,4,1,23,FRA
8332db56,28,14,16,6,6,13,26,13,8,3,5,16,44,9,0,23,FRA
834b5c4c,4,3,4,0,0,4,4,0,0,0,0,4,8,23,0,23,FRA
836dc4a8,3,1,0,2,1,1,2,1,1,0,1,1,4,0,0,23,FRA
83f03b07,30,21,18,9,3,14,26,12,17,7,10,26,56,18,0,23,FRA
8499c713,2,2,2,0,0,2,3,1,1,1,0,0,2,0,0,23,FRA
85613cf0,1,1,0,0,1,0,1,1,0,0,0,0,1,2,0,23,FRA
8577e60a,63,36,18,38,7,25,43,18,35,4,31,40,103,16,0,23,FRA
8608f269,0,0,0,0,0,0,0,0,0,0,0,1,1,0,0,23,FRA
8652a85c,11,9,2,6,3,2,13,11,9,0,9,2,13,6,0,23,FRA
868eaba0,62,34,30,23,9,38,111,73,37,7,30,36,98,25,1,23,FRA
86a2ba20,44,27,28,14,2,17,41,24,32,11,21,49,93,46,1,23,FRA
86a49468,2,2,0,1,1,0,6,6,2,0,2,0,2,0,0,23,FRA
87935cf3,9,5,4,5,0,3,5,2,17,12,5,8,17,35,1,23,FRA
87d31635,2,1,1,1,0,1,10,9,1,0,1,3,5,5,0,23,FRA
87e9c7cd,10,6,6,2,2,7,22,15,10,2,8,8,18,10,0,23,FRA
8827bf46,6,4,1,4,1,3,5,2,5,0,5,2,8,4,0,23,FRA
8846a40f,20,7,5,14,1,11,29,18,10,1,9,14,34,12,0,23,FRA
88c4d190,15,9,5,9,1,3,27,24,29,2,27,11,26,30,0,23,FRA
88f130ed,76,48,54,19,3,41,56,15,41,19,22,41,117,110,2,23,FRA
890bc029,0,0,0,0,0,0,0,0,0,0,0,0,0,0,0,23,FRA
8a53d24b,5,2,2,2,1,3,11,8,8,2,6,2,7,4,0,23,FRA
8ac64b4e,0,0,0,0,0,0,0,0,0,0,0,0,0,0,0,23,FRA
8bc8829a,42,25,18,15,9,17,33,16,14,5,9,27,69,24,0,23,FRA
8ca9415f,5,5,2,1,2,0,3,3,6,0,6,1,6,2,0,23,FRA
8d62d31a,11,7,9,2,0,4,10,6,16,12,4,9,20,54,1,23,FRA
8dbff17c,19,14,13,5,1,17,32,15,23,16,7,25,44,75,3,23,FRA
8eec784d,24,14,13,9,2,16,29,13,17,3,14,23,47,18,0,23,FRA
8f325097,38,21,27,9,2,26,38,12,11,5,6,21,59,35,1,23,FRA
8f7e6783,2,2,1,0,1,1,2,1,0,0,0,0,2,0,0,23,FRA
8fd9996f,32,17,15,14,3,19,26,7,26,19,7,36,68,59,1,23,FRA
906baf89,0,0,0,0,0,0,0,0,0,0,0,0,0,0,0,23,FRA
909222de,45,23,14,23,8,11,46,35,21,1,20,20,65,15,0,23,FRA
90a9cc01,1,1,1,0,0,0,1,1,2,1,1,3,4,0,0,23,FRA
90eb507d,35,22,18,11,6,17,46,29,21,7,14,33,68,29,2,23,FRA
90f87966,23,17,18,4,1,10,21,11,27,14,13,25,48,112,2,23,FRA
90fcf472,4,1,1,2,1,2,6,4,4,0,4,1,5,2,0,23,FRA
910e3cad,1,1,1,0,0,1,1,0,0,0,0,0,1,0,0,23,FRA
9226aa22,31,16,9,14,8,12,37,25,17,1,16,13,44,3,0,23,FRA
923f4dda,0,0,0,0,0,0,0,0,0,0,0,0,0,0,0,23,FRA
9260926b,10,7,6,3,1,7,11,4,7,3,4,10,20,20,0,23,FRA
928a4a61,46,25,25,14,7,25,48,23,30,6,24,18,64,22,0,23,FRA
92b56413,1,1,0,1,0,0,2,2,0,0,0,0,1,0,0,23,FRA
92d90c8f,2,2,2,0,0,1,2,1,0,0,0,1,3,0,0,23,FRA
92ffb8f9,19,11,9,9,1,11,29,18,12,3,9,4,23,11,1,23,FRA
93c942fb,13,11,8,5,0,7,14,7,7,2,5,10,23,11,0,23,FRA
942b4f90,16,9,2,5,9,4,13,9,15,0,15,4,20,0,0,23,FRA
94f8d10c,0,0,0,0,0,0,0,0,0,0,0,0,0,1,0,23,FRA
95192fe4,9,5,4,4,1,2,4,2,1,0,1,2,11,2,0,23,FRA
967f34d3,0,0,0,0,0,0,0,0,0,0,0,0,0,1,0,23,FRA
96f4ebc0,1,1,0,0,1,0,0,0,0,0,0,0,1,0,0,23,FRA
96fcd380,0,0,0,0,0,0,0,0,0,0,0,0,0,0,0,23,FRA
9744ff80,5,4,2,2,1,1,7,6,3,0,3,2,7,0,0,23,FRA
97fb4608,1,0,1,0,0,1,1,0,3,1,2,2,3,2,0,23,FRA
99d660b2,71,36,26,32,13,36,89,53,27,4,23,10,81,27,2,23,FRA
9b545925,66,37,54,10,2,30,58,28,52,26,26,56,122,126,4,23,FRA
9b6f7fd5,5,4,0,5,0,1,3,2,2,0,2,1,6,3,0,23,FRA
9bc9a519,14,6,8,2,4,11,18,7,10,3,7,4,18,15,0,23,FRA
9bdd8118,80,44,43,32,5,44,77,33,33,10,23,38,118,41,0,23,FRA
9c221d14,1,1,1,0,0,1,2,1,6,3,3,7,8,19,0,23,FRA
9c2b1f11,3,3,1,0,2,0,5,5,3,1,2,1,4,2,0,23,FRA
9cd28348,4,3,4,0,0,2,2,0,1,0,1,1,5,2,0,23,FRA
9d420dad,0,0,0,0,0,0,0,0,0,0,0,1,1,4,1,23,FRA
9d498560,6,4,4,0,2,5,8,3,5,1,4,4,10,7,0,23,FRA
9daeac61,45,31,31,13,1,17,31,14,20,3,17,27,72,27,1,23,FRA
9dbb75ca,43,23,7,17,19,10,29,19,23,3,20,15,58,4,0,23,FRA
9e17ccff,0,0,0,0,0,0,0,0,0,0,0,0,0,1,1,23,FRA
9e7483ff,37,18,10,23,4,13,32,19,17,1,16,13,50,3,0,23,FRA
9f0f4b49,4,2,3,0,1,2,2,0,2,0,2,4,8,4,0,23,FRA
9f4a940f,2,2,1,1,0,0,1,1,0,0,0,0,2,0,0,23,FRA
9f936061,75,45,45,20,10,46,75,29,45,11,34,41,116,62,1,23,FRA
a0415710,11,5,7,3,1,5,12,7,9,1,8,9,20,18,0,23,FRA
a08985b8,95,67,37,49,9,43,101,58,49,11,38,53,148,44,0,23,FRA
a0d55a09,25,16,8,10,7,8,39,31,29,0,29,19,44,10,0,23,FRA
a0f9b535,30,15,8,17,5,19,42,23,16,4,12,20,50,12,0,23,FRA
a1232f4e,13,10,6,6,1,7,7,0,15,12,3,12,25,18,1,23,FRA
a1390d2f,13,11,2,9,2,9,14,5,13,3,10,1,14,3,2,23,FRA
a17a94d6,66,41,30,29,7,36,61,25,37,11,26,46,112,52,0,23,FRA
a1dbfcb1,7,4,3,2,2,4,4,0,2,1,1,1,8,0,0,23,FRA
a3e1d20d,0,0,0,0,0,0,0,0,1,1,0,1,1,0,0,23,FRA
a426a912,16,9,9,5,2,13,19,6,8,2,6,8,24,9,0,23,FRA
a45a5d95,29,18,15,9,5,12,33,21,18,0,18,11,40,5,0,23,FRA
a4a44eb0,53,25,40,13,0,22,35,13,55,34,21,40,93,190,3,23,FRA
a4b1028a,48,32,26,15,7,28,52,24,33,7,26,38,86,64,0,23,FRA
a4b798a9,80,47,35,35,10,34,93,59,54,9,45,67,147,49,0,23,FRA
a5db0bec,12,5,5,5,2,3,9,6,12,2,10,8,20,3,0,23,FRA
a62f8bf1,6,3,1,4,1,1,5,4,2,0,2,4,10,2,0,23,FRA
a65c844b,56,30,19,24,13,28,55,27,32,4,28,15,71,25,0,23,FRA
a94571f6,0,0,0,0,0,0,1,1,0,0,0,1,1,1,0,23,FRA
a94d93be,13,7,8,5,0,8,12,4,20,13,7,15,28,91,1,23,FRA
a99138af,9,5,3,5,1,6,12,6,2,1,1,4,13,2,0,23,FRA
a9d4c241,51,28,34,13,4,23,37,14,32,11,21,52,103,82,0,23,FRA
aad56ca3,43,26,15,16,12,14,34,20,22,0,22,12,55,13,0,23,FRA
ac73ec79,31,23,16,6,9,19,29,10,22,9,13,14,45,16,0,23,FRA
ad82197c,30,20,13,13,4,13,27,14,51,31,20,56,86,112,2,23,FRA
ae11ba3d,6,5,3,3,0,2,5,3,1,0,1,4,10,4,0,23,FRA
aef6e670,17,8,9,6,2,9,13,4,12,7,5,13,30,9,1,23,FRA
aefa3050,14,7,8,6,0,10,14,4,18,11,7,2,16,24,0,23,FRA
af0c835b,64,34,27,28,9,26,76,50,23,2,21,24,88,15,0,23,FRA
af3ddb2e,13,5,2,7,4,2,15,13,8,1,7,8,21,13,0,23,FRA
af69e7f0,5,4,3,2,0,4,4,0,2,0,2,1,6,1,0,23,FRA
afb0c500,0,0,0,0,0,0,1,1,0,0,0,1,1,10,3,23,FRA
afe39ca8,31,19,17,11,3,15,33,18,21,2,19,18,49,31,0,23,FRA
b003239d,16,7,8,8,0,9,12,3,11,5,6,6,22,50,0,23,FRA
b026bbf6,6,2,4,2,0,2,4,2,6,0,6,2,8,9,0,23,FRA
b088d5d3,12,6,9,3,0,8,20,12,13,2,11,17,29,24,0,23,FRA
b0c71810,14,9,7,4,3,3,14,11,6,0,6,5,19,1,0,23,FRA
b20cc590,8,5,6,2,0,4,9,5,2,0,2,11,19,36,0,23,FRA
b2336681,31,21,23,7,1,13,20,7,17,11,6,23,54,60,1,23,FRA
b2791a55,25,15,14,11,0,18,38,20,27,16,11,27,52,73,1,23,FRA
b2bd0f6c,37,17,12,14,11,14,45,31,36,1,35,22,59,14,0,23,FRA
b2fe86e5,0,0,0,0,0,0,1,1,0,0,0,1,1,0,0,23,FRA
b3244eeb,46,33,35,9,2,35,63,28,26,12,14,30,76,46,1,23,FRA
b34c63a5,14,8,2,5,7,8,23,15,6,0,6,5,19,1,0,23,FRA
b3d76d84,2,1,2,0,0,2,2,0,1,0,1,2,4,7,2,23,FRA
b3f8bdef,45,26,18,20,7,21,34,13,21,4,17,21,66,27,0,23,FRA
b4ef3fb5,0,0,0,0,0,0,0,0,0,0,0,0,0,0,0,23,FRA
b5bb8188,28,17,8,17,3,10,22,12,15,5,10,18,46,20,0,23,FRA
b625b241,7,4,4,3,0,2,8,6,2,0,2,3,10,2,0,23,FRA
b70afb45,8,6,2,2,4,1,13,12,17,3,14,3,11,20,0,23,FRA
b73f17f8,24,16,8,13,3,6,12,6,17,1,16,9,33,6,0,23,FRA
b8c1de25,52,32,25,21,6,25,53,28,21,1,20,20,72,7,1,23,FRA
b94b8be1,5,2,3,1,1,1,9,8,1,0,1,4,9,1,0,23,FRA
b99bec05,56,31,33,17,6,30,65,35,34,8,26,70,126,73,0,23,FRA
badcdcae,35,13,16,12,7,13,31,18,16,1,15,8,43,9,0,23,FRA
bc7b4580,4,2,1,2,1,4,6,2,2,0,2,3,7,11,0,23,FRA
bc7cc472,11,9,3,7,1,2,12,10,8,2,6,10,21,2,0,23,FRA
be98f358,5,4,2,1,2,2,3,1,3,0,3,4,9,2,0,23,FRA
beae3a73,40,23,14,20,6,19,52,33,29,2,27,7,47,5,0,23,FRA
bf4c41f9,15,8,3,6,6,5,20,15,15,2,13,2,17,9,0,23,FRA
bfb2056e,9,4,7,1,1,6,9,3,6,3,3,4,13,12,0,23,FRA
c03b7266,3,2,2,0,1,2,4,2,0,0,0,1,4,3,0,23,FRA
c066d1a5,33,19,10,18,5,21,32,11,11,1,10,12,45,21,1,23,FRA
c0c7ff58,62,28,25,30,7,43,79,36,24,1,23,18,80,23,1,23,FRA
c25a7a2a,0,0,0,0,0,0,0,0,3,0,3,0,0,0,0,23,FRA
c2a6033c,33,23,13,9,11,14,45,31,18,1,17,22,55,23,0,23,FRA
c3725db2,51,29,34,12,5,21,35,14,34,19,15,39,90,124,0,23,FRA
c385bf49,47,27,27,13,7,20,38,18,23,7,16,10,57,16,0,23,FRA
c4065f40,10,5,6,4,0,4,9,5,9,4,5,8,18,35,1,23,FRA
c4173f1a,0,0,0,0,0,0,0,0,0,0,0,0,0,4,3,23,FRA
c43a8336,3,2,2,0,1,0,4,4,1,0,1,5,8,9,0,23,FRA
c5908bc4,3,2,1,2,0,0,3,3,2,0,2,1,4,1,0,23,FRA
c5adc293,3,3,1,1,1,3,5,2,4,2,2,4,7,12,1,23,FRA
c5e6c017,1,1,0,0,1,0,3,3,1,0,1,0,1,2,0,23,FRA
c631f952,1,0,1,0,0,0,0,0,0,0,0,0,1,8,1,23,FRA
c678ddd7,10,7,3,5,2,5,9,4,6,3,3,6,16,11,0,23,FRA
c6e5d20f,48,27,24,21,3,30,40,10,28,8,20,47,95,51,4,23,FRA
c76b7567,43,26,16,17,10,21,75,54,43,2,41,7,50,19,0,23,FRA
c7eebddf,4,4,2,2,0,1,5,4,2,0,2,1,5,4,0,23,FRA
c801616a,32,17,14,15,3,18,47,29,22,3,19,24,56,22,1,23,FRA
c8c02ac7,12,7,5,7,0,4,21,17,14,6,8,22,34,12,0,23,FRA
c90f380c,4,2,4,0,0,0,0,0,4,0,4,1,5,0,0,23,FRA
c9151d66,44,22,22,17,5,22,42,20,16,1,15,25,69,9,0,23,FRA
c92c24f0,40,24,31,8,1,20,28,8,33,18,15,34,74,70,0,23,FRA
c9f2f83a,12,9,9,3,0,4,9,5,6,5,1,5,17,24,1,23,FRA
c9f49454,3,3,0,1,2,2,4,2,2,0,2,1,4,1,0,23,FRA
ca6f4846,1,1,1,0,0,0,0,0,0,0,0,0,1,0,0,23,FRA
caa7aaea,89,54,37,45,7,54,106,52,50,12,38,25,114,46,0,23,FRA
cad3fd4d,8,1,5,3,0,2,15,13,3,0,3,2,10,0,0,23,FRA
caef7840,51,30,18,17,16,27,64,37,35,5,30,24,75,12,0,23,FRA
cd9b37a3,1,1,1,0,0,0,0,0,0,0,0,1,2,0,0,23,FRA
ce50fd99,24,17,6,11,7,10,27,17,20,2,18,8,32,13,0,23,FRA
cea59f02,52,31,35,14,3,31,51,20,28,14,14,52,104,50,2,23,FRA
cf182add,41,18,16,16,9,17,32,15,25,5,20,21,62,39,0,23,FRA
cf1ef7ec,11,6,7,2,2,4,7,3,8,8,0,11,22,23,0,23,FRA
cfa49cc1,25,17,14,8,3,12,22,10,13,6,7,6,31,25,0,23,FRA
d14229f3,39,20,17,16,6,16,45,29,35,0,35,7,46,7,0,23,FRA
d21e361a,21,12,7,12,2,11,22,11,16,0,16,8,29,7,0,23,FRA
d33c706e,7,4,2,3,2,3,8,5,3,0,3,1,8,9,0,23,FRA
d4d35152,43,27,18,23,2,23,63,40,21,1,20,25,68,12,0,23,FRA
d504b3e1,11,7,3,6,2,6,11,5,6,0,6,8,19,1,0,23,FRA
d5326924,9,6,1,4,4,1,4,3,2,0,2,0,9,4,0,23,FRA
d56b9520,42,26,23,11,8,21,43,22,22,5,17,28,70,23,1,23,FRA
d5d22a58,19,11,7,10,2,12,22,10,11,2,9,10,29,20,0,23,FRA
d5f2f82b,33,25,18,12,3,18,26,8,43,27,16,23,56,83,2,23,FRA
d60cf08d,19,11,9,7,3,12,22,10,11,1,10,15,34,30,0,23,FRA
d70ce98e,26,18,1,13,12,11,27,16,11,0,11,2,28,0,0,23,FRA
d7547531,0,0,0,0,0,0,0,0,0,0,0,1,1,0,0,23,FRA
d75f3980,8,5,4,4,0,7,12,5,6,2,4,7,15,5,0,23,FRA
d8c19a60,3,3,3,0,0,2,3,1,0,0,0,5,8,6,0,23,FRA
d9764034,46,26,26,20,0,17,33,16,39,27,12,38,84,87,0,23,FRA
db3164e1,2,2,2,0,0,2,4,2,0,0,0,2,4,17,0,23,FRA
db7849ca,41,29,20,8,13,19,34,15,22,2,20,21,62,18,0,23,FRA
db87a2c4,0,0,0,0,0,0,1,1,0,0,0,1,1,0,0,23,FRA
dbd3a428,40,20,14,15,11,13,53,40,29,1,28,8,48,4,1,23,FRA
dc29b608,0,0,0,0,0,0,0,0,0,0,0,2,2,6,3,23,FRA
dd211559,64,34,43,14,7,30,48,18,32,3,29,28,92,79,2,23,FRA
de488e56,8,5,5,2,1,5,7,2,9,2,7,10,18,12,0,23,FRA
df8d6029,29,19,17,8,4,17,30,13,26,14,12,30,59,114,3,23,FRA
dfc5d4fa,4,1,2,2,0,2,4,2,3,0,3,1,5,1,0,23,FRA
dff0c299,3,0,2,0,1,3,4,1,2,0,2,2,5,4,0,23,FRA
dff153a4,1,1,1,0,0,1,1,0,2,1,1,1,2,0,0,23,FRA
e05082d1,22,11,7,12,3,7,13,6,6,0,6,15,37,6,1,23,FRA
e0f3a1f6,43,26,29,12,2,22,36,14,35,22,13,58,101,90,0,23,FRA
e110ea4b,3,2,2,1,0,1,1,0,2,0,2,2,5,0,0,23,FRA
e3844ecb,32,20,12,17,3,8,45,37,17,0,17,18,50,11,0,23,FRA
e3e32fbb,18,11,12,2,4,12,21,9,7,0,7,5,23,17,0,23,FRA
e4114f5d,0,0,0,0,0,0,1,1,0,0,0,1,1,0,0,23,FRA
e42d61c7,54,34,19,20,15,31,59,28,34,2,32,16,70,19,0,23,FRA
e4448c8c,1,0,0,0,1,1,1,0,0,0,0,0,1,0,0,23,FRA
e472a6f6,70,30,34,28,8,37,53,16,38,6,32,21,91,29,2,23,FRA
e546b2e3,28,19,10,14,4,10,32,22,27,3,24,14,42,12,0,23,FRA
e54a9890,52,32,26,20,6,18,41,23,31,3,28,20,72,23,0,23,FRA
e5c1e0ca,42,27,31,10,1,18,33,15,56,29,27,26,68,166,1,23,FRA
e6eadfb8,28,19,24,4,0,18,25,7,9,2,7,12,40,32,1,23,FRA
e76cb9cc,43,26,24,17,2,22,31,9,25,12,13,42,85,89,0,23,FRA
e76f6fbe,1,1,0,1,0,0,0,0,0,0,0,1,2,0,0,23,FRA
e7986081,8,4,3,3,2,4,7,3,5,0,5,2,10,6,0,23,FRA
e7d59f4f,6,4,0,3,3,3,8,5,4,1,3,4,10,6,0,23,FRA
ea0ff634,13,11,3,5,5,4,12,8,8,0,8,6,19,12,0,23,FRA
eb0db257,6,3,2,3,1,4,9,5,5,0,5,2,8,3,0,23,FRA
eba1e557,27,15,10,15,2,7,16,9,12,3,9,14,41,7,0,23,FRA
ed39121c,31,20,19,12,0,12,31,19,19,4,15,23,54,15,0,23,FRA
ed45c4a5,93,59,33,47,13,41,77,36,50,11,39,54,147,38,1,23,FRA
ed8cecc9,0,0,0,0,0,0,0,0,0,0,0,0,0,0,0,23,FRA
ed90babd,20,11,4,10,6,8,13,5,16,0,16,7,27,5,0,23,FRA
edbe46dc,0,0,0,0,0,0,0,0,0,0,0,0,0,0,1,23,FRA
ee45fd85,84,48,36,34,14,44,75,31,36,9,27,48,132,36,1,23,FRA
eeba07f8,4,1,1,2,1,1,4,3,1,0,1,3,7,6,0,23,FRA
eedea60b,2,0,2,0,0,1,3,2,0,0,0,1,3,13,5,23,FRA
ef619b0b,47,25,18,19,10,16,39,23,25,4,21,17,64,18,1,23,FRA
ef8ae23b,23,13,13,10,0,8,28,20,19,3,16,19,42,21,0,23,FRA
ef9c1c95,128,74,51,60,17,65,121,56,50,8,42,47,175,60,0,23,FRA
f00de885,1,0,1,0,0,1,4,3,0,0,0,3,4,10,0,23,FRA
f066022d,22,16,18,3,1,16,22,6,33,27,6,18,40,108,2,23,FRA
f0661424,91,53,36,41,14,50,78,28,45,11,34,57,148,47,0,23,FRA
f19f32b1,0,0,0,0,0,0,0,0,0,0,0,0,0,2,2,23,FRA
f20e4cc9,45,30,29,12,4,30,41,11,19,3,16,17,62,18,0,23,FRA
f28474a4,9,4,3,2,4,6,13,7,3,1,2,5,14,8,0,23,FRA
f29131b5,0,0,0,0,0,0,0,0,0,0,0,0,0,0,0,23,FRA
f323d995,46,28,29,14,3,28,51,23,35,18,17,43,89,114,1,23,FRA
f3600c02,10,3,6,3,1,7,16,9,11,2,9,6,16,8,0,23,FRA
f41a69e6,0,0,0,0,0,0,4,4,0,0,0,2,2,13,5,23,FRA
f4bc42b1,19,10,9,8,2,8,17,9,13,0,13,7,26,5,1,23,FRA
f5044e54,97,55,55,37,5,57,123,66,48,13,35,52,149,46,1,23,FRA
f527a32c,30,15,15,4,11,13,35,22,13,0,13,7,37,5,0,23,FRA
f5c8b425,0,0,0,0,0,0,0,0,2,0,2,0,0,1,0,23,FRA
f5dfc256,0,0,0,0,0,0,1,1,0,0,0,0,0,0,1,23,FRA
f6496133,6,2,1,4,1,3,4,1,3,1,2,4,10,2,0,23,FRA
f6857b4f,0,0,0,0,0,0,0,0,1,0,1,0,0,0,0,23,FRA
f7691f63,46,29,20,18,8,34,57,23,28,4,24,16,62,24,0,23,FRA
f81ef10d,87,54,27,38,22,43,109,66,45,3,42,39,126,27,0,23,FRA
f833a830,15,8,5,7,3,7,35,28,14,0,14,6,21,4,0,23,FRA
f8ce97ca,5,5,3,1,1,2,4,2,2,0,2,4,9,2,0,23,FRA
f9d5908e,67,32,31,30,6,35,53,18,34,5,29,36,103,16,0,23,FRA
faf00ab8,30,14,12,16,2,12,21,9,8,1,7,9,39,4,0,23,FRA
fb0ee44e,32,19,5,20,7,10,36,26,22,0,22,13,45,20,0,23,FRA
fb14aa28,46,21,14,21,11,13,28,15,30,3,27,10,56,13,0,23,FRA
fb3236a7,38,23,21,16,1,23,33,10,43,12,31,39,77,70,0,23,FRA
fb4c5b6e,3,2,2,1,0,1,1,0,0,0,0,0,3,1,0,23,FRA
fb55f63a,1,0,1,0,0,0,0,0,1,1,0,0,1,1,0,23,FRA
fc46aab1,34,23,16,13,5,8,29,21,21,1,20,21,55,5,1,23,FRA
fc4cf6a7,65,38,33,24,8,31,48,17,38,11,27,32,97,53,0,23,FRA
fcc84a07,53,38,24,26,3,31,57,26,25,2,23,14,67,8,0,23,FRA
fd2bc67d,70,40,45,21,4,36,59,23,52,31,21,47,117,125,2,23,FRA
fd78b105,0,0,0,0,0,0,1,1,1,0,1,0,0,3,0,23,FRA
fdbde523,22,13,4,15,3,7,19,12,8,0,8,4,26,19,0,23,FRA
feb5d3ab,21,11,14,7,0,10,27,17,13,5,8,10,31,16,0,23,FRA
fed17f5a,20,12,6,10,4,10,19,9,12,4,8,4,24,6,0,23,FRA
ff4d0258,1,1,1,0,0,1,1,0,1,1,0,1,2,2,0,23,FRA
ff4df82e,11,6,4,4,3,5,13,8,5,1,4,2,13,5,0,23,FRA
ffec9769,5,3,2,2,1,0,3,3,2,0,2,1,6,11,0,23,FRA
fffea3e5,25,16,6,13,6,12,24,12,10,0,10,5,30,2,0,23,FRA
00242b75,50,31,13,30,7,21,38,17,34,13,21,31,81,41,0,24,GER
009a4f60,33,18,21,9,3,21,36,15,27,7,20,9,42,30,3,24,GER
00c9a283,30,16,16,10,4,14,26,12,28,6,22,27,57,26,1,24,GER
00e36323,4,4,3,0,1,2,3,1,2,0,2,2,6,1,0,24,GER
00f518d8,9,3,3,5,1,4,13,9,16,2,14,8,17,12,1,24,GER
0118c54c,45,17,24,21,0,21,35,14,31,6,25,26,71,39,0,24,GER
017018d1,41,24,18,18,5,19,36,17,21,12,9,22,63,27,0,24,GER
0174ba21,9,5,5,4,0,1,11,10,11,0,11,12,21,19,0,24,GER
01834aa0,18,6,13,5,0,10,15,5,15,9,6,12,30,50,0,24,GER
042e8a49,11,6,5,3,3,8,16,8,14,1,13,2,13,5,0,24,GER
048a1cbc,18,15,6,8,4,9,15,6,5,0,5,14,32,5,1,24,GER
049751d7,14,8,1,10,3,5,10,5,14,1,13,9,23,11,0,24,GER
054849d2,27,15,16,8,3,13,29,16,33,6,27,14,41,40,0,24,GER
056a8552,1,0,1,0,0,0,0,0,0,0,0,0,1,0,0,24,GER
056d2d95,18,13,8,9,1,10,27,17,12,3,9,11,29,42,0,24,GER
05d548d8,38,25,21,11,6,22,40,18,27,7,20,32,70,65,0,24,GER
05f99a4a,7,4,2,4,1,2,7,5,9,2,7,3,10,2,0,24,GER
061e8e23,8,5,4,4,0,1,6,5,6,0,6,1,9,2,0,24,GER
07c7eb0c,53,29,12,35,6,19,42,23,31,8,23,22,75,43,0,24,GER
07d3bfec,7,4,5,1,1,1,8,7,2,0,2,1,8,2,0,24,GER
08391d76,6,3,2,4,0,4,4,0,1,0,1,2,8,2,0,24,GER
08593525,0,0,0,0,0,0,0,0,0,0,0,1,1,0,0,24,GER
0911b4fc,9,4,6,3,0,5,9,4,4,3,1,3,12,6,0,24,GER
091c86e2,14,10,4,6,4,9,15,6,13,1,12,8,22,13,0,24,GER
0a084b35,16,10,8,7,1,8,16,8,10,3,7,10,26,21,1,24,GER
0a1cb833,0,0,0,0,0,0,0,0,0,0,0,0,0,2,0,24,GER
0a3f6cde,19,11,9,5,5,11,21,10,12,2,10,2,21,10,1,24,GER
0a89e877,52,30,25,19,8,22,44,22,37,2,35,29,81,24,0,24,GER
0c7a48f8,21,13,8,11,2,8,10,2,10,3,7,13,34,31,0,24,GER
0cbe584d,1,1,0,0,1,0,0,0,0,0,0,0,1,1,0,24,GER
0cbf4c54,20,12,10,7,3,11,18,7,13,4,9,13,33,18,0,24,GER
0cc5f4a5,1,1,0,0,1,0,0,0,1,0,1,0,1,0,0,24,GER
0cf778df,24,17,5,12,7,15,35,20,23,0,23,6,30,4,0,24,GER
0d55d942,0,0,0,0,0,0,0,0,0,0,0,0,0,2,0,24,GER
0e0102eb,19,10,6,8,5,6,13,7,8,0,8,8,27,7,0,24,GER
0e6bc38c,11,9,4,5,2,3,5,2,1,0,1,4,15,4,0,24,GER
0ed60738,49,30,23,22,4,21,52,31,31,4,27,31,80,40,0,24,GER
0ee6ea6a,1,0,0,0,1,0,0,0,0,0,0,0,1,0,0,24,GER
0f59a7bf,65,37,37,21,7,30,58,28,36,10,26,64,129,59,1,24,GER
0fbecd11,39,24,22,14,3,19,34,15,23,5,18,36,75,41,0,24,GER
1025db8e,29,20,10,17,2,14,21,7,34,18,16,27,56,82,0,24,GER
10745192,9,5,4,4,1,2,13,11,8,2,6,4,13,7,0,24,GER
10876d02,24,18,8,12,4,10,24,14,20,2,18,26,50,14,0,24,GER
10e7f486,14,6,7,5,2,10,14,4,16,5,11,5,19,23,1,24,GER
11407d95,16,12,5,9,2,8,17,9,25,4,21,10,26,19,0,24,GER
116c35df,8,6,4,1,3,2,6,4,11,4,7,2,10,7,0,24,GER
1238a3f9,4,2,1,3,0,0,2,2,5,3,2,0,4,19,0,24,GER
12c35abe,2,1,1,0,1,2,7,5,5,1,4,0,2,1,0,24,GER
13203c45,15,8,6,6,3,7,11,4,13,4,9,5,20,25,0,24,GER
13210854,28,15,21,4,3,18,35,17,24,8,16,13,41,44,1,24,GER
13d23b29,3,1,3,0,0,3,3,0,1,0,1,0,3,4,0,24,GER
13ddc856,15,4,2,8,5,6,18,12,13,2,11,3,18,11,0,24,GER
13fe7b69,11,6,3,3,5,3,9,6,17,1,16,1,12,10,0,24,GER
144e8717,27,18,22,2,3,17,28,11,26,16,10,13,40,66,1,24,GER
14a7af33,14,9,7,7,0,7,19,12,11,3,8,12,26,16,1,24,GER
14b09c41,9,5,6,2,1,4,6,2,9,1,8,9,18,27,0,24,GER
15413fa5,19,11,11,7,1,9,14,5,23,2,21,15,34,15,1,24,GER
15f24fe7,2,2,0,2,0,0,0,0,2,2,0,2,4,6,0,24,GER
17370b95,79,47,46,29,4,33,52,19,54,23,31,44,123,102,1,24,GER
178018f9,19,14,16,3,0,17,34,17,6,1,5,13,32,20,0,24,GER
19a967ab,37,21,16,14,7,14,27,13,35,3,32,11,48,12,0,24,GER
1a4b9094,2,0,1,1,0,2,2,0,3,0,3,0,2,1,0,24,GER
1ae836b1,30,19,14,13,3,18,36,18,32,7,25,20,50,20,0,24,GER
1b4be8eb,35,20,20,10,5,15,30,15,28,17,11,24,59,51,0,24,GER
1c59240b,3,3,0,1,2,0,1,1,1,0,1,0,3,1,0,24,GER
1d8e9add,22,17,12,10,0,14,22,8,30,23,7,13,35,106,2,24,GER
1df0c0b9,6,5,1,3,2,1,5,4,13,5,8,7,13,15,0,24,GER
1e2057aa,3,0,0,3,0,1,7,6,4,0,4,2,5,0,0,24,GER
1e274a0a,5,3,1,1,3,2,6,4,1,0,1,0,5,4,0,24,GER
1e37c986,0,0,0,0,0,0,0,0,1,0,1,0,0,0,0,24,GER
1f2c7b55,20,12,10,8,2,8,20,12,25,3,22,8,28,21,0,24,GER
1f3afdcb,23,17,9,10,4,9,15,6,21,2,19,24,47,29,0,24,GER
1fc08838,2,0,2,0,0,1,2,1,0,0,0,0,2,0,0,24,GER
1fc4f3d1,0,0,0,0,0,0,0,0,0,0,0,0,0,0,0,24,GER
1fffae99,50,22,20,22,8,17,41,24,42,23,19,22,72,54,0,24,GER
20030c06,11,6,4,6,1,5,10,5,15,8,7,8,19,49,0,24,GER
202b3b68,11,4,11,0,0,2,5,3,3,0,3,2,13,3,0,24,GER
204dded0,11,10,8,3,0,6,17,11,20,11,9,19,30,57,1,24,GER
2077ae86,11,9,4,4,3,6,15,9,11,3,8,3,14,19,0,24,GER
2180c761,0,0,0,0,0,0,0,0,0,0,0,0,0,2,0,24,GER
21a66f6a,11,7,3,4,4,5,15,10,8,2,6,5,16,14,0,24,GER
220ace7e,27,15,5,17,5,11,34,23,30,3,27,9,36,12,2,24,GER
2244908c,14,9,8,5,1,4,9,5,4,2,2,4,18,4,0,24,GER
226ddf9d,1,0,1,0,0,1,2,1,0,0,0,0,1,10,5,24,GER
22798128,19,12,4,11,4,3,9,6,22,2,20,11,30,13,1,24,GER
22919e97,9,6,2,4,3,4,8,4,10,1,9,5,14,4,0,24,GER
231c67ff,1,0,1,0,0,1,2,1,1,0,1,1,2,0,0,24,GER
236f02cd,36,25,17,16,3,20,34,14,25,9,16,17,53,70,2,24,GER
253bd2b3,0,0,0,0,0,0,0,0,0,0,0,0,0,1,0,24,GER
258a6f4d,14,9,4,8,2,5,21,16,24,7,17,10,24,45,0,24,GER
25ab9c9c,30,21,18,11,1,13,16,3,19,11,8,22,52,60,0,24,GER
2658c82f,21,14,8,12,1,13,24,11,9,0,9,10,31,7,0,24,GER
277c49ed,38,22,23,14,1,23,32,9,28,12,16,22,60,100,0,24,GER
285c7011,0,0,0,0,0,0,0,0,0,0,0,0,0,0,0,24,GER
28c6e925,20,12,12,7,1,6,12,6,9,1,8,5,25,8,0,24,GER
2903a856,19,13,6,8,5,9,21,12,15,0,15,7,26,5,0,24,GER
2979c05a,7,4,2,4,1,6,9,3,4,0,4,2,9,3,1,24,GER
298c8aa1,4,3,0,2,2,1,2,1,5,1,4,0,4,8,0,24,GER
29aee77c,0,0,0,0,0,0,1,1,2,1,1,0,0,4,0,24,GER
29f7cfd9,0,0,0,0,0,0,0,0,1,0,1,0,0,0,0,24,GER
2a158218,14,9,4,6,4,6,17,11,22,0,22,1,15,3,0,24,GER
2a29eb9b,40,18,28,10,2,23,33,10,27,10,17,26,66,44,1,24,GER
2b114be3,15,8,6,6,3,4,19,15,12,0,12,7,22,3,0,24,GER
2bab583c,12,5,9,2,1,9,17,8,25,15,10,10,22,61,1,24,GER
2be28a0c,10,5,6,3,1,4,6,2,9,6,3,7,17,30,0,24,GER
2c0558b8,38,24,8,21,9,14,35,21,23,1,22,15,53,5,0,24,GER
2c08cab0,5,3,2,2,1,1,1,0,2,0,2,0,5,0,0,24,GER
2d5f03bf,29,19,23,6,0,17,31,14,17,12,5,18,47,51,1,24,GER
2d61d13a,39,29,26,11,2,15,26,11,33,14,19,35,74,84,1,24,GER
2d970560,50,35,21,24,5,25,38,13,39,8,31,30,80,58,0,24,GER
2e77d607,8,4,6,2,0,4,5,1,1,0,1,4,12,18,0,24,GER
2f7fec15,4,1,3,1,0,2,4,2,3,1,2,1,5,0,0,24,GER
2ff76adc,26,12,10,14,2,14,26,12,24,3,21,15,41,35,0,24,GER
302527b2,20,13,14,5,1,13,23,10,18,11,7,14,34,51,0,24,GER
30ae134d,14,10,3,7,4,1,5,4,15,2,13,9,23,25,0,24,GER
30c220c3,55,34,25,24,6,29,48,19,33,5,28,10,65,32,0,24,GER
313254a3,40,18,28,6,6,26,41,15,33,15,18,18,58,60,0,24,GER
319fa018,2,2,1,1,0,2,3,1,0,0,0,0,2,0,0,24,GER
324ff0da,1,0,1,0,0,0,0,0,2,1,1,0,1,0,0,24,GER
3260690c,10,4,2,7,1,1,8,7,20,1,19,3,13,17,0,24,GER
3397e7b5,17,10,7,9,1,5,10,5,16,3,13,5,22,31,0,24,GER
33b38f49,3,3,2,0,1,1,1,0,0,0,0,0,3,0,0,24,GER
346d51d9,55,34,22,29,4,33,50,17,38,11,27,34,89,51,1,24,GER
3489184e,42,21,26,9,7,28,52,24,20,4,16,21,63,18,0,24,GER
34b0387f,24,14,9,11,4,12,32,20,19,1,18,22,46,18,0,24,GER
34b54da7,1,1,1,0,0,1,1,0,2,2,0,1,2,3,0,24,GER
34e12499,52,38,29,20,3,29,45,16,40,19,21,31,83,87,3,24,GER
357103bd,20,12,5,9,6,4,10,6,33,1,32,4,24,12,0,24,GER
35d64857,54,30,34,15,5,36,54,18,24,9,15,31,85,88,0,24,GER
36578017,0,0,0,0,0,0,0,0,0,0,0,0,0,0,0,24,GER
36a3ff67,29,21,14,13,2,8,18,10,14,2,12,5,34,15,0,24,GER
36a59ba4,15,12,7,8,0,8,25,17,8,6,2,14,29,8,0,24,GER
36cf2caf,25,13,16,9,0,15,26,11,26,10,16,15,40,63,4,24,GER
3745e8bd,1,0,1,0,0,0,1,1,5,1,4,0,1,4,0,24,GER
378825c7,34,21,21,11,2,24,34,10,22,7,15,16,50,37,0,24,GER
37dc1a48,1,1,1,0,0,0,0,0,0,0,0,0,1,0,0,24,GER
37f606f0,1,0,1,0,0,0,0,0,1,1,0,0,1,0,0,24,GER
395bbb60,1,1,0,1,0,0,3,3,2,0,2,1,2,6,0,24,GER
3b1ed320,44,27,12,27,5,19,33,14,36,10,26,27,71,21,2,24,GER
3bb625ac,21,14,13,7,1,14,22,8,11,5,6,21,42,45,0,24,GER
3c151571,0,0,0,0,0,0,0,0,0,0,0,0,0,0,0,24,GER
3c6089ab,19,11,1,8,10,11,26,15,19,0,19,1,20,4,0,24,GER
3dbdbb6a,8,5,5,2,1,5,13,8,11,2,9,7,15,15,0,24,GER
3eeb80e0,23,11,9,8,6,14,28,14,30,1,29,12,35,21,0,24,GER
431c837b,34,18,17,17,0,12,21,9,23,13,10,15,49,40,2,24,GER
437f2b00,23,12,8,11,4,12,30,18,16,1,15,4,27,12,0,24,GER
442b56fa,26,15,18,4,4,15,33,18,18,0,18,16,42,40,1,24,GER
44a20f0c,10,6,6,4,0,4,11,7,9,8,1,9,19,26,1,24,GER
462475ed,3,2,1,2,0,2,11,9,6,2,4,3,6,11,0,24,GER
4658e309,0,0,0,0,0,0,3,3,1,0,1,0,0,0,0,24,GER
46750e9c,0,0,0,0,0,0,0,0,1,0,1,0,0,0,0,24,GER
47064058,1,1,1,0,0,1,1,0,0,0,0,0,1,12,1,24,GER
48035304,25,12,16,8,1,15,18,3,26,18,8,35,60,110,1,24,GER
48780156,4,2,4,0,0,2,2,0,1,1,0,1,5,6,0,24,GER
489d4867,1,1,1,0,0,1,2,1,0,0,0,0,1,1,0,24,GER
49296448,28,21,11,12,5,15,27,12,23,3,20,13,41,18,1,24,GER
493924a7,44,34,21,16,7,18,29,11,26,9,17,22,66,40,0,24,GER
496aeede,10,5,5,5,0,2,14,12,7,1,6,4,14,6,0,24,GER
49fe9070,2,1,0,1,1,0,0,0,1,0,1,1,3,0,0,24,GER
4aea5077,11,7,6,5,0,7,12,5,6,3,3,4,15,19,0,24,GER
4b803b3c,55,29,35,19,1,23,40,17,44,25,19,34,89,101,0,24,GER
4ccd8957,27,15,14,10,3,17,40,23,30,2,28,9,36,20,0,24,GER
4cd41883,2,2,1,1,0,1,1,0,2,0,2,0,2,0,0,24,GER
4f16405e,8,3,1,7,0,3,6,3,15,4,11,1,9,25,0,24,GER
4f96ed39,0,0,0,0,0,0,0,0,0,0,0,0,0,0,0,24,GER
501055d8,11,10,5,4,2,6,16,10,7,0,7,3,14,3,0,24,GER
50871bcc,0,0,0,0,0,0,0,0,0,0,0,0,0,0,0,24,GER
50dc94ce,8,3,3,3,2,3,6,3,5,1,4,2,10,1,0,24,GER
50ff205b,4,2,4,0,0,2,6,4,11,4,7,2,6,18,1,24,GER
51d29173,1,0,0,1,0,0,1,1,1,0,1,1,2,3,0,24,GER
526ea7cc,14,11,8,6,0,7,13,6,12,7,5,9,23,36,1,24,GER
52ec54d0,6,5,2,4,0,4,4,0,5,3,2,7,13,16,0,24,GER
54d2b378,1,0,0,0,1,0,0,0,3,2,1,0,1,1,0,24,GER
54e4866f,22,15,9,9,4,11,24,13,16,0,16,11,33,16,0,24,GER
5521f419,9,4,2,3,4,3,7,4,1,0,1,2,11,0,0,24,GER
554bcc91,19,11,6,10,3,7,22,15,19,1,18,7,26,13,0,24,GER
555d5edd,20,13,4,11,5,9,18,9,6,0,6,10,30,12,0,24,GER
57382429,56,33,23,19,14,19,41,22,38,1,37,17,73,22,0,24,GER
5762be5c,65,41,21,35,9,27,50,23,31,6,25,23,88,39,0,24,GER
57d9f511,12,8,1,9,2,5,21,16,7,0,7,1,13,3,0,24,GER
57ec75bf,11,6,4,3,4,5,7,2,14,6,8,2,13,17,0,24,GER
582a5247,36,23,16,15,5,12,25,13,17,3,14,16,52,33,0,24,GER
58468842,3,3,1,2,0,2,2,0,0,0,0,0,3,2,0,24,GER
59e4b92e,26,15,11,15,0,14,21,7,10,4,6,17,43,28,0,24,GER
5b92d896,5,5,1,3,1,1,2,1,6,0,6,0,5,2,0,24,GER
5b9512c5,10,6,5,5,0,6,8,2,30,11,19,9,19,63,1,24,GER
5bc43860,20,12,7,9,4,9,18,9,19,0,19,2,22,3,0,24,GER
5c4bf6ba,2,2,2,0,0,2,5,3,1,0,1,1,3,13,1,24,GER
5c50fdbc,37,18,20,13,4,19,32,13,24,2,22,21,58,23,0,24,GER
5c899683,15,10,7,7,1,10,17,7,6,1,5,5,20,13,0,24,GER
5d4f7d61,3,2,0,0,3,0,2,2,2,0,2,1,4,6,0,24,GER
5d8e331f,49,29,28,16,5,19,41,22,21,10,11,25,74,33,0,24,GER
5db45ee5,15,9,4,9,2,3,14,11,15,0,15,3,18,11,0,24,GER
5dbfd101,10,7,6,4,0,7,14,7,7,1,6,7,17,18,0,24,GER
5dc15574,0,0,0,0,0,0,0,0,0,0,0,0,0,0,0,24,GER
5ddb8f9f,16,7,7,7,2,7,17,10,16,4,12,16,32,22,0,24,GER
5e080f73,1,1,0,0,1,1,3,2,1,0,1,0,1,1,0,24,GER
5e66fa06,31,21,14,16,1,17,33,16,25,14,11,32,63,125,1,24,GER
5fa2e0cf,0,0,0,0,0,0,1,1,0,0,0,2,2,9,4,24,GER
5fd5e542,0,0,0,0,0,0,0,0,0,0,0,1,1,0,0,24,GER
603cb947,7,1,4,2,1,3,9,6,11,2,9,8,15,8,1,24,GER
610aa1e9,16,9,15,1,0,9,14,5,12,5,7,7,23,28,0,24,GER
61590953,21,10,12,8,1,17,29,12,13,2,11,8,29,33,0,24,GER
616c09f5,20,11,6,12,2,8,22,14,16,0,16,4,24,14,0,24,GER
6190474d,12,8,5,6,1,5,7,2,4,0,4,5,17,2,0,24,GER
62ab9184,24,16,13,9,2,7,25,18,12,2,10,6,30,21,0,24,GER
638a4d71,8,3,4,3,1,6,12,6,0,0,0,3,11,20,0,24,GER
63b9cc6d,0,0,0,0,0,0,0,0,0,0,0,0,0,2,0,24,GER
640134d6,1,1,1,0,0,1,1,0,1,0,1,0,1,0,0,24,GER
64d7f629,45,21,22,19,4,30,55,25,38,9,29,20,65,50,2,24,GER
64f69877,18,7,8,4,6,7,17,10,7,0,7,5,23,11,0,24,GER
65857fdf,22,13,12,7,3,10,27,17,21,2,19,5,27,18,0,24,GER
663e080e,1,1,1,0,0,0,0,0,0,0,0,0,1,6,3,24,GER
677da306,27,13,12,10,5,9,17,8,28,20,8,38,65,142,1,24,GER
697dc00a,12,10,3,8,1,5,25,20,10,2,8,30,42,25,1,24,GER
699fb8db,11,5,6,5,0,7,10,3,6,1,5,3,14,22,0,24,GER
6b8887c2,4,3,3,0,1,1,2,1,2,1,1,1,5,4,0,24,GER
6bd5cd5d,32,21,25,7,0,18,29,11,23,16,7,11,43,59,0,24,GER
6c8ddd52,2,0,2,0,0,1,2,1,1,0,1,1,3,2,0,24,GER
6ce43701,4,1,2,2,0,3,5,2,4,1,3,2,6,1,0,24,GER
6e269dd3,4,3,1,3,0,3,6,3,9,0,9,1,5,3,0,24,GER
6ec6fde0,27,14,18,8,1,20,27,7,19,7,12,15,42,27,0,24,GER
6ecbddf6,18,7,5,8,5,7,19,12,15,4,11,6,24,14,0,24,GER
70d4c949,1,0,0,1,0,0,1,1,1,0,1,1,2,1,0,24,GER
70dcf94d,35,23,16,13,6,21,43,22,20,3,17,11,46,16,0,24,GER
71ec39ef,23,14,10,12,1,12,24,12,21,6,15,20,43,23,0,24,GER
74f2e748,20,12,9,6,5,6,17,11,23,0,23,7,27,15,0,24,GER
75402e99,38,24,12,21,5,23,54,31,27,6,21,23,61,78,0,24,GER
75645f0e,1,0,0,1,0,0,1,1,2,0,2,1,2,1,0,24,GER
76abb354,1,0,1,0,0,1,1,0,1,0,1,0,1,4,0,24,GER
76fa965f,9,5,3,4,2,2,6,4,3,0,3,7,16,2,0,24,GER
77cfae67,19,11,13,5,1,12,20,8,8,2,6,11,30,24,0,24,GER
796a5f30,19,9,14,4,1,10,19,9,21,11,10,12,31,32,1,24,GER
79c90e45,25,16,8,13,4,15,30,15,17,5,12,14,39,53,0,24,GER
79f7302a,1,0,0,1,0,0,0,0,0,0,0,0,1,0,0,24,GER
7bbb0ac4,38,23,20,12,6,17,24,7,31,6,25,11,49,34,0,24,GER
7bf9400b,35,22,18,14,3,13,22,9,54,26,28,35,70,124,2,24,GER
7c24eaf8,1,1,0,1,0,1,1,0,0,0,0,0,1,0,0,24,GER
7c254c75,0,0,0,0,0,0,0,0,0,0,0,1,1,0,0,24,GER
7ca196eb,21,14,5,12,4,10,15,5,5,0,5,1,22,14,0,24,GER
7d31f1cb,2,2,2,0,0,2,4,2,1,0,1,1,3,2,0,24,GER
7d3e7da6,1,0,1,0,0,1,1,0,0,0,0,0,1,3,2,24,GER
7d450ed3,51,29,20,26,5,31,50,19,46,7,39,23,74,68,2,24,GER
7e12a98d,6,3,5,1,0,3,6,3,2,0,2,4,10,13,0,24,GER
7ebd0896,48,26,31,17,0,29,53,24,28,6,22,19,67,32,0,24,GER
7ed08d5c,31,16,17,11,3,17,27,10,14,3,11,6,37,22,0,24,GER
7f73bdf4,29,21,11,18,0,11,28,17,14,9,5,15,44,23,0,24,GER
7fa4e703,9,6,3,4,2,2,5,3,5,1,4,2,11,5,0,24,GER
7fe12375,0,0,0,0,0,0,0,0,0,0,0,0,0,1,0,24,GER
80f252f6,0,0,0,0,0,0,0,0,1,0,1,0,0,0,0,24,GER
822b83e8,0,0,0,0,0,0,0,0,0,0,0,0,0,0,0,24,GER
826e8b63,25,16,6,17,2,18,25,7,16,1,15,7,32,17,1,24,GER
829aa60c,6,1,1,2,3,2,3,1,10,0,10,3,9,4,0,24,GER
82bfc14d,20,11,9,9,2,11,22,11,17,5,12,10,30,30,1,24,GER
82e12fe7,5,1,1,2,2,1,2,1,1,0,1,0,5,1,0,24,GER
83e1f40e,10,6,1,6,3,4,10,6,4,1,3,2,12,16,0,24,GER
8575037f,4,1,2,1,1,1,3,2,1,0,1,4,8,5,0,24,GER
857a5abe,8,8,7,1,0,4,8,4,7,5,2,6,14,30,0,24,GER
8593f88c,13,8,6,7,0,3,7,4,7,3,4,2,15,11,0,24,GER
85b6462d,3,2,0,2,1,0,1,1,7,2,5,0,3,5,0,24,GER
8652a85c,3,3,0,1,2,0,3,3,13,1,12,5,8,8,0,24,GER
86574238,33,19,12,16,5,13,19,6,21,1,20,11,44,14,1,24,GER
86adbcc7,0,0,0,0,0,0,0,0,0,0,0,2,2,2,0,24,GER
86c75897,11,8,4,6,1,4,10,6,30,20,10,25,36,103,0,24,GER
86e119e0,35,25,10,17,8,19,40,21,14,3,11,24,59,43,0,24,GER
87436846,1,0,1,0,0,1,1,0,0,0,0,0,1,10,1,24,GER
8778c910,1,1,1,0,0,0,0,0,0,0,0,0,1,10,2,24,GER
8779ddf8,0,0,0,0,0,0,0,0,1,0,1,0,0,0,0,24,GER
877bc844,8,3,2,5,1,4,6,2,5,0,5,2,10,13,0,24,GER
88d4144a,68,40,37,27,4,41,64,23,30,5,25,41,109,47,0,24,GER
88e357ef,8,5,0,5,3,2,11,9,3,0,3,2,10,2,0,24,GER
8a958856,2,2,1,0,1,2,2,0,0,0,0,0,2,1,0,24,GER
8b84b707,16,11,11,3,2,15,21,6,7,1,6,13,29,25,0,24,GER
8e235926,10,8,4,4,2,1,11,10,15,4,11,9,19,19,0,24,GER
8eb55dbb,3,3,0,2,1,0,2,2,2,0,2,0,3,2,0,24,GER
8eb5c94c,0,0,0,0,0,0,0,0,0,0,0,1,1,3,0,24,GER
8f056768,70,41,31,33,6,18,46,28,36,7,29,19,89,22,0,24,GER
8f325097,8,6,4,4,0,2,7,5,3,0,3,4,12,6,0,24,GER
923f4dda,4,2,0,4,0,1,3,2,7,1,6,4,8,20,0,24,GER
92432bc6,29,18,17,10,2,14,27,13,15,1,14,15,44,18,0,24,GER
924f9191,28,17,10,12,6,12,29,17,20,5,15,16,44,29,0,24,GER
92a16062,61,37,27,30,4,33,58,25,51,17,34,31,92,69,0,24,GER
92d83c27,35,16,8,17,10,12,36,24,25,5,20,20,55,26,0,24,GER
932bfcac,38,20,21,15,2,19,32,13,25,6,19,20,58,36,0,24,GER
93a50d2c,0,0,0,0,0,0,0,0,0,0,0,0,0,0,0,24,GER
93a8c4f9,6,3,2,2,2,3,8,5,7,0,7,2,8,2,0,24,GER
94302c52,53,37,38,12,3,37,60,23,43,24,19,50,103,125,1,24,GER
94c18565,24,17,7,11,6,16,32,16,17,6,11,11,35,18,0,24,GER
95bb6ddc,38,24,13,15,10,16,35,19,25,7,18,6,44,34,0,24,GER
962e54cb,8,4,2,2,4,3,6,3,5,0,5,0,8,7,0,24,GER
9662c9ec,30,21,12,17,1,12,29,17,26,8,18,19,49,27,0,24,GER
966e28d0,3,1,0,2,1,1,3,2,8,0,8,0,3,1,0,24,GER
96cfb5e2,1,0,0,0,1,0,0,0,0,0,0,0,1,0,0,24,GER
97d545ae,23,15,13,9,1,12,19,7,22,14,8,17,40,43,0,24,GER
99219195,0,0,0,0,0,0,0,0,0,0,0,0,0,0,0,24,GER
99f7e9aa,16,8,6,8,2,10,29,19,18,7,11,13,29,25,0,24,GER
9a2e0ccc,7,3,2,5,0,5,12,7,7,0,7,0,7,5,0,24,GER
9a2e3a23,0,0,0,0,0,0,1,1,8,1,7,1,1,3,0,24,GER
9ab16552,2,2,2,0,0,2,4,2,1,1,0,2,4,4,0,24,GER
9b545925,21,12,14,5,2,13,19,6,14,8,6,8,29,26,0,24,GER
9b5d89b3,1,0,1,0,0,1,7,6,1,0,1,1,2,1,0,24,GER
9b688ae1,2,1,2,0,0,2,2,0,0,0,0,0,2,5,2,24,GER
9efa1d25,37,25,14,16,7,21,47,26,17,2,15,7,44,9,0,24,GER
9f77012e,54,31,20,30,4,19,54,35,26,4,22,17,71,25,0,24,GER
9f941969,2,1,2,0,0,2,4,2,0,0,0,1,3,21,1,24,GER
a167537f,15,13,7,7,1,9,24,15,20,3,17,8,23,16,0,24,GER
a2a85828,9,5,2,6,1,3,6,3,7,0,7,2,11,1,0,24,GER
a396fb61,57,36,32,20,5,34,64,30,30,10,20,21,78,60,1,24,GER
a3ddb1b9,6,3,2,3,1,2,9,7,5,0,5,1,7,1,0,24,GER
a45241d5,5,1,2,2,1,3,9,6,9,1,8,2,7,6,0,24,GER
a4effc55,21,14,16,5,0,4,8,4,23,18,5,20,41,78,1,24,GER
a53b661f,18,8,9,6,3,7,15,8,10,1,9,10,28,15,0,24,GER
a5ae8f8e,24,12,13,10,1,15,26,11,21,14,7,10,34,46,0,24,GER
a65ce836,58,41,35,20,3,28,44,16,28,7,21,20,78,39,2,24,GER
a70b8345,1,1,1,0,0,0,0,0,0,0,0,1,2,19,2,24,GER
a73c8f95,21,16,9,10,2,8,13,5,15,8,7,14,35,44,3,24,GER
a8ee54ad,28,15,12,12,4,15,29,14,10,1,9,14,42,13,0,24,GER
a93b6f4e,7,2,4,3,0,5,8,3,3,2,1,4,11,7,0,24,GER
a96103b2,1,1,1,0,0,1,1,0,0,0,0,2,3,0,0,24,GER
aad48be9,25,15,12,11,2,11,15,4,14,7,7,19,44,60,1,24,GER
ab1a72b4,6,2,1,4,1,3,14,11,10,2,8,7,13,3,0,24,GER
ab5b7dc1,13,7,7,5,1,8,18,10,13,0,13,9,22,19,0,24,GER
ab700320,9,7,4,4,1,3,7,4,9,0,9,2,11,3,0,24,GER
ac861941,6,3,4,2,0,3,4,1,11,6,5,9,15,31,0,24,GER
ad00b1a8,19,10,15,4,0,12,28,16,15,4,11,6,25,22,0,24,GER
ad3389d5,0,0,0,0,0,0,1,1,1,0,1,0,0,7,2,24,GER
add37c13,6,4,1,5,0,3,3,0,3,1,2,1,7,1,0,24,GER
ae44e8e2,16,12,7,5,4,6,13,7,4,0,4,10,26,8,0,24,GER
ae7058f9,47,35,33,14,0,26,41,15,55,34,21,38,85,114,0,24,GER
ae961785,1,1,0,1,0,1,4,3,1,0,1,0,1,2,0,24,GER
ae9b998d,19,12,4,9,6,12,21,9,14,0,14,5,24,4,0,24,GER
af0d79a9,0,0,0,0,0,0,1,1,0,0,0,0,0,0,0,24,GER
afb0c500,2,2,2,0,0,2,4,2,0,0,0,0,2,11,4,24,GER
b06a7ae9,1,0,0,1,0,1,1,0,0,0,0,0,1,0,0,24,GER
b116c6e3,27,12,12,9,6,14,24,10,24,1,23,11,38,10,0,24,GER
b146275b,6,4,0,1,5,1,4,3,5,0,5,0,6,10,0,24,GER
b1f4086c,39,20,22,8,9,26,47,21,27,5,22,20,59,35,0,24,GER
b3b7f5a6,0,0,0,0,0,0,0,0,0,0,0,0,0,0,0,24,GER
b4705807,34,22,16,14,4,18,30,12,22,5,17,12,46,32,0,24,GER
b492126a,5,2,3,0,2,1,6,5,12,0,12,3,8,8,0,24,GER
b4b08774,5,4,2,3,0,0,4,4,1,0,1,4,9,2,0,24,GER
b56dd813,1,1,1,0,0,1,1,0,0,0,0,0,1,2,0,24,GER
b5e0af76,22,14,11,6,5,9,23,14,19,1,18,7,29,12,0,24,GER
b684a484,8,4,0,7,1,3,8,5,12,4,8,4,12,25,0,24,GER
b74277a0,23,12,11,8,4,9,14,5,12,1,11,19,42,20,1,24,GER
b77f44a4,16,10,13,2,1,8,11,3,22,16,6,8,24,60,0,24,GER
b825a650,19,8,8,9,2,10,21,11,17,6,11,9,28,13,1,24,GER
b8e17ca3,0,0,0,0,0,0,0,0,0,0,0,0,0,0,0,24,GER
b8e740fb,0,0,0,0,0,0,0,0,0,0,0,0,0,0,0,24,GER
b9ac6e0e,6,4,2,4,0,5,9,4,2,1,1,3,9,8,0,24,GER
ba115a40,1,0,0,1,0,1,1,0,4,1,3,0,1,7,0,24,GER
bb1cf301,6,3,2,4,0,1,13,12,12,0,12,7,13,6,0,24,GER
bbd79358,9,5,1,4,4,1,4,3,10,2,8,0,9,6,0,24,GER
bbd86530,2,2,1,1,0,2,2,0,0,0,0,1,3,3,0,24,GER
bc249af8,4,3,1,2,1,0,0,0,3,1,2,2,6,1,0,24,GER
bc67a0e1,0,0,0,0,0,0,0,0,0,0,0,0,0,0,0,24,GER
bc6bd723,12,6,4,5,3,5,13,8,7,0,7,1,13,3,0,24,GER
bcb2ccd8,0,0,0,0,0,0,0,0,0,0,0,0,0,6,1,24,GER
bd142efb,18,8,9,7,2,5,16,11,23,18,5,14,32,79,1,24,GER
be5e1c4c,1,1,1,0,0,1,4,3,2,1,1,0,1,1,0,24,GER
beb882a8,34,17,18,12,4,7,26,19,42,16,26,23,57,34,0,24,GER
bf075f6b,13,6,5,5,3,6,16,10,18,1,17,4,17,21,0,24,GER
c05f2f8c,10,6,5,3,2,5,8,3,6,0,6,7,17,11,0,24,GER
c0b3669f,0,0,0,0,0,0,0,0,0,0,0,0,0,1,0,24,GER
c1b7847c,47,29,20,17,10,19,40,21,38,6,32,17,64,13,1,24,GER
c2211709,37,20,14,18,5,17,32,15,26,2,24,34,71,40,2,24,GER
c38767ab,10,8,5,3,2,6,11,5,9,2,7,10,20,11,0,24,GER
c455a2b2,38,26,20,14,4,17,37,20,20,2,18,18,56,7,0,24,GER
c459a650,49,31,26,15,8,33,50,17,38,5,33,24,73,61,0,24,GER
c4987edc,40,28,25,10,5,21,44,23,32,17,15,42,82,122,0,24,GER
c4e87b8b,12,6,4,6,2,9,13,4,20,6,14,5,17,20,0,24,GER
c631f952,0,0,0,0,0,0,0,0,0,0,0,0,0,2,0,24,GER
c68da769,10,7,2,4,4,5,16,11,8,2,6,2,12,10,0,24,GER
c89e8aae,0,0,0,0,0,0,0,0,0,0,0,0,0,2,0,24,GER
c8b3a472,3,2,2,1,0,2,2,0,2,0,2,2,5,8,0,24,GER
c967f6b8,7,3,7,0,0,4,5,1,3,1,2,6,13,23,1,24,GER
ca618d23,26,19,13,7,6,4,19,15,18,4,14,13,39,27,0,24,GER
ca8033cb,14,9,7,6,1,4,13,9,21,10,11,11,25,58,1,24,GER
cab9634e,23,17,12,7,4,13,19,6,15,4,11,11,34,22,0,24,GER
cb11b429,11,4,5,5,1,8,13,5,12,0,12,2,13,4,0,24,GER
cb6d81b3,30,20,20,7,3,20,27,7,18,4,14,9,39,29,0,24,GER
cc86b9a3,28,15,15,8,5,15,35,20,30,5,25,25,53,34,1,24,GER
cc971106,46,26,24,19,3,23,45,22,49,17,32,29,75,28,0,24,GER
cd59b9df,0,0,0,0,0,0,1,1,0,0,0,0,0,9,0,24,GER
ce17b5eb,0,0,0,0,0,0,0,0,0,0,0,1,1,9,1,24,GER
cf007308,5,3,1,3,1,5,7,2,2,0,2,1,6,1,0,24,GER
d01bbb6f,40,21,16,14,10,17,30,13,21,3,18,6,46,22,0,24,GER
d07d0aeb,9,5,5,3,1,5,6,1,7,4,3,8,17,16,0,24,GER
d2416c2e,12,8,1,8,3,3,13,10,13,3,10,4,16,15,0,24,GER
d248cd8f,28,17,16,10,2,14,26,12,12,4,8,15,43,40,2,24,GER
d28339cb,0,0,0,0,0,0,1,1,0,0,0,0,0,2,0,24,GER
d2c580ce,10,8,6,3,1,5,7,2,5,1,4,6,16,10,1,24,GER
d5326924,2,2,0,2,0,1,1,0,4,1,3,1,3,0,0,24,GER
d646c218,1,0,1,0,0,1,3,2,0,0,0,0,1,1,0,24,GER
d6e53a3a,12,10,3,6,3,5,6,1,13,9,4,18,30,46,0,24,GER
d781d855,38,19,22,13,3,23,44,21,22,2,20,21,59,34,1,24,GER
d7a03bf3,8,7,7,1,0,5,12,7,4,1,3,3,11,13,0,24,GER
d7cdfd81,15,12,9,4,2,6,19,13,12,3,9,9,24,10,0,24,GER
d82a310a,0,0,0,0,0,0,0,0,1,1,0,0,0,0,1,24,GER
da4d670f,25,13,9,10,6,14,28,14,18,0,18,10,35,3,0,24,GER
db401046,2,1,2,0,0,2,3,1,0,0,0,0,2,16,4,24,GER
db4ed67b,4,0,0,4,0,2,4,2,3,0,3,0,4,1,0,24,GER
db7849ca,24,13,12,10,2,11,18,7,20,2,18,8,32,26,1,24,GER
dbd1b101,0,0,0,0,0,0,1,1,0,0,0,0,0,5,1,24,GER
dbf053da,3,2,0,2,1,0,0,0,8,0,8,2,5,5,0,24,GER
dc62fbee,34,16,17,14,3,11,28,17,16,1,15,8,42,6,0,24,GER
dcfb17f4,8,3,1,4,3,5,11,6,9,2,7,6,14,2,0,24,GER
dd2e62da,9,8,7,2,0,4,16,12,9,1,8,0,9,6,0,24,GER
dd549382,19,8,5,6,8,3,11,8,10,0,10,5,24,4,0,24,GER
dd676a97,6,2,3,0,3,2,8,6,7,0,7,8,14,10,0,24,GER
dd9caa07,70,39,47,21,2,30,61,31,52,21,31,42,112,122,1,24,GER
de4cac2d,4,2,3,1,0,2,8,6,8,0,8,0,4,3,0,24,GER
de838f86,33,20,19,12,2,17,29,12,32,13,19,21,54,81,0,24,GER
dee3013b,1,0,1,0,0,1,2,1,0,0,0,0,1,15,5,24,GER
df1665d7,3,1,2,1,0,0,0,0,2,0,2,0,3,0,0,24,GER
dfb6490a,2,2,1,0,1,1,1,0,1,0,1,1,3,1,0,24,GER
e0b113a7,19,11,3,10,6,7,13,6,10,3,7,15,34,14,0,24,GER
e0f8151c,25,16,13,8,4,9,20,11,24,14,10,40,65,54,1,24,GER
e110ea4b,28,18,13,13,2,11,26,15,18,0,18,4,32,17,1,24,GER
e12b0b5b,6,4,0,5,1,4,6,2,0,0,0,1,7,1,0,24,GER
e162b013,5,1,3,2,0,3,13,10,8,2,6,4,9,22,0,24,GER
e27da244,27,14,17,9,1,14,29,15,28,17,11,26,53,102,1,24,GER
e280527c,36,22,17,18,1,21,40,19,28,12,16,9,45,28,0,24,GER
e33c06cf,13,8,9,3,1,7,10,3,19,11,8,17,30,48,2,24,GER
e547d3cf,10,7,7,3,0,5,15,10,10,1,9,4,14,12,0,24,GER
e5649a78,42,26,18,19,5,22,54,32,34,4,30,16,58,14,0,24,GER
e5a35ae9,16,9,2,11,3,5,14,9,14,3,11,5,21,8,0,24,GER
e5d85da8,13,12,8,3,2,7,22,15,10,1,9,6,19,8,0,24,GER
e5f76710,30,20,17,12,1,15,26,11,21,14,7,13,43,75,0,24,GER
e61b8aee,27,19,10,13,4,8,27,19,24,6,18,15,42,35,0,24,GER
e6c43eec,15,10,10,5,0,6,7,1,13,7,6,13,28,21,0,24,GER
e717705a,17,12,5,10,2,6,16,10,14,3,11,9,26,26,0,24,GER
e75129bd,0,0,0,0,0,0,0,0,0,0,0,1,1,0,0,24,GER
e79269bd,36,20,17,16,3,21,38,17,28,9,19,19,55,69,1,24,GER
e7f4869a,10,4,1,6,3,6,9,3,11,4,7,3,13,14,0,24,GER
e7fcf289,25,18,7,12,6,8,26,18,31,2,29,7,32,3,0,24,GER
e82900ef,10,7,3,5,2,4,9,5,4,0,4,0,10,5,0,24,GER
e82adcab,52,28,21,26,5,21,43,22,21,0,21,29,81,16,2,24,GER
e8ef59da,2,1,0,2,0,1,2,1,4,0,4,1,3,1,0,24,GER
e9a97974,1,0,0,1,0,0,0,0,1,0,1,0,1,0,0,24,GER
ea6bc03a,32,21,22,10,0,16,22,6,26,19,7,27,59,113,1,24,GER
eb6e14be,0,0,0,0,0,0,0,0,3,1,2,0,0,3,0,24,GER
ec11ecf8,0,0,0,0,0,0,1,1,2,0,2,0,0,0,0,24,GER
ec759ba1,0,0,0,0,0,0,0,0,0,0,0,0,0,3,0,24,GER
ecbe2839,54,33,34,19,1,28,44,16,45,19,26,40,94,133,0,24,GER
ed79b7d3,20,12,5,13,2,11,31,20,20,1,19,7,27,21,0,24,GER
ed98c321,5,3,4,1,0,4,6,2,4,2,2,1,6,5,0,24,GER
edb2712b,18,12,7,10,1,10,18,8,9,1,8,16,34,18,0,24,GER
ee644761,25,19,15,9,1,8,15,7,24,15,9,23,48,87,0,24,GER
f1e94cd6,8,6,4,4,0,4,7,3,9,0,9,3,11,6,0,24,GER
f24ea523,1,1,1,0,0,0,0,0,0,0,0,0,1,1,0,24,GER
f256f213,1,0,1,0,0,1,2,1,0,0,0,0,1,6,1,24,GER
f25c8e3a,1,1,1,0,0,0,1,1,2,0,2,2,3,1,0,24,GER
f26834c7,16,7,4,6,6,6,11,5,18,4,14,1,17,7,0,24,GER
f26dee6b,0,0,0,0,0,0,0,0,0,0,0,0,0,3,0,24,GER
f27680d9,23,17,11,11,1,13,32,19,18,6,12,14,37,33,1,24,GER
f44e8a73,46,27,25,16,5,25,47,22,22,5,17,29,75,34,1,24,GER
f521b80a,29,15,19,9,1,16,29,13,40,26,14,16,45,93,0,24,GER
f5b281e7,46,23,29,16,1,25,54,29,27,2,25,15,61,26,0,24,GER
f631c17f,0,0,0,0,0,0,2,2,0,0,0,0,0,0,0,24,GER
f67c9d29,25,18,15,10,0,11,15,4,31,16,15,29,54,87,1,24,GER
f68b64fc,16,8,8,6,2,12,23,11,14,5,9,11,27,27,0,24,GER
f6bdc830,28,15,18,9,1,15,19,4,27,18,9,20,48,67,1,24,GER
f76022e7,31,17,7,14,10,14,31,17,22,2,20,13,44,6,1,24,GER
f761c901,27,11,21,6,0,8,20,12,16,10,6,21,48,29,1,24,GER
f86ad3f5,40,26,27,13,0,30,40,10,41,26,15,26,66,103,0,24,GER
f86cd5df,26,12,10,7,9,13,24,11,15,6,9,11,37,24,0,24,GER
f972644c,10,4,5,3,2,4,11,7,9,0,9,2,12,1,0,24,GER
fa661778,14,8,4,9,1,7,15,8,8,0,8,5,19,12,0,24,GER
fb377d11,26,16,13,11,2,14,29,15,11,5,6,2,28,15,1,24,GER
fb6316d5,0,0,0,0,0,0,0,0,0,0,0,0,0,0,0,24,GER
fc46aab1,31,15,14,17,0,11,27,16,18,1,17,7,38,11,0,24,GER
fc62fdf4,1,0,1,0,0,1,2,1,0,0,0,0,1,1,0,24,GER
fcb27134,43,25,23,19,1,27,36,9,32,14,18,25,68,62,0,24,GER
fd53759d,21,14,9,8,4,8,17,9,29,5,24,4,25,22,0,24,GER
fd82af8c,9,5,6,1,2,5,10,5,8,1,7,3,12,10,0,24,GER
fdbe14c8,0,0,0,0,0,0,0,0,0,0,0,0,0,0,0,24,GER
ff98492b,20,12,13,6,1,14,32,18,15,3,12,8,28,18,1,24,GER
ffa90327,0,0,0,0,0,0,1,1,0,0,0,0,0,0,0,24,GER
ffbbc83b,36,20,23,10,3,13,36,23,26,13,13,36,72,66,2,24,GER
00242715,33,21,26,7,0,14,18,4,16,10,6,9,42,42,0,24,ENG
003cf4d1,0,0,0,0,0,0,0,0,0,0,0,0,0,0,0,24,ENG
00963611,25,13,14,9,2,14,17,3,20,12,8,22,47,70,1,24,ENG
00b77ecf,4,1,2,1,1,1,3,2,2,1,1,1,5,1,0,24,ENG
01ce9e70,0,0,0,0,0,0,0,0,0,0,0,0,0,0,0,24,ENG
01e5f06e,1,0,0,1,0,1,1,0,0,0,0,1,2,0,0,24,ENG
02b29014,32,20,16,11,5,14,32,18,20,2,18,14,46,13,0,24,ENG
0313a347,40,23,22,15,3,19,22,3,29,16,13,27,67,63,3,24,ENG
03df04ff,0,0,0,0,0,0,1,1,0,0,0,0,0,1,0,24,ENG
0420d84f,11,10,7,2,2,8,12,4,6,3,3,4,15,12,1,24,ENG
0442183b,15,9,7,6,2,9,12,3,9,2,7,4,19,21,0,24,ENG
0480ebc7,1,0,1,0,0,0,9,9,8,1,7,5,6,23,0,24,ENG
049a888d,20,12,9,6,5,9,25,16,10,1,9,5,25,6,0,24,ENG
0562b7f1,19,10,7,5,7,3,17,14,15,1,14,5,24,19,0,24,ENG
05e8ca6d,14,9,6,5,3,6,15,9,17,3,14,1,15,10,0,24,ENG
06df8256,13,10,8,5,0,6,10,4,13,8,5,7,20,35,1,24,ENG
077faf72,3,3,2,1,0,1,7,6,4,0,4,1,4,1,0,24,ENG
07802f7f,5,2,0,5,0,3,9,6,4,1,3,2,7,6,0,24,ENG
07d65234,1,0,1,0,0,0,4,4,2,0,2,0,1,1,1,24,ENG
0a3d6d2b,36,22,18,15,3,16,22,6,26,9,17,22,58,87,0,24,ENG
0ad53bdc,42,23,27,12,3,26,36,10,25,9,16,16,58,53,1,24,ENG
0ba976e4,4,2,1,2,1,1,11,10,7,0,7,3,7,3,0,24,ENG
0cd31129,24,13,13,4,7,12,29,17,29,1,28,6,30,12,1,24,ENG
0cf321c8,0,0,0,0,0,0,0,0,0,0,0,0,0,5,1,24,ENG
0db169ae,7,7,4,2,1,3,9,6,3,0,3,2,9,4,0,24,ENG
0db5d2c8,13,9,11,1,1,8,15,7,9,5,4,10,23,28,0,24,ENG
0ed063d6,15,7,8,5,2,8,11,3,5,1,4,7,22,18,1,24,ENG
0ef89a37,0,0,0,0,0,0,1,1,0,0,0,0,0,0,0,24,ENG
0f134faf,46,27,23,18,5,22,77,55,34,6,28,16,62,20,1,24,ENG
0f7533cd,16,11,3,11,2,3,11,8,17,2,15,3,19,12,0,24,ENG
104d0bb8,17,10,6,8,3,9,19,10,11,4,7,11,28,12,2,24,ENG
10a10454,7,2,4,2,1,2,8,6,4,2,2,3,10,2,0,24,ENG
10cb48b7,5,3,3,1,1,2,6,4,4,2,2,3,8,10,0,24,ENG
10f0fdd3,15,9,7,6,2,6,13,7,17,2,15,7,22,13,0,24,ENG
119b9a8e,0,0,0,0,0,0,0,0,1,1,0,0,0,1,0,24,ENG
1265a93a,13,8,10,2,1,8,10,2,4,4,0,3,16,7,1,24,ENG
1544f145,16,8,7,6,3,5,15,10,15,2,13,3,19,8,0,24,ENG
15ab5a2b,20,9,3,7,10,7,26,19,24,0,24,2,22,13,1,24,ENG
15ea812b,49,32,35,13,1,25,40,15,66,43,23,50,99,143,2,24,ENG
15f24fe7,6,2,3,2,1,1,2,1,3,0,3,1,7,6,0,24,ENG
15f3ec41,11,4,2,4,5,5,20,15,11,1,10,4,15,10,0,24,ENG
16264a81,60,33,28,25,7,22,39,17,38,17,21,24,84,32,3,24,ENG
169fd162,16,8,9,6,1,8,21,13,18,1,17,8,24,9,0,24,ENG
16e9d0ea,17,12,17,0,0,11,17,6,9,2,7,13,30,35,0,24,ENG
1704b0b8,37,23,26,10,1,15,27,12,35,19,16,27,64,146,0,24,ENG
17695062,4,1,2,2,0,2,4,2,3,1,2,3,7,1,0,24,ENG
1780bb4a,16,9,9,3,4,7,7,0,7,3,4,3,19,10,0,24,ENG
178ae8f8,23,13,6,13,4,10,22,12,8,1,7,6,29,4,0,24,ENG
1961b2aa,4,3,2,1,1,2,8,6,7,1,6,1,5,1,1,24,ENG
1971591f,18,11,5,9,4,4,14,10,18,4,14,8,26,7,0,24,ENG
197640fd,40,19,18,13,9,22,34,12,29,7,22,34,74,54,1,24,ENG
19a9cb70,0,0,0,0,0,0,0,0,0,0,0,0,0,0,0,24,ENG
19f4d211,0,0,0,0,0,0,0,0,0,0,0,0,0,0,0,24,ENG
1a066e69,13,5,6,7,0,9,15,6,13,7,6,14,27,31,0,24,ENG
1aa84968,7,2,4,3,0,2,9,7,9,4,5,5,12,17,0,24,ENG
1b4f1169,19,12,10,7,2,13,18,5,19,11,8,6,25,11,0,24,ENG
1b84dbe1,36,17,26,9,1,20,35,15,12,0,12,21,57,45,0,24,ENG
1b9728b0,2,0,0,2,0,1,1,0,0,0,0,0,2,0,0,24,ENG
1c7012b8,59,35,29,24,6,24,43,19,31,10,21,36,95,43,0,24,ENG
1caa93a5,2,1,2,0,0,2,6,4,1,0,1,0,2,10,2,24,ENG
1d042188,28,15,15,10,3,8,19,11,33,24,9,25,53,133,2,24,ENG
1daec722,36,24,19,15,2,20,37,17,20,8,12,14,50,30,0,24,ENG
1df4a109,12,9,3,8,1,3,8,5,5,2,3,1,13,3,0,24,ENG
1f44ac21,5,2,0,3,2,2,3,1,9,1,8,1,6,13,0,24,ENG
20b104bc,23,13,14,3,6,13,26,13,17,8,9,15,38,41,0,24,ENG
20b3a502,62,33,34,27,1,23,48,25,27,4,23,14,76,23,0,24,ENG
21512407,57,27,30,16,11,37,76,39,38,8,30,23,80,55,3,24,ENG
215f3907,17,9,8,6,3,9,23,14,9,1,8,8,25,4,1,24,ENG
21945a9e,0,0,0,0,0,0,0,0,0,0,0,0,0,0,0,24,ENG
230f0471,33,23,21,10,2,14,37,23,14,3,11,9,42,32,0,24,ENG
2389cdc2,48,26,21,22,5,24,49,25,33,12,21,18,66,52,0,24,ENG
246d153b,28,16,22,5,1,17,23,6,11,3,8,8,36,44,1,24,ENG
24fae784,12,5,6,4,2,8,17,9,8,6,2,4,16,25,2,24,ENG
2500cef9,23,13,9,9,5,3,17,14,18,3,15,8,31,10,0,24,ENG
259fea27,2,1,2,0,0,2,2,0,0,0,0,1,3,18,1,24,ENG
2628fd2b,0,0,0,0,0,0,0,0,0,0,0,0,0,12,1,24,ENG
2696b6a9,25,13,15,8,2,9,21,12,20,5,15,5,30,2,0,24,ENG
26ce2263,65,33,27,24,14,30,69,39,34,5,29,40,105,35,0,24,ENG
27d0a506,78,54,38,26,14,51,99,48,53,15,38,27,105,84,2,24,ENG
27f4f772,0,0,0,0,0,0,0,0,0,0,0,0,0,1,0,24,ENG
282f75f3,22,11,13,8,1,9,30,21,41,31,10,25,47,63,1,24,ENG
28300a16,0,0,0,0,0,0,3,3,0,0,0,0,0,7,1,24,ENG
2886c9b5,4,4,2,2,0,1,5,4,5,1,4,3,7,6,0,24,ENG
288e1e13,23,12,17,6,0,14,19,5,31,23,8,17,40,82,2,24,ENG
289601e6,78,49,50,21,7,46,86,40,43,5,38,73,151,87,3,24,ENG
28b40c9c,18,9,11,5,2,7,15,8,22,15,7,25,43,56,2,24,ENG
2944f86f,35,22,9,21,5,14,26,12,15,7,8,23,58,16,0,24,ENG
2aaadf33,3,2,1,2,0,1,1,0,1,0,1,0,3,1,0,24,ENG
2afc7272,47,32,22,21,4,27,48,21,23,7,16,48,95,34,1,24,ENG
2b09d998,4,3,1,3,0,2,3,1,2,0,2,4,8,2,0,24,ENG
2b471f99,71,49,36,26,9,16,35,19,24,5,19,37,108,56,0,24,ENG
2bd83368,42,25,12,22,8,17,54,37,24,0,24,5,47,4,0,24,ENG
2c6835e5,33,21,6,20,7,15,32,17,20,3,17,8,41,18,2,24,ENG
2da834f1,9,6,3,3,3,4,9,5,18,3,15,1,10,34,0,24,ENG
2e4f5f03,26,18,17,7,2,18,26,8,10,3,7,9,35,30,0,24,ENG
2e5915f1,4,1,1,0,3,1,7,6,7,0,7,1,5,7,0,24,ENG
2ee5b0c9,25,16,1,13,11,7,25,18,20,9,11,8,33,10,0,24,ENG
2f90f6b8,20,14,9,10,1,9,14,5,9,0,9,8,28,16,0,24,ENG
2f965a72,1,1,1,0,0,1,3,2,0,0,0,1,2,13,0,24,ENG
2f9e4435,31,18,17,7,7,13,24,11,10,2,8,10,41,24,0,24,ENG
2fba6108,32,18,19,6,7,16,33,17,22,2,20,7,39,18,1,24,ENG
30d4a2e5,60,34,40,19,1,35,57,22,34,11,23,33,93,77,0,24,ENG
30e81a88,5,1,1,2,2,0,2,2,2,0,2,0,5,2,0,24,ENG
31c69ef1,33,17,12,19,2,18,24,6,27,15,12,25,58,71,0,24,ENG
32163807,0,0,0,0,0,0,0,0,1,0,1,0,0,1,0,24,ENG
32e7ce92,0,0,0,0,0,0,0,0,0,0,0,0,0,1,0,24,ENG
32f60ed8,32,21,6,16,10,13,29,16,23,5,18,12,44,18,0,24,ENG
3312f911,35,21,14,15,6,9,17,8,12,2,10,7,42,23,0,24,ENG
3353737a,37,18,21,10,6,22,40,18,23,2,21,13,50,23,0,24,ENG
339fe0e8,0,0,0,0,0,0,0,0,0,0,0,0,0,0,0,24,ENG
34721c11,2,0,2,0,0,1,1,0,0,0,0,1,3,0,0,24,ENG
35141f4c,39,19,21,16,2,15,40,25,36,17,19,23,62,84,1,24,ENG
3515d404,37,24,13,18,6,13,31,18,25,7,18,30,67,45,0,24,ENG
35516eac,14,11,5,5,4,6,21,15,24,2,22,4,18,9,0,24,ENG
35e413f1,32,19,13,15,4,15,32,17,33,17,16,25,57,59,1,24,ENG
37118440,25,16,17,6,2,15,22,7,23,13,10,23,48,68,0,24,ENG
374d5158,14,11,8,5,1,10,18,8,5,2,3,6,20,28,1,24,ENG
387d06b2,3,2,2,1,0,2,3,1,1,0,1,0,3,1,0,24,ENG
38ceb24a,16,11,6,6,4,5,13,8,19,0,19,6,22,6,0,24,ENG
3925dbd6,0,0,0,0,0,0,0,0,0,0,0,0,0,0,0,24,ENG
394854c4,18,10,10,7,1,6,15,9,14,8,6,10,28,33,0,24,ENG
399e9474,50,33,30,19,1,22,35,13,33,15,18,25,75,60,1,24,ENG
3a233281,10,5,5,3,2,4,17,13,14,1,13,8,18,5,0,24,ENG
3a24769f,41,16,14,19,8,9,38,29,19,7,12,23,64,46,2,24,ENG
3a949a25,0,0,0,0,0,0,3,3,0,0,0,0,0,4,1,24,ENG
3b8674e6,15,9,9,4,2,7,16,9,12,3,9,8,23,12,1,24,ENG
3bb7b8b4,0,0,0,0,0,0,1,1,0,0,0,0,0,6,1,24,ENG
3d554589,2,1,1,1,0,0,1,1,4,2,2,4,6,17,0,24,ENG
3e9e06cb,30,20,23,6,1,22,34,12,51,39,12,16,46,120,1,24,ENG
3ea50f67,4,1,1,2,1,0,1,1,0,0,0,2,6,1,0,24,ENG
3eb22ec9,43,21,11,23,9,22,48,26,21,3,18,12,55,11,1,24,ENG
3f034750,0,0,0,0,0,0,0,0,1,0,1,0,0,4,1,24,ENG
3f7bafbe,1,0,1,0,0,0,0,0,0,0,0,0,1,0,0,24,ENG
3fe6bd8c,1,0,1,0,0,1,1,0,0,0,0,0,1,0,0,24,ENG
41034650,1,1,0,1,0,0,0,0,0,0,0,0,1,1,0,24,ENG
4125cb98,9,7,7,1,1,5,8,3,6,2,4,9,18,21,0,24,ENG
414184f7,5,4,2,1,2,1,4,3,5,0,5,1,6,7,0,24,ENG
41f08ac8,17,7,5,11,1,7,13,6,10,2,8,6,23,16,0,24,ENG
43439614,41,26,18,18,5,20,47,27,24,9,15,21,62,39,0,24,ENG
43a166b4,6,4,5,0,1,0,0,0,6,0,6,2,8,4,0,24,ENG
44781702,21,17,13,6,2,15,18,3,16,14,2,10,31,33,0,24,ENG
4506aec5,0,0,0,0,0,0,0,0,0,0,0,0,0,0,0,24,ENG
450ab6fc,14,9,7,7,0,6,11,5,17,12,5,5,19,42,0,24,ENG
45685411,4,1,3,1,0,2,3,1,2,0,2,3,7,1,0,24,ENG
4596da74,14,6,4,7,3,5,14,9,10,3,7,2,16,8,0,24,ENG
45db685d,19,8,6,6,7,9,20,11,15,1,14,9,28,6,1,24,ENG
466fb2c5,0,0,0,0,0,0,0,0,0,0,0,0,0,3,2,24,ENG
468a7a91,33,16,8,20,5,10,30,20,18,3,15,6,39,4,0,24,ENG
47369df8,51,33,18,24,9,22,30,8,30,8,22,32,83,39,1,24,ENG
47a34c4f,0,0,0,0,0,0,1,1,0,0,0,1,1,0,0,24,ENG
4806ec67,0,0,0,0,0,0,0,0,3,0,3,0,0,16,0,24,ENG
484a3eae,0,0,0,0,0,0,0,0,0,0,0,1,1,0,0,24,ENG
48a5a5d6,19,15,3,7,9,8,18,10,18,1,17,4,23,5,1,24,ENG
491a433d,10,6,2,3,5,5,12,7,5,0,5,1,11,16,0,24,ENG
49fe9070,5,3,3,2,0,4,12,8,9,0,9,3,8,1,0,24,ENG
4a1a9578,25,19,4,10,11,6,26,20,14,0,14,3,28,7,0,24,ENG
4a51ba65,0,0,0,0,0,0,0,0,0,0,0,0,0,8,4,24,ENG
4ab53cdb,12,8,5,4,3,6,11,5,11,1,10,1,13,8,0,24,ENG
4b40d9ca,0,0,0,0,0,0,1,1,0,0,0,0,0,7,2,24,ENG
4b542852,20,15,5,11,4,11,24,13,5,2,3,10,30,9,1,24,ENG
4bcf39f6,10,7,4,5,1,3,14,11,11,0,11,2,12,4,0,24,ENG
4c3a6744,22,11,3,10,9,6,23,17,11,1,10,5,27,8,0,24,ENG
4c5835e6,0,0,0,0,0,0,0,0,0,0,0,0,0,2,0,24,ENG
4d224fe8,50,29,22,22,6,30,67,37,52,19,33,11,61,42,0,24,ENG
4d77b365,20,12,2,9,9,11,22,11,17,6,11,2,22,7,0,24,ENG
4dcec659,25,15,13,6,6,11,29,18,17,1,16,12,37,12,0,24,ENG
4e015693,69,37,28,30,11,30,72,42,39,11,28,42,111,42,1,24,ENG
4e204552,5,2,2,1,2,4,14,10,10,0,10,5,10,10,0,24,ENG
4e5a4cbc,4,0,3,1,0,2,3,1,6,4,2,5,9,27,0,24,ENG
4e9a0555,4,3,1,1,2,1,6,5,10,2,8,1,5,23,0,24,ENG
4f28a6ff,13,9,7,5,1,7,12,5,18,10,8,6,19,47,1,24,ENG
4f565d77,12,7,3,7,2,5,8,3,4,1,3,6,18,4,1,24,ENG
4f974391,1,0,1,0,0,1,2,1,3,2,1,2,3,4,0,24,ENG
4fb9c88f,21,13,12,7,2,8,20,12,17,0,17,6,27,8,0,24,ENG
4fd08daa,40,23,21,16,3,23,40,17,44,24,20,26,66,69,4,24,ENG
507c7bdf,59,34,24,21,14,26,78,52,40,6,34,23,82,36,1,24,ENG
50dc94ce,0,0,0,0,0,0,0,0,1,0,1,0,0,0,0,24,ENG
50e6dc35,14,10,4,6,4,4,7,3,12,4,8,3,17,12,0,24,ENG
51a3c4c8,12,9,9,3,0,9,12,3,4,1,3,4,16,12,0,24,ENG
51cf8561,48,29,18,23,7,34,49,15,17,3,14,17,65,24,2,24,ENG
51dbeea9,1,1,0,1,0,0,0,0,2,2,0,0,1,0,0,24,ENG
529f49ab,7,5,6,1,0,4,6,2,3,1,2,5,12,3,0,24,ENG
52afb588,2,1,1,1,0,0,3,3,0,0,0,1,3,3,0,24,ENG
532e1e4f,22,13,14,7,1,10,22,12,19,7,12,11,33,56,0,24,ENG
5515376c,2,1,1,0,1,2,2,0,2,2,0,4,6,10,0,24,ENG
5526deb1,19,9,9,7,3,11,17,6,17,7,10,11,30,14,0,24,ENG
56f7a928,31,17,14,13,4,13,30,17,19,2,17,10,41,5,0,24,ENG
570bb4b9,1,0,1,0,0,1,3,2,3,0,3,0,1,0,0,24,ENG
57827369,4,2,2,1,1,2,4,2,4,3,1,0,4,4,0,24,ENG
57c94db2,37,24,28,6,3,24,48,24,11,2,9,15,52,62,0,24,ENG
59e6e5bf,9,3,1,5,3,2,13,11,11,3,8,3,12,27,0,24,ENG
5a04fd92,8,4,5,3,0,4,15,11,8,0,8,5,13,7,0,24,ENG
5a2cb25d,23,15,14,7,2,16,25,9,12,3,9,5,28,12,2,24,ENG
5a7301ae,6,4,3,2,1,4,5,1,5,2,3,2,8,3,1,24,ENG
5ad50391,38,27,14,17,7,15,26,11,22,10,12,22,60,26,2,24,ENG
5c0da4a4,50,32,24,21,5,23,44,21,29,3,26,5,55,21,0,24,ENG
5c2b4f07,20,14,9,11,0,5,11,6,10,3,7,9,29,36,1,24,ENG
5cbd1eb0,87,47,68,12,7,33,47,14,47,9,38,24,111,92,0,24,ENG
5e4d9b48,0,0,0,0,0,0,0,0,0,0,0,0,0,3,0,24,ENG
5ed9b537,31,20,18,12,1,15,21,6,17,11,6,19,50,46,0,24,ENG
5eecec3d,2,1,1,0,1,0,3,3,11,7,4,9,11,20,0,24,ENG
5f346071,10,7,2,7,1,5,14,9,11,1,10,9,19,14,0,24,ENG
5ff4ab71,48,22,20,18,10,26,61,35,36,13,23,16,64,26,0,24,ENG
60344e4f,2,1,0,1,1,0,0,0,0,0,0,0,2,0,0,24,ENG
620922ed,1,1,1,0,0,1,1,0,4,4,0,5,6,14,0,24,ENG
6250083a,15,10,7,5,3,8,14,6,11,1,10,1,16,7,0,24,ENG
62d7ef38,0,0,0,0,0,0,0,0,0,0,0,0,0,3,1,24,ENG
6412cc03,3,2,2,0,1,3,3,0,0,0,0,2,5,1,0,24,ENG
6434f10d,57,34,20,27,10,27,51,24,27,7,20,20,77,37,3,24,ENG
6613c819,41,28,17,22,2,16,37,21,50,26,24,35,76,87,0,24,ENG
6639e500,19,9,3,8,8,8,31,23,14,2,12,3,22,12,0,24,ENG
67ac5bb8,37,20,19,17,1,13,16,3,37,27,10,24,61,73,0,24,ENG
67f649be,0,0,0,0,0,0,0,0,0,0,0,0,0,0,0,24,ENG
68db6358,0,0,0,0,0,0,0,0,0,0,0,0,0,1,0,24,ENG
69942fb3,3,2,1,2,0,1,1,0,1,1,0,2,5,6,0,24,ENG
6a713852,0,0,0,0,0,0,0,0,0,0,0,0,0,11,3,24,ENG
6a7353d7,1,0,0,1,0,1,2,1,2,1,1,0,1,7,0,24,ENG
6a8a7af8,111,68,53,45,13,35,65,30,49,15,34,29,140,67,1,24,ENG
6afaebf2,12,8,6,4,2,4,13,9,14,0,14,5,17,9,0,24,ENG
6c203af0,66,43,28,29,9,34,49,15,26,5,21,32,98,38,3,24,ENG
6ca5ec4b,22,13,10,10,2,10,22,12,14,0,14,14,36,7,0,24,ENG
6f7d826d,55,36,20,26,9,24,49,25,30,6,24,18,73,17,1,24,ENG
6fe90922,3,2,1,1,1,3,5,2,1,0,1,2,5,1,0,24,ENG
700783e7,48,30,26,17,5,26,34,8,28,10,18,26,74,66,0,24,ENG
71ef519e,3,2,1,2,0,2,3,1,0,0,0,1,4,5,0,24,ENG
72c812f3,59,39,25,21,13,22,39,17,17,4,13,20,79,10,0,24,ENG
73341ace,2,1,1,1,0,1,5,4,6,2,4,1,3,1,0,24,ENG
733f1a7d,0,0,0,0,0,0,0,0,0,0,0,0,0,0,0,24,ENG
7399c7a8,38,25,27,11,0,24,35,11,45,30,15,29,67,129,2,24,ENG
73b1d65b,8,6,4,3,1,2,7,5,2,0,2,4,12,22,0,24,ENG
745ca0a3,1,1,0,1,0,0,3,3,0,0,0,0,1,0,0,24,ENG
74618572,13,6,3,7,3,5,19,14,15,1,14,5,18,12,0,24,ENG
74b2cd7e,3,1,3,0,0,2,2,0,10,8,2,2,5,18,0,24,ENG
74e12f1e,2,0,0,2,0,1,3,2,0,0,0,0,2,1,0,24,ENG
767d9605,0,0,0,0,0,0,0,0,0,0,0,0,0,0,0,24,ENG
774cf58b,28,18,20,6,2,19,30,11,9,5,4,6,34,23,0,24,ENG
77816c91,4,2,1,2,1,0,4,4,4,1,3,1,5,1,0,24,ENG
778ef829,19,16,14,3,2,7,21,14,15,5,10,13,32,29,0,24,ENG
77cf6852,5,3,2,2,1,5,7,2,2,0,2,1,6,2,0,24,ENG
77d6fd4d,0,0,0,0,0,0,1,1,0,0,0,1,1,28,2,24,ENG
77d7c96f,22,15,15,5,2,9,17,8,10,3,7,16,38,33,0,24,ENG
77e84962,0,0,0,0,0,0,0,0,0,0,0,0,0,0,0,24,ENG
788c0277,17,10,10,7,0,12,22,10,14,3,11,5,22,33,2,24,ENG
78b8ac63,14,5,2,6,6,2,8,6,15,2,13,3,17,24,0,24,ENG
79300479,39,14,11,20,8,13,47,34,21,1,20,9,48,5,0,24,ENG
7956236f,0,0,0,0,0,0,0,0,0,0,0,0,0,11,1,24,ENG
79bc4c45,13,5,5,6,2,4,8,4,12,1,11,4,17,22,0,24,ENG
79c0821a,21,16,11,8,2,11,17,6,14,1,13,4,25,8,0,24,ENG
79c84d1c,37,24,13,12,12,12,32,20,33,5,28,18,55,14,0,24,ENG
7a11550b,42,27,21,14,7,27,59,32,25,3,22,15,57,45,2,24,ENG
7a1f2c08,4,1,0,2,2,1,2,1,0,0,0,2,6,0,0,24,ENG
7a2e46a8,0,0,0,0,0,0,1,1,0,0,0,0,0,10,3,24,ENG
7aa8adfe,18,12,6,4,8,9,36,27,22,2,20,14,32,18,0,24,ENG
7af88b33,20,10,12,5,3,8,15,7,7,3,4,5,25,13,0,24,ENG
7b355808,2,2,1,0,1,1,2,1,3,1,2,2,4,9,0,24,ENG
7b5ab7f2,1,0,0,0,1,1,3,2,3,0,3,3,4,4,0,24,ENG
7ba2eaa9,7,3,3,2,2,5,15,10,5,1,4,4,11,2,0,24,ENG
7c56da38,2,1,0,2,0,0,0,0,3,0,3,2,4,3,0,24,ENG
7c5fa6cf,21,12,9,9,3,7,24,17,17,2,15,5,26,8,1,24,ENG
7cd520e8,68,33,41,16,11,27,49,22,25,7,18,36,104,76,4,24,ENG
7f94982c,0,0,0,0,0,0,0,0,1,0,1,0,0,0,0,24,ENG
7fa4e703,4,2,4,0,0,2,2,0,0,0,0,1,5,0,0,24,ENG
803ae100,26,16,8,15,3,12,29,17,18,9,9,11,37,20,0,24,ENG
82518f62,67,35,37,22,8,27,54,27,41,9,32,27,94,16,0,24,ENG
828657ff,58,33,27,24,7,15,33,18,20,4,16,15,73,25,0,24,ENG
82927de4,10,6,4,3,3,5,16,11,8,1,7,6,16,7,0,24,ENG
834b5c4c,0,0,0,0,0,0,0,0,0,0,0,0,0,7,0,24,ENG
8397a50c,0,0,0,0,0,0,0,0,0,0,0,1,1,1,0,24,ENG
839c14e1,0,0,0,0,0,0,0,0,0,0,0,0,0,0,0,24,ENG
83d074ff,71,39,23,39,9,44,94,50,54,6,48,30,101,18,0,24,ENG
8449d35e,55,32,26,21,8,29,57,28,28,8,20,28,83,50,1,24,ENG
84c5ceea,7,5,4,2,1,4,8,4,3,0,3,2,9,1,0,24,ENG
861e9b3b,1,1,0,1,0,1,1,0,0,0,0,1,2,0,0,24,ENG
862a1c15,35,24,12,15,8,11,28,17,28,2,26,10,45,12,0,24,ENG
86dd77d1,28,18,15,11,2,15,32,17,16,4,12,22,50,36,1,24,ENG
86e7deaf,25,11,21,3,1,17,29,12,26,20,6,21,46,108,3,24,ENG
886f9aac,3,3,1,1,1,1,2,1,4,0,4,3,6,2,0,24,ENG
88968486,47,27,21,25,1,17,38,21,40,25,15,29,76,118,3,24,ENG
890f108d,1,1,1,0,0,0,2,2,2,1,1,0,1,0,0,24,ENG
89ac64a6,28,19,10,13,5,16,29,13,23,12,11,20,48,61,1,24,ENG
8a3c1dc7,7,5,3,3,1,6,7,1,8,3,5,5,12,5,1,24,ENG
8a7ff278,43,27,24,18,1,29,46,17,15,9,6,11,54,85,1,24,ENG
8aec0537,55,34,26,16,13,23,53,30,33,7,26,19,74,24,3,24,ENG
8aff2b51,0,0,0,0,0,0,0,0,0,0,0,0,0,0,0,24,ENG
8b04d6c1,24,14,9,13,2,11,29,18,19,7,12,15,39,27,1,24,ENG
8b3ab7ad,65,32,40,21,4,25,50,25,48,18,30,31,96,72,0,24,ENG
8b529245,3,2,0,1,2,0,4,4,4,0,4,0,3,1,0,24,ENG
8b57ad2c,95,55,51,36,8,33,73,40,44,4,40,18,113,23,2,24,ENG
8b788c01,4,1,1,1,2,1,1,0,4,0,4,0,4,3,0,24,ENG
8b9ebd03,12,7,5,3,4,3,16,13,13,0,13,9,21,12,0,24,ENG
8c3078cd,1,1,1,0,0,0,1,1,0,0,0,0,1,0,0,24,ENG
8d3c902d,8,5,3,3,2,1,4,3,4,1,3,2,10,10,0,24,ENG
8df7a2fb,26,15,12,12,2,17,22,5,21,13,8,13,39,63,1,24,ENG
8e16dd48,23,12,9,10,4,9,16,7,18,0,18,8,31,4,0,24,ENG
8e92be30,3,0,2,1,0,1,7,6,12,1,11,3,6,6,0,24,ENG
8fe2a392,34,25,24,7,3,16,22,6,12,9,3,13,47,58,0,24,ENG
903b6e8b,0,0,0,0,0,0,1,1,3,0,3,0,0,17,5,24,ENG
907a5d7c,14,10,5,6,3,7,13,6,15,3,12,5,19,4,0,24,ENG
90f91999,48,29,13,29,6,25,60,35,21,2,19,15,63,18,0,24,ENG
91748070,43,15,27,15,1,15,25,10,31,22,9,47,90,114,0,24,ENG
9228b07c,10,5,4,3,3,3,9,6,2,1,1,3,13,6,1,24,ENG
92868cb5,0,0,0,0,0,0,0,0,0,0,0,0,0,0,0,24,ENG
9295dc1c,53,29,29,18,6,36,75,39,32,4,28,11,64,37,4,24,ENG
92e7e919,15,9,5,5,5,7,16,9,4,1,3,7,22,4,0,24,ENG
9319781b,10,6,7,2,1,8,11,3,1,1,0,5,15,8,0,24,ENG
9328b835,1,0,1,0,0,1,1,0,0,0,0,1,2,1,0,24,ENG
934e1968,30,18,11,11,8,15,48,33,34,2,32,13,43,16,1,24,ENG
938fa024,0,0,0,0,0,0,0,0,0,0,0,0,0,0,0,24,ENG
93e08bce,12,5,4,7,1,1,10,9,13,6,7,12,24,38,2,24,ENG
95bd120d,1,1,1,0,0,0,1,1,0,0,0,0,1,0,0,24,ENG
96593e89,29,19,7,13,9,13,28,15,20,0,20,9,38,14,0,24,ENG
9674002f,18,12,4,8,6,3,12,9,6,1,5,5,23,2,0,24,ENG
96cf7b61,3,1,3,0,0,3,4,1,0,0,0,0,3,12,6,24,ENG
97220da2,3,0,0,1,2,1,2,1,6,1,5,0,3,3,0,24,ENG
972aeb2a,32,20,20,11,1,14,16,2,25,12,13,21,53,62,2,24,ENG
9744ff80,17,11,7,6,4,11,27,16,16,1,15,8,25,8,0,24,ENG
980522ec,14,12,4,7,3,8,27,19,14,5,9,3,17,10,0,24,ENG
98ea5115,1,1,1,0,0,1,1,0,0,0,0,0,1,6,4,24,ENG
9907b1c8,16,7,9,5,2,7,15,8,13,0,13,1,17,10,0,24,ENG
99127249,31,16,11,14,6,17,32,15,24,1,23,8,39,7,0,24,ENG
99813635,7,2,3,4,0,0,4,4,2,1,1,2,9,1,0,24,ENG
999ceb5f,14,11,7,6,1,3,9,6,9,2,7,4,18,4,0,24,ENG
99aa1a84,1,1,1,0,0,1,1,0,0,0,0,0,1,1,0,24,ENG
9a28eba4,4,3,1,2,1,3,6,3,1,0,1,1,5,1,0,24,ENG
9ade9ce1,8,5,3,1,4,3,9,6,5,1,4,4,12,6,0,24,ENG
9af1f9ff,35,20,22,12,1,14,24,10,22,15,7,16,51,68,1,24,ENG
9b066938,0,0,0,0,0,0,0,0,0,0,0,0,0,0,0,24,ENG
9b398aea,53,30,30,17,6,21,35,14,25,6,19,12,65,31,0,24,ENG
9b5ce51a,38,22,11,23,4,17,38,21,28,11,17,29,67,57,0,24,ENG
9b6f7fd5,60,41,33,22,5,22,44,22,23,0,23,17,77,23,1,24,ENG
9c36ed83,14,10,2,6,6,3,18,15,16,5,11,3,17,15,0,24,ENG
9c94165b,11,8,7,3,1,9,15,6,18,11,7,6,17,39,0,24,ENG
9cfbad36,0,0,0,0,0,0,2,2,3,0,3,0,0,0,0,24,ENG
9dc96f10,3,1,0,2,1,1,1,0,0,0,0,0,3,0,0,24,ENG
9e525177,31,21,15,12,4,16,22,6,17,9,8,28,59,48,1,24,ENG
9e5708be,1,0,1,0,0,1,1,0,0,0,0,1,2,5,0,24,ENG
9f7c837d,25,17,16,5,4,13,24,11,10,5,5,10,35,38,0,24,ENG
9f8e9423,18,11,10,7,1,10,14,4,22,17,5,15,33,88,0,24,ENG
a011a1e9,2,1,1,1,0,0,0,0,0,0,0,0,2,1,0,24,ENG
a0666d3e,48,27,23,15,10,18,36,18,24,9,15,14,62,23,0,24,ENG
a105d46a,25,13,20,5,0,14,23,9,32,12,20,13,38,44,0,24,ENG
a1390d2f,31,15,14,13,4,17,32,15,27,5,22,14,45,22,2,24,ENG
a1d5bd30,16,9,8,3,5,7,24,17,13,1,12,4,20,16,0,24,ENG
a2852b4f,1,0,0,0,1,1,2,1,3,1,2,0,1,2,0,24,ENG
a2b105e0,42,23,13,22,7,19,52,33,30,5,25,13,55,20,0,24,ENG
a36524bf,35,22,23,11,1,13,18,5,25,9,16,24,59,58,3,24,ENG
a3b03921,12,7,7,5,0,4,10,6,6,0,6,1,13,1,0,24,ENG
a3d94a58,51,32,32,17,2,25,33,8,32,15,17,34,85,81,1,24,ENG
a4ac4b8f,32,19,28,4,0,15,25,10,22,15,7,20,52,71,0,24,ENG
a4e85758,18,11,4,12,2,11,20,9,13,6,7,11,29,34,0,24,ENG
a5212312,7,5,6,1,0,3,6,3,5,4,1,3,10,32,1,24,ENG
a53649b7,12,7,2,6,4,2,7,5,11,0,11,4,16,3,0,24,ENG
a572e291,27,13,16,10,1,14,29,15,12,6,6,26,53,32,0,24,ENG
a65c844b,10,7,8,1,1,7,8,1,6,0,6,1,11,19,0,24,ENG
a681b7b7,23,14,12,7,4,7,17,10,20,15,5,14,37,56,0,24,ENG
a6c58494,6,4,3,3,0,4,11,7,3,0,3,1,7,3,0,24,ENG
a712ca2b,23,12,17,5,1,11,16,5,20,14,6,12,35,63,1,24,ENG
a755db8c,4,2,1,3,0,1,5,4,7,3,4,4,8,17,0,24,ENG
a7588cdc,0,0,0,0,0,0,0,0,0,0,0,0,0,0,0,24,ENG
a78ff07f,115,60,62,41,12,75,116,41,45,8,37,39,154,42,0,24,ENG
a816dbfb,22,11,12,9,1,13,31,18,22,6,16,24,46,30,0,24,ENG
a8748947,21,13,10,9,2,11,23,12,15,4,11,13,34,5,0,24,ENG
a8c0acb7,31,17,21,8,2,20,32,12,21,10,11,20,51,65,1,24,ENG
a8c19eb8,32,17,20,10,2,19,29,10,33,19,14,34,66,117,4,24,ENG
a92ab7be,1,1,1,0,0,1,4,3,1,0,1,0,1,12,0,24,ENG
a9b1c319,12,4,5,6,1,5,9,4,15,7,8,9,21,15,2,24,ENG
a9dc785c,0,0,0,0,0,0,0,0,1,0,1,1,1,11,2,24,ENG
aa849a12,24,12,4,11,9,12,36,24,19,2,17,9,33,18,0,24,ENG
aa888da7,0,0,0,0,0,0,1,1,0,0,0,0,0,0,0,24,ENG
ab651565,2,1,0,0,2,1,4,3,1,0,1,0,2,3,0,24,ENG
ac05f970,11,6,4,4,3,3,9,6,13,3,10,3,14,1,0,24,ENG
ac7e7b1c,5,3,4,1,0,1,3,2,7,1,6,1,6,5,0,24,ENG
ac861941,2,1,2,0,0,2,2,0,3,3,0,2,4,12,0,24,ENG
ad82197c,31,18,18,10,3,21,28,7,26,19,7,17,48,95,2,24,ENG
ae4fc6a4,26,10,2,13,11,12,25,13,15,1,14,8,34,5,0,24,ENG
ae5019e6,52,27,36,14,2,27,58,31,36,11,25,28,80,79,0,24,ENG
aed3a70f,9,6,0,3,6,4,10,6,24,4,20,4,13,20,0,24,ENG
aeed5c06,9,3,3,4,2,3,15,12,8,1,7,6,15,4,0,24,ENG
afe1a491,6,5,2,4,0,3,5,2,8,4,4,1,7,2,0,24,ENG
afed6722,18,10,13,4,1,8,17,9,12,5,7,19,37,30,0,24,ENG
b026bbf6,21,11,12,7,2,11,18,7,11,4,7,9,30,21,0,24,ENG
b0b4fd3e,13,8,6,7,0,6,11,5,12,2,10,6,19,5,0,24,ENG
b217ef29,12,6,7,4,1,8,12,4,16,12,4,9,21,43,0,24,ENG
b28bbd58,17,12,8,2,7,11,24,13,12,0,12,4,21,9,0,24,ENG
b2a81fc6,10,6,9,1,0,8,17,9,5,0,5,1,11,1,0,24,ENG
b2d31e83,51,25,31,18,2,20,52,32,37,13,24,28,79,91,1,24,ENG
b2f9c73e,3,2,1,2,0,1,2,1,1,1,0,0,3,0,0,24,ENG
b3af9be1,12,6,10,2,0,7,11,4,4,2,2,10,22,21,0,24,ENG
b400bde0,20,10,7,7,6,11,25,14,12,0,12,12,32,8,0,24,ENG
b4a014b1,22,12,18,3,1,11,17,6,15,11,4,11,33,54,2,24,ENG
b561db50,14,10,3,7,4,6,18,12,9,2,7,3,17,12,0,24,ENG
b57e066e,8,5,4,2,2,3,7,4,7,1,6,4,12,5,0,24,ENG
b62878a5,52,41,20,22,10,19,34,15,22,0,22,7,59,8,1,24,ENG
b63e789d,1,0,0,1,0,0,1,1,0,0,0,0,1,1,0,24,ENG
b66315ae,20,14,11,4,5,4,16,12,18,1,17,10,30,10,0,24,ENG
b737f944,10,6,6,4,0,3,4,1,9,3,6,9,19,26,0,24,ENG
b8e740fb,22,9,5,10,7,9,24,15,15,1,14,13,35,11,0,24,ENG
b9e1436c,17,12,3,11,3,7,22,15,17,0,17,5,22,6,0,24,ENG
b9f282ec,0,0,0,0,0,0,0,0,0,0,0,0,0,0,0,24,ENG
bac46a10,11,7,8,3,0,5,12,7,9,7,2,4,15,23,0,24,ENG
bb5fbd2b,19,14,9,7,3,8,14,6,5,0,5,11,30,8,0,24,ENG
bbd67769,28,21,12,11,5,20,32,12,14,1,13,9,37,13,0,24,ENG
bc7dc64d,53,26,19,17,17,21,48,27,38,2,36,10,63,15,1,24,ENG
bced0375,40,21,23,13,4,11,27,16,23,6,17,14,54,20,0,24,ENG
be927d03,31,21,16,11,4,18,39,21,14,5,9,18,49,35,2,24,ENG
beb391dd,3,2,3,0,0,1,5,4,0,0,0,1,4,1,0,24,ENG
bf33b257,47,30,23,14,10,26,67,41,36,5,31,24,71,33,3,24,ENG
bf34eebd,8,6,4,3,1,6,15,9,5,0,5,2,10,6,0,24,ENG
bf973eeb,0,0,0,0,0,0,0,0,1,0,1,1,1,0,0,24,ENG
bfc3b3a0,19,13,10,7,2,10,17,7,11,2,9,5,24,18,0,24,ENG
c066d1a5,46,27,23,16,7,20,41,21,20,10,10,14,60,51,2,24,ENG
c1242d4e,0,0,0,0,0,0,0,0,0,0,0,0,0,0,1,24,ENG
c149016b,32,18,7,21,4,12,37,25,17,2,15,14,46,22,1,24,ENG
c17bfb65,30,22,16,12,2,10,30,20,19,5,14,17,47,11,1,24,ENG
c1949191,52,28,34,16,2,36,45,9,34,25,9,42,94,125,1,24,ENG
c1fe2a48,53,32,30,17,6,14,27,13,38,14,24,19,72,35,0,24,ENG
c2731c10,69,42,28,28,13,28,59,31,41,8,33,35,104,14,0,24,ENG
c393a6c4,9,3,8,1,0,5,8,3,9,7,2,12,21,35,1,24,ENG
c40b6180,11,11,8,2,1,6,15,9,7,4,3,9,20,30,1,24,ENG
c4486bac,14,8,5,8,1,8,20,12,14,0,14,6,20,8,0,24,ENG
c47541e0,1,1,1,0,0,0,0,0,0,0,0,0,1,1,0,24,ENG
c596fcb0,4,3,0,2,2,0,4,4,5,0,5,1,5,2,0,24,ENG
c5b7c315,7,3,3,3,1,1,6,5,4,4,0,5,12,18,1,24,ENG
c5bdb6e3,9,6,5,1,3,8,10,2,5,1,4,1,10,5,0,24,ENG
c6220452,29,17,11,13,5,12,27,15,15,9,6,17,46,28,1,24,ENG
c6dc9ecd,19,12,8,8,3,11,27,16,24,3,21,10,29,10,0,24,ENG
c6e8cf1f,25,15,6,13,6,13,29,16,10,3,7,11,36,11,1,24,ENG
c81d773d,17,11,12,5,0,10,15,5,14,10,4,18,35,65,0,24,ENG
c8aa95da,33,23,22,10,1,13,33,20,42,32,10,28,61,107,0,24,ENG
ca18c8f1,19,12,7,7,5,7,18,11,20,1,19,8,27,22,0,24,ENG
ca22ccb0,3,3,1,2,0,1,3,2,1,1,0,0,3,0,0,24,ENG
ca76b087,1,1,1,0,0,0,1,1,2,0,2,1,2,2,0,24,ENG
caa1a7f0,0,0,0,0,0,0,0,0,1,0,1,0,0,0,0,24,ENG
cab9634e,3,2,1,1,1,0,4,4,4,0,4,3,6,10,0,24,ENG
cc2d7ad5,32,18,17,13,2,15,33,18,24,9,15,16,48,69,0,24,ENG
cc77354e,43,29,16,21,6,24,47,23,21,7,14,21,64,16,0,24,ENG
ccce7025,20,13,14,6,0,8,13,5,20,16,4,9,29,61,3,24,ENG
cd1acf9d,28,19,19,8,1,20,67,47,13,1,12,23,51,39,4,24,ENG
cd889153,31,17,15,15,1,12,20,8,34,18,16,29,60,71,0,24,ENG
cdd70dc0,3,0,2,1,0,2,4,2,7,0,7,1,4,0,1,24,ENG
cddf767b,38,24,25,10,3,15,34,19,28,17,11,22,60,124,3,24,ENG
ce4246f5,15,11,9,6,0,4,8,4,30,21,9,21,36,132,0,24,ENG
ce4f40c7,34,17,15,13,6,18,30,12,13,2,11,20,54,12,0,24,ENG
ce5143da,20,8,6,10,4,6,12,6,10,0,10,6,26,15,1,24,ENG
cf134113,1,1,1,0,0,1,1,0,0,0,0,0,1,5,3,24,ENG
d0042ab9,6,2,3,2,1,2,4,2,9,3,6,6,12,31,0,24,ENG
d00d45ab,10,6,3,6,1,5,6,1,2,0,2,0,10,2,0,24,ENG
d04b94db,64,41,41,15,8,31,52,21,34,8,26,30,94,71,0,24,ENG
d0706b27,26,17,21,5,0,13,23,10,22,17,5,18,44,86,1,24,ENG
d0b6129f,62,36,26,32,4,28,49,21,42,17,25,20,82,49,1,24,ENG
d0f72bf1,37,17,31,5,1,19,26,7,46,23,23,30,67,143,3,24,ENG
d2424d1b,15,10,5,9,1,5,8,3,11,3,8,4,19,19,1,24,ENG
d3085b49,11,8,6,2,3,7,13,6,5,1,4,0,11,10,0,24,ENG
d328a254,30,14,4,22,4,8,24,16,29,5,24,18,48,27,1,24,ENG
d38fdf53,24,12,11,10,3,13,28,15,13,3,10,18,42,19,0,24,ENG
d4aa4582,0,0,0,0,0,0,0,0,0,0,0,0,0,0,0,24,ENG
d557d734,16,8,8,6,2,7,13,6,7,2,5,4,20,30,0,24,ENG
d56b9520,50,24,31,14,5,31,47,16,27,4,23,14,64,36,1,24,ENG
d60c03a9,1,1,1,0,0,0,0,0,0,0,0,0,1,0,0,24,ENG
d7553721,17,9,7,7,3,7,10,3,4,1,3,5,22,2,0,24,ENG
d7f99582,3,2,2,1,0,0,0,0,1,0,1,0,3,0,0,24,ENG
d86a1f3e,0,0,0,0,0,0,0,0,0,0,0,0,0,0,0,24,ENG
d8931174,16,11,9,7,0,8,17,9,26,18,8,22,38,66,1,24,ENG
d91f104d,2,0,2,0,0,1,2,1,2,1,1,1,3,2,0,24,ENG
d93c2511,43,21,20,21,2,19,30,11,32,12,20,12,55,45,0,24,ENG
d9565625,61,38,45,9,7,39,54,15,37,14,23,33,94,87,0,24,ENG
da011f18,15,10,8,7,0,8,12,4,5,0,5,3,18,6,0,24,ENG
da052c14,56,30,23,21,12,16,37,21,41,2,39,14,70,12,0,24,ENG
da7b447d,0,0,0,0,0,0,0,0,3,2,1,1,1,2,0,24,ENG
dab84ad2,0,0,0,0,0,0,0,0,0,0,0,0,0,0,0,24,ENG
dad4b285,42,33,23,15,4,29,44,15,16,7,9,16,58,47,1,24,ENG
db4ed67b,9,4,2,4,3,3,9,6,4,1,3,1,10,5,0,24,ENG
dbf053da,1,0,1,0,0,1,3,2,1,0,1,1,2,0,0,24,ENG
dc3e663e,19,12,10,8,1,14,19,5,10,3,7,6,25,25,0,24,ENG
dc4cae05,5,4,2,1,2,2,4,2,3,0,3,2,7,2,0,24,ENG
dc62b55d,24,11,6,15,3,10,30,20,23,7,16,13,37,16,1,24,ENG
dc6f5bdd,0,0,0,0,0,0,0,0,2,1,1,0,0,4,0,24,ENG
dc7f8a28,20,12,8,5,7,7,17,10,17,1,16,15,35,11,2,24,ENG
dd323728,59,32,37,17,5,32,51,19,38,10,28,20,79,47,0,24,ENG
dd745366,0,0,0,0,0,0,0,0,1,0,1,0,0,0,0,24,ENG
de0abf23,0,0,0,0,0,0,0,0,0,0,0,0,0,0,0,24,ENG
de112b84,11,7,4,3,4,6,12,6,11,0,11,1,12,10,0,24,ENG
de31038e,15,10,6,7,2,7,13,6,7,3,4,4,19,11,0,24,ENG
de5b5570,40,24,24,14,2,24,42,18,23,6,17,11,51,11,1,24,ENG
debe38a0,6,4,4,2,0,4,11,7,10,4,6,13,19,39,1,24,ENG
df0a4c90,73,46,39,27,7,29,80,51,40,2,38,46,119,50,0,24,ENG
df10e27c,21,14,13,6,2,9,30,21,21,8,13,8,29,14,1,24,ENG
df3cda47,50,25,16,17,17,19,54,35,18,1,17,13,63,2,1,24,ENG
df8b52a5,31,21,19,9,3,19,35,16,17,8,9,18,49,45,1,24,ENG
e06683ca,32,17,20,9,3,10,12,2,39,27,12,34,66,115,0,24,ENG
e09f279b,12,5,1,6,5,5,12,7,4,1,3,8,20,12,0,24,ENG
e0bc6fdc,82,52,35,35,12,42,65,23,39,9,30,34,116,79,0,24,ENG
e1618c22,17,14,7,5,5,8,16,8,11,2,9,1,18,10,0,24,ENG
e28868f3,0,0,0,0,0,0,1,1,1,1,0,0,0,0,0,24,ENG
e31708b2,0,0,0,0,0,0,0,0,0,0,0,0,0,0,0,24,ENG
e342ad68,13,9,0,5,8,5,17,12,16,1,15,2,15,0,0,24,ENG
e34fc66d,40,25,28,11,1,22,31,9,28,17,11,36,76,155,1,24,ENG
e4238fb1,3,1,1,0,2,1,7,6,3,0,3,1,4,3,0,24,ENG
e46012d4,6,5,1,2,3,4,9,5,3,0,3,2,8,2,0,24,ENG
e514ab62,2,0,1,1,0,1,1,0,1,0,1,0,2,2,0,24,ENG
e541326e,32,21,21,11,0,8,17,9,34,21,13,36,68,144,2,24,ENG
e5478b87,9,7,1,4,4,1,2,1,7,2,5,1,10,9,0,24,ENG
e5a76dfe,0,0,0,0,0,0,0,0,0,0,0,0,0,7,1,24,ENG
e6af02e0,12,4,4,6,2,6,17,11,5,1,4,6,18,8,0,24,ENG
e77dc3b2,19,10,1,11,7,8,21,13,20,4,16,3,22,36,0,24,ENG
e7aa9d7c,7,4,3,4,0,2,3,1,1,0,1,2,9,0,0,24,ENG
e7ca0439,0,0,0,0,0,0,0,0,0,0,0,1,1,0,0,24,ENG
e7ee38c3,0,0,0,0,0,0,0,0,0,0,0,0,0,0,0,24,ENG
e814e1cf,7,6,3,3,1,5,9,4,4,1,3,1,8,0,0,24,ENG
e82900ef,6,3,1,3,2,1,3,2,5,2,3,0,6,1,0,24,ENG
e8832875,23,13,7,11,5,9,17,8,10,1,9,9,32,23,0,24,ENG
e98211e7,14,5,7,4,3,5,13,8,6,2,4,14,28,18,0,24,ENG
e9c0c1b2,1,0,1,0,0,1,1,0,0,0,0,0,1,10,1,24,ENG
ea1a5662,0,0,0,0,0,0,0,0,0,0,0,0,0,1,0,24,ENG
eab957a3,53,34,38,13,2,22,39,17,35,21,14,25,78,112,1,24,ENG
eaeca114,23,13,15,6,2,12,17,5,13,2,11,11,34,44,0,24,ENG
eba1e557,1,1,1,0,0,0,0,0,1,0,1,0,1,0,0,24,ENG
ecad9aa5,1,0,0,1,0,0,0,0,0,0,0,0,1,1,0,24,ENG
ed1e53f3,27,17,10,9,8,12,25,13,22,0,22,13,40,16,1,24,ENG
ed383e43,0,0,0,0,0,0,0,0,0,0,0,0,0,0,0,24,ENG
ed5c0319,14,6,1,6,7,4,11,7,9,0,9,1,15,12,0,24,ENG
edc98fac,6,3,1,5,0,2,4,2,10,4,6,3,9,19,0,24,ENG
ee38d9c5,27,15,4,14,9,14,26,12,12,3,9,11,38,7,1,24,ENG
eebacc07,33,19,17,11,5,11,49,38,22,3,19,26,59,30,0,24,ENG
eed2427e,3,0,1,0,2,1,2,1,3,0,3,1,4,1,0,24,ENG
efd2ec23,18,12,7,6,5,7,21,14,28,1,27,5,23,14,0,24,ENG
f08490a6,6,4,2,3,1,1,4,3,4,0,4,3,9,0,0,24,ENG
f098c03e,6,5,4,2,0,4,4,0,9,6,3,8,14,29,0,24,ENG
f0caab96,37,23,27,7,3,18,25,7,26,14,12,19,56,65,1,24,ENG
f1c42eb3,0,0,0,0,0,0,1,1,0,0,0,1,1,0,0,24,ENG
f230bc30,12,7,5,4,3,7,11,4,5,1,4,2,14,8,0,24,ENG
f315ca93,19,13,9,6,4,9,15,6,9,1,8,6,25,10,0,24,ENG
f31def1e,21,17,7,9,5,13,22,9,15,7,8,8,29,48,0,24,ENG
f449640d,3,2,1,2,0,1,1,0,1,0,1,3,6,2,0,24,ENG
f4e433d4,12,9,7,4,1,5,13,8,5,2,3,5,17,2,0,24,ENG
f5deef4c,15,10,8,7,0,5,13,8,18,9,9,12,27,40,1,24,ENG
f6d7d690,24,16,10,12,2,14,29,15,22,13,9,10,34,19,0,24,ENG
f72293fc,13,4,6,5,2,7,15,8,13,0,13,15,28,16,0,24,ENG
f7b1d4e0,26,17,19,5,2,17,28,11,9,2,7,5,31,11,0,24,ENG
f84a807c,16,8,3,6,7,4,12,8,11,3,8,2,18,23,0,24,ENG
f8eca1b6,1,1,1,0,0,0,2,2,0,0,0,0,1,1,0,24,ENG
f8fcd2a5,12,7,10,2,0,9,16,7,22,16,6,18,30,66,0,24,ENG
fa031b34,16,11,4,8,4,2,9,7,32,6,26,8,24,21,0,24,ENG
fb920f3a,2,1,1,1,0,0,0,0,1,0,1,0,2,2,0,24,ENG
fc027d02,20,9,13,6,1,8,14,6,23,5,18,10,30,27,0,24,ENG
fc076f78,7,4,2,5,0,2,10,8,13,0,13,2,9,0,0,24,ENG
fc15fb84,31,18,12,9,10,17,44,27,38,7,31,16,47,27,0,24,ENG
fdf3cb77,52,35,42,8,2,32,58,26,38,11,27,36,88,83,0,24,ENG
feb5d972,28,20,10,13,5,13,30,17,16,4,12,20,48,22,0,24,ENG
fed7cb61,25,11,3,16,6,11,31,20,25,1,24,15,40,16,0,24,ENG
fed96827,12,11,9,3,0,9,14,5,13,6,7,7,19,30,1,24,ENG
fffea3e5,30,19,11,11,8,9,18,9,9,0,9,8,38,4,0,24,ENG
0033fb1b,0,0,0,0,0,0,1,1,0,0,0,1,1,1,0,24,EL
00963611,2,1,1,1,0,0,3,3,9,7,2,14,16,30,0,24,EL
00a8d210,3,0,3,0,0,1,4,3,2,1,1,1,4,4,0,24,EL
0107757e,0,0,0,0,0,0,0,0,0,0,0,0,0,2,0,24,EL
010857ca,0,0,0,0,0,0,0,0,0,0,0,0,0,0,0,24,EL
01a08323,4,2,0,1,3,2,2,0,8,2,6,0,4,0,0,24,EL
01d00f38,9,7,6,2,1,5,12,7,3,2,1,2,11,6,0,24,EL
01ecd78a,0,2,0,0,0,0,0,0,0,0,0,2,0,0,0,24,EL
032f894e,1,0,0,1,0,0,1,1,3,1,2,1,2,0,0,24,EL
0341a8ec,0,0,0,0,0,0,0,0,0,0,0,0,0,7,0,24,EL
03998238,1,0,1,0,0,1,1,0,2,0,2,0,1,3,0,24,EL
03b2ae29,0,4,0,0,0,0,0,0,0,0,0,16,0,0,0,24,EL
04ac78d2,5,2,4,1,0,3,4,1,7,2,5,4,9,16,0,24,EL
05160902,0,0,0,0,0,0,0,0,0,0,0,0,0,3,0,24,EL
05b00fef,7,4,2,5,0,5,6,1,7,2,5,2,9,12,0,24,EL
061e8e23,0,0,0,0,0,0,1,1,2,0,2,3,3,0,0,24,EL
0683f364,12,11,4,4,4,6,8,2,9,1,8,10,22,8,0,24,EL
06c48679,1,0,0,1,0,0,0,0,3,2,1,2,3,13,0,24,EL
06f33dc8,0,0,0,0,0,0,1,1,2,0,2,0,0,3,0,24,EL
07802f7f,0,0,0,0,0,0,1,1,0,0,0,0,0,1,0,24,EL
080ac8d8,2,2,1,0,1,1,3,2,1,0,1,1,3,2,0,24,EL
08452314,0,0,0,0,0,0,0,0,0,0,0,0,0,0,0,24,EL
089c7323,0,0,0,0,0,0,0,0,0,0,0,0,0,3,0,24,EL
08d37c53,3,1,2,1,0,3,5,2,5,3,2,3,6,11,1,24,EL
0a26ec79,0,0,0,0,0,0,0,0,0,0,0,0,0,0,0,24,EL
0a7fa520,7,5,1,5,1,4,9,5,4,1,3,8,15,4,0,24,EL
0a8fd9cb,0,0,0,0,0,0,2,2,1,0,1,1,1,4,0,24,EL
0abc51f2,2,1,2,0,0,2,2,0,3,1,2,4,6,19,0,24,EL
0ba976e4,3,3,0,0,3,0,1,1,5,0,5,2,5,2,0,24,EL
0bf814ff,0,0,0,0,0,0,0,0,0,0,0,0,0,0,0,24,EL
0bfca6a1,7,6,4,2,1,5,7,2,4,0,4,1,8,8,0,24,EL
0c152537,21,12,6,13,2,12,18,6,11,0,11,4,25,4,0,24,EL
0c7a48f8,8,6,8,0,0,3,10,7,7,4,3,7,15,13,0,24,EL
0cb35466,18,12,12,4,2,11,14,3,8,3,5,9,27,13,0,24,EL
0cbe2ba8,0,0,0,0,0,0,0,0,0,0,0,2,0,0,0,24,EL
0d267745,8,5,5,3,0,1,6,5,7,3,4,8,16,26,0,24,EL
0d274394,0,0,0,0,0,0,0,0,0,0,0,0,0,0,0,24,EL
0d4fd3a0,0,0,0,0,0,0,0,0,1,1,0,1,1,6,0,24,EL
0d7b6576,0,0,0,0,0,0,0,0,1,0,1,1,1,1,0,24,EL
0da3d7ab,2,2,0,2,0,2,3,1,0,0,0,0,2,0,0,24,EL
0dad7403,3,2,0,2,1,2,5,3,3,1,2,5,8,10,0,24,EL
0df2b165,14,7,6,7,1,10,26,16,16,4,12,6,20,10,0,24,EL
0e09dd0d,0,0,0,0,0,0,0,0,0,0,0,0,0,2,0,24,EL
0e100630,0,0,0,0,0,0,1,1,0,0,0,0,0,0,0,24,EL
0eb8ee41,8,4,2,6,0,2,7,5,10,1,9,7,15,7,0,24,EL
0f41e2ee,1,0,1,0,0,1,3,2,0,0,0,0,1,2,0,24,EL
10072610,0,0,0,0,0,0,1,1,0,0,0,0,0,2,0,24,EL
102e2599,1,0,0,0,1,0,2,2,0,0,0,1,2,1,0,24,EL
10549b49,1,1,1,0,0,0,0,0,0,0,0,2,3,0,0,24,EL
10cff752,12,7,6,5,1,5,9,4,11,1,10,2,14,0,0,24,EL
11b9265b,4,3,3,1,0,2,7,5,5,4,1,1,5,4,0,24,EL
1227a22d,3,3,2,1,0,0,1,1,6,4,2,1,4,8,0,24,EL
123d2733,0,0,0,0,0,0,0,0,0,0,0,0,0,0,0,24,EL
12806697,6,3,3,3,0,4,4,0,0,0,0,0,6,4,0,24,EL
1295b5e3,1,0,0,1,0,0,0,0,1,0,1,0,1,2,0,24,EL
12ba7959,5,2,2,3,0,0,3,3,3,1,2,2,7,2,0,24,EL
12c50af5,0,0,0,0,0,0,0,0,1,0,1,0,0,0,0,24,EL
12dcbdcc,12,9,5,3,4,10,14,4,7,2,5,6,18,8,0,24,EL
12dfd92a,8,6,6,2,0,6,8,2,6,4,2,1,9,19,0,24,EL
13b736e9,0,0,0,0,0,0,1,1,0,0,0,3,3,1,0,24,EL
13ca5337,3,3,0,1,2,0,2,2,1,0,1,1,4,1,0,24,EL
13ea2544,9,3,3,5,1,4,4,0,6,2,4,10,19,5,0,24,EL
141b0bd2,8,4,4,4,0,5,9,4,6,2,4,4,12,7,0,24,EL
1443ca7d,1,1,1,0,0,1,3,2,1,1,0,0,1,1,0,24,EL
14b09c41,6,5,5,1,0,2,3,1,6,0,6,5,11,6,0,24,EL
15e1f59b,4,3,2,2,0,3,4,1,4,1,3,3,7,8,0,24,EL
16657b95,17,8,11,6,0,7,12,5,13,3,10,10,27,11,0,24,EL
16ceb862,2,2,0,1,1,0,1,1,0,0,0,1,3,3,0,24,EL
16daec92,2,0,2,0,0,1,2,1,5,0,5,0,2,1,0,24,EL
178ae8f8,3,2,0,2,1,0,1,1,1,0,1,0,3,0,0,24,EL
17c602ca,0,0,0,0,0,0,0,0,0,0,0,0,0,5,0,24,EL
17e1261b,5,1,1,4,0,3,5,2,3,1,2,1,6,6,0,24,EL
185a2732,11,7,7,3,1,3,14,11,6,0,6,2,13,2,0,24,EL
189fb038,3,1,0,2,1,0,0,0,4,0,4,1,4,5,0,24,EL
1971591f,3,2,0,2,1,1,4,3,2,0,2,1,4,4,0,24,EL
1994703a,6,2,4,2,0,2,4,2,2,0,2,4,10,7,0,24,EL
19a9cb70,0,0,0,0,0,0,0,0,0,0,0,0,0,0,0,24,EL
19b3caf7,2,2,2,0,0,1,1,0,1,0,1,2,4,3,0,24,EL
19cda00b,8,7,3,2,3,3,9,6,4,0,4,0,8,3,1,24,EL
1adcf39e,0,0,0,0,0,0,0,0,3,2,1,4,4,9,0,24,EL
1b6862e8,5,3,0,5,0,2,2,0,4,0,4,2,7,1,0,24,EL
1ba6c2b3,0,0,0,0,0,0,0,0,0,0,0,0,0,0,0,24,EL
1bf33a9a,7,4,2,3,2,3,5,2,5,0,5,0,7,4,0,24,EL
1c341b14,5,3,3,0,2,3,7,4,10,2,8,7,12,12,0,24,EL
1c358b2e,14,6,4,9,1,6,6,0,5,1,4,2,16,4,0,24,EL
1c59240b,0,0,0,0,0,0,0,0,0,0,0,1,1,0,0,24,EL
1d2c3e5e,13,10,3,7,3,5,11,6,9,0,9,4,17,4,0,24,EL
1d2d5cc8,1,1,1,0,0,1,1,0,0,0,0,0,1,2,0,24,EL
1d3ba8a5,8,5,6,2,0,6,8,2,12,7,5,1,9,21,0,24,EL
1d42db4a,10,8,6,4,0,6,9,3,7,1,6,12,22,14,2,24,EL
1d54e8f8,1,1,1,0,0,1,1,0,0,0,0,1,2,2,0,24,EL
1d5c96f8,19,11,12,5,2,7,14,7,14,6,8,13,32,11,0,24,EL
1e159d70,1,1,0,0,1,1,4,3,1,0,1,0,1,5,0,24,EL
1e37c986,0,0,0,0,0,0,0,0,1,0,1,0,0,0,0,24,EL
1e4319ac,1,1,1,0,0,0,0,0,0,0,0,0,1,0,0,24,EL
1e9aa637,14,9,8,6,0,10,12,2,0,0,0,6,20,7,0,24,EL
1f1828dd,0,0,0,0,0,0,0,0,0,0,0,0,0,0,0,24,EL
1f2c7b55,13,7,6,6,1,8,11,3,8,1,7,4,17,2,0,24,EL
1f3afdcb,3,3,1,1,1,2,6,4,4,1,3,2,5,4,0,24,EL
1f8c7aa9,0,0,0,0,0,0,0,0,0,0,0,0,0,0,0,24,EL
1f994616,0,0,0,0,0,0,0,0,0,0,0,0,0,1,0,24,EL
1fbbfbde,12,6,7,5,0,8,10,2,4,2,2,4,16,29,0,24,EL
20730eae,2,2,2,0,0,2,4,2,0,0,0,2,4,1,0,24,EL
20b9f052,0,0,0,0,0,0,0,0,1,0,1,0,0,2,0,24,EL
20e73fac,4,2,1,3,0,4,10,6,5,1,4,8,12,2,0,24,EL
2146785a,3,3,1,2,0,1,1,0,4,1,3,2,5,3,0,24,EL
21a260a8,4,1,1,2,1,0,3,3,2,0,2,3,7,0,0,24,EL
2200181e,4,2,1,1,2,2,3,1,0,0,0,3,7,1,0,24,EL
226673c2,0,0,0,0,0,0,0,0,1,0,1,0,0,1,0,24,EL
2319ebe3,5,3,3,0,2,5,7,2,2,0,2,0,5,5,0,24,EL
235a646b,15,8,9,5,1,10,18,8,11,3,8,5,20,23,0,24,EL
242e1043,2,2,1,1,0,1,3,2,2,0,2,1,3,3,0,24,EL
24baba9d,13,9,8,5,0,9,15,6,6,2,4,8,21,23,0,24,EL
24fc70d3,3,2,1,1,1,1,1,0,2,1,1,1,4,3,0,24,EL
25ab9c9c,9,6,5,4,0,3,7,4,3,2,1,7,16,19,0,24,EL
25cde772,9,5,4,4,1,5,13,8,14,1,13,5,14,4,0,24,EL
25e6f8cb,4,1,3,1,0,2,6,4,3,1,2,3,7,5,0,24,EL
25ef5b47,2,1,1,1,0,1,2,1,1,0,1,1,3,1,0,24,EL
26777636,4,3,1,3,0,2,3,1,2,1,1,2,6,0,0,24,EL
26952edc,3,2,3,0,0,1,1,0,0,0,0,0,3,0,0,24,EL
27610955,2,2,1,1,0,0,1,1,2,1,1,1,3,9,0,24,EL
27b030b6,31,24,12,16,3,14,20,6,10,3,7,8,39,15,0,24,EL
27d902c8,0,0,0,0,0,0,0,0,0,0,0,0,0,4,0,24,EL
27d95698,1,0,0,1,0,0,1,1,2,0,2,1,2,0,0,24,EL
27e6fbbc,4,3,2,2,0,2,9,7,4,0,4,2,6,2,0,24,EL
282f75f3,7,6,2,5,0,4,8,4,9,6,3,3,10,9,2,24,EL
28300a16,0,0,0,0,0,0,1,1,0,0,0,0,0,2,1,24,EL
288e1e13,4,4,3,1,0,3,3,0,5,2,3,1,5,10,0,24,EL
28cb9f21,2,0,2,0,0,0,2,2,1,0,1,2,4,2,0,24,EL
2903a856,4,3,2,1,1,1,4,3,3,0,3,2,6,3,0,24,EL
2964fd20,0,0,0,0,0,0,0,0,0,0,0,0,0,0,0,24,EL
2973a975,8,5,6,2,0,5,6,1,9,5,4,2,10,14,0,24,EL
29d0f2ac,1,1,1,0,0,1,5,4,2,1,1,0,1,1,0,24,EL
29fbdc88,0,0,0,0,0,0,0,0,0,0,0,2,2,0,0,24,EL
2a1beb34,9,4,4,2,3,5,15,10,11,2,9,8,17,7,0,24,EL
2a29eb9b,9,8,2,6,1,3,10,7,1,1,0,11,20,11,1,24,EL
2a57edd2,5,3,3,1,1,3,7,4,6,1,5,2,7,20,0,24,EL
2b3efa4a,3,1,1,1,1,3,4,1,2,0,2,1,4,4,0,24,EL
2c08cab0,3,2,0,2,1,0,2,2,3,0,3,2,5,2,0,24,EL
2c70d915,3,1,2,0,1,3,4,1,3,1,2,2,5,5,0,24,EL
2e4f5f03,4,3,3,1,0,2,3,1,2,0,2,0,4,6,0,24,EL
2e820983,0,0,0,0,0,0,1,1,0,0,0,0,0,0,0,24,EL
2e9ddbfb,0,0,0,0,0,0,2,2,2,1,1,1,1,6,0,24,EL
2ef7c612,4,3,0,2,2,2,5,3,5,0,5,2,6,6,0,24,EL
2f18d0b8,0,0,0,0,0,0,0,0,0,0,0,0,0,0,0,24,EL
2f90f6b8,4,2,1,1,2,2,3,1,2,0,2,0,4,8,0,24,EL
2f965a72,0,0,0,0,0,0,0,0,0,0,0,0,0,0,0,24,EL
302527b2,0,0,0,0,0,0,2,2,3,3,0,3,3,14,0,24,EL
307877be,3,3,1,2,0,0,3,3,4,1,3,0,3,10,0,24,EL
30941e96,0,0,0,0,0,0,0,0,0,0,0,1,1,0,0,24,EL
312d7b42,3,2,2,1,0,1,2,1,7,3,4,8,11,25,0,24,EL
313254a3,13,9,4,5,4,6,8,2,8,0,8,4,17,12,0,24,EL
315e74cf,3,2,1,2,0,1,1,0,1,0,1,1,4,1,0,24,EL
3170788d,5,4,2,3,0,1,4,3,6,1,5,3,8,4,0,24,EL
31a62dc7,19,12,7,7,5,9,16,7,14,2,12,10,29,17,2,24,EL
32bb1138,7,4,2,3,2,2,7,5,8,0,8,4,11,4,0,24,EL
32e8417f,1,1,0,1,0,0,1,1,0,0,0,0,1,0,0,24,EL
33144cc5,1,0,0,1,0,1,5,4,0,0,0,4,5,0,0,24,EL
33591ff0,1,0,0,1,0,1,3,2,3,0,3,1,2,1,0,24,EL
33651873,11,7,9,1,1,5,10,5,15,6,9,9,20,22,0,24,EL
33a68b9b,1,0,0,1,0,0,2,2,1,0,1,1,2,6,0,24,EL
33a6a650,2,1,2,0,0,1,3,2,5,5,0,10,12,19,1,24,EL
349cae8f,2,1,2,0,0,1,1,0,2,0,2,2,4,1,0,24,EL
34e393f2,9,5,5,4,0,4,17,13,9,2,7,8,17,7,0,24,EL
3515d404,5,2,0,4,1,1,5,4,4,0,4,5,10,13,0,24,EL
3626daea,6,4,3,3,0,3,5,2,4,3,1,0,6,6,0,24,EL
3642b47f,8,5,4,4,0,6,10,4,4,0,4,6,14,2,0,24,EL
364f602a,4,1,2,2,0,0,1,1,2,0,2,0,4,1,0,24,EL
3694fad1,9,6,5,4,0,3,10,7,5,1,4,7,16,3,1,24,EL
36b76751,2,2,0,0,2,2,2,0,0,0,0,0,2,0,0,24,EL
37268799,8,7,3,5,0,4,12,8,6,1,5,6,14,5,1,24,EL
37337aea,1,1,0,0,1,0,0,0,1,0,1,0,1,2,0,24,EL
374c0932,2,1,2,0,0,0,0,0,5,2,3,1,3,2,0,24,EL
37739c71,1,1,1,0,0,1,1,0,1,0,1,1,2,1,1,24,EL
38bf8baa,2,0,2,0,0,0,0,0,1,1,0,1,3,0,0,24,EL
3935e52e,10,8,2,7,1,6,14,8,2,1,1,13,23,12,0,24,EL
3945764e,0,2,0,0,0,0,0,0,0,0,0,2,0,0,0,24,EL
394be156,10,5,7,3,0,6,7,1,11,2,9,8,18,16,0,24,EL
39b326ed,13,8,5,7,1,5,14,9,9,1,8,4,17,12,0,24,EL
39e1138f,4,4,1,2,1,2,2,0,0,0,0,4,8,5,0,24,EL
3a58d075,0,0,0,0,0,0,1,1,0,0,0,3,3,0,0,24,EL
3a770838,3,0,0,1,2,3,4,1,2,0,2,4,7,1,0,24,EL
3ad56bf8,8,4,3,4,1,5,6,1,4,0,4,2,10,11,0,24,EL
3af19679,13,8,8,4,1,8,12,4,9,1,8,11,24,11,1,24,EL
3b333ac3,3,3,2,1,0,1,1,0,1,1,0,4,7,5,0,24,EL
3b88609d,2,1,1,0,1,0,1,1,1,0,1,0,2,1,0,24,EL
3c0aacd2,0,0,0,0,0,0,1,1,1,0,1,0,0,0,0,24,EL
3c70fb81,7,5,4,2,1,3,8,5,3,1,2,1,8,5,0,24,EL
3c776f8f,2,2,0,2,0,0,1,1,1,0,1,0,2,6,0,24,EL
3c7bc9bd,6,2,0,3,3,4,6,2,4,1,3,3,9,2,0,24,EL
3dd738a1,3,3,3,0,0,2,2,0,3,1,2,1,4,5,0,24,EL
3ef68782,1,1,0,1,0,0,1,1,0,0,0,0,1,0,0,24,EL
3f319bb9,9,5,9,0,0,4,9,5,12,10,2,12,21,52,0,24,EL
3f359b33,5,2,3,2,0,2,5,3,5,4,1,10,15,17,1,24,EL
3f47ebce,0,0,0,0,0,0,0,0,0,0,0,0,0,0,0,24,EL
40e57039,0,0,0,0,0,0,1,1,1,0,1,0,0,2,2,24,EL
40f65c01,1,0,0,0,1,1,2,1,1,0,1,2,3,2,0,24,EL
411fabd7,12,7,5,5,2,6,9,3,6,0,6,3,15,5,0,24,EL
4125cb98,12,9,8,4,0,9,12,3,6,2,4,6,18,17,0,24,EL
414b2ce4,5,3,4,0,1,4,5,1,2,0,2,1,6,2,1,24,EL
415568b5,1,1,0,1,0,1,2,1,3,2,1,3,4,2,0,24,EL
418befe0,13,7,8,4,1,10,17,7,6,4,2,9,22,22,1,24,EL
41eebdf5,9,4,4,4,1,3,4,1,6,2,4,5,14,9,0,24,EL
41f0b196,0,0,0,0,0,0,0,0,0,0,0,0,0,2,0,24,EL
4253363a,17,12,12,5,0,12,17,5,5,1,4,3,20,12,0,24,EL
4256a876,1,1,1,0,0,1,2,1,1,0,1,1,2,2,0,24,EL
4288f249,5,4,3,2,0,1,4,3,4,0,4,0,5,0,0,24,EL
42fdb11d,8,4,2,3,3,4,5,1,4,1,3,1,9,2,0,24,EL
43521f09,11,9,8,2,1,7,18,11,10,0,10,3,14,4,0,24,EL
4353dd07,1,0,0,0,1,1,4,3,9,1,8,3,4,2,0,24,EL
43b78598,0,0,0,0,0,0,0,0,2,1,1,0,0,2,0,24,EL
441197b8,5,3,3,2,0,2,4,2,10,4,6,4,9,26,0,24,EL
443a4bb2,6,4,1,3,2,3,5,2,2,0,2,4,10,1,0,24,EL
45191c29,10,6,6,4,0,4,8,4,1,1,0,6,16,12,0,24,EL
4534a352,6,2,3,3,0,3,7,4,7,6,1,4,10,16,0,24,EL
45922f6d,0,0,0,0,0,0,0,0,0,0,0,0,0,1,0,24,EL
4596da74,4,2,2,2,0,2,2,0,3,0,3,2,6,1,0,24,EL
45b9b619,4,3,2,1,1,2,5,3,2,0,2,0,4,1,0,24,EL
45c29ae7,6,3,1,4,1,1,2,1,1,0,1,0,6,0,0,24,EL
466f9e5b,1,1,0,1,0,1,3,2,0,0,0,0,1,2,0,24,EL
468a7a91,4,4,2,1,1,1,7,6,4,0,4,1,5,0,0,24,EL
47420f02,0,0,0,0,0,0,0,0,0,0,0,0,0,0,0,24,EL
4788cb6b,0,0,0,0,0,0,0,0,0,0,0,0,0,0,0,24,EL
478f023e,0,0,0,0,0,0,0,0,0,0,0,0,0,0,0,24,EL
47c609d5,0,0,0,0,0,0,1,1,0,0,0,0,0,0,0,24,EL
47f82561,0,0,0,0,0,0,0,0,0,0,0,0,0,0,0,24,EL
47fd5136,0,0,0,0,0,0,0,0,3,1,2,5,5,6,0,24,EL
4876c9ab,3,0,1,2,0,0,2,2,7,0,7,3,6,3,0,24,EL
4a1a9578,5,4,0,3,2,3,4,1,3,0,3,0,5,0,0,24,EL
4a1abff3,9,7,4,4,1,2,8,6,11,0,11,5,14,6,1,24,EL
4a396ae9,1,1,1,0,0,0,3,3,1,0,1,1,2,2,0,24,EL
4a478107,2,1,0,0,2,1,1,0,1,0,1,0,2,1,0,24,EL
4a56052c,8,6,2,3,3,2,5,3,4,2,2,5,13,6,0,24,EL
4a5a45c7,8,5,5,3,0,4,13,9,9,1,8,2,10,3,0,24,EL
4adc7b42,11,7,3,5,3,5,12,7,4,2,2,1,12,2,0,24,EL
4b00cd47,15,11,12,3,0,9,19,10,6,4,2,6,21,36,1,24,EL
4b49ed54,2,1,2,0,0,0,0,0,2,0,2,0,2,0,0,24,EL
4b96c347,2,1,0,1,1,1,1,0,2,0,2,0,2,0,0,24,EL
4bce9c16,2,1,0,2,0,2,11,9,6,0,6,2,4,5,1,24,EL
4bd00a50,10,6,4,6,0,7,11,4,12,4,8,6,16,22,0,24,EL
4bd414c1,1,1,1,0,0,0,0,0,1,1,0,1,2,9,0,24,EL
4c184730,0,0,0,0,0,0,0,0,3,0,3,0,0,2,0,24,EL
4c5039bd,0,0,0,0,0,0,0,0,0,0,0,0,0,1,0,24,EL
4c5b714f,12,8,9,3,0,5,9,4,3,1,2,5,17,5,0,24,EL
4d0be953,0,0,0,0,0,0,0,0,0,0,0,0,0,0,0,24,EL
4d2d7ea5,10,7,4,4,2,4,11,7,7,0,7,0,10,3,0,24,EL
4d5a9185,4,3,0,3,1,0,0,0,2,0,2,1,5,2,0,24,EL
4d77b365,7,5,1,2,4,2,5,3,0,0,0,1,8,1,0,24,EL
4d8cd038,0,0,0,0,0,0,0,0,1,0,1,0,0,2,0,24,EL
4dcec659,6,3,2,3,1,2,6,4,9,1,8,0,6,5,1,24,EL
4e6e69b3,4,1,3,1,0,1,1,0,1,0,1,1,5,6,0,24,EL
4f1e6a0b,2,1,1,1,0,0,1,1,3,1,2,0,2,4,0,24,EL
4f565d77,1,0,0,1,0,1,1,0,0,0,0,0,1,0,0,24,EL
4f5a953e,5,5,4,1,0,4,6,2,10,6,4,1,6,33,0,24,EL
4f974391,2,2,0,2,0,0,1,1,0,0,0,0,2,5,1,24,EL
4fac8f81,1,0,1,0,0,0,1,1,3,3,0,2,3,15,0,24,EL
4fb9c88f,6,4,1,3,2,3,7,4,5,1,4,3,9,2,0,24,EL
4fd08daa,7,5,3,3,1,5,7,2,9,5,4,6,13,19,0,24,EL
50e73475,7,6,4,3,0,3,8,5,7,4,3,3,10,10,0,24,EL
50f9bec6,0,0,0,0,0,0,3,3,0,0,0,1,1,0,0,24,EL
5148dcc5,8,7,1,4,3,5,8,3,7,0,7,1,9,0,0,24,EL
5167c97e,0,0,0,0,0,0,0,0,3,1,2,3,3,5,0,24,EL
518f2234,3,0,2,0,1,1,9,8,1,0,1,6,9,2,0,24,EL
51dbeea9,3,2,2,1,0,1,2,1,2,0,2,3,6,4,0,24,EL
5219ab4a,21,15,11,8,2,9,18,9,9,3,6,11,32,20,1,24,EL
524ed774,7,4,2,3,2,3,10,7,6,1,5,5,12,5,0,24,EL
52611641,2,1,1,1,0,1,3,2,2,0,2,2,4,4,0,24,EL
526541e5,0,0,0,0,0,0,0,0,0,0,0,0,0,4,0,24,EL
52d7f819,7,3,5,1,1,4,6,2,4,1,3,5,12,14,1,24,EL
530e7d85,3,1,2,1,0,2,2,0,1,0,1,5,8,9,0,24,EL
53520a67,5,2,1,4,0,3,7,4,1,0,1,5,10,2,0,24,EL
53a13f51,0,0,0,0,0,0,1,1,0,0,0,2,2,2,0,24,EL
540ec57b,2,1,1,1,0,1,2,1,4,0,4,2,4,1,0,24,EL
543b9811,1,0,0,1,0,0,3,3,1,1,0,2,3,2,0,24,EL
54b4dc4e,2,2,1,1,0,1,3,2,1,0,1,5,7,2,1,24,EL
54d608cc,8,6,5,3,0,5,8,3,6,0,6,7,15,6,1,24,EL
54dd7308,6,2,3,3,0,3,3,0,5,2,3,2,8,3,0,24,EL
54e4866f,8,8,3,4,1,4,13,9,4,1,3,4,12,5,1,24,EL
54fcc20c,0,0,0,0,0,0,0,0,0,0,0,0,0,0,0,24,EL
5521f419,2,1,0,1,1,1,2,1,5,1,4,2,4,2,0,24,EL
55b93ae0,0,0,0,0,0,0,0,0,0,0,0,0,0,3,3,24,EL
55bf8287,4,2,4,0,0,4,9,5,6,4,2,11,15,14,1,24,EL
56bcde74,2,1,1,1,0,1,2,1,3,3,0,2,4,7,0,24,EL
56f6f826,10,7,7,3,0,6,12,6,9,3,6,8,18,46,0,24,EL
576817b7,3,2,1,1,1,1,1,0,5,1,4,2,5,3,0,24,EL
576c084f,2,2,2,0,0,0,1,1,0,0,0,0,2,0,0,24,EL
57760e66,2,1,0,2,0,2,4,2,4,0,4,4,6,0,0,24,EL
57827369,2,1,0,1,1,1,1,0,1,0,1,0,2,0,0,24,EL
585fe6ab,4,1,2,1,1,2,4,2,1,0,1,1,5,2,0,24,EL
5885dc48,1,0,0,1,0,1,1,0,1,1,0,0,1,3,0,24,EL
58a05c2e,1,1,0,1,0,0,1,1,1,0,1,1,2,1,0,24,EL
58aae0a9,1,0,0,1,0,0,0,0,2,0,2,0,1,1,0,24,EL
5944af8f,3,3,1,2,0,0,1,1,0,0,0,3,6,7,0,24,EL
59948ef7,0,0,0,0,0,0,1,1,1,0,1,2,2,1,0,24,EL
599d91d0,2,0,2,0,0,2,3,1,1,1,0,1,3,1,0,24,EL
59f0c185,0,0,0,0,0,0,0,0,0,0,0,0,0,1,1,24,EL
5a04fd92,4,1,4,0,0,2,7,5,1,0,1,0,4,0,0,24,EL
5a9dab86,0,0,0,0,0,0,0,0,0,0,0,0,0,2,0,24,EL
5aa1a2a7,0,0,0,0,0,0,0,0,0,0,0,0,0,0,0,24,EL
5aa53281,12,8,8,3,1,5,9,4,7,4,3,7,19,12,0,24,EL
5acc4a10,12,5,4,5,3,6,8,2,2,0,2,8,20,4,0,24,EL
5ada5385,9,9,3,6,0,2,5,3,4,1,3,3,12,3,0,24,EL
5add6a3e,3,2,2,1,0,1,3,2,5,2,3,8,11,6,0,24,EL
5ae499d0,3,3,1,2,0,3,7,4,8,0,8,1,4,4,0,24,EL
5b5c2228,13,9,6,7,0,9,11,2,6,5,1,17,30,27,2,24,EL
5c1663e9,9,5,5,2,2,2,6,4,3,0,3,3,12,2,0,24,EL
5c397195,3,3,0,3,0,1,2,1,7,0,7,1,4,0,1,24,EL
5c550ee1,8,5,6,2,0,5,10,5,3,2,1,3,11,19,0,24,EL
5caa62a7,1,1,1,0,0,1,2,1,1,1,0,0,1,0,0,24,EL
5cbb5ad6,2,2,1,1,0,2,2,0,0,0,0,0,2,1,0,24,EL
5cdddffa,0,0,0,0,0,0,0,0,0,0,0,0,0,0,0,24,EL
5d0e0a1f,6,5,4,2,0,4,9,5,9,3,6,1,7,10,0,24,EL
5d4f7d61,3,1,1,1,1,1,3,2,1,0,1,0,3,1,0,24,EL
5d51b074,2,2,0,1,1,1,1,0,0,0,0,0,2,0,0,24,EL
5d8e331f,24,15,10,13,1,13,23,10,18,4,14,12,36,11,2,24,EL
5d9cff53,2,1,2,0,0,1,2,1,2,0,2,2,4,3,0,24,EL
5e22e2a4,5,3,3,2,0,4,10,6,3,1,2,4,9,8,0,24,EL
5e42afa3,14,3,8,5,1,9,18,9,7,0,7,5,19,9,0,24,EL
5e5273eb,5,4,3,1,1,4,5,1,12,4,8,3,8,2,0,24,EL
5e6355f8,1,0,0,1,0,0,1,1,1,0,1,0,1,0,0,24,EL
5eae500a,4,2,0,3,1,2,3,1,2,1,1,1,5,7,0,24,EL
5ed97752,4,4,2,2,0,1,6,5,2,0,2,1,5,4,0,24,EL
5ed9b537,9,6,7,2,0,4,7,3,5,2,3,6,15,13,0,24,EL
5f26e0c5,7,3,3,2,2,4,5,1,5,2,3,13,20,9,0,24,EL
5f3a46fb,0,6,0,0,0,0,0,0,0,0,0,7,0,0,0,24,EL
5f3d00d1,2,1,1,0,1,0,1,1,1,0,1,0,2,2,0,24,EL
5f5ebdae,0,0,0,0,0,0,0,0,1,1,0,0,0,0,0,24,EL
60713cb3,0,0,0,0,0,0,0,0,0,0,0,0,0,4,0,24,EL
60d90c55,0,0,0,0,0,0,1,1,0,0,0,0,0,0,0,24,EL
611f4f60,10,8,4,4,2,3,9,6,8,2,6,5,15,6,0,24,EL
6191093d,5,3,3,2,0,1,2,1,4,0,4,1,6,0,0,24,EL
6224214f,0,0,0,0,0,0,0,0,0,0,0,0,0,0,0,24,EL
62cf5c04,1,0,0,0,1,1,7,6,4,1,3,2,3,0,0,24,EL
62d7ef38,0,0,0,0,0,0,1,1,0,0,0,0,0,3,1,24,EL
62de9d42,8,7,3,3,2,4,7,3,2,0,2,1,9,3,0,24,EL
6358cb11,11,7,10,1,0,7,12,5,5,2,3,5,16,8,0,24,EL
636247ca,5,3,2,0,3,2,10,8,14,0,14,4,9,4,0,24,EL
638ddf68,5,2,4,1,0,3,11,8,5,3,2,6,11,11,0,24,EL
63f04c6c,4,3,3,1,0,2,3,1,1,0,1,2,6,4,0,24,EL
640d17d5,0,0,0,0,0,0,0,0,0,0,0,0,0,0,0,24,EL
6445d6fe,3,2,3,0,0,0,0,0,1,0,1,0,3,1,0,24,EL
645481cc,8,4,2,4,2,5,10,5,9,0,9,3,11,3,1,24,EL
649b57e9,0,0,0,0,0,0,1,1,1,0,1,2,2,1,0,24,EL
64aadf6b,1,1,0,1,0,1,1,0,0,0,0,0,1,2,0,24,EL
652c4865,0,0,0,0,0,0,2,2,2,1,1,1,1,0,0,24,EL
653222cd,0,0,0,0,0,0,0,0,2,1,1,2,2,7,1,24,EL
6597f8b6,3,3,0,3,0,0,3,3,3,0,3,0,3,0,0,24,EL
65d62814,0,0,0,0,0,0,0,0,0,0,0,0,0,2,0,24,EL
65e4dede,2,0,1,1,0,1,1,0,9,5,4,8,10,21,0,24,EL
6613c819,4,1,2,1,1,3,6,3,4,2,2,12,16,13,0,24,EL
663629ae,3,2,3,0,0,3,6,3,2,0,2,2,5,4,0,24,EL
6637e6a7,12,11,5,6,1,6,25,19,12,0,12,5,17,2,0,24,EL
66a7effe,0,0,0,0,0,0,0,0,0,0,0,0,0,0,0,24,EL
689c9cf4,2,0,0,2,0,2,2,0,0,0,0,0,2,2,0,24,EL
68cf59f0,1,1,1,0,0,0,0,0,0,0,0,0,1,0,0,24,EL
6989550f,0,0,0,0,0,0,0,0,0,0,0,0,0,1,0,24,EL
698f11e3,9,5,2,6,1,3,7,4,15,4,11,12,21,11,0,24,EL
6a54638e,7,5,6,1,0,6,8,2,7,1,6,12,19,26,1,24,EL
6a829019,6,4,2,4,0,4,5,1,0,0,0,1,7,2,0,24,EL
6b91b999,0,0,0,0,0,0,1,1,0,0,0,0,0,4,0,24,EL
6be41a31,3,2,0,2,1,2,7,5,4,0,4,1,4,0,0,24,EL
6c731625,1,0,0,0,1,0,0,0,0,0,0,0,1,0,0,24,EL
6c7762c3,3,2,3,0,0,1,1,0,2,1,1,2,5,4,0,24,EL
6cbf8d0d,1,0,0,0,1,0,0,0,2,0,2,0,1,0,0,24,EL
6d445ffc,5,1,3,2,0,5,5,0,7,4,3,4,9,24,1,24,EL
6e33125f,1,1,1,0,0,0,0,0,6,5,1,1,2,1,1,24,EL
6ea23758,16,9,11,5,0,3,6,3,9,5,4,9,25,21,0,24,EL
6eac907b,1,1,1,0,0,0,0,0,0,0,0,0,1,1,0,24,EL
6eee05f1,7,5,4,3,0,2,7,5,6,2,4,15,22,26,0,24,EL
6f5ec8bb,3,3,3,0,0,0,3,3,1,0,1,0,3,1,0,24,EL
6f7d7bc2,7,2,5,2,0,4,6,2,2,0,2,6,13,7,0,24,EL
6f806d99,6,4,1,3,2,1,6,5,2,0,2,1,7,2,0,24,EL
6fbde63a,13,9,1,8,4,5,12,7,8,2,6,6,19,12,0,24,EL
708d068c,2,0,1,1,0,1,2,1,0,0,0,0,2,0,0,24,EL
70a9cba5,1,1,1,0,0,0,3,3,3,0,3,3,4,1,0,24,EL
70cf63ca,3,1,2,1,0,3,5,2,2,0,2,1,4,0,0,24,EL
71031a25,2,2,0,2,0,0,2,2,0,0,0,0,2,0,0,24,EL
7120a04d,0,0,0,0,0,0,0,0,0,0,0,0,0,0,0,24,EL
712dd708,10,5,6,3,1,6,8,2,3,0,3,5,15,14,0,24,EL
713c144a,2,1,0,2,0,0,3,3,2,0,2,2,4,2,0,24,EL
715e5b0e,10,7,2,5,3,4,8,4,7,0,7,3,13,1,0,24,EL
718a3a5c,14,8,10,4,0,10,12,2,9,4,5,6,20,39,0,24,EL
72603d10,2,2,0,1,1,1,2,1,2,0,2,2,4,1,1,24,EL
7271a7d4,3,3,3,0,0,1,5,4,2,0,2,0,3,4,0,24,EL
731302dc,7,2,3,2,2,3,8,5,2,0,2,1,8,2,0,24,EL
73341ace,6,3,0,3,3,3,3,0,1,0,1,1,7,0,0,24,EL
733f1a7d,2,0,1,1,0,2,3,1,1,0,1,0,2,2,0,24,EL
73c56892,2,1,2,0,0,2,5,3,2,0,2,1,3,2,0,24,EL
73d430c6,6,4,1,2,3,3,9,6,7,1,6,3,9,4,0,24,EL
740a0e28,1,0,1,0,0,0,1,1,1,1,0,2,3,2,0,24,EL
7410d325,3,2,0,0,3,2,4,2,8,2,6,1,4,0,0,24,EL
742a4995,15,8,4,10,1,6,12,6,6,1,5,8,23,7,0,24,EL
742ea558,1,0,0,1,0,1,2,1,0,0,0,0,1,1,0,24,EL
743ffce1,1,0,0,1,0,1,4,3,4,0,4,0,1,7,0,24,EL
7460ca0d,8,4,1,6,1,4,10,6,5,1,4,3,11,4,0,24,EL
74618572,3,2,1,1,1,1,5,4,4,0,4,4,7,6,0,24,EL
74b2cd7e,1,1,0,1,0,0,1,1,3,1,2,2,3,1,1,24,EL
74d4cec6,1,1,0,0,1,0,6,6,1,0,1,0,1,5,0,24,EL
74f2e748,3,3,0,2,1,1,4,3,5,0,5,1,4,3,0,24,EL
75645f0e,5,3,1,3,1,1,4,3,3,0,3,1,6,1,0,24,EL
756ff73f,3,3,1,1,1,0,1,1,1,0,1,0,3,1,0,24,EL
757a3431,8,5,3,4,1,6,8,2,2,0,2,2,10,3,0,24,EL
75b74432,21,13,2,15,4,7,15,8,8,2,6,3,24,9,1,24,EL
760fd987,0,0,0,0,0,0,0,0,1,1,0,0,0,0,0,24,EL
7664c2e8,0,0,0,0,0,0,2,2,2,0,2,1,1,2,0,24,EL
7696cc85,14,8,6,7,1,7,8,1,8,2,6,5,19,17,0,24,EL
76d0e227,0,0,0,0,0,0,2,2,0,0,0,0,0,1,0,24,EL
7713c72a,0,0,0,0,0,0,1,1,1,1,0,0,0,3,0,24,EL
774b7f08,2,1,1,0,1,1,3,2,4,1,3,1,3,4,0,24,EL
77e39b04,10,6,8,2,0,5,10,5,7,0,7,2,12,2,0,24,EL
78f13530,0,0,0,0,0,0,0,0,2,1,1,0,0,0,0,24,EL
78f21137,8,6,2,5,1,6,10,4,8,2,6,2,10,11,0,24,EL
794364d7,3,2,3,0,0,2,5,3,1,0,1,1,4,6,0,24,EL
79b51257,0,0,0,0,0,0,0,0,0,0,0,0,0,1,0,24,EL
79c84d1c,4,2,2,2,0,0,3,3,3,0,3,1,5,1,0,24,EL
79ccb6eb,7,4,4,2,1,3,7,4,4,2,2,5,12,5,0,24,EL
7a11550b,15,11,11,4,0,9,14,5,8,3,5,11,26,12,0,24,EL
7a2e46a8,0,0,0,0,0,0,0,0,0,0,0,0,0,0,0,24,EL
7a391b75,15,9,8,6,1,4,9,5,5,2,3,1,16,5,1,24,EL
7a42d0df,6,6,1,4,1,3,4,1,2,0,2,0,6,3,0,24,EL
7a538238,0,0,0,0,0,0,2,2,7,0,7,4,4,2,0,24,EL
7a6c48f8,5,2,4,1,0,4,5,1,4,3,1,2,7,9,0,24,EL
7af655fe,0,0,0,0,0,0,1,1,0,0,0,0,0,0,0,24,EL
7b04c5cb,1,1,0,0,1,1,1,0,0,0,0,0,1,2,0,24,EL
7b433ed0,1,1,1,0,0,1,2,1,1,0,1,0,1,3,1,24,EL
7b536033,1,1,0,0,1,1,2,1,3,0,3,0,1,1,0,24,EL
7b5f516f,0,0,0,0,0,0,0,0,0,0,0,0,0,0,0,24,EL
7b9ecf02,10,6,7,3,0,6,9,3,5,0,5,10,20,15,0,24,EL
7c104bb7,4,3,1,1,2,1,3,2,6,0,6,2,6,0,0,24,EL
7c2965bb,1,1,0,1,0,1,1,0,0,0,0,0,1,1,0,24,EL
7c2a398c,6,5,2,3,1,5,12,7,8,0,8,0,6,0,0,24,EL
7c3ed041,21,16,19,2,0,11,14,3,8,4,4,10,31,24,0,24,EL
7c41b738,10,8,3,5,2,4,7,3,6,2,4,5,15,2,0,24,EL
7d0b3e46,0,0,0,0,0,0,1,1,0,0,0,0,0,0,0,24,EL
7d31f1cb,1,1,0,1,0,1,1,0,0,0,0,0,1,4,1,24,EL
7d6af698,2,1,1,1,0,1,2,1,0,0,0,2,4,4,0,24,EL
7d704e92,2,2,1,1,0,0,0,0,1,1,0,2,4,14,0,24,EL
7da05fff,8,4,1,5,2,5,9,4,0,0,0,7,15,3,0,24,EL
7e277e7c,1,1,0,1,0,0,6,6,2,0,2,0,1,2,0,24,EL
7e2f45f4,5,3,3,2,0,1,5,4,1,0,1,3,8,2,0,24,EL
7ec723b7,10,6,6,4,0,4,7,3,4,3,1,9,19,9,1,24,EL
7ed08d5c,8,7,5,3,0,3,12,9,6,1,5,3,11,7,0,24,EL
7edfbb8a,3,0,1,2,0,0,0,0,2,1,1,0,3,5,0,24,EL
7f8fb807,0,0,0,0,0,0,0,0,0,0,0,0,0,0,0,24,EL
7f9111ea,20,13,16,2,2,11,15,4,7,2,5,11,31,20,0,24,EL
7f9c5d2d,9,3,5,4,0,6,11,5,4,0,4,4,13,5,0,24,EL
7f9d956a,0,0,0,0,0,0,0,0,0,0,0,0,0,0,0,24,EL
7fcc71d8,5,2,1,2,2,2,7,5,1,0,1,1,6,2,0,24,EL
7fe90ccd,4,3,2,1,1,3,3,0,4,0,4,0,4,5,0,24,EL
7ff1c729,2,1,0,1,1,2,3,1,1,0,1,1,3,1,0,24,EL
7fff395a,1,1,0,0,1,1,3,2,5,1,4,0,1,2,0,24,EL
803e7aca,2,0,1,0,1,0,1,1,1,0,1,1,3,2,0,24,EL
8059806f,10,4,7,2,1,6,8,2,3,1,2,1,11,1,0,24,EL
808035bd,4,2,1,2,1,2,3,1,11,9,2,12,16,44,0,24,EL
819aa8e7,5,3,3,1,1,0,4,4,8,1,7,1,6,0,0,24,EL
81f0781e,5,3,1,3,1,2,4,2,1,0,1,2,7,3,0,24,EL
82464ce3,4,1,2,1,1,3,3,0,0,0,0,3,7,2,0,24,EL
82598b71,1,0,0,0,1,1,1,0,1,0,1,1,2,2,0,24,EL
827651b8,0,0,0,0,0,0,0,0,0,0,0,0,0,0,0,24,EL
82927de4,1,0,1,0,0,1,2,1,3,0,3,8,9,0,0,24,EL
82e12fe7,5,2,2,3,0,3,3,0,2,0,2,1,6,2,0,24,EL
83299cc0,6,2,2,4,0,5,8,3,5,1,4,5,11,1,0,24,EL
8382b207,11,5,6,1,4,6,17,11,17,0,17,8,19,4,0,24,EL
83d074ff,2,0,1,1,0,2,6,4,8,0,8,2,4,2,1,24,EL
841beda7,0,0,0,0,0,0,0,0,0,0,0,0,0,1,0,24,EL
8530dd74,2,0,2,0,0,1,8,7,5,1,4,4,6,4,1,24,EL
856eefa6,0,1,0,0,0,0,0,0,0,0,0,1,0,0,0,24,EL
857411ed,11,4,6,5,0,7,11,4,4,3,1,1,12,10,1,24,EL
8593f88c,0,0,0,0,0,0,1,1,1,0,1,0,0,8,0,24,EL
85bed4ee,2,1,0,0,2,0,1,1,1,0,1,0,2,0,0,24,EL
85f7d1be,0,0,0,0,0,0,0,0,0,0,0,0,0,0,0,24,EL
878f0921,0,0,0,0,0,0,1,1,0,0,0,0,0,0,0,24,EL
8790f988,1,1,0,1,0,1,4,3,3,0,3,0,1,4,0,24,EL
88015937,3,1,0,1,2,1,1,0,3,0,3,1,4,5,0,24,EL
881cd6be,5,3,2,3,0,4,6,2,6,1,5,5,10,2,0,24,EL
8830d81d,0,0,0,0,0,0,0,0,1,0,1,0,0,0,0,24,EL
88a9ea33,12,8,6,4,2,3,7,4,4,1,3,1,13,1,0,24,EL
88d56da3,3,2,1,2,0,2,2,0,3,3,0,6,9,6,0,24,EL
89333def,1,0,1,0,0,0,1,1,8,6,2,3,4,20,0,24,EL
894e0084,3,1,1,1,1,1,3,2,0,0,0,0,3,0,0,24,EL
89b2c8a9,3,2,1,2,0,0,1,1,1,0,1,0,3,0,0,24,EL
89c63f8c,8,8,6,2,0,5,8,3,6,2,4,12,20,13,0,24,EL
8a310070,6,3,3,2,1,3,11,8,5,0,5,3,9,1,1,24,EL
8a6ab963,1,1,1,0,0,1,1,0,0,0,0,0,1,2,1,24,EL
8ae7d0ec,3,1,1,1,1,1,3,2,5,0,5,1,4,3,0,24,EL
8aec0537,10,7,3,5,2,8,15,7,6,1,5,0,10,2,0,24,EL
8af1b3a2,8,5,8,0,0,7,9,2,5,2,3,18,26,20,0,24,EL
8b3ab7ad,8,4,6,1,1,4,9,5,8,2,6,6,14,6,0,24,EL
8b529245,0,0,0,0,0,0,0,0,1,0,1,0,0,0,0,24,EL
8b5504e1,8,5,6,0,2,6,13,7,11,0,11,5,13,4,0,24,EL
8b8a56ce,4,1,3,1,0,2,2,0,4,3,1,2,6,15,1,24,EL
8b8a9bde,9,6,3,5,1,6,9,3,7,3,4,3,12,13,1,24,EL
8bb174fc,8,7,2,5,1,8,11,3,7,0,7,14,22,11,0,24,EL
8bf49cd8,4,3,3,1,0,2,3,1,10,9,1,6,10,39,0,24,EL
8bfbf257,2,2,1,1,0,2,3,1,3,0,3,3,5,2,0,24,EL
8c4b95af,0,5,0,0,0,0,0,0,0,0,0,0,0,0,0,24,EL
8c725b43,8,5,6,1,1,4,5,1,9,5,4,8,16,20,0,24,EL
8c8c07a7,5,3,3,2,0,3,8,5,0,0,0,4,9,5,0,24,EL
8d4baac4,1,0,1,0,0,1,1,0,0,0,0,0,1,0,0,24,EL
8d5d4b89,3,0,0,1,2,1,2,1,0,0,0,0,3,0,0,24,EL
8dfdc6c3,8,4,2,4,2,2,4,2,2,0,2,1,9,1,0,24,EL
8e235926,5,3,1,3,1,1,4,3,0,0,0,1,6,3,0,24,EL
8e3cf6ce,0,0,0,0,0,0,0,0,0,0,0,0,0,0,1,24,EL
8ec56e62,0,0,0,0,0,0,0,0,0,0,0,0,0,0,0,24,EL
8eef18aa,4,1,3,1,0,2,2,0,2,1,1,4,8,9,0,24,EL
8f0435c7,10,5,7,3,0,6,9,3,2,2,0,4,14,18,0,24,EL
8f21b7bd,4,2,1,2,1,1,5,4,1,0,1,1,5,3,0,24,EL
8f4e359f,2,0,1,1,0,2,3,1,3,1,2,1,3,3,1,24,EL
8f7e6783,0,0,0,0,0,0,0,0,2,2,0,0,0,0,0,24,EL
90339309,12,7,8,4,0,8,8,0,6,1,5,4,16,8,1,24,EL
90f8796d,0,0,0,0,0,0,0,0,0,0,0,0,0,0,0,24,EL
90fcf472,0,0,0,0,0,0,0,0,0,0,0,0,0,0,0,24,EL
921f6058,1,1,1,0,0,0,0,0,0,0,0,2,3,1,0,24,EL
925fe145,5,4,2,3,0,2,3,1,0,0,0,3,8,1,0,24,EL
92725c75,2,2,1,1,0,1,1,0,3,1,2,1,3,6,0,24,EL
92868cb5,1,0,0,0,1,0,0,0,2,0,2,0,1,0,0,24,EL
92904961,0,0,0,0,0,0,0,0,1,0,1,0,0,2,0,24,EL
92ffb8f9,24,8,8,13,3,17,33,16,17,6,11,14,38,11,0,24,EL
9319781b,1,1,1,0,0,0,1,1,3,2,1,1,2,2,0,24,EL
9321b8ed,0,0,0,0,0,0,0,0,0,0,0,0,0,0,0,24,EL
9328b835,0,0,0,0,0,0,0,0,0,0,0,0,0,0,0,24,EL
934e1968,1,1,0,1,0,0,2,2,5,1,4,2,3,1,1,24,EL
93508980,0,0,0,0,0,0,0,0,0,0,0,0,0,0,0,24,EL
938d8a55,2,1,0,2,0,2,2,0,1,1,0,8,10,3,0,24,EL
939c6319,2,2,1,1,0,2,3,1,4,0,4,1,3,5,0,24,EL
93c8e934,2,2,1,1,0,1,2,1,2,1,1,0,2,4,0,24,EL
944ae938,7,6,5,2,0,5,6,1,4,1,3,4,11,6,0,24,EL
94721522,2,2,1,0,1,1,2,1,9,6,3,4,6,7,0,24,EL
947e036f,1,0,1,0,0,0,0,0,0,0,0,0,1,0,0,24,EL
953597a1,2,2,0,2,0,2,3,1,1,0,1,2,4,6,0,24,EL
9574709a,0,0,0,0,0,0,0,0,0,0,0,0,0,0,0,24,EL
958ede06,10,8,7,2,1,10,13,3,4,0,4,2,12,11,0,24,EL
96094cbc,2,2,2,0,0,1,1,0,0,0,0,0,2,0,0,24,EL
963829d0,8,5,0,6,2,6,10,4,2,0,2,0,8,1,0,24,EL
967f34d3,0,0,0,0,0,0,0,0,0,0,0,0,0,0,0,24,EL
97e996a7,3,2,2,1,0,1,2,1,3,2,1,9,12,22,0,24,EL
9866afec,19,11,8,8,3,10,25,15,12,4,8,20,39,8,0,24,EL
98e0d76c,0,0,0,0,0,0,0,0,0,0,0,0,0,1,0,24,EL
99351886,0,0,0,0,0,0,0,0,0,0,0,0,0,9,1,24,EL
99549c4b,4,2,1,2,1,2,5,3,3,0,3,0,4,2,0,24,EL
99813635,2,1,0,1,1,1,1,0,0,0,0,1,3,0,0,24,EL
99d660b2,3,3,2,1,0,2,2,0,0,0,0,0,3,0,0,24,EL
9a36ffe4,13,9,2,10,1,3,6,3,11,0,11,3,16,2,0,24,EL
9b5237b1,1,0,1,0,0,1,3,2,1,0,1,1,2,1,0,24,EL
9b6f7fd5,20,13,6,9,5,7,11,4,4,1,3,3,23,4,1,24,EL
9bdb6d1b,3,2,1,2,0,3,6,3,4,0,4,0,3,2,0,24,EL
9bf914b4,1,1,1,0,0,0,1,1,1,0,1,0,1,0,0,24,EL
9c145144,3,2,1,2,0,0,1,1,1,0,1,0,3,1,0,24,EL
9c74fa25,17,11,8,8,1,9,15,6,16,4,12,8,25,13,0,24,EL
9cfbad36,1,1,0,0,1,0,0,0,1,0,1,0,1,1,0,24,EL
9d152938,8,4,7,1,0,5,6,1,7,2,5,2,10,7,0,24,EL
9d689a5b,5,3,1,3,1,3,4,1,4,0,4,4,9,0,0,24,EL
9d7d5334,4,3,3,1,0,0,2,2,1,0,1,0,4,4,0,24,EL
9dc0fa97,2,1,2,0,0,1,2,1,4,4,0,2,4,2,0,24,EL
9e675199,0,0,0,0,0,0,1,1,0,0,0,1,1,0,0,24,EL
9e7483ff,9,6,1,3,5,6,13,7,7,0,7,6,15,0,0,24,EL
9f69eb8f,0,0,0,0,0,0,0,0,0,0,0,0,0,0,0,24,EL
9f84febe,4,3,3,0,1,3,5,2,3,0,3,6,10,8,0,24,EL
a08985b8,9,4,3,4,2,4,6,2,3,2,1,1,10,5,0,24,EL
a09829d7,0,0,0,0,0,0,0,0,1,0,1,0,0,0,0,24,EL
a0b4bb3e,4,4,0,3,1,3,6,3,2,0,2,2,6,0,0,24,EL
a111cf41,0,0,0,0,0,0,0,0,0,0,0,0,0,0,0,24,EL
a1232f4e,1,1,0,1,0,1,2,1,0,0,0,0,1,6,0,24,EL
a1390d2f,2,2,0,2,0,0,0,0,2,0,2,1,3,4,0,24,EL
a1507cc7,12,7,6,4,2,5,12,7,4,0,4,5,17,2,0,24,EL
a17a94d6,2,1,0,2,0,2,3,1,2,1,1,2,4,2,0,24,EL
a1932f00,11,3,1,7,3,4,5,1,5,0,5,5,16,1,0,24,EL
a26fb8aa,10,8,1,7,2,7,11,4,5,1,4,2,12,6,0,24,EL
a29b1131,1,1,1,0,0,1,6,5,0,0,0,0,1,1,0,24,EL
a2abe631,0,0,0,0,0,0,0,0,0,0,0,0,0,1,0,24,EL
a2d9cf74,0,0,0,0,0,0,0,0,1,0,1,0,0,0,0,24,EL
a31f54ca,8,5,5,3,0,3,4,1,4,2,2,2,10,8,0,24,EL
a3eabee0,6,3,6,0,0,2,4,2,2,0,2,3,9,7,0,24,EL
a426a912,5,4,1,3,1,4,4,0,1,0,1,1,6,4,0,24,EL
a4564423,1,1,0,1,0,1,2,1,0,0,0,0,1,0,0,24,EL
a4e85758,3,2,1,2,0,2,4,2,6,1,5,3,6,11,0,24,EL
a55d8df5,7,3,5,1,1,6,9,3,3,0,3,4,11,4,0,24,EL
a5db0bec,7,5,2,4,1,2,6,4,5,0,5,2,9,3,0,24,EL
a62c16d0,2,0,0,2,0,0,2,2,7,0,7,1,3,8,0,24,EL
a63a995f,2,0,2,0,0,2,3,1,0,0,0,4,6,2,0,24,EL
a650c75b,10,8,2,8,0,6,14,8,7,0,7,6,16,6,0,24,EL
a6951bf8,3,2,0,0,3,1,3,2,1,0,1,3,6,2,0,24,EL
a6ee4f55,5,3,2,2,1,1,5,4,1,0,1,2,7,4,0,24,EL
a73c8f95,4,2,1,3,0,1,4,3,11,6,5,4,8,14,0,24,EL
a74ea18d,13,9,9,4,0,8,11,3,4,0,4,5,18,19,1,24,EL
a793f5a8,0,0,0,0,0,0,2,2,3,1,2,1,1,3,1,24,EL
a7bc6c2a,12,5,5,6,1,7,12,5,4,0,4,3,15,6,0,24,EL
a7d48b00,2,2,0,2,0,0,3,3,2,0,2,2,4,5,0,24,EL
a8102ed1,4,3,1,3,0,1,1,0,1,0,1,0,4,0,0,24,EL
a820e429,2,1,0,1,1,0,0,0,4,2,2,0,2,3,0,24,EL
a8327abd,0,0,0,0,0,0,3,3,0,0,0,0,0,1,0,24,EL
a8567629,2,1,0,2,0,2,5,3,2,0,2,4,6,0,0,24,EL
a88c2e88,0,0,0,0,0,0,1,1,0,0,0,0,0,2,0,24,EL
a8fbae1d,1,1,1,0,0,1,1,0,5,4,1,2,3,6,0,24,EL
a9202def,11,9,5,5,1,4,6,2,8,0,8,10,21,5,0,24,EL
a9aa0d1d,5,2,1,1,3,1,4,3,3,0,3,2,7,2,0,24,EL
aa04bee3,0,0,0,0,0,0,0,0,0,0,0,1,1,0,0,24,EL
aad56ca3,6,3,1,3,2,4,7,3,3,1,2,0,6,0,0,24,EL
aafb3d5b,3,1,1,1,1,1,1,0,1,0,1,2,5,1,0,24,EL
ab4b3e35,8,3,3,2,3,4,10,6,7,0,7,3,11,1,0,24,EL
abddf25d,1,0,1,0,0,0,1,1,0,0,0,0,1,0,0,24,EL
ac05f970,0,0,0,0,0,0,0,0,1,0,1,0,0,1,0,24,EL
ac4003af,0,0,0,0,0,0,0,0,0,0,0,0,0,0,0,24,EL
aca0a525,14,9,8,3,3,6,13,7,5,1,4,6,20,3,0,24,EL
acf7e795,0,0,0,0,0,0,0,0,1,1,0,4,4,8,0,24,EL
ad1ffcfd,0,0,0,0,0,0,1,1,1,0,1,1,1,5,0,24,EL
ad9b2747,8,3,4,2,2,0,5,5,4,1,3,5,13,2,0,24,EL
adc77724,1,0,1,0,0,1,2,1,0,0,0,1,2,1,0,24,EL
adfbe1f5,3,3,1,1,1,1,2,1,0,0,0,0,3,4,0,24,EL
ae1159bf,8,7,3,5,0,5,11,6,6,0,6,3,11,30,0,24,EL
ae3e6d85,1,0,1,0,0,1,1,0,2,1,1,2,3,1,0,24,EL
ae94a6c5,24,14,15,8,1,19,26,7,9,3,6,8,32,2,0,24,EL
ae961785,1,1,1,0,0,1,1,0,0,0,0,0,1,0,0,24,EL
ae9898c5,8,4,3,5,0,6,11,5,10,0,10,6,14,3,0,24,EL
aee634bf,6,4,3,2,1,4,5,1,1,1,0,4,10,3,0,24,EL
af0d79a9,9,5,7,2,0,5,8,3,4,1,3,6,15,11,0,24,EL
afb61630,3,2,3,0,0,1,2,1,4,3,1,3,6,1,0,24,EL
afcac9da,3,2,1,2,0,1,2,1,5,0,5,4,7,4,0,24,EL
b003239d,2,2,0,2,0,1,3,2,0,0,0,3,5,13,0,24,EL
b026bbf6,5,4,1,4,0,2,4,2,3,1,2,4,9,2,0,24,EL
b05f4787,0,0,0,0,0,0,0,0,0,0,0,0,0,0,0,24,EL
b060e3b8,8,4,4,4,0,5,8,3,4,0,4,5,13,7,0,24,EL
b146275b,3,2,0,3,0,0,3,3,1,0,1,2,5,3,0,24,EL
b1bfd1d4,2,1,1,1,0,2,3,1,2,1,1,4,6,4,0,24,EL
b1e61f23,8,3,4,4,0,6,14,8,8,3,5,2,10,6,0,24,EL
b1f4086c,8,4,5,3,0,4,9,5,6,1,5,2,10,3,1,24,EL
b217ef29,0,0,0,0,0,0,0,0,3,1,2,1,1,6,0,24,EL
b2bc3b1f,0,0,0,0,0,0,0,0,0,0,0,1,1,0,0,24,EL
b330c3b5,6,5,6,0,0,4,6,2,0,0,0,8,14,3,0,24,EL
b3dcc2cf,14,8,4,7,3,5,13,8,11,3,8,11,25,7,0,24,EL
b494cc0e,0,3,0,0,0,0,0,0,0,0,0,4,0,0,0,24,EL
b4ef3fb5,8,5,5,2,1,6,8,2,5,1,4,2,10,4,0,24,EL
b51b1b9c,5,2,2,3,0,4,5,1,4,1,3,0,5,8,0,24,EL
b558534d,1,1,0,0,1,0,1,1,1,0,1,0,1,1,0,24,EL
b582ff63,12,8,11,1,0,9,21,12,8,0,8,8,20,4,0,24,EL
b5b9bde7,4,2,2,1,1,3,3,0,0,0,0,1,5,2,0,24,EL
b62878a5,16,12,8,7,1,4,10,6,12,0,12,5,21,3,0,24,EL
b686f4c0,2,2,0,1,1,0,1,1,1,0,1,4,6,0,0,24,EL
b6a6e0a7,2,1,0,0,2,2,4,2,2,0,2,1,3,4,0,24,EL
b6b6bfc4,9,5,4,4,1,4,9,5,12,6,6,6,15,31,0,24,EL
b6ca3ab3,9,6,3,4,2,8,9,1,5,0,5,7,16,7,0,24,EL
b70afb45,7,6,1,3,3,3,3,0,4,0,4,1,8,11,0,24,EL
b742cc0d,4,2,4,0,0,2,2,0,2,2,0,2,6,5,0,24,EL
b79d8e93,9,7,6,2,1,4,8,4,7,4,3,6,15,26,2,24,EL
b7b27de0,9,6,3,2,4,5,11,6,2,0,2,1,10,0,0,24,EL
b7bf9318,1,0,1,0,0,0,1,1,0,0,0,0,1,0,0,24,EL
b7d8cbb9,7,3,2,4,1,1,2,1,4,1,3,4,11,6,0,24,EL
b7de5bad,1,1,1,0,0,1,1,0,2,0,2,1,2,4,0,24,EL
b8103669,8,5,1,7,0,1,7,6,14,4,10,6,14,7,0,24,EL
b8a642fc,1,1,0,1,0,0,2,2,0,0,0,0,1,0,0,24,EL
b8bd60fe,5,3,3,2,0,0,6,6,1,0,1,4,9,2,1,24,EL
b8e740fb,9,5,1,5,3,2,2,0,10,0,10,3,12,3,0,24,EL
b90c4a43,0,0,0,0,0,0,0,0,0,0,0,0,0,1,2,24,EL
b9392438,15,8,11,3,1,11,19,8,11,3,8,4,19,10,0,24,EL
b9ae8560,11,5,4,5,2,7,10,3,3,1,2,3,14,3,0,24,EL
b9e1436c,12,8,4,6,2,4,18,14,11,0,11,5,17,2,0,24,EL
ba26440f,3,3,0,2,1,1,2,1,1,0,1,0,3,1,0,24,EL
badcdcae,1,0,0,0,1,0,1,1,0,0,0,0,1,2,0,24,EL
baeac12a,0,0,0,0,0,0,0,0,0,0,0,0,0,0,0,24,EL
bafcf742,5,4,3,2,0,3,10,7,6,1,5,2,7,3,0,24,EL
bb5fbd2b,6,3,1,1,4,2,4,2,2,0,2,0,6,1,0,24,EL
bba30585,9,5,6,3,0,7,8,1,6,1,5,8,17,27,0,24,EL
bbd67769,4,2,2,2,0,4,11,7,8,1,7,2,6,4,0,24,EL
bc647827,9,3,2,6,1,4,6,2,1,0,1,3,12,18,1,24,EL
bc67a0e1,0,0,0,0,0,0,1,1,0,0,0,0,0,1,1,24,EL
bcf5058a,0,0,0,0,0,0,0,0,0,0,0,0,0,4,0,24,EL
bd142efb,7,6,2,4,1,3,4,1,4,2,2,2,9,15,1,24,EL
bd2f622a,4,2,0,3,1,4,5,1,3,0,3,0,4,0,0,24,EL
bd5eb2e5,0,0,0,0,0,0,0,0,0,0,0,1,1,0,0,24,EL
bde35051,9,6,7,1,1,5,9,4,10,6,4,4,13,20,0,24,EL
be47b750,1,1,0,1,0,0,2,2,2,0,2,0,1,2,0,24,EL
be692b64,2,0,1,1,0,0,1,1,0,0,0,3,5,17,0,24,EL
be765073,23,11,12,9,2,14,23,9,13,4,9,10,33,25,0,24,EL
be837003,5,4,2,3,0,4,4,0,0,0,0,1,6,4,0,24,EL
beb391dd,0,0,0,0,0,0,1,1,2,0,2,0,0,0,0,24,EL
beb882a8,13,4,7,4,2,4,11,7,10,4,6,7,20,6,0,24,EL
bece776f,0,0,0,0,0,0,0,0,0,0,0,0,0,0,0,24,EL
bed68338,6,2,1,4,1,3,5,2,4,0,4,1,7,1,0,24,EL
bf075f6b,5,5,1,2,2,1,2,1,2,0,2,3,8,2,0,24,EL
bf356094,0,0,0,0,0,0,0,0,1,0,1,0,0,0,0,24,EL
bf4c41f9,2,2,0,1,1,1,1,0,1,0,1,0,2,3,0,24,EL
bf973eeb,2,2,0,1,1,0,2,2,0,0,0,1,3,0,0,24,EL
bfb2056e,14,14,10,3,1,4,6,2,9,7,2,5,19,36,0,24,EL
bfdb33aa,4,2,2,2,0,1,2,1,7,2,5,1,5,0,0,24,EL
c0295327,0,0,0,0,0,0,1,1,1,1,0,0,0,0,0,24,EL
c0eeaa39,10,7,4,5,1,5,6,1,6,1,5,5,15,0,0,24,EL
c149016b,12,6,2,5,5,5,15,10,7,0,7,9,21,5,0,24,EL
c2357b65,8,3,7,1,0,2,6,4,9,2,7,1,9,5,0,24,EL
c235e803,8,4,5,3,0,4,7,3,9,7,2,6,14,28,1,24,EL
c24014d7,0,0,0,0,0,0,1,1,1,0,1,0,0,0,0,24,EL
c275947b,7,4,3,1,3,3,9,6,8,0,8,2,9,0,0,24,EL
c283ddef,7,5,1,3,3,3,10,7,7,1,6,4,11,2,0,24,EL
c2a15a27,16,12,9,6,1,11,14,3,4,0,4,8,24,5,0,24,EL
c2a6033c,0,0,0,0,0,0,0,0,0,0,0,0,0,0,0,24,EL
c2bd8585,5,3,2,1,2,1,4,3,3,0,3,1,6,1,0,24,EL
c3cf087d,2,2,1,1,0,1,1,0,3,0,3,2,4,3,0,24,EL
c402fb6a,14,12,12,2,0,10,14,4,11,5,6,6,20,40,0,24,EL
c40b6180,0,0,0,0,0,0,0,0,0,0,0,0,0,0,0,24,EL
c43a8336,2,2,0,2,0,1,1,0,0,0,0,2,4,0,0,24,EL
c4a5b4f6,1,1,0,1,0,0,1,1,2,0,2,0,1,1,1,24,EL
c56dc39e,9,5,3,5,1,5,7,2,3,1,2,7,16,7,0,24,EL
c5cbbcff,9,6,4,5,0,5,8,3,3,2,1,7,16,9,0,24,EL
c63f6e46,1,1,0,1,0,0,0,0,0,0,0,0,1,0,0,24,EL
c678ddd7,2,0,1,1,0,0,1,1,4,4,0,1,3,8,0,24,EL
c6f0d5d4,5,4,0,4,1,2,6,4,2,0,2,1,6,1,0,24,EL
c7069d87,13,6,2,10,1,3,6,3,5,0,5,2,15,3,0,24,EL
c75f04f4,0,0,0,0,0,0,0,0,0,0,0,1,1,0,0,24,EL
c762b1a6,2,0,1,0,1,0,3,3,3,1,2,1,3,2,0,24,EL
c84dcc88,1,0,0,0,1,0,0,0,0,0,0,1,2,0,0,24,EL
c8ccc39e,3,3,1,1,1,2,3,1,2,0,2,1,4,1,0,24,EL
c9009a1f,11,7,7,4,0,8,11,3,10,5,5,3,14,27,1,24,EL
ca607d59,0,0,0,0,0,0,1,1,0,0,0,0,0,1,0,24,EL
ca618d23,12,8,2,7,3,5,9,4,10,2,8,0,12,6,0,24,EL
cad3fd4d,5,2,1,3,1,1,2,1,2,0,2,1,6,0,0,24,EL
caf6cc9b,5,5,3,2,0,4,7,3,1,1,0,1,6,2,0,24,EL
cc704d9c,0,0,0,0,0,0,0,0,0,0,0,0,0,0,0,24,EL
cc70a1d5,0,0,0,0,0,0,0,0,0,0,0,0,0,3,0,24,EL
ccbbe661,1,0,0,0,1,1,3,2,0,0,0,1,2,1,0,24,EL
ccd38335,1,1,0,0,1,0,4,4,3,1,2,0,1,0,0,24,EL
cce181df,26,17,7,15,4,12,20,8,7,3,4,23,49,9,1,24,EL
cd1acf9d,5,2,3,2,0,5,6,1,5,1,4,6,11,2,0,24,EL
ce129ae6,0,0,0,0,0,0,0,0,0,0,0,0,0,0,0,24,EL
ce4246f5,2,1,1,1,0,1,1,0,2,1,1,1,3,12,0,24,EL
ce5143da,0,0,0,0,0,0,1,1,1,0,1,0,0,1,0,24,EL
cea59f02,3,2,2,0,1,2,2,0,0,0,0,2,5,0,0,24,EL
cf043a33,3,0,0,2,1,2,3,1,1,0,1,0,3,1,0,24,EL
cf134113,0,0,0,0,0,0,0,0,0,0,0,0,0,0,0,24,EL
cfdacb90,6,5,3,2,1,1,3,2,6,0,6,6,12,2,1,24,EL
d01bbb6f,22,14,5,13,4,7,14,7,13,1,12,3,25,9,0,24,EL
d1046335,9,8,7,2,0,7,7,0,8,5,3,8,17,18,0,24,EL
d1562e2e,9,7,4,4,1,6,9,3,7,1,6,4,13,8,0,24,EL
d17ce930,2,1,2,0,0,0,0,0,2,2,0,3,5,6,1,24,EL
d1fea02e,5,2,2,3,0,3,5,2,6,2,4,5,10,10,1,24,EL
d27a449b,7,6,5,2,0,3,3,0,9,7,2,9,16,23,1,24,EL
d2c580ce,0,0,0,0,0,0,0,0,1,1,0,4,4,7,0,24,EL
d38fdf53,3,2,2,1,0,1,1,0,2,1,1,0,3,4,0,24,EL
d3aaad90,7,4,5,1,1,3,5,2,6,0,6,5,12,4,0,24,EL
d4232ba9,0,0,0,0,0,0,0,0,0,0,0,0,0,0,0,24,EL
d4456fb3,16,10,5,9,2,7,15,8,6,3,3,9,25,11,0,24,EL
d4c9725f,4,4,2,1,1,1,4,3,1,0,1,3,7,11,0,24,EL
d51bd6c5,8,6,4,2,2,2,9,7,5,0,5,3,11,5,0,24,EL
d52b2a9f,0,0,0,0,0,0,0,0,0,0,0,0,0,0,0,24,EL
d5dd5f1f,2,1,1,1,0,1,3,2,7,2,5,3,5,3,0,24,EL
d68e3575,0,0,0,0,0,0,1,1,0,0,0,0,0,0,0,24,EL
d697a2d0,2,1,2,0,0,2,4,2,1,1,0,0,2,9,0,24,EL
d705ba44,7,5,4,2,1,2,4,2,1,0,1,1,8,5,0,24,EL
d7547531,0,0,0,0,0,0,1,1,1,0,1,0,0,1,0,24,EL
d7556379,1,1,0,0,1,0,5,5,2,1,1,1,2,1,1,24,EL
d7abc42e,7,5,3,2,2,3,5,2,1,0,1,3,10,4,0,24,EL
d874b374,2,1,1,1,0,2,2,0,2,0,2,1,3,3,0,24,EL
d87e2cae,1,1,0,1,0,0,0,0,0,0,0,1,2,1,0,24,EL
d97cccc9,7,5,3,3,1,4,5,1,1,0,1,1,8,2,0,24,EL
da27e268,11,8,6,4,1,8,14,6,4,3,1,8,19,11,0,24,EL
da7b447d,2,2,1,1,0,1,1,0,1,1,0,4,6,7,0,24,EL
da7f2781,8,6,4,4,0,6,9,3,3,0,3,10,18,13,0,24,EL
da84230f,1,0,0,0,1,0,0,0,0,0,0,0,1,0,0,24,EL
da887ea1,0,0,0,0,0,0,0,0,1,1,0,1,1,0,0,24,EL
dac2bed8,0,0,0,0,0,0,0,0,0,0,0,0,0,0,0,24,EL
dacd983e,0,0,0,0,0,0,0,0,0,0,0,0,0,0,0,24,EL
dad4b285,8,5,4,3,1,6,9,3,2,1,1,7,15,11,0,24,EL
db092d3b,3,3,0,3,0,0,0,0,0,0,0,0,3,0,0,24,EL
db3164e1,0,0,0,0,0,0,0,0,0,0,0,0,0,1,0,24,EL
db4ed67b,3,1,0,2,1,0,3,3,1,1,0,1,4,2,0,24,EL
dba1f190,8,3,5,3,0,3,8,5,4,0,4,2,10,1,0,24,EL
dbd1b101,0,0,0,0,0,0,0,0,0,0,0,0,0,2,2,24,EL
dcb38abe,3,3,1,1,1,1,4,3,1,0,1,0,3,0,0,24,EL
dcef222b,0,0,0,0,0,0,0,0,0,0,0,0,0,0,0,24,EL
dcfb17f4,13,6,3,5,5,7,12,5,8,0,8,3,16,5,0,24,EL
dd676a97,4,2,3,1,0,2,4,2,0,0,0,1,5,5,0,24,EL
dd95af65,1,0,1,0,0,1,1,0,1,1,0,3,4,6,0,24,EL
de8f6250,6,5,1,4,1,2,3,1,3,0,3,0,6,0,0,24,EL
dee86451,6,4,1,4,1,2,5,3,6,3,3,3,9,5,0,24,EL
df10e27c,5,2,1,2,2,3,9,6,2,0,2,4,9,5,0,24,EL
df8d6029,5,3,2,3,0,2,6,4,7,5,2,7,12,16,0,24,EL
dff153a4,12,8,3,8,1,5,16,11,9,0,9,16,28,18,0,24,EL
e03c2d97,14,11,6,8,0,7,11,4,7,4,3,15,29,14,1,24,EL
e06683ca,1,0,1,0,0,0,1,1,2,2,0,2,3,8,0,24,EL
e0921a4f,1,0,0,0,1,1,6,5,2,0,2,0,1,1,0,24,EL
e095928e,0,0,0,0,0,0,0,0,0,0,0,0,0,0,0,24,EL
e0b113a7,8,5,5,3,0,4,7,3,8,6,2,7,15,3,0,24,EL
e0bc6fdc,12,11,3,9,0,8,9,1,5,1,4,1,13,11,0,24,EL
e0ee850b,0,0,0,0,0,0,0,0,0,0,0,0,0,0,0,24,EL
e0fbd23c,5,3,2,2,1,2,6,4,1,0,1,1,6,6,0,24,EL
e134351a,0,0,0,0,0,0,0,0,0,0,0,0,0,0,0,24,EL
e134b9f9,5,4,2,1,2,2,5,3,0,0,0,6,11,2,0,24,EL
e1ba3d5a,2,1,1,0,1,2,5,3,0,0,0,0,2,0,0,24,EL
e1ceafce,4,1,2,2,0,2,5,3,9,7,2,5,9,9,0,24,EL
e288d4b3,0,0,0,0,0,0,1,1,3,2,1,1,1,4,0,24,EL
e2b384d2,2,1,0,1,1,0,1,1,0,0,0,2,4,4,0,24,EL
e342ad68,0,0,0,0,0,0,1,1,1,0,1,0,0,0,0,24,EL
e358587b,0,0,0,0,0,0,0,0,0,0,0,0,0,0,0,24,EL
e4a47bec,9,5,3,4,2,3,4,1,2,0,2,4,13,3,0,24,EL
e53b5534,1,1,0,1,0,1,2,1,1,0,1,0,1,2,0,24,EL
e599253a,0,0,0,0,0,0,4,4,4,1,3,2,2,2,0,24,EL
e5d01ecf,3,2,0,3,0,2,2,0,4,0,4,5,8,7,0,24,EL
e5d553a8,0,4,0,0,0,0,0,0,0,0,0,3,0,0,0,24,EL
e61b8aee,10,4,3,6,1,5,7,2,3,2,1,2,12,6,1,24,EL
e6679c22,0,0,0,0,0,0,0,0,0,0,0,0,0,0,0,24,EL
e66c698a,10,5,5,5,0,7,9,2,4,1,3,4,14,3,0,24,EL
e66e4ddc,0,0,0,0,0,0,1,1,3,2,1,1,1,2,0,24,EL
e6bc67d7,2,2,1,1,0,1,3,2,1,0,1,0,2,0,0,24,EL
e75129bd,0,0,0,0,0,0,1,1,0,0,0,3,3,1,0,24,EL
e76cb9cc,14,10,10,4,0,11,12,1,13,10,3,13,27,38,2,24,EL
e7aa9d7c,5,2,0,3,2,2,4,2,3,0,3,1,6,1,0,24,EL
e7d59f4f,8,6,2,4,2,4,9,5,7,0,7,4,12,1,0,24,EL
e7fcf289,4,4,1,2,1,3,9,6,5,0,5,3,7,0,0,24,EL
e82adcab,12,8,6,3,3,4,7,3,2,0,2,4,16,4,0,24,EL
e83d5f45,3,2,0,2,1,2,3,1,7,1,6,2,5,0,0,24,EL
e8832875,2,1,1,0,1,2,5,3,4,0,4,0,2,2,0,24,EL
e92cd3f7,0,0,0,0,0,0,0,0,3,0,3,1,1,7,0,24,EL
e935dbbf,14,7,5,7,2,5,10,5,11,3,8,11,25,8,0,24,EL
e95b4604,11,5,2,6,3,5,12,7,7,0,7,3,14,3,0,24,EL
e97fd090,2,1,1,1,0,1,1,0,1,1,0,0,2,0,0,24,EL
e98211e7,4,1,2,2,0,4,5,1,1,1,0,1,5,3,0,24,EL
e9a12436,1,0,1,0,0,0,0,0,0,0,0,0,1,3,1,24,EL
e9b0ccaf,1,1,1,0,0,1,1,0,2,1,1,1,2,3,0,24,EL
e9e41fd0,8,6,1,3,4,3,5,2,3,0,3,4,12,0,0,24,EL
ea83bfa6,1,0,1,0,0,1,1,0,0,0,0,0,1,0,1,24,EL
ead61f73,2,1,2,0,0,2,3,1,1,0,1,1,3,4,0,24,EL
eadc8e4f,23,13,9,13,1,7,12,5,13,2,11,5,28,7,1,24,EL
eb0db257,17,11,7,8,2,6,23,17,18,8,10,10,27,15,0,24,EL
eb2fe5b6,2,1,1,0,1,1,1,0,1,0,1,0,2,2,0,24,EL
eb3022c3,10,6,5,4,1,3,8,5,4,2,2,5,15,5,0,24,EL
eb49bd3f,3,3,3,0,0,2,2,0,1,1,0,2,5,15,0,24,EL
eb6fac77,0,0,0,0,0,0,0,0,0,0,0,0,0,0,0,24,EL
eb7822d7,4,2,2,2,0,2,2,0,2,0,2,10,14,3,0,24,EL
ebadcb80,0,0,0,0,0,0,0,0,0,0,0,0,0,4,0,24,EL
ec11ecf8,2,0,0,0,2,2,2,0,1,0,1,0,2,0,0,24,EL
eca17cf2,0,0,0,0,0,0,0,0,0,0,0,0,0,0,0,24,EL
eccbe56a,2,0,0,2,0,0,2,2,5,0,5,0,2,1,0,24,EL
eccf6574,6,3,1,3,2,0,2,2,1,0,1,0,6,4,0,24,EL
ed45a7d7,2,1,1,1,0,1,1,0,0,0,0,0,2,0,0,24,EL
ed45c4a5,3,1,0,3,0,0,4,4,7,0,7,3,6,3,0,24,EL
ed55b838,3,1,0,1,2,0,2,2,0,0,0,0,3,2,0,24,EL
ed9f7cfe,6,3,5,1,0,4,8,4,4,1,3,8,14,8,0,24,EL
edeb21ff,14,11,13,1,0,9,17,8,4,2,2,2,16,16,0,24,EL
ee3519f5,6,4,2,4,0,3,7,4,2,1,1,1,7,4,1,24,EL
ee3c4b3f,0,0,0,0,0,0,0,0,0,0,0,0,0,0,0,24,EL
ef233486,2,1,0,1,1,1,1,0,1,0,1,0,2,1,0,24,EL
ef322658,4,2,0,4,0,2,9,7,3,0,3,4,8,1,0,24,EL
ef3909cd,1,0,1,0,0,1,3,2,1,0,1,0,1,2,0,24,EL
f0021247,2,1,1,1,0,1,2,1,2,0,2,0,2,0,0,24,EL
f05b0000,0,0,0,0,0,0,0,0,0,0,0,0,0,0,0,24,EL
f0677ed7,13,10,6,6,1,10,12,2,6,2,4,4,17,10,0,24,EL
f07a0fe5,5,4,4,1,0,2,5,3,6,5,1,2,7,26,2,24,EL
f0e4c69e,0,0,0,0,0,0,0,0,0,0,0,0,0,2,0,24,EL
f0e59e3a,1,0,0,1,0,0,0,0,2,0,2,0,1,0,0,24,EL
f17aa65c,8,7,5,1,2,3,12,9,9,2,7,6,14,8,0,24,EL
f1e94cd6,4,3,0,3,1,3,7,4,7,0,7,3,7,3,0,24,EL
f28659fb,0,0,0,0,0,0,1,1,1,0,1,1,1,1,0,24,EL
f2e3b81c,15,9,3,7,5,7,9,2,7,0,7,1,16,6,0,24,EL
f315ca93,10,8,2,4,4,6,6,0,3,0,3,6,16,11,1,24,EL
f3187250,0,0,0,0,0,0,0,0,1,0,1,0,0,0,0,24,EL
f36016a5,1,1,0,0,1,1,3,2,3,1,2,1,2,1,0,24,EL
f360f047,0,0,0,0,0,0,0,0,0,0,0,0,0,0,0,24,EL
f36c432f,0,0,0,0,0,0,2,2,1,0,1,0,0,2,0,24,EL
f36d5624,0,0,0,0,0,0,0,0,1,0,1,3,3,1,0,24,EL
f3e2f544,7,5,7,0,0,6,9,3,7,2,5,7,14,11,0,24,EL
f3e82e37,1,1,1,0,0,1,1,0,0,0,0,0,1,2,0,24,EL
f40dd3c7,2,1,1,0,1,2,6,4,1,0,1,2,4,6,0,24,EL
f47a530a,10,7,6,4,0,3,3,0,5,2,3,1,11,6,1,24,EL
f4e433d4,4,3,3,1,0,3,6,3,3,2,1,8,12,1,0,24,EL
f521b80a,9,4,4,4,1,2,3,1,5,2,3,3,12,26,0,24,EL
f582d5c1,0,0,0,0,0,0,0,0,2,0,2,0,0,0,0,24,EL
f5a00fa4,7,2,1,5,1,6,15,9,2,0,2,2,9,4,0,24,EL
f620b04f,0,0,0,0,0,0,0,0,0,0,0,0,0,0,0,24,EL
f63d8a4b,1,1,0,1,0,0,0,0,2,0,2,2,3,0,0,24,EL
f648b2e1,1,0,1,0,0,0,1,1,1,1,0,1,2,5,1,24,EL
f6d6a31a,0,1,0,0,0,0,0,0,0,0,0,2,0,0,0,24,EL
f6e8ee38,0,0,0,0,0,0,3,3,0,0,0,1,1,1,0,24,EL
f754c59e,2,1,2,0,0,1,4,3,1,0,1,0,2,1,0,24,EL
f7b10c66,0,0,0,0,0,0,0,0,0,0,0,0,0,0,0,24,EL
f80d03ca,2,1,0,1,1,1,4,3,4,0,4,0,2,0,0,24,EL
f820504e,7,3,6,1,0,2,4,2,3,2,1,6,13,6,0,24,EL
f86fe8c1,20,9,14,5,1,8,13,5,7,0,7,9,29,14,0,24,EL
f874dd44,1,1,1,0,0,0,2,2,4,3,1,4,5,1,0,24,EL
f8766ef9,7,5,6,1,0,4,5,1,5,5,0,3,10,38,1,24,EL
f882b0a1,0,0,0,0,0,0,0,0,0,0,0,0,0,0,0,24,EL
f9b1b7bf,0,0,0,0,0,0,0,0,0,0,0,0,0,0,0,24,EL
fa18b6cc,3,0,2,1,0,1,1,0,2,1,1,2,5,2,1,24,EL
fa462ff0,0,1,0,0,0,0,0,0,0,0,0,0,0,0,0,24,EL
fb140eb4,1,1,1,0,0,1,1,0,0,0,0,0,1,3,0,24,EL
fbc471e8,0,0,0,0,0,0,0,0,0,0,0,1,1,1,0,24,EL
fbd6378b,5,3,4,1,0,1,2,1,2,2,0,8,13,14,0,24,EL
fc3697dd,4,2,2,1,1,2,5,3,0,0,0,1,5,0,0,24,EL
fc9b373e,8,6,0,4,4,1,2,1,3,1,2,2,10,3,0,24,EL
fcb38f57,0,0,0,0,0,0,0,0,0,0,0,0,0,1,0,24,EL
fcea4f04,0,0,0,0,0,0,1,1,0,0,0,0,0,0,0,24,EL
fceadb9b,13,10,10,3,0,7,15,8,11,1,10,8,21,13,0,24,EL
fd0a98c8,5,4,4,0,1,2,5,3,1,0,1,2,7,2,0,24,EL
fd7383b8,1,1,1,0,0,1,1,0,0,0,0,0,1,3,1,24,EL
fdbde523,14,9,7,3,4,8,13,5,6,0,6,4,18,14,0,24,EL
fde5fc24,0,0,0,0,0,0,0,0,0,0,0,0,0,0,0,24,EL
fdf3cb77,2,1,1,1,0,1,5,4,2,1,1,2,4,14,0,24,EL
fe0f9f6a,6,2,1,3,2,5,7,2,3,2,1,1,7,1,0,24,EL
fe192f45,10,5,2,5,3,5,10,5,5,0,5,2,12,1,0,24,EL
fe784367,2,1,2,0,0,1,5,4,2,1,1,1,3,2,0,24,EL
fe91e603,1,0,0,1,0,0,0,0,1,1,0,1,2,3,0,24,EL
fec5accc,2,1,0,0,2,1,4,3,0,0,0,1,3,3,0,24,EL
fef20ac5,38,24,17,17,4,12,24,12,11,3,8,9,47,9,1,24,EL
ff20acfe,3,2,1,2,0,1,2,1,0,0,0,3,6,1,0,24,EL
ff2fb007,0,0,0,0,0,0,0,0,1,0,1,0,0,1,0,24,EL
ff5ea0bf,2,1,2,0,0,1,2,1,0,0,0,0,2,5,0,24,EL
0076ab7f,26,21,15,9,2,14,28,14,17,9,8,22,48,52,0,24,SPA
00b28772,52,36,19,27,6,18,32,14,46,21,25,40,92,53,0,24,SPA
00eba9c9,17,12,7,7,3,3,9,6,13,0,13,11,28,6,0,24,SPA
0107757e,3,1,3,0,0,3,4,1,0,0,0,2,5,9,3,24,SPA
0127419a,11,8,2,8,1,3,10,7,6,0,6,2,13,4,0,24,SPA
0166a73e,2,1,2,0,0,2,7,5,0,0,0,0,2,35,1,24,SPA
01bb93d5,0,0,0,0,0,0,0,0,2,0,2,1,1,0,0,24,SPA
01da7812,15,12,7,6,2,5,25,20,18,3,15,3,18,7,0,24,SPA
01eb744d,13,9,3,4,6,3,12,9,9,0,9,1,14,2,0,24,SPA
02319ad7,21,14,11,7,3,10,23,13,16,1,15,15,36,23,0,24,SPA
02c15616,29,17,15,10,4,11,33,22,27,9,18,11,40,27,0,24,SPA
02d2c436,7,3,4,3,0,4,8,4,3,2,1,8,15,25,0,24,SPA
02ef8778,9,5,4,3,2,3,6,3,3,0,3,1,10,8,0,24,SPA
0302f7b4,1,0,0,0,1,0,0,0,0,0,0,0,1,0,0,24,SPA
036bba5f,72,41,28,40,4,35,89,54,50,13,37,30,102,47,1,24,SPA
047759a0,1,1,0,1,0,0,0,0,1,0,1,1,2,0,0,24,SPA
04bb2b06,1,0,1,0,0,1,1,0,1,0,1,0,1,4,0,24,SPA
04e17fd5,9,7,2,4,3,0,6,6,7,0,7,5,14,18,1,24,SPA
04e531b6,5,2,0,5,0,4,10,6,8,2,6,4,9,6,1,24,SPA
05439de2,13,9,7,5,1,4,8,4,10,7,3,15,28,34,0,24,SPA
056269d7,48,29,33,9,6,32,66,34,31,5,26,15,63,37,1,24,SPA
0630eb63,1,1,0,1,0,1,3,2,1,0,1,2,3,1,0,24,SPA
068f4dec,25,13,4,17,4,11,24,13,13,6,7,3,28,11,0,24,SPA
06efa9dc,27,15,18,7,2,13,16,3,14,4,10,10,37,34,0,24,SPA
070a3904,33,22,11,18,4,9,23,14,19,4,15,15,48,12,0,24,SPA
075fe5a3,2,2,0,2,0,1,1,0,1,1,0,0,2,2,0,24,SPA
08511d65,35,22,26,7,2,21,30,9,25,22,3,30,65,109,0,24,SPA
08593525,2,1,2,0,0,2,3,1,0,0,0,2,4,1,0,24,SPA
09507ffa,6,5,6,0,0,5,5,0,8,8,0,10,16,43,0,24,SPA
0959c2a2,41,29,19,12,10,22,35,13,30,2,28,37,78,29,0,24,SPA
0a69de7b,29,17,16,10,3,15,26,11,16,8,8,18,47,67,1,24,SPA
0abc51f2,36,25,23,8,5,16,25,9,24,13,11,20,56,105,0,24,SPA
0ae4e09a,9,5,1,8,0,1,5,4,13,1,12,6,15,3,0,24,SPA
0af4dcf0,0,0,0,0,0,0,0,0,1,0,1,0,0,0,0,24,SPA
0ba976e4,0,0,0,0,0,0,1,1,0,0,0,0,0,0,0,24,SPA
0c61c77c,4,2,2,1,1,1,5,4,7,2,5,2,6,1,0,24,SPA
0cadc46d,10,5,4,3,3,2,12,10,8,3,5,5,15,23,0,24,SPA
0cb29e91,5,2,4,1,0,2,3,1,2,0,2,1,6,3,0,24,SPA
0d9b2d31,22,18,12,8,2,6,20,14,24,2,22,10,32,6,0,24,SPA
0e4fef6e,19,12,9,5,5,8,22,14,7,1,6,28,47,31,0,24,SPA
0f26ffd7,37,20,22,14,1,25,35,10,12,6,6,24,61,37,1,24,SPA
10072610,0,0,0,0,0,0,1,1,0,0,0,0,0,2,0,24,SPA
106c142c,10,3,6,2,2,5,9,4,10,2,8,0,10,12,0,24,SPA
112521d1,40,22,23,13,4,17,26,9,20,4,16,14,54,45,0,24,SPA
1137759d,17,8,6,7,4,5,15,10,10,1,9,8,25,5,0,24,SPA
114bbdee,43,28,36,7,0,22,34,12,20,13,7,27,70,93,2,24,SPA
11b9265b,25,17,16,7,2,8,24,16,8,2,6,19,44,26,0,24,SPA
11fd2b75,27,14,12,15,0,15,30,15,18,5,13,24,51,25,1,24,SPA
1282939a,8,6,3,4,1,4,10,6,8,3,5,6,14,7,0,24,SPA
129af0db,12,7,3,5,4,3,3,0,17,3,14,1,13,24,0,24,SPA
12c50af5,0,0,0,0,0,0,2,2,2,2,0,0,0,4,0,24,SPA
12c6cbef,0,0,0,0,0,0,1,1,0,0,0,0,0,9,2,24,SPA
132ac341,10,8,5,4,1,4,10,6,18,13,5,13,23,96,1,24,SPA
133faa84,8,5,4,4,0,5,9,4,8,6,2,3,11,7,1,24,SPA
1545cf15,16,13,11,5,0,8,16,8,4,2,2,1,17,17,1,24,SPA
15d0c248,7,3,5,2,0,4,5,1,10,4,6,4,11,16,0,24,SPA
162efffd,28,19,9,13,6,13,33,20,21,1,20,9,37,14,2,24,SPA
1633fc8a,8,6,7,1,0,7,8,1,17,11,6,7,15,48,1,24,SPA
16aa3654,19,15,11,5,3,6,20,14,19,2,17,9,28,7,1,24,SPA
174f09a6,37,23,33,4,0,19,33,14,23,9,14,35,72,120,3,24,SPA
175ece4c,15,11,5,10,0,8,18,10,8,1,7,6,21,28,0,24,SPA
184fe4b2,5,3,2,3,0,3,5,2,2,0,2,0,5,3,0,24,SPA
18abe173,8,3,6,2,0,4,8,4,3,1,2,4,12,28,0,24,SPA
18b896d6,20,13,13,3,4,14,18,4,23,18,5,11,31,71,0,24,SPA
18f0a9f0,7,2,4,1,2,2,8,6,4,1,3,2,9,10,0,24,SPA
1944818c,38,27,22,11,5,17,35,18,13,2,11,6,44,28,1,24,SPA
19709006,13,6,1,8,4,3,7,4,6,0,6,4,17,3,0,24,SPA
19b776e9,41,22,14,19,8,17,42,25,20,1,19,13,54,15,0,24,SPA
19c36442,41,27,13,19,9,18,34,16,13,1,12,23,64,5,0,24,SPA
19cae58d,39,21,20,14,5,18,36,18,19,3,16,8,47,16,1,24,SPA
1bacc518,42,26,14,23,5,8,19,11,18,8,10,13,55,28,1,24,SPA
1bda5842,22,15,6,10,6,8,21,13,9,1,8,2,24,6,0,24,SPA
1cb49278,16,10,7,9,0,11,19,8,15,5,10,17,33,36,0,24,SPA
1ccd3dae,2,1,1,0,1,1,5,4,5,0,5,1,3,4,0,24,SPA
1d1691ad,1,0,0,1,0,0,0,0,1,1,0,4,5,2,0,24,SPA
1e159d70,11,4,6,4,1,5,6,1,6,0,6,4,15,34,0,24,SPA
1e465e70,31,15,16,14,1,12,27,15,17,1,16,13,44,8,1,24,SPA
1f079188,36,22,17,14,5,17,42,25,25,4,21,21,57,32,3,24,SPA
1f423a54,62,38,30,28,4,26,60,34,17,5,12,18,80,35,1,24,SPA
1f60244a,33,19,10,16,7,19,37,18,22,1,21,16,49,21,0,24,SPA
1fc474ae,56,39,31,23,2,29,62,33,20,3,17,25,81,49,2,24,SPA
1fda2b14,4,4,1,3,0,2,4,2,2,0,2,0,4,5,0,24,SPA
1fe0492d,32,19,16,14,2,15,22,7,17,5,12,20,52,52,0,24,SPA
200e89e1,23,13,4,13,6,7,21,14,9,1,8,5,28,3,0,24,SPA
20a65cdf,0,7,0,0,0,0,0,0,0,0,0,7,0,0,0,24,SPA
211589b8,0,0,0,0,0,0,0,0,0,0,0,0,0,0,0,24,SPA
21166ff4,1,1,1,0,0,0,0,0,1,0,1,1,2,7,0,24,SPA
220c11f1,14,11,4,6,4,4,7,3,9,2,7,5,19,13,0,24,SPA
22371dee,1,0,0,0,1,0,0,0,1,0,1,0,1,1,0,24,SPA
228b0d9d,36,21,20,10,6,24,35,11,16,8,8,9,45,33,0,24,SPA
23610943,32,20,12,16,4,21,42,21,15,2,13,8,40,31,1,24,SPA
237a3851,26,11,11,14,1,11,22,11,11,0,11,8,34,6,0,24,SPA
23cbf863,11,5,8,1,2,7,12,5,3,0,3,1,12,11,0,24,SPA
240d3a0b,10,5,1,5,4,8,18,10,7,1,6,7,17,6,0,24,SPA
2475cf9b,27,17,18,9,0,14,19,5,30,20,10,12,39,72,0,24,SPA
253a06b9,5,3,1,3,1,4,14,10,16,0,16,5,10,12,0,24,SPA
25b82f9a,3,1,1,2,0,0,1,1,1,0,1,1,4,1,0,24,SPA
274ab13c,25,13,19,5,1,13,29,16,18,12,6,11,36,94,3,24,SPA
2784f898,0,0,0,0,0,0,0,0,1,0,1,0,0,1,0,24,SPA
27dc1378,69,48,33,30,6,34,62,28,38,10,28,38,107,58,0,24,SPA
28d596a0,0,0,0,0,0,0,1,1,0,0,0,0,0,4,0,24,SPA
28e957d7,17,10,9,8,0,7,13,6,18,7,11,9,26,67,0,24,SPA
2946f9a1,14,8,5,7,2,5,10,5,14,8,6,12,26,38,0,24,SPA
2973a975,3,2,2,1,0,2,2,0,0,0,0,0,3,7,0,24,SPA
2a0c8ba4,7,6,2,3,2,6,14,8,4,2,2,4,11,2,0,24,SPA
2a295d33,46,25,28,10,8,29,52,23,29,0,29,13,59,22,0,24,SPA
2ae958ab,0,0,0,0,0,0,0,0,0,0,0,0,0,2,0,24,SPA
2bc7f211,29,15,23,4,2,17,28,11,21,17,4,16,45,93,0,24,SPA
2bea832e,6,4,0,5,1,0,9,9,5,0,5,3,9,16,0,24,SPA
2bed3eab,36,26,22,11,3,23,33,10,27,16,11,23,59,57,2,24,SPA
2bef2bca,24,19,11,12,1,9,13,4,18,9,9,9,33,58,2,24,SPA
2cf496fb,14,8,12,1,1,8,10,2,3,3,0,6,20,21,0,24,SPA
2cfb6e88,2,1,0,2,0,0,0,0,0,0,0,0,2,0,0,24,SPA
2dce876a,12,8,4,8,0,2,16,14,11,1,10,11,23,12,0,24,SPA
2e31f3a6,3,2,3,0,0,3,7,4,0,0,0,2,5,4,0,24,SPA
2e3995cd,2,1,0,2,0,1,2,1,3,0,3,1,3,0,0,24,SPA
2ef08833,0,0,0,0,0,0,0,0,0,0,0,0,0,1,0,24,SPA
2f5c78ca,0,0,0,0,0,0,0,0,0,0,0,0,0,0,0,24,SPA
30061f53,0,0,0,0,0,0,0,0,0,0,0,0,0,0,0,24,SPA
3061e1ec,0,0,0,0,0,0,1,1,0,0,0,0,0,9,0,24,SPA
31d45cc8,4,1,1,3,0,0,1,1,3,1,2,2,6,4,0,24,SPA
31f5b89b,5,3,0,2,3,3,3,0,3,1,2,1,6,1,0,24,SPA
3239a8ed,23,16,16,7,0,8,21,13,28,17,11,23,46,105,2,24,SPA
32974271,7,5,1,4,2,3,5,2,8,0,8,0,7,4,0,24,SPA
3318286e,0,0,0,0,0,0,1,1,0,0,0,0,0,13,2,24,SPA
335fa267,9,5,3,6,0,2,9,7,4,1,3,5,14,2,0,24,SPA
33a68b9b,13,8,8,4,1,5,11,6,5,1,4,7,20,9,1,24,SPA
3423f250,13,7,5,6,2,4,16,12,15,1,14,10,23,8,0,24,SPA
34269bdf,37,26,18,16,3,12,23,11,30,7,23,18,55,46,0,24,SPA
34e393f2,32,19,15,12,5,21,38,17,23,5,18,23,55,34,0,24,SPA
34e39a18,2,1,1,1,0,1,2,1,3,1,2,2,4,5,1,24,SPA
3521abfe,25,15,11,9,5,17,25,8,17,7,10,21,46,62,0,24,SPA
35a6e5c7,0,0,0,0,0,0,0,0,0,0,0,0,0,0,0,24,SPA
35f6db55,16,9,6,5,5,6,18,12,7,1,6,7,23,16,0,24,SPA
3624ce4c,5,3,2,3,0,1,3,2,1,0,1,1,6,8,0,24,SPA
365113c0,40,17,28,8,4,19,35,16,16,7,9,10,50,51,0,24,SPA
3701906c,16,8,4,7,5,5,13,8,16,1,15,5,21,7,0,24,SPA
3741ca58,2,2,1,1,0,2,2,0,0,0,0,0,2,0,0,24,SPA
374ee424,0,0,0,0,0,0,0,0,0,0,0,0,0,19,2,24,SPA
375ed9d7,0,0,0,0,0,0,0,0,0,0,0,0,0,0,0,24,SPA
379652be,13,5,4,9,0,4,12,8,13,0,13,5,18,4,1,24,SPA
379dc075,1,1,0,0,1,1,4,3,3,0,3,0,1,1,0,24,SPA
37db6cae,10,9,1,5,4,4,7,3,8,1,7,1,11,6,0,24,SPA
37e103f8,14,7,5,6,3,8,25,17,21,4,17,4,18,22,0,24,SPA
3828f130,39,17,19,14,6,15,42,27,20,3,17,15,54,33,0,24,SPA
38699c72,1,1,0,1,0,1,3,2,1,0,1,1,2,8,0,24,SPA
38b0cf42,2,0,1,1,0,1,1,0,1,0,1,1,3,3,0,24,SPA
38ce1150,8,3,2,4,2,2,14,12,7,0,7,6,14,13,0,24,SPA
3902e91b,12,7,6,4,2,6,15,9,10,2,8,4,16,9,0,24,SPA
39352da2,2,1,1,1,0,1,3,2,3,0,3,3,5,2,0,24,SPA
39a938cb,0,0,0,0,0,0,0,0,0,0,0,0,0,0,0,24,SPA
3a18abe2,5,4,4,1,0,3,5,2,3,0,3,2,7,13,0,24,SPA
3a9c4b7b,13,7,4,7,2,6,14,8,6,1,5,3,16,10,0,24,SPA
3aa74860,12,11,1,9,2,5,12,7,6,1,5,1,13,4,0,24,SPA
3c16d927,17,10,9,6,2,10,18,8,13,4,9,5,22,19,0,24,SPA
3cefcaef,14,9,11,2,1,10,13,3,10,2,8,13,27,24,1,24,SPA
3d79a68c,30,17,10,14,6,15,41,26,17,0,17,14,44,5,0,24,SPA
3d7e48ce,34,17,21,8,5,16,53,37,19,0,19,4,38,17,0,24,SPA
3d99999d,14,12,3,7,4,4,7,3,2,0,2,3,17,5,1,24,SPA
3e42f707,27,18,19,7,1,15,25,10,40,19,21,16,43,113,2,24,SPA
3ecc11d8,11,7,9,2,0,7,10,3,6,4,2,10,21,21,1,24,SPA
3ee0dd59,46,25,17,27,2,22,39,17,30,8,22,37,83,52,0,24,SPA
3effaa34,2,2,0,0,2,0,3,3,3,0,3,1,3,2,0,24,SPA
3f10bd22,30,21,16,12,2,21,38,17,14,6,8,19,49,36,0,24,SPA
3f79a1c8,29,18,13,10,6,16,39,23,16,4,12,19,48,28,1,24,SPA
3f7bafbe,0,0,0,0,0,0,1,1,0,0,0,0,0,1,0,24,SPA
3fc45c73,8,6,7,1,0,4,5,1,11,10,1,7,15,40,0,24,SPA
405f267a,0,0,0,0,0,0,4,4,0,0,0,1,1,0,0,24,SPA
407feb71,23,14,2,13,8,5,11,6,11,0,11,3,26,1,0,24,SPA
41f32541,9,8,2,4,3,5,9,4,2,0,2,7,16,9,0,24,SPA
4242011c,1,1,1,0,0,1,1,0,0,0,0,0,1,2,0,24,SPA
436a9dd0,38,27,9,24,5,17,30,13,9,1,8,14,52,12,0,24,SPA
44150beb,16,9,15,1,0,8,14,6,13,5,8,5,21,36,1,24,SPA
44330c36,2,1,0,1,1,1,1,0,0,0,0,0,2,1,0,24,SPA
44e07fac,23,12,9,11,3,6,23,17,16,4,12,9,32,39,0,24,SPA
452c3055,0,0,0,0,0,0,0,0,0,0,0,0,0,0,0,24,SPA
45736cec,36,20,13,22,1,16,35,19,19,2,17,26,62,20,2,24,SPA
45e17712,33,19,20,10,3,16,22,6,8,0,8,11,44,37,1,24,SPA
45f771db,0,0,0,0,0,0,0,0,0,0,0,0,0,0,0,24,SPA
46e07328,10,6,4,3,3,3,16,13,9,2,7,3,13,1,0,24,SPA
4737cebe,3,3,2,0,1,0,1,1,2,0,2,1,4,0,0,24,SPA
484ebdb0,5,2,1,4,0,1,5,4,4,1,3,0,5,4,0,24,SPA
4958bfb2,42,27,25,13,4,20,37,17,25,8,17,21,63,42,4,24,SPA
49a6ecbb,0,0,0,0,0,0,0,0,0,0,0,0,0,1,0,24,SPA
49d028db,37,18,17,17,3,20,37,17,39,20,19,30,67,112,1,24,SPA
49dbab27,37,19,14,18,5,16,46,30,24,1,23,16,53,35,0,24,SPA
4a478107,5,3,1,4,0,3,13,10,8,0,8,6,11,4,0,24,SPA
4a633cfe,11,8,8,2,1,5,9,4,6,1,5,7,18,17,0,24,SPA
4accb7e0,1,0,1,0,0,1,1,0,1,0,1,0,1,0,0,24,SPA
4acd733a,9,7,4,5,0,4,6,2,6,1,5,1,10,3,0,24,SPA
4b511457,26,17,14,11,1,11,20,9,10,2,8,9,35,16,0,24,SPA
4bd414c1,18,11,8,9,1,13,22,9,27,20,7,14,32,93,0,24,SPA
4c0a6a48,32,19,7,21,4,9,39,30,21,3,18,14,46,15,0,24,SPA
4c2e9442,5,4,2,2,1,3,4,1,5,3,2,2,7,3,0,24,SPA
4c6facae,28,21,15,8,5,9,25,16,20,3,17,17,45,8,1,24,SPA
4d1666ff,29,19,19,7,3,22,39,17,27,9,18,21,50,77,4,24,SPA
4d753a3f,24,15,17,7,0,16,20,4,13,8,5,9,33,53,2,24,SPA
4dbd0916,3,1,2,1,0,1,2,1,0,0,0,0,3,0,0,24,SPA
4e219ad2,20,14,12,8,0,6,17,11,8,0,8,5,25,3,0,24,SPA
4f255115,31,18,17,13,1,7,15,8,19,12,7,25,56,42,1,24,SPA
506daeac,51,31,26,21,4,26,75,49,22,2,20,27,78,24,0,24,SPA
5083a734,45,24,17,23,5,20,42,22,21,6,15,16,61,34,0,24,SPA
518f2234,25,15,8,10,7,13,34,21,17,2,15,10,35,12,1,24,SPA
53552942,37,19,16,19,2,17,33,16,19,3,16,24,61,20,0,24,SPA
53cad200,21,13,11,9,1,10,16,6,20,4,16,12,33,32,0,24,SPA
540ec57b,25,18,12,10,3,9,18,9,11,1,10,5,30,5,0,24,SPA
5418d47c,0,0,0,0,0,0,0,0,0,0,0,0,0,0,0,24,SPA
5487adcd,12,6,9,2,1,4,6,2,22,15,7,10,22,61,1,24,SPA
5496cc91,0,0,0,0,0,0,2,2,0,0,0,0,0,0,0,24,SPA
55126f3b,52,36,22,24,6,31,61,30,28,9,19,15,67,21,1,24,SPA
5556d20b,14,10,2,11,1,7,13,6,4,1,3,7,21,6,0,24,SPA
555f3a0b,38,21,22,13,3,22,42,20,23,8,15,24,62,74,0,24,SPA
55634fb8,7,4,6,0,1,3,6,3,9,7,2,3,10,29,1,24,SPA
56cafd0a,15,8,9,6,0,11,14,3,19,12,7,15,30,35,1,24,SPA
57827369,2,2,1,0,1,0,2,2,0,0,0,0,2,0,0,24,SPA
57be54ec,2,1,0,0,2,2,2,0,1,0,1,0,2,4,0,24,SPA
57d88cf9,32,27,11,15,6,10,28,18,45,5,40,20,52,14,0,24,SPA
5853ac44,12,8,9,2,1,8,11,3,1,0,1,3,15,6,0,24,SPA
58a9a4d9,35,20,17,13,5,22,55,33,37,4,33,6,41,5,0,24,SPA
58ad9383,1,1,1,0,0,1,1,0,0,0,0,0,1,11,0,24,SPA
58afe001,6,2,3,2,1,1,6,5,1,0,1,2,8,7,0,24,SPA
58eee997,6,2,1,3,2,2,13,11,6,0,6,3,9,2,0,24,SPA
592f3158,89,54,32,52,5,38,82,44,51,10,41,33,122,47,1,24,SPA
59b7d823,32,16,19,9,4,21,44,23,18,2,16,9,41,36,0,24,SPA
59c29820,0,0,0,0,0,0,0,0,0,0,0,0,0,2,0,24,SPA
5a626448,29,18,7,18,4,9,24,15,13,1,12,10,39,19,0,24,SPA
5acc4a10,32,18,17,12,3,15,22,7,19,4,15,22,54,24,1,24,SPA
5ae499d0,31,18,10,15,6,13,29,16,29,8,21,18,49,18,1,24,SPA
5b847bb0,3,2,2,0,1,0,1,1,7,1,6,0,3,15,0,24,SPA
5c4dc0ff,1,1,0,1,0,0,0,0,1,0,1,0,1,2,0,24,SPA
5c7845f6,30,23,20,9,1,18,25,7,26,18,8,30,60,94,3,24,SPA
5c96b017,19,12,3,11,5,6,21,15,18,3,15,8,27,12,0,24,SPA
5ca20b7a,12,7,10,1,1,6,9,3,4,3,1,1,13,10,0,24,SPA
5ccc9672,20,11,11,6,3,7,11,4,14,1,13,5,25,21,1,24,SPA
5cfec13d,30,25,25,4,1,17,25,8,29,23,6,24,54,141,2,24,SPA
5d68f5b2,40,22,27,9,4,26,44,18,24,4,20,12,52,42,0,24,SPA
5db04597,27,15,14,9,4,20,36,16,7,1,6,8,35,18,0,24,SPA
5dcf3e90,2,1,1,1,0,2,3,1,0,0,0,1,3,9,0,24,SPA
5dfc6ad5,29,17,17,12,0,13,19,6,40,21,19,14,43,96,0,24,SPA
5e1028e5,23,17,13,9,1,12,22,10,15,0,15,7,30,4,0,24,SPA
5fa714d5,24,14,8,9,7,11,19,8,17,2,15,10,34,16,0,24,SPA
6025fab1,18,12,9,4,5,7,16,9,9,3,6,18,36,7,0,24,SPA
608f2092,27,20,10,13,4,14,22,8,12,2,10,18,45,34,1,24,SPA
61220da2,2,2,1,1,0,0,2,2,2,1,1,2,4,0,0,24,SPA
6265208f,5,3,1,3,1,0,4,4,7,0,7,5,10,10,0,24,SPA
63787ec5,1,0,1,0,0,0,0,0,0,0,0,0,1,1,0,24,SPA
63b0ca6b,0,0,0,0,0,0,0,0,1,0,1,1,1,0,0,24,SPA
63c5e56b,10,8,7,3,0,6,6,0,8,0,8,3,13,20,0,24,SPA
63d17038,2,2,2,0,0,2,3,1,0,0,0,0,2,10,1,24,SPA
63f04c6c,24,9,17,5,2,9,17,8,13,5,8,11,35,18,0,24,SPA
64c14d49,57,35,34,17,6,15,39,24,20,5,15,14,71,21,1,24,SPA
64e8ed6d,9,5,2,2,5,5,22,17,7,0,7,4,13,16,0,24,SPA
65154df0,20,12,12,3,5,14,39,25,16,0,16,7,27,15,0,24,SPA
66017b9d,24,11,13,7,4,12,18,6,13,5,8,13,37,26,0,24,SPA
66116290,5,4,0,5,0,0,1,1,1,0,1,1,6,3,0,24,SPA
66654daa,15,10,12,2,1,8,14,6,9,5,4,8,23,35,0,24,SPA
6763373d,0,0,0,0,0,0,0,0,2,0,2,0,0,0,0,24,SPA
67669ce7,0,0,0,0,0,0,0,0,0,0,0,0,0,0,0,24,SPA
686cbe7d,14,9,2,7,5,4,8,4,8,0,8,0,14,10,0,24,SPA
691bef82,35,15,23,11,1,21,38,17,30,13,17,16,51,91,0,24,SPA
6a99e0b1,20,14,5,7,8,11,27,16,37,8,29,12,32,24,0,24,SPA
6b5ea2f4,32,21,6,24,2,8,25,17,31,2,29,16,48,23,0,24,SPA
6bca20fe,50,29,13,26,11,15,36,21,18,2,16,11,61,13,1,24,SPA
6c4776b1,1,1,1,0,0,1,3,2,0,0,0,0,1,12,3,24,SPA
6c7762c3,26,15,18,8,0,12,27,15,17,4,13,12,38,44,0,24,SPA
6c811eb7,19,7,6,10,3,8,18,10,13,3,10,3,22,12,0,24,SPA
6ce1f46f,50,32,19,24,7,23,52,29,20,4,16,12,62,8,1,24,SPA
6eaed4eb,25,13,17,7,1,11,20,9,28,14,14,17,42,131,1,24,SPA
6f392eb8,5,4,1,2,2,3,6,3,1,0,1,1,6,3,0,24,SPA
6f4c734d,2,1,0,2,0,1,2,1,0,0,0,0,2,0,0,24,SPA
6f51e382,0,0,0,0,0,0,0,0,0,0,0,0,0,3,2,24,SPA
6f5f82c0,49,33,30,15,4,30,63,33,22,7,15,22,71,64,0,24,SPA
6fb59070,0,0,0,0,0,0,1,1,0,0,0,0,0,1,2,24,SPA
7016332f,0,0,0,0,0,0,0,0,0,0,0,1,0,0,0,24,SPA
70f8e0bd,40,21,18,16,6,20,41,21,29,5,24,13,53,17,0,24,SPA
7111d552,17,12,5,5,7,2,10,8,11,0,11,1,18,3,2,24,SPA
722494dc,1,0,0,1,0,0,1,1,3,0,3,5,6,1,0,24,SPA
7226539b,15,10,5,8,2,7,19,12,11,2,9,15,30,17,1,24,SPA
72947847,5,3,4,1,0,2,5,3,8,3,5,2,7,17,1,24,SPA
72a84002,30,17,20,9,1,15,27,12,31,20,11,22,52,89,0,24,SPA
73000a79,7,4,3,4,0,1,6,5,2,1,1,3,10,7,0,24,SPA
736c14ec,6,4,3,3,0,3,5,2,4,1,3,4,10,0,0,24,SPA
7426f085,24,16,11,10,3,11,16,5,11,4,7,19,43,19,0,24,SPA
7460ca0d,37,26,14,21,2,18,38,20,15,5,10,15,52,25,3,24,SPA
74c2d562,0,0,0,0,0,0,1,1,1,1,0,0,0,1,0,24,SPA
74e90475,79,47,44,27,8,49,82,33,35,7,28,42,121,92,0,24,SPA
75645f0e,0,0,0,0,0,0,3,3,0,0,0,2,2,2,0,24,SPA
757a3431,16,7,9,6,1,9,24,15,18,5,13,5,21,18,0,24,SPA
758dd7f0,10,6,3,4,3,7,11,4,11,2,9,1,11,11,0,24,SPA
75a66bed,5,1,3,1,1,3,4,1,3,0,3,2,7,2,0,24,SPA
76c2a023,77,42,33,42,2,39,80,41,27,13,14,32,109,53,3,24,SPA
7868c973,0,0,0,0,0,0,0,0,0,0,0,0,0,0,0,24,SPA
78841da9,10,5,7,3,0,7,17,10,4,1,3,2,12,10,0,24,SPA
7b9c2d84,57,34,27,25,5,18,28,10,27,5,22,21,78,19,1,24,SPA
7c363088,40,25,16,19,5,13,36,23,25,2,23,13,53,10,0,24,SPA
7dcf86f6,6,4,1,5,0,0,10,10,18,3,15,8,14,6,0,24,SPA
7e98cff1,25,16,9,12,4,11,30,19,23,10,13,19,44,55,2,24,SPA
7f14ec2a,17,12,8,8,1,6,13,7,14,0,14,2,19,7,0,24,SPA
7f9c5d2d,23,18,14,8,1,16,30,14,22,5,17,13,36,51,0,24,SPA
8059806f,15,11,4,10,1,9,14,5,11,0,11,5,20,8,0,24,SPA
808d48f3,33,19,20,9,4,17,28,11,13,4,9,15,48,24,0,24,SPA
81442ecb,22,15,14,8,0,6,9,3,7,1,6,4,26,17,0,24,SPA
819aa8e7,39,24,11,23,5,14,32,18,33,3,30,17,56,13,0,24,SPA
819b3158,26,18,11,14,1,9,30,21,17,3,14,19,45,15,0,24,SPA
81f0781e,24,11,10,7,7,10,23,13,23,7,16,8,32,24,0,24,SPA
82927de4,10,7,2,4,4,6,8,2,8,0,8,12,22,5,1,24,SPA
82ec26c1,49,31,26,13,10,14,35,21,27,0,27,15,64,11,0,24,SPA
833fb62e,11,8,3,6,2,5,11,6,12,1,11,1,12,9,1,24,SPA
84399660,5,2,0,5,0,1,7,6,5,0,5,4,9,2,0,24,SPA
852ddfb8,56,31,39,15,2,31,45,14,38,10,28,33,89,64,0,24,SPA
853ca71c,10,5,2,3,5,1,6,5,3,2,1,1,11,8,0,24,SPA
857cb4f3,1,1,1,0,0,1,1,0,0,0,0,0,1,1,0,24,SPA
85bed4ee,14,8,5,7,2,8,19,11,9,0,9,7,21,2,0,24,SPA
86087757,1,0,1,0,0,1,1,0,0,0,0,0,1,1,0,24,SPA
8696bc90,34,22,15,14,5,16,36,20,20,1,19,10,44,14,0,24,SPA
86a2ba20,14,9,6,7,1,7,15,8,10,2,8,13,27,10,1,24,SPA
86ff856b,4,1,2,0,2,2,8,6,4,0,4,1,5,1,0,24,SPA
873619c6,11,4,2,7,2,3,9,6,6,1,5,1,12,12,0,24,SPA
88050721,38,19,15,17,6,16,42,26,20,3,17,13,51,11,2,24,SPA
89f951b5,30,16,9,12,9,11,19,8,16,5,11,14,44,12,0,24,SPA
8aae94b9,6,3,3,3,0,2,5,3,10,7,3,5,11,26,0,24,SPA
8aafd64f,19,14,9,5,5,6,20,14,13,1,12,8,27,8,0,24,SPA
8ae7d0ec,20,12,5,9,6,6,17,11,22,4,18,7,27,7,0,24,SPA
8bc8829a,5,4,2,3,0,2,2,0,2,0,2,3,8,0,0,24,SPA
8c3c640c,19,15,6,8,5,6,18,12,19,3,16,4,23,10,0,24,SPA
8c4e56cb,12,8,3,6,3,6,18,12,4,0,4,2,14,5,0,24,SPA
8c725b43,31,22,22,9,0,20,33,13,29,18,11,28,59,136,0,24,SPA
8ca358c5,1,1,0,1,0,1,1,0,0,0,0,0,1,0,0,24,SPA
8d47bb39,24,16,17,6,1,13,32,19,31,11,20,16,40,86,1,24,SPA
8d78e732,7,5,0,6,1,3,9,6,10,4,6,7,14,16,0,24,SPA
8e088e04,33,21,17,11,5,15,26,11,14,3,11,14,47,21,0,24,SPA
8e48dc61,47,27,23,19,5,26,55,29,27,9,18,12,59,41,1,24,SPA
8eb55dbb,1,1,0,1,0,0,0,0,1,0,1,1,2,0,0,24,SPA
8f3565b3,19,14,2,11,6,3,11,8,14,5,9,5,24,17,0,24,SPA
8f4541c2,35,20,23,7,5,21,31,10,22,15,7,10,45,46,1,24,SPA
8f5e92a6,12,11,2,7,3,2,15,13,13,0,13,8,20,5,0,24,SPA
8f696594,5,2,0,3,2,3,6,3,2,0,2,1,6,0,0,24,SPA
8f8c6934,0,0,0,0,0,0,2,2,0,0,0,0,0,16,6,24,SPA
90bbd822,28,20,12,9,7,7,31,24,26,0,26,31,59,30,0,24,SPA
90df343e,9,3,3,6,0,6,13,7,2,0,2,3,12,7,0,24,SPA
91f7631f,43,27,13,23,7,22,43,21,14,3,11,11,54,16,0,24,SPA
922dfade,9,8,6,2,1,7,9,2,4,1,3,6,15,2,0,24,SPA
93090f69,7,4,6,0,1,5,7,2,7,5,2,8,15,27,0,24,SPA
94acdd4e,15,8,8,6,1,11,22,11,12,1,11,8,23,10,0,24,SPA
94e01ec6,36,18,20,11,5,25,30,5,28,10,18,13,49,47,0,24,SPA
958d67bb,4,2,2,1,1,2,6,4,5,0,5,2,6,0,0,24,SPA
963829d0,6,4,5,1,0,3,6,3,1,1,0,2,8,6,0,24,SPA
974322dc,40,22,24,11,5,20,32,12,18,7,11,16,56,50,0,24,SPA
9939e168,27,18,14,10,3,17,38,21,29,5,24,13,40,21,0,24,SPA
9970da54,0,0,0,0,0,0,1,1,0,0,0,0,0,16,1,24,SPA
9a0408b6,32,17,13,19,0,14,22,8,20,8,12,25,57,44,0,24,SPA
9a64e67e,25,19,15,10,0,14,25,11,22,13,9,24,49,76,1,24,SPA
9a76c2e9,29,15,17,8,4,15,29,14,26,7,19,11,40,55,0,24,SPA
9a796115,8,4,3,2,3,5,15,10,10,1,9,3,11,6,0,24,SPA
9a93efc9,21,12,17,4,0,13,20,7,13,6,7,13,34,65,1,24,SPA
9b130479,39,26,17,17,5,19,58,39,31,3,28,17,56,19,1,24,SPA
9c137b36,42,26,24,14,4,26,30,4,27,11,16,14,56,75,0,24,SPA
9d33c71a,0,0,0,0,0,0,0,0,1,1,0,0,0,2,0,24,SPA
9e095d72,5,4,0,4,1,3,12,9,6,0,6,6,11,8,0,24,SPA
9e1035f8,7,5,1,4,2,5,14,9,5,0,5,4,11,4,0,24,SPA
9f323c71,53,37,25,22,6,39,62,23,22,5,17,10,63,32,0,24,SPA
9f979eb2,8,7,6,2,0,4,7,3,5,3,2,8,16,33,0,24,SPA
9fb45456,37,23,13,17,7,14,25,11,7,4,3,14,51,22,0,24,SPA
a01c3d54,0,0,0,0,0,0,1,1,0,0,0,0,0,2,1,24,SPA
a0255c67,37,23,17,19,1,16,40,24,11,1,10,11,48,18,0,24,SPA
a08b974a,49,34,16,18,15,19,36,17,29,1,28,14,63,20,0,24,SPA
a0b4bb3e,32,21,11,18,3,11,30,19,17,1,16,8,40,7,0,24,SPA
a10361d2,40,23,12,23,5,23,43,20,35,13,22,31,71,44,3,24,SPA
a1232f4e,4,3,3,1,0,2,2,0,4,4,0,8,12,27,2,24,SPA
a254bbe0,22,9,11,9,2,10,29,19,21,5,16,9,31,10,0,24,SPA
a2c1a8d3,0,0,0,0,0,0,0,0,0,0,0,0,0,0,0,24,SPA
a2d9cf74,0,0,0,0,0,0,0,0,0,0,0,0,0,0,0,24,SPA
a35134ae,14,10,10,4,0,10,16,6,8,4,4,13,27,43,0,24,SPA
a461f098,7,4,3,2,2,2,3,1,1,0,1,1,8,0,0,24,SPA
a4971d84,24,13,12,11,1,11,20,9,23,10,13,18,42,57,0,24,SPA
a4995f48,1,1,1,0,0,1,2,1,0,0,0,0,1,16,2,24,SPA
a4b00319,27,17,11,12,4,13,22,9,16,1,15,13,40,13,1,24,SPA
a4b1028a,38,18,22,14,2,21,37,16,19,4,15,19,57,46,1,24,SPA
a55d8df5,42,24,25,13,4,30,56,26,9,1,8,13,55,30,0,24,SPA
a56da3ba,22,12,13,8,1,14,21,7,14,7,7,7,29,34,1,24,SPA
a6103274,7,1,1,3,3,3,7,4,5,1,4,2,9,8,0,24,SPA
a6536561,1,1,0,1,0,1,3,2,2,0,2,1,2,0,0,24,SPA
a6951bf8,10,5,2,7,1,3,9,6,11,3,8,16,26,14,0,24,SPA
a8981944,48,27,21,19,8,20,40,20,33,7,26,37,85,31,0,24,SPA
a8f21b9f,7,4,2,3,2,4,9,5,9,0,9,4,11,4,0,24,SPA
a96103b2,18,9,8,6,4,8,23,15,9,0,9,3,21,3,0,24,SPA
aa677a35,11,3,7,4,0,7,14,7,11,4,7,13,24,25,0,24,SPA
aad53e64,6,2,2,2,2,3,8,5,2,1,1,2,8,2,0,24,SPA
ab13a5aa,1,1,1,0,0,1,2,1,0,0,0,0,1,7,0,24,SPA
ab7bf91d,35,24,26,7,2,23,38,15,44,21,23,23,58,86,0,24,SPA
abe66106,18,12,4,9,5,8,13,5,11,0,11,1,19,5,0,24,SPA
ac295d9e,1,1,1,0,0,1,2,1,0,0,0,1,2,5,0,24,SPA
ac454a4f,38,22,12,23,3,13,40,27,17,3,14,17,55,23,1,24,SPA
ac7e7b1c,17,9,6,6,5,4,7,3,10,0,10,3,20,4,0,24,SPA
ae14af56,0,0,0,0,0,0,0,0,0,0,0,1,1,0,0,24,SPA
ae48c5cb,39,22,19,14,6,20,49,29,22,2,20,17,56,13,0,24,SPA
ae59b359,26,21,15,11,0,9,19,10,17,4,13,17,43,16,1,24,SPA
ae852b7d,11,6,9,2,0,8,15,7,5,2,3,13,24,22,0,24,SPA
ae9a9b2d,1,1,1,0,0,0,0,0,0,0,0,0,1,0,0,24,SPA
afdc14d7,25,10,9,10,6,11,28,17,14,2,12,3,28,4,1,24,SPA
b05e2dbd,70,36,44,22,4,42,66,24,17,3,14,10,80,42,0,24,SPA
b0fce72c,34,16,8,21,5,17,45,28,15,5,10,27,61,28,1,24,SPA
b151a3f2,1,1,1,0,0,1,1,0,0,0,0,1,2,0,0,24,SPA
b1b99435,10,2,5,4,1,7,13,6,2,0,2,0,10,11,0,24,SPA
b2bd0f6c,13,8,4,7,2,1,15,14,18,0,18,15,28,9,0,24,SPA
b3b9b8b8,26,17,14,12,0,13,21,8,15,8,7,14,40,80,0,24,SPA
b418dbd4,4,4,1,2,1,3,6,3,5,0,5,2,6,5,0,24,SPA
b4819112,12,5,10,2,0,7,11,4,5,1,4,9,21,17,0,24,SPA
b4b4d0a6,1,0,0,0,1,1,1,0,0,0,0,0,1,0,0,24,SPA
b682dcf6,11,5,7,4,0,7,9,2,11,7,4,6,17,45,0,24,SPA
b6e50615,27,20,11,11,5,15,25,10,18,5,13,17,44,50,0,24,SPA
b742cc0d,4,3,3,1,0,4,5,1,3,1,2,3,7,10,0,24,SPA
b793dea2,2,0,2,0,0,2,2,0,1,0,1,0,2,0,0,24,SPA
b7ca5c51,16,11,11,5,0,8,14,6,20,10,10,28,44,100,0,24,SPA
b857bd29,19,16,11,8,0,11,16,5,33,23,10,19,38,64,1,24,SPA
b85bf253,5,2,2,3,0,2,5,3,5,3,2,5,10,10,1,24,SPA
b8bd60fe,30,19,10,14,6,9,14,5,9,2,7,9,39,9,0,24,SPA
b906757a,13,9,7,6,0,6,13,7,20,10,10,24,37,85,0,24,SPA
b92b456a,6,5,3,1,2,1,11,10,5,0,5,1,7,7,0,24,SPA
ba5004e1,36,21,16,16,4,26,45,19,13,3,10,10,46,31,0,24,SPA
bb08bce9,22,17,14,8,0,16,25,9,24,14,10,8,30,81,0,24,SPA
bbf5c11b,2,2,1,1,0,1,2,1,2,0,2,1,3,1,0,24,SPA
bc49fd34,5,2,1,1,3,3,6,3,2,0,2,0,5,1,0,24,SPA
bd4e3824,1,0,1,0,0,1,3,2,3,0,3,0,1,3,0,24,SPA
bd6351cd,52,35,24,20,8,34,51,17,26,6,20,20,72,50,1,24,SPA
bdb624a3,17,11,3,8,6,6,18,12,5,1,4,8,25,5,0,24,SPA
bdc14559,4,3,3,1,0,0,1,1,1,1,0,2,6,5,0,24,SPA
bdc74a8f,44,27,22,18,4,21,35,14,28,10,18,6,50,24,1,24,SPA
bdedffac,0,0,0,0,0,0,0,0,0,0,0,0,0,5,1,24,SPA
be170419,43,24,22,19,2,18,43,25,35,22,13,49,92,137,3,24,SPA
be719093,0,1,0,0,0,0,0,0,0,0,0,0,0,0,0,24,SPA
bece776f,13,8,4,6,3,5,10,5,7,0,7,7,20,2,0,24,SPA
bed68338,12,11,3,5,4,4,13,9,9,0,9,4,16,3,0,24,SPA
bfd381b3,46,26,27,18,1,17,38,21,20,6,14,11,57,27,2,24,SPA
c05dfb74,4,0,1,3,0,1,2,1,4,1,3,0,4,0,0,24,SPA
c0617e2b,4,3,1,3,0,1,4,3,5,1,4,0,4,2,0,24,SPA
c14bc029,58,34,25,28,5,28,43,15,35,9,26,14,72,51,0,24,SPA
c1fe5f0b,28,15,12,11,5,8,27,19,9,0,9,2,30,6,0,24,SPA
c20bdcd7,26,19,14,9,3,18,21,3,10,2,8,13,39,20,0,24,SPA
c2111b45,3,1,1,2,0,2,2,0,3,2,1,0,3,1,1,24,SPA
c235e803,10,6,4,6,0,5,8,3,5,2,3,8,18,36,1,24,SPA
c2c8897d,9,6,4,3,2,5,24,19,9,0,9,6,15,10,0,24,SPA
c3e66ffe,21,14,14,6,1,12,26,14,11,4,7,10,31,34,2,24,SPA
c47541e0,2,2,0,1,1,1,2,1,3,0,3,0,2,1,0,24,SPA
c487901c,27,17,7,13,7,9,40,31,17,0,17,14,41,9,0,24,SPA
c4b888df,43,27,27,13,3,19,36,17,23,7,16,23,66,80,2,24,SPA
c4f5eb61,4,1,0,3,1,2,2,0,1,0,1,0,4,6,0,24,SPA
c5642098,1,0,1,0,0,1,1,0,2,0,2,0,1,0,0,24,SPA
c77a8043,10,7,4,5,1,5,13,8,4,0,4,5,15,4,0,24,SPA
c78b352d,49,31,32,14,3,25,46,21,23,9,14,30,79,52,0,24,SPA
c997b942,36,23,15,16,5,15,30,15,25,0,25,14,50,7,0,24,SPA
c9e39d91,36,24,12,16,8,13,39,26,18,3,15,8,44,15,0,24,SPA
ca22ccb0,2,2,1,1,0,0,1,1,0,0,0,0,2,0,0,24,SPA
ca6edaa0,1,0,0,1,0,1,1,0,8,0,8,0,1,2,0,24,SPA
cb00f1e6,2,1,1,0,1,0,1,1,3,0,3,0,2,5,0,24,SPA
cb1e5807,1,1,1,0,0,0,0,0,0,0,0,0,1,1,0,24,SPA
cb641b9d,5,2,1,2,2,3,6,3,4,0,4,1,6,7,0,24,SPA
cc1c5035,0,0,0,0,0,0,1,1,0,0,0,0,0,5,1,24,SPA
cc2dd8a5,0,0,0,0,0,0,1,1,0,0,0,0,0,0,0,24,SPA
cc6de655,52,33,31,17,4,31,50,19,24,7,17,11,63,35,0,24,SPA
cc7888f3,19,12,15,3,1,11,13,2,13,11,2,8,27,41,0,24,SPA
cc851506,2,1,2,0,0,0,0,0,1,0,1,0,2,0,0,24,SPA
cc9256ef,12,7,5,6,1,6,26,20,15,2,13,34,46,10,0,24,SPA
cd59a7e6,2,1,1,1,0,1,1,0,0,0,0,3,5,3,0,24,SPA
cde52ef5,0,0,0,0,0,0,1,1,0,0,0,0,0,5,0,24,SPA
cee88597,35,24,16,19,0,17,32,15,23,9,14,24,59,56,1,24,SPA
cf9bdd43,9,2,7,2,0,4,6,2,1,1,0,7,16,12,0,24,SPA
d068118b,1,0,0,1,0,0,0,0,0,0,0,0,1,1,0,24,SPA
d080ed5e,47,25,17,19,11,17,34,17,29,10,19,9,56,44,3,24,SPA
d0ee1652,21,13,16,5,0,7,12,5,22,13,9,15,36,95,3,24,SPA
d1b060e2,4,3,1,2,1,2,4,2,5,2,3,2,6,9,0,24,SPA
d2110326,18,11,9,9,0,11,13,2,17,7,10,11,29,62,0,24,SPA
d29202c2,1,0,0,1,0,0,5,5,4,0,4,0,1,8,0,24,SPA
d2c8aacc,4,4,2,2,0,2,6,4,1,0,1,1,5,2,0,24,SPA
d3d774cc,1,0,0,1,0,0,0,0,0,0,0,0,1,0,0,24,SPA
d4808594,5,3,2,3,0,4,8,4,3,0,3,0,5,2,0,24,SPA
d49f3e6b,41,19,10,22,9,14,29,15,30,4,26,6,47,36,0,24,SPA
d4b73232,2,2,2,0,0,2,2,0,0,0,0,0,2,18,2,24,SPA
d633fd46,0,0,0,0,0,0,0,0,1,1,0,0,0,1,0,24,SPA
d709cd5c,0,0,0,0,0,0,0,0,0,0,0,0,0,0,0,24,SPA
d80d7f17,1,0,0,1,0,0,0,0,0,0,0,0,1,1,0,24,SPA
d8712bf9,2,2,1,1,0,1,5,4,1,0,1,0,2,0,0,24,SPA
d87e2cae,6,2,1,2,3,1,3,2,8,2,6,2,8,14,0,24,SPA
d9235a45,0,0,0,0,0,0,0,0,0,0,0,0,0,1,0,24,SPA
d925b04e,0,0,0,0,0,0,0,0,0,0,0,0,0,0,0,24,SPA
d9ba39fc,50,37,27,18,5,34,62,28,22,7,15,35,85,57,0,24,SPA
da27e268,49,34,16,27,6,28,49,21,27,5,22,16,65,21,1,24,SPA
da82ccb1,1,1,0,0,1,1,1,0,0,0,0,1,2,3,0,24,SPA
daa2eab3,14,7,3,8,3,4,13,9,12,2,10,4,18,3,0,24,SPA
dabb2827,0,0,0,0,0,0,0,0,1,0,1,0,0,1,0,24,SPA
db001fa9,60,41,37,21,2,27,72,45,24,3,21,38,98,59,0,24,SPA
db714daf,4,2,1,3,0,2,4,2,5,1,4,2,6,0,0,24,SPA
db8f0eba,39,25,23,7,9,17,39,22,23,0,23,12,51,8,0,24,SPA
dc1c2fce,22,13,8,9,5,6,21,15,22,0,22,5,27,10,0,24,SPA
dc1ce4f5,38,23,23,13,2,19,31,12,28,12,16,30,68,115,2,24,SPA
dc44b03c,7,4,1,5,1,1,4,3,8,1,7,1,8,12,0,24,SPA
dc7a172e,14,9,8,4,2,10,14,4,6,3,3,5,19,15,0,24,SPA
de39485a,4,4,3,1,0,2,7,5,2,0,2,1,5,6,0,24,SPA
dee86451,16,9,7,7,2,8,12,4,5,1,4,6,22,6,1,24,SPA
df69b544,25,14,8,12,5,10,31,21,24,2,22,9,34,16,0,24,SPA
e08647d6,11,7,3,6,2,0,2,2,4,0,4,0,11,5,0,24,SPA
e19c989c,14,9,11,3,0,6,9,3,14,8,6,11,25,47,0,24,SPA
e27fdbca,6,4,3,2,1,4,7,3,1,0,1,1,7,4,1,24,SPA
e358587b,0,0,0,0,0,0,0,0,0,0,0,0,0,0,0,24,SPA
e447352c,1,1,0,1,0,0,1,1,0,0,0,0,1,2,0,24,SPA
e54a9890,8,5,6,1,1,4,5,1,4,0,4,1,9,2,0,24,SPA
e5d01ecf,21,16,12,8,1,13,22,9,12,5,7,19,40,25,0,24,SPA
e5ec95f8,0,0,0,0,0,0,0,0,1,1,0,0,0,1,0,24,SPA
e6697917,14,8,4,7,3,5,10,5,5,0,5,3,17,2,0,24,SPA
e6777e6b,9,3,7,2,0,4,8,4,3,2,1,6,15,26,0,24,SPA
e6bc67d7,2,2,0,2,0,1,3,2,3,0,3,1,3,1,0,24,SPA
e7630876,57,34,36,19,2,28,39,11,32,16,16,33,90,124,2,24,SPA
e7af9060,15,7,5,3,7,2,5,3,16,5,11,2,17,13,0,24,SPA
e897d8ba,6,3,1,2,3,4,9,5,12,5,7,0,6,10,0,24,SPA
e9241b40,36,19,12,21,3,20,39,19,19,3,16,11,47,16,0,24,SPA
e92cd3f7,4,3,0,1,3,2,6,4,9,4,5,0,4,24,0,24,SPA
e9ada8cf,18,10,8,8,2,12,21,9,17,5,12,7,25,65,1,24,SPA
ea0aa7e0,15,9,9,6,0,9,12,3,9,2,7,9,24,21,0,24,SPA
ea83bfa6,0,0,0,0,0,0,3,3,0,0,0,1,1,10,1,24,SPA
ead61f73,27,15,13,10,4,11,20,9,21,4,17,13,40,48,0,24,SPA
eb3dd471,26,18,10,12,4,13,36,23,26,1,25,16,42,26,0,24,SPA
ec1a731e,20,14,14,5,1,12,17,5,18,13,5,9,29,57,1,24,SPA
ec7c84c2,32,16,11,15,6,13,36,23,33,4,29,15,47,20,1,24,SPA
ed5c5fa3,39,22,15,17,7,18,48,30,19,0,19,16,55,22,0,24,SPA
ed6ea4d9,23,14,7,9,7,13,24,11,8,1,7,3,26,2,0,24,SPA
ee8508c0,0,0,0,0,0,0,0,0,0,0,0,0,0,8,0,24,SPA
ee923664,15,13,7,7,1,12,18,6,11,3,8,4,19,25,0,24,SPA
eeba07f8,5,4,2,3,0,1,4,3,9,0,9,0,5,9,0,24,SPA
ef322658,17,12,5,9,3,7,14,7,4,2,2,6,23,5,0,24,SPA
efa708aa,11,4,3,5,3,5,16,11,3,0,3,0,11,2,0,24,SPA
efaefda0,28,20,14,11,3,13,27,14,19,2,17,10,38,15,1,24,SPA
efecd633,3,2,2,1,0,1,4,3,3,2,1,2,5,1,0,24,SPA
f03f284b,25,18,15,10,0,11,14,3,20,14,6,16,41,47,3,24,SPA
f0da930c,14,7,7,6,1,5,11,6,7,6,1,8,22,54,0,24,SPA
f0f499ea,1,1,0,1,0,0,0,0,0,0,0,0,1,0,0,24,SPA
f0fe87dc,0,0,0,0,0,0,0,0,0,0,0,0,0,0,0,24,SPA
f1124008,0,0,0,0,0,0,0,0,0,0,0,0,0,0,0,24,SPA
f2c6ac01,27,17,17,8,2,15,25,10,24,11,13,24,51,89,1,24,SPA
f33b6ee6,1,0,0,0,1,1,6,5,0,0,0,1,2,2,0,24,SPA
f35430a4,29,14,20,9,0,19,26,7,29,17,12,24,53,98,0,24,SPA
f36016a5,9,6,2,6,1,1,8,7,6,0,6,3,12,4,0,24,SPA
f3b1d9a2,9,6,7,2,0,2,10,8,2,0,2,3,12,6,0,24,SPA
f4290206,5,3,2,3,0,3,4,1,2,0,2,4,9,3,0,24,SPA
f4c69aa6,9,3,1,5,3,2,6,4,2,1,1,4,13,8,0,24,SPA
f553b2b3,15,9,1,11,3,5,32,27,14,1,13,5,20,14,0,24,SPA
f6798fc3,0,0,0,0,0,0,0,0,0,0,0,0,0,0,0,24,SPA
f6ac68c1,20,15,10,7,3,9,22,13,26,14,12,25,45,48,1,24,SPA
f7c12fbf,22,14,5,14,3,11,16,5,7,3,4,10,32,24,1,24,SPA
f7dc2ae5,6,4,1,4,1,5,8,3,6,5,1,5,11,15,0,24,SPA
f7e87032,27,18,10,12,5,14,26,12,14,1,13,10,37,21,0,24,SPA
f814e5d3,1,1,0,1,0,1,2,1,1,0,1,0,1,2,0,24,SPA
f8405304,4,3,3,1,0,2,7,5,6,0,6,1,5,1,0,24,SPA
f874dd44,28,19,11,13,4,16,43,27,11,5,6,19,47,35,1,24,SPA
f8eca1b6,0,0,0,0,0,0,0,0,1,0,1,0,0,2,0,24,SPA
fb938d24,0,0,0,0,0,0,0,0,0,0,0,1,1,0,0,24,SPA
fbbb9269,10,7,7,2,1,4,5,1,5,2,3,7,17,18,0,24,SPA
fbd6378b,10,6,7,3,0,7,13,6,7,5,2,8,18,35,0,24,SPA
fc627681,0,0,0,0,0,0,1,1,0,0,0,0,0,3,1,24,SPA
fc647b34,21,12,8,7,6,11,17,6,13,1,12,4,25,8,0,24,SPA
fc70e345,1,1,1,0,0,1,1,0,0,0,0,0,1,15,3,24,SPA
fc8b614b,1,1,0,1,0,1,1,0,1,0,1,0,1,0,0,24,SPA
fce2302c,32,20,14,17,1,17,25,8,19,6,13,10,42,32,0,24,SPA
fce521d7,26,16,12,8,6,11,22,11,27,3,24,12,38,60,0,24,SPA
fd51b456,27,20,15,11,1,13,18,5,21,4,17,8,35,27,0,24,SPA
fdd26d71,0,0,0,0,0,0,2,2,0,0,0,2,2,5,0,24,SPA
fe6e7156,34,23,10,19,5,11,20,9,26,0,26,14,48,10,1,24,SPA
fea23125,0,0,0,0,0,0,0,0,0,0,0,0,0,3,0,24,SPA
ffacd3d5,50,25,20,24,6,28,50,22,23,3,20,17,67,62,0,24,SPA
00459419,0,0,0,0,0,0,0,0,1,0,1,1,1,2,0,24,CL
0076ab7f,12,7,7,5,0,7,13,6,4,2,2,4,16,17,0,24,CL
008042f3,1,0,1,0,0,1,1,0,0,0,0,0,1,0,0,24,CL
009a4f60,12,7,6,6,0,4,13,9,5,3,2,2,14,8,0,24,CL
00a8d210,20,16,9,10,1,10,20,10,2,0,2,6,26,13,0,24,CL
016cb21b,5,3,0,3,2,2,7,5,5,0,5,3,8,1,0,24,CL
01bb93d5,2,2,1,1,0,1,2,1,4,0,4,0,2,1,0,24,CL
01e5f06e,3,2,1,1,1,1,2,1,1,0,1,1,4,2,0,24,CL
01eb744d,1,1,0,1,0,0,1,1,2,0,2,0,1,4,0,24,CL
02a5618e,0,0,0,0,0,0,0,0,1,0,1,0,0,0,0,24,CL
02c15616,5,4,3,1,1,3,6,3,8,2,6,1,6,5,0,24,CL
02caf6e0,10,7,3,7,0,6,15,9,13,3,10,5,15,6,0,24,CL
02ce2030,0,0,0,0,0,0,1,1,1,1,0,0,0,0,0,24,CL
0355010f,0,0,0,0,0,0,1,1,1,0,1,0,0,2,0,24,CL
037f2523,3,2,0,2,1,0,1,1,1,0,1,1,4,0,0,24,CL
03998238,6,5,2,3,1,2,5,3,7,1,6,1,7,11,1,24,CL
042e8a49,4,2,2,2,0,0,4,4,6,0,6,0,4,1,0,24,CL
046ca6db,2,2,0,2,0,0,2,2,2,0,2,3,5,1,0,24,CL
048a1cbc,0,0,0,0,0,0,2,2,3,0,3,3,3,2,0,24,CL
04e17fd5,5,2,2,2,1,2,2,0,4,1,3,3,8,2,0,24,CL
05439de2,1,1,0,1,0,1,1,0,1,1,0,3,4,9,1,24,CL
056d2d95,4,4,2,2,0,3,4,1,2,0,2,1,5,3,0,24,CL
05d548d8,34,21,28,6,0,22,34,12,14,4,10,20,54,43,0,24,CL
0670ee51,3,3,3,0,0,2,3,1,2,1,1,2,5,4,0,24,CL
068f4dec,4,3,1,2,1,0,4,4,4,2,2,1,5,1,1,24,CL
06c48679,18,12,10,7,1,10,14,4,8,5,3,8,26,16,0,24,CL
08273d48,0,0,0,0,0,0,0,0,3,1,2,0,0,0,0,24,CL
08452314,6,1,0,4,2,2,2,0,0,0,0,1,7,0,0,24,CL
08511d65,2,2,1,1,0,2,4,2,12,9,3,4,6,16,0,24,CL
08990838,6,2,5,1,0,5,10,5,14,12,2,6,12,53,0,24,CL
089c7323,4,1,2,1,1,2,4,2,9,2,7,4,8,2,0,24,CL
08f5afaa,0,0,0,0,0,0,0,0,0,0,0,0,0,4,1,24,CL
08fe932d,1,1,1,0,0,1,2,1,2,1,1,0,1,5,0,24,CL
091c86e2,8,3,3,4,1,1,7,6,2,0,2,5,13,4,0,24,CL
0959c2a2,14,9,9,5,0,7,12,5,6,3,3,10,24,13,0,24,CL
0a084b35,6,1,5,1,0,4,8,4,7,3,4,2,8,11,1,24,CL
0a69de7b,4,2,1,3,0,2,2,0,2,0,2,5,9,7,0,24,CL
0a89e877,22,14,13,6,3,10,18,8,10,2,8,3,25,11,0,24,CL
0ab1f153,0,0,0,0,0,0,0,0,1,0,1,1,1,1,0,24,CL
0af4dcf0,0,0,0,0,0,0,0,0,0,0,0,0,0,0,0,24,CL
0b059e15,1,1,0,0,1,1,2,1,1,0,1,1,2,0,0,24,CL
0b5a292a,3,1,1,2,0,3,10,7,3,0,3,2,5,5,0,24,CL
0c61c77c,2,2,0,2,0,1,4,3,1,0,1,1,3,0,0,24,CL
0ca476cc,0,0,0,0,0,0,0,0,1,0,1,0,0,1,0,24,CL
0caa2fd4,10,8,4,4,2,6,9,3,8,1,7,4,14,3,0,24,CL
0d267745,12,4,9,3,0,9,18,9,11,6,5,11,23,24,1,24,CL
0d7b6576,2,2,0,1,1,0,0,0,0,0,0,0,2,0,0,24,CL
0d9b2d31,5,3,2,2,1,3,4,1,3,0,3,2,7,3,0,24,CL
0db169ae,1,1,1,0,0,1,1,0,1,0,1,2,3,2,0,24,CL
0de73fa4,9,6,1,6,2,4,11,7,8,4,4,3,12,5,1,24,CL
0e09dd0d,1,1,1,0,0,1,1,0,0,0,0,0,1,3,1,24,CL
0e6bc38c,0,0,0,0,0,0,0,0,0,0,0,0,0,2,0,24,CL
0f41e2ee,15,10,9,6,0,13,19,6,8,3,5,6,21,17,0,24,CL
0f422610,1,0,1,0,0,0,1,1,0,0,0,0,1,1,0,24,CL
0fa11d7d,3,2,1,2,0,1,1,0,5,4,1,4,7,5,0,24,CL
0fdcef0e,2,1,1,1,0,0,2,2,3,1,2,1,3,3,0,24,CL
10745192,1,1,0,0,1,0,2,2,2,0,2,0,1,2,0,24,CL
112521d1,6,6,3,3,0,4,11,7,1,1,0,2,8,4,0,24,CL
114bbdee,4,3,4,0,0,4,4,0,1,1,0,1,5,7,0,24,CL
116c35df,3,1,0,3,0,0,0,0,3,0,3,0,3,5,0,24,CL
1227a22d,7,4,4,3,0,3,9,6,5,1,4,6,13,10,0,24,CL
129af0db,2,1,1,0,1,0,1,1,5,1,4,0,2,7,0,24,CL
12e6d21a,3,2,0,2,1,2,2,0,1,0,1,0,3,2,0,24,CL
13203c45,8,5,3,4,1,3,4,1,3,3,0,0,8,10,0,24,CL
136958ad,2,0,1,1,0,1,3,2,1,0,1,0,2,1,0,24,CL
15413fa5,9,4,5,4,0,3,9,6,8,2,6,7,16,5,0,24,CL
1598599e,8,4,4,2,2,4,8,4,0,0,0,7,15,7,0,24,CL
15ab5a2b,3,2,0,2,1,2,5,3,0,0,0,0,3,2,0,24,CL
15b287da,7,3,1,4,2,4,5,1,4,1,3,1,8,2,0,24,CL
15fd5593,1,1,0,0,1,0,2,2,0,0,0,0,1,0,0,24,CL
162efffd,6,2,2,3,1,5,8,3,13,0,13,2,8,4,0,24,CL
16aa3654,4,3,0,3,1,0,7,7,4,1,3,2,6,4,0,24,CL
16ceb862,3,1,3,0,0,1,8,7,3,0,3,0,3,10,1,24,CL
172bab0a,9,4,1,7,1,3,8,5,5,0,5,5,14,1,0,24,CL
175bef1f,14,5,3,9,2,7,17,10,14,9,5,6,20,9,0,24,CL
17695062,1,1,1,0,0,1,2,1,0,0,0,1,2,0,0,24,CL
17e1261b,5,2,2,2,1,2,2,0,2,1,1,1,6,4,0,24,CL
18b896d6,7,3,5,2,0,5,7,2,13,12,1,2,9,22,0,24,CL
18fae4ac,13,7,5,6,2,7,20,13,8,0,8,6,19,11,0,24,CL
19cae58d,3,2,2,1,0,1,4,3,2,0,2,1,4,5,0,24,CL
19cda00b,3,3,2,1,0,1,7,6,4,0,4,1,4,2,0,24,CL
1a4b9094,0,0,0,0,0,0,0,0,0,0,0,1,1,0,0,24,CL
1a799243,7,5,4,1,2,3,4,1,6,2,4,1,8,5,0,24,CL
1a7a4d84,8,4,7,1,0,7,9,2,8,6,2,12,20,25,1,24,CL
1adcf39e,11,5,7,3,1,6,15,9,10,5,5,2,13,29,2,24,CL
1b82f8df,17,8,9,6,2,10,18,8,9,1,8,8,25,13,0,24,CL
1bacc518,5,3,1,3,1,2,4,2,0,0,0,2,7,3,0,24,CL
1bf33a9a,6,4,1,4,1,2,2,0,7,1,6,0,6,2,0,24,CL
1c7012b8,13,10,2,9,2,8,12,4,7,5,2,13,26,12,0,24,CL
1cb49278,9,6,3,5,1,3,5,2,3,1,2,7,16,11,0,24,CL
1d1691ad,1,1,1,0,0,1,1,0,1,0,1,1,2,0,0,24,CL
1e1378e1,6,5,2,4,0,3,9,6,9,0,9,5,11,7,0,24,CL
1f44ac21,1,0,0,1,0,0,0,0,0,0,0,0,1,2,0,24,CL
1fc08838,0,0,0,0,0,0,0,0,1,1,0,0,0,1,0,24,CL
20030c06,4,3,2,2,0,4,6,2,9,6,3,1,5,9,1,24,CL
200e89e1,12,6,7,2,3,7,14,7,3,0,3,1,13,2,0,24,CL
20730eae,8,1,5,1,2,2,5,3,2,0,2,2,10,1,0,24,CL
21166ff4,0,0,0,0,0,0,0,0,0,0,0,0,0,1,0,24,CL
213f0daf,11,8,9,0,2,7,12,5,11,4,7,4,15,19,0,24,CL
2146785a,18,14,10,3,5,11,18,7,8,2,6,3,21,10,0,24,CL
21512407,11,6,7,3,1,7,16,9,8,2,6,5,16,13,0,24,CL
21a66f6a,8,6,2,5,1,3,4,1,4,1,3,0,8,5,0,24,CL
2200181e,8,5,2,5,1,3,9,6,3,2,1,11,19,8,0,24,CL
22798128,5,5,1,2,2,0,3,3,3,1,2,1,6,5,0,24,CL
228b0d9d,13,9,7,4,2,7,10,3,7,3,4,3,16,16,0,24,CL
230a2fac,20,12,13,7,0,15,21,6,11,2,9,6,26,15,0,24,CL
232b3da4,0,0,0,0,0,0,1,1,5,3,2,1,1,1,0,24,CL
23610943,16,9,8,6,2,11,19,8,17,2,15,4,20,10,0,24,CL
24051310,7,4,5,2,0,3,5,2,2,0,2,4,11,6,0,24,CL
242e1043,14,9,12,1,1,9,13,4,2,2,0,5,19,5,1,24,CL
24fc70d3,8,4,6,2,0,3,6,3,12,9,3,6,14,24,0,24,CL
25146df0,12,6,7,5,0,7,12,5,7,4,3,5,17,26,1,24,CL
262e5a82,1,1,0,1,0,0,0,0,1,1,0,0,1,2,0,24,CL
2658c82f,0,0,0,0,0,0,1,1,5,2,3,2,2,2,0,24,CL
26777636,3,2,1,2,0,2,4,2,0,0,0,3,6,4,0,24,CL
26a2dc36,0,0,0,0,0,0,0,0,0,0,0,0,0,0,0,24,CL
277da414,0,0,0,0,0,0,0,0,0,0,0,0,0,1,0,24,CL
28c6e925,9,5,3,5,1,4,8,4,5,1,4,5,14,4,0,24,CL
28d596a0,0,0,0,0,0,0,0,0,0,0,0,0,0,0,0,24,CL
2946f9a1,5,4,1,4,0,2,6,4,3,2,1,5,10,21,0,24,CL
29fbdc88,3,2,1,1,1,2,6,4,2,0,2,1,4,1,0,24,CL
2a0c8ba4,5,2,3,2,0,3,4,1,0,0,0,0,5,0,0,24,CL
2a295d33,8,7,5,2,1,4,11,7,12,0,12,2,10,4,0,24,CL
2a7d27c1,10,7,5,5,0,4,11,7,4,1,3,3,13,8,0,24,CL
2b0852db,2,1,0,1,1,1,4,3,4,1,3,1,3,2,0,24,CL
2b114be3,9,6,0,3,6,3,11,8,7,0,7,1,10,1,0,24,CL
2b8360f1,0,0,0,0,0,0,0,0,0,0,0,0,0,0,0,24,CL
2bd83368,10,8,5,2,3,6,13,7,8,0,8,2,12,2,0,24,CL
2bef2bca,11,9,4,6,1,3,3,0,8,5,3,6,17,14,0,24,CL
2c0558b8,6,6,1,4,1,5,12,7,6,0,6,6,12,0,0,24,CL
2c0f8e9e,5,4,1,4,0,3,5,2,0,0,0,2,7,0,0,24,CL
2c56a792,4,4,4,0,0,1,5,4,1,0,1,2,6,4,0,24,CL
2c6835e5,3,1,1,2,0,2,8,6,5,3,2,2,5,8,0,24,CL
2cf496fb,5,4,3,2,0,3,4,1,2,0,2,4,9,14,0,24,CL
2cfae697,13,9,4,6,3,6,9,3,6,2,4,5,18,7,0,24,CL
2d970560,6,3,3,3,0,1,5,4,5,1,4,3,9,12,0,24,CL
2e31f3a6,0,0,0,0,0,0,3,3,0,0,0,0,0,4,0,24,CL
2ef08833,0,0,0,0,0,0,0,0,2,1,1,1,1,1,0,24,CL
2f18d0b8,0,0,0,0,0,0,0,0,0,0,0,0,0,0,0,24,CL
2f3452eb,8,3,4,4,0,2,5,3,3,0,3,2,10,6,0,24,CL
2ffa6348,0,0,0,0,0,0,2,2,1,1,0,2,2,1,0,24,CL
3061e1ec,0,0,0,0,0,0,1,1,0,0,0,0,0,2,1,24,CL
30941e96,7,5,3,2,2,4,9,5,6,3,3,6,13,9,0,24,CL
30ae134d,3,2,0,2,1,1,2,1,4,2,2,1,4,9,0,24,CL
30d75bfb,11,8,6,5,0,7,11,4,6,2,4,4,15,12,0,24,CL
30f5ffa9,12,7,9,3,0,8,8,0,5,3,2,5,17,12,0,24,CL
31c69ef1,6,5,4,1,1,3,6,3,8,4,4,7,13,18,0,24,CL
31dce0c8,4,3,0,2,2,3,8,5,4,0,4,0,4,7,0,24,CL
3260690c,4,1,0,2,2,3,10,7,5,0,5,1,5,3,0,24,CL
3353737a,2,0,2,0,0,0,5,5,3,0,3,3,5,2,0,24,CL
335fa267,2,2,0,1,1,0,3,3,2,0,2,0,2,1,0,24,CL
3423f250,5,4,3,2,0,3,4,1,2,0,2,1,6,2,0,24,CL
343c0d52,3,2,2,1,0,0,0,0,0,0,0,1,4,1,0,24,CL
34a0f5ff,0,0,0,0,0,0,0,0,0,0,0,0,0,0,0,24,CL
34e12499,17,9,9,8,0,11,11,0,10,7,3,7,24,22,1,24,CL
35e413f1,8,4,1,4,3,4,14,10,9,1,8,8,16,8,0,24,CL
36a3ff67,10,3,5,2,3,5,11,6,5,1,4,3,13,4,0,24,CL
37337aea,0,0,0,0,0,0,2,2,2,0,2,1,1,4,0,24,CL
374ee424,0,0,0,0,0,0,0,0,0,0,0,0,0,3,0,24,CL
378825c7,21,12,12,7,2,12,15,3,16,6,10,7,28,9,0,24,CL
37d0048f,0,0,0,0,0,0,0,0,0,0,0,0,0,0,0,24,CL
37dc1a48,6,3,1,3,2,3,4,1,1,0,1,0,6,0,0,24,CL
38ceb24a,3,1,1,0,2,1,8,7,4,0,4,3,6,5,0,24,CL
395451fc,2,1,0,2,0,2,7,5,2,0,2,3,5,3,0,24,CL
3963c25b,1,0,1,0,0,0,1,1,3,2,1,1,2,8,0,24,CL
39e1138f,15,14,6,5,4,5,9,4,14,4,10,7,22,10,0,24,CL
3a089320,6,4,1,3,2,3,4,1,1,0,1,0,6,2,0,24,CL
3a949a25,0,0,0,0,0,0,0,0,0,0,0,0,0,0,0,24,CL
3b029691,10,7,3,5,2,1,9,8,6,0,6,7,17,7,0,24,CL
3b12b11f,0,0,0,0,0,0,0,0,0,0,0,0,0,1,0,24,CL
3b387cc7,0,0,0,0,0,0,1,1,1,0,1,0,0,0,0,24,CL
3b61c9ec,2,1,1,1,0,1,3,2,4,1,3,3,5,5,0,24,CL
3bb7b8b4,0,0,0,0,0,0,0,0,0,0,0,0,0,1,1,24,CL
3c6089ab,3,2,1,1,1,1,7,6,4,0,4,1,4,3,0,24,CL
3ca7254a,2,1,0,2,0,0,2,2,1,1,0,0,2,1,0,24,CL
3cd7820a,10,8,4,4,2,4,12,8,7,3,4,12,22,6,0,24,CL
3ce20eda,5,2,4,1,0,2,3,1,7,5,2,4,9,20,0,24,CL
3cefcaef,5,5,4,1,0,4,7,3,5,1,4,4,9,7,0,24,CL
3d99999d,0,0,0,0,0,0,0,0,0,0,0,0,0,0,0,24,CL
3dd738a1,4,4,2,2,0,2,3,1,3,0,3,0,4,1,0,24,CL
3e2bbae6,3,2,1,2,0,2,2,0,1,0,1,0,3,1,0,24,CL
3ea50f67,0,0,0,0,0,0,0,0,0,0,0,0,0,0,0,24,CL
3ead85f9,7,4,4,3,0,4,5,1,7,5,2,2,9,21,0,24,CL
3eb22ec9,4,1,1,1,2,3,6,3,2,0,2,1,5,4,0,24,CL
3ec9f005,4,3,2,2,0,2,6,4,2,0,2,3,7,3,0,24,CL
3ee0dd59,18,7,5,12,1,5,10,5,9,1,8,7,25,12,0,24,CL
3ef0a2d7,3,1,2,1,0,2,6,4,0,0,0,2,5,3,0,24,CL
3effaa34,2,1,2,0,0,1,1,0,1,1,0,0,2,1,0,24,CL
3f10bd22,8,7,4,3,1,2,2,0,3,1,2,2,10,9,0,24,CL
3f5f38fb,1,1,1,0,0,0,2,2,1,0,1,0,1,9,0,24,CL
3fc45c73,2,1,1,0,1,2,4,2,2,1,1,3,5,11,0,24,CL
402b0928,0,0,0,0,0,0,0,0,1,0,1,0,0,0,0,24,CL
403f5d20,15,7,9,5,1,6,10,4,10,5,5,11,26,26,0,24,CL
407db0d5,22,15,12,8,2,9,18,9,22,4,18,7,29,16,0,24,CL
407feb71,4,1,0,2,2,0,1,1,0,0,0,0,4,0,0,24,CL
4123bc9a,1,0,0,1,0,1,2,1,0,0,0,0,1,0,0,24,CL
4142f132,2,0,2,0,0,0,7,7,8,2,6,5,7,2,0,24,CL
414b2ce4,2,2,0,1,1,0,4,4,0,0,0,2,4,0,0,24,CL
415568b5,4,4,2,2,0,2,4,2,6,1,5,2,6,4,0,24,CL
41c12f75,13,8,9,4,0,6,9,3,4,1,3,7,20,7,0,24,CL
41f0b196,0,0,0,0,0,0,1,1,0,0,0,0,0,2,0,24,CL
41f32541,13,8,8,5,0,7,11,4,6,3,3,4,17,8,0,24,CL
420c18a1,0,0,0,0,0,0,0,0,0,0,0,0,0,2,0,24,CL
42fd9c7f,0,0,0,0,0,0,2,2,3,0,3,1,1,0,0,24,CL
433dc9a2,3,2,1,2,0,3,3,0,1,1,0,1,4,1,0,24,CL
437f2b00,3,1,2,0,1,2,5,3,2,0,2,3,6,3,0,24,CL
43b78598,2,2,1,1,0,1,1,0,0,0,0,0,2,3,0,24,CL
44150beb,2,1,2,0,0,0,1,1,0,0,0,0,2,6,0,24,CL
4431aed2,2,1,0,2,0,1,4,3,5,1,4,1,3,6,0,24,CL
44ac04e9,9,5,3,4,2,5,18,13,8,3,5,6,15,13,0,24,CL
450ab6fc,5,5,3,1,1,3,3,0,6,3,3,0,5,16,0,24,CL
4567a0b4,6,3,1,5,0,1,3,2,2,0,2,1,7,2,0,24,CL
45736cec,4,4,3,1,0,2,6,4,4,3,1,4,8,4,0,24,CL
45a03961,7,3,4,3,0,3,5,2,6,3,3,9,16,25,1,24,CL
45af8a54,2,1,2,0,0,0,1,1,1,1,0,0,2,0,0,24,CL
45c29ae7,7,7,1,3,3,0,5,5,1,0,1,3,10,2,0,24,CL
45db685d,9,4,1,6,2,1,3,2,4,1,3,8,17,3,0,24,CL
4658e309,0,0,0,0,0,0,0,0,1,1,0,0,0,1,0,24,CL
466fb2c5,0,0,0,0,0,0,0,0,0,0,0,0,0,0,0,24,CL
47420f02,7,3,4,3,0,1,10,9,6,0,6,1,8,3,0,24,CL
47a34c4f,0,0,0,0,0,0,1,1,1,0,1,0,0,0,0,24,CL
47fd5136,3,2,3,0,0,2,4,2,6,4,2,6,9,22,0,24,CL
481c9ece,3,2,1,2,0,1,1,0,4,1,3,0,3,3,0,24,CL
4876c9ab,9,5,3,4,2,6,9,3,5,0,5,10,19,5,0,24,CL
48a5a5d6,4,2,2,0,2,3,4,1,8,0,8,2,6,0,0,24,CL
491a433d,0,0,0,0,0,0,0,0,3,0,3,1,1,0,0,24,CL
49296448,16,11,7,8,1,11,24,13,6,0,6,10,26,8,1,24,CL
4958bfb2,12,9,7,5,0,5,10,5,4,1,3,4,16,14,0,24,CL
49fe9070,1,1,1,0,0,1,1,0,1,0,1,0,1,1,0,24,CL
4a5839fa,2,2,0,1,1,0,1,1,3,2,1,3,5,5,0,24,CL
4b3e1a38,5,3,2,1,2,2,4,2,4,1,3,11,16,33,0,24,CL
4b40d9ca,0,0,0,0,0,0,0,0,0,0,0,0,0,2,0,24,CL
4b511457,7,4,2,4,1,3,8,5,5,1,4,1,8,1,3,24,CL
4b5ed2f7,8,5,7,1,0,6,8,2,8,7,1,0,8,29,0,24,CL
4b96c347,6,3,2,3,1,5,9,4,2,0,2,1,7,1,0,24,CL
4c2a5d34,17,8,3,8,6,3,9,6,10,0,10,0,17,8,0,24,CL
4c53a688,0,0,0,0,0,0,1,1,1,0,1,0,0,0,0,24,CL
4c6facae,5,3,2,3,0,1,3,2,3,1,2,1,6,3,0,24,CL
4c82730b,7,2,3,3,1,5,11,6,9,2,7,7,14,8,0,24,CL
4d1666ff,7,4,4,1,2,1,3,2,8,3,5,8,15,24,0,24,CL
4d1c4a5d,1,1,0,1,0,0,0,0,0,0,0,1,2,0,0,24,CL
4d224fe8,6,3,4,2,0,3,9,6,3,0,3,1,7,4,0,24,CL
4d8cd038,0,0,0,0,0,0,0,0,1,0,1,0,0,0,0,24,CL
4dd2a0be,16,11,10,0,6,5,11,6,6,0,6,2,18,4,1,24,CL
4dedd469,9,5,6,2,1,6,10,4,7,4,3,4,13,13,0,24,CL
4e219ad2,1,1,1,0,0,1,4,3,0,0,0,0,1,0,0,24,CL
4e5a4cbc,2,2,1,0,1,1,1,0,6,6,0,2,4,6,0,24,CL
4f16405e,1,0,0,1,0,0,1,1,5,1,4,1,2,5,0,24,CL
4f1e6a0b,2,2,1,1,0,0,3,3,3,0,3,1,3,2,0,24,CL
4f255115,7,2,5,2,0,2,6,4,5,3,2,7,14,10,0,24,CL
4f565d77,2,2,2,0,0,0,1,1,0,0,0,0,2,1,0,24,CL
4fac8f81,3,2,2,1,0,3,3,0,4,3,1,5,8,11,0,24,CL
4fb17e20,15,7,11,4,0,9,13,4,9,4,5,4,19,13,0,24,CL
501055d8,6,4,4,2,0,4,8,4,4,0,4,2,8,2,0,24,CL
507c7bdf,13,6,6,6,1,5,19,14,7,1,6,3,16,9,0,24,CL
50f9bec6,12,6,6,3,3,5,9,4,2,0,2,1,13,6,0,24,CL
515ebe8d,0,0,0,0,0,0,0,0,2,1,1,2,2,3,0,24,CL
5167c97e,2,2,2,0,0,1,2,1,3,2,1,2,4,3,0,24,CL
51cf8561,3,1,3,0,0,2,4,2,3,0,3,4,7,1,0,24,CL
52611641,11,7,5,6,0,2,7,5,6,0,6,8,19,10,1,24,CL
5294a83f,4,2,1,2,1,1,10,9,13,4,9,7,11,3,0,24,CL
52ec54d0,1,0,1,0,0,1,2,1,5,5,0,2,3,23,0,24,CL
52f7e3a7,1,1,1,0,0,0,0,0,1,0,1,0,1,0,1,24,CL
530e7d85,2,1,1,1,0,1,1,0,0,0,0,0,2,2,0,24,CL
53cad200,4,3,1,2,1,2,4,2,4,0,4,3,7,9,0,24,CL
53d93280,0,0,0,0,0,0,1,1,1,0,1,0,0,3,0,24,CL
543b9811,1,1,0,1,0,1,1,0,0,0,0,0,1,0,0,24,CL
54b4dc4e,2,1,1,0,1,2,4,2,0,0,0,0,2,0,0,24,CL
55126f3b,11,7,3,3,5,6,13,7,4,0,4,3,14,9,0,24,CL
555f3a0b,6,5,3,2,1,2,11,9,9,3,6,5,11,23,1,24,CL
55a1cac2,3,1,2,1,0,2,4,2,2,1,1,1,4,3,0,24,CL
570bb4b9,0,0,0,0,0,0,0,0,3,0,3,2,2,0,0,24,CL
5715bb71,0,0,0,0,0,0,4,4,1,0,1,2,2,1,0,24,CL
577efaec,14,5,4,8,2,4,14,10,13,4,9,10,24,6,0,24,CL
57d88cf9,7,4,1,4,2,3,6,3,4,2,2,5,12,2,0,24,CL
5853ac44,0,0,0,0,0,0,0,0,0,0,0,1,1,1,0,24,CL
58a05c2e,3,2,1,2,0,1,1,0,3,0,3,1,4,1,0,24,CL
58a9a4d9,1,0,0,1,0,1,1,0,2,0,2,0,1,0,0,24,CL
5976f83e,13,7,6,5,2,9,14,5,9,0,9,4,17,11,0,24,CL
59948ef7,2,2,0,1,1,2,2,0,1,0,1,2,4,0,0,24,CL
59e4b92e,6,4,2,3,1,1,5,4,5,1,4,2,8,3,0,24,CL
5a2cb25d,8,5,5,2,1,6,8,2,10,1,9,3,11,3,0,24,CL
5ad50391,2,1,2,0,0,1,3,2,2,0,2,4,6,5,1,24,CL
5b3d1a7a,7,5,4,1,2,3,5,2,4,0,4,8,15,7,0,24,CL
5b9512c5,7,3,6,1,0,6,10,4,7,3,4,16,23,16,2,24,CL
5bc43860,1,0,1,0,0,0,4,4,5,1,4,3,4,1,0,24,CL
5c4dc0ff,1,1,0,1,0,0,0,0,1,0,1,0,1,0,0,24,CL
5c7845f6,14,12,9,4,1,8,9,1,12,7,5,8,22,23,0,24,CL
5caa62a7,8,4,3,3,2,4,7,3,3,0,3,1,9,2,0,24,CL
5ccc9672,6,4,2,2,2,4,5,1,3,0,3,1,7,5,0,24,CL
5cdddffa,3,3,0,3,0,1,2,1,1,0,1,0,3,1,0,24,CL
5d51b074,4,2,2,2,0,1,6,5,8,0,8,0,4,2,0,24,CL
5d9cff53,19,9,13,4,2,13,19,6,6,5,1,11,30,25,0,24,CL
5dfc6ad5,4,2,2,2,0,2,2,0,12,6,6,11,15,20,0,24,CL
5e861944,3,1,2,1,0,2,12,10,2,0,2,1,4,2,0,24,CL
5ea8ef20,6,6,1,3,2,2,5,3,3,1,2,5,11,6,0,24,CL
5eecec3d,1,1,0,1,0,0,0,0,4,2,2,1,2,4,0,24,CL
5ef3d210,2,1,1,0,1,0,5,5,3,0,3,1,3,1,0,24,CL
5f09991f,4,1,0,4,0,2,6,4,1,0,1,2,6,0,0,24,CL
6025fab1,2,2,1,1,0,1,1,0,0,0,0,3,5,3,1,24,CL
60d90c55,0,0,0,0,0,0,0,0,1,0,1,0,0,1,1,24,CL
61e65971,3,3,1,2,0,3,4,1,0,0,0,0,3,2,0,24,CL
62182b1d,0,0,0,0,0,0,0,0,0,0,0,0,0,0,1,24,CL
6265208f,1,0,1,0,0,0,0,0,0,0,0,0,1,4,0,24,CL
6412cc03,0,0,0,0,0,0,0,0,0,0,0,0,0,1,0,24,CL
6434f10d,9,6,5,4,0,6,9,3,1,0,1,5,14,5,0,24,CL
649b01d8,0,0,0,0,0,0,0,0,0,0,0,0,0,0,0,24,CL
64f69877,5,3,1,3,1,0,4,4,3,0,3,0,5,0,1,24,CL
65154df0,9,6,7,1,1,8,19,11,2,0,2,2,11,4,0,24,CL
6603fed7,7,4,2,3,2,2,9,7,2,0,2,3,10,2,0,24,CL
6622454d,4,2,1,1,2,2,6,4,6,2,4,4,8,0,0,24,CL
663e080e,0,0,0,0,0,0,0,0,0,0,0,0,0,2,0,24,CL
66a7effe,0,0,0,0,0,0,3,3,0,0,0,0,0,1,0,24,CL
6747869d,2,2,0,1,1,1,1,0,2,0,2,0,2,3,0,24,CL
674dee62,0,0,0,0,0,0,0,0,0,0,0,0,0,0,0,24,CL
67ac5bb8,7,5,3,3,1,2,3,1,7,5,2,2,9,33,0,24,CL
6800f515,4,4,1,2,1,2,7,5,12,6,6,6,10,17,0,24,CL
686cbe7d,2,1,0,2,0,0,0,0,0,0,0,0,2,1,0,24,CL
6885cc44,9,3,6,3,0,4,9,5,4,0,4,6,15,3,0,24,CL
689c9cf4,4,2,2,1,1,3,7,4,8,2,6,1,5,7,0,24,CL
68cf59f0,0,0,0,0,0,0,1,1,0,0,0,0,0,0,0,24,CL
68dc0dac,20,9,14,4,2,9,20,11,10,2,8,11,31,7,1,24,CL
690d1049,5,1,3,0,2,4,10,6,8,3,5,2,7,11,0,24,CL
6928979a,16,13,6,7,3,5,10,5,6,2,4,5,21,5,0,24,CL
6a829019,4,2,0,1,3,1,9,8,7,2,5,2,6,1,0,24,CL
6b9960cf,8,5,3,2,3,5,11,6,8,1,7,5,13,8,0,24,CL
6bb2c084,11,6,3,8,0,5,17,12,11,1,10,8,19,9,0,24,CL
6bd5cd5d,6,2,5,1,0,3,8,5,4,4,0,3,9,10,1,24,CL
6c731625,0,0,0,0,0,0,0,0,1,0,1,0,0,3,0,24,CL
6c8ddd52,20,12,13,5,2,11,22,11,10,3,7,6,26,20,0,24,CL
6cbf8d0d,1,0,0,0,1,0,0,0,1,0,1,0,1,0,0,24,CL
6cdd9d3d,0,0,0,0,0,0,0,0,0,0,0,0,0,0,0,24,CL
6ce1f46f,10,6,4,4,2,5,14,9,1,0,1,3,13,6,0,24,CL
6ce43701,1,0,0,0,1,0,0,0,1,0,1,0,1,1,0,24,CL
6e058f06,3,0,0,3,0,1,3,2,2,0,2,1,4,2,0,24,CL
6e33125f,4,2,3,1,0,3,5,2,4,2,2,4,8,27,0,24,CL
6e44569a,2,2,2,0,0,1,2,1,3,0,3,0,2,1,0,24,CL
6f22e535,4,4,3,1,0,1,1,0,3,3,0,0,4,6,0,24,CL
6f3cc2fe,6,3,1,4,1,3,4,1,3,0,3,3,9,2,0,24,CL
6f51170f,2,1,1,1,0,0,0,0,0,0,0,0,2,0,0,24,CL
6f51e382,0,0,0,0,0,0,0,0,0,0,0,0,0,1,0,24,CL
6f5ec8bb,9,6,5,4,0,6,7,1,10,0,10,5,14,13,0,24,CL
6f8cd6d0,4,3,1,1,2,1,1,0,2,0,2,1,5,3,0,24,CL
6fd8a334,6,2,3,3,0,3,8,5,17,15,2,6,12,34,0,24,CL
6fe5c35b,0,0,0,0,0,0,0,0,0,0,0,1,1,2,0,24,CL
70c52749,7,5,4,2,1,3,6,3,2,0,2,0,7,5,0,24,CL
70cf63ca,7,4,2,2,3,1,6,5,2,0,2,3,10,0,0,24,CL
70dcf94d,5,2,1,4,0,3,11,8,4,1,3,1,6,5,0,24,CL
7111d552,4,2,3,1,0,0,2,2,3,0,3,0,4,1,0,24,CL
7120a04d,7,2,3,2,2,4,10,6,2,0,2,2,9,3,0,24,CL
71ec39ef,10,5,9,1,0,5,7,2,3,0,3,4,14,4,0,24,CL
722494dc,19,8,8,9,2,10,16,6,13,4,9,7,26,6,1,24,CL
7226539b,1,1,1,0,0,1,4,3,1,0,1,1,2,6,0,24,CL
72984eee,0,0,0,0,0,0,3,3,0,0,0,1,1,0,0,24,CL
73d6a176,0,0,0,0,0,0,4,4,5,0,5,1,1,3,0,24,CL
7483d9f9,8,5,5,3,0,5,5,0,10,6,4,4,12,15,0,24,CL
75b86fb3,5,1,3,2,0,1,3,2,6,1,5,6,11,15,1,24,CL
760fd987,7,2,6,1,0,3,5,2,5,1,4,5,12,8,0,24,CL
762179d9,19,8,11,5,3,14,20,6,8,2,6,9,28,9,1,24,CL
7713c72a,7,4,4,3,0,5,7,2,6,3,3,5,12,18,2,24,CL
7767cb03,5,3,3,0,2,1,6,5,4,0,4,0,5,1,0,24,CL
78c3ad07,1,0,1,0,0,1,1,0,0,0,0,0,1,1,0,24,CL
78c513b3,0,0,0,0,0,0,1,1,0,0,0,0,0,3,3,24,CL
78f21137,11,6,7,3,1,7,9,2,7,1,6,4,15,6,0,24,CL
78f85621,0,0,0,0,0,0,2,2,1,0,1,0,0,1,0,24,CL
79083382,11,4,3,7,1,4,6,2,6,3,3,4,15,17,0,24,CL
79300479,9,3,1,6,2,4,9,5,4,0,4,5,14,0,0,24,CL
79b51257,0,0,0,0,0,0,1,1,4,2,2,0,0,1,0,24,CL
79c0821a,6,2,2,4,0,1,6,5,2,1,1,3,9,3,0,24,CL
7a42d0df,10,7,6,3,1,7,12,5,7,1,6,5,15,8,0,24,CL
7aa8adfe,4,4,0,4,0,2,4,2,6,0,6,5,9,0,0,24,CL
7b9c2d84,16,8,7,4,5,5,11,6,11,3,8,6,22,11,0,24,CL
7c2965bb,0,0,0,0,0,0,0,0,1,0,1,0,0,0,0,24,CL
7d3e7da6,0,0,0,0,0,0,0,0,0,0,0,0,0,2,1,24,CL
7d450ed3,17,12,8,5,4,11,17,6,11,7,4,10,27,15,0,24,CL
7e0b6c50,0,0,0,0,0,0,1,1,0,0,0,0,0,0,0,24,CL
7edfbb8a,16,9,7,8,1,6,7,1,13,6,7,10,26,15,0,24,CL
7f14ec2a,4,1,2,2,0,1,1,0,7,0,7,1,5,1,0,24,CL
7f40333d,0,0,0,0,0,0,2,2,0,0,0,0,0,0,2,24,CL
7fa4e703,1,0,0,1,0,1,1,0,1,1,0,0,1,1,0,24,CL
803e7aca,6,5,0,5,1,2,4,2,9,0,9,3,9,1,0,24,CL
812e5ded,4,4,2,1,1,2,3,1,0,0,0,1,5,2,1,24,CL
81442ecb,2,2,1,1,0,1,2,1,1,1,0,1,3,2,0,24,CL
817c6964,4,2,3,0,1,1,5,4,0,0,0,3,7,4,0,24,CL
817ee048,1,0,1,0,0,0,0,0,2,0,2,1,2,5,0,24,CL
819b3158,4,4,0,1,3,3,6,3,12,3,9,5,9,2,1,24,CL
82464ce3,9,5,3,6,0,2,6,4,6,1,5,5,14,7,0,24,CL
82518f62,13,11,9,2,2,6,14,8,10,4,6,6,19,8,0,24,CL
829aa60c,1,1,0,1,0,1,4,3,4,0,4,2,3,0,0,24,CL
82a39b66,21,15,14,6,1,14,26,12,8,0,8,2,23,11,0,24,CL
82e9b1bb,15,9,11,4,0,8,15,7,8,4,4,7,22,8,0,24,CL
82ec26c1,6,5,2,1,3,1,8,7,14,0,14,5,11,1,0,24,CL
83300259,13,6,9,3,1,6,14,8,9,3,6,3,16,10,0,24,CL
839c14e1,0,0,0,0,0,0,2,2,2,0,2,0,0,2,0,24,CL
8455ad90,7,4,2,3,2,5,8,3,3,0,3,2,9,2,0,24,CL
858a54c3,4,2,1,1,2,1,2,1,2,0,2,1,5,6,0,24,CL
85f7d1be,0,0,0,0,0,0,1,1,1,0,1,2,2,2,0,24,CL
862a1c15,15,11,4,7,4,10,15,5,8,1,7,4,19,2,0,24,CL
8652a85c,2,1,1,1,0,0,7,7,3,0,3,0,2,2,0,24,CL
86dd77d1,6,3,2,3,1,5,5,0,1,0,1,3,9,3,0,24,CL
86df4d6b,5,3,3,1,1,2,5,3,2,0,2,1,6,7,0,24,CL
8778c910,0,0,0,0,0,0,0,0,0,0,0,0,0,2,0,24,CL
881cd6be,3,2,0,2,1,1,3,2,1,0,1,3,6,1,1,24,CL
8830d81d,0,0,0,0,0,0,2,2,0,0,0,0,0,2,0,24,CL
88ce7ddc,0,0,0,0,0,0,3,3,0,0,0,1,1,1,0,24,CL
88ced02c,4,2,2,2,0,3,4,1,4,2,2,4,8,12,0,24,CL
88e357ef,2,1,0,0,2,1,2,1,4,0,4,0,2,0,0,24,CL
89ac64a6,4,3,2,2,0,1,3,2,3,2,1,2,6,10,0,24,CL
89b2c8a9,0,0,0,0,0,0,1,1,6,0,6,2,2,2,0,24,CL
89f951b5,11,4,2,9,0,3,10,7,6,2,4,3,14,3,0,24,CL
8a2248b4,0,0,0,0,0,0,0,0,0,0,0,0,0,2,0,24,CL
8aafd64f,4,1,0,3,1,0,5,5,0,0,0,0,4,1,0,24,CL
8b788c01,0,0,0,0,0,0,0,0,0,0,0,1,1,1,0,24,CL
8b8a56ce,0,0,0,0,0,0,0,0,0,0,0,0,0,0,0,24,CL
8b8e759d,2,1,1,0,1,1,1,0,1,0,1,0,2,1,0,24,CL
8c3c640c,8,5,2,3,3,1,4,3,4,1,3,0,8,0,0,24,CL
8c451492,2,2,1,0,1,1,5,4,3,0,3,1,3,1,0,24,CL
8c90fd7a,0,0,0,0,0,0,1,1,2,2,0,3,3,10,0,24,CL
8d3cd59d,10,6,6,4,0,5,10,5,6,2,4,0,10,15,0,24,CL
8d4baac4,14,9,7,4,3,3,12,9,16,3,13,5,19,3,0,24,CL
8d78e732,1,1,0,0,1,1,2,1,5,1,4,0,1,6,0,24,CL
8e034340,2,0,0,1,1,0,3,3,1,0,1,1,3,0,0,24,CL
8e6d2fcd,0,0,0,0,0,0,0,0,0,0,0,0,0,0,1,24,CL
8e92be30,1,0,0,1,0,1,1,0,3,2,1,0,1,2,0,24,CL
8eb55dbb,0,0,0,0,0,0,0,0,3,1,2,1,1,1,0,24,CL
8eef18aa,6,3,5,1,0,4,6,2,8,8,0,5,11,22,0,24,CL
8f0435c7,8,6,7,1,0,6,7,1,3,2,1,1,9,16,0,24,CL
8f056768,21,15,10,10,1,4,13,9,9,3,6,5,26,7,2,24,CL
8f5e92a6,4,3,1,2,1,1,5,4,6,1,5,2,6,1,0,24,CL
8f696594,0,0,0,0,0,0,1,1,1,1,0,1,1,0,0,24,CL
8f7e6783,8,7,1,5,2,2,6,4,2,1,1,2,10,1,0,24,CL
8fd9996f,4,4,3,1,0,1,1,0,2,2,0,1,5,3,0,24,CL
90ba7fa6,6,3,0,4,2,2,2,0,0,0,0,0,6,1,0,24,CL
90f87966,4,1,3,1,0,1,6,5,6,4,2,1,5,16,1,24,CL
90fcf472,1,0,0,1,0,1,2,1,0,0,0,0,1,0,0,24,CL
92432bc6,7,3,7,0,0,7,12,5,6,1,5,2,9,4,0,24,CL
928a4a61,7,4,5,2,0,4,6,2,3,1,2,2,9,2,0,24,CL
92fa5d28,19,10,8,7,4,6,14,8,5,1,4,5,24,4,0,24,CL
93fffbcf,0,0,0,0,0,0,0,0,0,0,0,0,0,6,1,24,CL
9413b19f,0,0,0,0,0,0,0,0,0,0,0,0,0,4,0,24,CL
9440e587,9,5,6,3,0,5,10,5,6,3,3,0,9,12,0,24,CL
947e036f,4,3,1,2,1,1,4,3,5,0,5,0,4,2,1,24,CL
94bccc82,10,6,7,2,1,6,9,3,14,11,3,5,15,20,0,24,CL
951f1739,3,3,1,0,2,3,6,3,0,0,0,0,3,0,0,24,CL
96094cbc,0,0,0,0,0,0,0,0,0,0,0,0,0,0,0,24,CL
966e28d0,6,2,2,1,3,3,10,7,3,0,3,1,7,0,0,24,CL
9674002f,2,1,1,0,1,0,0,0,0,0,0,1,3,0,0,24,CL
96e0490d,8,3,3,4,1,5,9,4,9,2,7,2,10,10,0,24,CL
970b8574,0,0,0,0,0,0,5,5,6,1,5,3,3,4,0,24,CL
972aeb2a,8,3,4,3,1,4,7,3,3,1,2,5,13,21,0,24,CL
980522ec,0,0,0,0,0,0,3,3,3,1,2,3,3,3,0,24,CL
98ea5115,0,0,0,0,0,0,0,0,0,0,0,0,0,3,1,24,CL
99127249,7,6,5,1,1,5,9,4,5,1,4,5,12,2,0,24,CL
9a2e0ccc,8,4,4,1,3,3,8,5,4,1,3,4,12,2,0,24,CL
9a64e67e,8,5,6,1,1,4,9,5,2,1,1,11,19,16,0,24,CL
9b3ab988,0,0,0,0,0,0,0,0,0,0,0,1,1,1,0,24,CL
9b5237b1,1,1,1,0,0,1,1,0,1,0,1,0,1,1,0,24,CL
9b909569,1,0,0,1,0,0,0,0,0,0,0,1,2,4,0,24,CL
9b94c838,0,0,0,0,0,0,0,0,0,0,0,0,0,0,0,24,CL
9bd73cce,3,3,0,1,2,1,2,1,4,1,3,1,4,2,0,24,CL
9bf914b4,6,2,3,2,1,3,9,6,3,1,2,0,6,2,0,24,CL
9c435456,8,8,8,0,0,4,7,3,7,6,1,4,12,12,0,24,CL
9c94165b,2,2,0,2,0,1,2,1,2,1,1,3,5,0,0,24,CL
9d21da85,5,3,3,2,0,2,3,1,6,4,2,2,7,8,0,24,CL
9d7d5334,13,7,6,6,1,6,8,2,10,0,10,3,16,11,0,24,CL
9dff291c,5,3,5,0,0,3,4,1,8,7,1,7,12,26,0,24,CL
9e1035f8,3,2,2,0,1,1,2,1,1,0,1,0,3,2,0,24,CL
9e39fa2d,2,0,2,0,0,1,1,0,3,2,1,2,4,1,0,24,CL
9e525177,7,5,3,4,0,1,1,0,1,0,1,10,17,9,0,24,CL
9f1893b9,17,7,5,10,2,5,21,16,7,0,7,12,29,5,0,24,CL
9f8e9423,4,3,2,2,0,1,1,0,6,3,3,4,8,13,0,24,CL
9ffb2ce6,15,6,6,8,1,6,11,5,5,1,4,8,23,12,1,24,CL
a086ae11,2,1,1,1,0,1,1,0,1,0,1,2,4,3,0,24,CL
a08b974a,5,2,1,4,0,2,6,4,4,0,4,4,9,2,0,24,CL
a0d55a09,8,7,1,4,3,2,7,5,6,0,6,3,11,2,0,24,CL
a167537f,12,6,6,6,0,10,17,7,6,0,6,4,16,6,0,24,CL
a1d5bd30,3,3,1,2,0,1,3,2,2,0,2,1,4,2,0,24,CL
a29e5244,2,1,1,1,0,1,3,2,2,0,2,4,6,2,0,24,CL
a2abe631,2,0,2,0,0,2,2,0,0,0,0,0,2,9,0,24,CL
a2b105e0,7,3,3,4,0,2,5,3,7,1,6,2,9,2,0,24,CL
a2b1ed42,1,0,0,1,0,0,0,0,1,0,1,0,1,0,0,24,CL
a39d11bc,3,2,3,0,0,3,4,1,2,2,0,0,3,1,0,24,CL
a3b03921,2,2,1,1,0,2,3,1,1,1,0,0,2,0,0,24,CL
a4b00319,9,6,5,3,1,3,9,6,8,1,7,10,19,3,0,24,CL
a4b1028a,7,3,2,2,3,3,7,4,6,2,4,12,19,11,0,24,CL
a4e16ab4,0,0,0,0,0,0,1,1,1,0,1,1,1,1,1,24,CL
a5296e55,2,1,0,1,1,0,2,2,1,0,1,4,6,2,0,24,CL
a53649b7,0,0,0,0,0,0,0,0,0,0,0,0,0,1,0,24,CL
a5420709,13,11,0,10,3,2,4,2,13,2,11,8,21,5,0,24,CL
a63a995f,2,1,1,1,0,1,1,0,2,1,1,3,5,2,0,24,CL
a65ce836,11,8,5,6,0,5,11,6,6,1,5,7,18,12,0,24,CL
a686ef30,1,0,0,1,0,0,1,1,0,0,0,1,2,0,0,24,CL
a69e4806,5,4,2,3,0,2,8,6,5,0,5,2,7,4,0,24,CL
a70b8345,0,0,0,0,0,0,0,0,0,0,0,0,0,2,0,24,CL
a793f5a8,4,2,2,2,0,2,8,6,3,0,3,6,10,6,0,24,CL
a820e429,3,2,1,2,0,1,1,0,0,0,0,0,3,2,0,24,CL
a8b8af8d,3,1,2,1,0,1,1,0,1,1,0,0,3,3,0,24,CL
a93b6f4e,2,1,2,0,0,2,3,1,5,5,0,4,6,7,0,24,CL
aa34ed38,1,0,1,0,0,1,3,2,1,0,1,0,1,1,0,24,CL
ab57e591,6,3,1,4,1,2,14,12,2,0,2,2,8,0,0,24,CL
abb3bb95,5,5,1,3,1,2,2,0,7,2,5,1,6,4,0,24,CL
abc06eb3,0,0,0,0,0,0,0,0,0,0,0,0,0,2,2,24,CL
abe66106,7,3,3,2,2,3,4,1,4,0,4,2,9,0,0,24,CL
ac295d9e,0,0,0,0,0,0,0,0,0,0,0,0,0,3,0,24,CL
ac4003af,0,0,0,0,0,0,0,0,0,0,0,0,0,1,0,24,CL
ac73ec79,0,0,0,0,0,0,0,0,2,1,1,0,0,1,0,24,CL
ac7e7b1c,3,2,1,1,1,0,2,2,0,0,0,1,4,0,0,24,CL
ac861941,0,0,0,0,0,0,0,0,0,0,0,2,2,3,0,24,CL
adc77724,4,3,2,2,0,3,5,2,5,2,3,1,5,6,0,24,CL
adfbe1f5,11,6,5,4,2,7,14,7,2,0,2,2,13,7,0,24,CL
ae44e8e2,4,1,2,2,0,1,4,3,1,0,1,0,4,2,0,24,CL
ae59b359,5,5,2,3,0,2,3,1,3,1,2,3,8,2,0,24,CL
aee634bf,8,5,4,4,0,6,8,2,3,0,3,6,14,3,0,24,CL
af50141d,4,2,1,3,0,2,8,6,1,0,1,0,4,0,0,24,CL
afb61630,11,4,4,5,2,6,11,5,7,0,7,5,16,4,0,24,CL
afed6722,9,6,3,5,1,4,5,1,5,1,4,1,10,9,1,24,CL
b0395623,0,0,0,0,0,0,0,0,1,0,1,0,0,0,0,24,CL
b05f4787,0,0,0,0,0,0,0,0,0,0,0,1,1,0,0,24,CL
b0b4fd3e,2,1,0,2,0,0,4,4,3,0,3,2,4,1,0,24,CL
b19db005,10,7,1,5,4,5,12,7,3,0,3,5,15,0,0,24,CL
b2bc3b1f,9,7,2,6,1,3,4,1,5,0,5,1,10,1,0,24,CL
b2d31e83,6,3,5,1,0,3,4,1,9,5,4,1,7,16,0,24,CL
b35a7399,4,3,3,1,0,0,1,1,4,3,1,2,6,13,0,24,CL
b3a712de,7,4,4,1,2,6,11,5,17,3,14,4,11,10,0,24,CL
b3af9be1,1,0,1,0,0,1,3,2,4,0,4,2,3,5,0,24,CL
b3f8bdef,10,7,5,5,0,5,6,1,5,0,5,2,12,10,0,24,CL
b51b1b9c,6,3,2,3,1,2,2,0,4,2,2,2,8,3,0,24,CL
b56dd813,0,0,0,0,0,0,0,0,0,0,0,0,0,0,0,24,CL
b57e066e,8,5,4,1,3,3,5,2,8,2,6,3,11,4,0,24,CL
b66315ae,6,3,0,5,1,0,3,3,5,0,5,1,7,2,0,24,CL
b6db05c3,0,0,0,0,0,0,0,0,0,0,0,0,0,0,0,24,CL
b74277a0,11,7,5,4,2,6,9,3,6,2,4,6,17,4,0,24,CL
b7de5bad,10,6,6,4,0,10,15,5,3,1,2,3,13,9,0,24,CL
b7f2edff,0,0,0,0,0,0,1,1,1,0,1,0,0,1,0,24,CL
b825a650,8,7,2,6,0,4,6,2,4,1,3,4,12,6,0,24,CL
b8a642fc,2,2,0,1,1,1,3,2,2,1,1,0,2,1,0,24,CL
b8aedf06,6,3,4,2,0,4,8,4,2,0,2,4,10,6,0,24,CL
b96b595c,3,1,2,0,1,2,5,3,1,0,1,5,8,15,0,24,CL
b9beb6c5,1,0,1,0,0,0,3,3,0,0,0,0,1,2,0,24,CL
ba115a40,0,0,0,0,0,0,0,0,2,1,1,1,1,1,0,24,CL
ba3d3bea,2,1,1,1,0,1,2,1,0,0,0,1,3,1,0,24,CL
bac46a10,0,0,0,0,0,0,0,0,4,2,2,2,2,1,1,24,CL
bbd86530,6,6,5,1,0,4,8,4,4,0,4,0,6,1,0,24,CL
bbf5c11b,0,0,0,0,0,0,0,0,0,0,0,1,1,0,0,24,CL
bc2618f0,2,2,1,1,0,1,3,2,1,0,1,3,5,4,0,24,CL
bc62d898,3,2,3,0,0,1,2,1,3,1,2,0,3,0,0,24,CL
bc6e544a,12,4,9,1,2,7,13,6,10,2,8,6,18,21,0,24,CL
bc7dc64d,12,9,3,6,3,5,11,6,9,1,8,1,13,3,0,24,CL
bcb2ccd8,0,0,0,0,0,0,0,0,0,0,0,0,0,1,0,24,CL
bd6351cd,21,14,9,7,5,12,16,4,11,4,7,16,37,13,1,24,CL
bdedffac,0,0,0,0,0,0,1,1,0,0,0,0,0,0,0,24,CL
be47b750,1,0,0,1,0,0,0,0,3,0,3,0,1,2,0,24,CL
beec76cc,6,4,1,3,2,1,1,0,0,0,0,1,7,2,0,24,CL
bf356094,3,2,1,2,0,1,4,3,2,0,2,1,4,0,0,24,CL
c0295327,1,1,0,0,1,0,0,0,0,0,0,0,1,0,0,24,CL
c0347e9b,1,1,1,0,0,1,1,0,0,0,0,1,2,0,0,24,CL
c0617e2b,3,1,1,1,1,1,4,3,1,0,1,3,6,2,0,24,CL
c0b3669f,7,3,4,2,1,0,1,1,4,1,3,1,8,4,0,24,CL
c0c7ff58,5,4,2,3,0,4,6,2,5,0,5,5,10,2,0,24,CL
c1242d4e,0,0,0,0,0,0,0,0,0,0,0,0,0,1,0,24,CL
c14bc029,7,5,5,1,1,6,9,3,9,2,7,4,11,9,0,24,CL
c17bfb65,5,3,3,2,0,1,6,5,6,2,4,4,9,7,0,24,CL
c1b7847c,21,14,10,6,5,12,24,12,10,2,8,4,25,3,0,24,CL
c1fe5f0b,7,5,1,6,0,2,7,5,3,0,3,2,9,0,0,24,CL
c20bdcd7,1,0,1,0,0,0,0,0,2,2,0,2,3,2,1,24,CL
c2a15a27,24,18,14,7,3,12,20,8,8,2,6,10,34,10,0,24,CL
c3cf087d,9,8,3,4,2,6,10,4,1,0,1,1,10,0,0,24,CL
c3ee18ef,11,7,6,5,0,10,13,3,5,0,5,3,14,18,0,24,CL
c4987edc,11,5,9,2,0,7,16,9,15,9,6,5,16,30,0,24,CL
c54638ba,0,0,0,0,0,0,1,1,1,0,1,0,0,0,0,24,CL
c596fcb0,0,0,0,0,0,0,1,1,1,0,1,0,0,0,0,24,CL
c5bdb6e3,6,3,0,3,3,4,6,2,1,0,1,1,7,0,0,24,CL
c6220452,2,1,1,1,0,0,0,0,1,1,0,0,2,2,0,24,CL
c632fa35,1,0,1,0,0,0,2,2,0,0,0,3,4,2,0,24,CL
c693347d,1,1,0,1,0,0,0,0,0,0,0,0,1,0,0,24,CL
c70be9cf,4,2,2,1,1,1,5,4,5,1,4,1,5,2,0,24,CL
c762b1a6,10,6,6,3,1,6,8,2,5,1,4,5,15,3,0,24,CL
c76b7567,0,0,0,0,0,0,1,1,5,0,5,0,0,2,1,24,CL
c8829a58,0,0,0,0,0,0,3,3,1,0,1,0,0,1,0,24,CL
c8aa95da,7,7,4,3,0,4,9,5,7,5,2,6,13,28,0,24,CL
c8ccc39e,5,5,4,0,1,4,7,3,2,1,1,2,7,6,0,24,CL
c8d1c3a5,7,4,4,1,2,4,8,4,0,0,0,1,8,5,0,24,CL
c8e65157,0,0,0,0,0,0,0,0,0,0,0,0,0,1,0,24,CL
c906ce0f,10,8,9,1,0,6,11,5,6,5,1,8,18,20,0,24,CL
c952f633,14,9,10,2,2,7,15,8,11,2,9,4,18,7,0,24,CL
c9817014,8,3,3,4,1,4,22,18,2,1,1,6,14,5,0,24,CL
c9e39d91,13,8,0,8,5,6,10,4,7,1,6,3,16,8,0,24,CL
ca22ccb0,2,1,1,1,0,1,2,1,0,0,0,0,2,0,0,24,CL
ca607d59,0,0,0,0,0,0,1,1,0,0,0,0,0,0,0,24,CL
ca8033cb,6,3,4,2,0,5,8,3,4,2,2,4,10,23,0,24,CL
cab9634e,4,2,3,1,0,3,5,2,3,0,3,5,9,8,0,24,CL
cabb3a1d,9,6,6,1,2,7,12,5,3,0,3,5,14,2,0,24,CL
cb4f24c6,0,0,0,0,0,0,0,0,0,0,0,0,0,5,0,24,CL
cc1c5035,0,0,0,0,0,0,0,0,0,0,0,0,0,2,0,24,CL
cc6de655,15,8,10,4,1,9,24,15,6,1,5,2,17,5,0,24,CL
cc7888f3,3,3,2,1,0,0,0,0,0,0,0,1,4,5,0,24,CL
cc86b9a3,9,6,4,4,1,5,13,8,9,2,7,15,24,11,0,24,CL
ccce7025,0,0,0,0,0,0,1,1,1,1,0,0,0,2,0,24,CL
cd0fa27b,10,5,7,2,1,4,13,9,8,2,6,6,16,4,0,24,CL
cd1629bc,0,0,0,0,0,0,0,0,1,0,1,0,0,0,0,24,CL
cd59b9df,0,0,0,0,0,0,1,1,0,0,0,0,0,6,0,24,CL
cd6a1a59,9,7,4,4,1,3,8,5,2,0,2,8,17,6,0,24,CL
cf007308,1,0,1,0,0,0,1,1,2,0,2,3,4,0,0,24,CL
d080ed5e,15,8,8,4,3,6,13,7,8,1,7,4,19,15,0,24,CL
d0b8e745,2,0,1,1,0,1,1,0,1,0,1,0,2,0,0,24,CL
d0d8dd44,9,5,6,3,0,4,8,4,6,3,3,5,14,34,0,24,CL
d17ce930,2,1,2,0,0,2,3,1,1,0,1,0,2,0,0,24,CL
d2416c2e,1,0,0,0,1,0,4,4,2,0,2,1,2,0,1,24,CL
d248cd8f,16,11,11,5,0,7,9,2,2,1,1,5,21,13,0,24,CL
d25422fb,1,0,0,0,1,0,2,2,0,0,0,0,1,1,0,24,CL
d3d774cc,1,0,0,1,0,1,1,0,1,0,1,0,1,3,0,24,CL
d4535821,9,8,2,7,0,5,7,2,6,5,1,8,17,10,0,24,CL
d4808594,0,0,0,0,0,0,0,0,0,0,0,0,0,1,0,24,CL
d4c9725f,7,5,5,2,0,4,5,1,4,2,2,5,12,16,0,24,CL
d5127c3f,2,1,1,1,0,1,1,0,0,0,0,0,2,1,0,24,CL
d5f2f82b,10,2,9,1,0,6,10,4,5,3,2,6,16,22,1,24,CL
d6e53a3a,1,1,1,0,0,0,1,1,3,2,1,2,3,9,0,24,CL
d781d855,11,6,7,2,2,5,14,9,9,2,7,4,15,10,0,24,CL
d7a03bf3,6,2,3,1,2,4,11,7,2,0,2,1,7,4,0,24,CL
d85c238b,8,5,2,6,0,4,7,3,8,1,7,5,13,2,0,24,CL
d874b374,1,1,0,1,0,0,1,1,0,0,0,0,1,0,0,24,CL
d8931174,1,1,1,0,0,1,1,0,6,3,3,4,5,13,0,24,CL
d93c2511,2,1,1,1,0,1,7,6,5,3,2,1,3,6,0,24,CL
d9565625,7,5,4,2,1,3,8,5,8,4,4,3,10,13,0,24,CL
d9d43555,0,0,0,0,0,0,1,1,0,0,0,0,0,0,0,24,CL
da011f18,1,1,1,0,0,1,1,0,0,0,0,0,1,3,0,24,CL
da4d670f,5,2,3,2,0,1,7,6,7,0,7,4,9,1,0,24,CL
da76bab4,2,0,1,1,0,0,5,5,1,0,1,0,2,2,0,24,CL
da7b447d,8,7,4,2,2,5,12,7,9,3,6,5,13,12,1,24,CL
dbf053da,4,3,1,2,1,2,3,1,1,0,1,0,4,1,0,24,CL
dc234f98,4,2,3,1,0,2,5,3,5,3,2,3,7,11,0,24,CL
dc3e663e,6,3,3,2,1,2,10,8,1,1,0,2,8,4,0,24,CL
dc7a172e,0,0,0,0,0,0,0,0,0,0,0,0,0,1,0,24,CL
dd0daf32,10,5,5,5,0,3,8,5,10,3,7,8,18,10,0,24,CL
dd95af65,9,5,6,3,0,3,13,10,2,1,1,4,13,12,0,24,CL
de112b84,2,2,1,0,1,1,2,1,1,1,0,0,2,1,0,24,CL
de31038e,2,1,1,1,0,0,2,2,1,1,0,2,4,0,0,24,CL
de8f6250,0,0,0,0,0,0,0,0,0,0,0,1,1,0,0,24,CL
dea88efd,8,5,1,4,3,3,7,4,8,0,8,4,12,2,0,24,CL
df525574,12,8,7,4,1,8,17,9,5,4,1,10,22,11,0,24,CL
df69b544,9,7,3,5,1,2,12,10,8,1,7,5,14,6,0,24,CL
e08647d6,1,1,1,0,0,1,2,1,1,0,1,1,2,1,0,24,CL
e095928e,5,3,1,0,4,3,10,7,3,1,2,0,5,2,0,24,CL
e0f8151c,9,5,6,3,0,2,5,3,13,8,5,12,21,22,0,24,CL
e1cbb531,11,5,6,5,0,6,15,9,7,2,5,10,21,7,1,24,CL
e280527c,9,6,4,3,2,6,11,5,6,1,5,3,12,10,0,24,CL
e288d4b3,8,7,6,2,0,4,7,3,3,1,2,2,10,6,0,24,CL
e2f16dcc,3,2,0,2,1,1,1,0,4,0,4,1,4,0,0,24,CL
e33c06cf,12,9,9,3,0,10,17,7,4,2,2,2,14,12,0,24,CL
e42d61c7,14,8,6,5,3,8,16,8,9,0,9,11,25,11,2,24,CL
e46012d4,3,2,0,1,2,2,4,2,0,0,0,0,3,0,0,24,CL
e514ab62,0,0,0,0,0,0,0,0,0,0,0,0,0,0,0,24,CL
e53b5534,3,1,3,0,0,3,3,0,1,1,0,0,3,6,1,24,CL
e58cbfd5,5,4,2,2,1,2,4,2,1,0,1,3,8,0,0,24,CL
e6af02e0,4,2,0,3,1,3,5,2,2,0,2,3,7,2,0,24,CL
e6bc67d7,0,0,0,0,0,0,1,1,1,0,1,0,0,0,0,24,CL
e717705a,7,4,4,2,1,3,6,3,3,1,2,2,9,2,0,24,CL
e73659d3,2,0,0,1,1,1,1,0,0,0,0,0,2,0,0,24,CL
e7f3e8a7,2,1,1,1,0,2,4,2,2,0,2,3,5,0,0,24,CL
e82900ef,2,1,0,1,1,1,1,0,1,0,1,0,2,6,0,24,CL
e83d5f45,8,4,1,6,1,4,8,4,1,0,1,3,11,3,0,24,CL
e8ef59da,1,1,1,0,0,0,1,1,1,0,1,0,1,0,0,24,CL
e97fd090,3,3,1,1,1,1,2,1,1,0,1,0,3,2,0,24,CL
e9c0c1b2,0,0,0,0,0,0,0,0,0,0,0,1,1,2,4,24,CL
e9fda01d,0,0,0,0,0,0,0,0,0,0,0,0,0,0,0,24,CL
eab85789,5,3,1,1,3,2,4,2,2,0,2,2,7,2,0,24,CL
eaeca114,4,2,3,1,0,2,3,1,1,0,1,0,4,11,0,24,CL
eb907bfc,3,3,0,3,0,1,6,5,3,0,3,0,3,1,0,24,CL
ed1e53f3,1,1,0,0,1,0,1,1,4,0,4,2,3,2,0,24,CL
ed45a7d7,4,3,1,2,1,3,6,3,3,1,2,2,6,5,0,24,CL
ee3519f5,14,7,12,2,0,8,9,1,5,2,3,6,20,19,0,24,CL
ee6e2b92,0,0,0,0,0,0,1,1,0,0,0,0,0,0,0,24,CL
ee8508c0,0,0,0,0,0,0,0,0,0,0,0,0,0,1,1,24,CL
eed2427e,2,1,0,2,0,2,2,0,0,0,0,0,2,0,0,24,CL
ef233486,2,2,1,1,0,1,2,1,3,0,3,0,2,3,0,24,CL
ef3909cd,0,0,0,0,0,0,0,0,0,0,0,0,0,1,0,24,CL
f0021247,2,1,1,0,1,2,8,6,2,0,2,2,4,3,0,24,CL
f0677ed7,13,8,8,4,1,7,13,6,9,2,7,3,16,13,0,24,CL
f0da930c,0,0,0,0,0,0,2,2,6,5,1,2,2,22,0,24,CL
f179ee11,8,5,8,0,0,6,6,0,8,5,3,7,15,39,0,24,CL
f20e4cc9,1,0,1,0,0,0,0,0,0,0,0,2,3,4,0,24,CL
f28659fb,5,4,1,2,2,5,7,2,3,0,3,2,7,5,0,24,CL
f3945e07,0,0,0,0,0,0,0,0,0,0,0,0,0,2,0,24,CL
f40dd3c7,3,2,1,1,1,3,6,3,1,0,1,0,3,0,1,24,CL
f4290206,1,0,0,1,0,1,1,0,3,0,3,2,3,5,0,24,CL
f446748f,1,0,0,1,0,1,1,0,2,0,2,0,1,3,0,24,CL
f4b52308,9,7,4,4,1,5,11,6,4,0,4,6,15,6,0,24,CL
f4cda99f,4,3,2,0,2,2,6,4,4,1,3,3,7,1,0,24,CL
f5692b25,8,7,6,2,0,5,8,3,2,0,2,2,10,4,0,24,CL
f5a00fa4,8,4,2,5,1,4,10,6,4,1,3,7,15,1,0,24,CL
f5b6fb78,6,4,3,3,0,3,8,5,7,5,2,7,13,15,0,24,CL
f5deef4c,0,0,0,0,0,0,1,1,6,2,4,1,1,11,0,24,CL
f63cda26,3,2,2,1,0,2,3,1,1,0,1,0,3,2,0,24,CL
f67c9d29,5,2,4,1,0,2,7,5,4,2,2,1,6,11,0,24,CL
f6ac68c1,5,2,3,1,1,3,3,0,4,1,3,11,16,15,0,24,CL
f7036e1c,5,1,1,3,1,1,5,4,6,0,6,1,6,3,0,24,CL
f7223718,3,3,3,0,0,3,4,1,3,2,1,5,8,17,0,24,CL
f7b10c66,0,0,0,0,0,0,0,0,0,0,0,0,0,1,0,24,CL
f7d50789,6,4,4,2,0,5,9,4,9,5,4,5,11,24,0,24,CL
f7dc2ae5,7,4,5,1,1,5,6,1,3,0,3,1,8,7,0,24,CL
f8405304,0,0,0,0,0,0,0,0,1,0,1,0,0,0,0,24,CL
f882b0a1,3,1,2,0,1,2,3,1,3,1,2,2,5,4,0,24,CL
f8fcd2a5,1,1,1,0,0,1,1,0,2,1,1,0,1,1,0,24,CL
f9acca3a,16,7,12,4,0,4,8,4,5,2,3,9,25,10,0,24,CL
fa661778,13,8,9,2,2,6,8,2,4,1,3,4,17,14,0,24,CL
fb495bb8,14,8,7,6,1,9,19,10,8,1,7,7,21,10,0,24,CL
fc3697dd,18,9,9,8,1,11,18,7,7,1,6,2,20,2,0,24,CL
fc4e7637,10,7,8,2,0,1,6,5,3,0,3,3,13,1,1,24,CL
fcb27134,12,7,12,0,0,7,15,8,7,4,3,10,22,23,0,24,CL
fcb38f57,0,0,0,0,0,0,0,0,0,0,0,0,0,4,0,24,CL
fce2302c,2,2,0,1,1,2,2,0,3,0,3,2,4,2,0,24,CL
fcea4f04,0,0,0,0,0,0,0,0,0,0,0,0,0,0,0,24,CL
fd4d5f81,0,0,0,0,0,0,1,1,3,0,3,1,1,3,0,24,CL
fd51b456,3,3,1,2,0,1,3,2,2,0,2,1,4,3,0,24,CL
fed17f5a,0,0,0,0,0,0,0,0,0,0,0,0,0,0,0,24,CL
fed7cb61,15,5,0,12,3,8,14,6,8,0,8,3,18,5,0,24,CL
ff20acfe,6,5,1,2,3,1,7,6,15,6,9,17,23,4,0,24,CL
ff2fb007,1,0,0,1,0,1,1,0,1,0,1,0,1,0,0,24,CL
ff5ea0bf,8,3,4,4,0,3,4,1,7,4,3,4,12,19,0,24,CL
ff9e56c6,1,1,0,1,0,0,7,7,5,2,3,1,2,1,0,24,CL
fffea3e5,4,2,0,4,0,2,3,1,4,0,4,0,4,0,0,24,CL
00459419,9,4,3,4,2,4,7,3,6,1,5,5,14,3,0,24,ITA
00a17eba,0,0,0,0,0,0,0,0,0,0,0,0,0,0,0,24,ITA
016ff750,11,8,2,8,1,7,12,5,12,1,11,8,19,25,0,24,ITA
01b8a2b2,0,0,0,0,0,0,0,0,0,0,0,0,0,11,2,24,ITA
01c3aff5,44,27,29,10,5,16,24,8,24,6,18,17,61,61,0,24,ITA
01efac19,3,1,1,1,1,2,5,3,4,0,4,0,3,2,0,24,ITA
028e70b9,27,18,8,11,8,13,23,10,17,1,16,3,30,34,0,24,ITA
02caf6e0,23,16,11,9,3,17,25,8,17,4,13,12,35,32,1,24,ITA
032f894e,2,1,1,1,0,2,3,1,1,0,1,0,2,1,0,24,ITA
0375723e,0,0,0,0,0,0,0,0,0,0,0,0,0,0,0,24,ITA
03f946ed,4,2,1,0,3,1,2,1,6,3,3,1,5,4,0,24,ITA
04c4edc1,0,0,0,0,0,0,0,0,0,0,0,0,0,0,0,24,ITA
04df29a5,17,12,3,9,5,8,14,6,17,5,12,0,17,14,0,24,ITA
0545a08e,9,5,1,5,3,2,4,2,4,1,3,3,12,8,0,24,ITA
0630eb63,1,1,0,0,1,1,3,2,3,0,3,0,1,0,0,24,ITA
06b08c45,39,20,22,11,6,24,44,20,17,1,16,9,48,15,0,24,ITA
0704d719,2,1,1,1,0,1,3,2,4,2,2,4,6,7,0,24,ITA
0821331c,25,10,17,7,1,11,22,11,47,29,18,19,44,102,1,24,ITA
08aa9cd1,11,8,0,6,5,3,16,13,16,2,14,0,11,29,0,24,ITA
08eb3b58,34,21,22,7,5,20,36,16,12,2,10,9,43,34,0,24,ITA
0917188a,35,23,11,17,7,16,40,24,19,2,17,12,47,9,0,24,ITA
0967845b,22,10,8,8,6,12,18,6,19,4,15,12,34,20,0,24,ITA
09899de8,26,12,16,9,1,10,15,5,36,25,11,22,48,114,0,24,ITA
099a2de5,4,3,2,0,2,2,3,1,0,0,0,0,4,0,0,24,ITA
0a447501,15,13,4,8,3,4,8,4,6,1,5,5,20,10,0,24,ITA
0a483542,16,9,13,3,0,8,18,10,11,0,11,12,28,20,0,24,ITA
0ab1f153,3,3,1,2,0,2,3,1,5,1,4,0,3,1,0,24,ITA
0b5a292a,24,14,16,3,5,12,18,6,15,2,13,12,36,19,0,24,ITA
0be276c6,35,17,29,6,0,19,24,5,32,22,10,23,58,72,2,24,ITA
0ccac09c,42,19,22,17,3,14,39,25,25,4,21,21,63,30,0,24,ITA
0cf465f2,6,4,0,1,5,3,4,1,6,0,6,1,7,0,0,24,ITA
0d077b88,5,4,1,4,0,2,4,2,3,0,3,0,5,4,0,24,ITA
0d422df7,0,0,0,0,0,0,3,3,1,0,1,0,0,5,3,24,ITA
0d82903c,11,6,5,6,0,4,5,1,12,6,6,11,22,19,0,24,ITA
0def2376,18,12,8,9,1,7,8,1,9,3,6,6,24,11,0,24,ITA
0dfce079,0,0,0,0,0,0,0,0,0,0,0,1,1,1,2,24,ITA
0fdcef0e,5,1,3,2,0,0,6,6,6,1,5,9,14,7,0,24,ITA
0fee6bda,34,19,24,8,2,20,29,9,23,12,11,23,57,102,1,24,ITA
102e2599,9,5,2,4,3,3,10,7,7,0,7,2,11,4,0,24,ITA
10549b49,6,4,2,3,1,3,7,4,0,0,0,3,9,3,1,24,ITA
1079c685,3,3,1,1,1,2,4,2,3,1,2,3,6,5,0,24,ITA
11d8aff0,0,0,0,0,0,0,0,0,0,0,0,1,1,17,3,24,ITA
12806697,23,15,13,10,0,12,23,11,18,8,10,12,35,47,1,24,ITA
130a7a3f,12,10,5,5,2,7,19,12,16,1,15,1,13,3,0,24,ITA
13b9e2fb,0,0,0,0,0,0,0,0,0,0,0,0,0,0,0,24,ITA
149c5f5d,16,12,11,4,1,14,18,4,13,5,8,0,16,13,0,24,ITA
14aac43e,2,0,1,0,1,0,2,2,1,0,1,1,3,2,0,24,ITA
14b8fcdf,9,7,5,3,1,3,4,1,10,4,6,7,16,37,0,24,ITA
15b287da,34,22,15,13,6,16,30,14,11,3,8,9,43,5,0,24,ITA
15fd5593,4,2,0,4,0,1,1,0,4,0,4,2,6,4,0,24,ITA
16463a79,10,6,2,6,2,6,7,1,4,0,4,1,11,1,0,24,ITA
16657b95,48,30,24,18,6,17,36,19,24,4,20,21,69,48,1,24,ITA
16bb656a,42,24,27,14,1,14,24,10,15,9,6,16,58,96,1,24,ITA
16ceb862,14,8,5,5,4,1,10,9,14,3,11,5,19,22,0,24,ITA
18950a80,6,4,3,1,2,3,7,4,9,6,3,7,13,25,0,24,ITA
18dd3219,24,15,11,12,1,15,20,5,17,10,7,17,41,71,1,24,ITA
1956a64b,0,0,0,0,0,0,2,2,0,0,0,0,0,0,0,24,ITA
19a12bed,32,22,20,7,5,18,26,8,23,2,21,19,51,44,0,24,ITA
1ac232b8,16,9,9,6,1,10,17,7,7,0,7,9,25,17,0,24,ITA
1bf33a9a,27,21,11,7,9,13,22,9,16,1,15,9,36,7,1,24,ITA
1cadaf34,10,6,2,5,3,2,4,2,10,1,9,2,12,13,0,24,ITA
1ceeae3e,9,4,7,2,0,5,15,10,13,0,13,4,13,8,1,24,ITA
1d45fd81,5,3,1,2,2,3,4,1,9,1,8,1,6,0,0,24,ITA
1d50130f,4,1,2,2,0,0,1,1,1,0,1,2,6,2,0,24,ITA
1dc5a029,4,3,1,2,1,1,5,4,6,2,4,4,8,5,0,24,ITA
1e9aa637,48,31,27,16,5,18,35,17,42,16,26,50,98,60,0,24,ITA
1e9bde92,0,0,0,0,0,0,1,1,0,0,0,0,0,9,1,24,ITA
1ea5f91c,12,9,9,1,2,8,20,12,5,1,4,5,17,20,0,24,ITA
1fca9171,1,0,0,1,0,0,0,0,0,0,0,0,1,0,0,24,ITA
20094685,13,5,5,5,3,4,9,5,3,1,2,4,17,6,0,24,ITA
204ac005,20,13,12,5,3,11,20,9,24,8,16,14,34,31,0,24,ITA
2054d037,2,1,0,1,1,0,4,4,5,1,4,1,3,5,0,24,ITA
20730eae,12,9,2,6,4,5,8,3,12,1,11,8,20,14,0,24,ITA
20b3a502,1,0,1,0,0,0,2,2,3,0,3,0,1,2,0,24,ITA
2146785a,62,33,35,21,6,39,64,25,25,6,19,23,85,45,1,24,ITA
217875a4,32,22,28,4,0,23,31,8,38,22,16,12,44,99,0,24,ITA
217c93a1,25,12,12,10,3,9,27,18,15,5,10,8,33,20,0,24,ITA
22051fbe,0,0,0,0,0,0,0,0,0,0,0,0,0,0,0,24,ITA
226008f1,23,13,18,3,2,12,21,9,26,17,9,27,50,49,0,24,ITA
22ae86f9,28,17,18,8,2,13,24,11,15,6,9,18,46,62,1,24,ITA
230a2fac,45,29,23,18,4,27,56,29,34,12,22,18,63,38,0,24,ITA
230c3f3a,23,10,7,12,4,12,20,8,20,3,17,5,28,11,0,24,ITA
232b3da4,4,3,0,4,0,2,3,1,3,0,3,0,4,3,0,24,ITA
2374aaca,22,15,10,7,5,7,22,15,20,1,19,8,30,7,0,24,ITA
23d73767,0,0,0,0,0,0,0,0,0,0,0,0,0,1,0,24,ITA
2434f24a,1,1,1,0,0,1,2,1,0,0,0,0,1,5,1,24,ITA
244bc2c8,4,2,2,2,0,1,3,2,5,0,5,3,7,7,0,24,ITA
247ed022,32,20,16,11,5,18,32,14,23,1,22,10,42,22,0,24,ITA
24eb7ed6,5,2,5,0,0,3,6,3,5,3,2,6,11,15,0,24,ITA
26777636,27,14,13,11,3,10,29,19,15,6,9,18,45,14,1,24,ITA
26db8853,51,36,28,23,0,29,61,32,33,4,29,36,87,49,1,24,ITA
277da414,1,0,1,0,0,1,3,2,0,0,0,0,1,11,1,24,ITA
279508bf,3,3,0,2,1,1,1,0,2,0,2,0,3,1,0,24,ITA
28f66c2e,2,2,1,1,0,2,6,4,2,0,2,0,2,3,1,24,ITA
2a1beb34,73,40,34,28,11,32,76,44,29,7,22,31,104,48,0,24,ITA
2a6cd437,32,21,15,16,1,16,22,6,28,19,9,39,71,99,1,24,ITA
2a7d27c1,4,1,2,2,0,1,3,2,4,1,3,4,8,15,0,24,ITA
2a82aa85,20,12,7,7,6,7,16,9,11,3,8,8,28,5,0,24,ITA
2b8360f1,16,10,6,4,6,6,15,9,9,1,8,4,20,12,0,24,ITA
2b9fdeea,7,4,2,4,1,4,13,9,9,1,8,3,10,2,0,24,ITA
2c0f8e9e,3,3,0,2,1,0,1,1,3,0,3,1,4,2,0,24,ITA
2c3a6c21,2,0,0,2,0,0,1,1,0,0,0,0,2,0,0,24,ITA
2d22cea7,19,12,4,11,4,11,40,29,28,3,25,13,32,10,0,24,ITA
2d3d7c0d,2,2,1,1,0,2,3,1,1,0,1,2,4,2,0,24,ITA
2d5f2ff0,0,0,0,0,0,0,0,0,0,0,0,0,0,0,0,24,ITA
2d9d9e42,12,8,2,10,0,6,12,6,9,0,9,3,15,11,0,24,ITA
2db2fd7b,0,0,0,0,0,0,0,0,4,3,1,4,4,17,0,24,ITA
2df7cc43,11,3,9,2,0,4,5,1,4,2,2,9,20,19,2,24,ITA
2ead2809,1,1,0,0,1,1,7,6,2,1,1,2,3,5,0,24,ITA
2edcd048,0,0,0,0,0,0,0,0,0,0,0,0,0,0,0,24,ITA
2ef7c612,26,17,3,9,14,6,15,9,23,2,21,5,31,5,0,24,ITA
2f067cf2,8,3,3,3,2,3,9,6,10,0,10,1,9,8,0,24,ITA
2f3452eb,18,10,6,10,2,11,18,7,13,5,8,11,29,27,0,24,ITA
2f3e911a,13,6,5,6,2,7,16,9,7,1,6,6,19,8,0,24,ITA
2f69d881,33,21,20,13,0,22,37,15,35,11,24,14,47,39,1,24,ITA
30223b33,0,0,0,0,0,0,0,0,0,0,0,0,0,0,0,24,ITA
30297946,1,1,0,0,1,1,1,0,7,2,5,0,1,2,0,24,ITA
30941e96,5,1,3,1,1,3,5,2,4,2,2,6,11,18,0,24,ITA
31a62dc7,16,11,6,8,2,8,13,5,6,3,3,4,20,13,0,24,ITA
31b252fc,23,13,14,7,2,12,26,14,22,18,4,8,31,60,0,24,ITA
343c0d52,10,3,1,3,6,3,12,9,8,0,8,1,11,5,0,24,ITA
34693494,17,13,6,8,3,9,25,16,9,1,8,7,24,5,0,24,ITA
356c9002,17,13,7,8,2,9,22,13,9,0,9,6,23,23,0,24,ITA
3626daea,13,6,8,5,0,6,14,8,7,2,5,3,16,12,0,24,ITA
3649ece2,7,7,6,1,0,5,8,3,14,2,12,11,18,18,0,24,ITA
364e2d13,0,0,0,0,0,0,0,0,0,0,0,0,0,0,0,24,ITA
366be751,4,2,1,2,1,2,5,3,3,0,3,3,7,0,0,24,ITA
379dc075,4,3,2,0,2,0,3,3,1,0,1,3,7,3,0,24,ITA
37dc1a48,6,2,2,1,3,4,8,4,3,0,3,2,8,4,0,24,ITA
3935e52e,36,26,20,14,2,23,39,16,18,8,10,18,54,39,0,24,ITA
3963c25b,10,5,6,3,1,6,8,2,6,3,3,1,11,15,0,24,ITA
39769cff,30,14,20,7,3,22,39,17,25,6,19,5,35,38,0,24,ITA
3aca6420,1,1,0,0,1,1,1,0,0,0,0,0,1,0,0,24,ITA
3ad34015,0,0,0,0,0,0,1,1,0,0,0,0,0,0,0,24,ITA
3b12b11f,12,10,7,5,0,6,9,3,6,1,5,2,14,8,0,24,ITA
3b333ac3,6,3,4,1,1,2,6,4,15,3,12,2,8,13,0,24,ITA
3b387cc7,9,3,0,7,2,3,8,5,6,2,4,3,12,7,0,24,ITA
3b61c9ec,16,11,6,9,1,9,16,7,7,3,4,6,22,16,0,24,ITA
3bb7af3b,3,1,2,0,1,1,7,6,4,0,4,0,3,2,0,24,ITA
3c6bbbab,3,2,1,2,0,3,5,2,1,0,1,7,10,9,0,24,ITA
3ca7254a,14,11,4,7,3,3,10,7,14,1,13,3,17,1,0,24,ITA
3cd3b384,25,18,17,6,2,16,24,8,17,9,8,9,34,71,0,24,ITA
3d13d9e4,2,0,2,0,0,0,1,1,3,0,3,0,2,2,0,24,ITA
3d50bcdb,7,4,3,2,2,1,2,1,2,1,1,2,9,5,0,24,ITA
3ead85f9,21,14,12,9,0,14,20,6,25,16,9,17,38,93,0,24,ITA
3ec3c1c9,60,38,35,22,3,30,44,14,32,12,20,25,85,44,3,24,ITA
3ecc8c5f,12,10,7,3,2,1,7,6,9,4,5,14,26,43,0,24,ITA
3f5f38fb,11,6,10,1,0,6,14,8,15,13,2,8,19,46,0,24,ITA
3f7e5a98,1,0,0,1,0,1,1,0,0,0,0,0,1,0,0,24,ITA
405f6586,5,4,0,4,1,1,6,5,3,1,2,1,6,26,0,24,ITA
414e1f69,0,0,0,0,0,0,0,0,0,0,0,0,0,0,0,24,ITA
41723204,2,2,0,0,2,1,2,1,4,3,1,1,3,6,0,24,ITA
41bd99ea,1,0,1,0,0,1,1,0,1,0,1,1,2,8,0,24,ITA
41c12f75,33,19,22,8,3,15,27,12,22,4,18,12,45,19,0,24,ITA
41fb0f4e,1,1,1,0,0,0,0,0,0,0,0,0,1,0,0,24,ITA
420c18a1,2,1,2,0,0,2,2,0,1,0,1,0,2,5,1,24,ITA
42eaa028,22,11,7,9,6,10,16,6,10,0,10,2,24,6,0,24,ITA
441197b8,26,14,8,17,1,11,17,6,19,8,11,11,37,52,0,24,ITA
4431aed2,9,7,1,5,3,3,13,10,6,3,3,5,14,10,0,24,ITA
44ac04e9,19,11,8,11,0,11,18,7,13,3,10,6,25,12,0,24,ITA
44eb9093,51,31,31,17,3,26,38,12,19,12,7,11,62,30,0,24,ITA
45191c29,18,13,9,8,1,7,18,11,10,3,7,8,26,15,0,24,ITA
45392b06,13,9,2,8,3,7,16,9,7,0,7,2,15,5,0,24,ITA
45a03961,28,17,15,11,2,17,21,4,20,14,6,23,51,30,1,24,ITA
473803c9,12,4,3,6,3,3,7,4,11,3,8,3,15,20,0,24,ITA
47c609d5,0,0,0,0,0,0,0,0,0,0,0,0,0,1,0,24,ITA
481c9ece,19,12,7,10,2,7,20,13,15,6,9,9,28,30,0,24,ITA
482d2bc3,23,14,3,16,4,10,18,8,27,3,24,1,24,10,0,24,ITA
4887118d,4,4,1,2,1,4,7,3,4,1,3,1,5,0,0,24,ITA
48b3dd60,37,23,14,19,4,20,34,14,27,3,24,15,52,6,0,24,ITA
48d5bd33,30,17,17,8,5,16,40,24,22,8,14,4,34,15,0,24,ITA
4a5a45c7,27,14,10,13,4,13,34,21,22,4,18,14,41,15,0,24,ITA
4abac767,2,2,0,2,0,1,4,3,1,0,1,2,4,0,0,24,ITA
4ae67f27,51,30,32,16,3,17,27,10,17,12,5,51,102,102,0,24,ITA
4b029b31,12,7,9,3,0,4,10,6,11,7,4,15,27,37,1,24,ITA
4b3e1a38,26,20,15,11,0,15,28,13,19,8,11,18,44,67,0,24,ITA
4c62d0c8,0,0,0,0,0,0,0,0,0,0,0,0,0,1,0,24,ITA
4c8845f7,58,39,19,31,8,18,44,26,50,5,45,19,77,21,0,24,ITA
4cdcbc14,0,0,0,0,0,0,1,1,1,1,0,1,1,0,0,24,ITA
4d8cd038,5,3,0,3,2,3,5,2,3,0,3,0,5,9,0,24,ITA
4e0c8d66,1,0,1,0,0,1,2,1,0,0,0,1,2,10,1,24,ITA
4e1d5e59,14,5,5,8,1,5,10,5,4,1,3,4,18,9,0,24,ITA
4e358a2d,12,8,10,2,0,4,10,6,16,13,3,9,21,66,1,24,ITA
505486d6,33,22,15,15,3,11,23,12,32,6,26,10,43,39,1,24,ITA
5128bde4,17,10,7,3,7,9,17,8,8,1,7,2,19,12,0,24,ITA
517cfb19,39,23,15,16,8,17,34,17,22,4,18,12,51,13,0,24,ITA
528492ea,27,17,8,13,6,13,29,16,22,4,18,10,37,11,0,24,ITA
5294a83f,29,16,12,10,7,12,46,34,31,4,27,6,35,12,0,24,ITA
53a0e358,17,8,7,9,1,2,21,19,17,0,17,13,30,9,0,24,ITA
53e494ec,0,0,0,0,0,0,1,1,0,0,0,0,0,1,0,24,ITA
546c7f68,1,1,0,1,0,0,1,1,3,0,3,1,2,1,0,24,ITA
547c0119,1,1,1,0,0,1,1,0,4,1,3,2,3,3,0,24,ITA
548bd0de,11,7,3,8,0,4,7,3,10,4,6,4,15,9,1,24,ITA
54e53b7e,2,1,1,1,0,0,1,1,0,0,0,2,4,0,0,24,ITA
55a1cac2,14,8,11,3,0,5,10,5,8,2,6,6,20,7,0,24,ITA
56fca564,4,4,0,3,1,2,3,1,1,0,1,0,4,2,0,24,ITA
570bb4b9,1,0,0,0,1,0,3,3,3,0,3,2,3,1,1,24,ITA
5715bb71,4,3,2,1,1,1,9,8,11,1,10,3,7,2,0,24,ITA
57469b2d,4,3,0,3,1,2,5,3,2,0,2,2,6,1,0,24,ITA
58e08f40,0,0,0,0,0,0,0,0,0,0,0,0,0,0,0,24,ITA
58e933d2,8,2,4,4,0,3,6,3,12,0,12,0,8,7,0,24,ITA
591bf874,12,7,6,3,3,6,17,11,3,1,2,4,16,7,1,24,ITA
596cc50e,34,22,23,5,6,19,23,4,19,5,14,10,44,48,0,24,ITA
599d91d0,3,2,0,2,1,1,1,0,0,0,0,0,3,2,1,24,ITA
5a08ee41,17,9,13,4,0,6,11,5,36,23,13,22,39,120,1,24,ITA
5a7301ae,0,0,0,0,0,0,0,0,1,1,0,0,0,0,0,24,ITA
5aa53281,29,16,17,10,2,8,22,14,30,21,9,29,58,62,0,24,ITA
5b418e15,3,0,0,2,1,1,2,1,1,1,0,1,4,4,0,24,ITA
5bd72174,2,0,0,0,2,0,1,1,4,0,4,1,3,2,0,24,ITA
5cbb5ad6,30,19,23,6,1,17,32,15,25,6,19,20,50,17,0,24,ITA
5cfc74fc,17,8,5,11,1,4,15,11,8,0,8,9,26,8,0,24,ITA
5dde403b,0,0,0,0,0,0,0,0,1,0,1,1,1,0,0,24,ITA
5de3866c,30,18,13,13,4,13,20,7,18,5,13,9,39,28,0,24,ITA
5e3ecc35,1,1,1,0,0,1,1,0,0,0,0,1,2,2,0,24,ITA
5e861944,19,8,8,7,4,11,29,18,6,0,6,10,29,10,0,24,ITA
5ea8ef20,28,13,8,16,4,17,42,25,17,4,13,18,46,20,1,24,ITA
5eae500a,3,2,1,1,1,1,3,2,7,1,6,0,3,18,1,24,ITA
5eaed77a,42,27,30,10,2,30,43,13,43,23,20,33,75,85,0,24,ITA
5efc5389,9,5,4,4,1,5,9,4,14,5,9,5,14,27,0,24,ITA
5f9970a0,0,0,0,0,0,0,0,0,0,0,0,0,0,0,0,24,ITA
5fa57166,37,21,22,13,2,20,28,8,20,10,10,29,66,47,1,24,ITA
5fd5ed86,49,34,26,20,3,18,25,7,34,21,13,38,87,118,0,24,ITA
61b3978f,24,13,14,8,2,14,22,8,13,5,8,9,33,29,0,24,ITA
61efb926,52,33,41,11,0,29,45,16,47,27,20,37,89,141,2,24,ITA
620922ed,16,11,9,6,1,8,9,1,18,12,6,21,37,87,3,24,ITA
6411925d,0,0,0,0,0,0,0,0,0,0,0,0,0,0,0,24,ITA
6416adf0,0,2,0,0,0,0,0,0,0,0,0,1,0,0,0,24,ITA
645dffbf,9,7,4,5,0,3,3,0,8,5,3,3,12,22,0,24,ITA
6499048c,20,13,3,12,5,7,12,5,10,4,6,10,30,10,0,24,ITA
649b01d8,0,0,0,0,0,0,0,0,0,0,0,0,0,1,0,24,ITA
64cd167d,3,3,1,2,0,1,3,2,0,0,0,2,5,5,0,24,ITA
65fd099c,17,8,7,10,0,7,15,8,16,3,13,3,20,6,0,24,ITA
6662d731,0,0,0,0,0,0,0,0,0,0,0,0,0,1,0,24,ITA
6841f107,15,9,9,5,1,8,10,2,7,3,4,21,36,20,1,24,ITA
68b7e72e,37,26,21,14,2,23,34,11,17,3,14,9,46,32,0,24,ITA
6928979a,33,20,13,14,6,13,55,42,21,0,21,7,40,11,0,24,ITA
6af30900,14,9,9,5,0,7,11,4,9,4,5,6,20,27,1,24,ITA
6b21b7b5,19,9,5,11,3,4,15,11,18,4,14,9,28,5,0,24,ITA
6b587d3d,29,22,9,18,2,7,21,14,19,1,18,8,37,8,0,24,ITA
6b635f5c,24,15,16,6,2,17,20,3,24,15,9,19,43,108,1,24,ITA
6bb2c084,44,22,16,21,7,24,54,30,30,4,26,22,66,18,1,24,ITA
6caffe81,57,38,24,25,8,26,60,34,37,8,29,25,82,50,2,24,ITA
6cc97b6a,19,12,8,10,1,6,19,13,23,10,13,38,57,29,0,24,ITA
6d5701f2,10,7,9,1,0,6,11,5,17,10,7,3,13,34,0,24,ITA
6e058f06,19,10,5,9,5,5,13,8,14,0,14,3,22,7,0,24,ITA
6e4df551,0,0,0,0,0,0,2,2,0,0,0,1,1,0,0,24,ITA
6eee05f1,31,17,20,11,0,11,19,8,47,28,19,46,77,81,0,24,ITA
6f8cd6d0,17,12,7,6,4,3,10,7,22,3,19,4,21,18,0,24,ITA
6fdac234,29,18,23,6,0,15,26,11,19,12,7,16,45,88,1,24,ITA
70006831,3,0,2,0,1,2,2,0,1,0,1,1,4,0,0,24,ITA
705a1642,1,1,0,1,0,1,1,0,0,0,0,0,1,0,0,24,ITA
707b98f1,16,9,9,6,1,7,19,12,9,1,8,5,21,3,0,24,ITA
72f5b81f,2,2,0,0,2,0,0,0,1,0,1,1,3,0,0,24,ITA
72f87f25,11,6,6,4,1,6,15,9,6,0,6,1,12,3,0,24,ITA
74d4cec6,2,2,1,0,1,1,1,0,2,0,2,0,2,2,0,24,ITA
75374ee7,3,3,0,1,2,1,2,1,8,0,8,1,4,1,0,24,ITA
75438a9a,16,9,9,5,2,4,11,7,14,9,5,7,23,36,0,24,ITA
75b86fb3,37,29,26,8,3,21,34,13,20,9,11,21,58,42,0,24,ITA
75bd6f48,0,0,0,0,0,0,0,0,1,0,1,0,0,0,0,24,ITA
75c62731,16,9,6,9,1,10,25,15,10,2,8,5,21,15,0,24,ITA
75f2c59f,12,5,8,4,0,7,22,15,15,4,11,3,15,11,0,24,ITA
76b2817e,8,7,7,1,0,4,5,1,6,3,3,5,13,15,0,24,ITA
76ff8d0d,32,16,6,22,4,17,34,17,18,8,10,19,51,31,0,24,ITA
780e3631,41,22,19,19,3,22,43,21,28,10,18,25,66,33,0,24,ITA
78338347,4,0,2,1,1,0,2,2,4,0,4,2,6,3,0,24,ITA
78a3c38e,18,7,10,8,0,9,15,6,11,4,7,6,24,19,1,24,ITA
78f13530,0,0,0,0,0,0,0,0,0,0,0,0,0,0,0,24,ITA
79083382,31,15,23,7,1,18,26,8,21,12,9,14,45,59,1,24,ITA
794364d7,6,4,5,1,0,3,6,3,3,0,3,4,10,5,0,24,ITA
79443529,5,4,0,3,2,2,6,4,2,1,1,1,6,10,0,24,ITA
7952d0c2,3,3,2,1,0,2,8,6,4,0,4,3,6,1,0,24,ITA
79b0d6a0,0,0,0,0,0,0,1,1,1,0,1,0,0,3,1,24,ITA
79ca3e23,52,33,16,31,5,27,47,20,25,9,16,19,71,20,0,24,ITA
7afb1573,6,1,1,4,1,2,4,2,5,2,3,0,6,6,0,24,ITA
7afbd2c3,6,3,1,3,2,3,5,2,10,3,7,0,6,6,0,24,ITA
7c104bb7,10,6,2,4,4,6,15,9,10,0,10,8,18,0,1,24,ITA
7c4b4e36,0,0,0,0,0,0,0,0,0,0,0,0,0,0,0,24,ITA
7d6d4395,0,0,0,0,0,0,0,0,0,0,0,0,0,0,0,24,ITA
7e0b6c50,1,0,0,1,0,1,3,2,1,1,0,0,1,4,0,24,ITA
7eb97a8e,10,6,6,2,2,4,13,9,6,1,5,4,14,5,2,24,ITA
7edfbb8a,33,20,25,6,2,17,27,10,29,21,8,20,53,59,1,24,ITA
7ef972c3,19,11,12,5,2,9,19,10,13,4,9,8,27,15,0,24,ITA
7f267d66,22,13,10,10,2,12,30,18,12,3,9,7,29,23,0,24,ITA
7f609bfc,59,34,27,28,4,36,61,25,20,7,13,13,72,53,0,24,ITA
7f78ad23,37,21,16,20,1,24,39,15,14,6,8,20,57,57,1,24,ITA
7fac99d4,32,14,10,18,4,18,24,6,12,2,10,3,35,24,1,24,ITA
7fe90ccd,19,14,7,8,4,12,23,11,22,3,19,4,23,17,0,24,ITA
801831fe,7,4,0,4,3,5,6,1,7,0,7,3,10,3,0,24,ITA
80490d7f,38,24,25,13,0,25,32,7,19,9,10,8,46,50,0,24,ITA
80556f08,11,8,4,6,1,6,13,7,14,5,9,8,19,16,0,24,ITA
80dbbd10,5,3,0,2,3,0,2,2,6,0,6,0,5,4,0,24,ITA
817c6964,10,8,3,6,1,4,9,5,7,3,4,11,21,14,0,24,ITA
822ed0ec,45,27,30,12,3,25,35,10,29,5,24,31,76,88,0,24,ITA
82598b71,18,12,8,9,1,7,17,10,6,2,4,4,22,21,0,24,ITA
83c06f3a,16,9,4,8,4,4,16,12,16,2,14,3,19,28,1,24,ITA
83fe71b8,34,23,9,17,8,11,39,28,13,0,13,5,39,7,0,24,ITA
854ee61a,12,4,4,5,3,5,8,3,9,0,9,3,15,9,0,24,ITA
85613cf0,8,4,2,4,2,2,3,1,7,1,6,4,12,3,0,24,ITA
85a44ecc,39,28,16,17,6,19,38,19,18,4,14,13,52,25,0,24,ITA
85f476cc,7,5,3,3,1,5,9,4,4,2,2,5,12,8,0,24,ITA
85f7d1be,4,0,2,2,0,0,1,1,3,2,1,1,5,7,1,24,ITA
85f7ed25,42,30,14,24,4,24,38,14,20,11,9,14,56,28,2,24,ITA
8650af85,19,8,10,9,0,11,15,4,21,11,10,18,37,54,0,24,ITA
867239d3,1,1,0,1,0,1,1,0,0,0,0,1,2,1,0,24,ITA
87278bce,8,4,4,4,0,1,4,3,7,4,3,4,12,25,1,24,ITA
8790f988,12,7,3,4,5,5,11,6,7,1,6,2,14,8,0,24,ITA
8794e251,44,28,17,24,3,27,37,10,21,5,16,21,65,26,0,24,ITA
89976232,19,14,13,6,0,9,15,6,13,10,3,13,32,33,1,24,ITA
8a6de8c7,26,22,11,12,3,7,21,14,18,0,18,3,29,7,0,24,ITA
8b66d9cc,1,0,0,0,1,0,0,0,0,0,0,0,1,1,0,24,ITA
8b8a56ce,21,13,9,10,2,14,21,7,22,16,6,14,35,46,0,24,ITA
8bbe2df5,28,19,12,10,6,14,23,9,21,6,15,26,54,54,1,24,ITA
8bc8829a,0,0,0,0,0,0,0,0,0,0,0,0,0,0,0,24,ITA
8c4b95af,0,0,0,0,0,0,0,0,0,0,0,0,0,0,0,24,ITA
8c63fae5,6,4,5,1,0,5,10,5,19,9,10,21,27,46,0,24,ITA
8c90fd7a,7,4,0,2,5,2,4,2,4,1,3,1,8,13,0,24,ITA
8cabdc1e,0,0,0,0,0,0,0,0,1,0,1,0,0,15,0,24,ITA
8d3cd59d,18,14,11,7,0,7,13,6,16,6,10,12,30,38,0,24,ITA
8da74c05,23,15,6,15,2,8,22,14,17,8,9,41,64,21,1,24,ITA
8daee720,0,0,0,0,0,0,0,0,0,0,0,0,0,0,0,24,ITA
8e697a8f,26,12,15,10,1,14,32,18,16,1,15,7,33,11,0,24,ITA
8ec109e6,37,21,19,17,1,17,28,11,38,29,9,23,60,114,4,24,ITA
8ec56e62,0,0,0,0,0,0,0,0,0,0,0,0,0,18,2,24,ITA
8eec784d,21,16,10,8,3,10,15,5,10,1,9,5,26,12,0,24,ITA
8ef2452a,0,0,0,0,0,0,0,0,0,0,0,0,0,0,0,24,ITA
911080b1,0,0,0,0,0,0,0,0,0,0,0,0,0,0,0,24,ITA
914ab9a1,10,7,4,5,1,2,11,9,14,8,6,12,22,56,0,24,ITA
91d0fabf,7,6,4,3,0,3,13,10,10,2,8,7,14,33,0,24,ITA
91ff775f,38,28,14,13,11,13,30,17,23,1,22,12,50,6,0,24,ITA
921f6058,2,1,1,1,0,1,1,0,2,1,1,1,3,6,0,24,ITA
928143e7,0,0,0,0,0,0,1,1,0,0,0,0,0,1,0,24,ITA
928a4a61,25,17,11,12,2,15,23,8,11,2,9,2,27,10,0,24,ITA
933d3b51,14,9,9,5,0,3,4,1,10,5,5,10,24,20,0,24,ITA
938d8a55,0,0,0,0,0,0,0,0,0,0,0,0,0,1,0,24,ITA
9413b19f,1,0,1,0,0,1,2,1,0,0,0,0,1,9,0,24,ITA
94816803,8,5,4,1,3,2,7,5,10,0,10,2,10,2,0,24,ITA
94b2001f,45,28,28,14,3,22,31,9,22,9,13,29,74,68,0,24,ITA
94bccc82,14,10,10,3,1,5,10,5,11,9,2,7,21,31,0,24,ITA
957e4c87,46,28,25,20,1,19,39,20,22,4,18,21,67,36,0,24,ITA
95facda1,41,28,18,17,6,16,46,30,16,1,15,13,54,23,0,24,ITA
966eea58,25,12,9,11,5,9,23,14,21,2,19,21,46,24,0,24,ITA
967ac202,19,11,10,6,3,9,18,9,10,1,9,16,35,22,0,24,ITA
968a1c2f,2,2,1,1,0,1,3,2,4,1,3,3,5,13,1,24,ITA
96e0490d,44,21,20,15,9,18,46,28,26,10,16,11,55,47,0,24,ITA
970b8574,32,22,12,12,8,14,29,15,18,3,15,8,40,29,1,24,ITA
97d7afbd,1,0,1,0,0,1,1,0,0,0,0,0,1,11,2,24,ITA
9823be92,23,12,9,10,4,10,15,5,15,2,13,16,39,18,0,24,ITA
983ff2c7,1,1,1,0,0,1,1,0,3,2,1,3,4,6,0,24,ITA
986693ed,17,11,8,2,7,9,19,10,17,2,15,11,28,25,1,24,ITA
98a84572,0,0,0,0,0,0,0,0,5,1,4,0,0,0,0,24,ITA
98d2c2c4,62,37,32,25,5,29,50,21,28,6,22,27,89,42,2,24,ITA
997fff07,28,18,20,6,2,13,20,7,37,30,7,20,48,123,1,24,ITA
9b3099d6,0,0,0,0,0,0,0,0,1,1,0,0,0,0,0,24,ITA
9ba7b4fa,1,1,1,0,0,0,1,1,0,0,0,1,2,0,0,24,ITA
9bc9a519,8,5,7,1,0,2,2,0,13,2,11,5,13,9,0,24,ITA
9bd97418,0,0,0,0,0,0,0,0,0,0,0,0,0,1,0,24,ITA
9c435456,24,10,19,4,1,15,25,10,18,11,7,14,38,60,0,24,ITA
9d376bef,1,0,1,0,0,0,0,0,0,0,0,0,1,0,0,24,ITA
9d60028d,5,2,2,2,1,2,8,6,11,2,9,1,6,7,0,24,ITA
9deaf2c8,0,0,0,0,0,0,0,0,0,0,0,0,0,2,0,24,ITA
9e1577aa,41,25,16,22,3,27,49,22,28,4,24,14,55,36,0,24,ITA
9ef42479,0,0,0,0,0,0,0,0,0,0,0,0,0,5,0,24,ITA
9f1893b9,66,37,26,27,13,32,78,46,40,3,37,24,90,21,0,24,ITA
9f5a610b,0,0,0,0,0,0,0,0,1,0,1,1,1,15,2,24,ITA
9f84febe,23,17,10,7,6,14,22,8,11,4,7,8,31,15,0,24,ITA
9fa26bc2,1,0,1,0,0,1,1,0,0,0,0,1,2,7,4,24,ITA
a111cf41,1,0,1,0,0,1,1,0,0,0,0,0,1,6,0,24,ITA
a14d0ab0,6,4,2,3,1,2,3,1,2,0,2,1,7,1,0,24,ITA
a26fb8aa,31,19,11,16,4,16,46,30,27,3,24,9,40,31,0,24,ITA
a2d9f138,32,21,16,14,2,16,38,22,13,7,6,20,52,24,5,24,ITA
a3695ac2,0,0,0,0,0,0,0,0,0,0,0,0,0,0,0,24,ITA
a378a02a,20,11,9,8,3,8,12,4,16,14,2,19,39,56,2,24,ITA
a3c8b4d3,14,5,4,9,1,9,18,9,18,1,17,3,17,14,1,24,ITA
a40819d9,0,0,0,0,0,0,0,0,3,3,0,0,0,1,0,24,ITA
a44d3a3c,4,1,1,3,0,1,5,4,2,1,1,0,4,3,0,24,ITA
a4948e67,9,6,1,3,5,4,5,1,8,0,8,0,9,19,0,24,ITA
a5296e55,19,13,5,10,4,10,21,11,11,1,10,8,27,14,0,24,ITA
a5db0bec,16,11,4,10,2,3,11,8,5,0,5,4,20,2,1,24,ITA
a8567629,5,2,5,0,0,1,9,8,5,0,5,1,6,5,0,24,ITA
a8a874f1,51,30,18,26,7,22,46,24,30,12,18,22,73,55,0,24,ITA
a9202def,72,44,32,33,7,37,52,15,41,6,35,34,106,29,1,24,ITA
a96e5dc0,11,8,7,3,1,8,14,6,16,4,12,12,23,44,1,24,ITA
a9aa0d1d,9,5,4,4,1,3,9,6,4,1,3,2,11,2,1,24,ITA
aa25ce92,10,5,4,5,1,5,10,5,10,5,5,13,23,23,0,24,ITA
aa54ec6f,32,19,26,6,0,16,23,7,24,17,7,23,55,83,1,24,ITA
aa8e289e,23,14,3,13,7,4,27,23,21,5,16,8,31,13,0,24,ITA
aae9d04a,22,14,10,8,4,12,20,8,11,6,5,11,33,31,0,24,ITA
ab4449d6,2,2,2,0,0,2,3,1,0,0,0,0,2,8,3,24,ITA
ab5c36dd,0,0,0,0,0,0,0,0,0,0,0,1,1,1,0,24,ITA
ac4003af,0,0,0,0,0,0,0,0,0,0,0,0,0,1,0,24,ITA
ac4a4508,24,17,8,7,9,14,20,6,17,0,17,7,31,11,0,24,ITA
acf7e795,1,1,1,0,0,0,0,0,0,0,0,3,4,7,0,24,ITA
aded8e6f,36,27,21,12,3,16,25,9,35,13,22,42,78,58,2,24,ITA
ae4e2852,0,0,0,0,0,0,0,0,1,0,1,1,1,2,0,24,ITA
ae94a6c5,50,27,11,29,10,24,40,16,21,1,20,6,56,10,1,24,ITA
ae9898c5,22,12,12,5,5,13,26,13,35,3,32,20,42,33,0,24,ITA
aeca7743,34,22,23,10,1,21,43,22,16,7,9,17,51,43,2,24,ITA
af104654,0,0,0,0,0,0,0,0,0,0,0,0,0,0,0,24,ITA
afb61630,39,21,9,27,3,18,33,15,19,4,15,11,50,22,0,24,ITA
b09e0873,6,4,4,0,2,3,8,5,12,0,12,1,7,2,0,24,ITA
b0f7e36c,15,7,4,4,7,3,9,6,14,1,13,5,20,4,0,24,ITA
b136c945,4,1,1,3,0,3,5,2,5,1,4,0,4,2,0,24,ITA
b1cd37e6,33,20,18,12,3,15,28,13,26,8,18,8,41,33,0,24,ITA
b2e08cb6,0,0,0,0,0,0,0,0,0,0,0,0,0,0,0,24,ITA
b3325a30,36,28,17,16,3,14,31,17,18,5,13,14,50,20,1,24,ITA
b35a7399,19,10,11,7,1,4,8,4,13,8,5,13,32,44,0,24,ITA
b51b1b9c,19,11,11,5,3,6,11,5,15,4,11,9,28,10,1,24,ITA
b5b9bde7,2,2,1,1,0,0,6,6,3,2,1,0,2,2,0,24,ITA
b5f7d10b,4,3,1,3,0,2,5,3,2,0,2,4,8,7,0,24,ITA
b6964eb6,1,1,1,0,0,1,4,3,6,5,1,5,6,6,0,24,ITA
b6a1cdf9,30,19,10,15,5,12,29,17,16,0,16,6,36,18,0,24,ITA
b6baba31,0,0,0,0,0,0,0,0,0,0,0,0,0,0,0,24,ITA
b70bde8f,0,0,0,0,0,0,1,1,1,0,1,1,1,0,0,24,ITA
b79858d5,18,8,7,7,4,9,30,21,15,2,13,10,28,9,0,24,ITA
b85bf253,24,13,9,13,2,8,11,3,8,3,5,7,31,24,0,24,ITA
b8a642fc,15,5,8,5,2,7,14,7,3,1,2,5,20,2,0,24,ITA
b937e490,1,0,0,0,1,0,0,0,1,1,0,0,1,2,0,24,ITA
b96b595c,19,12,15,4,0,9,12,3,16,10,6,29,48,65,0,24,ITA
ba1e04b3,1,0,0,0,1,1,1,0,1,1,0,2,3,2,0,24,ITA
ba3d3bea,23,12,6,16,1,7,17,10,13,6,7,17,40,18,1,24,ITA
ba492306,19,10,8,8,3,9,13,4,9,1,8,4,23,11,0,24,ITA
bb376bed,14,6,3,8,3,8,18,10,16,6,10,15,29,24,0,24,ITA
bba30585,29,18,20,8,1,10,20,10,35,23,12,18,47,59,0,24,ITA
bcf5058a,0,0,0,0,0,0,0,0,0,0,0,0,0,2,1,24,ITA
bdbff2b5,27,18,9,12,6,11,30,19,15,1,14,14,41,13,0,24,ITA
be2706c0,8,5,3,4,1,7,12,5,7,0,7,7,15,16,0,24,ITA
bee704fc,37,18,21,13,3,19,31,12,20,13,7,21,58,82,1,24,ITA
bf168004,0,0,0,0,0,0,0,0,0,0,0,0,0,6,3,24,ITA
bf57eaab,1,0,0,1,0,0,6,6,6,1,5,3,4,2,0,24,ITA
c13ddd3e,36,24,12,14,10,14,32,18,29,3,26,15,51,8,0,24,ITA
c1b9b13c,8,3,7,1,0,3,7,4,2,0,2,5,13,2,0,24,ITA
c1d95617,0,0,0,0,0,0,2,2,0,0,0,0,0,22,2,24,ITA
c20892ee,0,0,0,0,0,0,0,0,0,0,0,0,0,0,0,24,ITA
c2357b65,18,13,12,4,2,9,28,19,17,3,14,7,25,17,0,24,ITA
c235e803,19,17,11,7,1,12,16,4,8,4,4,8,27,32,0,24,ITA
c23c8e0d,0,0,0,0,0,0,3,3,1,0,1,0,0,1,0,24,ITA
c391a179,45,26,18,20,7,20,53,33,41,11,30,17,62,39,2,24,ITA
c56dc39e,8,3,3,2,3,5,8,3,2,1,1,8,16,17,0,24,ITA
c69ef855,21,12,7,14,0,10,25,15,11,2,9,18,39,27,0,24,ITA
c6db4f29,2,0,0,1,1,1,3,2,1,1,0,1,3,5,0,24,ITA
c707411f,8,4,5,3,0,5,7,2,9,7,2,1,9,15,0,24,ITA
c7259b83,22,10,8,9,5,7,18,11,10,2,8,7,29,15,1,24,ITA
c74d63ac,29,20,20,8,1,24,35,11,25,7,18,19,48,53,0,24,ITA
c77be0cf,12,7,9,3,0,5,13,8,15,2,13,4,16,15,0,24,ITA
c83c203f,8,6,5,3,0,2,10,8,8,2,6,14,22,8,1,24,ITA
c84dcc88,0,0,0,0,0,0,0,0,0,0,0,0,0,0,0,24,ITA
c8d7131c,4,4,2,0,2,3,4,1,3,0,3,5,9,7,1,24,ITA
c976160c,0,0,0,0,0,0,0,0,0,0,0,0,0,0,0,24,ITA
c9fc39ce,1,1,1,0,0,0,0,0,5,4,1,0,1,3,0,24,ITA
ca3db240,42,26,23,13,6,25,35,10,24,4,20,19,61,63,2,24,ITA
ca607d59,5,3,1,3,1,3,8,5,3,0,3,0,5,9,0,24,ITA
ca6edaa0,0,0,0,0,0,0,3,3,2,0,2,0,0,0,0,24,ITA
caec77da,29,16,17,12,0,11,21,10,33,23,10,14,43,68,1,24,ITA
cbe32194,0,0,0,0,0,0,0,0,0,0,0,0,0,0,0,24,ITA
cce9f582,26,15,19,7,0,13,23,10,40,23,17,39,65,99,0,24,ITA
cd0fa27b,51,27,23,21,7,25,41,16,22,10,12,15,66,18,0,24,ITA
ce30bfc8,53,27,24,22,7,27,42,15,27,8,19,29,82,32,0,24,ITA
cf007308,4,3,1,3,0,2,2,0,2,0,2,2,6,8,0,24,ITA
d023d70f,22,18,6,16,0,6,21,15,20,8,12,16,38,22,1,24,ITA
d0d8dd44,16,12,11,4,1,6,11,5,17,7,10,20,36,40,0,24,ITA
d125f22f,1,0,0,0,1,0,2,2,0,0,0,0,1,0,0,24,ITA
d19ef4ef,10,5,6,3,1,3,10,7,5,1,4,2,12,3,0,24,ITA
d1ac669b,0,0,0,0,0,0,0,0,0,0,0,0,0,0,0,24,ITA
d1b49282,12,8,5,6,1,6,10,4,13,2,11,4,16,9,0,24,ITA
d37b0350,1,1,0,0,1,0,1,1,2,1,1,0,1,7,0,24,ITA
d3aaad90,16,8,11,4,1,4,12,8,9,4,5,8,24,13,1,24,ITA
d3de9af0,14,6,9,1,4,2,9,7,18,5,13,6,20,18,0,24,ITA
d4535821,34,22,19,14,1,22,42,20,23,7,16,26,60,53,2,24,ITA
d4a2533d,8,6,6,2,0,2,11,9,7,0,7,1,9,0,0,24,ITA
d4c9725f,26,13,17,9,0,9,19,10,29,13,16,17,43,37,1,24,ITA
d705ba44,13,6,3,6,4,6,13,7,13,1,12,3,16,5,0,24,ITA
d7918b13,0,0,0,0,0,0,0,0,0,0,0,0,0,0,0,24,ITA
d7d32194,1,0,0,1,0,1,1,0,1,0,1,2,3,3,0,24,ITA
d8363914,34,20,9,22,3,18,33,15,20,3,17,11,45,19,1,24,ITA
d85c238b,21,16,10,10,1,6,16,10,24,2,22,19,40,12,0,24,ITA
d8cda243,10,7,3,6,1,3,6,3,4,0,4,0,10,2,0,24,ITA
d995ed27,24,13,6,8,10,8,17,9,16,1,15,14,38,6,0,24,ITA
d9ebed1c,16,11,7,9,0,7,16,9,9,1,8,3,19,14,0,24,ITA
d9f83409,0,0,0,0,0,0,0,0,0,0,0,0,0,0,0,24,ITA
da76bab4,16,9,0,8,8,2,13,11,16,2,14,1,17,11,0,24,ITA
dac2bed8,0,0,0,0,0,0,0,0,0,0,0,0,0,0,0,24,ITA
db092d3b,21,12,8,13,0,9,18,9,8,1,7,7,28,8,2,24,ITA
dbfa4f16,33,20,23,9,1,21,35,14,30,1,29,7,40,27,0,24,ITA
dc3fa3b5,1,1,0,1,0,0,1,1,0,0,0,0,1,0,0,24,ITA
dc61b402,33,21,11,16,6,19,41,22,17,3,14,13,46,50,0,24,ITA
dd0daf32,56,32,16,31,9,20,41,21,21,4,17,26,82,40,0,24,ITA
dd403465,0,0,0,0,0,0,0,0,1,0,1,0,0,0,0,24,ITA
dd86e8e4,36,22,22,11,3,21,32,11,15,4,11,14,50,46,0,24,ITA
de0f152c,16,9,7,8,1,5,19,14,12,6,6,8,24,22,0,24,ITA
de13cee5,26,11,14,11,1,16,25,9,30,17,13,14,40,85,0,24,ITA
dea88efd,29,16,6,15,8,12,38,26,12,1,11,12,41,8,0,24,ITA
dfd24c07,4,1,0,2,2,0,7,7,5,0,5,4,8,1,0,24,ITA
dfd56738,23,10,10,11,2,6,20,14,19,5,14,9,32,31,0,24,ITA
dff153a4,46,29,23,19,4,27,63,36,20,4,16,25,71,35,1,24,ITA
e04dca4a,1,1,0,1,0,1,1,0,1,0,1,0,1,0,0,24,ITA
e08ac719,9,4,7,2,0,4,5,1,10,6,4,19,28,39,0,24,ITA
e0921a4f,18,12,3,6,9,1,10,9,9,0,9,3,21,3,0,24,ITA
e0ce7038,3,1,2,0,1,0,2,2,6,2,4,4,7,3,0,24,ITA
e14ec482,18,9,10,3,5,7,28,21,18,2,16,7,25,18,1,24,ITA
e19660a8,40,24,18,13,9,24,34,10,21,11,10,14,54,37,2,24,ITA
e1b0a70d,1,1,1,0,0,1,3,2,1,0,1,0,1,6,0,24,ITA
e1cbb531,50,32,14,27,9,19,50,31,23,5,18,20,70,24,0,24,ITA
e288d4b3,37,18,22,11,4,22,44,22,14,8,6,15,52,19,1,24,ITA
e34e086c,13,9,4,7,2,3,9,6,3,0,3,1,14,4,0,24,ITA
e3756e72,25,17,11,12,2,12,19,7,18,2,16,13,38,28,1,24,ITA
e4ba67f2,2,2,2,0,0,1,1,0,1,1,0,0,2,2,0,24,ITA
e58cbfd5,37,23,19,14,4,15,33,18,25,5,20,21,58,25,0,24,ITA
e599253a,21,13,7,14,0,9,18,9,19,5,14,10,31,23,0,24,ITA
e613313c,20,12,11,8,1,3,9,6,10,2,8,9,29,23,0,24,ITA
e6536124,31,16,19,10,2,17,23,6,12,3,9,9,40,30,2,24,ITA
e74f0e59,7,5,3,2,2,3,5,2,7,3,4,6,13,19,0,24,ITA
e7695e6c,14,9,6,6,2,5,16,11,13,2,11,0,14,20,0,24,ITA
e8271ad9,24,16,13,7,4,11,19,8,5,1,4,13,37,19,0,24,ITA
e8c930bb,43,24,19,21,3,22,48,26,37,8,29,45,88,43,1,24,ITA
e95069bb,0,0,0,0,0,0,0,0,0,0,0,0,0,1,0,24,ITA
e97fd090,22,16,7,9,6,12,23,11,21,11,10,6,28,8,1,24,ITA
ea02beaf,20,10,8,12,0,9,14,5,11,0,11,18,38,18,0,24,ITA
eb0ec070,29,21,15,12,2,18,31,13,16,6,10,6,35,39,0,24,ITA
eb2fe5b6,3,2,0,2,1,1,1,0,4,0,4,1,4,0,0,24,ITA
ec315772,3,3,2,0,1,1,2,1,0,0,0,0,3,0,0,24,ITA
ec52b661,11,9,7,3,1,9,10,1,4,2,2,5,16,12,0,24,ITA
ec5dae45,1,1,1,0,0,0,0,0,0,0,0,0,1,1,0,24,ITA
ed5c0319,1,0,0,0,1,0,0,0,0,0,0,0,1,0,0,24,ITA
edd81e2a,0,0,0,0,0,0,1,1,2,0,2,0,0,4,0,24,ITA
ee251371,25,18,11,10,4,9,21,12,11,1,10,8,33,9,1,24,ITA
ee5565ae,0,0,0,0,0,0,0,0,0,0,0,0,0,0,0,24,ITA
ee64a822,36,20,15,17,4,15,35,20,20,8,12,16,52,26,1,24,ITA
ee6e2b92,2,1,2,0,0,1,2,1,1,1,0,0,2,0,0,24,ITA
ee833569,0,0,0,0,0,0,1,1,0,0,0,0,0,7,1,24,ITA
ef2e5e1a,32,17,13,16,3,14,28,14,17,4,13,3,35,18,0,24,ITA
ef3c876b,59,35,27,26,6,32,79,47,47,11,36,42,101,41,0,24,ITA
ef6eef89,20,13,11,7,2,12,19,7,17,6,11,7,27,33,1,24,ITA
efc9e31f,12,6,2,4,6,7,15,8,3,1,2,2,14,15,0,24,ITA
efdeaff3,0,0,0,0,0,0,0,0,0,0,0,0,0,0,0,24,ITA
eff9c9ea,0,0,0,0,0,0,0,0,0,0,0,0,0,0,0,24,ITA
f025eade,22,12,10,9,3,12,20,8,14,1,13,3,25,7,0,24,ITA
f0f7f62f,1,1,1,0,0,1,1,0,0,0,0,1,2,2,0,24,ITA
f25de136,6,4,3,3,0,3,4,1,4,3,1,7,13,20,0,24,ITA
f37f3522,38,21,19,15,4,14,27,13,21,4,17,13,51,20,2,24,ITA
f42d6c13,11,4,4,3,4,3,11,8,5,1,4,4,15,8,0,24,ITA
f4797849,35,23,19,12,4,17,25,8,23,7,16,19,54,60,0,24,ITA
f49c4ae9,25,19,18,5,2,8,18,10,7,1,6,5,30,18,0,24,ITA
f4d60499,112,61,40,58,14,50,76,26,44,9,35,36,148,34,1,24,ITA
f554e29b,0,0,0,0,0,0,0,0,0,0,0,0,0,3,0,24,ITA
f573a8bf,6,4,0,5,1,1,2,1,6,1,5,1,7,10,0,24,ITA
f5c4fd91,7,6,4,2,1,1,9,8,4,0,4,1,8,3,0,24,ITA
f7036e1c,21,15,3,13,5,4,15,11,21,1,20,19,40,8,0,24,ITA
f7223718,9,5,7,2,0,5,11,6,8,5,3,5,14,28,0,24,ITA
f794e9ab,0,0,0,0,0,0,0,0,0,0,0,0,0,0,0,24,ITA
f7c491f1,57,38,34,21,2,31,37,6,38,18,20,37,94,131,0,24,ITA
f7e2af2c,35,20,23,10,2,18,28,10,23,13,10,17,52,54,1,24,ITA
f8342731,6,1,2,3,1,4,7,3,2,0,2,0,6,1,0,24,ITA
f95f49d2,0,0,0,0,0,0,0,0,0,0,0,0,0,0,0,24,ITA
f9758dae,21,11,8,11,2,8,17,9,18,8,10,4,25,15,1,24,ITA
f97f9188,13,6,6,7,0,6,10,4,4,2,2,7,20,10,0,24,ITA
f9c927de,23,16,4,17,2,10,23,13,21,3,18,10,33,14,0,24,ITA
fa449bba,5,3,1,2,2,3,3,0,1,0,1,1,6,1,0,24,ITA
faa13947,2,1,2,0,0,2,5,3,0,0,0,0,2,4,0,24,ITA
fadf9a05,23,18,17,6,0,12,18,6,13,8,5,22,45,75,0,24,ITA
faed84db,7,3,3,4,0,0,8,8,16,7,9,6,13,20,0,24,ITA
fb37a645,48,35,34,12,2,29,49,20,22,5,17,28,76,80,0,24,ITA
fb77bfef,7,2,0,7,0,1,3,2,1,0,1,1,8,13,1,24,ITA
fcb38f57,1,0,1,0,0,1,1,0,1,0,1,1,2,4,3,24,ITA
fd987f24,0,0,0,0,0,0,4,4,2,1,1,1,1,0,0,24,ITA
fdf4b948,16,7,12,3,1,3,8,5,6,3,3,8,24,10,0,24,ITA
ff579c7e,19,14,8,10,1,6,13,7,13,1,12,6,25,9,0,24,ITA
ff5ea0bf,20,14,8,10,2,7,15,8,19,9,10,10,30,41,0,24,ITA
ff800ed8,16,8,6,9,1,8,21,13,9,1,8,16,32,25,0,24,ITA
00a8d210,42,27,16,19,7,18,50,32,24,5,19,13,55,27,0,24,FRA
011b2a32,0,0,0,0,0,0,0,0,0,0,0,1,1,0,0,24,FRA
01870104,9,4,1,4,4,1,9,8,8,1,7,2,11,11,0,24,FRA
01becd60,3,2,2,1,0,1,5,4,5,0,5,1,4,4,0,24,FRA
01fd01e8,24,12,15,9,0,7,11,4,35,20,15,32,56,92,1,24,FRA
02b3733e,18,9,11,4,3,11,23,12,8,2,6,6,24,15,0,24,FRA
02bcaf8e,0,0,0,0,0,0,4,4,2,0,2,0,0,0,0,24,FRA
039f1983,42,27,28,12,2,23,37,14,26,18,8,35,77,108,2,24,FRA
0400dd2f,4,2,1,2,1,3,5,2,6,0,6,4,8,2,0,24,FRA
04ac78d2,17,11,15,2,0,8,12,4,14,7,7,14,31,40,0,24,FRA
04bb2b06,0,0,0,0,0,0,1,1,0,0,0,0,0,0,0,24,FRA
0512a60a,20,14,5,13,2,12,19,7,15,6,9,18,38,25,2,24,FRA
0595569d,0,0,0,0,0,0,0,0,0,0,0,1,1,7,2,24,FRA
059a83b8,0,0,0,0,0,0,0,0,2,2,0,2,2,5,0,24,FRA
05ba9d7c,5,5,2,2,1,2,5,3,7,0,7,1,6,1,0,24,FRA
061266cd,25,20,14,9,2,12,20,8,9,2,7,13,38,35,0,24,FRA
065dc209,5,3,0,4,1,2,9,7,12,1,11,2,7,14,0,24,FRA
06a1d642,10,9,4,4,2,6,16,10,5,1,4,4,14,4,0,24,FRA
06c48679,27,15,12,12,3,15,28,13,22,11,11,32,59,42,0,24,FRA
06efa9dc,5,1,2,3,0,3,4,1,3,1,2,4,9,4,0,24,FRA
08f5afaa,0,0,0,0,0,0,0,0,0,0,0,1,1,8,4,24,FRA
0959184b,5,3,3,1,1,3,7,4,1,0,1,2,7,1,0,24,FRA
0b33f6ad,20,12,7,10,3,13,17,4,14,7,7,17,37,35,0,24,FRA
0b6911e4,2,0,1,1,0,1,2,1,1,1,0,0,2,0,0,24,FRA
0be95d34,31,22,7,12,12,13,54,41,24,1,23,9,40,6,0,24,FRA
0bfca6a1,41,31,22,16,3,23,42,19,24,1,23,22,63,34,0,24,FRA
0cbc8baa,31,17,14,14,3,15,39,24,14,5,9,17,48,27,0,24,FRA
0d7b6576,5,3,1,2,2,2,9,7,3,1,2,2,7,2,0,24,FRA
0da3d7ab,0,0,0,0,0,0,1,1,1,0,1,0,0,1,0,24,FRA
0e46fa2f,2,2,0,2,0,1,6,5,1,0,1,0,2,3,0,24,FRA
0e8d7b6c,17,13,8,9,0,11,17,6,13,2,11,5,22,5,1,24,FRA
0f8418aa,35,23,10,18,7,20,27,7,16,7,9,15,50,25,0,24,FRA
0f86995c,1,0,0,0,1,1,2,1,0,0,0,1,2,0,0,24,FRA
102c9665,28,21,22,6,0,13,27,14,24,14,10,29,57,106,4,24,FRA
10cff752,13,8,2,7,4,5,19,14,12,0,12,8,21,16,1,24,FRA
10e51236,1,0,1,0,0,1,4,3,3,1,2,3,4,6,0,24,FRA
10f0fdd3,5,3,3,2,0,3,6,3,4,0,4,4,9,0,0,24,FRA
12a4e38c,13,9,12,1,0,7,11,4,14,11,3,36,49,86,0,24,FRA
12de1b0d,0,0,0,0,0,0,3,3,3,0,3,2,2,5,0,24,FRA
12f9a649,1,1,0,1,0,1,1,0,1,1,0,0,1,1,0,24,FRA
133d2aa5,0,0,0,0,0,0,0,0,0,0,0,0,0,0,0,24,FRA
13e827f8,13,9,7,6,0,3,10,7,7,1,6,6,19,9,0,24,FRA
148e136f,44,30,16,16,12,18,43,25,26,0,26,4,48,4,0,24,FRA
15937e17,34,24,23,11,0,23,31,8,30,15,15,30,64,68,0,24,FRA
15944afd,3,1,0,3,0,2,4,2,1,1,0,3,6,0,0,24,FRA
1598599e,16,11,7,5,4,8,12,4,8,3,5,9,25,9,1,24,FRA
1609700b,2,0,0,2,0,1,1,0,0,0,0,1,3,0,0,24,FRA
16aa7d4c,42,26,25,15,2,24,45,21,47,28,19,39,81,112,2,24,FRA
17bb562c,43,27,20,20,3,18,32,14,30,18,12,53,96,73,0,24,FRA
17e1261b,30,15,12,15,3,15,37,22,19,5,14,26,56,18,1,24,FRA
19053e31,8,6,3,4,1,4,10,6,4,0,4,3,11,3,0,24,FRA
1906b842,8,5,4,4,0,3,10,7,4,1,3,4,12,4,0,24,FRA
1956b948,27,15,9,13,5,12,33,21,20,3,17,12,39,25,0,24,FRA
19ba6c6d,6,5,0,2,4,2,8,6,12,3,9,1,7,14,0,24,FRA
19c2ffa4,55,38,24,25,6,22,43,21,33,2,31,27,82,31,0,24,FRA
1a066e69,16,12,11,5,0,10,15,5,13,9,4,18,34,50,0,24,FRA
1a2935f6,9,7,6,3,0,3,7,4,6,5,1,12,21,37,0,24,FRA
1a6b7ea4,27,17,12,12,3,17,26,9,21,11,10,16,43,31,0,24,FRA
1b2ec72e,0,0,0,0,0,0,0,0,0,0,0,0,0,0,0,24,FRA
1bc6135b,5,3,0,3,2,1,3,2,4,0,4,6,11,2,0,24,FRA
1bfb6fef,23,17,8,13,2,18,23,5,12,6,6,18,41,32,0,24,FRA
1d2d5cc8,2,0,2,0,0,2,4,2,0,0,0,0,2,5,1,24,FRA
1d383c10,62,45,34,22,6,36,58,22,37,12,25,34,96,61,0,24,FRA
1d5c96f8,14,8,6,6,2,7,14,7,28,12,16,14,28,34,0,24,FRA
1d8aa290,2,0,2,0,0,0,4,4,0,0,0,0,2,2,0,24,FRA
1ddbc7ca,52,28,17,27,8,24,46,22,39,11,28,34,86,36,0,24,FRA
1e52971c,4,3,2,2,0,1,8,7,5,0,5,4,8,0,0,24,FRA
20b9f052,0,0,0,0,0,0,1,1,0,0,0,0,0,8,1,24,FRA
20de219a,0,0,0,0,0,0,0,0,1,0,1,0,0,1,1,24,FRA
20e73fac,25,15,12,7,6,10,33,23,26,2,24,18,43,32,1,24,FRA
213ab9bb,5,4,0,3,2,1,2,1,2,0,2,0,5,0,0,24,FRA
226673c2,4,3,2,2,0,1,2,1,0,0,0,2,6,2,0,24,FRA
22bfb57e,5,4,3,2,0,2,6,4,12,1,11,8,13,5,0,24,FRA
22d90df9,6,4,2,1,3,2,2,0,3,0,3,1,7,2,0,24,FRA
2321ea6e,5,0,4,0,1,4,8,4,11,3,8,3,8,10,0,24,FRA
234a703c,21,10,12,5,4,8,28,20,12,1,11,6,27,9,0,24,FRA
23c63b7f,0,0,0,0,0,0,1,1,1,0,1,1,1,1,0,24,FRA
25749008,19,13,1,11,7,7,15,8,13,1,12,3,22,6,0,24,FRA
25f2ef01,13,11,10,2,1,10,15,5,14,11,3,7,20,74,1,24,FRA
2677a1de,19,12,6,11,2,12,27,15,9,0,9,3,22,7,0,24,FRA
29c91632,48,21,27,16,5,25,31,6,29,7,22,21,69,49,2,24,FRA
2acd49b9,18,10,9,6,3,10,18,8,3,1,2,8,26,24,0,24,FRA
2acf0cd7,40,28,12,24,4,21,47,26,16,3,13,14,54,25,0,24,FRA
2b5a35e5,27,20,11,12,4,10,37,27,20,1,19,18,45,9,0,24,FRA
2b7cdb79,23,14,8,12,3,6,14,8,21,4,17,11,34,24,0,24,FRA
2c70d915,17,12,11,3,3,8,18,10,20,10,10,18,35,33,1,24,FRA
2ccd39ed,10,4,3,3,4,3,7,4,5,1,4,4,14,10,0,24,FRA
2ccd89a3,0,0,0,0,0,0,0,0,0,0,0,0,0,1,0,24,FRA
2e1b7c83,17,4,4,7,6,7,26,19,19,1,18,11,28,5,0,24,FRA
2eb1ec07,6,5,5,1,0,1,3,2,2,0,2,2,8,6,0,24,FRA
2f71c116,33,18,21,6,6,13,24,11,17,5,12,13,46,53,0,24,FRA
2fa2a875,0,0,0,0,0,0,1,1,0,0,0,0,0,12,1,24,FRA
3010aefb,36,21,23,9,4,24,52,28,16,1,15,18,54,33,0,24,FRA
301c287b,67,40,32,29,6,28,54,26,21,7,14,25,92,27,0,24,FRA
30670b0e,0,0,0,0,0,0,0,0,0,0,0,0,0,0,0,24,FRA
307581ff,0,0,0,0,0,0,0,0,0,0,0,0,0,0,0,24,FRA
30af8b93,12,6,3,6,3,6,9,3,7,1,6,3,15,8,0,24,FRA
30f5ffa9,20,15,14,6,0,13,19,6,16,9,7,11,31,36,1,24,FRA
315fe681,0,0,0,0,0,0,0,0,0,0,0,0,0,1,0,24,FRA
31626657,69,39,36,26,7,31,82,51,25,6,19,48,117,52,2,24,FRA
31822f8c,9,3,2,6,1,5,13,8,8,0,8,2,11,4,0,24,FRA
3189f61a,40,27,23,15,2,15,33,18,30,10,20,29,69,26,0,24,FRA
31f5b89b,14,9,2,10,2,6,7,1,5,1,4,6,20,11,0,24,FRA
32100829,18,12,10,7,1,10,16,6,6,3,3,13,31,30,1,24,FRA
32c2d95f,49,28,25,20,4,19,35,16,41,25,16,30,79,75,1,24,FRA
32f3d97e,9,6,2,4,3,4,7,3,4,0,4,3,12,4,1,24,FRA
331c5a98,3,1,1,1,1,3,7,4,0,0,0,1,4,1,0,24,FRA
3322e296,4,2,2,2,0,2,3,1,2,0,2,3,7,6,0,24,FRA
349cae8f,14,6,7,4,3,8,11,3,5,1,4,5,19,13,0,24,FRA
34a88e3e,22,13,5,11,6,9,24,15,14,0,14,7,29,5,0,24,FRA
357103bd,0,0,0,0,0,0,0,0,0,0,0,0,0,2,0,24,FRA
3681cfff,28,14,21,6,1,10,20,10,16,9,7,15,43,63,2,24,FRA
36f65bdf,25,17,8,16,1,12,23,11,2,1,1,4,29,5,0,24,FRA
3708e9fa,41,29,13,22,6,14,40,26,37,3,34,20,61,12,0,24,FRA
37143438,10,8,6,3,1,7,9,2,3,0,3,1,11,5,0,24,FRA
375622c5,32,18,14,16,2,17,57,40,17,1,16,13,45,21,0,24,FRA
380a15e2,0,0,0,0,0,0,0,0,0,0,0,0,0,0,0,24,FRA
384d58d9,36,26,11,18,7,12,25,13,33,11,22,38,74,38,0,24,FRA
397ba086,5,3,1,2,2,2,3,1,2,0,2,1,6,4,0,24,FRA
39b326ed,54,23,34,15,5,30,69,39,28,3,25,21,75,28,0,24,FRA
3b029691,34,20,11,13,10,15,44,29,26,10,16,21,55,21,2,24,FRA
3b6ace25,0,0,0,0,0,0,0,0,0,0,0,0,0,1,0,24,FRA
3b88609d,2,2,0,2,0,1,2,1,0,0,0,0,2,0,0,24,FRA
3bd65247,5,3,0,4,1,2,5,3,4,0,4,1,6,1,0,24,FRA
3c6bbbab,2,1,2,0,0,2,3,1,2,1,1,0,2,1,0,24,FRA
3cc4bb19,30,17,24,6,0,12,23,11,30,22,8,18,48,90,1,24,FRA
3d214e5f,0,0,0,0,0,0,0,0,0,0,0,0,0,15,1,24,FRA
3dd738a1,48,29,24,22,2,25,42,17,31,4,27,24,72,38,0,24,FRA
3eaf8817,5,2,1,4,0,3,4,1,6,1,5,0,5,11,0,24,FRA
3ecc8c5f,4,1,3,1,0,3,5,2,4,2,2,5,9,8,0,24,FRA
3eed9821,1,1,0,1,0,1,4,3,0,0,0,2,3,4,0,24,FRA
3eeebc87,49,34,24,15,10,25,47,22,22,5,17,13,62,31,0,24,FRA
3f319bb9,38,24,31,7,0,20,34,14,41,30,11,33,71,134,1,24,FRA
40221fa7,82,45,47,31,4,41,69,28,23,0,23,34,116,57,0,24,FRA
40774c6b,2,2,0,2,0,1,2,1,2,0,2,0,2,7,0,24,FRA
41e7ef1c,0,0,0,0,0,0,0,0,0,0,0,0,0,0,0,24,FRA
41eebdf5,30,21,13,13,4,12,18,6,24,14,10,22,52,83,1,24,FRA
42276181,10,10,5,3,2,2,15,13,7,0,7,2,12,6,0,24,FRA
42f0113f,0,0,0,0,0,0,2,2,0,0,0,1,1,1,0,24,FRA
42fd9c7f,4,1,1,1,2,4,8,4,4,0,4,2,6,1,0,24,FRA
42fdb11d,18,11,4,9,5,11,16,5,11,2,9,4,22,16,0,24,FRA
44435c8f,18,9,7,6,5,6,16,10,9,0,9,3,21,5,0,24,FRA
4534a352,28,16,20,6,2,14,26,12,29,19,10,28,56,64,2,24,FRA
45af8a54,6,4,2,4,0,1,6,5,6,0,6,1,7,2,0,24,FRA
45b9b619,5,3,3,1,1,0,8,8,2,0,2,1,6,1,0,24,FRA
45cce300,11,4,3,5,3,4,11,7,1,0,1,0,11,0,0,24,FRA
468fdbad,32,20,13,18,1,14,25,11,13,1,12,5,37,18,1,24,FRA
477e50ce,0,0,0,0,0,0,0,0,0,0,0,0,0,7,0,24,FRA
4788cb6b,2,2,0,2,0,0,6,6,6,0,6,8,10,2,0,24,FRA
47f82561,2,1,0,2,0,1,3,2,6,0,6,1,3,3,0,24,FRA
481f76cf,28,15,12,13,3,6,15,9,18,2,16,10,38,25,0,24,FRA
489e80e3,27,14,8,15,4,11,22,11,7,2,5,10,37,5,0,24,FRA
49070d66,39,24,29,10,0,24,40,16,38,27,11,22,61,101,0,24,FRA
4a56052c,33,20,18,10,5,14,31,17,19,4,15,10,43,22,0,24,FRA
4a987ffa,0,0,0,0,0,0,0,0,0,0,0,0,0,0,0,24,FRA
4b96c347,15,7,3,9,3,7,13,6,16,0,16,3,18,9,0,24,FRA
4d3e9033,0,0,0,0,0,0,0,0,0,0,0,0,0,0,0,24,FRA
4e7db402,0,0,0,0,0,0,2,2,0,0,0,0,0,7,0,24,FRA
4fe2648c,0,0,0,0,0,0,0,0,0,0,0,0,0,0,0,24,FRA
5069b796,1,1,1,0,0,0,2,2,2,0,2,5,6,9,1,24,FRA
508a9011,0,0,0,0,0,0,0,0,0,0,0,0,0,0,0,24,FRA
514270e8,0,0,0,0,0,0,2,2,1,0,1,1,1,2,0,24,FRA
5148dcc5,11,7,3,5,3,5,13,8,16,3,13,6,17,14,0,24,FRA
5167c97e,8,7,4,3,1,3,5,2,6,1,5,10,18,18,2,24,FRA
51c30111,0,0,0,0,0,0,1,1,2,1,1,3,3,1,0,24,FRA
51dbeea9,18,12,13,3,2,13,22,9,11,1,10,13,31,34,0,24,FRA
5219ab4a,40,18,20,16,4,23,43,20,16,3,13,30,70,40,0,24,FRA
5271c8f1,1,0,1,0,0,0,3,3,6,1,5,4,5,8,0,24,FRA
546bb36e,6,4,2,2,2,2,9,7,2,1,1,4,10,2,0,24,FRA
547a72ad,15,6,8,6,1,8,15,7,5,3,2,9,24,15,0,24,FRA
548756f2,0,0,0,0,0,0,0,0,0,0,0,0,0,0,0,24,FRA
55abe554,32,20,22,6,4,17,28,11,27,13,14,32,64,43,0,24,FRA
562a4799,41,27,33,6,2,24,46,22,28,17,11,24,65,113,1,24,FRA
5680bf3f,0,0,0,0,0,0,0,0,0,0,0,0,0,0,0,24,FRA
575b1a7b,1,1,1,0,0,1,2,1,1,1,0,1,2,0,0,24,FRA
576817b7,6,4,5,1,0,1,2,1,0,0,0,3,9,2,0,24,FRA
576ca93f,0,0,0,0,0,0,0,0,0,0,0,0,0,0,0,24,FRA
58aae0a9,0,0,0,0,0,0,1,1,3,0,3,2,2,1,0,24,FRA
5939baa2,6,4,1,4,1,4,8,4,3,1,2,2,8,3,0,24,FRA
595e6f3e,17,13,5,9,3,5,19,14,19,4,15,8,25,20,0,24,FRA
59878425,3,2,2,0,1,1,4,3,7,2,5,6,9,1,0,24,FRA
59948ef7,11,8,4,7,0,6,14,8,15,3,12,12,23,8,0,24,FRA
59bf127b,20,13,10,8,2,5,12,7,7,4,3,16,36,13,0,24,FRA
59fcbd6d,46,25,20,19,7,18,51,33,39,6,33,36,82,31,0,24,FRA
5a04fd92,7,6,1,5,1,3,4,1,4,0,4,0,7,1,0,24,FRA
5b146df3,26,15,15,11,0,12,19,7,19,14,5,36,62,72,0,24,FRA
5b479568,2,2,0,1,1,1,2,1,2,0,2,0,2,0,0,24,FRA
5b92d896,0,0,0,0,0,0,0,0,0,0,0,0,0,0,0,24,FRA
5c26ca51,46,32,16,19,11,22,52,30,30,4,26,18,64,5,0,24,FRA
5d004b30,0,0,0,0,0,0,0,0,0,0,0,0,0,0,0,24,FRA
5d0e0a1f,33,18,21,6,6,22,37,15,20,4,16,14,47,39,0,24,FRA
5d36f616,1,1,1,0,0,1,1,0,0,0,0,0,1,0,0,24,FRA
5d8d7454,70,41,42,22,6,36,57,21,32,7,25,59,129,76,1,24,FRA
5dbefa9d,6,5,3,3,0,5,6,1,7,2,5,1,7,6,0,24,FRA
5e22e2a4,46,29,18,22,6,25,40,15,9,3,6,28,74,26,1,24,FRA
5e6355f8,5,3,1,3,1,3,9,6,4,0,4,5,10,5,0,24,FRA
5ea8ef20,0,0,0,0,0,0,0,0,1,1,0,0,0,0,0,24,FRA
5ed97752,19,17,4,10,5,10,23,13,13,2,11,6,25,6,0,24,FRA
5f3eaaf5,7,5,2,5,0,2,8,6,9,1,8,3,10,5,1,24,FRA
5fdcb075,54,34,34,16,4,32,53,21,20,2,18,19,73,47,0,24,FRA
6043997c,18,14,13,5,0,12,18,6,19,11,8,10,28,43,0,24,FRA
60d90c55,1,1,1,0,0,1,1,0,0,0,0,0,1,7,2,24,FRA
6191093d,26,12,14,11,1,10,26,16,13,1,12,5,31,9,0,24,FRA
61f80c89,0,0,0,0,0,0,0,0,0,0,0,0,0,0,0,24,FRA
627c7a3d,2,2,0,2,0,2,3,1,1,0,1,2,4,0,0,24,FRA
6388e356,28,16,13,10,5,21,32,11,19,7,12,24,52,37,0,24,FRA
645a3363,21,11,3,13,5,11,25,14,19,4,15,15,36,21,1,24,FRA
649b57e9,5,4,1,2,2,3,9,6,2,0,2,4,9,10,0,24,FRA
64ba07c0,15,9,12,2,1,5,7,2,13,4,9,8,23,25,0,24,FRA
652d4c37,27,16,9,10,8,11,28,17,23,9,14,9,36,15,0,24,FRA
65c55288,29,19,16,11,2,11,21,10,18,11,7,12,41,45,1,24,FRA
6620c21a,15,11,7,4,4,7,16,9,8,0,8,9,24,17,0,24,FRA
6763f716,29,22,21,6,2,12,21,9,17,11,6,33,62,84,1,24,FRA
68a26d51,41,24,16,24,1,25,61,36,21,4,17,27,68,23,0,24,FRA
698f11e3,21,8,10,10,1,8,20,12,22,12,10,14,35,32,0,24,FRA
6993927b,17,9,12,5,0,10,17,7,23,17,6,8,25,32,3,24,FRA
69c9532c,0,0,0,0,0,0,1,1,0,0,0,0,0,0,0,24,FRA
69e930e4,4,2,2,2,0,3,4,1,0,0,0,4,8,3,0,24,FRA
6a827d8e,9,3,6,2,1,6,8,2,7,1,6,4,13,1,0,24,FRA
6b5edd5d,16,11,4,9,3,5,11,6,5,1,4,5,21,9,0,24,FRA
6b91b999,0,0,0,0,0,0,1,1,0,0,0,0,0,19,1,24,FRA
6b9960cf,43,25,13,21,9,22,43,21,28,7,21,14,57,21,1,24,FRA
6bde367b,32,17,14,13,5,10,52,42,30,7,23,29,61,25,1,24,FRA
6be41a31,9,3,5,4,0,5,11,6,13,1,12,3,12,1,0,24,FRA
6c9642ae,2,1,0,1,1,1,2,1,0,0,0,0,2,0,0,24,FRA
6ce2cdf0,0,16,0,0,0,0,0,0,0,0,0,13,0,0,0,24,FRA
6d0fe035,23,18,5,16,2,7,29,22,22,4,18,17,40,11,0,24,FRA
6d2b0ada,5,1,0,1,4,1,2,1,1,0,1,1,6,2,0,24,FRA
6de23ab0,10,4,5,3,2,9,16,7,12,9,3,15,25,26,1,24,FRA
6dfd8f05,7,6,5,1,1,4,9,5,4,0,4,6,13,15,1,24,FRA
6e33125f,19,11,11,8,0,12,25,13,39,27,12,17,36,97,1,24,FRA
6e7f1353,22,15,9,7,6,11,28,17,28,5,23,19,41,11,0,24,FRA
6f5ec8bb,51,31,19,25,7,36,55,19,34,12,22,18,69,39,2,24,FRA
6f806d99,38,27,17,15,6,19,38,19,16,3,13,14,52,17,0,24,FRA
6fd76804,2,0,0,1,1,1,2,1,1,0,1,0,2,0,0,24,FRA
705a1642,1,0,0,1,0,1,1,0,0,0,0,0,1,0,0,24,FRA
70c52749,1,1,1,0,0,1,1,0,1,0,1,0,1,0,0,24,FRA
7155e3e1,16,12,2,12,2,6,10,4,6,0,6,7,23,8,0,24,FRA
7304f3b1,0,0,0,0,0,0,0,0,0,0,0,0,0,0,0,24,FRA
731f1f5a,1,1,0,1,0,0,3,3,0,0,0,0,1,2,0,24,FRA
7362a6f2,4,1,0,3,1,1,1,0,2,1,1,3,7,0,0,24,FRA
737945d9,24,11,9,7,8,11,31,20,18,0,18,9,33,2,0,24,FRA
7410d325,6,4,2,2,2,3,7,4,6,0,6,0,6,4,0,24,FRA
741418c3,11,5,3,5,3,1,5,4,3,0,3,4,15,7,0,24,FRA
745ca0a3,13,6,5,4,4,6,15,9,6,1,5,7,20,3,1,24,FRA
74d4cec6,14,8,3,5,6,3,12,9,11,2,9,5,19,8,0,24,FRA
75f1ed80,49,31,26,19,4,33,47,14,32,15,17,36,85,83,1,24,FRA
76d679c7,20,12,13,5,2,9,13,4,6,5,1,10,30,29,0,24,FRA
770d7eb8,68,41,31,26,11,24,46,22,20,4,16,23,91,59,1,24,FRA
77816c91,5,1,0,4,1,2,4,2,1,0,1,1,6,0,0,24,FRA
779847d6,22,11,14,6,2,13,23,10,25,18,7,16,38,79,0,24,FRA
7909ffa4,70,47,40,21,9,40,80,40,39,18,21,32,102,46,0,24,FRA
79b51257,18,9,3,11,4,5,11,6,8,1,7,4,22,3,0,24,FRA
7a42d0df,26,17,9,15,2,14,30,16,30,3,27,14,40,27,0,24,FRA
7af655fe,0,0,0,0,0,0,3,3,2,0,2,1,1,1,0,24,FRA
7b082ec2,1,0,0,1,0,0,2,2,4,0,4,2,3,1,0,24,FRA
7b9a9e25,8,4,2,4,2,4,10,6,9,0,9,1,9,9,0,24,FRA
7c3ed041,61,38,45,15,1,41,54,13,28,12,16,39,100,79,0,24,FRA
7cdda3bf,15,11,8,3,4,10,26,16,19,2,17,6,21,7,1,24,FRA
7d08063d,6,3,2,4,0,5,14,9,12,2,10,14,20,13,0,24,FRA
7d827b4f,10,6,5,4,1,6,10,4,2,0,2,3,13,1,0,24,FRA
7d9397f8,30,20,9,17,4,16,31,15,19,9,10,11,41,26,0,24,FRA
7e82a78f,16,10,7,5,4,9,27,18,11,1,10,9,25,14,0,24,FRA
7f41ee30,0,0,0,0,0,0,1,1,0,0,0,0,0,1,1,24,FRA
7f783431,17,11,13,2,2,8,20,12,11,5,6,7,24,19,0,24,FRA
8006228f,6,2,6,0,0,2,5,3,2,0,2,1,7,3,0,24,FRA
8104e41e,18,12,8,8,2,15,30,15,11,1,10,8,26,9,0,24,FRA
822d51d7,47,30,14,27,6,23,52,29,29,6,23,28,75,25,1,24,FRA
8236f673,3,2,2,0,1,2,5,3,2,0,2,3,6,3,0,24,FRA
82464ce3,20,14,8,9,3,7,15,8,10,1,9,11,31,15,0,24,FRA
825ed0d1,9,2,3,2,4,2,6,4,6,1,5,0,9,9,0,24,FRA
83299cc0,23,11,8,13,2,10,30,20,5,0,5,10,33,8,0,24,FRA
8332db56,29,14,21,7,1,18,31,13,14,2,12,16,45,45,0,24,FRA
834b5c4c,0,0,0,0,0,0,0,0,2,0,2,0,0,13,1,24,FRA
8455ad90,22,11,4,8,10,13,33,20,7,0,7,5,27,2,0,24,FRA
8577e60a,42,30,7,30,5,17,40,23,20,0,20,24,66,14,0,24,FRA
86383d0e,14,10,3,9,2,6,14,8,13,5,8,5,19,20,0,24,FRA
868eaba0,32,16,13,17,2,21,61,40,24,7,17,22,54,18,2,24,FRA
87935cf3,1,1,1,0,0,1,1,0,0,0,0,0,1,1,0,24,FRA
87d31635,1,1,1,0,0,1,3,2,0,0,0,0,1,0,0,24,FRA
8846a40f,17,11,7,6,4,7,23,16,10,3,7,8,25,12,0,24,FRA
88acf83f,9,5,3,3,3,4,13,9,5,0,5,2,11,9,0,24,FRA
88c4d190,21,10,7,9,5,11,25,14,13,1,12,2,23,9,0,24,FRA
88f130ed,44,22,24,14,6,24,42,18,30,13,17,28,72,82,0,24,FRA
8b609c34,26,20,14,10,2,13,21,8,23,11,12,44,70,69,1,24,FRA
8b66d9cc,0,0,0,0,0,0,1,1,2,0,2,0,0,0,0,24,FRA
8bfbf257,1,1,0,0,1,0,2,2,2,1,1,4,5,0,0,24,FRA
8f325097,19,15,14,5,0,12,14,2,3,0,3,7,26,16,0,24,FRA
8fd9996f,17,10,11,4,2,6,12,6,23,22,1,20,37,79,1,24,FRA
90eb507d,31,17,21,7,3,19,39,20,32,10,22,24,55,30,0,24,FRA
90fcf472,6,2,1,2,3,2,9,7,3,0,3,4,10,2,0,24,FRA
914bb955,37,26,22,12,3,18,40,22,30,4,26,29,66,50,1,24,FRA
91f04b44,6,6,1,5,0,4,7,3,0,0,0,0,6,1,0,24,FRA
9226aa22,19,12,5,5,9,7,20,13,12,0,12,5,24,4,0,24,FRA
92d90c8f,8,6,0,4,4,3,3,0,4,0,4,1,9,6,0,24,FRA
92ffb8f9,31,15,12,15,4,21,62,41,29,11,18,26,57,30,0,24,FRA
93c942fb,17,7,10,6,1,11,19,8,9,4,5,3,20,15,0,24,FRA
942b4f90,4,3,1,2,1,1,9,8,13,0,13,8,12,1,0,24,FRA
94f8d10c,16,6,13,3,0,11,13,2,19,11,8,9,25,66,1,24,FRA
96726741,4,1,4,0,0,1,1,0,1,0,1,0,4,3,0,24,FRA
967f34d3,0,0,0,0,0,0,0,0,0,0,0,0,0,0,0,24,FRA
972183e0,0,0,0,0,0,0,0,0,1,0,1,0,0,0,0,24,FRA
979b811d,10,6,3,4,3,7,20,13,8,2,6,5,15,6,0,24,FRA
9b5237b1,27,18,11,11,5,13,20,7,11,2,9,3,30,3,0,24,FRA
9b6d9b53,1,0,1,0,0,0,0,0,1,0,1,2,3,5,0,24,FRA
9c4f39b3,6,4,2,3,1,3,8,5,2,1,1,1,7,8,0,24,FRA
9dbb75ca,18,11,8,8,2,5,15,10,20,3,17,5,23,7,0,24,FRA
9dd5da03,3,3,2,0,1,2,3,1,1,0,1,1,4,3,0,24,FRA
9ddf7fae,40,20,23,12,5,16,40,24,19,2,17,10,50,14,0,24,FRA
9e7483ff,27,15,8,12,7,8,24,16,19,0,19,10,37,6,0,24,FRA
9f29c204,3,3,2,1,0,0,5,5,5,1,4,5,8,7,0,24,FRA
9f4a940f,3,1,0,2,1,2,4,2,2,0,2,0,3,0,0,24,FRA
9f936061,36,17,18,14,4,21,51,30,18,4,14,46,82,58,0,24,FRA
a0415710,56,41,26,21,9,28,46,18,19,2,17,10,66,39,0,24,FRA
a08985b8,45,33,21,17,7,28,45,17,20,4,16,25,70,28,0,24,FRA
a0c590b9,7,4,2,3,2,4,8,4,9,2,7,2,9,23,0,24,FRA
a0d55a09,31,14,11,12,8,6,25,19,26,2,24,11,42,10,1,24,FRA
a1390d2f,6,2,1,4,1,3,4,1,0,0,0,2,8,0,0,24,FRA
a17a94d6,41,27,18,20,3,23,33,10,27,4,23,38,79,42,1,24,FRA
a1dbb2c7,0,0,0,0,0,0,0,0,0,0,0,0,0,0,0,24,FRA
a26d3da7,0,0,0,0,0,0,1,1,0,0,0,0,0,0,0,24,FRA
a329a732,2,1,1,1,0,1,1,0,0,0,0,0,2,1,0,24,FRA
a426a912,25,17,12,10,3,10,18,8,9,2,7,5,30,27,0,24,FRA
a4a44eb0,33,20,20,11,2,16,25,9,34,21,13,28,61,97,0,24,FRA
a572e291,4,2,0,1,3,1,3,2,2,2,0,4,8,4,0,24,FRA
a6138e4a,14,9,6,8,0,6,18,12,8,0,8,8,22,5,1,24,FRA
a758ca47,0,0,0,0,0,0,0,0,0,0,0,0,0,0,0,24,FRA
a951ca82,1,1,0,1,0,0,0,0,0,0,0,0,1,0,0,24,FRA
aad56ca3,17,9,4,9,4,7,16,9,15,0,15,11,28,11,0,24,FRA
abd56820,9,5,7,2,0,4,8,4,6,2,4,6,15,6,0,24,FRA
abddf25d,3,2,2,1,0,1,3,2,3,0,3,1,4,0,0,24,FRA
abefc3af,41,20,21,18,2,26,62,36,14,3,11,21,62,13,1,24,FRA
ac73ec79,10,7,5,4,1,7,13,6,13,4,9,10,20,25,0,24,FRA
ac89503b,44,25,36,7,1,24,37,13,44,26,18,25,69,113,1,24,FRA
add37c13,8,7,5,2,1,2,9,7,5,1,4,2,10,5,0,24,FRA
ae7d0ecd,2,1,2,0,0,1,2,1,1,0,1,2,4,21,1,24,FRA
af0c835b,22,12,9,8,5,12,20,8,13,3,10,8,30,9,0,24,FRA
af3ddb2e,2,1,0,1,1,0,3,3,2,0,2,0,2,1,0,24,FRA
afe39ca8,33,21,23,7,3,17,37,20,23,3,20,11,44,40,0,24,FRA
b003239d,9,5,6,3,0,1,5,4,16,8,8,16,25,42,0,24,FRA
b026bbf6,24,12,12,8,4,9,24,15,9,4,5,9,33,27,1,24,FRA
b19db005,16,12,2,6,8,3,10,7,10,0,10,4,20,3,1,24,FRA
b2009f99,11,5,10,0,1,4,4,0,7,4,3,3,14,20,0,24,FRA
b229aa13,7,2,2,4,1,2,3,1,4,0,4,0,7,8,0,24,FRA
b2fe86e5,7,4,2,2,3,1,8,7,3,0,3,9,16,5,0,24,FRA
b34c63a5,23,11,2,16,5,13,37,24,13,3,10,6,29,0,0,24,FRA
b386310a,3,2,2,1,0,2,4,2,6,1,5,3,6,4,0,24,FRA
b3d76d84,1,0,1,0,0,1,2,1,1,0,1,0,1,10,2,24,FRA
b3f8bdef,8,5,2,5,1,6,10,4,9,1,8,4,12,5,0,24,FRA
b4ef3fb5,24,17,13,9,2,18,28,10,10,1,9,14,38,42,0,24,FRA
b5bb8188,14,7,3,8,3,9,20,11,5,2,3,9,23,8,1,24,FRA
b625b241,26,19,10,12,4,9,28,19,14,0,14,7,33,0,0,24,FRA
b666421b,16,10,10,6,0,6,17,11,28,17,11,27,43,70,0,24,FRA
b70a4c6c,0,2,0,0,0,0,0,0,0,0,0,1,0,0,0,24,FRA
b70afb45,23,13,6,7,10,6,11,5,10,4,6,2,25,28,0,24,FRA
b73f17f8,12,4,1,5,6,3,4,1,9,1,8,8,20,6,0,24,FRA
b8aedf06,15,8,10,5,0,6,18,12,12,5,7,13,28,14,0,24,FRA
b8c1de25,47,33,14,27,6,25,57,32,18,3,15,20,67,11,0,24,FRA
b99bec05,23,14,16,5,2,12,28,16,15,4,11,17,40,35,0,24,FRA
b9ae8560,32,21,12,17,3,14,28,14,13,7,6,4,36,12,0,24,FRA
bac89b96,0,0,0,0,0,0,1,1,0,0,0,1,1,0,0,24,FRA
badcdcae,11,8,5,6,0,8,13,5,8,1,7,4,15,8,0,24,FRA
bc7cc472,0,0,0,0,0,0,0,0,1,0,1,1,1,1,0,24,FRA
bcc81786,5,3,3,2,0,4,7,3,0,0,0,0,5,12,0,24,FRA
bf4c41f9,5,4,2,2,1,2,4,2,10,2,8,4,9,3,0,24,FRA
bfb2056e,31,20,22,9,0,10,19,9,35,22,13,15,46,98,1,24,FRA
bfdb33aa,14,8,2,10,2,6,16,10,20,6,14,12,26,11,0,24,FRA
c0b3669f,7,6,4,2,1,3,10,7,5,0,5,4,11,9,0,24,FRA
c0c7ff58,31,20,17,11,3,21,37,16,7,2,5,9,40,19,1,24,FRA
c1597cf7,19,14,12,6,1,12,17,5,11,2,9,7,26,9,0,24,FRA
c19a2df1,5,4,2,3,0,2,8,6,5,2,3,6,11,7,0,24,FRA
c21983bf,24,14,19,5,0,14,25,11,21,10,11,16,40,49,1,24,FRA
c284d6fb,40,24,25,11,4,20,32,12,35,20,15,21,61,50,0,24,FRA
c2a6033c,1,1,0,0,1,1,3,2,3,0,3,1,2,1,0,24,FRA
c2bd8585,8,5,1,5,2,4,7,3,1,1,0,3,11,1,0,24,FRA
c3725db2,18,9,10,5,3,11,17,6,17,12,5,17,35,42,0,24,FRA
c385bf49,30,20,14,12,4,9,22,13,12,3,9,14,44,18,2,24,FRA
c3b6fa1e,32,23,17,11,4,14,26,12,10,1,9,15,47,10,0,24,FRA
c3ee18ef,50,34,26,15,9,29,50,21,20,5,15,27,77,37,0,24,FRA
c43a8336,3,2,3,0,0,2,3,1,5,0,5,3,6,10,0,24,FRA
c4a71372,0,0,0,0,0,0,0,0,1,0,1,0,0,0,0,24,FRA
c55de1f5,10,6,8,0,2,6,6,0,10,6,4,8,18,44,1,24,FRA
c678ddd7,28,18,20,7,1,19,23,4,13,9,4,12,40,42,0,24,FRA
c6f0d5d4,8,6,2,6,0,2,5,3,3,0,3,0,8,2,0,24,FRA
c76b7567,22,11,4,14,4,9,30,21,11,0,11,9,31,10,0,24,FRA
c8c02ac7,19,13,12,4,3,9,21,12,5,1,4,13,32,24,0,24,FRA
c92c24f0,32,23,25,5,2,19,29,10,11,5,6,15,47,57,2,24,FRA
c952f633,13,11,5,7,1,9,12,3,6,2,4,4,17,9,1,24,FRA
c9817014,81,47,32,36,13,38,77,39,21,4,17,37,118,21,1,24,FRA
ca122e29,0,0,0,0,0,0,3,3,1,1,0,0,0,1,0,24,FRA
ca95200f,0,0,0,0,0,0,0,0,0,0,0,0,0,0,0,24,FRA
caa7aaea,28,17,6,20,2,10,24,14,31,7,24,11,39,15,0,24,FRA
cad3fd4d,15,7,5,6,4,11,18,7,4,0,4,8,23,5,0,24,FRA
cc41f558,48,33,33,10,5,33,48,15,51,13,38,37,85,88,0,24,FRA
cc588cbe,28,16,9,15,4,13,20,7,25,9,16,24,52,22,0,24,FRA
cc704d9c,0,0,0,0,0,0,0,0,0,0,0,0,0,0,0,24,FRA
cce181df,39,25,16,19,4,9,24,15,19,3,16,29,68,21,0,24,FRA
cd2cb5bb,0,0,0,0,0,0,0,0,0,0,0,0,0,0,0,24,FRA
cdc4458b,4,4,1,2,1,0,2,2,10,1,9,1,5,6,0,24,FRA
ce50fd99,21,13,4,11,6,7,22,15,12,0,12,8,29,2,0,24,FRA
cea59f02,41,29,25,16,0,30,39,9,20,10,10,31,72,43,0,24,FRA
cedc53d2,2,2,0,1,1,0,0,0,0,0,0,1,3,0,0,24,FRA
cef70c94,2,2,2,0,0,1,2,1,2,1,1,4,6,0,0,24,FRA
cf182add,56,36,25,21,10,25,47,22,27,4,23,26,82,57,0,24,FRA
cf1ef7ec,20,14,10,9,1,8,18,10,11,6,5,11,31,43,1,24,FRA
d17ce930,15,9,10,5,0,9,17,8,10,5,5,9,24,23,2,24,FRA
d2448564,13,9,3,8,2,5,15,10,4,0,4,3,16,3,1,24,FRA
d2c12fe0,0,0,0,0,0,0,0,0,1,0,1,0,0,0,0,24,FRA
d3b54513,1,0,1,0,0,0,2,2,2,2,0,0,1,7,0,24,FRA
d3ddf88b,15,11,6,7,2,7,13,6,5,1,4,9,24,14,0,24,FRA
d469252b,0,3,0,0,0,0,0,0,0,0,0,1,0,0,0,24,FRA
d4d35152,41,24,15,21,5,21,49,28,17,1,16,11,52,15,0,24,FRA
d4e93bab,29,15,9,13,7,12,34,22,12,3,9,16,45,15,1,24,FRA
d5326924,1,0,0,1,0,0,0,0,1,0,1,0,1,1,0,24,FRA
d595de71,0,0,0,0,0,0,0,0,0,0,0,0,0,0,0,24,FRA
d5d22a58,20,14,7,12,1,11,17,6,11,3,8,13,33,21,0,24,FRA
d5dd5f1f,17,11,3,11,3,5,19,14,22,5,17,9,26,21,0,24,FRA
d5f2f82b,17,9,9,7,1,10,15,5,26,18,8,16,33,50,0,24,FRA
d638ab17,7,3,3,3,1,4,8,4,5,1,4,4,11,3,0,24,FRA
d7547531,4,4,2,1,1,1,1,0,0,0,0,0,4,0,0,24,FRA
d8c19a60,1,0,0,1,0,0,1,1,3,0,3,2,3,5,0,24,FRA
d9764034,18,7,11,6,1,10,23,13,24,12,12,22,40,97,4,24,FRA
d97af612,23,10,8,8,7,14,30,16,13,2,11,5,28,5,0,24,FRA
daa11a4f,0,0,0,0,0,0,3,3,7,3,4,0,0,2,0,24,FRA
dab1b8dc,0,0,0,0,0,0,0,0,0,0,0,0,0,0,0,24,FRA
dacf856a,6,3,2,3,1,2,6,4,2,0,2,0,6,0,0,24,FRA
db87a2c4,0,0,0,0,0,0,1,1,0,0,0,0,0,8,3,24,FRA
dbd3a428,23,11,7,11,5,7,28,21,15,1,14,11,34,7,0,24,FRA
dc29b608,0,0,0,0,0,0,1,1,0,0,0,0,0,14,3,24,FRA
dcd94cdb,0,0,0,0,0,0,0,0,0,0,0,0,0,1,0,24,FRA
dd211559,21,15,13,7,1,10,19,9,16,2,14,4,25,30,0,24,FRA
dd745366,8,5,5,3,0,6,8,2,2,0,2,1,9,5,0,24,FRA
de17db90,3,2,0,1,2,1,3,2,2,0,2,1,4,1,1,24,FRA
df8d6029,23,13,13,6,4,19,30,11,34,21,13,25,48,77,2,24,FRA
dfc5d4fa,51,25,22,28,1,23,41,18,21,4,17,21,72,36,2,24,FRA
e0f3a1f6,24,19,13,9,2,14,21,7,15,8,7,28,52,66,0,24,FRA
e11a39aa,0,0,0,0,0,0,0,0,0,0,0,0,0,0,0,24,FRA
e1df6989,3,1,1,2,0,1,4,3,5,1,4,3,6,2,0,24,FRA
e2ae54db,9,7,3,5,1,3,14,11,5,2,3,1,10,4,0,24,FRA
e33fb79d,5,2,0,4,1,1,4,3,5,1,4,0,5,15,0,24,FRA
e3a5814e,25,10,8,11,6,11,24,13,11,2,9,14,39,18,0,24,FRA
e3e32fbb,8,6,6,1,1,4,6,2,0,0,0,3,11,6,0,24,FRA
e42d61c7,26,16,13,7,6,15,29,14,23,3,20,11,37,25,2,24,FRA
e43a4083,1,0,0,1,0,0,1,1,1,0,1,0,1,0,0,24,FRA
e4448c8c,5,2,1,1,3,1,5,4,1,0,1,0,5,0,0,24,FRA
e50623a0,16,12,10,5,1,10,24,14,8,3,5,16,32,29,0,24,FRA
e546b2e3,21,9,10,7,4,7,25,18,19,1,18,16,37,18,0,24,FRA
e54a9890,1,1,1,0,0,1,1,0,1,0,1,0,1,3,0,24,FRA
e606b6c0,1,0,0,0,1,0,0,0,1,0,1,1,2,0,0,24,FRA
e768de1f,2,2,1,0,1,1,3,2,2,0,2,4,6,2,0,24,FRA
e76cb9cc,28,19,24,3,1,15,24,9,18,11,7,13,41,90,0,24,FRA
e7d59f4f,26,15,6,17,3,11,32,21,29,4,25,11,37,3,0,24,FRA
e8a65bc8,19,11,6,8,5,9,22,13,9,0,9,8,27,2,0,24,FRA
e8c5dd4d,0,0,0,0,0,0,1,1,0,0,0,0,0,12,0,24,FRA
e980e78d,0,0,0,0,0,0,0,0,0,0,0,1,1,3,0,24,FRA
ea0893d6,4,2,2,2,0,1,3,2,3,2,1,1,5,3,0,24,FRA
eb7822d7,28,16,12,12,4,15,21,6,23,10,13,34,62,27,0,24,FRA
ecada4fc,0,0,0,0,0,0,0,0,0,0,0,0,0,0,0,24,FRA
ed45c4a5,23,12,9,12,2,14,26,12,16,4,12,15,38,18,0,24,FRA
ed55b838,14,8,5,6,3,7,20,13,8,2,6,5,19,8,0,24,FRA
ed90babd,4,3,2,2,0,2,7,5,2,0,2,6,10,1,0,24,FRA
ed9f7cfe,24,16,8,13,3,13,21,8,7,2,5,16,40,35,0,24,FRA
eda38706,7,6,1,6,0,2,2,0,5,0,5,2,9,2,0,24,FRA
ee158be5,40,20,23,12,5,12,24,12,18,5,13,18,58,19,0,24,FRA
ee45fd85,45,31,15,21,9,24,56,32,20,1,19,27,72,24,1,24,FRA
eedea60b,0,0,0,0,0,0,0,0,0,0,0,0,0,15,2,24,FRA
eef3f9c6,3,1,0,3,0,0,3,3,3,0,3,1,4,0,0,24,FRA
ef7cd87a,36,24,17,16,3,23,48,25,25,7,18,21,57,23,0,24,FRA
ef9c1c95,81,45,35,41,5,39,74,35,30,5,25,30,111,54,0,24,FRA
f00de885,0,0,0,0,0,0,0,0,0,0,0,0,0,14,0,24,FRA
f02067df,0,0,0,0,0,0,0,0,0,0,0,0,0,0,0,24,FRA
f066022d,17,11,12,4,1,11,26,15,27,20,7,8,25,88,1,24,FRA
f0661424,48,30,21,21,6,20,43,23,21,6,15,18,66,35,0,24,FRA
f15f8b2b,20,16,10,5,5,9,20,11,17,1,16,4,24,5,0,24,FRA
f18d7ab2,43,31,34,8,1,27,34,7,29,16,13,27,70,69,1,24,FRA
f20e4cc9,4,4,3,1,0,4,7,3,1,0,1,1,5,1,0,24,FRA
f28474a4,5,3,2,3,0,2,6,4,6,2,4,9,14,1,0,24,FRA
f323d995,7,5,6,1,0,4,13,9,20,16,4,7,14,75,1,24,FRA
f365b837,11,4,6,3,2,1,9,8,11,3,8,11,22,15,1,24,FRA
f36d5624,4,4,2,1,1,2,2,0,5,0,5,2,6,1,0,24,FRA
f41a69e6,0,0,0,0,0,0,1,1,0,0,0,1,1,10,3,24,FRA
f4547573,0,0,0,0,0,0,0,0,0,0,0,0,0,0,0,24,FRA
f5044e54,84,56,46,36,2,41,110,69,53,9,44,41,125,60,3,24,FRA
f527a32c,21,11,9,10,2,9,24,15,16,2,14,6,27,4,1,24,FRA
f5c8b425,17,10,6,7,4,3,11,8,9,1,8,5,22,5,0,24,FRA
f63cda26,19,11,4,9,6,6,17,11,8,1,7,4,23,16,0,24,FRA
f6857b4f,9,5,6,2,1,2,6,4,2,0,2,2,11,6,0,24,FRA
f6a3c84d,24,18,8,10,6,10,25,15,13,2,11,9,33,25,1,24,FRA
f6b94e8d,17,9,14,3,0,8,10,2,6,4,2,9,26,29,2,24,FRA
f81ef10d,74,55,31,32,11,32,85,53,34,6,28,39,113,18,2,24,FRA
f833a830,25,14,5,10,10,12,44,32,21,1,20,9,34,8,0,24,FRA
f8342731,15,10,7,5,3,11,21,10,5,1,4,5,20,5,0,24,FRA
f8405304,7,5,2,4,1,1,4,3,6,0,6,3,10,4,0,24,FRA
f86fe8c1,57,27,25,27,5,23,46,23,26,3,23,26,83,29,1,24,FRA
f9124307,17,10,5,7,5,10,20,10,8,2,6,5,22,5,0,24,FRA
f999e9be,11,3,3,6,2,5,9,4,7,3,4,1,12,7,0,24,FRA
f9d5908e,35,16,13,19,3,17,23,6,12,0,12,9,44,12,0,24,FRA
faf00ab8,23,13,16,4,3,8,21,13,11,0,11,12,35,4,0,24,FRA
fb14aa28,8,5,1,2,5,3,7,4,0,0,0,2,10,1,1,24,FRA
fb4c5b6e,6,3,5,1,0,4,9,5,6,3,3,10,16,34,1,24,FRA
fc46aab1,0,0,0,0,0,0,0,0,0,0,0,0,0,1,0,24,FRA
fc4cf6a7,30,22,16,8,6,21,30,9,24,8,16,14,44,22,0,24,FRA
fcb9b1f8,1,1,0,1,0,0,0,0,0,0,0,1,2,2,0,24,FRA
fcc84a07,14,6,6,5,3,3,16,13,9,1,8,4,18,8,0,24,FRA
fd2bc67d,49,22,34,13,2,30,41,11,32,17,15,28,77,68,2,24,FRA
fe012aca,8,4,1,7,0,5,13,8,23,2,21,4,12,3,0,24,FRA
fed17f5a,10,7,5,2,3,4,18,14,8,3,5,2,12,9,1,24,FRA
ff74841d,1,1,1,0,0,1,1,0,0,0,0,1,2,5,3,24,FRA
fffea3e5,2,2,1,0,1,1,1,0,0,0,0,0,2,0,0,24,FRA
