id,matches,minutes,nineties,starts,completed,sub,sub_unused,onpitch_goals,onpitch_goals_ag,onpitch_goals_delta,onpitch_xg,onpitch_xga,onpitch_xg_delta,season,comp
00844823,25,2250,25.0,25,25,0,1,30,29,1,30.9,35.1,-4.2,18,GER
00a6485f,23,1927,21.4,22,16,1,4,20,23,-3,25.0,21.4,3.6,18,GER
012c38ec,1,55,0.6,1,0,0,1,1,0,1,0.5,1.1,-0.6,18,GER
016ff750,26,1864,20.7,19,16,7,0,29,26,3,27.8,29.0,-1.2,18,GER
0174ba21,3,69,0.8,1,0,2,2,1,3,-2,1.2,1.6,-0.4,18,GER
01c3aff5,22,1263,14.0,13,8,9,4,19,18,1,18.2,16.4,1.7,18,GER
01e5f06e,2,9,0.1,0,0,2,1,0,0,0,0.1,0.0,0.0,18,GER
03bd0bf4,34,3060,34.0,34,34,0,0,53,37,16,46.7,40.2,6.6,18,GER
042e8a49,21,1153,12.8,10,6,11,0,34,8,26,28.1,9.6,18.4,18,GER
048a1cbc,9,547,6.1,6,3,3,2,11,10,1,10.7,7.9,2.8,18,GER
04c11885,28,2055,22.8,23,16,5,6,31,36,-5,30.3,42.3,-12.0,18,GER
05439de2,23,1551,17.2,17,14,6,0,51,10,41,41.5,13.8,27.7,18,GER
05d548d8,26,2213,24.6,25,23,1,5,65,20,45,55.3,24.5,30.8,18,GER
061e8e23,20,1203,13.4,15,6,5,2,31,12,19,25.1,14.8,10.3,18,GER
070ec0b1,29,2345,26.1,29,24,0,1,43,35,8,41.6,28.1,13.5,18,GER
080440a4,30,2655,29.5,29,29,1,0,38,39,-1,38.0,36.7,1.3,18,GER
088ca1bd,25,1473,16.4,15,10,10,6,16,23,-7,16.6,20.6,-3.9,18,GER
09586899,21,1507,16.7,19,7,2,3,45,12,33,37.8,11.8,26.0,18,GER
096a77c4,7,201,2.2,1,0,6,3,1,3,-2,3.7,3.2,0.5,18,GER
0a1cb833,34,3060,34.0,34,34,0,0,37,40,-3,38.9,45.1,-6.2,18,GER
0a89e877,23,1268,14.1,11,9,12,9,27,22,5,27.1,18.8,8.3,18,GER
0b4f388a,21,919,10.2,9,2,12,7,20,13,7,15.3,13.6,1.7,18,GER
0cf778df,2,95,1.1,1,0,1,0,1,0,1,1.8,0.4,1.4,18,GER
0d55d942,33,2906,32.3,33,32,0,0,28,53,-25,38.3,44.6,-6.3,18,GER
0d8a37c2,5,435,4.8,4,4,1,29,3,10,-7,5.7,8.0,-2.4,18,GER
0dabaf14,6,305,3.4,3,1,3,11,4,3,1,4.2,4.0,0.2,18,GER
0eb5720b,17,1445,16.1,17,14,0,6,13,26,-13,14.2,27.4,-13.1,18,GER
0f26fd24,18,949,10.5,11,3,7,9,10,12,-2,13.2,16.1,-2.9,18,GER
0fbecd11,28,1664,18.5,18,8,10,4,25,27,-2,29.8,21.8,8.1,18,GER
1025db8e,27,2385,26.5,27,26,0,0,34,36,-2,34.7,31.2,3.5,18,GER
106bca06,15,808,9.0,9,5,6,9,11,9,2,10.5,9.9,0.6,18,GER
11dbba47,24,1299,14.4,14,3,10,7,22,21,1,23.1,18.1,5.0,18,GER
11fd2b75,9,771,8.6,8,8,1,0,14,15,-1,12.2,12.5,-0.4,18,GER
1238a3f9,27,1886,21.0,19,12,8,0,28,32,-4,29.0,29.0,0.0,18,GER
125cb9fe,11,786,8.7,9,7,2,5,2,14,-12,6.9,13.3,-6.4,18,GER
126cf855,1,7,0.1,0,0,1,3,0,0,0,0.0,0.0,0.0,18,GER
13ddc856,15,721,8.0,7,3,8,6,6,10,-4,9.7,9.7,-0.1,18,GER
140afefb,16,1169,13.0,13,11,3,0,15,34,-19,13.8,26.5,-12.7,18,GER
15413fa5,23,1670,18.6,19,14,4,5,21,31,-10,24.2,39.5,-15.4,18,GER
15b287da,3,144,1.6,2,0,1,4,0,2,-2,1.3,1.4,0.0,18,GER
15ea94de,13,467,5.2,4,1,9,10,10,10,0,8.1,11.1,-2.9,18,GER
16b8fabd,2,91,1.0,1,1,1,32,4,4,0,2.4,1.1,1.3,18,GER
16daec92,29,1815,20.2,22,9,7,4,22,21,1,23.1,25.1,-2.0,18,GER
17370b95,18,1350,15.0,15,13,3,14,27,26,1,24.2,20.1,4.1,18,GER
17376543,2,154,1.7,1,1,1,32,4,3,1,1.3,1.5,-0.2,18,GER
17780d2b,4,115,1.3,1,0,3,1,3,2,1,2.0,2.2,-0.2,18,GER
1900032e,32,2880,32.0,32,32,0,0,41,48,-7,46.5,48.3,-1.8,18,GER
1ae836b1,4,128,1.4,1,1,3,8,1,3,-2,0.5,1.8,-1.3,18,GER
1bcca8b8,16,1092,12.1,12,9,4,1,13,14,-1,16.0,12.1,3.9,18,GER
1bf33a9a,32,2302,25.6,27,14,5,0,49,38,11,48.9,31.5,17.3,18,GER
1c08a3c8,12,850,9.4,11,8,1,3,8,11,-3,7.5,10.0,-2.5,18,GER
1cd87320,27,2379,26.4,27,25,0,7,35,38,-3,35.5,42.0,-6.5,18,GER
1d8e9add,31,2790,31.0,31,31,0,0,59,47,12,47.9,43.3,4.7,18,GER
1e43fad8,34,3015,33.5,34,33,0,0,53,37,16,46.1,39.8,6.4,18,GER
20030c06,26,2126,23.6,25,22,1,4,34,34,0,36.2,31.2,5.0,18,GER
2042d931,31,2207,24.5,27,8,4,3,32,37,-5,27.5,32.5,-5.0,18,GER
21166ff4,26,2153,23.9,25,22,1,3,18,36,-18,23.7,30.6,-6.9,18,GER
22051fbe,29,2284,25.4,26,18,3,2,24,38,-14,22.9,34.8,-11.8,18,GER
226008f1,1,90,1.0,1,1,0,15,1,1,0,0.9,1.0,0.0,18,GER
229cd98a,26,586,6.5,3,0,23,2,10,10,0,8.8,11.0,-2.2,18,GER
258a6f4d,22,1138,12.6,12,5,10,2,14,16,-2,19.4,16.3,3.1,18,GER
25ab9c9c,17,1530,17.0,17,17,0,0,15,25,-10,17.6,21.2,-3.7,18,GER
2628fd2b,33,2970,33.0,33,33,0,0,58,40,18,57.0,35.3,21.7,18,GER
26db8853,18,1318,14.6,16,10,2,4,9,26,-17,14.4,24.6,-10.2,18,GER
27d2618c,31,2790,31.0,31,31,0,0,41,44,-3,36.2,39.2,-2.9,18,GER
2903a856,23,1033,11.5,12,4,11,1,17,22,-5,20.3,18.5,1.8,18,GER
2930c9d8,1,45,0.5,1,0,0,5,1,1,0,0.7,0.8,0.0,18,GER
2973d8ff,10,839,9.3,9,9,1,0,14,14,0,15.2,14.6,0.6,18,GER
2979c05a,17,901,10.0,10,6,7,5,15,19,-4,11.8,17.0,-5.2,18,GER
29f7cfd9,17,963,10.7,12,4,5,5,9,26,-17,12.6,22.1,-9.5,18,GER
2a29eb9b,15,1151,12.8,13,11,2,18,13,20,-7,14.3,18.8,-4.5,18,GER
2b350e6b,9,520,5.8,6,2,3,2,8,10,-2,6.1,10.5,-4.4,18,GER
2b83fa49,11,825,9.2,10,7,1,7,9,23,-14,13.4,22.7,-9.3,18,GER
2bcc6d52,32,2324,25.8,24,14,8,0,41,33,8,35.3,33.5,1.8,18,GER
2c38b327,7,260,2.9,3,0,4,8,4,5,-1,1.2,4.7,-3.6,18,GER
2db2fd7b,19,1640,18.2,19,15,0,7,58,12,46,43.3,13.6,29.7,18,GER
2e64bb49,1,29,0.3,0,0,1,1,1,0,1,0.7,0.4,0.3,18,GER
2e7ff968,32,2880,32.0,32,32,0,1,41,42,-1,43.8,38.4,5.4,18,GER
302527b2,11,865,9.6,11,8,0,7,6,21,-15,10.2,16.3,-6.0,18,GER
30261ba1,1,7,0.1,0,0,1,1,0,0,0,0.0,0.0,0.0,18,GER
30c220c3,24,1979,22.0,23,19,1,3,26,28,-2,24.5,26.0,-1.5,18,GER
31114001,17,1002,11.1,11,3,6,9,12,14,-2,13.3,17.1,-3.8,18,GER
316de854,6,245,2.7,1,0,5,5,3,6,-3,3.9,3.6,0.2,18,GER
3189f61a,16,1011,11.2,12,8,4,6,14,7,7,13.2,11.2,1.9,18,GER
32e96d52,1,39,0.4,0,0,1,0,0,3,-3,0.1,1.0,-0.9,18,GER
3376a776,26,2302,25.6,26,24,0,0,34,38,-4,30.7,30.1,0.7,18,GER
33a81b3d,11,396,4.4,3,0,8,3,3,10,-7,5.3,12.3,-7.0,18,GER
33b554b7,29,2352,26.1,27,22,2,0,25,35,-10,26.3,35.0,-8.7,18,GER
33ec696b,1,32,0.4,0,0,1,1,1,3,-2,0.9,1.3,-0.4,18,GER
346d51d9,25,1944,21.6,20,18,5,6,40,30,10,43.7,29.2,14.6,18,GER
34b54da7,13,727,8.1,8,4,5,12,12,13,-1,13.2,12.1,1.1,18,GER
34c313d5,10,297,3.3,3,0,7,6,2,3,-1,4.2,5.0,-0.8,18,GER
362aa29d,1,4,0.0,0,0,1,0,1,0,1,0.5,0.2,0.3,18,GER
36a3ff67,11,928,10.3,11,4,0,0,16,11,5,15.8,10.9,4.9,18,GER
379c0717,1,2,0.0,0,0,1,2,0,0,0,0.0,0.0,0.0,18,GER
37c213cf,3,56,0.6,0,0,3,0,1,1,0,1.3,1.3,0.0,18,GER
37f606f0,21,1588,17.6,20,12,1,1,30,23,7,22.8,21.0,1.9,18,GER
381e52af,6,191,2.1,1,1,5,7,5,5,0,5.1,2.1,3.0,18,GER
384d58d9,30,2296,25.5,29,16,1,0,34,40,-6,36.7,38.3,-1.6,18,GER
3963c25b,3,156,1.7,1,1,2,2,2,5,-3,2.1,5.5,-3.4,18,GER
3a233281,30,2215,24.6,25,15,5,3,42,27,15,43.7,28.3,15.4,18,GER
3c05e082,28,2046,22.7,23,14,5,1,23,28,-5,28.1,27.9,0.2,18,GER
3c6089ab,29,2005,22.3,22,12,7,1,66,19,47,51.3,20.8,30.5,18,GER
3cd9e95a,34,3060,34.0,34,34,0,0,35,70,-35,43.2,67.4,-24.1,18,GER
3dffff26,28,2336,26.0,28,21,0,4,33,38,-5,34.2,42.9,-8.6,18,GER
3e99c613,2,90,1.0,1,0,1,5,0,2,-2,0.8,1.2,-0.4,18,GER
3eb0f2df,21,1635,18.2,18,13,3,3,23,26,-3,18.6,22.9,-4.3,18,GER
3f30b506,11,914,10.2,10,9,1,14,7,17,-10,12.9,19.5,-6.6,18,GER
3f65898c,32,2828,31.4,31,30,1,0,34,35,-1,35.0,40.7,-5.8,18,GER
3f7cd8f1,27,1859,20.7,23,8,4,5,27,22,5,23.8,24.8,-1.0,18,GER
3faa1780,21,1160,12.9,15,4,6,7,25,19,6,17.6,18.7,-1.0,18,GER
410ab123,16,1196,13.3,13,10,3,5,12,25,-13,17.3,25.9,-8.6,18,GER
4114f306,23,1674,18.6,20,14,3,3,24,44,-20,22.3,36.3,-14.1,18,GER
420c18a1,30,2625,29.2,30,29,0,0,44,42,2,45.5,43.9,1.5,18,GER
433dc9a2,11,888,9.9,11,7,0,5,31,10,21,19.6,11.4,8.2,18,GER
43a166b4,31,1967,21.9,22,14,9,0,26,31,-5,23.3,38.3,-15.0,18,GER
442b56fa,3,233,2.6,3,2,0,1,6,3,3,4.1,2.4,1.6,18,GER
44e471ca,2,110,1.2,2,0,0,0,1,1,0,1.7,2.4,-0.7,18,GER
45870256,1,19,0.2,0,0,1,7,0,0,0,0.5,0.1,0.4,18,GER
45954ec7,16,1247,13.9,14,12,2,2,17,20,-3,15.5,25.8,-10.4,18,GER
45a03961,34,3060,34.0,34,34,0,0,36,36,0,40.3,43.5,-3.1,18,GER
45b7edae,27,2173,24.1,24,23,3,0,26,23,3,30.1,31.2,-1.2,18,GER
463503e2,23,1138,12.6,12,9,11,6,9,16,-7,12.9,17.8,-4.9,18,GER
47064058,34,3060,34.0,34,34,0,0,66,48,18,50.5,47.2,3.3,18,GER
48035304,33,2914,32.4,33,31,0,0,45,51,-6,48.9,50.0,-1.1,18,GER
482b70ad,15,1041,11.6,12,5,3,1,8,19,-11,14.2,17.6,-3.4,18,GER
49296448,29,2329,25.9,26,22,3,4,71,25,46,54.9,26.9,28.0,18,GER
496aeede,27,2151,23.9,26,17,1,0,27,32,-5,31.4,37.2,-5.8,18,GER
49d53c68,17,1417,15.7,17,15,0,2,24,19,5,22.7,18.0,4.8,18,GER
49fe9070,32,2494,27.7,28,19,4,1,47,46,1,41.0,37.9,3.1,18,GER
49ffe0f2,21,797,8.9,7,0,14,5,8,12,-4,9.9,14.2,-4.3,18,GER
4a15e95b,24,2160,24.0,24,24,0,9,18,38,-20,24.0,40.3,-16.3,18,GER
4b5e7e90,1,27,0.3,0,0,1,6,1,0,1,0.5,1.4,-0.9,18,GER
4bd00a50,24,1716,19.1,18,15,6,6,34,25,9,30.2,23.4,6.7,18,GER
4d74201d,10,498,5.5,5,2,5,5,9,10,-1,9.2,7.0,2.3,18,GER
4d8cd038,22,936,10.4,9,5,13,9,18,21,-3,16.1,16.1,0.0,18,GER
4e204552,5,114,1.3,1,0,4,7,0,3,-3,0.5,2.0,-1.5,18,GER
4f16405e,34,2387,26.5,26,19,8,0,37,41,-4,37.4,43.8,-6.4,18,GER
500cd987,7,372,4.1,5,0,2,4,4,3,1,3.4,4.2,-0.8,18,GER
50871bcc,34,2939,32.7,33,25,1,0,47,51,-4,50.6,49.1,1.5,18,GER
51dbeea9,28,2365,26.3,27,25,1,4,37,28,9,35.0,29.0,6.1,18,GER
531807b3,12,634,7.0,7,2,5,0,8,13,-5,7.8,13.4,-5.5,18,GER
5343eb4e,27,1904,21.2,20,11,7,0,24,31,-7,22.7,26.6,-3.9,18,GER
536cebe5,25,1751,19.5,21,6,4,0,29,20,9,23.8,22.4,1.4,18,GER
53e07d0b,18,896,10.0,8,6,10,6,16,17,-1,15.4,14.0,1.4,18,GER
53eeaf6a,9,338,3.8,3,3,6,7,2,9,-7,4.8,8.6,-3.8,18,GER
541cdd20,22,1687,18.7,20,12,2,10,26,39,-13,23.5,32.0,-8.5,18,GER
549c6ba7,30,1654,18.4,22,4,8,3,29,16,13,25.1,16.8,8.3,18,GER
54b4dc4e,19,1211,13.5,13,9,6,1,22,13,9,18.4,16.9,1.5,18,GER
54b6ee79,16,579,6.4,5,2,11,6,8,19,-11,7.0,13.2,-6.1,18,GER
54e4866f,17,786,8.7,9,6,8,7,8,14,-6,10.4,13.8,-3.4,18,GER
5528407e,29,2319,25.8,27,16,2,0,29,37,-8,31.5,36.4,-4.8,18,GER
55537f53,9,189,2.1,0,0,9,4,0,2,-2,2.9,4.4,-1.5,18,GER
555d5edd,28,1744,19.4,19,8,9,3,35,31,4,30.6,28.9,1.8,18,GER
5603d397,1,11,0.1,0,0,1,7,0,0,0,0.2,0.3,-0.1,18,GER
56413b1f,27,2302,25.6,27,22,0,3,41,29,12,42.9,26.6,16.3,18,GER
565bf0da,27,2302,25.6,27,25,0,1,30,31,-1,30.2,29.3,1.0,18,GER
57200916,1,8,0.1,0,0,1,6,0,0,0,0.1,0.0,0.0,18,GER
5722eced,24,1207,13.4,9,5,15,8,18,24,-6,21.3,20.6,0.7,18,GER
5939baa2,28,2197,24.4,24,22,4,4,41,29,12,37.7,28.9,8.8,18,GER
59e4b92e,30,2275,25.3,27,19,3,1,27,35,-8,29.9,32.1,-2.2,18,GER
5afafbfe,19,1166,13.0,12,7,7,5,20,19,1,25.6,15.5,10.1,18,GER
5b52d1f7,2,180,2.0,2,2,0,26,2,0,2,3.8,0.9,3.0,18,GER
5c4bf6ba,15,1350,15.0,15,15,0,10,19,27,-8,16.0,21.4,-5.4,18,GER
5c899683,3,75,0.7999999999999999,1,0,2,6,2,2,0,1.0,1.6,-0.6,18,GER
5caa62a7,28,1611,17.9,16,5,12,5,23,26,-3,28.7,23.4,5.4,18,GER
5d8e331f,27,2259,25.1,24,23,3,0,24,47,-23,32.0,36.5,-4.5,18,GER
5ddb8f9f,17,1202,13.4,13,12,4,3,19,23,-4,18.7,16.4,2.3,18,GER
5e1df051,2,101,1.1,1,0,1,1,1,1,0,0.3,0.8,-0.5,18,GER
5e66fa06,27,2278,25.3,26,25,1,1,32,35,-3,33.6,39.7,-6.1,18,GER
5ed9b537,16,1228,13.6,14,12,2,11,25,23,2,20.2,19.8,0.3,18,GER
5f9f0531,28,2081,23.1,26,14,2,0,21,34,-13,27.5,33.9,-6.4,18,GER
603cb947,34,2228,24.8,22,16,12,0,50,38,12,38.4,36.4,2.0,18,GER
612cb8d3,14,646,7.2,6,1,8,6,10,16,-6,12.0,14.5,-2.5,18,GER
61b0b44d,25,1596,17.799999999999997,18,11,7,3,41,24,17,30.4,21.8,8.6,18,GER
61fc9685,22,957,10.6,11,1,11,7,14,18,-4,10.7,14.5,-3.8,18,GER
626fab5f,9,696,7.7,7,5,2,5,8,11,-3,11.4,9.2,2.2,18,GER
62ab9184,17,1228,13.6,12,11,5,5,18,16,2,15.1,18.6,-3.5,18,GER
6435e737,12,925,10.3,11,8,1,4,7,14,-7,14.4,20.2,-5.8,18,GER
64c07ae1,20,1607,17.9,17,14,3,2,25,20,5,19.9,21.3,-1.4,18,GER
64f69877,31,2591,28.8,30,22,1,1,50,34,16,47.5,30.0,17.5,18,GER
652d4c37,26,1575,17.5,17,12,9,6,41,16,25,36.5,15.9,20.6,18,GER
66385c46,25,1741,19.3,21,6,4,0,21,27,-6,19.1,25.8,-6.7,18,GER
6743cef5,20,1012,11.2,12,3,8,5,14,14,0,14.8,19.5,-4.7,18,GER
677da306,19,1560,17.3,17,16,2,3,16,25,-9,16.8,27.2,-10.4,18,GER
67cdbc0e,22,1456,16.2,17,9,5,0,42,13,29,35.9,15.4,20.5,18,GER
68635c10,28,2001,22.2,24,18,4,4,24,42,-18,29.2,42.3,-13.1,18,GER
6873f3bc,22,1868,20.8,22,20,0,6,16,30,-14,21.0,31.1,-10.1,18,GER
68829001,19,1206,13.4,16,9,3,9,27,17,10,25.0,17.2,7.9,18,GER
69374ff5,22,1393,15.5,17,9,5,9,32,12,20,29.8,14.2,15.6,18,GER
699fb8db,31,2790,31.0,31,31,0,0,33,65,-32,40.2,61.6,-21.3,18,GER
6a81a181,24,674,7.5,3,0,21,3,9,18,-9,8.3,12.1,-3.8,18,GER
6b85f966,3,52,0.6,0,0,3,4,0,0,0,0.3,0.3,0.0,18,GER
6bd5cd5d,24,2102,23.4,24,22,0,10,23,35,-12,22.4,33.6,-11.2,18,GER
6bd603db,30,2591,28.8,29,28,1,1,33,42,-9,30.6,38.1,-7.5,18,GER
6c6a3300,9,384,4.3,5,0,4,5,5,6,-1,5.2,5.6,-0.3,18,GER
6cafd68d,15,969,10.8,10,9,5,5,23,12,11,16.3,13.9,2.4,18,GER
6d8f8441,1,2,0.0,0,0,1,12,0,0,0,0.0,0.1,-0.1,18,GER
6e33125f,16,1105,12.3,13,8,3,8,12,20,-8,15.4,15.3,0.1,18,GER
6ec6fde0,22,1690,18.8,17,16,5,3,42,27,15,32.1,23.6,8.5,18,GER
6fd8a334,1,45,0.5,0,0,1,0,1,1,0,1.1,1.6,-0.5,18,GER
70dcf94d,33,2748,30.5,31,19,2,0,27,47,-20,34.3,39.6,-5.3,18,GER
710fbdd1,6,196,2.2,2,0,4,11,3,2,1,4.4,1.8,2.6,18,GER
7124239e,1,23,0.3,0,0,1,7,1,0,1,0.5,0.3,0.2,18,GER
715bf047,23,1621,18.0,19,11,4,5,45,15,30,36.8,20.0,16.8,18,GER
71a20ce8,28,2321,25.8,27,22,1,0,31,25,6,28.5,33.9,-5.3,18,GER
733fecf1,10,277,3.1,3,0,7,13,8,3,5,5.0,3.7,1.3,18,GER
7364c4d1,7,235,2.6,3,0,4,2,1,5,-4,2.8,4.0,-1.2,18,GER
73e2f6eb,31,2790,31.0,31,31,0,1,39,45,-6,39.4,48.2,-8.8,18,GER
7483d9f9,3,34,0.4,0,0,3,1,0,1,-1,0.4,0.5,-0.1,18,GER
74c7c2db,24,1409,15.7,15,8,9,6,18,26,-8,17.6,25.9,-8.3,18,GER
74ced675,5,108,1.2,1,0,4,7,1,2,-1,1.1,0.8,0.3,18,GER
74d70fb5,21,1366,15.2,16,14,5,10,22,21,1,16.8,18.5,-1.7000000000000002,18,GER
76e5da9d,10,465,5.2,5,0,5,4,12,13,-1,9.5,11.4,-1.9,18,GER
77e84962,19,1247,13.9,12,9,7,1,39,10,29,33.1,10.2,22.9,18,GER
78952998,3,73,0.8,0,0,3,3,1,1,0,0.9,0.6,0.3,18,GER
78e68b4d,14,1173,13.0,14,10,0,9,15,25,-10,13.3,21.3,-8.0,18,GER
791abba1,32,2879,32.0,32,31,0,0,43,53,-10,43.2,53.1,-9.9,18,GER
791af558,27,2071,23.0,23,11,4,1,36,34,2,33.7,32.7,1.0,18,GER
79c90e45,28,2199,24.4,24,22,4,3,53,33,20,35.0,35.0,-0.1,18,GER
79ca3e23,17,744,8.3,9,0,8,9,9,6,3,8.1,9.3,-1.2,18,GER
79fa1799,2,60,0.7,1,0,1,6,0,2,-2,0.1,1.4,-1.3,18,GER
7aac47fe,9,548,6.1,7,4,2,8,12,10,2,5.6,11.6,-6.0,18,GER
7c104bb7,11,574,6.4,7,2,4,3,15,10,5,10.4,10.9,-0.5,18,GER
7cd6badb,31,2727,30.3,31,27,0,0,42,43,-1,46.7,43.7,3.0,18,GER
7d3e7da6,29,2610,29.0,29,29,0,3,84,26,58,64.8,29.2,35.6,18,GER
7d841904,3,19,0.2,0,0,3,5,0,0,0,0.0,0.1,-0.1,18,GER
7e689867,24,1489,16.5,19,2,5,5,20,23,-3,24.4,21.8,2.5,18,GER
7f609bfc,9,756,8.4,9,6,0,3,13,11,2,12.4,10.2,2.1,18,GER
7f73bdf4,1,90,1.0,1,1,0,2,4,1,3,1.8,2.1,-0.2,18,GER
7f97771d,22,1609,17.9,18,13,4,7,44,13,31,36.8,15.8,21.0,18,GER
7fe12375,2,180,2.0,2,2,0,31,2,4,-2,0.9,3.0,-2.1,18,GER
80f36c88,25,1515,16.8,16,13,9,8,46,17,29,39.9,17.8,22.1,18,GER
815c314f,12,901,10.0,11,9,1,6,14,18,-4,11.9,14.1,-2.1,18,GER
81aeb1dd,5,165,1.8,1,0,4,10,1,1,0,1.5,1.9,-0.4,18,GER
821233cc,4,271,3.0,3,3,1,5,4,5,-1,6.0,5.2,0.8,18,GER
826e8b63,33,2959,32.9,33,32,0,0,43,44,-1,44.5,39.8,4.7,18,GER
8279c033,7,320,3.6,3,1,4,12,0,5,-5,2.3,5.4,-3.2,18,GER
834d0be5,23,1550,17.2,17,12,6,3,27,21,6,32.8,19.8,13.0,18,GER
83e0eeb4,3,270,3.0,3,3,0,30,5,9,-4,5.3,7.4,-2.2,18,GER
8494acc4,21,1289,14.3,14,11,7,7,21,25,-4,23.3,22.0,1.3,18,GER
849c826a,18,1039,11.5,13,4,5,4,22,18,4,24.1,13.0,11.0,18,GER
857a5abe,25,2177,24.2,24,24,1,2,26,33,-7,24.3,31.7,-7.4,18,GER
8593f88c,34,3060,34.0,34,34,0,0,32,56,-24,39.6,46.1,-6.6,18,GER
861e0116,2,33,0.4,0,0,2,6,0,0,0,0.0,0.5,-0.5,18,GER
863ff1ee,30,2115,23.5,24,18,6,3,26,40,-14,28.7,36.6,-7.9,18,GER
86b30561,2,78,0.9,1,0,1,5,1,1,0,0.2,2.4,-2.2,18,GER
86e119e0,29,2454,27.3,28,26,1,1,30,37,-7,28.3,41.5,-13.2,18,GER
8778c910,3,270,3.0,3,3,0,0,6,2,4,7.2,1.7,5.5,18,GER
88d4144a,11,424,4.7,5,2,6,6,4,3,1,5.8,4.4,1.4,18,GER
88e357ef,22,1507,16.7,20,6,2,0,37,20,17,25.9,20.8,5.0,18,GER
8954fddc,2,52,0.6,0,0,2,1,1,1,0,0.1,0.1,0.0,18,GER
89565ac5,18,1491,16.6,17,14,1,1,24,32,-8,27.7,22.5,5.2,18,GER
896c126c,5,450,5.0,5,5,0,6,5,10,-5,6.7,13.6,-6.8,18,GER
89ac64a6,11,904,10.0,10,10,1,4,15,15,0,17.8,14.6,3.1,18,GER
8b6e0db2,7,463,5.1,5,3,2,17,6,5,1,9.7,6.7,3.0,18,GER
8be4fd6a,14,669,7.4,6,2,8,1,10,12,-2,7.0,11.0,-4.0,18,GER
8c90fd7a,12,287,3.2,3,2,9,11,2,5,-3,3.9,3.5,0.4,18,GER
8d78e732,30,2172,24.1,24,20,6,3,64,21,43,58.5,21.6,37.0,18,GER
8e235926,32,2527,28.1,30,19,2,1,37,39,-2,38.3,32.6,5.7,18,GER
8e58987d,19,1036,11.5,12,7,7,10,13,14,-1,13.5,14.0,-0.5,18,GER
8e92be30,5,119,1.3,1,0,4,15,2,0,2,3.7,0.9,2.8,18,GER
8ed9b33a,11,951,10.6,11,9,0,0,10,12,-2,9.7,13.8,-4.0,18,GER
8f0f2230,22,855,9.5,8,5,14,5,14,9,5,13.8,10.7,3.1,18,GER
8ff2354e,15,1178,13.1,14,12,1,1,21,21,0,20.8,18.3,2.4,18,GER
9050ddc4,23,1664,18.5,19,11,4,5,21,22,-1,22.5,20.8,1.7,18,GER
923f4dda,15,851,9.5,8,6,7,2,10,20,-10,13.9,20.0,-6.1,18,GER
92948149,19,1336,14.8,14,10,5,3,10,26,-16,19.4,28.8,-9.4,18,GER
92ffb8f9,4,213,2.4,3,1,1,5,0,3,-3,1.2,2.7,-1.5,18,GER
931b7c30,29,2610,29.0,29,28,0,1,25,43,-18,32.8,45.1,-12.4,18,GER
94302c52,5,450,5.0,5,5,0,1,7,11,-4,5.9,9.0,-3.1,18,GER
94c18565,30,1712,19.0,19,4,11,3,18,21,-3,19.4,22.1,-2.7,18,GER
95173427,2,180,2.0,2,2,0,2,7,1,6,3.4,2.4,1.0,18,GER
97655ccd,31,2614,29.0,30,25,1,1,29,38,-9,29.1,42.8,-13.7,18,GER
97bfa797,25,1266,14.1,14,2,11,6,35,19,16,22.9,18.9,4.0,18,GER
9853983f,24,1609,17.9,18,6,6,1,14,26,-12,18.4,25.9,-7.5,18,GER
99b7584f,30,1888,21.0,21,12,9,2,25,33,-8,26.3,38.2,-11.9,18,GER
99be8fb5,11,205,2.3,2,0,9,6,0,5,-5,2.2,3.3,-1.1,18,GER
99d6044d,1,50,0.6,1,0,0,3,0,2,-2,0.2,1.2,-0.9,18,GER
99de6b6f,27,2315,25.7,27,23,0,0,49,34,15,35.4,35.9,-0.6,18,GER
99f7e9aa,25,1941,21.6,21,19,4,6,20,36,-16,25.7,27.4,-1.7,18,GER
9a2e0ccc,21,1370,15.2,15,6,6,1,23,27,-4,24.0,19.4,4.5,18,GER
9a493fb7,12,789,8.8,8,5,4,4,13,22,-9,10.2,15.0,-4.8,18,GER
9ab16552,24,2090,23.2,23,22,1,1,32,32,0,31.3,29.6,1.8,18,GER
9ab48bde,25,1652,18.4,20,11,5,7,22,25,-3,19.5,23.1,-3.6,18,GER
9b285700,13,449,5.0,5,1,8,4,5,6,-1,8.6,8.7,-0.1,18,GER
9b88e120,16,956,10.6,12,9,4,18,6,16,-10,9.8,13.2,-3.4,18,GER
9d12e142,33,2969,33.0,33,32,0,0,60,43,17,63.6,41.1,22.5,18,GER
9efa1d25,23,1601,17.8,19,9,4,3,35,26,9,35.7,23.9,11.8,18,GER
9f381d8b,18,957,10.6,9,5,9,1,8,26,-18,14.4,21.7,-7.3,18,GER
9f979eb2,22,1890,21.0,21,20,1,3,25,45,-20,24.4,40.3,-15.9,18,GER
9fb640a8,11,802,8.9,10,5,1,6,7,15,-8,8.1,13.5,-5.3,18,GER
9fec8860,29,2532,28.1,29,26,0,0,33,34,-1,33.1,37.2,-4.1,18,GER
a0606ae8,34,3060,34.0,34,34,0,0,36,36,0,40.3,43.5,-3.1,18,GER
a0e209bc,11,737,8.2,10,3,1,6,10,17,-7,7.5,12.3,-4.8,18,GER
a165a577,1,90,1.0,1,1,0,30,0,4,-4,0.5,3.5,-3.0,18,GER
a167537f,34,2326,25.8,26,12,8,0,51,34,17,41.9,29.6,12.3,18,GER
a2a85828,9,314,3.5,2,0,7,8,3,3,0,2.3,3.9,-1.5,18,GER
a2e7de6f,30,2570,28.6,29,26,1,0,19,46,-27,30.2,47.9,-17.7,18,GER
a3ddb1b9,31,2177,24.2,24,17,7,0,52,33,19,37.6,35.8,1.8,18,GER
a4e14205,10,370,4.1,4,0,6,12,3,9,-6,3.9,10.2,-6.2,18,GER
a4effc55,11,657,7.3,6,3,5,11,18,10,8,14.4,8.4,6.0,18,GER
a4f94a0d,27,2412,26.8,27,25,0,0,29,26,3,31.9,34.2,-2.4,18,GER
a53b661f,30,2140,23.8,20,12,10,0,38,37,1,37.0,34.4,2.5,18,GER
a572e291,20,779,8.7,7,5,13,10,9,13,-4,10.0,13.0,-2.9,18,GER
a5ae8f8e,30,2655,29.5,30,29,0,2,32,35,-3,33.1,38.4,-5.2,18,GER
a5d77c4e,1,10,0.1,0,0,1,11,0,1,-1,0.0,0.3,-0.3,18,GER
a5ec3ede,15,1287,14.3,14,13,1,8,18,21,-3,16.1,20.1,-4.0,18,GER
a63a995f,23,1583,17.6,18,15,5,8,17,24,-7,19.8,21.9,-2.1,18,GER
a7813ac4,29,2500,27.8,28,25,1,3,34,42,-8,29.6,37.5,-7.9,18,GER
a93b6f4e,3,270,3.0,3,3,0,3,2,3,-1,1.8,3.8,-2.0,18,GER
a96e5dc0,18,1391,15.5,15,14,3,4,29,17,12,30.4,21.3,9.100000000000001,18,GER
aad48be9,26,2210,24.6,25,24,1,3,27,26,1,26.7,34.1,-7.3,18,GER
ab700320,17,1223,13.6,14,7,3,4,19,17,2,21.0,18.4,2.6,18,GER
abb42ce6,20,1515,16.8,17,10,3,8,11,35,-24,20.2,36.3,-16.2,18,GER
acc7b7ec,14,1121,12.5,14,6,0,1,10,12,-2,13.5,13.6,-0.1,18,GER
ad00b1a8,2,82,0.9,1,0,1,10,0,1,-1,1.2,0.9,0.3,18,GER
ad3389d5,34,3060,34.0,34,34,0,0,45,45,0,42.2,41.7,0.5,18,GER
aeda1f69,28,1981,22.0,25,12,3,1,28,33,-5,26.8,35.2,-8.4,18,GER
afb0c500,1,45,0.5,0,0,1,33,0,0,0,0.6,0.4,0.2,18,GER
b1823b08,7,75,0.8,0,0,7,5,1,1,0,1.2,1.0,0.2,18,GER
b1cd37e6,30,2438,27.1,27,21,3,0,26,38,-12,31.6,42.8,-11.2,18,GER
b3325a30,25,1703,18.9,16,11,9,4,20,30,-10,20.3,29.4,-9.1,18,GER
b3b7f5a6,24,1892,21.0,22,18,2,2,27,30,-3,25.5,27.1,-1.6,18,GER
b48215cd,16,617,6.9,6,1,10,13,11,11,0,7.8,9.6,-1.8,18,GER
b500b384,17,990,11.0,11,6,6,8,18,23,-5,14.1,15.299999999999999,-1.0999999999999999,18,GER
b5920350,10,336,3.7,3,0,7,8,4,5,-1,4.8,5.9,-1.2,18,GER
b5f63410,21,902,10.0,9,1,12,7,7,14,-7,10.0,11.5,-1.4,18,GER
b682dcf6,30,2373,26.4,28,23,2,2,52,37,15,49.7,33.0,16.8,18,GER
b69261a0,28,2457,27.3,28,25,0,0,43,44,-1,40.6,42.7,-2.1,18,GER
b6a6e0a7,20,1431,15.9,17,6,3,14,24,23,1,17.3,26.6,-9.3,18,GER
b742cc0d,12,807,9.0,9,8,3,3,15,16,-1,15.6,11.2,4.4,18,GER
b825a650,27,2049,22.7,22,18,5,4,41,37,4,35.9,31.2,4.7,18,GER
b82880c6,27,2211,24.6,25,22,2,0,32,32,0,28.4,30.8,-2.5,18,GER
b883006f,1,18,0.2,0,0,1,0,0,1,-1,0.6,0.3,0.3,18,GER
b93b7882,26,1853,20.6,19,15,7,3,23,27,-4,21.7,25.7,-4.0,18,GER
b9ebc83e,2,46,0.5,0,0,2,10,0,0,0,0.3,0.7,-0.4,18,GER
ba115a40,31,2347,26.1,26,16,5,3,30,34,-4,29.7,32.2,-2.4,18,GER
bb25c778,3,270,3.0,3,3,0,28,4,3,1,3.0,5.1,-2.1,18,GER
bbb496b5,13,441,4.9,4,3,9,9,8,4,4,5.5,6.3,-0.8,18,GER
bcb2ccd8,33,2970,33.0,33,33,0,1,57,52,5,50.7,45.5,5.2,18,GER
bd142efb,28,2427,27.0,27,26,1,1,48,34,14,46.2,30.9,15.3,18,GER
bd7d2e6d,29,2610,29.0,29,29,0,0,33,29,4,35.2,39.3,-4.1,18,GER
beb882a8,33,2692,29.9,31,21,2,1,36,37,-1,33.9,39.4,-5.5,18,GER
bee0bab1,24,1146,12.7,13,6,11,10,17,24,-7,21.2,16.6,4.6,18,GER
c0a0c18f,2,36,0.4,0,0,2,5,1,1,0,0.5,0.5,0.0,18,GER
c0dc9fc7,12,276,3.1,2,0,10,4,8,3,5,4.9,4.5,0.4,18,GER
c18d22f5,17,1375,15.3,17,12,0,17,18,21,-3,15.4,21.0,-5.6,18,GER
c1b7847c,22,1337,14.9,14,11,8,6,27,19,8,20.9,19.2,1.8,18,GER
c2009df3,20,1759,19.5,20,18,0,0,25,44,-19,24.2,35.1,-10.9,18,GER
c21fb312,18,850,9.4,8,3,10,2,11,10,1,10.0,15.0,-5.0,18,GER
c311243f,29,1954,21.7,22,14,7,3,21,25,-4,24.9,28.6,-3.7,18,GER
c3fd9887,27,1452,16.1,18,5,9,4,25,23,2,19.2,18.5,0.7,18,GER
c419e035,8,82,0.9,0,0,8,5,0,3,-3,1.1,3.1,-2.0,18,GER
c50281a0,21,1595,17.7,20,10,1,2,37,20,17,31.2,16.8,14.4,18,GER
c50e5bba,27,2378,26.4,26,25,1,3,22,43,-21,28.5,44.7,-16.1,18,GER
c5fd13e9,26,2020,22.4,22,20,4,3,49,26,23,50.7,22.9,27.8,18,GER
c6637acf,33,2855,31.7,32,28,1,0,42,44,-2,43.2,38.3,5.0,18,GER
c70b221c,2,81,0.9,1,0,1,2,0,2,-2,0.9,2.3,-1.3,18,GER
c8e25f78,28,2289,25.4,26,23,2,6,24,40,-16,30.1,43.4,-13.3,18,GER
c952f633,1,90,1.0,1,1,0,9,0,0,0,0.5,1.0,-0.5,18,GER
ca618d23,14,906,10.1,12,1,2,2,9,14,-5,9.8,13.2,-3.4,18,GER
ca8033cb,26,2190,24.3,25,21,1,5,40,38,2,34.1,34.0,0.0,18,GER
cbac6ec9,5,450,5.0,5,5,0,9,3,7,-4,3.3,6.6,-3.3,18,GER
cc58c4ea,6,228,2.5,3,2,3,15,3,3,0,3.3,2.9,0.4,18,GER
cc86b9a3,26,1982,22.0,21,17,5,0,37,21,16,30.6,24.2,6.4,18,GER
cd82452e,23,1358,15.1,14,11,9,2,8,25,-17,13.9,22.9,-9.0,18,GER
ce218223,19,1306,14.5,13,8,6,5,14,26,-12,17.9,24.3,-6.4,18,GER
cf01fe3a,5,78,0.9,0,0,5,9,2,2,0,1.5,1.8,-0.3,18,GER
d003e213,27,1851,20.6,19,18,8,5,48,16,32,47.8,17.7,30.1,18,GER
d0421d25,18,1308,14.5,16,11,2,13,11,27,-16,18.0,21.9,-3.8,18,GER
d1273f09,33,2917,32.4,32,31,1,0,51,35,16,45.0,38.8,6.2,18,GER
d1661819,29,2320,25.8,26,24,3,3,40,27,13,36.9,30.0,6.9,18,GER
d2416c2e,30,1664,18.5,18,10,12,3,23,30,-7,27.1,25.1,2.1,18,GER
d248cd8f,28,2268,25.2,25,23,3,1,45,36,9,37.9,33.7,4.1,18,GER
d3096421,30,2237,24.9,26,11,4,1,27,31,-4,24.2,37.2,-13.0,18,GER
d45472b2,1,58,0.6,1,0,0,1,1,1,0,0.7,0.9,-0.2,18,GER
d459281d,10,703,7.8,7,7,3,10,10,17,-7,10.1,14.5,-4.4,18,GER
d4a2533d,27,1595,17.799999999999997,17,5,10,5,16,22,-6,20.3,24.3,-4.2,18,GER
d4d0a9ad,22,1612,17.9,19,13,3,4,15,26,-11,17.5,25.7,-8.2,18,GER
d571df78,7,99,1.1,0,0,7,9,1,0,1,1.8,2.6,-0.8,18,GER
d5dd5f1f,16,1416,15.7,16,14,0,0,39,21,18,35.4,17.5,18.0,18,GER
d6862409,10,697,7.7,9,3,1,0,5,14,-9,9.1,11.6,-2.5,18,GER
d6f6ce93,10,900,10.0,10,10,0,22,11,15,-4,13.7,15.6,-1.9,18,GER
d8f5dc3d,6,165,1.8,2,0,4,7,2,4,-2,2.3,3.3,-1.0,18,GER
d9a5d930,27,1562,17.4,18,4,9,6,28,18,10,25.6,19.6,6.0,18,GER
da59a197,13,592,6.6,6,2,7,10,2,12,-10,5.0,8.6,-3.6,18,GER
db401046,34,3060,34.0,34,34,0,0,36,48,-12,34.2,52.0,-17.8,18,GER
db4ed67b,23,1146,12.7,11,6,12,3,28,14,14,28.9,16.2,12.7,18,GER
db7161ed,2,27,0.3,0,0,2,4,2,0,2,1.2,0.1,1.1,18,GER
dba67bc4,24,1633,18.1,17,8,7,1,24,18,6,24.0,25.1,-1.1,18,GER
dbf053da,12,690,7.7,7,7,5,3,12,10,2,15.0,7.5,7.5,18,GER
dc29b608,1,90,1.0,1,1,0,33,0,1,-1,1.1,1.2,0.0,18,GER
dc3fa3b5,30,2284,25.4,25,20,5,2,46,39,7,39.2,34.4,4.8,18,GER
dc62fbee,22,1613,17.9,17,11,5,1,16,35,-19,22.2,34.5,-12.4,18,GER
dd669209,16,659,7.3,6,3,10,1,8,12,-4,6.3,13.4,-7.1,18,GER
de164de6,6,457,5.1,6,4,0,1,4,5,-1,4.2,6.7,-2.5,18,GER
de1a2530,1,15,0.2,0,0,1,0,0,0,0,0.1,0.1,0.1,18,GER
debc2f28,22,1102,12.2,13,1,9,7,14,17,-3,14.5,16.5,-1.9,18,GER
df8e7b62,20,1147,12.8,16,2,4,5,21,8,13,18.5,12.9,5.6,18,GER
dfb6490a,23,1124,12.5,12,3,11,5,16,12,4,17.2,15.1,2.1,18,GER
dfc85b89,1,11,0.1,0,0,1,3,0,0,0,0.0,0.0,0.0,18,GER
e199d5b0,3,77,0.9,1,0,2,0,0,2,-2,0.6,1.2,-0.5,18,GER
e26c4233,19,1145,12.7,12,6,7,10,20,21,-1,18.3,16.9,1.4,18,GER
e26fcca3,29,2381,26.5,27,18,2,0,26,22,4,30.4,31.1,-0.7,18,GER
e27da244,9,727,8.1,9,7,0,2,16,9,7,11.9,10.1,1.8,18,GER
e280527c,22,1790,19.9,21,18,1,0,29,28,1,31.2,25.3,5.9,18,GER
e33c06cf,27,1926,21.4,20,20,7,7,55,20,35,44.2,22.1,22.1,18,GER
e4086af3,1,34,0.4,0,0,1,1,0,0,0,0.5,0.4,0.1,18,GER
e5a35ae9,20,794,8.8,5,1,15,4,8,15,-7,12.8,13.9,-1.1,18,GER
e5d652c1,1,73,0.8,1,0,0,2,0,1,-1,0.1,1.5,-1.4,18,GER
e5d85da8,1,5,0.1,0,0,1,2,2,0,2,1.7,0.9,0.8,18,GER
e5f63987,23,1523,16.9,17,5,6,1,26,16,10,21.6,19.6,2.0,18,GER
e665a2db,7,422,4.7,3,3,4,3,4,14,-10,6.1,7.6,-1.6,18,GER
e6c15f6e,5,412,4.6,5,3,0,11,6,6,0,4.6,10.0,-5.4,18,GER
e6c43eec,29,2404,26.7,27,21,2,1,29,40,-11,28.4,42.5,-14.1,18,GER
e7d22eae,16,702,7.8,7,0,9,8,8,7,1,8.2,8.4,-0.1,18,GER
e7d59f4f,31,2043,22.7,23,8,8,2,35,24,11,32.3,27.1,5.2,18,GER
e82d2807,8,232,2.6,2,2,6,3,2,6,-4,3.3,6.2,-2.9,18,GER
e8385ec4,10,265,2.9,2,0,8,12,4,9,-5,4.8,8.7,-3.9,18,GER
e87ad81a,9,327,3.6,4,3,5,17,2,7,-5,2.9,6.8,-3.9,18,GER
ea003d07,7,116,1.3,0,0,7,14,1,2,-1,1.8,1.7,0.0,18,GER
ea6bc03a,26,1919,21.3,21,20,5,5,21,33,-12,23.4,26.5,-3.1,18,GER
eafac393,11,774,8.6,9,4,2,4,9,14,-5,10.0,12.7,-2.7,18,GER
eb61713c,2,29,0.3,0,0,2,5,1,1,0,0.5,0.5,0.0,18,GER
eba42d2b,24,1727,19.2,21,13,3,6,31,23,8,25.8,24.6,1.2,18,GER
ecab64a0,28,2183,24.3,24,21,4,6,30,35,-5,25.0,33.3,-8.3,18,GER
ecbb3fdf,18,1236,13.7,11,7,7,3,17,23,-6,23.6,20.9,2.7,18,GER
ee57792b,8,595,6.6,8,3,0,0,10,12,-2,11.2,11.5,-0.3,18,GER
f04f45a2,1,19,0.2,0,0,1,2,0,0,0,0.1,0.1,0.0,18,GER
f0797d57,18,1440,16.0,16,12,2,12,15,27,-12,15.8,29.0,-13.3,18,GER
f24ea523,7,211,2.3,2,0,5,2,2,3,-1,1.8,4.2,-2.4,18,GER
f25c8e3a,27,1962,21.8,23,10,4,1,39,35,4,33.2,31.5,1.7,18,GER
f261abcb,29,2538,28.2,29,23,0,1,38,43,-5,39.1,35.4,3.7,18,GER
f26834c7,8,256,2.8,2,2,6,6,2,4,-2,3.3,3.8,-0.5,18,GER
f2e3b81c,5,208,2.3,1,0,4,8,3,2,1,3.1,1.9,1.2,18,GER
f35430a4,24,1989,22.1,22,19,2,0,36,23,13,29.3,27.2,2.1,18,GER
f3722c97,31,2242,24.9,24,16,7,2,32,35,-3,26.1,40.1,-14.0,18,GER
f3cccffe,25,2106,23.4,24,22,1,2,29,23,6,27.8,30.4,-2.6,18,GER
f4081572,18,1225,13.6,14,10,4,16,28,21,7,25.3,15.9,9.4,18,GER
f4ec4fd0,31,2357,26.2,27,19,4,0,41,30,11,34.0,29.9,4.1,18,GER
f503ea63,19,1108,12.3,12,3,7,0,12,16,-4,13.7,16.5,-2.7,18,GER
f521b80a,34,3060,34.0,34,34,0,0,47,52,-5,51.1,52.0,-0.8,18,GER
f61c7c4e,20,1203,13.4,15,2,5,5,35,14,21,31.3,11.2,20.1,18,GER
f69fba57,25,1896,21.1,23,11,2,3,18,40,-22,24.9,36.7,-11.8,18,GER
f71890f5,14,1260,14.0,14,14,0,2,16,18,-2,16.1,20.0,-3.9,18,GER
f7aa75bd,33,2970,33.0,33,33,0,0,43,46,-3,38.8,43.2,-4.4,18,GER
f820504e,10,599,6.7,6,4,4,5,8,10,-2,13.6,7.8,5.7,18,GER
f86ad3f5,10,645,7.2,6,5,4,10,8,9,-1,8.0,10.0,-2.1999999999999997,18,GER
f86cabbd,12,663,7.4,7,5,5,9,10,10,0,8.6,11.2,-2.6,18,GER
f93e6e94,32,2244,24.9,24,19,8,0,27,40,-13,29.0,33.8,-4.8,18,GER
f9446dcd,29,2453,27.3,28,25,1,0,33,33,0,31.1,37.7,-6.5,18,GER
f956479d,4,34,0.4,0,0,4,5,0,0,0,0.7,0.6,0.1,18,GER
f972644c,12,644,7.2,6,2,6,2,10,10,0,7.5,9.6,-2.1,18,GER
f9acca3a,26,2115,23.5,26,19,0,1,40,29,11,37.5,25.1,12.4,18,GER
f9e7c4ac,22,1814,20.2,22,10,0,1,29,23,6,28.5,21.0,7.4,18,GER
fa274d97,27,1780,19.8,19,17,8,3,44,27,17,36.4,23.6,12.8,18,GER
fa661778,28,2363,26.3,27,22,1,3,37,37,0,32.6,32.4,0.2,18,GER
fb2a63bb,9,261,2.9,2,0,7,18,7,5,2,2.7,5.3,-2.6,18,GER
fb377d11,1,21,0.2,0,0,1,2,0,2,-2,0.0,2.4,-2.4,18,GER
fb59286d,25,1459,16.2,17,7,8,4,17,22,-5,23.5,29.1,-5.6,18,GER
fbbc8e15,7,118,1.3,0,0,7,2,3,3,0,2.3,2.0,0.3,18,GER
fbffc4b1,11,990,11.0,11,11,0,4,7,18,-11,9.4,17.6,-8.2,18,GER
fc62f087,27,2415,26.8,27,26,0,0,29,40,-11,27.8,38.5,-10.7,18,GER
fc93fdf1,7,184,2.0,2,0,5,4,4,2,2,3.5,3.2,0.2,18,GER
fdd5d298,1,90,1.0,1,1,0,4,0,3,-3,0.4,1.0,-0.6,18,GER
fe2db476,24,2138,23.8,24,23,0,0,45,25,20,45.9,26.8,19.1,18,GER
fe641c1a,32,2796,31.1,31,30,1,0,33,36,-3,34.4,40.7,-6.3,18,GER
fe888e39,2,38,0.4,0,0,2,5,0,1,-1,0.3,1.9,-1.5,18,GER
fed7cb61,30,2144,23.8,22,18,8,3,38,31,7,39.8,27.7,12.1,18,GER
ff182fdc,26,1350,15.0,13,5,13,4,15,19,-4,20.7,19.6,1.1,18,GER
ffbbc83b,25,1888,21.0,21,16,4,7,41,29,12,35.3,28.7,6.6,18,GER
00459419,31,2313,25.7,28,14,3,1,34,48,-14,25.4,36.5,-11.1,18,ENG
008a6e6d,19,1451,16.1,16,16,3,11,31,15,16,30.6,12.9,17.7,18,ENG
00963611,3,195,2.2,3,2,0,0,6,3,3,3.2,2.1,1.1,18,ENG
01226327,35,3135,34.8,35,32,0,0,34,49,-15,37.0,39.1,-2.0,18,ENG
02b29014,37,3324,36.9,37,36,0,0,44,63,-19,43.5,50.5,-7.0,18,ENG
032f894e,12,702,7.8,9,4,3,5,3,10,-7,4.8,10.1,-5.3,18,ENG
0356cf4f,3,39,0.4,0,0,3,7,0,2,-2,0.6,0.8,-0.2,18,ENG
0420d84f,12,1035,11.5,12,11,0,0,14,12,2,13.4,12.4,1.0,18,ENG
0442183b,3,174,1.9,2,1,1,2,0,1,-1,1.7,1.6,0.2,18,ENG
07802f7f,8,267,3.0,3,0,5,9,3,0,3,5.6,1.0,4.6,18,ENG
08aa17d0,31,2740,30.4,31,28,0,1,57,22,35,45.4,33.0,12.4,18,ENG
099e666f,19,1590,17.7,17,17,2,5,27,31,-4,19.3,29.7,-10.4,18,ENG
0c61c77c,1,16,0.2,0,0,1,4,0,1,-1,0.4,0.5,-0.1,18,ENG
0cc5f4a5,2,16,0.2,0,0,2,2,0,0,0,0.3,0.0,0.3,18,ENG
0d267745,34,2967,33.0,33,31,1,1,90,25,65,68.9,21.4,47.5,18,ENG
0db5d2c8,38,3420,38.0,38,38,0,0,28,58,-30,31.3,48.5,-17.2,18,ENG
0e6bc38c,30,2314,25.7,26,18,4,1,28,45,-17,25.3,36.7,-11.4,18,ENG
0ef89a37,14,1109,12.3,13,5,1,1,29,14,15,23.2,11.5,11.7,18,ENG
10072610,3,226,2.5,2,2,1,35,8,1,7,3.9,1.7,2.2,18,ENG
101da2b5,34,2881,32.0,33,28,1,0,89,24,65,66.2,19.6,46.5,18,ENG
10b9fa99,1,11,0.1,0,0,1,11,0,1,-1,0.0,0.2,-0.2,18,ENG
111c3236,22,1741,19.3,21,15,1,3,55,17,38,42.4,11.4,31.0,18,ENG
1148323a,2,180,2.0,2,2,0,8,7,6,1,3.5,3.2,0.4,18,ENG
119b9a8e,9,806,9.0,9,8,0,5,28,5,23,18.0,4.0,14.0,18,ENG
11b9265b,16,1266,14.1,14,14,2,8,28,19,9,25.9,15.6,10.3,18,ENG
129af0db,31,2061,22.9,24,12,7,0,38,19,19,34.8,19.2,15.7,18,ENG
12aa7661,28,2382,26.5,26,24,2,4,30,47,-17,32.6,36.7,-4.1,18,ENG
15ea812b,31,2790,31.0,31,31,0,0,31,30,1,26.7,40.5,-13.7,18,ENG
15f3ec41,2,29,0.3,0,0,2,2,0,1,-1,0.7,0.2,0.5,18,ENG
15fd5593,7,251,2.8,3,0,4,5,3,6,-3,2.8,2.4,0.4,18,ENG
16380240,26,2163,24.0,24,21,2,1,48,36,12,44.7,32.6,12.2,18,ENG
1695c659,4,31,0.3,0,0,4,9,1,2,-1,1.9,1.5,0.4,18,ENG
16ceb862,29,1001,11.1,7,3,22,2,19,11,8,20.0,10.3,9.8,18,ENG
1840e36d,35,3150,35.0,35,35,0,0,56,34,22,50.1,30.9,19.3,18,ENG
184e4970,27,2219,24.7,25,19,2,8,26,49,-23,25.2,39.5,-14.2,18,ENG
189cee7b,28,1548,17.2,16,9,12,3,21,36,-15,16.1,27.7,-11.6,18,ENG
18b896d6,27,2338,26.0,25,25,2,9,46,22,24,37.8,19.5,18.3,18,ENG
18e96f64,5,235,2.6,2,1,3,10,2,4,-2,2.3,5.6,-3.4,18,ENG
1931bde9,33,2137,23.7,26,10,7,1,16,36,-20,18.3,28.5,-10.2,18,ENG
199ff86e,1,26,0.3,0,0,1,0,0,0,0,1.5,0.0,1.4,18,ENG
19b8b0b9,26,1280,14.2,13,8,13,5,13,23,-10,14.3,21.4,-7.1,18,ENG
19ba6c6d,28,1855,20.6,21,12,7,6,14,32,-18,18.7,24.1,-5.4,18,ENG
1a160ea3,20,1525,16.9,17,14,3,8,15,31,-16,16.9,28.2,-11.4,18,ENG
1a2935f6,29,2127,23.6,24,22,5,5,54,24,30,42.8,22.0,20.8,18,ENG
1a4ef233,8,487,5.4,6,4,2,11,7,7,0,6.8,6.9,-0.1,18,ENG
1ae30132,13,1125,12.5,13,12,0,20,8,13,-5,10.2,18.3,-8.1,18,ENG
1b780599,6,481,5.3,6,4,0,6,6,15,-9,5.5,12.0,-6.5,18,ENG
1b7ec703,15,549,6.1,7,1,8,6,9,8,1,11.5,5.6,5.8999999999999995,18,ENG
1bebde9d,1,90,1.0,1,1,0,36,1,1,0,1.2,0.8,0.4,18,ENG
1bf811d4,5,248,2.8,2,1,3,7,4,7,-3,2.4,4.1,-1.7,18,ENG
1c7012b8,26,1430,15.9,15,12,11,10,24,29,-5,15.8,24.8,-9.0,18,ENG
1cb49278,27,2086,23.2,23,18,4,9,37,23,14,34.3,19.3,15.0,18,ENG
1d387eee,15,429,4.8,4,1,11,12,1,11,-10,3.4,10.1,-6.7,18,ENG
1d6ac165,30,998,11.1,7,4,23,7,12,16,-4,10.8,14.3,-3.5,18,ENG
1d8c99b0,25,1868,20.8,21,16,4,0,16,29,-13,17.0,30.2,-13.2,18,ENG
1e0b6a73,32,2705,30.1,31,28,1,0,36,47,-11,32.6,48.0,-15.4,18,ENG
1e26e376,1,90,1.0,1,1,0,29,1,0,1,0.4,0.6,-0.2,18,ENG
1ecb65be,20,1221,13.600000000000001,13,11,7,10,19,17,2,16.1,16.700000000000003,-0.6000000000000001,18,ENG
1ef37668,31,2718,30.2,30,27,1,1,29,50,-21,28.7,47.2,-18.6,18,ENG
1f9a3a04,13,1049,11.7,11,11,2,1,7,14,-7,8.9,15.6,-6.7,18,ENG
20b104bc,27,2071,23.0,22,20,5,1,24,38,-14,21.9,35.9,-14.0,18,ENG
210d9ecb,2,96,1.1,1,1,1,8,0,5,-5,0.4,3.1,-2.7,18,ENG
21512407,24,1914,21.3,21,18,3,11,37,21,16,33.2,22.4,10.7,18,ENG
21a66e33,4,207,2.3,2,1,2,1,2,1,1,2.1,2.4,-0.3,18,ENG
21a66f6a,37,3076,34.2,35,26,2,0,65,34,31,57.6,29.8,27.7,18,ENG
22551915,21,1830,20.3,20,19,1,14,20,30,-10,20.3,30.3,-10.1,18,ENG
2475dcc6,36,2791,31.0,34,11,2,2,32,43,-11,33.6,36.9,-3.3,18,ENG
24fae784,4,268,3.0,3,2,1,5,0,4,-4,2.3,4.0,-1.7,18,ENG
25b166d0,15,494,5.5,3,1,12,11,4,13,-9,6.9,12.5,-5.6,18,ENG
25f50295,24,1944,21.6,24,16,0,13,17,27,-10,18.4,31.2,-12.8,18,ENG
2649ff32,12,527,5.9,5,3,7,8,10,7,3,9.3,5.1,4.2,18,ENG
26679cdf,19,745,8.3,8,3,11,7,3,14,-11,6.5,14.7,-8.2,18,ENG
2691c772,36,2165,24.1,21,14,15,1,26,23,3,23.0,32.6,-9.6,18,ENG
26f6dca8,27,2042,22.7,23,14,4,0,30,44,-14,22.2,34.4,-12.2,18,ENG
27d7453c,16,849,9.4,9,3,7,6,6,8,-2,6.8,11.3,-4.5,18,ENG
282f75f3,38,3420,38.0,38,38,0,0,34,54,-20,37.0,50.8,-13.8,18,ENG
285a3d44,27,2371,26.3,27,26,0,2,26,40,-14,25.7,41.1,-15.5,18,ENG
29733c72,28,1922,21.4,23,7,5,8,34,10,24,33.4,16.6,16.8,18,ENG
2973d8ff,12,360,4.0,3,1,9,9,11,7,4,4.8,3.6,1.2,18,ENG
2acd49b9,32,1386,15.4,15,6,17,5,27,18,9,25.1,12.5,12.6,18,ENG
2afc7272,29,2237,24.9,25,20,4,6,32,42,-10,28.0,40.1,-12.1,18,ENG
2b114be3,32,2419,26.9,27,18,5,2,72,22,50,53.2,17.5,35.6,18,ENG
2b471f99,25,1720,19.1,20,12,5,6,18,31,-13,19.4,26.5,-7.1,18,ENG
2b622f01,6,210,2.3,2,0,4,6,6,6,0,3.9,3.3,0.5,18,ENG
2b91cf8e,20,1746,19.4,19,19,1,14,21,30,-9,22.5,30.0,-7.5,18,ENG
2baec6ce,1,1,0.0,0,0,1,3,0,0,0,0.0,0.0,0.0,18,ENG
2c0f8e9e,31,2546,28.299999999999997,29,18,2,1,48,32,16,44.6,30.5,14.2,18,ENG
2ce2508a,36,3080,34.2,35,32,1,1,42,52,-10,46.8,45.8,1.0,18,ENG
2e4f5f03,22,1940,21.6,22,19,0,5,53,18,35,43.3,15.9,27.4,18,ENG
2f4c5a52,13,960,10.7,11,7,2,11,10,13,-3,8.7,15.2,-6.4,18,ENG
2f72f79e,36,3149,35.0,36,31,0,0,26,50,-24,28.4,53.3,-24.9,18,ENG
2f7acede,16,774,8.6,9,5,7,5,16,9,7,12.1,8.9,3.3,18,ENG
2f90f6b8,32,1775,19.7,16,13,16,5,40,25,15,36.0,19.4,16.6,18,ENG
2ff964a0,29,1911,21.200000000000003,22,8,7,0,32,30,2,25.1,29.6,-4.5,18,ENG
31dce0c8,1,1,0.0,0,0,1,2,0,0,0,0.0,0.0,0.0,18,ENG
3201b03d,28,2306,25.6,27,20,1,2,40,41,-1,32.7,31.3,1.4,18,ENG
3233eefd,25,2065,22.9,23,21,2,5,24,39,-15,22.1,34.5,-12.4,18,ENG
32e7ce92,19,1710,19.0,19,19,0,19,40,14,26,36.1,13.6,22.5,18,ENG
3312f911,24,1745,19.4,21,15,3,3,22,30,-8,26.6,24.7,1.9,18,ENG
33508c78,32,2307,25.6,25,15,7,4,40,26,14,37.9,22.8,15.1,18,ENG
3515d404,30,1716,19.1,20,10,10,7,20,29,-9,19.4,21.0,-1.5,18,ENG
356a9a62,12,797,8.9,10,7,2,7,15,16,-1,13.8,13.5,0.3,18,ENG
3680d723,2,150,1.7,2,1,0,0,4,3,1,2.6,2.8,-0.2,18,ENG
36c2ca73,18,1620,18.0,18,18,0,19,17,26,-9,16.2,19.9,-3.7,18,ENG
3727dd3c,30,2270,25.2,25,20,5,3,25,28,-3,26.7,35.4,-8.7,18,ENG
381d7d54,16,478,5.3,4,2,12,4,10,10,0,8.0,7.4,0.7,18,ENG
3831b9fe,28,2460,27.3,28,26,0,1,29,27,2,23.2,35.5,-12.3,18,ENG
38aefb74,4,79,0.9,0,0,4,4,0,2,-2,0.9,2.2,-1.3,18,ENG
38c7feef,35,1734,19.3,17,7,18,0,46,27,19,34.9,19.5,15.4,18,ENG
3925dbd6,6,95,1.1,0,0,6,4,4,0,4,2.0,1.0,1.0,18,ENG
3935e52e,27,2147,23.9,25,19,2,9,49,30,19,45.4,28.5,17.0,18,ENG
39583cfd,7,435,4.8,5,0,2,0,3,3,0,4.8,3.5,1.3,18,ENG
3a24769f,2,129,1.4,2,0,0,6,0,4,-4,1.4,2.8,-1.4,18,ENG
3a949a25,12,1080,12.0,12,12,0,1,15,11,4,15.2,13.8,1.4,18,ENG
3bb625ac,14,845,9.4,9,3,5,5,11,20,-9,7.0,18.2,-11.3,18,ENG
3bb7b8b4,36,3194,35.5,36,35,0,1,99,26,73,74.7,22.1,52.6,18,ENG
3be1a627,1,58,0.6,1,0,0,2,0,1,-1,0.5,1.0,-0.5,18,ENG
3c066877,1,21,0.2,0,0,1,4,0,0,0,0.2,0.1,0.0,18,ENG
3ca7254a,31,1523,16.9,17,4,14,4,29,14,15,21.0,15.2,5.8,18,ENG
3cefa66a,20,1397,15.5,15,10,5,4,12,26,-14,13.3,25.2,-12.0,18,ENG
3e5e4e63,34,2767,30.7,31,29,3,3,37,53,-16,30.9,50.9,-20.0,18,ENG
3e9e06cb,28,2510,27.9,28,26,0,1,24,39,-15,25.9,34.6,-8.7,18,ENG
3ea50f67,3,10,0.1,0,0,3,3,1,0,1,0.6,0.0,0.6,18,ENG
3eb22ec9,35,1533,17.0,15,9,20,3,46,10,36,32.0,10.6,21.4,18,ENG
3f2d59fe,27,2273,25.3,25,23,2,3,51,30,21,46.8,30.9,15.9,18,ENG
3fe6bd8c,20,1602,17.8,19,17,1,2,19,18,1,21.3,24.6,-3.3,18,ENG
407feb71,5,55,0.6,0,0,5,5,2,1,1,1.1,0.9,0.2,18,ENG
4115ce4e,5,426,4.7,5,3,0,9,5,5,0,4.4,2.8,1.6,18,ENG
422862ea,6,447,5.0,5,3,1,0,7,7,0,6.0,7.2,-1.2,18,ENG
43458538,33,2453,27.3,27,18,6,0,31,38,-7,27.9,42.0,-14.0,18,ENG
434ad289,2,19,0.2,0,0,2,3,0,0,0,0.0,0.4,-0.4,18,ENG
436a9dd0,26,1268,14.1,13,7,13,7,20,14,6,15.5,19.0,-3.6,18,ENG
43a166b4,1,10,0.1,0,0,1,1,0,1,-1,0.1,0.8,-0.7,18,ENG
4468ec10,35,1697,18.9,17,6,18,3,25,35,-10,22.1,25.9,-3.8,18,ENG
44781702,29,2324,25.8,26,24,3,7,47,20,27,44.4,21.6,22.8,18,ENG
450ab6fc,33,2928,32.5,32,31,1,1,33,31,2,37.2,41.6,-4.4,18,ENG
4535e4bb,38,3420,38.0,38,38,0,0,34,54,-20,37.0,50.8,-13.8,18,ENG
453f566a,4,170,1.9,1,0,3,0,2,2,0,1.9,1.8,0.1,18,ENG
45963054,37,3247,36.1,37,26,0,0,52,57,-5,47.7,45.9,1.8,18,ENG
45da6694,23,1820,20.2,21,17,2,12,21,37,-16,22.7,28.2,-5.5,18,ENG
46b5375e,1,9,0.1,0,0,1,16,0,0,0,0.0,0.0,0.0,18,ENG
46ee5234,33,2827,31.4,32,27,1,0,23,44,-21,31.2,39.8,-8.7,18,ENG
47a34c4f,13,867,9.6,11,5,2,11,18,12,6,16.8,12.2,4.7,18,ENG
47b7e3af,36,3067,34.1,34,29,2,0,25,52,-27,28.0,43.6,-15.6,18,ENG
4806ec67,38,3420,38.0,38,38,0,0,44,58,-14,40.5,52.4,-11.9,18,ENG
4830e0af,5,220,2.4,2,0,3,8,1,5,-4,1.6,3.0,-1.4,18,ENG
495945ef,19,1111,12.3,12,10,7,19,16,17,-1,13.4,17.1,-3.7,18,ENG
49b05a83,7,135,1.5,1,0,6,18,2,3,-1,2.5,0.7,1.8,18,ENG
4a537185,13,614,6.8,8,0,5,5,7,17,-10,5.8,13.4,-7.6,18,ENG
4ab53cdb,37,2812,31.2,31,13,6,1,24,41,-17,28.6,38.3,-9.7,18,ENG
4b40d9ca,35,3115,34.6,34,34,1,3,31,35,-4,29.3,46.2,-17.0,18,ENG
4b511457,34,2897,32.2,34,28,0,3,27,47,-20,32.0,40.0,-7.9,18,ENG
4c370d81,37,2763,30.7,32,12,5,1,73,32,41,61.2,28.5,32.6,18,ENG
4cde5509,5,106,1.2,1,0,4,3,1,2,-1,2.2,1.0,1.2,18,ENG
4d034881,25,1963,21.8,22,13,3,4,63,12,51,45.8,13.1,32.7,18,ENG
4e9a0555,24,1624,18.0,20,7,4,1,22,11,11,17.0,23.0,-6.0,18,ENG
4f974391,36,3069,34.1,35,30,1,1,45,60,-15,34.5,47.8,-13.3,18,ENG
5167c97e,1,4,0.0,0,0,1,6,0,0,0,0.0,0.0,0.0,18,ENG
51a3caf1,5,228,2.5,3,1,2,7,3,10,-7,1.0,6.7,-5.7,18,ENG
51b41c5c,30,2130,23.7,24,19,6,4,22,38,-16,23.4,31.7,-8.3,18,ENG
51cf8561,8,532,5.9,6,3,2,12,16,3,13,10.6,3.4,7.2,18,ENG
52105203,17,1435,15.9,16,15,1,2,16,26,-10,23.7,20.1,3.6,18,ENG
5271c8f1,7,363,4.0,4,3,3,1,14,1,13,9.2,2.5,6.7,18,ENG
53538b39,30,1406,15.6,14,8,16,8,8,21,-13,12.9,21.5,-8.7,18,ENG
53af52f3,33,2965,32.9,33,32,0,0,49,47,2,44.7,39.6,5.1,18,ENG
53cad200,37,3330,37.0,37,37,0,1,61,38,23,52.9,33.8,19.1,18,ENG
5540c9dc,38,3386,37.6,38,37,0,0,30,55,-25,35.6,47.8,-12.2,18,ENG
562eed5c,17,1452,16.1,17,15,0,3,14,27,-13,14.9,19.4,-4.5,18,ENG
56f6f826,3,200,2.2,2,2,1,28,1,5,-4,2.0,2.9,-0.9,18,ENG
57c433c8,14,306,3.4,0,0,14,4,5,11,-6,4.5,7.8,-3.3,18,ENG
57df7a11,27,1870,20.8,21,13,6,5,27,29,-2,21.2,27.3,-6.1,18,ENG
580d52dd,27,1641,18.2,20,11,7,6,13,30,-17,15.8,23.3,-7.5,18,ENG
59bf127b,29,2126,23.6,24,20,5,5,37,20,17,31.4,21.5,9.9,18,ENG
59e6e5bf,32,1882,20.9,18,13,14,1,26,29,-3,23.9,29.0,-5.1,18,ENG
5a1900a4,37,2570,28.6,28,20,9,1,18,39,-21,24.4,44.3,-20.0,18,ENG
5a4280b1,16,1440,16.0,16,16,0,22,14,21,-7,13.0,22.4,-9.4,18,ENG
5acc4a10,23,1542,17.1,18,13,5,13,15,29,-14,18.5,23.3,-4.8,18,ENG
5b54bf3b,5,260,2.9,2,0,3,6,3,3,0,2.4,4.9,-2.5,18,ENG
5bddccc9,19,1329,14.8,17,6,2,1,12,23,-11,12.3,18.6,-6.3,18,ENG
5be28712,6,366,4.1,4,3,2,16,9,7,2,7.3,5.1,2.1,18,ENG
5c2b4f07,17,1429,15.9,16,14,1,13,35,12,23,30.5,9.7,20.8,18,ENG
5dbefa9d,30,1845,20.5,19,11,11,4,20,41,-21,20.9,34.4,-13.5,18,ENG
5eae500a,34,2867,31.9,33,30,1,0,63,26,37,49.6,35.6,14.0,18,ENG
5eebbfdf,13,1023,11.4,13,6,0,0,13,9,4,14.2,12.0,2.2,18,ENG
5eecec3d,18,1302,14.5,16,11,2,4,44,11,33,30.7,8.5,22.2,18,ENG
5f09991f,28,2184,24.3,25,21,3,8,31,38,-7,32.2,34.7,-2.5,18,ENG
601ef102,15,453,5.0,3,0,12,3,9,12,-3,7.1,8.5,-1.5,18,ENG
61abe9b6,15,707,7.9,8,4,7,0,3,8,-5,5.5,9.7,-4.1,18,ENG
6265208f,30,1712,19.0,19,4,11,4,20,25,-5,18.5,26.2,-7.7,18,ENG
62a0089e,3,37,0.4,0,0,3,5,1,0,1,1.0,0.8,0.2,18,ENG
63d17038,1,90,1.0,1,1,0,1,1,0,1,0.9,0.8,0.0,18,ENG
6421ec64,36,3039,33.8,36,26,0,1,30,58,-28,31.6,54.3,-22.7,18,ENG
64b08de7,4,205,2.3,3,0,1,0,0,6,-6,1.6,5.3,-3.7,18,ENG
653ee42d,36,3240,36.0,36,36,0,0,34,50,-16,34.9,48.1,-13.2,18,ENG
67d23ab0,33,2452,27.2,27,17,6,3,22,39,-17,24.4,29.3,-4.9,18,ENG
6813ac34,37,3289,36.5,37,35,0,0,45,62,-17,34.3,50.6,-16.3,18,ENG
68796d61,27,1324,14.7,17,2,10,2,25,19,6,21.2,18.7,2.5,18,ENG
691bef82,7,362,4.0,4,3,3,11,11,0,11,8.3,2.5,5.9,18,ENG
6992791d,19,1286,14.3,17,5,2,0,18,22,-4,14.0,24.2,-10.2,18,ENG
6adbc307,22,1980,22.0,22,21,0,5,19,33,-14,21.2,27.9,-6.7,18,ENG
6b47c5db,33,2898,32.2,33,30,0,0,46,44,2,41.4,39.5,1.9,18,ENG
6c679c6d,33,2421,26.9,27,16,6,1,28,29,-1,26.5,30.9,-4.4,18,ENG
6c96b263,4,168,1.9,1,1,3,2,0,4,-4,0.5,4.1,-3.6,18,ENG
6ca5ec4b,26,1830,20.3,22,5,4,10,36,26,10,35.6,25.5,10.2,18,ENG
6cc47ae1,6,224,2.5,3,0,3,6,3,8,-5,3.3,5.6,-2.3,18,ENG
6cdd8245,23,1902,21.1,22,17,1,0,30,31,-1,27.4,27.7,-0.3,18,ENG
6d6f09dc,6,163,1.8,1,0,5,4,1,2,-1,1.8,1.1,0.7,18,ENG
6dfd5af0,24,1307,14.5,16,3,8,7,12,21,-9,13.0,22.3,-9.3,18,ENG
6eaed4eb,24,2103,23.4,24,23,0,4,24,32,-8,23.5,32.0,-8.6,18,ENG
6fd8a334,11,769,8.5,7,6,4,18,10,14,-4,10.8,10.0,0.8,18,ENG
715fc0fe,16,851,9.5,11,2,5,4,9,14,-5,10.1,12.4,-2.3,18,ENG
71672fa0,34,3039,33.8,34,33,0,1,64,48,16,60.3,43.1,17.3,18,ENG
71ef519e,35,2804,31.2,32,21,3,3,35,35,0,36.5,41.4,-4.9,18,ENG
72c812f3,33,2751,30.6,32,24,1,1,38,42,-4,32.1,40.1,-8.1,18,ENG
7314bba4,37,3292,36.6,37,35,0,0,32,52,-20,35.1,48.2,-13.1,18,ENG
73489527,24,1997,22.2,24,12,0,0,18,17,1,15.9,28.6,-12.8,18,ENG
7391c2d9,14,1179,13.1,13,13,1,8,9,18,-9,10.6,19.4,-8.9,18,ENG
73d9bdc7,31,1567,17.4,14,10,17,4,18,27,-9,20.4,31.8,-11.4,18,ENG
74b2cd7e,32,2880,32.0,32,32,0,5,43,60,-17,32.0,49.5,-17.5,18,ENG
74e12f1e,38,3420,38.0,38,38,0,0,36,39,-3,32.3,51.2,-18.9,18,ENG
7527558b,28,1540,17.1,16,8,12,3,20,31,-11,20.8,26.4,-5.7,18,ENG
758dd7f0,21,1758,19.5,20,18,1,17,17,31,-14,16.5,32.4,-15.9,18,ENG
75f2c59f,32,1624,18.0,18,6,14,0,23,34,-11,22.8,24.1,-1.3,18,ENG
76c131da,9,229,2.5,2,0,7,10,2,2,0,2.1,2.6,-0.6,18,ENG
76dd1480,27,2259,25.1,25,20,2,2,31,40,-9,26.3,37.5,-11.3,18,ENG
76eca7e2,27,2430,27.0,27,27,0,9,29,41,-12,35.9,36.8,-0.9,18,ENG
76fa5f80,1,71,0.8,1,0,0,16,0,2,-2,0.2,1.0,-0.7,18,ENG
78803d03,25,2016,22.4,23,19,2,10,16,23,-7,18.6,28.6,-10.1,18,ENG
78b8ac63,11,276,3.1,2,0,9,2,3,5,-2,3.3,5.3,-2.0,18,ENG
7914b9fe,27,2086,23.2,24,22,3,7,35,24,11,33.5,22.5,11.0,18,ENG
7a11550b,23,1902,21.1,21,21,2,6,47,22,25,41.1,18.6,22.5,18,ENG
7a1f2c08,12,442,4.9,4,4,8,17,3,6,-3,6.2,6.9,-0.7,18,ENG
7b4de647,38,3420,38.0,38,38,0,0,45,61,-16,38.8,59.2,-20.4,18,ENG
7ba6d84e,37,3330,37.0,37,37,0,0,67,28,39,55.3,40.1,15.2,18,ENG
7bb5f40e,30,2093,23.3,23,13,7,1,24,32,-8,23.1,26.2,-3.1,18,ENG
7bc34048,17,1243,13.8,14,10,3,5,10,27,-17,11.9,22.0,-10.1,18,ENG
7c104bb7,7,159,1.8,1,0,6,10,7,6,1,3.7,3.6,0.1,18,ENG
7c2a398c,3,198,2.2,3,1,0,0,4,3,1,4.4,3.8,0.6,18,ENG
7c4243d4,11,754,8.4,9,4,2,9,4,16,-12,6.3,13.2,-7.0,18,ENG
7ca2d989,1,90,1.0,1,1,0,37,1,1,0,0.2,1.3,-1.1,18,ENG
7ca9f0f0,2,46,0.5,0,0,2,4,0,0,0,0.4,0.4,0.0,18,ENG
7d2d3329,8,378,4.2,4,2,4,0,6,9,-3,6.8,5.8,1.0,18,ENG
7d41b619,25,1856,20.6,20,19,5,11,20,29,-9,19.3,31.5,-12.3,18,ENG
7dbbe367,25,1923,21.4,22,16,3,0,20,35,-15,21.9,26.4,-4.5,18,ENG
7f4f3e49,35,2596,28.8,30,19,5,0,29,49,-20,26.9,43.6,-16.8,18,ENG
7fe90ccd,22,1098,12.2,12,5,10,9,21,15,6,21.7,11.6,10.1,18,ENG
7fec31a0,28,1947,21.6,21,19,7,10,30,41,-11,23.0,34.2,-11.1,18,ENG
80c31c97,32,2817,31.3,32,31,0,1,48,52,-4,40.9,41.7,-0.8,18,ENG
810e3c74,33,1817,20.2,20,3,13,4,41,18,23,29.6,23.2,6.4,18,ENG
819aa8e7,36,2492,27.7,28,15,8,2,33,28,5,33.3,33.1,0.2,18,ENG
819b3158,30,1517,16.9,15,9,15,4,44,14,30,32.9,12.5,20.4,18,ENG
82b1198a,5,381,4.2,4,4,1,29,10,3,7,8.0,4.7,3.2,18,ENG
82dbf623,16,238,2.6,1,0,15,13,5,2,3,7.7,4.5,3.2,18,ENG
82e34b69,29,1844,20.5,20,13,9,1,24,28,-4,26.4,23.9,2.5,18,ENG
8309b068,1,90,1.0,1,1,0,8,0,2,-2,0.5,1.6,-1.1,18,ENG
833fb62e,8,278,3.1,3,0,5,4,1,7,-6,1.6,4.7,-3.0,18,ENG
8397a50c,4,201,2.2,3,1,1,4,1,5,-4,1.0,3.7,-2.7,18,ENG
839c14e1,32,2794,31.0,32,29,0,0,31,44,-13,33.5,35.2,-1.7,18,ENG
85b011bb,15,1292,14.4,14,14,1,17,12,24,-12,15.5,18.7,-3.2,18,ENG
861e0116,5,335,3.7,4,3,1,1,2,6,-4,1.9,5.6,-3.7,18,ENG
867239d3,27,2148,23.9,25,19,2,0,48,20,28,39.1,25.8,13.3,18,ENG
86dd77d1,32,2785,30.9,32,29,0,4,87,22,65,64.8,19.6,45.2,18,ENG
87449a74,1,20,0.2,0,0,1,2,0,2,-2,0.0,1.0,-1.0,18,ENG
87575fd9,16,683,7.6,5,4,11,0,19,1,18,13.8,7.4,6.5,18,ENG
875898c7,28,2520,28.0,28,28,0,6,27,42,-15,26.3,33.6,-7.3,18,ENG
87935cf3,19,1600,17.8,18,17,1,2,24,23,1,26.0,22.0,4.1,18,ENG
8816329f,28,1784,19.8,19,12,9,0,17,22,-5,20.6,24.4,-3.8,18,ENG
892d5bb1,36,2950,32.8,34,22,2,0,49,51,-2,42.0,40.5,1.5,18,ENG
89cbc961,4,121,1.3,1,0,3,3,2,2,0,1.3,1.8,-0.5,18,ENG
89d10e53,10,800,8.9,9,6,1,10,18,14,4,14.0,10.9,3.1,18,ENG
89e4b358,7,523,5.8,5,5,2,2,2,6,-4,5.3,4.3,1.0,18,ENG
8a7ff278,19,1613,17.9,19,16,0,4,16,25,-9,23.2,20.3,2.9,18,ENG
8aa5f52c,28,2210,24.6,24,21,4,5,26,45,-19,25.3,33.3,-8.0,18,ENG
8aadeaef,1,7,0.1,0,0,1,5,1,0,1,0.1,0.0,0.1,18,ENG
8abd0c03,12,994,11.0,12,10,0,5,18,17,1,14.2,13.9,0.3,18,ENG
8ae9869d,37,3265,36.3,37,35,0,0,28,53,-25,30.1,46.6,-16.5,18,ENG
8aec0537,38,2928,32.5,35,11,3,0,34,46,-12,34.0,40.1,-6.0,18,ENG
8b04d6c1,23,1670,18.6,19,14,4,8,18,30,-12,16.6,21.2,-4.6,18,ENG
8b0d6fe9,3,164,1.8,1,1,2,5,2,3,-1,1.5,2.3,-0.8,18,ENG
8b6e0db2,1,5,0.1,0,0,1,0,0,0,0,0.0,0.0,0.0,18,ENG
8b788c01,30,1582,17.6,18,5,12,4,34,13,21,27.0,22.1,4.9,18,ENG
8b8e759d,3,16,0.2,0,0,3,3,0,0,0,0.1,0.1,0.0,18,ENG
8b9ebd03,36,1890,21.0,20,11,16,1,35,19,16,28.0,16.9,11.1,18,ENG
8cceca90,9,547,6.1,7,3,2,10,4,14,-10,4.5,11.8,-7.3,18,ENG
8d228291,24,1037,11.5,10,3,14,1,14,15,-1,15.3,10.5,4.8,18,ENG
8d3c902d,33,2799,31.1,32,27,1,0,41,57,-16,29.5,43.8,-14.3,18,ENG
8df7a2fb,29,2610,29.0,29,29,0,0,27,27,0,24.9,39.6,-14.6,18,ENG
8e65a5e5,11,990,11.0,11,11,0,18,16,14,2,17.6,11.4,6.1,18,ENG
8f62b6ee,36,3240,36.0,36,36,0,0,72,35,37,62.7,32.3,30.4,18,ENG
8f866fe8,28,1081,12.0,11,3,17,10,13,17,-4,12.4,13.5,-1.2,18,ENG
8f898ba8,7,450,5.0,5,2,2,1,5,8,-3,4.5,6.0,-1.5,18,ENG
90f87966,8,688,7.6,8,6,0,5,9,11,-2,7.3,8.7,-1.3,18,ENG
914ab9a1,28,2330,25.9,27,24,1,1,31,43,-12,30.5,34.8,-4.3,18,ENG
91bdc54a,2,33,0.4,0,0,2,9,0,1,-1,0.0,1.0,-1.0,18,ENG
9228b07c,33,1900,21.1,20,8,13,2,27,24,3,22.3,25.9,-3.6,18,ENG
92e7e919,37,2317,25.7,27,7,10,1,56,18,38,45.9,21.5,24.3,18,ENG
9306d5ea,30,2398,26.6,29,17,1,2,20,39,-19,21.1,35.6,-14.5,18,ENG
9328b835,38,3420,38.0,38,38,0,0,28,56,-28,31.6,58.6,-27.0,18,ENG
935e6b8f,27,2171,24.1,25,21,2,4,52,21,31,42.6,21.9,20.7,18,ENG
939bc634,38,3420,38.0,38,38,0,0,28,58,-30,31.3,48.5,-17.2,18,ENG
93ee387c,4,156,1.7,2,1,2,17,1,3,-2,3.2,2.2,0.9,18,ENG
94b2001f,23,1349,15.0,13,11,10,13,40,11,29,30.1,11.1,19.0,18,ENG
960acc0a,13,1138,12.6,13,11,0,0,10,17,-7,10.0,21.9,-12.0,18,ENG
96bb8cc2,15,1277,14.2,15,13,0,0,14,12,2,9.6,19.8,-10.2,18,ENG
96e0490d,8,444,4.9,5,4,3,9,5,3,2,4.5,6.1,-1.6,18,ENG
97572117,29,2310,25.7,25,23,4,8,23,40,-17,24.8,33.0,-8.2,18,ENG
977ffc24,18,625,6.9,5,1,13,14,8,15,-7,8.0,12.4,-4.4,18,ENG
980522ec,37,3218,35.8,37,29,0,0,71,33,38,62.2,31.8,30.4,18,ENG
984a5a64,3,189,2.1,2,2,1,11,8,4,4,4.5,2.2,2.3,18,ENG
987718f5,29,2044,22.7,23,16,6,6,18,30,-12,17.4,32.9,-15.4,18,ENG
989d5705,34,2331,25.9,29,13,5,1,17,28,-11,19.0,35.1,-16.1,18,ENG
98be0d02,24,1238,13.8,12,5,12,12,9,30,-21,11.2,21.9,-10.6,18,ENG
99813635,12,308,3.4,1,0,11,2,4,1,3,4.6,1.4,3.2,18,ENG
9a104dee,14,986,11.0,12,5,2,2,10,13,-3,11.8,12.8,-1.0,18,ENG
9a8c6673,6,166,1.8,1,0,5,10,2,9,-7,0.9,5.4,-4.4,18,ENG
9a9c05db,26,2295,25.5,25,25,1,8,28,26,2,22.1,32.9,-10.8,18,ENG
9aa186b2,23,1674,18.6,19,16,4,10,13,28,-15,16.2,22.9,-6.7,18,ENG
9aacb284,20,985,10.9,11,4,9,11,11,17,-6,10.8,15.8,-4.9,18,ENG
9c318325,20,1193,13.3,12,10,8,6,27,16,11,22.2,16.5,5.8,18,ENG
9c94165b,11,790,8.8,8,7,3,10,14,2,12,12.4,6.7,5.7,18,ENG
9d107085,35,3002,33.4,34,30,1,1,36,50,-14,31.9,51.7,-19.8,18,ENG
9d597f08,2,32,0.4,0,0,2,10,0,1,-1,0.3,1.1,-0.8,18,ENG
9dab6e3b,3,270,3.0,3,3,0,26,3,7,-4,2.6,4.8,-2.1,18,ENG
9dbb75ca,32,2202,24.5,26,10,6,1,51,28,23,46.9,27.4,19.5,18,ENG
9e525177,7,627,7.0,7,6,0,7,10,10,0,9.7,10.2,-0.5,18,ENG
9e53837d,3,180,2.0,2,1,1,13,0,7,-7,1.3,4.8,-3.5,18,ENG
9f472354,30,1582,17.6,15,5,15,3,18,28,-10,20.5,24.0,-3.6,18,ENG
9f736ed2,32,1995,22.2,22,8,10,3,27,33,-6,23.2,32.2,-9.0,18,ENG
9fa0a0b8,1,71,0.8,1,0,0,2,0,1,-1,0.2,0.6,-0.4,18,ENG
9feb8f24,36,3139,34.9,36,33,0,1,30,55,-25,33.6,52.2,-18.6,18,ENG
a0666d3e,15,990,11.0,11,2,4,2,13,16,-3,12.1,12.1,0.1,18,ENG
a1232f4e,13,1001,11.1,11,11,2,5,24,6,18,17.9,11.9,6.0,18,ENG
a179d516,3,270,3.0,3,3,0,35,6,4,2,4.2,2.9,1.3,18,ENG
a1d5bd30,35,1813,20.1,17,7,18,2,34,16,18,29.1,19.3,9.8,18,ENG
a32204c9,4,71,0.8,0,0,4,6,1,3,-2,1.0,1.4,-0.4,18,ENG
a36d4785,3,25,0.3,0,0,3,9,0,0,0,0.0,0.7,-0.6,18,ENG
a39bb753,34,2422,26.9,28,11,6,1,43,27,16,40.8,23.8,17.0,18,ENG
a3b03921,2,82,0.9,1,0,1,3,1,2,-1,1.0,0.6,0.5,18,ENG
a440d8ca,6,438,4.9,5,3,1,7,7,8,-1,5.4,7.4,-2.0,18,ENG
a498e276,24,1834,20.4,20,16,4,5,23,31,-8,21.1,27.2,-6.1,18,ENG
a53649b7,3,20,0.2,0,0,3,8,0,1,-1,0.3,0.4,-0.1,18,ENG
a634b9d2,2,180,2.0,2,2,0,11,2,3,-1,2.0,2.2,-0.2,18,ENG
a65ce836,26,2091,23.2,24,19,2,3,56,29,27,46.5,23.7,22.8,18,ENG
a67a09fb,25,1921,21.3,21,20,4,11,34,35,-1,28.0,29.1,-1.1,18,ENG
a6951bf8,7,169,1.9,1,0,6,12,2,6,-4,3.3,4.3,-1.0,18,ENG
a6de6361,4,305,3.4,4,3,0,7,5,4,1,3.1,5.0,-1.9,18,ENG
a6e316c1,20,1318,14.6,15,12,5,14,16,30,-14,17.3,21.2,-4.0,18,ENG
a9142dc3,21,1596,17.7,17,15,4,9,12,29,-17,26.4,24.6,1.8,18,ENG
aa51343f,5,138,1.5,2,0,3,3,2,8,-6,1.2,4.5,-3.3,18,ENG
aa5859cb,33,1820,20.2,18,15,15,2,14,34,-20,14.7,26.8,-12.0,18,ENG
aa8e289e,12,576,6.4,7,3,5,5,4,12,-8,6.1,8.0,-1.9,18,ENG
ab070c55,31,2240,24.9,24,21,7,0,27,36,-9,36.3,33.1,3.3,18,ENG
ab651565,31,1945,21.6,22,13,9,4,14,31,-17,21.0,26.0,-5.1,18,ENG
ab7263c1,2,109,1.2,1,0,1,7,1,0,1,1.3,0.7,0.6,18,ENG
abe66106,25,843,9.4,7,0,18,0,21,12,9,18.0,10.2,7.9,18,ENG
ac05f970,21,1354,15.0,16,8,5,0,13,23,-10,13.1,20.3,-7.2,18,ENG
ac7d7378,9,458,5.1,5,3,4,18,3,15,-12,3.2,7.6,-4.4,18,ENG
ac861941,34,2824,31.4,32,27,2,3,59,30,29,53.8,26.5,27.3,18,ENG
ad1ffcfd,19,1410,15.7,17,10,2,10,26,23,3,16.8,20.4,-3.6,18,ENG
ad7b19ef,31,2376,26.4,28,13,3,2,32,36,-4,39.2,30.3,8.8,18,ENG
ae0a7ddf,34,2845,31.6,31,31,3,1,33,37,-4,35.9,40.6,-4.7,18,ENG
af721f98,22,1087,12.1,10,4,12,8,20,23,-3,17.7,18.8,-1.1,18,ENG
aff418dc,11,411,4.6,5,1,6,21,2,7,-5,5.4,8.0,-2.5,18,ENG
b070482d,9,55,0.6,0,0,9,11,1,3,-2,1.9,2.2,-0.3,18,ENG
b0c71810,26,1219,13.5,11,3,15,6,18,24,-6,14.8,17.4,-2.6,18,ENG
b1313ec4,18,1333,14.8,15,9,3,8,7,15,-8,8.6,23.7,-15.0,18,ENG
b18095b6,22,1909,21.2,22,20,0,1,22,34,-12,23.0,26.5,-3.5,18,ENG
b1b25949,16,1440,16.0,16,16,0,6,14,21,-7,15.6,22.8,-7.2,18,ENG
b217ef29,25,1997,22.2,22,22,3,1,53,27,26,46.8,21.8,24.9,18,ENG
b27b49b4,7,148,1.6,1,1,6,10,1,2,-1,1.5,2.5,-1.1,18,ENG
b28bbd58,36,3120,34.7,35,26,1,1,39,48,-9,47.9,42.8,5.1,18,ENG
b2bc3b1f,29,2549,28.3,28,26,1,0,42,31,11,44.3,30.7,13.6,18,ENG
b318a643,36,2767,30.7,32,23,4,1,25,48,-23,27.6,40.1,-12.5,18,ENG
b400bde0,33,2587,28.7,29,19,4,1,82,23,59,63.1,17.1,46.0,18,ENG
b581987a,16,751,8.3,7,3,9,5,14,12,2,11.2,9.9,1.4,18,ENG
b63f4077,17,611,6.8,5,1,12,4,5,12,-7,6.5,12.7,-6.2,18,ENG
b66315ae,29,1668,18.5,19,5,10,3,54,12,42,41.5,10.2,31.3,18,ENG
b6964eb6,29,2536,28.2,28,28,1,6,46,24,22,36.2,32.7,3.5,18,ENG
b7d082af,31,2041,22.7,23,14,8,6,26,27,-1,27.5,32.5,-4.9,18,ENG
b827d5b3,34,2538,28.2,30,19,4,1,35,39,-4,35.6,34.9,0.7,18,ENG
b92dd711,5,302,3.4,4,0,1,2,2,1,1,4.1,3.1,1.0,18,ENG
b98570d1,34,2674,29.7,30,25,4,0,22,41,-19,28.3,36.7,-8.3,18,ENG
b9fbae28,34,2994,33.3,34,30,0,0,54,32,22,48.8,28.1,20.7,18,ENG
ba1e04b3,21,1563,17.4,18,14,3,4,18,29,-11,16.5,23.6,-7.1,18,ENG
ba23a904,36,3203,35.6,36,34,0,0,67,31,36,59.6,30.6,29.0,18,ENG
bb5fbd2b,36,1851,20.6,18,10,18,2,11,29,-18,16.8,28.3,-11.5,18,ENG
bcf30f17,4,131,1.5,1,1,3,6,0,4,-4,2.1,2.8,-0.7,18,ENG
bd1d1cbb,2,98,1.1,1,1,1,9,1,0,1,1.3,1.2,0.1,18,ENG
bd8a7d05,10,537,6.0,7,1,3,7,5,7,-2,5.9,6.5,-0.6,18,ENG
bda6ffd4,16,903,10.0,9,6,7,18,5,17,-12,8.3,12.9,-4.6,18,ENG
be927d03,30,2442,27.1,28,21,2,2,44,26,18,37.0,31.8,5.3,18,ENG
bf54c8cc,13,311,3.5,4,0,9,2,1,8,-7,2.6,7.7,-5.1,18,ENG
c0e27d1a,10,840,9.3,9,8,1,3,17,13,4,10.5,11.1,-0.6,18,ENG
c204f844,10,236,2.6,1,0,9,18,6,2,4,4.8,3.6,1.2,18,ENG
c24dba2a,31,1498,16.6,16,4,15,7,19,30,-11,20.3,24.1,-3.8,18,ENG
c3e39f12,20,1800,20.0,20,20,0,18,20,30,-10,23.7,25.3,-1.6,18,ENG
c5942695,4,139,1.5,1,0,3,7,1,2,-1,0.4,2.9,-2.6,18,ENG
c596fcb0,28,1981,22.0,23,9,5,1,27,33,-6,25.2,30.7,-5.6,18,ENG
c5b7c315,30,2560,28.4,29,27,1,4,30,46,-16,29.2,40.7,-11.6,18,ENG
c5bdb6e3,3,145,1.6,2,0,1,4,3,3,0,1.7,2.3,-0.5,18,ENG
c5f13182,6,221,2.5,2,0,4,2,2,5,-3,1.5,2.2,-0.7,18,ENG
c61f1719,13,1050,11.7,12,11,1,3,18,19,-1,13.3,17.0,-3.7,18,ENG
c6896eab,23,1588,17.6,19,10,4,8,13,26,-13,15.9,24.5,-8.7,18,ENG
c691bfe2,29,2190,24.3,28,9,1,3,53,20,33,49.4,17.4,31.9,18,ENG
c7aee75b,1,1,0.0,0,0,1,2,0,0,0,0.0,0.0,0.0,18,ENG
c92e1a31,21,830,9.2,7,0,14,11,15,17,-2,15.4,8.8,6.6,18,ENG
c951a6df,26,1374,15.3,15,8,11,8,12,25,-13,15.3,24.0,-8.8,18,ENG
ca2bc3df,32,1984,22.0,23,11,9,3,26,32,-6,25.6,29.4,-3.8,18,ENG
ca9178af,8,198,2.2,1,0,7,6,0,2,-2,2.6,1.9,0.7,18,ENG
caa1a7f0,1,9,0.1,0,0,1,0,0,0,0,0.5,0.5,0.0,18,ENG
caffaf5a,24,2051,22.8,23,21,1,8,22,31,-9,25.6,27.0,-1.4,18,ENG
cb4f24c6,19,1710,19.0,19,19,0,16,18,39,-21,17.5,26.8,-9.2,18,ENG
cc2d7ad5,11,950,10.6,10,10,1,18,6,12,-6,8.6,15.7,-7.1,18,ENG
cc70a1d5,35,3150,35.0,35,35,0,0,32,61,-29,33.8,57.7,-23.9,18,ENG
cd1acf9d,19,1573,17.5,18,14,1,16,39,17,22,33.8,15.7,18.1,18,ENG
cde3309f,10,900,10.0,10,10,0,25,10,15,-5,10.9,15.9,-5.0,18,ENG
ce4246f5,34,2888,32.1,32,31,2,0,33,50,-17,32.2,49.7,-17.5,18,ENG
ce5143da,28,1194,13.3,12,5,16,2,20,21,-1,20.1,16.6,3.5,18,ENG
ce9c203e,1,75,0.8,1,0,0,2,2,1,1,1.6,2.1,-0.6,18,ENG
cea4ee8f,36,2958,32.9,34,18,2,0,63,28,35,54.1,25.7,28.5,18,ENG
cee31595,33,2431,27.0,27,18,6,2,34,35,-1,37.1,31.4,5.7,18,ENG
cf15bbb1,23,1521,16.9,17,11,6,5,16,21,-5,20.1,20.9,-0.7,18,ENG
cfd5e123,25,2236,24.8,25,23,0,2,25,36,-11,26.4,31.3,-4.9,18,ENG
cfe6238d,15,1306,14.5,15,12,0,1,10,18,-8,11.9,21.8,-10.0,18,ENG
d0042ab9,15,1184,13.2,13,13,2,12,16,14,2,14.6,15.9,-1.3,18,ENG
d07e3b41,14,587,6.5,5,1,9,1,11,12,-1,9.8,8.8,1.1,18,ENG
d080ed5e,24,1347,15.0,14,8,10,7,14,18,-4,15.5,18.6,-3.1,18,ENG
d0b3ceb9,37,3330,37.0,37,37,0,0,30,55,-25,36.3,46.6,-10.3,18,ENG
d2424d1b,24,1853,20.6,20,16,4,8,32,30,2,29.2,24.8,4.4,18,ENG
d2bff301,17,1394,15.5,17,14,0,5,37,12,25,29.4,10.6,18.8,18,ENG
d328a254,16,764,8.5,8,4,8,4,7,11,-4,7.2,11.3,-4.1,18,ENG
d368feb8,38,3420,38.0,38,38,0,0,28,56,-28,31.6,58.6,-27.0,18,ENG
d436eb94,19,1710,19.0,19,19,0,18,44,24,20,36.7,20.2,16.6,18,ENG
d4cb83cc,28,2243,24.9,26,23,2,2,48,29,19,48.7,27.9,20.8,18,ENG
d56543a0,26,2004,22.3,23,15,3,9,25,38,-13,23.0,32.2,-9.2,18,ENG
d596e193,24,2128,23.6,24,23,0,9,32,40,-8,29.5,33.1,-3.6,18,ENG
d5dd5f1f,13,1057,11.7,12,10,1,0,26,15,11,19.5,15.6,3.9,18,ENG
d6f88a1d,12,761,8.5,9,5,3,3,13,18,-5,10.5,11.5,-1.0,18,ENG
d7492450,15,1195,13.3,12,10,3,13,16,21,-5,15.5,18.7,-3.2,18,ENG
d790907f,22,1252,13.9,14,7,8,10,15,26,-11,15.0,22.3,-7.300000000000001,18,ENG
d79a8c87,12,822,9.1,9,8,3,6,14,17,-3,15.1,15.8,-0.7,18,ENG
d822a850,4,275,3.1,3,3,1,29,0,7,-7,1.8,5.4,-3.6,18,ENG
d8931174,38,3420,38.0,38,38,0,0,56,60,-4,50.0,48.1,1.9,18,ENG
d93c2511,13,634,7.0,7,6,6,10,8,3,5,7.3,5.9,1.4,18,ENG
d9cfca3d,23,596,6.6,4,0,19,9,16,16,0,8.8,11.0,-2.2,18,ENG
da052c14,36,2852,31.7,33,22,3,0,26,49,-23,27.9,48.3,-20.4,18,ENG
da2b8db3,1,17,0.2,0,0,1,1,0,1,-1,0.0,0.7,-0.7,18,ENG
da7b447d,31,2534,28.2,29,26,2,1,53,21,32,46.8,23.2,23.6,18,ENG
dc6f5bdd,12,866,9.6,10,5,2,7,22,14,8,15.3,12.5,2.8,18,ENG
dd0daf32,26,1716,19.0,20,5,6,1,38,17,21,33.2,21.7,11.4,18,ENG
de112b84,25,1148,12.8,13,5,12,11,10,25,-15,12.0,22.7,-10.7,18,ENG
def899bd,23,1973,21.9,23,21,0,3,37,11,26,34.6,21.2,13.4,18,ENG
df540668,8,456,5.1,6,2,2,13,3,12,-9,4.1,8.9,-4.8,18,ENG
e06683ca,26,2254,25.0,25,25,1,3,40,28,12,39.4,23.1,16.3,18,ENG
e0900238,18,846,9.4,8,6,10,2,20,11,9,16.1,11.9,4.3,18,ENG
e0991c04,9,640,7.1,8,5,1,11,13,8,5,7.9,11.5,-3.7,18,ENG
e0bc6fdc,5,280,3.1,3,2,2,7,3,4,-1,4.1,3.2,0.9,18,ENG
e2716bd0,29,2430,27.0,28,20,1,1,79,18,61,56.7,17.0,39.6,18,ENG
e342ad68,36,2907,32.3,34,17,2,0,77,30,47,64.3,27.0,37.3,18,ENG
e3a5814e,15,914,10.2,8,8,7,11,17,16,1,14.3,14.3,0.0,18,ENG
e46012d4,37,3073,34.1,36,22,1,1,93,22,71,69.8,19.2,50.6,18,ENG
e514ab62,2,166,1.8,2,1,0,4,2,6,-4,1.8,4.0,-2.2,18,ENG
e58a03c6,35,1958,21.8,23,8,12,1,19,31,-12,23.2,32.1,-8.8,18,ENG
e5d01ecf,23,1713,19.0,19,13,4,1,27,34,-7,23.4,28.0,-4.6,18,ENG
e61b8aee,38,3260,36.2,37,30,1,0,72,50,22,64.4,46.9,17.5,18,ENG
e726e11e,28,2110,23.4,25,14,3,5,38,20,18,30.4,21.2,9.2,18,ENG
e76cb9cc,9,672,7.5,7,5,2,3,8,11,-3,8.4,11.2,-2.7,18,ENG
e77dc3b2,21,596,6.6,5,3,16,14,11,4,7,12.6,4.6,8.0,18,ENG
e7ca0439,28,2387,26.5,27,25,1,6,40,32,8,39.4,30.4,9.0,18,ENG
e860c42f,34,3030,33.7,34,31,0,1,26,50,-24,25.4,52.0,-26.6,18,ENG
e9208654,24,1904,21.2,21,15,3,12,15,31,-16,15.5,27.6,-12.1,18,ENG
e92cd3f7,4,360,4.0,4,4,0,5,4,9,-5,3.3,7.4,-4.1,18,ENG
e97fd090,24,1874,20.8,21,17,3,0,28,30,-2,29.9,26.7,3.2,18,ENG
eaeca114,38,3353,37.3,37,36,1,0,44,59,-15,37.9,56.9,-19.0,18,ENG
eb58eef0,33,2387,26.5,27,21,6,2,60,23,37,50.7,25.4,25.2,18,ENG
eb7822d7,36,3118,34.6,35,33,1,0,64,26,38,51.9,37.1,14.8,18,ENG
ebd0a048,13,993,11.0,11,7,2,2,14,15,-1,16.5,12.7,3.8,18,ENG
ec7e6ad1,26,1920,21.3,22,15,4,9,22,23,-1,23.1,25.1,-2.0,18,ENG
ec9a28ce,20,1124,12.5,11,9,9,6,10,22,-12,8.9,18.1,-9.1,18,ENG
ed1e53f3,5,49,0.5,0,0,5,8,4,1,3,2.1,0.2,1.9,18,ENG
eed56f6c,14,289,3.2,2,0,12,7,2,4,-2,3.5,5.5,-1.9999999999999998,18,ENG
ef619b0b,24,1846,20.5,21,16,3,0,42,25,17,42.8,23.0,19.8,18,ENG
efe6f6ac,3,163,1.8,2,1,1,5,0,9,-9,1.7,4.5,-2.8,18,ENG
f0021247,13,1022,11.4,12,6,1,1,13,14,-1,9.8,15.3,-5.5,18,ENG
f07be45a,31,2268,25.2,27,7,4,3,30,33,-3,25.9,31.8,-5.9,18,ENG
f15a50e8,22,1119,12.4,12,6,10,12,8,23,-15,9.5,14.0,-4.5,18,ENG
f1e8372d,24,1088,12.1,11,2,13,2,18,21,-3,12.2,20.8,-8.6,18,ENG
f25b010f,30,2676,29.7,30,29,0,4,24,44,-20,23.0,47.0,-23.9,18,ENG
f2f29dda,35,2192,24.4,25,10,10,1,25,36,-11,26.3,29.0,-2.7,18,ENG
f3709655,1,83,0.9,1,0,0,3,3,2,1,1.7,1.9,-0.3,18,ENG
f42456eb,1,18,0.2,0,0,1,9,1,1,0,0.8,1.0,-0.2,18,ENG
f4290206,33,2855,31.7,33,28,0,1,48,30,18,44.0,26.7,17.3,18,ENG
f520049f,11,622,6.9,6,5,5,15,15,7,8,13.9,6.7,7.2,18,ENG
f586779e,31,1726,19.2,15,9,16,2,15,31,-16,16.9,31.8,-14.8,18,ENG
f5deef4c,17,1285,14.3,13,13,4,9,26,14,12,21.4,17.0,4.4,18,ENG
f5e6d08d,21,1570,17.4,17,15,4,6,15,29,-14,18.0,23.5,-5.5,18,ENG
f5efb153,25,2225,24.7,25,23,0,1,46,32,14,44.6,29.5,15.1,18,ENG
f631c17f,15,367,4.1,2,0,13,10,6,12,-6,4.8,5.6,-0.8,18,ENG
f6d7d690,2,8,0.1,0,0,2,12,0,0,0,0.1,0.3,-0.2,18,ENG
f72293fc,35,2833,31.5,32,23,3,1,29,33,-4,26.8,41.9,-15.1,18,ENG
f76e6b4e,19,1710,19.0,19,19,0,19,30,29,1,19.2,28.4,-9.2,18,ENG
f7d50789,14,1178,13.1,13,13,1,1,25,13,12,20.7,10.1,10.6,18,ENG
f7ee69fb,28,1879,20.9,21,8,7,2,41,22,19,36.2,21.2,15.0,18,ENG
f874dd44,35,3051,33.9,34,33,1,0,67,44,23,61.4,41.9,19.5,18,ENG
f8fcd2a5,28,2270,25.2,26,22,2,1,21,38,-17,26.5,30.8,-4.3,18,ENG
fa031b34,38,2823,31.4,32,22,6,0,31,54,-23,36.1,45.3,-9.2,18,ENG
faf55ce4,17,1323,14.7,14,13,3,2,17,32,-15,15.4,28.9,-13.5,18,ENG
fb2dec57,21,827,9.2,8,2,13,5,5,14,-9,10.6,13.0,-2.3,18,ENG
fc166e49,1,14,0.2,0,0,1,4,0,0,0,0.0,0.3,-0.3,18,ENG
fd3f57ce,10,645,7.2,6,4,4,9,0,14,-14,8.7,9.6,-0.9,18,ENG
fdd85f94,35,3119,34.7,35,33,0,0,31,50,-19,33.8,45.4,-11.6,18,ENG
fe012aca,1,17,0.2,1,0,0,0,0,0,0,0.0,0.0,0.0,18,ENG
ff527768,29,2400,26.7,28,23,1,4,35,45,-10,23.2,38.0,-14.9,18,ENG
ff9fcd4d,14,998,11.1,12,6,2,2,8,12,-4,9.4,13.3,-3.9,18,ENG
ffec9769,16,381,4.3,3,1,13,7,6,4,2,5.3,3.5,1.8,18,ENG
0027c6cc,4,285,3.2,3,3,1,2,1,3,-2,3.1,3.6,-0.5,18,EL
003a5c72,8,524,5.8,6,4,2,0,5,7,-2,7.0,6.9,0.0,18,EL
003d7410,2,136,1.5,2,1,0,7,3,3,0,2.3,2.2,0.1,18,EL
011d8c56,1,90,1.0,1,1,0,1,4,1,3,2.7,1.6,1.1,18,EL
016ff750,4,338,3.8,4,2,0,1,4,6,-2,6.7,5.9,0.7,18,EL
0174ba21,1,76,0.8,1,0,0,3,1,1,0,0.7,0.7,0.0,18,EL
0193a8bf,6,395,4.4,4,3,2,0,6,6,0,5.5,3.9,1.5,18,EL
01eb744d,9,546,6.1,7,1,2,0,14,3,11,9.9,6.1,3.8,18,EL
02f4b798,2,147,1.6,1,1,1,5,1,2,-1,1.9,2.7,-0.8,18,EL
038aa94a,6,540,6.0,6,6,0,0,7,8,-1,5.9,7.2,-1.3,18,EL
03de83d9,4,360,4.0,4,4,0,2,3,7,-4,5.5,5.3,0.2,18,EL
03f946ed,8,489,5.4,6,3,2,0,14,5,9,12.2,4.9,7.3,18,EL
042d286e,3,88,1.0,1,0,2,3,2,1,1,1.7,0.9,0.8,18,EL
0488e833,4,295,3.3,3,3,1,2,1,6,-5,2.4,3.9,-1.6,18,EL
0489db27,1,90,1.0,1,1,0,1,2,1,1,0.3,0.5,-0.2,18,EL
048a1cbc,1,28,0.3,0,0,1,1,0,0,0,0.8,0.7,0.1,18,EL
04f2ed4d,5,450,5.0,5,5,0,1,7,9,-2,6.6,9.9,-3.3,18,EL
053f6e16,2,131,1.5,1,0,1,2,3,2,1,0.6,1.4,-0.8,18,EL
0557ff4f,6,509,5.7,6,4,0,1,7,9,-2,5.3,9.5,-4.2,18,EL
0562b7f1,1,6,0.1,0,0,1,1,0,0,0,0.0,0.0,0.0,18,EL
05a275e0,4,307,3.4,3,2,1,1,4,4,0,3.8,4.0,-0.2,18,EL
05ad9890,1,22,0.2,0,0,1,2,0,0,0,0.4,0.2,0.3,18,EL
05cb19c5,4,175,1.9,2,1,2,1,2,2,0,2.0,2.1,0.0,18,EL
05e19d6a,9,578,6.4,7,3,2,0,16,6,10,12.6,5.5,7.1,18,EL
061e8e23,2,73,0.8,0,0,2,0,1,0,1,2.1,1.3,0.8,18,EL
0630eb63,6,490,5.4,6,1,0,0,2,2,0,6.5,5.6,0.9,18,EL
06eae126,6,329,3.7,4,2,2,0,1,6,-5,2.7,4.4,-1.7,18,EL
0711c00f,5,258,2.9,3,0,2,1,5,1,4,2.7,4.0,-1.3,18,EL
075fe5a3,2,114,1.3,1,1,1,5,1,1,0,0.9,2.0,-1.1,18,EL
077b773d,4,245,2.7,3,2,1,0,2,4,-2,3.4,5.1,-1.6,18,EL
07a0baa9,4,276,3.1,3,2,1,0,3,4,-1,3.7,3.1,0.6,18,EL
080ac8d8,8,485,5.4,5,3,3,0,5,4,1,8.0,5.0,3.0,18,EL
0810b6df,5,450,5.0,5,5,0,1,8,11,-3,6.2,8.7,-2.4,18,EL
08593525,12,1081,12.0,12,11,0,0,14,12,2,14.7,11.5,3.3,18,EL
08990838,8,720,8.0,8,8,0,0,8,8,0,8.9,9.1,-0.2,18,EL
08f5afaa,8,720,8.0,8,8,0,1,17,9,8,13.5,8.3,5.2,18,EL
08fe932d,5,381,4.2,4,4,1,0,4,6,-2,5.5,5.9,-0.5,18,EL
0984c5d5,3,191,2.1,2,2,1,3,1,5,-4,1.2,3.3,-2.1,18,EL
099e666f,3,249,2.8,3,2,0,0,2,7,-5,2.5,3.8,-1.4,18,EL
09a9e921,6,484,5.4,6,3,0,1,6,7,-1,9.9,7.3,2.6,18,EL
09bcc566,5,430,4.8,5,3,0,0,3,8,-5,4.7,6.0,-1.3,18,EL
0a215326,2,180,2.0,2,2,0,0,3,4,-1,1.9,2.2,-0.3,18,EL
0ac94a23,5,190,2.1,1,0,4,0,4,3,1,3.0,4.0,-1.0,18,EL
0aeeed3f,5,286,3.2,3,2,2,1,4,4,0,5.4,3.3,2.0,18,EL
0af4dcf0,5,260,2.9,2,2,3,0,6,1,5,5.7,2.9,2.7,18,EL
0b221abd,3,270,3.0,3,3,0,3,4,8,-4,2.0,5.5,-3.5,18,EL
0b2c9aec,1,21,0.2,0,0,1,2,0,0,0,0.2,0.1,0.1,18,EL
0b5a292a,2,104,1.2,1,0,1,0,1,3,-2,2.0,2.2,-0.2,18,EL
0b5b8057,2,90,1.0,1,0,1,2,1,2,-1,1.2,1.6,-0.4,18,EL
0be28faf,2,180,2.0,2,2,0,0,1,3,-2,1.4,2.3,-0.9,18,EL
0be3255b,13,1200,13.3,13,13,0,1,21,13,8,16.9,13.0,3.9,18,EL
0be46103,4,148,1.6,2,0,2,1,4,4,0,1.7,3.5,-1.8,18,EL
0cd0e21b,9,614,6.8,7,3,2,0,8,12,-4,9.5,6.7,2.7,18,EL
0d077b88,6,540,6.0,6,6,0,0,4,6,-2,4.3,6.9,-2.6,18,EL
0daa34cc,1,33,0.4,0,0,1,1,0,0,0,0.0,0.6,-0.6,18,EL
0e5753c7,6,492,5.5,6,4,0,1,9,6,3,6.1,7.2,-1.1,18,EL
0e61c46b,1,90,1.0,1,1,0,4,2,1,1,0.9,0.5,0.4,18,EL
0eeafda5,9,739,8.2,8,8,1,4,11,5,6,12.6,8.7,3.9,18,EL
0efacb06,5,450,5.0,5,5,0,0,9,4,5,6.2,6.9,-0.7,18,EL
0f5e0b8a,10,916,10.2,10,9,0,0,18,12,6,15.3,14.8,0.4,18,EL
0f816ae5,2,157,1.7,2,0,0,1,2,1,1,2.6,1.9,0.7,18,EL
0f888175,5,182,2.0,2,1,3,1,2,2,0,2.5,1.4,1.1,18,EL
0f8bd0a6,5,432,4.8,5,2,0,0,9,8,1,9.9,5.3,4.6,18,EL
0f9b8301,6,442,4.9,5,4,1,0,0,8,-8,3.1,6.8,-3.6,18,EL
0fffd034,5,236,2.6,2,0,3,0,0,0,0,0.0,0.0,0.0,18,EL
10206347,1,1,0.0,0,0,1,6,0,0,0,0.2,0.0,0.2,18,EL
10a81962,3,183,2.0,2,0,1,1,0,8,-8,1.0,9.8,-8.7,18,EL
10d58a78,5,386,4.3,5,2,0,0,4,6,-2,4.7,4.2,0.6,18,EL
10efd0e1,5,398,4.4,5,1,0,0,11,5,6,7.6,6.6,1.0,18,EL
110a95ca,6,540,6.0,6,6,0,0,6,16,-10,5.7,13.7,-8.0,18,EL
119b9a8e,6,540,6.0,6,6,0,0,8,5,3,9.6,7.3,2.3,18,EL
11a1a615,1,90,1.0,1,1,0,0,2,1,1,2.4,0.4,1.9,18,EL
11c0fa9d,8,333,3.7,3,2,5,0,8,7,1,8.4,6.4,2.0,18,EL
120c594d,2,102,1.1,1,1,1,2,3,1,2,1.8,0.8,1.1,18,EL
1238a3f9,3,238,2.6,3,2,0,0,5,4,1,4.6,4.1,0.5,18,EL
12947ab7,2,83,0.9,1,0,1,0,0,0,0,0.1,0.4,-0.3,18,EL
12dcbdcc,8,720,8.0,8,8,0,0,10,11,-1,8.9,11.4,-2.4,18,EL
12e6d21a,6,339,3.8,4,2,2,0,5,5,0,5.1,3.2,2.0,18,EL
130a7a3f,5,220,2.4,2,0,3,0,3,4,-1,2.6,4.6,-2.0,18,EL
1321d6f0,1,67,0.7,1,0,0,3,0,1,-1,0.3,1.2,-0.9,18,EL
134832c6,4,121,1.3,1,1,3,1,0,1,-1,1.2,1.4,-0.2,18,EL
136e7649,1,90,1.0,1,1,0,9,0,0,0,0.8,1.1,-0.3,18,EL
1381e699,3,122,1.4,1,1,2,5,1,0,1,1.4,1.8,-0.4,18,EL
13a78e01,8,720,8.0,8,8,0,0,14,13,1,9.2,12.4,-3.3,18,EL
13ac19de,10,900,10.0,10,10,0,0,14,14,0,10.1,11.8,-1.8,18,EL
13b0c150,5,450,5.0,5,5,0,2,8,6,2,8.2,5.6,2.6,18,EL
140afefb,1,25,0.3,0,0,1,0,0,2,-2,0.3,0.6,-0.4,18,EL
1432d037,3,152,1.7,2,0,1,2,1,2,-1,3.5,3.2,0.3,18,EL
1443ca7d,2,134,1.5,1,1,1,1,2,7,-5,1.0,4.1,-3.1,18,EL
144607cc,4,102,1.1,1,0,3,2,1,0,1,1.9,1.1,0.8,18,EL
14e8fe86,6,460,5.1,5,4,1,0,2,8,-6,4.2,7.0,-2.9,18,EL
15413fa5,5,450,5.0,5,5,0,0,6,5,1,6.5,5.2,1.3,18,EL
1598599e,4,272,3.0,3,2,1,3,6,5,1,3.7,5.7,-1.9,18,EL
15b949ab,2,160,1.8,2,1,0,1,1,2,-1,3.0,2.5,0.4,18,EL
15d0c248,10,831,9.2,10,8,0,0,14,12,2,16.4,7.4,9.0,18,EL
15e99107,1,24,0.3,0,0,1,0,0,1,-1,0.0,1.3,-1.2,18,EL
15e9c7e6,6,246,2.7,4,0,2,4,2,3,-1,3.2,1.6,1.6,18,EL
15fd5593,5,245,2.7,3,1,2,1,3,3,0,4.1,3.7,0.4,18,EL
16380240,7,609,6.8,7,5,0,0,14,6,8,13.2,8.8,4.4,18,EL
163bbd4a,3,34,0.4,0,0,3,0,1,0,1,1.0,1.3,-0.3,18,EL
16657b95,8,628,7.0,8,2,0,0,13,7,6,14.7,6.8,7.8,18,EL
1668b4b1,1,19,0.2,0,0,1,1,0,1,-1,0.1,0.3,-0.2,18,EL
166a981d,2,157,1.7,2,1,0,0,2,2,0,1.9,4.0,-2.1,18,EL
16952f65,5,435,4.8,5,3,0,1,4,9,-5,6.7,4.4,2.3,18,EL
169fd162,9,521,5.8,6,0,3,0,10,5,5,7.3,6.0,1.3,18,EL
16ceb862,6,540,6.0,6,6,0,0,14,4,10,11.7,5.5,6.3,18,EL
17370b95,5,264,2.9,2,2,3,1,3,5,-2,4.8,3.6,1.2,18,EL
173eb3cd,3,208,2.3,2,2,1,1,3,1,2,2.4,1.5,0.9,18,EL
1770bd68,8,720,8.0,8,8,0,0,10,8,2,10.0,11.8,-1.8,18,EL
1771f2c1,2,134,1.5,1,1,1,4,1,3,-2,2.9,2.2,0.7,18,EL
17e3e467,5,174,1.9,2,0,3,1,5,3,2,4.4,2.7,1.7,18,EL
182c10aa,5,436,4.8,5,4,0,0,5,8,-3,3.4,8.5,-5.1,18,EL
18682b13,3,270,3.0,3,3,0,2,1,4,-3,2.0,4.2,-2.2,18,EL
194ace07,4,256,2.8,4,2,0,2,3,4,-1,3.6,2.4,1.2,18,EL
197640fd,3,224,2.5,2,2,1,5,9,1,8,4.9,2.3,2.6,18,EL
19e4dca5,10,900,10.0,10,10,0,0,14,14,0,10.1,11.8,-1.8,18,EL
1a105265,2,142,1.6,2,0,0,1,2,2,0,1.4,1.9,-0.5,18,EL
1a4b9094,15,1000,11.1,11,10,4,0,11,12,-1,14.9,12.2,2.7,18,EL
1a63f024,6,509,5.7,6,4,0,0,4,4,0,7.5,5.9,1.6,18,EL
1a799243,14,1266,14.1,14,13,0,0,21,12,9,17.2,13.2,4.0,18,EL
1a97dc06,5,143,1.6,1,1,4,3,1,4,-3,2.5,2.7,-0.2,18,EL
1aa98b10,1,5,0.1,0,0,1,2,1,1,0,0.6,0.5,0.1,18,EL
1bd5735a,6,524,5.8,6,5,0,0,3,9,-6,5.2,8.2,-3.0,18,EL
1bf33a9a,3,172,1.9,2,0,1,0,3,3,0,2.8,2.9,-0.1,18,EL
1bfdb73a,6,540,6.0,6,6,0,0,1,8,-7,4.4,7.8,-3.4,18,EL
1c37137f,10,707,7.9,8,7,2,0,12,10,2,12.3,13.2,-1.0,18,EL
1c529186,5,346,3.8,4,3,1,1,10,3,7,6.2,3.3,3.0,18,EL
1c639185,7,500,5.6,6,5,1,1,5,8,-3,6.7,7.0,-0.3,18,EL
1c78737d,9,501,5.6,5,4,4,1,8,7,1,5.7,9.6,-3.9,18,EL
1c98558c,3,270,3.0,3,3,0,3,3,4,-1,3.4,4.0,-0.6,18,EL
1cfd188f,1,4,0.0,0,0,1,5,0,0,0,0.0,0.0,0.0,18,EL
1d1691ad,6,540,6.0,6,6,0,1,10,10,0,10.8,6.6,4.2,18,EL
1d2d5cc8,7,630,7.0,7,7,0,0,8,8,0,9.6,8.7,1.0,18,EL
1d5f96d9,2,8,0.1,0,0,2,5,0,0,0,0.4,0.2,0.2,18,EL
1d8e9add,5,383,4.3,5,4,0,0,6,8,-2,5.8,3.8,2.1,18,EL
1db295e5,6,540,6.0,6,6,0,0,9,11,-2,6.5,7.8,-1.3,18,EL
1de2f2de,5,381,4.2,5,2,0,1,4,6,-2,6.9,5.2,1.7,18,EL
1e062a01,6,510,5.7,5,5,1,0,5,10,-5,8.1,7.9,0.2,18,EL
1e064bfb,4,360,4.0,4,4,0,0,3,5,-2,4.0,7.6,-3.6,18,EL
1e29552f,1,90,1.0,1,1,0,3,1,1,0,1.5,1.0,0.5,18,EL
1e415dd6,4,360,4.0,4,4,0,2,3,5,-2,2.6,5.3,-2.7,18,EL
1ecb65be,5,424,4.7,5,3,0,0,13,3,10,10.2,4.3,6.0,18,EL
1f9bc0d4,2,90,1.0,1,0,1,2,1,2,-1,0.3,2.1,-1.8,18,EL
1fbbfbde,4,360,4.0,4,4,0,1,6,3,3,8.1,4.0,4.1,18,EL
1fe67e86,6,475,5.3,6,4,0,1,8,5,3,7.7,7.2,0.5,18,EL
20030c06,3,226,2.5,3,2,0,1,6,3,3,5.2,2.2,3.0,18,EL
20094685,13,957,10.6,11,5,2,2,16,11,5,16.9,10.6,6.3,18,EL
2042d931,3,176,2.0,2,0,1,2,1,1,0,2.8,2.1,0.7,18,EL
20730eae,1,16,0.2,0,0,1,1,0,2,-2,0.5,0.5,0.0,18,EL
2077ae86,1,10,0.1,0,0,1,0,0,0,0,0.0,0.0,0.0,18,EL
2079b3cc,8,469,5.2,5,3,3,0,6,8,-2,4.9,11.5,-6.6,18,EL
20c1ef47,6,431,4.8,5,3,1,0,5,13,-8,4.3,11.4,-7.1,18,EL
20dbf9e0,5,312,3.5,3,2,2,1,4,8,-4,5.2,5.8,-0.5,18,EL
213ab9bb,2,87,1.0,1,0,1,0,1,2,-1,1.0,1.0,-0.1,18,EL
2146785a,4,349,3.9,4,3,0,1,3,4,-1,5.5,2.7,2.8,18,EL
21519148,5,450,5.0,5,5,0,0,5,10,-5,4.8,8.6,-3.8,18,EL
2196d7d2,7,550,6.1,6,4,1,0,10,9,1,6.4,11.6,-5.2,18,EL
22551915,3,223,2.5,3,2,0,2,2,7,-5,2.1,4.3,-2.3,18,EL
22721b88,12,1011,11.2,11,9,1,2,16,11,5,17.1,10.3,6.8,18,EL
2277a390,4,360,4.0,4,4,0,2,0,7,-7,2.0,5.3,-3.4,18,EL
22b752ee,2,150,1.7,2,1,0,2,2,3,-1,2.5,3.2,-0.7,18,EL
22bfb57e,2,101,1.1,1,1,1,2,0,1,-1,0.6,2.8,-2.1,18,EL
22cd43d2,3,206,2.3,3,0,0,0,3,4,-1,2.6,3.2,-0.6,18,EL
2306bfde,2,100,1.1,1,0,1,2,2,3,-1,1.9,1.4,0.5,18,EL
2319ebe3,3,242,2.7,3,1,0,0,1,1,0,2.6,2.8,-0.2,18,EL
23c63b7f,2,30,0.3,0,0,2,0,1,0,1,0.2,0.4,-0.1,18,EL
2409762c,4,204,2.3,2,0,2,1,1,5,-4,1.2,5.8,-4.6,18,EL
242dbdeb,5,362,4.0,4,3,1,1,3,9,-6,3.7,4.9,-1.1,18,EL
248be14f,6,540,6.0,6,6,0,0,11,12,-1,5.8,9.3,-3.5,18,EL
24baba9d,6,540,6.0,6,6,0,0,11,12,-1,5.8,9.3,-3.5,18,EL
24e9421b,5,242,2.7,3,0,2,1,2,5,-3,4.0,5.2,-1.1,18,EL
25126342,8,720,8.0,8,8,0,0,8,8,0,8.9,9.1,-0.2,18,EL
2557c196,2,180,2.0,2,2,0,0,3,4,-1,1.9,2.2,-0.3,18,EL
2567b7b6,6,537,6.0,6,5,0,0,4,4,0,7.5,5.9,1.7,18,EL
25736bcf,4,360,4.0,4,4,0,1,4,8,-4,4.6,5.9,-1.3,18,EL
25763990,2,68,0.8,2,0,0,1,2,0,2,0.7,0.8,-0.1,18,EL
258aff54,8,617,6.9,7,5,1,0,6,7,-1,7.5,8.2,-0.7,18,EL
25c72b36,1,3,0.0,0,0,1,0,0,0,0,0.0,0.0,0.0,18,EL
26a796c1,5,260,2.9,3,1,2,3,5,3,2,2.7,2.6,0.1,18,EL
26b7d548,2,164,1.8,2,1,0,1,0,2,-2,1.5,2.1,-0.6,18,EL
273c483b,1,28,0.3,0,0,1,1,0,0,0,0.2,0.1,0.1,18,EL
27b1390c,3,89,1.0,1,0,2,0,2,1,1,0.5,0.6,-0.1,18,EL
27d2618c,1,90,1.0,1,1,0,1,1,2,-1,1.5,1.8,-0.3,18,EL
27d34558,2,22,0.2,0,0,2,0,0,0,0,0.6,0.0,0.6,18,EL
27d902c8,1,90,1.0,1,1,0,12,0,0,0,0.6,0.3,0.4,18,EL
27f0fcda,6,503,5.6,6,3,0,0,3,1,2,7.0,4.5,2.5,18,EL
27ff9bdb,1,44,0.5,0,0,1,1,0,1,-1,0.3,0.8,-0.5,18,EL
281659b5,4,352,3.9,4,3,0,0,6,8,-2,4.9,8.5,-3.6,18,EL
283699b4,5,352,3.9,4,3,1,1,3,6,-3,4.0,5.3,-1.3,18,EL
28aeafaa,6,456,5.1,5,4,1,0,1,19,-18,2.5,15.7,-13.2,18,EL
28baf8f6,3,106,1.2,1,0,2,3,1,3,-2,1.0,2.0,-0.9,18,EL
28c2d647,6,506,5.6,6,3,0,0,1,19,-18,3.1,16.6,-13.5,18,EL
29102874,5,480,5.3,5,5,0,4,11,9,2,6.9,8.1,-1.2,18,EL
293211e1,10,801,8.9,9,7,1,0,13,12,1,13.9,12.4,1.5,18,EL
2973d8ff,4,331,3.7,4,3,0,0,4,5,-1,4.3,6.3,-1.9,18,EL
29aee77c,1,82,0.9,1,0,0,0,2,0,2,1.3,0.6,0.7,18,EL
29ef0f49,5,409,4.5,5,3,0,0,6,13,-7,5.5,9.2,-3.7,18,EL
29f7cfd9,3,238,2.6,3,1,0,0,5,4,1,3.3,2.8,0.5,18,EL
2a1beb34,8,479,5.3,5,4,3,0,12,7,5,8.9,7.0,2.0,18,EL
2a6cd437,3,133,1.5,1,1,2,3,4,2,2,2.5,0.9,1.6,18,EL
2a82aa85,3,108,1.2,2,0,1,2,0,3,-3,0.7,3.0,-2.3,18,EL
2b16cb1a,4,339,3.8,4,2,0,0,9,5,4,5.9,6.2,-0.3,18,EL
2b3efa4a,3,224,2.5,2,2,1,2,1,3,-2,3.2,4.6,-1.4,18,EL
2b59d76f,6,453,5.0,5,4,1,0,4,6,-2,3.8,5.9,-2.0,18,EL
2b83fa49,2,180,2.0,2,2,0,3,1,1,0,1.5,2.3,-0.7,18,EL
2b9fdeea,12,762,8.5,9,2,3,0,14,10,4,12.4,7.9,4.6,18,EL
2bd83368,1,2,0.0,0,0,1,0,0,0,0,0.0,0.0,0.0,18,EL
2c0f8e9e,1,90,1.0,1,1,0,0,3,1,2,1.4,0.4,0.9,18,EL
2c125b75,5,184,2.0,1,1,4,0,0,2,-2,2.9,1.7,1.1,18,EL
2ccd89a3,6,540,6.0,6,6,0,0,6,6,0,8.0,7.7,0.3,18,EL
2cd3d3ce,6,528,5.9,6,5,0,0,9,15,-6,6.7,9.6,-2.9,18,EL
2d3b60c1,2,180,2.0,2,2,0,1,2,2,0,2.3,2.8,-0.4,18,EL
2d49b833,6,540,6.0,6,6,0,0,4,4,0,7.6,5.9,1.6,18,EL
2d970560,3,55,0.6,0,0,3,2,3,3,0,0.6,1.2,-0.6,18,EL
2deaf8b2,7,285,3.2,3,2,4,3,10,3,7,5.4,5.0,0.5,18,EL
2e06f387,1,19,0.2,0,0,1,0,1,0,1,0.3,0.1,0.2,18,EL
2e2ec9cf,5,110,1.2,1,1,4,2,0,3,-3,0.6,2.1,-1.5,18,EL
2e3596d1,5,385,4.3,5,4,0,0,7,6,1,4.3,7.7,-3.4,18,EL
2e8fc160,1,74,0.8,1,0,0,1,0,0,0,1.1,1.0,0.0,18,EL
2ebc1b44,5,441,4.9,5,3,0,0,6,2,4,6.4,4.5,1.9,18,EL
2f3452eb,2,76,0.8,1,0,1,0,2,0,2,0.8,0.8,0.0,18,EL
2f557579,2,127,1.4,1,1,1,0,2,3,-1,2.6,2.2,0.4,18,EL
2f798b41,2,180,2.0,2,2,0,6,2,2,0,2.8,2.3,0.4,18,EL
2f94b2a0,4,183,2.0,2,1,2,0,1,4,-3,0.8,3.6,-2.8,18,EL
2f9c21da,6,536,6.0,6,5,0,0,9,15,-6,6.7,9.6,-2.9,18,EL
2fd78b8e,3,133,1.5,1,1,2,1,1,4,-3,0.6,2.1,-1.5,18,EL
2ff964a0,1,71,0.8,1,0,0,0,0,1,-1,0.2,0.8,-0.6,18,EL
3061e1ec,6,540,6.0,6,6,0,0,3,9,-6,5.3,8.2,-2.9,18,EL
30643ce2,2,135,1.5,2,0,0,0,3,2,1,1.7,1.9,-0.3,18,EL
30c220c3,5,370,4.1,4,4,1,1,3,6,-3,6.9,7.5,-0.6,18,EL
314a0ea4,5,441,4.9,5,3,0,0,4,4,0,4.3,5.9,-1.5,18,EL
314bdac5,10,682,7.6,7,7,3,0,20,8,12,10.7,10.3,0.4,18,EL
314c2af0,2,180,2.0,2,2,0,6,1,2,-1,0.8,1.9,-1.1,18,EL
319322cd,5,450,5.0,5,5,0,0,5,9,-4,7.5,6.4,1.1,18,EL
31d7f557,2,180,2.0,2,2,0,0,3,3,0,2.8,3.0,-0.2,18,EL
31daff3a,4,267,3.0,3,1,1,0,1,3,-2,2.2,4.0,-1.7,18,EL
31e3ab68,5,450,5.0,5,5,0,1,8,11,-3,4.9,7.0,-2.2,18,EL
3200c583,6,540,6.0,6,6,0,0,7,8,-1,5.9,7.2,-1.3,18,EL
321a71a7,5,450,5.0,5,5,0,0,12,6,6,7.0,6.8,0.2,18,EL
3233eefd,1,90,1.0,1,1,0,0,0,3,-3,1.1,2.4,-1.4,18,EL
323b698f,2,158,1.8,2,1,0,2,1,2,-1,2.0,2.2,-0.3,18,EL
32c0491f,3,233,2.6,2,2,1,0,4,3,1,5.6,2.7,2.9,18,EL
33072e69,7,369,4.1,4,0,3,0,7,7,0,4.9,6.6,-1.7,18,EL
33332e0b,5,358,4.0,3,3,2,0,7,9,-2,6.0,5.6,0.4,18,EL
33591ff0,2,6,0.1,0,0,2,1,0,0,0,0.0,0.0,0.0,18,EL
3376a776,3,270,3.0,3,3,0,1,3,5,-2,4.4,5.0,-0.6,18,EL
3392603d,6,540,6.0,6,6,0,0,5,10,-5,7.5,6.0,1.5,18,EL
339fe0e8,10,900,10.0,10,10,0,1,23,13,10,19.7,10.3,9.4,18,EL
33c7af24,1,90,1.0,1,1,0,1,0,0,0,0.3,0.8,-0.6,18,EL
33d38e32,5,190,2.1,2,0,3,1,3,3,0,2.3,2.2,0.0,18,EL
3423f250,6,503,5.6,6,0,0,0,4,9,-5,4.8,6.7,-1.9,18,EL
346d51d9,2,171,1.9,2,1,0,1,3,4,-1,3.0,3.3,-0.3,18,EL
3470f44e,1,90,1.0,1,1,0,5,0,3,-3,0.6,1.6,-1.0,18,EL
3480cb6b,8,720,8.0,8,8,0,0,10,8,2,10.0,11.8,-1.8,18,EL
348e0505,5,432,4.8,5,3,0,1,0,8,-8,3.2,6.4,-3.3,18,EL
3493992e,6,108,1.2,1,0,5,0,2,1,1,2.1,2.3,-0.3,18,EL
34bf7740,4,65,0.7,0,0,4,2,0,3,-3,0.2,3.0,-2.8,18,EL
34c3ec17,1,90,1.0,1,1,0,1,1,3,-2,1.3,1.7,-0.4,18,EL
35375f7c,2,19,0.2,0,0,2,5,0,0,0,0.7,0.4,0.3,18,EL
35862524,6,472,5.2,6,3,0,0,2,17,-15,2.9,13.9,-11.0,18,EL
35bec436,4,257,2.9,3,1,1,2,3,5,-2,2.7,3.3,-0.6,18,EL
35dd6d80,9,810,9.0,9,9,0,1,20,8,12,12.3,12.2,0.1,18,EL
3626daea,6,540,6.0,6,6,0,0,9,7,2,10.9,7.0,3.9,18,EL
36a3ff67,4,229,2.5,3,1,1,0,3,4,-1,3.8,4.2,-0.4,18,EL
36d320ec,1,90,1.0,1,1,0,1,2,3,-1,2.3,1.5,0.8,18,EL
36f288ba,2,180,2.0,2,2,0,1,1,6,-5,1.0,5.4,-4.4,18,EL
3708e9fa,5,450,5.0,5,5,0,0,6,9,-3,5.7,10.1,-4.5,18,EL
375622c5,6,286,3.2,3,1,3,3,5,5,0,6.2,4.4,1.8,18,EL
3799e138,6,527,5.9,6,5,0,0,8,8,0,7.0,9.3,-2.2,18,EL
37f606f0,4,174,1.9,2,0,2,0,2,3,-1,1.4,1.0,0.4,18,EL
3811e046,2,102,1.1,1,0,1,2,0,1,-1,1.2,0.8,0.4,18,EL
3904e745,6,466,5.2,5,5,1,0,7,10,-3,6.3,7.4,-1.1,18,EL
390eb94b,2,50,0.6,0,0,2,0,0,3,-3,0.5,1.0,-0.5,18,EL
3935e52e,5,224,2.5,2,1,3,4,7,2,5,4.8,2.8,2.0,18,EL
394c5d32,4,157,1.7,1,0,3,0,2,2,0,1.8,2.4,-0.6,18,EL
3959661b,4,154,1.7,2,0,2,2,2,1,1,1.0,1.9,-0.9,18,EL
3a8b9635,2,59,0.7,1,0,1,0,0,1,-1,0.7,0.6,0.1,18,EL
3ad17caa,2,46,0.5,0,0,2,2,1,3,-2,0.3,2.4,-2.1,18,EL
3ad56bf8,3,226,2.5,3,2,0,2,4,3,1,3.4,3.7,-0.3,18,EL
3b333ac3,8,700,7.8,8,7,0,0,14,7,7,15.2,8.7,6.5,18,EL
3b57f7f8,7,555,6.2,7,3,0,0,13,9,4,11.0,6.3,4.7,18,EL
3b99b9e1,6,399,4.4,5,1,1,0,5,6,-1,3.5,6.1,-2.6,18,EL
3c285843,2,180,2.0,2,2,0,3,2,4,-2,1.7,4.8,-3.0,18,EL
3cd9e95a,6,540,6.0,6,6,0,0,7,8,-1,6.9,6.6,0.4,18,EL
3cefcaef,7,387,4.3,4,4,3,1,6,2,4,7.4,4.1,3.3,18,EL
3cfc870f,5,283,3.1,3,1,2,0,4,2,2,3.7,3.8,-0.2,18,EL
3d0fd3d7,1,5,0.1,0,0,1,1,0,0,0,0.6,0.0,0.6,18,EL
3d13d9e4,1,1,0.0,0,0,1,3,0,0,0,0.0,0.1,-0.1,18,EL
3d227f54,1,13,0.1,0,0,1,2,0,1,-1,0.1,1.2,-1.2,18,EL
3d68d631,2,114,1.3,1,0,1,2,2,0,2,1.0,0.9,0.2,18,EL
3d7b7d68,1,8,0.1,0,0,1,1,0,0,0,0.1,0.6,-0.6,18,EL
3da610eb,5,363,4.0,4,2,1,0,3,6,-3,4.0,4.7,-0.7,18,EL
3db34c8e,6,431,4.8,4,4,2,0,2,8,-6,4.7,5.8,-1.2,18,EL
3dfc70ed,1,14,0.2,0,0,1,0,0,0,0,0.4,0.0,0.3,18,EL
3e092724,3,262,2.9,3,2,0,0,2,5,-3,2.6,5.2,-2.6,18,EL
3e587547,1,90,1.0,1,1,0,1,0,3,-3,0.4,2.8,-2.3,18,EL
3ead85f9,8,688,7.6,8,6,0,0,13,10,3,10.4,8.3,2.1,18,EL
3eb0f2df,2,118,1.3,1,1,1,0,0,0,0,1.5,1.2,0.3,18,EL
3ecc11d8,4,314,3.5,4,3,0,0,5,7,-2,3.4,5.4,-2.0,18,EL
3ef0fa48,5,474,5.3,5,4,0,0,7,5,2,11.2,5.5,5.6,18,EL
3effaa34,10,722,8.0,8,5,2,0,15,7,8,11.7,6.7,5.0,18,EL
3f2d59fe,8,720,8.0,8,8,0,2,19,8,11,18.2,10.8,7.3,18,EL
3f30b506,3,218,2.4,3,2,0,1,5,3,2,3.3,2.8,0.5,18,EL
3f359b33,4,349,3.9,4,3,0,0,9,5,4,7.7,4.5,3.3,18,EL
3faa1780,2,180,2.0,2,2,0,1,2,4,-2,2.9,2.4,0.6,18,EL
3fc45c73,3,270,3.0,3,3,0,0,5,3,2,7.4,1.6,5.7,18,EL
404a2746,4,354,3.9,4,3,0,2,6,6,0,2.7,7.3,-4.6,18,EL
40f0ed6c,3,196,2.2,2,1,1,0,7,3,4,3.3,1.2,2.1,18,EL
410c2fbc,4,360,4.0,4,4,0,0,2,12,-10,2.5,12.4,-9.9,18,EL
4114f306,2,180,2.0,2,2,0,1,1,4,-3,1.3,2.5,-1.2,18,EL
414f7c7d,1,10,0.1,0,0,1,5,0,0,0,0.0,0.7,-0.7,18,EL
41582151,5,406,4.5,5,4,0,0,2,4,-2,3.0,5.4,-2.4,18,EL
418befe0,2,180,2.0,2,2,0,0,1,3,-2,1.7,2.5,-0.8,18,EL
41afd8cf,5,395,4.4,5,3,0,0,3,7,-4,3.6,5.7,-2.1,18,EL
42276181,5,254,2.8,3,0,2,3,4,2,2,4.0,4.2,-0.2,18,EL
423e3d0b,5,343,3.8,4,2,1,0,1,11,-10,2.4,11.1,-8.7,18,EL
4285332d,5,450,5.0,5,5,0,0,1,8,-7,3.7,5.4,-1.7,18,EL
42a6cc47,1,10,0.1,0,0,1,0,0,0,0,0.0,0.0,0.0,18,EL
42dcf26d,3,270,3.0,3,3,0,4,3,4,-1,4.9,5.8,-0.9,18,EL
42ec696a,6,540,6.0,6,6,0,0,7,9,-2,7.4,11.2,-3.8,18,EL
42fe6b05,3,171,1.9,2,0,1,0,3,3,0,1.9,3.0,-1.1,18,EL
4315f30d,3,270,3.0,3,3,0,4,2,5,-3,2.7,5.7,-3.0,18,EL
4326c2a9,1,23,0.3,0,0,1,0,2,0,2,0.5,0.5,0.0,18,EL
43309491,1,8,0.1,0,0,1,0,1,0,1,0.3,0.0,0.3,18,EL
435f829f,1,90,1.0,1,1,0,0,1,1,0,0.8,0.9,-0.1,18,EL
4383b0da,5,122,1.4,0,0,5,1,2,0,2,2.4,1.9,0.5,18,EL
438ae11e,6,452,5.0,5,4,1,0,2,11,-9,4.0,9.3,-5.3,18,EL
43cd8b69,8,574,6.4,6,1,2,0,12,9,3,8.6,9.6,-1.0,18,EL
43d249bd,6,506,5.6,6,4,0,0,9,11,-2,6.2,7.6,-1.5,18,EL
441950f5,2,180,2.0,2,2,0,2,3,1,2,2.1,1.5,0.6,18,EL
4431aed2,9,581,6.5,5,3,4,0,19,10,9,14.9,8.0,6.9,18,EL
4442fbcd,8,720,8.0,8,8,0,0,10,11,-1,8.9,11.4,-2.4,18,EL
44865466,5,373,4.1,4,4,1,0,3,11,-8,2.8,9.9,-7.1,18,EL
448a3608,4,168,1.9,2,1,2,1,8,0,8,5.0,0.9,4.1,18,EL
44f050bc,2,180,2.0,2,2,0,2,2,4,-2,2.0,4.5,-2.4,18,EL
450ad405,5,441,4.9,5,4,0,0,4,7,-3,4.6,5.3,-0.8,18,EL
45db685d,1,8,0.1,0,0,1,1,1,0,1,0.5,0.0,0.5,18,EL
46152b69,4,320,3.6,4,1,0,0,6,7,-1,3.7,4.8,-1.1,18,EL
46a8347f,4,144,1.6,2,0,2,3,5,0,5,3.2,1.6,1.6,18,EL
46d50339,5,448,5.0,5,4,0,0,12,5,7,7.0,6.3,0.7,18,EL
47064058,5,450,5.0,5,5,0,0,7,9,-2,6.5,4.9,1.6,18,EL
4737cebe,6,367,4.1,3,3,3,2,8,9,-1,7.2,5.7,1.5,18,EL
474cf8e0,1,14,0.2,0,0,1,5,0,0,0,0.2,0.1,0.0,18,EL
4760b2f2,7,630,7.0,7,7,0,1,7,8,-1,6.5,7.8,-1.3,18,EL
47a34c4f,12,839,9.3,9,8,3,0,22,8,14,18.1,9.0,9.1,18,EL
4806ec67,3,270,3.0,3,3,0,2,3,7,-4,3.2,3.6,-0.5,18,EL
4841ba80,3,270,3.0,3,3,0,3,0,6,-6,2.3,3.7,-1.4,18,EL
488350bf,4,214,2.4,3,1,1,0,0,3,-3,1.2,3.7,-2.5,18,EL
48add958,3,210,2.3,2,2,1,0,2,2,0,2.5,2.2,0.3,18,EL
491d3ad0,2,21,0.2,0,0,2,2,0,0,0,0.3,0.2,0.1,18,EL
493924a7,6,464,5.2,5,5,1,0,6,7,-1,7.0,5.1,1.9,18,EL
494bff86,4,105,1.2,1,0,3,2,2,3,-1,1.8,2.6,-0.8,18,EL
49ea92be,9,461,5.1,5,2,4,1,6,6,0,7.8,7.6,0.2,18,EL
49fe9070,5,445,4.9,5,4,0,1,7,4,3,8.4,4.8,3.6,18,EL
4a895384,8,686,7.6,8,7,0,2,11,13,-2,10.7,12.5,-1.8,18,EL
4a97f4c2,5,295,3.3,3,1,2,1,1,5,-4,3.1,3.7,-0.6,18,EL
4aea5077,14,1290,14.3,14,14,0,0,21,13,8,17.5,13.3,4.2,18,EL
4bd414c1,1,90,1.0,1,1,0,1,2,0,2,1.8,0.3,1.5,18,EL
4c07f0e8,8,713,7.9,8,7,0,0,7,9,-2,7.0,9.4,-2.4,18,EL
4c45cdc2,6,455,5.1,6,2,0,0,5,7,-2,5.6,8.6,-2.9,18,EL
4c54b6ec,1,90,1.0,1,1,0,1,0,0,0,0.3,1.3,-1.0,18,EL
4c5e78da,6,451,5.0,5,4,1,0,1,9,-8,3.5,6.1,-2.6,18,EL
4c6facae,4,346,3.8,4,3,0,1,4,6,-2,5.8,4.2,1.6,18,EL
4c78b5ed,9,668,7.4,7,6,2,2,18,12,6,15.6,7.2,8.4,18,EL
4c82730b,6,504,5.6,6,4,0,0,6,16,-10,5.1,13.4,-8.3,18,EL
4cc82fe1,6,540,6.0,6,6,0,0,9,6,3,10.1,8.3,1.8,18,EL
4d478e8b,7,376,4.2,4,3,3,1,4,9,-5,5.0,7.2,-2.2,18,EL
4d64b28e,2,180,2.0,2,2,0,4,3,4,-1,2.7,1.5,1.2,18,EL
4dedd469,6,530,5.9,6,5,0,0,2,2,0,7.6,5.6,2.0,18,EL
4e034598,3,270,3.0,3,3,0,3,5,6,-1,3.6,3.2,0.4,18,EL
4e0afc5d,4,360,4.0,4,4,0,1,11,3,8,6.4,4.5,1.9,18,EL
4e219ad2,7,433,4.8,4,3,3,0,6,7,-1,7.0,6.0,1.0,18,EL
4e3f5992,6,431,4.8,5,3,1,0,2,6,-4,3.5,7.1,-3.5,18,EL
4e6dbac4,8,524,5.8,5,4,3,1,14,7,7,11.1,6.7,4.3,18,EL
4e80a8ef,6,512,5.7,6,4,0,0,6,15,-9,5.5,13.3,-7.9,18,EL
4f182a8f,5,261,2.9,2,0,3,2,3,3,0,4.1,2.4,1.7,18,EL
50310821,1,90,1.0,1,1,0,1,1,3,-2,1.3,1.7,-0.4,18,EL
504a654c,2,11,0.1,0,0,2,5,0,0,0,0.7,0.2,0.5,18,EL
507c7bdf,6,567,6.3,6,5,0,0,10,8,2,12.2,6.9,5.2,18,EL
50c1ff86,5,196,2.2,2,2,3,3,1,1,0,2.5,2.8,-0.2,18,EL
50ccf47d,8,720,8.0,8,8,0,0,7,6,1,9.9,7.2,2.7,18,EL
50e14b3c,2,46,0.5,1,0,1,1,1,1,0,0.1,0.9,-0.8,18,EL
512a52c6,7,410,4.6,4,2,3,0,5,8,-3,6.1,7.7,-1.6,18,EL
518738b4,6,350,3.9,5,1,1,0,5,10,-5,5.5,7.9,-2.3,18,EL
51a3caf1,5,58,0.6,5,1,0,1,1,2,-1,2.0,1.7,0.3,18,EL
51b41c5c,5,383,4.3,5,2,0,0,5,8,-3,4.3,5.5,-1.2,18,EL
51e9bb3f,6,331,3.7,4,1,2,0,3,8,-5,2.5,6.6,-4.1,18,EL
520c318f,2,63,0.7,0,0,2,0,2,0,2,0.9,0.7,0.3,18,EL
5294a83f,9,644,7.2,8,4,1,1,17,8,9,12.4,6.4,6.0,18,EL
529f49ab,8,477,5.3,5,4,3,1,15,3,12,8.8,5.9,2.9,18,EL
52e101a8,1,45,0.5,0,0,1,1,0,1,-1,0.4,1.3,-0.9,18,EL
52ec54d0,9,726,8.1,8,7,1,1,16,9,7,12.8,8.5,4.4,18,EL
532e1e4f,1,90,1.0,1,1,0,1,0,1,-1,1.3,1.2,0.1,18,EL
53520a67,4,236,2.6,3,1,1,0,2,2,0,1.9,2.9,-1.1,18,EL
53685aa2,2,180,2.0,2,2,0,3,2,3,-1,2.0,2.6,-0.6,18,EL
53b03dac,6,540,6.0,6,6,0,0,4,6,-2,4.3,6.9,-2.6,18,EL
53de807a,6,540,6.0,6,6,0,3,14,9,5,12.6,5.8,6.8,18,EL
53e07d0b,1,24,0.3,0,0,1,0,1,2,-1,0.6,0.5,0.1,18,EL
54131505,3,124,1.4,1,0,2,1,1,3,-2,0.9,2.7,-1.8,18,EL
54771b10,8,720,8.0,8,8,0,0,14,13,1,9.2,12.4,-3.3,18,EL
549922a7,1,90,1.0,1,1,0,3,1,5,-4,0.5,1.6,-1.1,18,EL
54b4dc4e,4,317,3.5,4,2,0,0,5,5,0,5.4,3.1,2.4,18,EL
54c9ed15,2,180,2.0,2,2,0,0,1,3,-2,1.4,2.3,-0.9,18,EL
54e0c0cc,5,60,0.7,0,0,5,1,0,0,0,1.4,0.5,0.9,18,EL
55126f3b,9,756,8.4,9,7,0,0,20,4,16,13.2,8.2,5.0,18,EL
555311f2,5,404,4.5,5,3,0,0,2,6,-4,4.6,5.5,-0.9,18,EL
555d5edd,3,238,2.6,3,1,0,1,5,3,2,3.5,1.4,2.1,18,EL
5594dfa6,2,47,0.5,0,0,2,1,0,2,-2,0.1,0.7,-0.6,18,EL
5595a4ff,4,360,4.0,4,4,0,1,3,5,-2,3.9,5.8,-1.8,18,EL
5631b735,8,707,7.9,8,6,0,0,3,3,0,9.2,7.7,1.5,18,EL
56ae428b,6,480,5.3,5,5,1,0,5,7,-2,5.2,6.2,-1.0,18,EL
5700824a,5,446,5.0,5,4,0,0,4,10,-6,4.8,5.5,-0.7,18,EL
5710a281,5,450,5.0,5,5,0,3,13,6,7,9.0,3.5,5.4,18,EL
57ae16f4,5,338,3.8,4,2,1,1,4,7,-3,5.2,7.0,-1.8,18,EL
57f60036,6,540,6.0,6,6,0,1,8,9,-1,7.1,10.5,-3.4,18,EL
583d6c1f,1,31,0.3,0,0,1,1,1,0,1,0.7,0.2,0.5,18,EL
58a3b151,1,28,0.3,0,0,1,0,0,0,0,0.4,0.2,0.2,18,EL
58ad9383,6,540,6.0,6,6,0,0,1,8,-7,4.4,7.8,-3.4,18,EL
58ae47b2,12,812,9.0,9,4,3,1,17,9,8,15.4,8.4,6.9,18,EL
58dda688,6,540,6.0,6,6,0,0,7,8,-1,5.9,7.2,-1.3,18,EL
59b7d823,9,741,8.2,8,8,1,1,13,9,4,11.7,10.6,1.1,18,EL
59e6e5bf,5,229,2.5,2,1,3,0,1,12,-11,2.2,5.2,-3.0,18,EL
59f0c185,2,180,2.0,2,2,0,7,5,2,3,2.7,3.7,-1.0,18,EL
5a1c49d1,2,119,1.3,1,1,1,4,2,1,1,0.9,1.6,-0.7,18,EL
5a5d394c,3,270,3.0,3,3,0,3,7,4,3,3.8,3.8,0.0,18,EL
5a969ba8,4,305,3.4,3,1,1,0,4,3,1,3.4,4.6,-1.2,18,EL
5ada5385,3,117,1.3,1,1,2,5,2,3,-1,1.4,3.5,-2.1,18,EL
5b0b23dc,5,337,3.7,3,3,2,0,4,8,-4,5.2,3.9,1.3,18,EL
5b61fba7,1,12,0.1,0,0,1,2,1,1,0,0.0,0.1,-0.1,18,EL
5b6cf07c,3,102,1.1,1,0,2,0,0,0,0,0.7,1.6,-0.9,18,EL
5b887c7a,5,416,4.6,5,4,0,0,6,7,-1,9.3,5.0,4.3,18,EL
5ba3c9cb,6,272,3.0,4,0,2,0,2,11,-9,1.7,9.1,-7.5,18,EL
5be28712,3,270,3.0,3,3,0,1,7,4,3,6.4,3.2,3.2,18,EL
5c46e908,6,374,4.2,3,3,3,0,5,6,-1,3.4,6.2,-2.9,18,EL
5c4dc0ff,9,684,7.6,8,3,1,0,14,6,8,12.7,8.5,4.2,18,EL
5c7845f6,5,288,3.2,3,3,2,2,13,2,11,12.3,2.0,10.3,18,EL
5c899683,2,106,1.2,1,1,1,2,1,1,0,0.8,1.0,-0.2,18,EL
5caa62a7,6,498,5.5,6,3,0,0,7,8,-1,7.9,7.7,0.2,18,EL
5cb1d026,9,771,8.6,9,7,0,0,13,8,5,9.4,9.8,-0.4,18,EL
5cdddffa,10,707,7.9,8,6,2,0,13,7,6,11.5,8.5,3.0,18,EL
5ce0b5ba,8,574,6.4,6,5,2,0,16,7,9,16.5,5.9,10.5,18,EL
5d0d1ec7,4,360,4.0,4,4,0,0,4,5,-1,6.6,3.8,2.9,18,EL
5d13b8ab,5,263,2.9,2,2,3,1,2,3,-1,3.8,2.2,1.6,18,EL
5d2bb85b,4,255,2.8,3,1,1,1,3,9,-6,2.4,7.0,-4.6,18,EL
5d311e8d,1,76,0.8,1,0,0,0,1,1,0,1.4,0.4,1.0,18,EL
5d5219b1,6,435,4.8,5,3,1,0,6,7,-1,6.9,4.6,2.3,18,EL
5db295be,2,120,1.3,1,1,1,0,1,0,1,1.5,1.3,0.2,18,EL
5db2faf1,6,467,5.2,4,4,2,0,6,13,-7,6.6,9.6,-3.0,18,EL
5e8936be,8,720,8.0,8,8,0,0,3,3,0,9.5,8.2,1.2,18,EL
5e91ddf8,6,540,6.0,6,6,0,0,6,11,-5,6.1,9.8,-3.7,18,EL
5ed9b537,4,314,3.5,3,3,1,2,3,7,-4,3.6,6.3,-2.7,18,EL
5f9970a0,2,180,2.0,2,2,0,4,1,7,-6,3.5,4.9,-1.4,18,EL
5fdd516f,7,630,7.0,7,7,0,1,9,11,-2,7.6,13.5,-5.9,18,EL
601299e9,6,382,4.2,5,0,1,0,4,8,-4,3.7,7.7,-4.0,18,EL
601be846,3,67,0.7,1,0,2,3,0,2,-2,0.6,1.6,-1.0,18,EL
602bb3f7,6,540,6.0,6,6,0,0,9,16,-7,6.7,10.3,-3.6,18,EL
603cb947,4,360,4.0,4,4,0,1,4,8,-4,5.6,4.4,1.2,18,EL
605873e1,5,450,5.0,5,5,0,0,9,12,-3,5.1,8.5,-3.3,18,EL
60713cb3,3,270,3.0,3,3,0,3,8,5,3,7.2,2.8,4.4,18,EL
60963682,4,265,2.9,3,2,1,1,2,6,-4,2.9,4.1,-1.3,18,EL
60e86875,8,358,4.0,3,1,5,2,7,5,2,4.9,4.9,0.0,18,EL
60fd5334,3,230,2.6,3,1,0,0,4,6,-2,2.5,4.2,-1.8,18,EL
612cb8d3,4,192,2.1,3,0,1,0,1,4,-3,2.9,1.4,1.5,18,EL
615c4d8f,5,424,4.7,5,3,0,0,4,7,-3,6.9,4.8,2.1,18,EL
61ae3d36,7,441,4.9,6,2,1,1,6,5,1,6.2,8.5,-2.3,18,EL
61b0b44d,3,270,3.0,3,3,0,0,5,4,1,3.8,3.1,0.6,18,EL
61f63784,9,734,8.2,8,8,1,0,14,8,6,12.9,10.2,2.7,18,EL
6257811f,1,34,0.4,0,0,1,1,0,1,-1,0.2,0.5,-0.3,18,EL
625c144a,8,706,7.8,8,7,0,0,19,10,9,20.1,7.2,12.9,18,EL
62a0089e,2,36,0.4,0,0,2,0,1,0,1,0.5,0.1,0.4,18,EL
62e4f112,8,572,6.4,6,0,2,0,0,0,0,0.0,0.0,0.0,18,EL
63a60d73,2,180,2.0,2,2,0,4,1,1,0,0.9,1.9,-1.0,18,EL
63fe0133,6,527,5.9,6,5,0,0,8,15,-7,6.4,9.8,-3.3,18,EL
6407ce4d,5,97,1.1,0,0,5,0,3,1,2,1.2,1.0,0.2,18,EL
6419c6f7,6,507,5.6,6,5,0,0,1,8,-7,3.8,6.0,-2.2,18,EL
642bb0c6,1,3,0.0,0,0,1,5,0,0,0,0.0,0.1,0.0,18,EL
6434f10d,6,458,5.1,5,5,1,1,9,7,2,9.3,7.4,1.8,18,EL
6435e737,6,502,5.6,5,5,1,0,7,8,-1,6.8,5.9,1.0,18,EL
6448e765,3,179,2.0,2,1,1,2,1,4,-3,1.3,3.1,-1.8,18,EL
644faf10,2,53,0.6,0,0,2,1,1,2,-1,1.0,1.5,-0.5,18,EL
64a674d9,6,329,3.7,4,0,2,0,8,4,4,3.8,3.9,0.0,18,EL
64ded08c,6,413,4.6,4,4,2,0,4,6,-2,4.9,5.9,-1.0,18,EL
64e801aa,8,708,7.9,8,7,0,0,3,3,0,8.7,8.2,0.5,18,EL
64ec2f85,6,450,5.0,5,4,1,1,7,8,-1,4.1,8.1,-4.0,18,EL
6503ae16,4,360,4.0,4,4,0,4,3,3,0,3.5,4.5,-1.0,18,EL
65166f80,2,95,1.1,1,0,1,1,1,1,0,0.8,1.1,-0.3,18,EL
6554bb97,2,180,2.0,2,2,0,0,1,3,-2,1.4,2.3,-0.9,18,EL
65adf2db,4,66,0.7,1,0,3,2,0,1,-1,0.4,0.2,0.2,18,EL
65d750b5,8,575,6.4,6,6,2,1,13,2,11,9.8,5.7,4.1,18,EL
6603fed7,4,134,1.5,1,0,3,2,3,2,1,2.1,2.8,-0.7,18,EL
6613c819,5,450,5.0,5,5,0,1,5,5,0,6.9,6.5,0.4,18,EL
668f2f7c,4,360,4.0,4,4,0,2,2,3,-1,2.6,4.5,-1.8,18,EL
676ff98c,1,14,0.2,0,0,1,0,0,0,0,0.1,0.2,-0.1,18,EL
6800f515,2,152,1.7,2,1,0,0,1,3,-2,1.1,2.1,-1.0,18,EL
6809ec76,6,487,5.4,5,5,1,0,1,9,-8,3.8,6.6,-2.8,18,EL
68252d6d,6,431,4.8,5,1,1,1,8,4,4,9.9,4.5,5.4,18,EL
683b919f,1,67,0.7,1,0,0,2,1,1,0,0.3,0.3,0.0,18,EL
685857dc,5,318,3.5,4,2,1,1,2,9,-7,4.9,7.6,-2.7,18,EL
68635c10,4,360,4.0,4,4,0,2,6,4,2,5.6,4.0,1.6,18,EL
68829001,3,242,2.7,3,2,0,1,4,4,0,3.6,4.0,-0.4,18,EL
68a87d66,1,6,0.1,0,0,1,1,0,0,0,0.2,0.1,0.0,18,EL
692d8bb0,5,375,4.2,4,1,1,0,7,9,-2,5.8,7.2,-1.5,18,EL
69960ac3,3,203,2.3,3,2,0,1,2,1,1,1.6,1.5,0.1,18,EL
699fb8db,4,360,4.0,4,4,0,0,6,7,-1,5.4,4.3,1.1,18,EL
6a5a9744,4,277,3.1,3,0,1,0,0,0,0,0.0,0.0,0.0,18,EL
6a99e0b1,10,794,8.8,9,4,1,0,12,11,1,12.9,10.0,2.9,18,EL
6b2c894b,5,450,5.0,5,5,0,0,4,8,-4,4.0,6.4,-2.4,18,EL
6b6cbca4,5,406,4.5,5,4,0,0,6,5,1,6.5,5.6,0.9,18,EL
6b85f966,2,102,1.1,1,1,1,1,2,0,2,2.0,1.4,0.6,18,EL
6b8b53d7,1,21,0.2,0,0,1,0,0,0,0,0.1,0.3,-0.1,18,EL
6bb2c084,14,584,6.5,4,3,10,1,3,6,-3,7.6,7.8,-0.2,18,EL
6be86f3d,1,18,0.2,0,0,1,0,0,0,0,0.0,0.2,-0.2,18,EL
6bfaecc4,4,360,4.0,4,4,0,4,4,6,-2,3.6,5.0,-1.4,18,EL
6bff8a73,4,360,4.0,4,4,0,1,7,9,-2,4.4,4.7,-0.2,18,EL
6c228bb6,2,180,2.0,2,2,0,2,2,3,-1,2.9,2.8,0.1,18,EL
6c6a3300,6,451,5.0,5,4,1,0,5,10,-5,5.9,5.5,0.5,18,EL
6c6e2719,5,450,5.0,5,5,0,0,6,6,0,5.6,6.2,-0.5,18,EL
6c7e441a,3,175,1.9,2,1,1,0,1,2,-1,1.7,3.0,-1.3,18,EL
6ca5ec4b,6,334,3.7,3,1,3,4,7,4,3,6.0,3.2,2.8,18,EL
6cafd68d,5,386,4.3,5,3,0,0,4,7,-3,4.7,4.7,0.0,18,EL
6cd38213,6,540,6.0,6,6,0,0,3,20,-17,3.6,16.8,-13.3,18,EL
6ceef869,2,165,1.8,2,1,0,2,1,7,-6,0.4,2.9,-2.5,18,EL
6d3f2898,2,180,2.0,2,2,0,0,3,4,-1,1.9,2.2,-0.3,18,EL
6dce77a5,7,528,5.9,5,5,2,1,10,7,3,9.8,7.2,2.6,18,EL
6dfd8f05,2,92,1.0,1,1,1,0,0,1,-1,0.7,0.9,-0.2,18,EL
6e4df551,7,606,6.7,7,5,0,0,16,6,10,13.7,7.6,6.2,18,EL
6e5497ca,7,522,5.8,5,2,2,0,7,4,3,7.9,4.0,3.9,18,EL
6e7f1353,13,1066,11.8,12,8,1,2,11,13,-2,15.2,12.0,3.3,18,EL
6e8272e0,6,392,4.4,5,2,1,0,4,4,0,3.5,4.3,-0.8,18,EL
6e905b8d,2,180,2.0,2,2,0,3,1,2,-1,1.5,2.1,-0.6,18,EL
6f4cf369,4,271,3.0,3,3,1,3,3,6,-3,2.4,7.3,-4.9,18,EL
6f5f82c0,2,180,2.0,2,2,0,1,9,0,9,9.5,0.8,8.8,18,EL
6f639ec7,9,769,8.5,8,7,1,0,18,10,8,14.5,10.9,3.5,18,EL
6fd1ba62,9,546,6.1,5,3,4,1,13,10,3,9.9,8.9,1.0,18,EL
705f5269,1,90,1.0,1,1,0,7,0,0,0,0.8,0.3,0.6,18,EL
706a60e1,6,136,1.5,1,0,5,1,3,1,2,2.7,1.5,1.3,18,EL
70a9cba5,6,107,1.2,0,0,6,0,0,1,-1,2.0,0.9,1.1,18,EL
70c52749,6,540,6.0,6,6,0,0,6,11,-5,6.1,9.8,-3.7,18,EL
70e5566a,1,11,0.1,0,0,1,2,0,0,0,0.4,0.0,0.3,18,EL
71672fa0,3,270,3.0,3,3,0,5,7,3,4,7.4,3.4,4.1,18,EL
71a998b9,8,720,8.0,8,8,0,0,9,12,-3,8.8,13.0,-4.2,18,EL
71d5ca31,9,765,8.5,9,8,0,1,17,13,4,16.6,12.5,4.1,18,EL
71ec39ef,9,764,8.5,8,8,1,1,16,7,9,14.3,8.3,6.1,18,EL
7214c684,2,131,1.5,1,0,1,1,1,2,-1,2.1,2.3,-0.2,18,EL
721608e5,1,17,0.2,0,0,1,1,0,0,0,0.1,0.3,-0.2,18,EL
729e3e14,5,377,4.2,4,4,1,1,6,6,0,4.5,5.1,-0.6,18,EL
72c812f3,2,107,1.2,2,0,0,3,1,1,0,0.8,1.1,-0.3,18,EL
731e29b8,9,740,8.2,9,2,0,1,7,8,-1,10.6,12.3,-1.7,18,EL
73221bb0,1,17,0.2,0,0,1,3,0,0,0,0.8,0.0,0.8,18,EL
7352dca8,3,189,2.1,3,0,0,1,4,4,0,2.3,3.1,-0.7,18,EL
741e058f,1,74,0.8,1,0,0,0,0,2,-2,0.8,0.6,0.1,18,EL
746b64a7,6,540,6.0,6,6,0,0,6,16,-10,5.7,13.7,-8.0,18,EL
7483d9f9,8,731,8.1,8,7,0,0,13,11,2,10.1,9.7,0.4,18,EL
74bafc9c,10,595,6.6,8,1,2,0,9,8,1,10.1,9.0,1.2,18,EL
74d70fb5,3,242,2.7,3,2,0,0,2,4,-2,4.7,4.4,0.4,18,EL
75229233,6,540,6.0,6,6,0,0,8,4,4,8.1,8.9,-0.8,18,EL
762179d9,7,309,3.4,2,0,5,0,4,2,2,4.9,5.3,-0.3,18,EL
7628b359,6,465,5.2,5,5,1,0,7,8,-1,4.7,8.1,-3.4,18,EL
76806215,8,750,8.3,8,8,0,7,12,7,5,12.8,6.9,5.9,18,EL
768667c0,1,2,0.0,0,0,1,5,0,0,0,0.0,0.2,-0.2,18,EL
768a35ac,1,13,0.1,0,0,1,0,0,0,0,0.3,0.8,-0.5,18,EL
76d5857d,5,330,3.7,4,2,1,4,3,4,-1,3.6,6.5,-2.8,18,EL
76d753f8,6,527,5.9,6,5,0,0,4,14,-10,4.2,12.4,-8.2,18,EL
76dd1480,4,303,3.4,3,3,1,0,3,9,-6,3.6,4.9,-1.3,18,EL
76ecfb22,3,124,1.4,1,0,2,1,4,1,3,2.4,1.3,1.1,18,EL
7750462c,5,450,5.0,5,5,0,1,5,11,-6,3.7,11.2,-7.6,18,EL
77cf8da0,4,340,3.8,4,3,0,2,4,7,-3,6.0,5.5,0.5,18,EL
77d7c96f,4,360,4.0,4,4,0,5,6,5,1,6.2,4.4,1.9,18,EL
77f278a0,11,447,5.0,4,1,7,3,6,3,3,6.2,5.7,0.4,18,EL
781b698a,2,12,0.1,0,0,2,1,0,0,0,0.1,0.1,0.1,18,EL
78841da9,2,115,1.3,1,1,1,0,2,3,-1,1.6,2.8,-1.2,18,EL
78952998,5,169,1.9,1,0,4,1,2,3,-1,1.3,2.0,-0.8,18,EL
79019bf4,4,334,3.7,3,3,1,1,6,5,1,5.4,5.9,-0.5,18,EL
79370f8c,2,80,0.9,1,0,1,4,2,0,2,1.9,0.5,1.4,18,EL
794e2914,2,180,2.0,2,2,0,4,3,2,1,2.5,1.0,1.5,18,EL
799caf80,5,369,4.1,4,3,1,0,4,4,0,6.2,4.2,2.0,18,EL
79b0d6a0,6,570,6.3,6,6,0,0,10,8,2,12.7,6.9,5.8,18,EL
79c90e45,3,236,2.6,3,2,0,0,5,4,1,3.7,2.6,1.1,18,EL
79ca3e23,4,279,3.1,3,2,1,1,3,1,2,4.8,3.1,1.7,18,EL
7a2cf111,3,200,2.2,3,2,0,0,2,4,-2,1.7,4.8,-3.0,18,EL
7aac47fe,2,136,1.5,2,1,0,1,2,2,0,2.3,1.3,1.1,18,EL
7abbf224,2,111,1.2,1,1,1,1,4,3,1,1.7,1.1,0.6,18,EL
7b4a62af,1,1,0.0,0,0,1,3,0,0,0,0.0,0.0,0.0,18,EL
7b66eec0,6,540,6.0,6,6,0,2,11,6,5,11.3,8.6,2.7,18,EL
7b9ecf02,3,263,2.9,3,2,0,3,4,4,0,3.1,2.2,0.9,18,EL
7beecde1,3,222,2.5,3,2,0,0,5,7,-2,4.2,2.7,1.6,18,EL
7bfd96fd,5,372,4.1,4,4,1,1,5,8,-3,4.8,7.3,-2.5,18,EL
7c104bb7,3,224,2.5,2,2,1,2,4,4,0,2.6,2.5,0.2,18,EL
7c1a0c67,2,180,2.0,2,2,0,0,1,0,1,2.4,2.3,0.1,18,EL
7c224498,8,720,8.0,8,8,0,0,17,13,4,16.0,12.4,3.6,18,EL
7ca9f0f0,3,227,2.5,2,2,1,2,3,6,-3,2.8,4.0,-1.1,18,EL
7cd78926,8,720,8.0,8,8,0,0,7,9,-2,7.1,9.5,-2.4,18,EL
7d74f9fd,3,51,0.6,0,0,3,2,0,0,0,1.6,0.3,1.3,18,EL
7d974435,4,360,4.0,4,4,0,1,2,6,-4,3.1,5.3,-2.2,18,EL
7dca49f6,8,284,3.2,3,0,5,2,6,3,3,3.4,3.4,0.0,18,EL
7e56d3db,3,259,2.9,3,2,0,3,6,3,3,5.8,2.2,3.5,18,EL
7e925fa3,3,189,2.1,2,2,1,2,4,2,2,2.7,2.8,-0.1,18,EL
7e927fda,8,717,8.0,8,7,0,1,18,6,12,11.8,7.2,4.6,18,EL
7eb97a8e,3,168,1.9,2,1,1,1,5,3,2,3.5,1.7,1.8,18,EL
7ebfac0f,1,30,0.3,0,0,1,0,0,0,0,0.5,0.1,0.4,18,EL
7f5ca4f8,2,100,1.1,2,1,0,0,1,3,-2,1.3,1.7,-0.4,18,EL
7f609bfc,4,316,3.5,3,2,1,0,5,6,-1,4.2,3.1,1.2,18,EL
7f78ad23,7,544,6.0,6,5,1,1,7,6,1,9.9,6.2,3.7,18,EL
7fd58fe3,10,547,6.1,5,4,5,0,18,8,10,13.3,6.0,7.3,18,EL
807e869a,10,689,7.7,8,4,2,0,9,13,-4,6.6,8.8,-2.1,18,EL
808d48f3,5,438,4.9,5,4,0,1,6,6,0,6.7,5.2,1.5,18,EL
80a479ab,1,90,1.0,1,1,0,2,2,1,1,0.9,0.5,0.4,18,EL
810486a5,5,428,4.8,5,4,0,1,3,8,-5,2.3,7.1,-4.8,18,EL
81442ecb,6,402,4.5,4,2,2,0,8,5,3,8.4,4.2,4.2,18,EL
816192f0,2,180,2.0,2,2,0,1,2,2,0,1.7,2.2,-0.5,18,EL
816cdcbb,2,104,1.2,1,0,1,4,0,2,-2,0.6,0.8,-0.2,18,EL
819f3a54,4,135,1.5,1,1,3,1,2,1,1,0.8,0.8,0.0,18,EL
81b013ec,6,540,6.0,6,6,0,0,1,10,-9,4.2,7.3,-3.1,18,EL
81fa2f75,4,335,3.7,3,3,1,2,4,6,-2,4.1,7.2,-3.1,18,EL
8229a21c,10,892,9.9,10,9,0,0,21,9,12,13.6,12.6,1.0,18,EL
826313e2,6,540,6.0,6,6,0,0,6,16,-10,5.7,13.7,-8.0,18,EL
82671804,15,1326,14.7,15,12,0,0,20,14,6,21.9,14.2,7.7,18,EL
8270ccf9,4,324,3.6,4,2,0,2,0,6,-6,2.3,5.2,-2.9,18,EL
82927de4,7,503,5.6,7,1,0,1,6,7,-1,9.8,5.3,4.5,18,EL
82b1198a,10,900,10.0,10,10,0,0,23,9,14,19.3,10.7,8.6,18,EL
833fb62e,4,203,2.3,2,1,2,0,4,7,-3,3.4,3.6,-0.2,18,EL
8395ab90,5,320,3.6,3,1,2,1,1,3,-2,2.2,3.7,-1.5,18,EL
83b9c48f,7,485,5.4,6,3,1,1,4,5,-1,5.1,5.9,-0.8,18,EL
84399660,6,287,3.2,3,1,3,1,4,3,1,5.6,2.3,3.4,18,EL
8454388c,3,300,3.3,3,3,0,6,7,5,2,4.4,5.6,-1.2,18,EL
84549a07,4,97,1.1,1,0,3,2,1,1,0,0.6,2.9,-2.3,18,EL
84566787,2,25,0.3,0,0,2,4,1,0,1,1.0,0.1,1.0,18,EL
8494acc4,3,109,1.2,1,1,2,1,2,5,-3,2.0,3.5,-1.5,18,EL
8497faf7,7,525,5.8,6,5,1,1,16,6,10,16.1,4.6,11.5,18,EL
84ad89fa,4,360,4.0,4,4,0,0,7,8,-1,4.9,8.8,-3.9,18,EL
84cef920,6,540,6.0,6,6,0,0,9,9,0,6.4,12.3,-6.0,18,EL
84e5adcd,5,450,5.0,5,4,0,0,5,7,-2,3.5,7.9,-4.4,18,EL
8530dd74,2,41,0.5,0,0,2,0,0,1,-1,0.2,1.2,-1.0,18,EL
85f8571a,7,615,6.8,7,5,0,2,18,6,12,9.8,9.5,0.3,18,EL
85fd00dd,4,287,3.2,3,3,1,2,3,7,-4,2.5,5.2,-2.7,18,EL
86dd16a8,6,494,5.5,5,5,1,1,5,9,-4,3.7,6.2,-2.5,18,EL
8746d5d0,5,392,4.4,4,3,1,1,3,7,-4,4.1,7.7,-3.6,18,EL
87c7c2b1,2,180,2.0,2,2,0,4,2,1,1,2.4,1.7,0.7,18,EL
884a8908,6,520,5.8,6,2,0,0,5,10,-5,5.6,9.0,-3.4,18,EL
889b3bd7,3,74,0.8,1,0,2,1,0,0,0,1.5,0.2,1.3,18,EL
88a9ea33,3,270,3.0,3,2,0,0,4,3,1,3.7,3.8,-0.1,18,EL
88b748d2,8,720,8.0,8,8,0,0,14,13,1,9.2,12.4,-3.3,18,EL
88cd098e,6,540,6.0,6,6,0,0,3,20,-17,3.6,16.8,-13.3,18,EL
88d4144a,3,270,3.0,3,3,0,1,5,4,1,5.2,4.4,0.8,18,EL
88e357ef,1,44,0.5,0,0,1,0,1,2,-1,1.4,0.6,0.8,18,EL
89565ac5,3,224,2.5,2,2,1,0,2,2,0,3.4,4.2,-0.7,18,EL
896c126c,5,272,3.0,3,1,2,0,2,3,-1,3.4,2.8,0.6,18,EL
89b2c8a9,1,90,1.0,1,1,0,0,2,0,2,1.8,0.3,1.5,18,EL
8a2248b4,4,360,4.0,4,4,0,4,5,6,-1,4.7,4.3,0.5,18,EL
8a6ab963,8,720,8.0,8,8,0,0,17,7,10,11.2,9.0,2.2,18,EL
8b3fd3af,4,360,4.0,4,4,0,4,3,9,-6,3.7,9.0,-5.3,18,EL
8c3c640c,6,455,5.1,6,3,0,1,11,5,6,13.7,4.6,9.1,18,EL
8cc29864,2,180,2.0,2,2,0,0,3,3,0,2.8,3.0,-0.2,18,EL
8ce063f9,2,121,1.3,2,0,0,0,2,1,1,1.6,1.7,0.0,18,EL
8cfcf5bb,2,97,1.1,1,1,1,3,0,2,-2,1.0,1.7,-0.7,18,EL
8d3bca49,1,44,0.5,1,0,0,0,0,3,-3,0.0,1.5,-1.5,18,EL
8d3d3b0a,3,85,0.9,1,0,2,2,0,1,-1,0.6,1.1,-0.5,18,EL
8da74c05,6,81,0.9,0,0,6,0,2,3,-1,0.6,1.5,-0.8,18,EL
8dbff17c,14,1262,14.0,13,13,1,0,18,13,5,19.7,14.3,5.4,18,EL
8e19242c,2,13,0.1,0,0,2,1,0,1,-1,0.1,0.6,-0.6,18,EL
8e92be30,3,57,0.6,0,0,3,1,2,0,2,1.8,1.0,0.8,18,EL
8ed1d91b,6,475,5.3,6,5,0,0,4,14,-10,4.0,11.6,-7.6,18,EL
8f056768,14,883,9.8,10,6,4,0,18,9,9,13.2,10.3,2.9,18,EL
8f299faf,6,453,5.0,5,5,1,0,6,13,-7,6.8,9.5,-2.8,18,EL
8f4d116f,8,720,8.0,8,8,0,0,3,3,0,9.5,8.2,1.2,18,EL
8f696594,10,689,7.7,8,3,2,0,13,6,7,11.9,8.0,3.9,18,EL
8ff07990,7,528,5.9,6,4,1,0,12,10,2,8.8,9.6,-0.8,18,EL
903b3b77,8,720,8.0,8,8,0,0,9,12,-3,8.8,13.0,-4.2,18,EL
90624e56,3,78,0.9,1,0,2,3,1,6,-5,0.5,2.2,-1.7,18,EL
908eea67,3,270,3.0,3,3,0,3,3,4,-1,3.1,3.4,-0.4,18,EL
9109185e,10,900,10.0,10,10,0,0,14,13,1,14.4,13.2,1.2,18,EL
91538ba3,6,504,5.6,6,4,0,0,9,9,0,6.3,8.9,-2.6,18,EL
917ddcdf,5,217,2.4,3,1,2,1,0,5,-5,1.2,4.3,-3.1,18,EL
91899ca8,5,376,4.2,4,4,1,3,8,3,5,7.9,3.5,4.4,18,EL
921f6058,7,462,5.1,5,5,2,1,13,5,8,10.9,5.1,5.8,18,EL
92232aad,4,354,3.9,4,3,0,0,7,1,6,6.4,3.2,3.2,18,EL
9228b07c,3,247,2.7,3,2,0,0,4,8,-4,3.2,4.5,-1.4,18,EL
923f4dda,5,324,3.6,4,2,1,1,4,4,0,3.1,4.4,-1.3,18,EL
92432bc6,14,1219,13.5,14,5,0,0,20,13,7,15.7,12.5,3.2,18,EL
9243fea6,3,42,0.5,0,0,3,1,1,2,-1,1.3,0.6,0.6,18,EL
92948149,3,191,2.1,2,1,1,3,2,2,0,1.4,2.6,-1.2,18,EL
92c62328,8,720,8.0,8,8,0,0,10,8,2,10.0,11.8,-1.8,18,EL
92fffd91,3,48,0.5,0,0,3,1,0,0,0,0.4,0.3,0.1,18,EL
936d9e3e,1,65,0.7,1,0,0,0,0,0,0,0.8,0.5,0.2,18,EL
93a194e1,5,450,5.0,5,5,0,0,4,1,3,5.4,2.8,2.5,18,EL
93a50d2c,4,360,4.0,4,4,0,2,4,6,-2,5.8,4.5,1.3,18,EL
93b0fa3c,6,414,4.6,6,0,0,0,4,2,2,4.2,4.3,-0.1,18,EL
93b891d1,9,520,5.8,6,4,3,2,11,8,3,9.9,6.2,3.6,18,EL
93bf37c5,5,267,3.0,4,2,1,0,4,4,0,2.7,5.8,-3.1,18,EL
94d260aa,8,720,8.0,8,8,0,0,7,9,-2,7.1,9.5,-2.4,18,EL
94f8d10c,13,1200,13.3,13,13,0,0,19,12,7,15.5,12.7,2.8,18,EL
950ff24d,4,360,4.0,4,4,0,3,9,5,4,5.0,8.2,-3.2,18,EL
951a4ee4,3,176,2.0,3,0,0,0,3,3,0,3.0,1.8,1.1,18,EL
951f1739,5,209,2.3,2,1,3,3,2,2,0,3.4,2.4,1.1,18,EL
958aba30,5,404,4.5,4,4,1,0,5,6,-1,4.4,5.4,-1.0,18,EL
95a34045,6,540,6.0,6,6,0,0,4,4,0,7.6,5.9,1.6,18,EL
963829d0,7,589,6.5,7,5,0,1,11,8,3,11.8,7.5,4.3,18,EL
9674002f,6,366,4.1,4,4,2,0,3,4,-1,4.8,3.2,1.6,18,EL
96f2d977,6,132,1.5,1,0,5,1,2,2,0,1.4,1.5,-0.1,18,EL
972d595a,1,90,1.0,1,1,0,1,2,1,1,0.6,0.5,0.2,18,EL
9731ab71,1,46,0.5,1,0,0,0,0,1,-1,0.9,0.6,0.2,18,EL
97bfa797,6,342,3.8,4,1,2,0,7,7,0,4.8,6.0,-1.1,18,EL
9804ba8b,3,19,0.2,0,0,3,1,2,1,1,1.1,0.8,0.3,18,EL
9836e892,1,45,0.5,0,0,1,0,0,0,0,0.4,0.2,0.2,18,EL
9866afec,7,615,6.8,7,5,0,0,8,7,1,6.2,8.9,-2.7,18,EL
98d2c2c4,8,720,8.0,8,8,0,0,17,8,9,15.6,8.8,6.8,18,EL
98daa26a,1,90,1.0,1,1,0,0,1,1,0,0.8,0.9,-0.1,18,EL
998d5709,5,282,3.1,2,1,3,1,1,5,-4,1.7,4.1,-2.4,18,EL
99a5321f,5,349,3.9,4,3,1,3,4,6,-2,3.1,6.1,-3.0,18,EL
99de6b6f,2,134,1.5,1,1,1,0,3,2,1,1.4,1.4,0.0,18,EL
9a1f2e1c,6,534,5.9,6,5,0,3,12,3,9,10.2,5.5,4.7,18,EL
9a2e0ccc,6,326,3.6,3,2,3,0,6,5,1,6.0,3.7,2.3,18,EL
9a34c46d,5,450,5.0,5,5,0,0,4,3,1,4.2,4.1,0.1,18,EL
9a493fb7,4,356,4.0,4,3,0,1,6,2,4,4.3,4.2,0.1,18,EL
9a6cfc02,3,169,1.9,2,1,1,1,1,5,-4,1.2,2.1,-0.9,18,EL
9ae9eaea,6,520,5.8,6,5,0,2,12,6,6,9.3,6.7,2.7,18,EL
9b6df52f,2,166,1.8,2,1,0,4,3,2,1,2.3,0.9,1.3,18,EL
9c318325,13,1029,11.4,12,8,1,0,23,11,12,22.7,13.4,9.4,18,EL
9cc4ae6d,2,180,2.0,2,0,0,0,0,0,0,0.0,0.0,0.0,18,EL
9d01ec0f,3,153,1.7,2,1,1,1,4,1,3,1.7,1.7,0.0,18,EL
9d0f626a,6,540,6.0,6,6,0,0,6,10,-4,4.0,9.5,-5.5,18,EL
9d12e142,4,360,4.0,4,4,0,0,5,5,0,5.5,6.5,-1.1,18,EL
9d1e8e76,5,336,3.7,4,2,1,1,8,4,4,6.1,5.5,0.7,18,EL
9d1f0c99,4,232,2.6,2,2,2,1,2,8,-6,2.1,4.0,-2.0,18,EL
9d4c45d6,6,297,3.3,4,0,2,1,4,5,-1,5.9,4.9,1.0,18,EL
9d971f13,7,556,6.2,7,1,0,0,7,7,0,6.0,7.0,-1.0,18,EL
9dbb75ca,4,331,3.7,4,2,0,0,6,5,1,7.3,5.3,2.0,18,EL
9dc39955,1,16,0.2,0,0,1,3,0,0,0,0.1,0.0,0.1,18,EL
9deab2db,6,294,3.3,3,1,3,0,0,4,-4,2.6,3.3,-0.7,18,EL
9efa1d25,4,226,2.5,3,1,1,0,3,3,0,2.1,4.0,-2.0,18,EL
9f0ea33f,2,180,2.0,2,2,0,1,1,4,-3,2.4,3.8,-1.3,18,EL
9f156830,2,180,2.0,2,2,0,0,3,7,-4,1.7,4.2,-2.5,18,EL
9f1893b9,7,369,4.1,3,2,4,0,13,8,5,11.3,3.8,7.5,18,EL
9f323c71,4,360,4.0,4,4,0,1,6,8,-2,4.8,6.0,-1.1,18,EL
9f381d8b,3,236,2.6,3,2,0,0,1,4,-3,2.3,3.0,-0.7,18,EL
9f979eb2,3,226,2.5,3,2,0,1,2,4,-2,1.5,3.2,-1.8,18,EL
9f9c57f0,6,540,6.0,6,6,0,0,6,11,-5,6.1,9.8,-3.7,18,EL
9fc0f253,6,540,6.0,6,6,0,0,5,10,-5,7.5,6.0,1.5,18,EL
9fc2531b,10,274,3.0,5,2,5,0,7,4,3,4.3,2.4,1.9,18,EL
Besar-Iseni,1,14,0.2,0,0,1,0,0,0,0,0.0,0.0,0.0,18,EL
Binyam-Belay,1,75,0.8,1,0,0,0,0,0,0,0.0,0.0,0.0,18,EL
Filip-Stojchevski,2,19,0.2,0,0,2,0,0,0,0,0.0,0.0,0.0,18,EL
Petr-Hronek,1,65,0.7,1,0,0,0,0,0,0,0.0,0.0,0.0,18,EL
a0255c67,1,76,0.8,1,0,0,0,0,1,-1,0.9,1.2,-0.3,18,EL
a0313275,5,442,4.9,5,4,0,0,4,10,-6,4.1,8.0,-3.9,18,EL
a08b5224,1,11,0.1,0,0,1,1,0,0,0,0.1,0.1,0.0,18,EL
a08b974a,13,964,10.7,11,8,2,1,13,9,4,15.4,9.8,5.6,18,EL
a0c8a672,1,22,0.2,1,0,0,0,0,0,0,0.1,0.4,-0.4,18,EL
a0d59251,6,540,6.0,6,6,0,0,5,14,-9,4.3,12.9,-8.6,18,EL
a1216563,10,775,8.6,9,4,1,0,18,8,10,11.3,11.2,0.1,18,EL
a1474d8e,3,234,2.6,3,1,0,0,4,3,1,3.8,6.1,-2.3,18,EL
a190d597,5,387,4.3,5,1,0,1,8,1,7,5.9,3.0,2.9,18,EL
a19be070,5,254,2.8,3,2,2,1,2,2,0,4.2,2.3,1.9,18,EL
a1a9ef78,6,540,6.0,6,6,0,0,3,20,-17,3.6,16.8,-13.3,18,EL
a2560346,1,4,0.0,0,0,1,0,0,0,0,0.0,0.1,-0.1,18,EL
a26c1727,5,383,4.3,4,4,1,0,0,8,-8,3.0,5.7,-2.7,18,EL
a2f2d806,8,277,3.1,2,1,6,0,0,2,-2,4.1,4.1,0.0,18,EL
a33a0dc0,7,223,2.5,2,2,5,1,9,4,5,4.6,2.9,1.8,18,EL
a3b03921,5,273,3.0,3,0,2,2,5,2,3,6.2,3.8,2.4,18,EL
a3b0ed18,7,573,6.4,7,6,0,0,9,6,3,5.8,6.7,-0.9,18,EL
a3bf2258,6,232,2.6,2,1,4,4,6,4,2,3.7,3.1,0.6,18,EL
a3ddb1b9,3,202,2.2,2,1,1,0,5,5,0,3.2,1.9,1.3,18,EL
a44f7c60,4,271,3.0,4,1,0,0,3,7,-4,3.5,3.7,-0.1,18,EL
a47e7ecd,5,413,4.6,5,4,0,1,3,6,-3,4.3,6.3,-2.0,18,EL
a498e276,4,360,4.0,4,4,0,1,4,12,-8,3.9,6.0,-2.1,18,EL
a49fd565,5,406,4.5,5,4,0,0,4,7,-3,5.9,9.1,-3.1,18,EL
a4bd9edd,1,90,1.0,1,1,0,3,1,0,1,1.7,0.6,1.1,18,EL
a4effc55,1,90,1.0,1,1,0,3,0,0,0,1.1,1.5,-0.4,18,EL
a4fe8cda,9,662,7.4,9,4,0,1,12,8,4,13.1,7.0,6.1,18,EL
a5296e55,2,180,2.0,2,2,0,0,3,3,0,2.8,3.0,-0.2,18,EL
a53649b7,5,50,0.6,0,0,5,7,0,0,0,0.5,1.1,-0.6,18,EL
a565da59,6,540,6.0,6,6,0,0,4,4,0,7.6,5.9,1.6,18,EL
a5d101a9,6,540,6.0,6,6,0,0,6,16,-10,5.7,13.7,-8.0,18,EL
a5db0bec,8,460,5.1,4,2,4,2,14,3,11,9.9,4.3,5.6,18,EL
a62c16d0,7,520,5.8,6,3,1,0,6,6,0,6.1,7.4,-1.4,18,EL
a63a995f,5,450,5.0,5,5,0,0,4,7,-3,8.2,7.7,0.5,18,EL
a6951bf8,4,360,4.0,4,3,0,0,7,1,6,6.5,3.2,3.3,18,EL
a6de370d,7,557,6.2,6,5,1,1,15,6,9,15.5,5.8,9.7,18,EL
a7121625,1,1,0.0,0,0,1,0,0,0,0,0.0,0.0,0.0,18,EL
a78147dd,4,316,3.5,4,2,0,0,2,5,-3,2.3,3.7,-1.4,18,EL
a78ff07f,1,74,0.8,1,0,0,4,3,1,2,1.0,0.9,0.1,18,EL
a81ed730,6,440,4.9,5,4,1,3,7,7,0,7.6,10.1,-2.5,18,EL
a81f4896,6,517,5.7,6,5,0,0,5,9,-4,7.3,5.7,1.6,18,EL
a8327abd,7,379,4.2,4,1,3,0,3,3,0,6.0,2.7,3.2,18,EL
a898d91e,1,90,1.0,1,1,0,0,0,0,0,1.5,1.4,0.1,18,EL
a8a874f1,7,454,5.0,5,4,2,1,5,5,0,7.5,5.1,2.5,18,EL
a8c0acb7,2,180,2.0,2,2,0,0,1,3,-2,1.4,2.3,-0.9,18,EL
a9440c25,8,408,4.5,4,1,4,0,7,7,0,5.9,9.5,-3.6,18,EL
a96e5dc0,2,136,1.5,2,1,0,1,3,3,0,2.0,2.4,-0.3,18,EL
a97afc61,3,124,1.4,1,1,2,2,2,5,-3,0.9,3.6,-2.6,18,EL
a9a3b55d,4,360,4.0,4,4,0,2,8,3,5,4.7,6.0,-1.3,18,EL
a9aa0d1d,9,784,8.7,9,5,0,0,13,13,0,9.4,10.0,-0.6,18,EL
a9e68c94,6,272,3.0,2,0,4,0,3,2,1,4.4,4.4,0.0,18,EL
aa51343f,4,249,2.8,3,0,1,2,4,3,1,3.8,3.8,-0.1,18,EL
aa8e289e,6,361,4.0,3,3,3,0,6,12,-6,5.1,6.0,-0.8,18,EL
aa954c2b,1,15,0.2,0,0,1,1,0,1,-1,0.1,0.3,-0.3,18,EL
aacdfe88,6,540,6.0,6,6,0,0,3,9,-6,5.3,8.2,-2.9,18,EL
aad48be9,4,334,3.7,4,3,0,1,4,4,0,6.7,4.7,2.0,18,EL
aad4f74f,6,540,6.0,6,6,0,2,10,6,4,10.8,6.5,4.3,18,EL
aad56ca3,1,15,0.2,0,0,1,2,0,0,0,0.2,0.0,0.2,18,EL
aad9c3f3,4,311,3.5,4,1,0,1,8,4,4,3.2,3.2,0.0,18,EL
aae44006,1,7,0.1,0,0,1,3,0,0,0,0.0,0.3,-0.2,18,EL
aaee68f1,2,29,0.3,0,0,2,4,0,3,-3,0.3,1.0,-0.7,18,EL
ab6928f2,2,134,1.5,1,1,1,2,3,6,-3,1.8,5.0,-3.2,18,EL
ab700320,3,270,3.0,3,3,0,1,5,5,0,5.2,5.3,-0.1,18,EL
abb42ce6,5,377,4.2,4,4,1,0,6,7,-1,5.1,4.3,0.8,18,EL
abcfaa50,2,64,0.7,1,0,1,2,0,0,0,0.4,0.5,-0.1,18,EL
ac7e640b,8,577,6.4,6,5,2,0,13,7,6,11.7,7.5,4.2,18,EL
ad10eae0,7,630,7.0,7,7,0,0,11,7,4,11.2,9.2,1.9,18,EL
ad178594,3,251,2.8,3,2,0,2,5,1,4,4.6,1.6,3.0,18,EL
ad625c12,2,156,1.7,2,1,0,1,1,3,-2,0.9,2.6,-1.7,18,EL
ae0f7da7,6,445,4.9,5,4,1,0,4,4,0,6.8,6.0,0.9,18,EL
ae3e6d85,4,245,2.7,3,1,1,1,3,3,0,3.4,3.7,-0.3,18,EL
aec6b711,7,344,3.8,3,1,4,1,7,7,0,3.8,7.1,-3.2,18,EL
aeee3365,4,85,0.9,1,0,3,4,2,2,0,1.7,1.7,-0.1,18,EL
af03f0b9,2,63,0.7,0,0,2,0,2,1,1,0.6,1.5,-0.9,18,EL
af50141d,6,519,5.8,6,4,0,0,3,2,1,6.6,5.5,1.1,18,EL
af8cabe1,3,115,1.3,1,1,2,3,4,3,1,3.2,1.4,1.8,18,EL
af8e4246,2,117,1.3,2,0,0,0,2,5,-3,1.4,2.6,-1.2,18,EL
af97a8af,6,484,5.4,5,3,1,0,6,6,0,7.7,7.5,0.2,18,EL
afda7d82,5,358,4.0,3,3,2,0,5,7,-2,3.8,8.0,-4.2,18,EL
b01e6102,4,303,3.4,4,3,0,0,4,7,-3,2.8,6.2,-3.4,18,EL
b037bd4f,4,260,2.9,3,1,1,2,3,6,-3,4.8,4.7,0.1,18,EL
b073f5ea,4,360,4.0,4,4,0,0,6,5,1,4.3,3.9,0.4,18,EL
b0fce72c,4,190,2.1,2,1,2,1,1,2,-1,1.5,4.5,-3.1,18,EL
b1062a37,7,606,6.7,7,6,0,0,2,2,0,8.6,6.3,2.4,18,EL
b12c68bf,7,605,6.7,7,6,0,0,7,7,0,7.2,9.4,-2.1,18,EL
b15e93aa,4,327,3.6,4,3,0,1,3,7,-4,2.2,7.0,-4.8,18,EL
b175c21c,7,393,4.4,5,1,2,1,4,8,-4,3.2,7.1,-4.0,18,EL
b18095b6,2,180,2.0,2,2,0,1,2,5,-3,2.8,3.2,-0.4,18,EL
b182a240,2,180,2.0,2,2,0,0,3,4,-1,1.9,2.2,-0.3,18,EL
b1deecf8,4,360,4.0,4,4,0,4,11,4,7,7.7,2.4,5.3,18,EL
b20eece9,1,90,1.0,1,0,0,0,3,0,3,1.6,0.6,1.0,18,EL
b20f5a66,3,270,3.0,3,3,0,1,2,2,0,3.9,2.5,1.4,18,EL
b2484b77,4,113,1.3,1,0,3,2,0,2,-2,0.4,3.2,-2.8,18,EL
b2bee28a,4,153,1.7,1,1,3,1,0,3,-3,0.9,4.1,-3.3,18,EL
b2db927b,7,341,3.8,3,0,4,0,8,4,4,5.0,6.9,-1.8,18,EL
b2ec3323,6,489,5.4,6,1,0,0,4,4,0,6.1,5.3,0.8,18,EL
b2f1fbd5,8,666,7.4,8,4,0,0,9,8,1,8.7,10.8,-2.1,18,EL
b340a30a,3,136,1.5,1,1,2,0,2,4,-2,1.5,1.3,0.2,18,EL
b3aed40d,7,630,7.0,7,7,0,0,10,8,2,8.5,8.6,-0.1,18,EL
b3b310f0,2,119,1.3,1,1,1,0,1,2,-1,1.5,2.4,-0.9,18,EL
b3dc6eca,5,450,5.0,5,5,0,1,8,7,1,9.4,5.7,3.7,18,EL
b418dbd4,9,639,7.1,7,3,2,0,11,8,3,10.3,8.9,1.4,18,EL
b437b9bd,1,17,0.2,0,0,1,0,0,1,-1,0.4,0.0,0.4,18,EL
b4541446,1,90,1.0,1,1,0,0,1,0,1,1.2,0.4,0.8,18,EL
b45e185a,6,412,4.6,4,2,2,0,3,5,-2,3.5,5.5,-2.0,18,EL
b48215cd,5,310,3.4,4,1,1,0,4,4,0,6.3,4.3,2.1,18,EL
b4825073,7,570,6.3,7,6,0,0,3,5,-2,7.5,6.4,1.1,18,EL
b54ea609,3,270,3.0,3,3,0,0,2,8,-6,5.0,5.5,-0.4,18,EL
b583aef5,4,360,4.0,4,4,0,2,6,6,0,4.4,5.1,-0.7,18,EL
b58b3e7b,1,8,0.1,0,0,1,1,0,0,0,0.1,0.3,-0.2,18,EL
b5920350,2,118,1.3,2,0,0,0,1,4,-3,1.3,3.2,-1.9,18,EL
b5b2e1ba,3,117,1.3,1,0,2,0,1,2,-1,1.2,1.2,-0.1,18,EL
b653b65b,4,189,2.1,2,1,2,2,2,3,-1,3.4,5.4,-2.0,18,EL
b682dcf6,4,360,4.0,4,4,0,0,5,5,0,5.5,6.5,-1.1,18,EL
b686f4c0,13,629,7.0,7,0,6,0,9,6,3,7.7,5.4,2.2,18,EL
b6a6e0a7,4,233,2.6,3,1,1,1,3,4,-1,2.9,2.7,0.2,18,EL
b6b2b820,1,90,1.0,1,1,0,1,1,3,-2,1.0,2.8,-1.7,18,EL
b7084daf,6,513,5.7,6,3,0,0,7,9,-2,7.1,10.5,-3.4,18,EL
b70be510,6,518,5.8,5,5,1,0,3,9,-6,5.2,7.7,-2.5,18,EL
b746d309,3,270,3.0,3,3,0,6,2,3,-1,3.1,3.7,-0.6,18,EL
b75af9ce,6,353,3.9,4,0,2,0,3,10,-7,3.0,9.4,-6.3,18,EL
b7d8cbb9,1,18,0.2,0,0,1,0,0,1,-1,0.2,0.5,-0.2,18,EL
b7e1c3b5,4,326,3.6,4,2,0,1,2,5,-3,3.6,4.5,-0.9,18,EL
b7f2edff,3,270,3.0,3,3,0,0,5,3,2,6.6,3.8,2.8,18,EL
b825a650,4,290,3.2,3,3,1,1,5,8,-3,4.1,6.3,-2.2,18,EL
b8814868,9,782,8.7,9,7,0,0,15,11,4,14.3,13.7,0.7,18,EL
b8ae831b,7,630,7.0,7,7,0,0,7,6,1,8.3,5.8,2.6,18,EL
b8fb9e84,2,108,1.2,1,1,1,3,1,2,-1,0.4,1.3,-0.9,18,EL
b9177a6f,6,404,4.5,4,3,2,0,7,13,-6,5.0,8.3,-3.3,18,EL
b93b7882,2,86,1.0,1,0,1,1,2,2,0,1.8,2.0,-0.1,18,EL
b9747ada,5,280,3.1,4,1,1,0,4,6,-2,2.5,5.0,-2.5,18,EL
b9c19ad9,1,90,1.0,1,1,0,1,1,0,1,2.6,0.5,2.2,18,EL
ba6e52b0,4,390,4.3,4,4,0,1,8,6,2,8.2,4.8,3.4,18,EL
ba7673a6,1,59,0.7,1,0,0,5,0,0,0,0.5,0.7,-0.1,18,EL
ba998e22,5,432,4.8,5,4,0,0,1,6,-5,3.6,6.7,-3.2,18,EL
bafcf742,8,720,8.0,8,8,0,0,3,3,0,9.5,8.2,1.2,18,EL
bb19da7c,7,193,2.1,2,0,5,1,5,1,4,3.1,2.0,1.0,18,EL
bb25c778,4,360,4.0,4,4,0,0,4,4,0,6.9,5.8,1.1,18,EL
bb31def4,1,1,0.0,0,0,1,0,0,0,0,0.0,0.0,0.0,18,EL
bb6ab7af,1,90,1.0,1,1,0,5,0,6,-6,0.5,3.1,-2.6,18,EL
bba30585,6,494,5.5,5,5,1,0,14,9,5,15.7,6.0,9.7,18,EL
bbddc31f,1,90,1.0,1,1,0,0,0,2,-2,0.4,2.1,-1.7,18,EL
bc5b5be5,5,256,2.8,2,2,3,0,4,0,4,7.4,2.4,5.0,18,EL
bc6bd723,8,581,6.5,7,3,1,0,13,7,6,8.8,8.2,0.6,18,EL
bcb2ccd8,6,540,6.0,6,6,0,0,9,10,-1,8.8,8.5,0.3,18,EL
bcd1bea2,6,283,3.1,3,0,3,0,5,8,-3,2.6,6.2,-3.6,18,EL
bcd9b19c,6,515,5.7,6,5,0,0,6,9,-3,3.6,9.0,-5.4,18,EL
bdf7b97d,7,245,2.7,2,2,5,2,7,1,6,4.4,1.5,2.9,18,EL
be170419,3,225,2.5,2,1,1,4,4,1,3,4.4,1.2,3.2,18,EL
be42a291,7,401,4.5,5,1,2,5,3,3,0,4.1,3.3,0.7,18,EL
be6cd760,1,90,1.0,1,1,0,0,0,1,-1,1.3,1.2,0.1,18,EL
beb391dd,8,367,4.1,4,3,4,0,8,5,3,6.7,5.0,1.8,18,EL
beb6c168,7,600,6.7,7,4,0,1,12,12,0,7.6,10.5,-2.9,18,EL
bece776f,8,660,7.3,8,5,0,0,11,4,7,12.3,7.3,5.0,18,EL
beec76cc,4,314,3.5,3,3,1,0,4,7,-3,5.4,5.4,0.0,18,EL
bef09ca8,5,397,4.4,4,4,1,1,7,8,-1,4.7,5.4,-0.7,18,EL
bf309d24,2,172,1.9,2,1,0,0,2,3,-1,2.3,3.0,-0.8,18,EL
bf5fc4fc,6,314,3.5,3,1,3,0,3,12,-9,2.2,8.4,-6.2,18,EL
bfc5768b,8,534,5.9,6,3,2,0,8,5,3,9.9,6.8,3.1,18,EL
bfe272bd,2,36,0.4,0,0,2,1,1,2,-1,0.4,0.5,-0.1,18,EL
c01c66d9,6,514,5.7,5,5,1,4,13,9,4,10.3,6.1,4.2,18,EL
c0321811,6,540,6.0,6,6,0,0,6,10,-4,4.0,9.5,-5.5,18,EL
c05dfb74,2,180,2.0,2,1,0,0,0,1,-1,2.5,1.6,0.9,18,EL
c089980e,8,720,8.0,8,7,0,0,9,12,-3,8.8,13.0,-4.2,18,EL
c0b1a6da,2,180,2.0,2,2,0,6,8,1,7,3.1,0.7,2.4,18,EL
c1268aa3,8,720,8.0,8,8,0,0,10,8,2,10.0,11.8,-1.8,18,EL
c14bc029,9,735,8.2,8,7,1,0,16,4,12,12.0,8.6,3.3,18,EL
c18d22f5,5,450,5.0,5,5,0,1,4,4,0,8.1,6.2,1.9,18,EL
c18f2143,6,540,6.0,6,6,0,0,4,4,0,7.6,5.9,1.6,18,EL
c1a13650,4,139,1.5,2,0,2,2,3,7,-4,1.6,3.1,-1.6,18,EL
c1b7847c,4,300,3.3,4,2,0,1,4,3,1,3.9,3.8,0.2,18,EL
c2009df3,1,35,0.4,1,0,0,0,1,0,1,0.2,0.3,-0.2,18,EL
c2304da8,6,470,5.2,5,5,1,0,3,9,-6,6.0,7.8,-1.7,18,EL
c2e41cfb,2,180,2.0,2,2,0,0,1,1,0,3.1,1.9,1.2,18,EL
c3ee18ef,8,614,6.8,7,6,1,0,17,3,14,11.1,8.1,3.0,18,EL
c3fd9887,4,208,2.3,2,1,2,0,0,3,-3,3.8,4.1,-0.3,18,EL
c41ca3d8,4,242,2.7,3,0,1,2,1,1,0,2.7,1.9,0.8,18,EL
c43a8301,4,337,3.7,4,2,0,2,7,6,1,2.8,5.4,-2.6,18,EL
c43e5e7e,10,741,8.2,7,5,3,0,17,9,8,15.4,13.5,1.9,18,EL
c44a1d58,6,452,5.0,5,4,1,0,5,9,-4,5.7,10.5,-4.8,18,EL
c47541e0,9,540,6.0,7,2,2,0,9,4,5,9.5,5.4,4.2,18,EL
c48130b7,2,9,0.1,0,0,2,2,0,0,0,0.1,0.3,-0.2,18,EL
c49afee6,2,72,0.8,1,0,1,1,3,1,2,1.9,1.5,0.4,18,EL
c4a306a1,6,540,6.0,6,6,0,0,6,6,0,8.0,7.7,0.3,18,EL
c4af5889,2,108,1.2,1,1,1,0,1,1,0,1.3,1.6,-0.4,18,EL
c56dc39e,5,448,5.0,5,4,0,1,12,5,7,9.4,5.8,3.7,18,EL
c5b7c315,3,270,3.0,3,3,0,0,2,10,-8,3.1,6.4,-3.3,18,EL
c5bdb6e3,8,314,3.5,3,2,5,1,6,2,4,6.4,4.7,1.7,18,EL
c5ea2dab,3,270,3.0,3,3,0,4,2,5,-3,3.3,5.5,-2.1,18,EL
c5eaff5c,5,60,0.7,1,0,4,1,1,2,-1,1.3,1.7,-0.3,18,EL
c5fd13e9,3,270,3.0,3,3,0,0,5,5,0,4.4,5.1,-0.7,18,EL
c6500a29,6,239,2.7,1,1,5,0,4,8,-4,2.0,6.4,-4.3,18,EL
c67b8590,2,165,1.8,2,1,0,0,3,4,-1,1.6,1.7,-0.2,18,EL
c693347d,4,25,0.3,0,0,4,3,3,0,3,0.7,0.9,-0.2,18,EL
c699e60c,5,311,3.5,3,2,2,0,4,10,-6,4.2,6.2,-2.1,18,EL
c6ac6579,7,384,4.3,4,3,3,3,9,5,4,7.1,4.2,2.9,18,EL
c6f99e42,6,540,6.0,6,6,0,0,11,12,-1,5.8,9.3,-3.5,18,EL
c71e97ba,3,244,2.7,3,2,0,0,8,5,3,6.6,2.7,3.9,18,EL
c76153e5,5,445,4.9,5,4,0,0,1,19,-18,2.2,15.5,-13.3,18,EL
c7e0f364,4,354,3.9,4,3,0,0,7,9,-2,3.3,6.4,-3.2,18,EL
c7f24d4b,2,145,1.6,2,1,0,2,1,2,-1,1.3,1.2,0.1,18,EL
c84c1afc,2,92,1.0,1,0,1,0,2,2,0,0.9,1.7,-0.8,18,EL
c886b062,9,582,6.5,8,3,1,0,12,5,7,7.1,6.6,0.5,18,EL
c904f3d5,1,90,1.0,1,1,0,0,3,1,2,1.5,1.0,0.5,18,EL
c90b2e8f,2,180,2.0,2,2,0,0,1,3,-2,1.4,2.3,-0.9,18,EL
c98971d1,4,84,0.9,1,0,3,2,1,0,1,0.6,1.2,-0.6,18,EL
c9e5f0f6,4,122,1.4,1,1,3,2,1,2,-1,0.9,2.6,-1.7,18,EL
ca45605e,1,25,0.3,0,0,1,0,0,0,0,0.6,0.0,0.6,18,EL
ca8033cb,5,450,5.0,5,5,0,1,9,8,1,8.6,6.7,1.8,18,EL
ca9178af,3,270,3.0,3,3,0,0,4,8,-4,2.5,4.2,-1.7,18,EL
cb85d8d0,7,569,6.3,6,6,1,0,10,8,2,7.4,10.6,-3.2,18,EL
cbd92a70,2,92,1.0,1,0,1,1,1,3,-2,2.1,3.0,-0.9,18,EL
cbdf7d5c,1,90,1.0,1,1,0,0,0,1,-1,1.3,1.2,0.1,18,EL
cbec1196,5,364,4.0,5,1,0,1,6,4,2,5.1,4.8,0.2,18,EL
cc3477f4,1,90,1.0,1,1,0,2,0,2,-2,0.8,0.6,0.2,18,EL
cc700722,2,120,1.3,1,1,1,0,2,3,-1,2.6,1.6,0.9,18,EL
cc77354e,6,537,6.0,6,5,0,3,8,6,2,9.5,5.5,3.9,18,EL
cc89c822,2,136,1.5,2,1,0,0,0,2,-2,0.7,2.5,-1.8,18,EL
cc96d422,8,370,4.1,4,1,4,2,5,6,-1,4.4,3.6,0.7,18,EL
ccc520dc,4,316,3.5,4,3,0,1,7,2,5,4.4,5.4,-1.0,18,EL
ccc66d00,6,540,6.0,6,6,0,0,7,9,-2,7.4,11.2,-3.8,18,EL
cd0ecf81,6,442,4.9,5,2,1,0,8,8,0,5.4,5.2,0.2,18,EL
cd0fa27b,8,613,6.8,8,4,0,1,14,5,9,11.3,5.8,5.5,18,EL
cd59b9df,1,90,1.0,1,1,0,4,1,1,0,0.8,0.9,-0.1,18,EL
cda08080,5,450,5.0,5,5,0,3,8,10,-2,5.4,8.2,-2.9,18,EL
cda0b317,2,180,2.0,2,2,0,1,4,5,-1,2.3,2.9,-0.6,18,EL
cdf65d12,3,141,1.6,2,1,1,3,4,4,0,2.0,3.5,-1.5,18,EL
ce5143da,10,761,8.5,9,6,1,0,18,7,11,15.9,8.3,7.6,18,EL
ce538b0b,4,71,0.8,0,0,4,2,0,0,0,0.7,1.2,-0.5,18,EL
ce6480b1,5,346,3.8,5,0,0,0,5,8,-3,3.9,8.4,-4.5,18,EL
ce940592,5,450,5.0,5,5,0,0,0,8,-8,3.2,6.5,-3.3,18,EL
cea0df32,6,301,3.3,2,1,4,0,5,7,-2,4.7,5.6,-0.8,18,EL
ceb30355,4,360,4.0,4,4,0,2,5,3,2,4.9,4.1,0.8,18,EL
cf41510e,2,151,1.7,2,1,0,0,1,4,-3,0.9,4.3,-3.3,18,EL
cf8ef0a1,8,531,5.9,6,1,2,0,3,1,2,7.3,5.5,1.8,18,EL
cfa65a2e,2,162,1.8,2,1,0,0,3,1,2,0.9,1.5,-0.6,18,EL
cfd8d664,7,540,6.0,6,5,1,0,13,3,10,9.1,5.2,4.0,18,EL
cff7dcb0,2,106,1.2,1,0,1,0,1,1,0,1.3,0.8,0.4,18,EL
d0042ab9,4,360,4.0,4,4,0,0,3,10,-7,4.2,6.1,-1.8,18,EL
d02e0cab,9,775,8.6,8,7,1,1,16,7,9,13.5,11.7,1.9,18,EL
d045ccb2,1,16,0.2,0,0,1,3,2,0,2,0.6,0.1,0.5,18,EL
d054d8b0,6,483,5.4,6,4,0,1,14,8,6,16.1,4.2,11.9,18,EL
d071af92,6,540,6.0,6,6,0,0,6,10,-4,4.0,9.5,-5.5,18,EL
d0a01d27,2,180,2.0,2,2,0,0,3,4,-1,1.9,2.2,-0.3,18,EL
d0c41b99,4,360,4.0,4,4,0,2,4,5,-1,5.6,6.0,-0.4,18,EL
d0d8dd44,7,630,7.0,7,7,0,2,18,11,7,13.0,8.4,4.5,18,EL
d0e6399c,2,180,2.0,2,2,0,1,3,4,-1,2.7,1.5,1.2,18,EL
d13aea07,4,337,3.7,4,2,0,2,6,7,-1,5.0,5.3,-0.2,18,EL
d189e48f,1,90,1.0,1,1,0,0,0,1,-1,1.3,1.2,0.1,18,EL
d1992a3b,5,377,4.2,4,4,1,2,4,3,1,4.0,3.4,0.6,18,EL
d2110326,5,450,5.0,5,5,0,5,11,5,6,8.1,5.6,2.4,18,EL
d2416c2e,5,214,2.4,2,0,3,1,2,6,-4,3.6,3.3,0.3,18,EL
d248cd8f,6,516,5.7,6,5,0,0,9,9,0,8.7,8.2,0.5,18,EL
d2800f47,4,294,3.3,4,1,0,1,3,5,-2,2.7,4.9,-2.2,18,EL
d2aea9ac,5,27,0.3,0,0,5,1,1,2,-1,0.6,0.2,0.4,18,EL
d2ba04be,1,10,0.1,0,0,1,0,0,0,0,0.0,0.4,-0.4,18,EL
d2ee6d5b,5,210,2.3,2,0,3,3,3,2,1,2.8,2.3,0.5,18,EL
d3149135,5,450,5.0,5,5,0,1,6,5,1,5.9,5.0,0.9,18,EL
d31c4115,4,121,1.3,2,0,2,0,0,1,-1,0.5,1.3,-0.8,18,EL
d38174c3,2,11,0.1,0,0,2,7,0,0,0,0.2,0.1,0.1,18,EL
d40cff47,1,12,0.1,0,0,1,3,0,1,-1,0.0,0.1,-0.1,18,EL
d4535821,5,310,3.4,3,3,2,2,7,2,5,4.9,3.9,1.0,18,EL
d46ce637,2,152,1.7,2,1,0,2,1,4,-3,0.9,1.8,-0.9,18,EL
d4931a5a,6,184,2.0,1,0,5,2,4,3,1,3.3,2.2,1.1,18,EL
d4aa40b8,2,180,2.0,2,2,0,0,0,1,-1,2.3,2.4,-0.1,18,EL
d4cb83cc,7,613,6.8,7,6,0,1,16,7,9,14.3,7.3,6.9,18,EL
d4e7c451,5,370,4.1,4,2,1,0,1,5,-4,3.3,5.5,-2.2,18,EL
d4e93bab,7,541,6.0,6,5,1,0,17,4,13,9.3,5.5,3.8,18,EL
d4f8f243,6,391,4.3,4,2,2,0,2,4,-2,2.3,5.1,-2.8,18,EL
d552c4a1,3,233,2.6,3,2,0,0,3,6,-3,2.8,3.6,-0.8,18,EL
d5575935,13,1138,12.6,12,12,1,0,18,10,8,15.5,11.4,4.2,18,EL
d56b9362,5,320,3.6,3,3,2,1,9,5,4,4.1,4.4,-0.3,18,EL
d5ce52a5,1,10,0.1,0,0,1,0,1,0,1,0.7,0.0,0.7,18,EL
d60ffe68,1,41,0.5,1,0,0,2,0,2,-2,0.2,0.2,0.0,18,EL
d61b3354,2,110,1.2,1,0,1,1,4,3,1,1.7,1.7,-0.1,18,EL
d637fc22,6,456,5.1,4,4,2,0,5,7,-2,8.9,6.3,2.7,18,EL
d63e2912,10,765,8.5,8,8,2,1,14,8,6,14.2,8.8,5.5,18,EL
d659a854,1,9,0.1,0,0,1,2,0,1,-1,0.0,0.1,0.0,18,EL
d732f72c,5,349,3.9,4,3,1,0,1,2,-1,1.7,4.4,-2.7,18,EL
d7398ac3,5,450,5.0,5,5,0,0,5,7,-2,5.8,9.1,-3.3,18,EL
d757fd45,4,334,3.7,4,3,0,2,2,13,-11,2.7,12.0,-9.4,18,EL
d79a8c87,8,596,6.6,7,6,1,4,12,6,6,12.4,6.0,6.4,18,EL
d7a70e5e,5,354,3.9,4,2,1,1,6,9,-3,3.2,7.1,-3.9,18,EL
d7c09951,2,35,0.4,0,0,2,5,0,1,-1,0.3,1.6,-1.4,18,EL
d820a7c8,5,329,3.7,4,0,1,0,4,4,0,5.9,5.6,0.3,18,EL
d849ef0f,5,450,5.0,5,5,0,0,5,11,-6,3.7,11.2,-7.6,18,EL
d87e2cae,6,384,4.3,5,1,1,0,10,3,7,14.4,3.0,11.4,18,EL
d8ff3b2c,2,116,1.3,1,1,1,2,0,7,-7,0.4,3.3,-2.9,18,EL
d9847696,3,200,2.2,2,1,1,0,5,4,1,4.5,2.3,2.2,18,EL
d995ed27,6,345,3.8,3,2,3,2,6,6,0,6.0,4.4,1.6,18,EL
d9bda115,5,371,4.1,5,2,0,1,7,7,0,8.3,4.3,4.0,18,EL
da1185fc,5,383,4.3,4,2,1,1,6,4,2,4.9,5.5,-0.6,18,EL
da1c9094,1,90,1.0,1,1,0,5,1,0,1,1.6,0.8,0.9,18,EL
da270297,2,119,1.3,2,0,0,0,0,2,-2,0.5,1.4,-0.9,18,EL
da4bd8fb,2,45,0.5,0,0,2,2,1,1,0,0.4,0.3,0.1,18,EL
da617483,8,720,8.0,8,8,0,0,10,8,2,10.0,11.8,-1.8,18,EL
da6cb94b,6,540,6.0,6,6,0,0,6,11,-5,6.1,9.8,-3.7,18,EL
da974c7b,1,90,1.0,1,1,0,1,1,3,-2,1.0,2.8,-1.7,18,EL
dab0da1c,4,148,1.6,2,0,2,1,1,2,-1,1.2,1.6,-0.3,18,EL
dab75831,1,19,0.2,0,0,1,1,1,0,1,0.8,0.1,0.7,18,EL
dabec4c3,10,745,8.3,8,8,2,0,11,9,2,8.7,9.4,-0.8,18,EL
db4ed67b,4,271,3.0,3,2,1,0,2,3,-1,3.5,5.2,-1.7,18,EL
db7161ed,2,88,1.0,1,0,1,0,1,1,0,1.2,0.3,1.0,18,EL
db750822,6,268,3.0,3,1,3,2,5,1,4,3.6,2.8,0.9,18,EL
dc3fa3b5,6,399,4.4,5,3,1,0,6,7,-1,4.6,6.7,-2.1,18,EL
dc4511f3,1,14,0.2,0,0,1,7,0,0,0,0.2,0.2,0.0,18,EL
dc4f62fd,5,245,2.7,3,1,2,0,3,5,-2,2.6,4.8,-2.1,18,EL
dc52c72f,9,747,8.3,9,7,0,0,13,13,0,14.0,14.6,-0.7,18,EL
dc62fbee,4,244,2.7,2,2,2,0,6,5,1,4.6,3.0,1.6,18,EL
dc6f5bdd,8,600,6.7,5,3,3,2,17,5,12,13.1,7.2,5.8,18,EL
dc8f5b58,3,270,3.0,3,3,0,0,4,10,-6,2.6,5.4,-2.8,18,EL
dc90cfbe,3,300,3.3,3,3,0,0,4,7,-3,5.8,4.4,1.4,18,EL
dcd160e4,8,693,7.7,8,4,0,0,9,12,-3,8.0,12.8,-4.8,18,EL
dd08d93a,1,90,1.0,1,1,0,3,0,3,-3,0.3,1.5,-1.2,18,EL
dd0daf32,6,416,4.6,5,2,1,0,11,4,7,9.1,4.1,5.0,18,EL
dd2044f4,2,173,1.9,2,1,0,4,2,3,-1,1.4,3.0,-1.6,18,EL
de0282f9,5,195,2.2,2,1,3,1,2,4,-2,1.0,5.1,-4.1,18,EL
de39485a,1,31,0.3,0,0,1,0,2,0,2,0.5,0.5,0.0,18,EL
dead55e5,8,396,4.4,4,2,4,0,5,3,2,6.7,3.6,3.1,18,EL
debc6b55,7,244,2.7,2,0,5,0,7,5,2,5.0,2.7,2.3,18,EL
dee86451,4,255,2.8,3,2,1,0,6,5,1,7.1,2.8,4.3,18,EL
def69cd0,6,364,4.0,5,3,1,1,8,4,4,5.5,4.0,1.5,18,EL
df525574,8,720,8.0,8,8,0,0,8,8,0,8.9,9.1,-0.2,18,EL
df69b544,8,631,7.0,7,3,1,1,16,3,13,12.2,7.4,4.8,18,EL
df85d472,2,110,1.2,1,0,1,0,2,2,0,2.6,1.8,0.8,18,EL
dff153a4,7,545,6.1,6,4,1,1,12,4,8,8.2,6.6,1.7,18,EL
e0314d87,8,678,7.5,8,6,0,0,13,7,6,14.8,7.9,6.9,18,EL
e0a1c004,7,400,4.4,4,4,3,1,3,6,-3,3.1,5.7,-2.7,18,EL
e0cd04e0,2,118,1.3,1,1,1,2,5,0,5,4.4,0.6,3.8,18,EL
e12d7851,3,270,3.0,3,3,0,5,5,5,0,5.8,2.8,3.0,18,EL
e14ec482,1,36,0.4,0,0,1,3,0,1,-1,0.1,0.7,-0.6,18,EL
e16dd48e,2,135,1.5,1,1,1,4,2,1,1,1.9,3.4,-1.5,18,EL
e1bbb68d,2,148,1.6,2,1,0,1,0,4,-4,0.7,3.2,-2.5,18,EL
e248e62f,2,137,1.5,2,0,0,3,2,3,-1,1.1,1.6,-0.5,18,EL
e280527c,5,261,2.9,3,2,2,0,6,7,-1,3.8,5.6,-1.8,18,EL
e2a302a8,4,253,2.8,3,2,1,1,1,4,-3,2.0,3.8,-1.8,18,EL
e2bf2abc,2,99,1.1,1,1,1,2,0,1,-1,0.4,1.2,-0.8,18,EL
e3207d47,1,2,0.0,0,0,1,7,0,0,0,0.1,0.0,0.1,18,EL
e32721e6,1,8,0.1,0,0,1,2,0,0,0,0.0,0.1,-0.1,18,EL
e358587b,2,180,2.0,2,2,0,0,3,3,0,2.8,3.0,-0.2,18,EL
e373f1ec,4,223,2.5,2,2,2,0,3,4,-1,2.6,3.5,-0.9,18,EL
e3993b65,8,717,8.0,8,6,0,0,13,13,0,9.1,12.0,-2.9,18,EL
e3a5814e,9,704,7.8,8,7,1,3,17,6,11,13.7,7.5,6.3,18,EL
e3d0b0c4,10,900,10.0,10,10,0,0,18,8,10,16.6,10.3,6.3,18,EL
e41ee432,5,445,4.9,5,4,0,2,6,6,0,6.4,5.8,0.6,18,EL
e4738e91,5,310,3.4,4,1,1,1,5,7,-2,3.7,6.7,-3.0,18,EL
e4a26a91,4,360,4.0,4,4,0,0,4,3,1,4.3,4.2,0.2,18,EL
e4ed2628,2,152,1.7,2,1,0,3,5,1,4,1.7,0.4,1.3,18,EL
e4fcb211,4,207,2.3,3,0,1,2,2,0,2,2.3,1.4,1.0,18,EL
e599253a,1,74,0.8,1,0,0,1,1,1,0,0.5,0.5,0.1,18,EL
e61b8aee,6,494,5.5,5,5,1,1,11,4,7,11.8,6.4,5.4,18,EL
e61c6efb,6,467,5.2,5,4,1,0,7,12,-5,6.7,10.1,-3.5,18,EL
e66a1ad7,4,360,4.0,4,4,0,2,7,6,1,3.8,5.6,-1.8,18,EL
e6ad16b2,2,118,1.3,2,0,0,0,2,0,2,1.4,1.1,0.3,18,EL
e704919e,2,180,2.0,2,2,0,0,1,3,-2,1.4,2.3,-0.9,18,EL
e73659d3,2,161,1.8,2,1,0,0,1,3,-2,1.3,2.2,-0.9,18,EL
e7986081,2,174,1.9,2,1,0,0,1,3,-2,1.4,2.3,-0.9,18,EL
e7ee38c3,6,540,6.0,6,6,0,1,7,6,1,8.1,7.2,0.9,18,EL
e814316b,3,262,2.9,3,0,0,0,0,0,0,0.0,0.0,0.0,18,EL
e81f0356,1,90,1.0,1,1,0,10,2,1,1,2.0,0.6,1.4,18,EL
e8ce5a3e,1,57,0.6,0,0,1,6,0,2,-2,0.7,1.9,-1.2,18,EL
e8d0a3a1,1,3,0.0,0,0,1,3,0,0,0,0.1,0.0,0.1,18,EL
e94d79e3,2,116,1.3,2,1,0,1,1,1,0,3.6,0.9,2.7,18,EL
e961d3ac,3,270,3.0,3,3,0,0,2,5,-3,2.0,3.1,-1.2,18,EL
e97150c0,6,496,5.5,6,5,0,2,9,3,6,9.6,5.2,4.4,18,EL
e978d6b6,4,277,3.1,3,0,1,0,0,0,0,0.0,0.0,0.0,18,EL
ea07ceb3,6,373,4.1,4,3,2,0,7,14,-7,5.0,8.2,-3.2,18,EL
ea0ff634,13,843,9.4,10,3,3,2,9,10,-1,13.6,9.8,3.8,18,EL
ea490705,4,185,2.1,2,1,2,1,2,2,0,1.4,2.7,-1.2,18,EL
ea6a7ab4,4,101,1.1,1,0,3,0,2,2,0,3.1,1.7,1.4,18,EL
ea7a8366,6,426,4.7,4,4,2,0,5,11,-6,5.4,6.7,-1.3,18,EL
eac044ad,14,1286,14.3,14,13,0,0,21,13,8,17.5,13.2,4.4,18,EL
ead960f2,8,459,5.1,5,1,3,0,9,10,-1,5.9,8.5,-2.5,18,EL
eafac393,5,430,4.8,5,4,0,1,9,7,2,4.8,5.8,-0.9,18,EL
eb174a27,2,170,1.9,2,1,0,3,2,1,1,1.8,1.4,0.3,18,EL
eb2b33aa,3,270,3.0,3,0,0,0,7,4,3,6.8,5.1,1.7,18,EL
eb3f56e5,1,90,1.0,1,1,0,2,2,0,2,0.4,1.3,-0.9,18,EL
eb5bc3eb,2,155,1.7,2,1,0,4,1,3,-2,1.5,1.0,0.4,18,EL
eb87ec70,4,302,3.4,4,1,0,2,1,3,-2,4.3,4.0,0.4,18,EL
ebc29a56,5,354,3.9,4,1,1,0,3,8,-5,4.6,4.1,0.5,18,EL
ebc49727,2,74,0.8,1,0,1,0,1,1,0,0.7,0.7,0.1,18,EL
ecab64a0,3,132,1.5,1,1,2,3,0,1,-1,2.6,2.6,0.0,18,EL
ecbb3fdf,4,360,4.0,4,4,0,0,5,5,0,5.5,6.5,-1.1,18,EL
ecf151ac,3,66,0.7,1,0,2,3,0,0,0,1.6,1.2,0.4,18,EL
ed16934e,2,82,0.9,0,0,2,0,0,1,-1,1.1,1.0,0.2,18,EL
ed2b33cb,4,216,2.4,2,2,2,6,6,2,4,3.3,3.6,-0.2,18,EL
ed560575,7,625,6.9,7,6,0,0,7,6,1,6.7,7.5,-0.8,18,EL
ed5886d2,8,572,6.4,6,6,2,1,18,10,8,14.3,7.2,7.1,18,EL
ed60d19f,4,239,2.7,3,2,1,1,3,6,-3,1.9,5.6,-3.6,18,EL
ed90babd,1,60,0.7,1,0,0,1,1,0,1,0.2,1.4,-1.2,18,EL
ed99d19e,1,3,0.0,0,0,1,1,0,1,-1,0.0,0.1,-0.1,18,EL
eddcbbc4,6,293,3.3,2,2,4,0,3,11,-8,4.1,7.8,-3.7,18,EL
ee833569,8,720,8.0,8,8,0,0,17,8,9,15.6,8.8,6.8,18,EL
ee8508c0,6,540,6.0,6,6,0,0,8,2,6,8.2,6.6,1.5,18,EL
ef3909cd,8,720,8.0,8,8,0,0,10,11,-1,8.9,11.4,-2.4,18,EL
ef4249ff,5,291,3.2,3,1,2,1,7,5,2,5.0,4.8,0.2,18,EL
ef5b337e,8,467,5.2,5,4,3,0,10,6,4,8.3,6.5,1.9,18,EL
ef619b0b,6,540,6.0,6,6,0,0,12,6,6,12.9,7.8,5.1,18,EL
ef8cafeb,2,170,1.9,1,1,1,0,3,4,-1,1.9,2.2,-0.3,18,EL
ef8f266e,3,97,1.1,1,0,2,0,2,1,1,2.2,1.1,1.2,18,EL
efc33b33,3,98,1.1,1,1,2,5,0,1,-1,0.8,1.9,-1.1,18,EL
efe679a0,8,635,7.1,7,6,1,0,13,10,3,8.1,11.0,-2.8,18,EL
f00de885,10,900,10.0,10,10,0,0,18,8,10,16.6,10.3,6.3,18,EL
f04f45a2,1,19,0.2,0,0,1,0,0,0,0,0.2,0.6,-0.4,18,EL
f07be45a,3,246,2.7,3,2,0,0,3,10,-7,2.6,5.3,-2.7,18,EL
f08a8947,7,542,6.0,6,6,1,0,12,12,0,6.8,10.1,-3.3,18,EL
f0da930c,7,630,7.0,7,7,0,1,18,3,15,11.1,6.6,4.5,18,EL
f0e3b343,6,290,3.2,3,1,3,0,2,3,-1,2.8,2.9,-0.1,18,EL
f0faccb9,1,12,0.1,0,0,1,2,0,0,0,0.3,0.3,0.1,18,EL
f0fc9d0e,9,397,4.4,3,2,6,1,7,8,-1,5.0,7.3,-2.3,18,EL
f15b778f,5,446,5.0,5,4,0,0,6,2,4,6.3,4.5,1.9,18,EL
f1b17a24,6,467,5.2,5,5,1,0,4,4,0,6.7,5.7,0.9,18,EL
f1bed920,2,151,1.7,2,1,0,3,3,3,0,4.0,1.5,2.5,18,EL
f24ea523,3,116,1.3,1,0,2,2,2,1,1,1.9,1.0,0.9,18,EL
f25c8e3a,5,446,5.0,5,4,0,0,8,8,0,8.2,6.6,1.6,18,EL
f2d063ec,10,930,10.3,10,10,0,0,18,12,6,15.6,14.8,0.8,18,EL
f2e3b81c,1,69,0.8,1,0,0,0,1,1,0,0.7,0.6,0.1,18,EL
f2eaebe9,6,411,4.6,5,0,1,1,8,6,2,6.3,6.6,-0.3,18,EL
f30a4ab1,5,388,4.3,4,4,1,0,5,7,-2,7.1,4.9,2.2,18,EL
f33238db,1,1,0.0,0,0,1,3,0,0,0,0.0,0.0,0.0,18,EL
f346787e,2,74,0.8,1,0,1,0,1,3,-2,0.6,1.3,-0.7,18,EL
f373db50,4,356,4.0,4,3,0,0,2,10,-8,3.0,7.1,-4.1,18,EL
f3f5941f,8,652,7.2,8,3,0,0,9,6,3,9.1,10.5,-1.4,18,EL
f4081572,1,90,1.0,1,1,0,3,1,1,0,1.0,1.8,-0.8,18,EL
f447fcdb,6,540,6.0,6,6,0,0,5,10,-5,8.3,8.1,0.3,18,EL
f4a8e2ed,5,310,3.4,4,0,1,1,1,7,-6,2.8,3.3,-0.4,18,EL
f4eb377b,10,930,10.3,10,10,0,0,18,12,6,15.6,14.8,0.8,18,EL
f5044e54,7,601,6.7,7,5,0,0,14,8,6,9.0,9.2,-0.3,18,EL
f50a668a,5,450,5.0,5,5,0,1,5,11,-6,3.7,11.2,-7.6,18,EL
f5b6fb78,1,90,1.0,1,1,0,2,1,2,-1,0.7,1.2,-0.5,18,EL
f5eedf74,7,495,5.5,6,2,1,1,5,6,-1,4.0,6.1,-2.1,18,EL
f5efb153,6,383,4.3,6,4,0,0,9,4,5,10.0,5.2,4.9,18,EL
f69d4d79,2,116,1.3,2,1,0,0,0,0,0,1.0,1.4,-0.4,18,EL
f69fba57,6,355,3.9,3,2,3,0,5,3,2,5.4,4.7,0.7,18,EL
f6ac68c1,4,195,2.2,2,2,2,1,3,1,2,3.6,2.7,0.9,18,EL
f6d4b6b2,1,3,0.0,0,0,1,0,0,0,0,0.0,0.3,-0.3,18,EL
f7223718,9,653,7.3,7,6,2,2,17,8,9,15.1,4.9,10.1,18,EL
f73abe54,8,553,6.1,7,1,1,0,7,5,2,8.1,4.7,3.4,18,EL
f7815d38,6,357,4.0,4,2,2,0,3,10,-7,3.1,8.7,-5.6,18,EL
f7aa75bd,3,270,3.0,3,3,0,0,3,5,-2,4.4,5.0,-0.6,18,EL
f7b10c66,5,450,5.0,5,5,0,0,5,7,-2,7.4,5.0,2.4,18,EL
f7b1d4e0,8,720,8.0,8,8,0,0,10,8,2,10.0,11.8,-1.8,18,EL
f7dc2ae5,5,374,4.2,4,4,1,3,13,6,7,11.5,5.3,6.2,18,EL
f7e87032,8,649,7.2,8,5,0,0,12,12,0,12.4,12.2,0.2,18,EL
f814f0f1,3,211,2.3,2,1,1,3,0,4,-4,1.5,4.2,-2.7,18,EL
f833a830,8,197,2.2,1,0,7,4,6,4,2,3.7,1.9,1.8,18,EL
f86cabbd,3,270,3.0,3,3,0,3,3,2,1,5.6,3.6,1.9,18,EL
f874dd44,8,720,8.0,8,8,0,0,17,9,8,15.8,8.8,6.9,18,EL
f8bfb4ae,6,431,4.8,5,4,1,0,3,3,0,5.0,5.5,-0.5,18,EL
f8eca1b6,5,291,3.2,3,2,2,0,6,5,1,4.8,4.6,0.2,18,EL
f9a5c9c1,6,527,5.9,6,4,0,0,6,10,-4,4.0,9.3,-5.3,18,EL
f9c927de,5,355,3.9,4,3,1,0,3,5,-2,4.8,3.5,1.3,18,EL
fa274d97,5,450,5.0,5,5,0,0,7,9,-2,6.5,4.9,1.6,18,EL
fa6292e2,6,487,5.4,6,2,0,0,8,6,2,11.1,4.8,6.3,18,EL
fa7e8a83,2,171,1.9,2,1,0,3,2,1,1,3.2,1.1,2.1,18,EL
faa1b07d,1,90,1.0,1,1,0,1,2,1,1,0.6,0.5,0.2,18,EL
fae8f607,5,371,4.1,4,4,1,1,3,7,-4,3.0,4.4,-1.3,18,EL
faed84db,6,24,0.3,0,0,6,1,0,0,0,0.7,0.8,-0.1,18,EL
fb054320,8,663,7.4,7,4,1,0,7,8,-1,6.6,8.5,-1.9,18,EL
fb2a63bb,4,232,2.6,2,2,2,1,3,4,-1,2.3,2.4,-0.1,18,EL
fb2c533b,9,696,7.7,8,6,1,3,14,10,4,13.0,8.3,4.7,18,EL
fb5022e4,4,134,1.5,1,0,3,2,3,1,2,2.9,0.5,2.4,18,EL
fb517645,6,394,4.4,5,2,1,0,1,8,-7,2.8,4.5,-1.7,18,EL
fb59286d,6,416,4.6,4,3,2,0,3,6,-3,5.2,4.8,0.4,18,EL
fb5d47b3,5,450,5.0,5,5,0,2,6,5,1,7.4,7.4,0.0,18,EL
fb5eb6e0,1,90,1.0,1,1,0,6,0,2,-2,0.8,0.6,0.2,18,EL
fbafd1b0,4,286,3.2,4,2,0,0,2,5,-3,2.4,3.4,-1.1,18,EL
fbb23472,10,900,10.0,10,10,0,0,14,14,0,10.1,11.8,-1.8,18,EL
fc176c8b,1,1,0.0,0,0,1,3,1,0,1,0.0,0.0,0.0,18,EL
fc1cf07a,5,323,3.6,3,3,2,0,3,3,0,4.8,4.1,0.7,18,EL
fc3f41aa,3,182,2.0,3,1,0,1,3,2,1,2.9,2.5,0.4,18,EL
fc4cf6a7,3,270,3.0,3,3,0,2,3,4,-1,5.1,3.3,1.8,18,EL
fc4f85b1,8,720,8.0,8,8,0,0,17,4,13,12.6,8.8,3.8,18,EL
fcb8b607,6,398,4.4,5,0,1,0,3,4,-1,3.8,5.7,-1.9,18,EL
fcd24f5f,3,270,3.0,3,3,0,3,1,4,-3,1.9,3.6,-1.7,18,EL
fce2302c,2,180,2.0,2,2,0,0,1,3,-2,1.4,2.3,-0.9,18,EL
fd2bc67d,8,720,8.0,8,8,0,0,14,11,3,9.8,12.5,-2.7,18,EL
fd4ee68b,7,630,7.0,7,7,0,0,5,4,1,7.3,6.0,1.3,18,EL
fd6f2466,6,494,5.5,5,5,1,0,3,6,-3,3.6,6.0,-2.4,18,EL
fe2db476,3,270,3.0,3,3,0,0,4,3,1,4.0,4.6,-0.7,18,EL
fe322052,4,311,3.5,4,2,0,1,7,4,3,3.8,4.7,-0.9,18,EL
fec5accc,9,698,7.8,9,6,0,0,17,6,11,10.5,9.1,1.3,18,EL
fefce889,1,90,1.0,1,1,0,2,0,3,-3,1.1,2.4,-1.4,18,EL
ff98492b,2,117,1.3,1,0,1,0,1,3,-2,1.5,3.2,-1.7,18,EL
ffbbc83b,3,236,2.6,3,2,0,1,3,6,-3,4.2,3.3,0.9,18,EL
ffc3c7ba,6,322,3.6,3,2,3,0,4,6,-2,5.1,3.2,1.9,18,EL
ffd740c5,8,419,4.7,4,3,4,2,7,5,2,4.7,5.6,-0.8,18,EL
000b3da6,20,1583,17.6,18,15,2,0,10,27,-17,18.7,26.8,-8.1,18,SPA
003a5c72,26,2155,23.9,24,20,2,7,24,36,-12,29.2,33.0,-3.9,18,SPA
00b28772,15,557,6.2,6,4,9,16,7,8,-1,7.6,9.8,-2.2,18,SPA
011d8c56,9,764,8.5,9,8,0,2,9,8,1,8.9,9.2,-0.3,18,SPA
01ae64cd,3,184,2.0,2,2,1,4,3,3,0,2.5,3.4,-0.8,18,SPA
01eb744d,37,2253,25.0,27,6,10,0,40,9,31,35.4,20.8,14.5,18,SPA
02c15616,13,546,6.1,5,3,8,10,12,5,7,14.8,8.4,6.4,18,SPA
02d2c436,36,3240,36.0,36,36,0,0,23,57,-34,36.5,54.6,-18.1,18,SPA
04965583,15,460,5.1,4,0,11,8,17,2,15,15.5,6.7,8.8,18,SPA
04a65a8f,18,1463,16.3,18,12,0,0,21,17,4,20.6,17.8,2.8,18,SPA
04ac8285,1,90,1.0,1,1,0,37,5,1,4,2.8,1.0,1.8,18,SPA
04e17fd5,25,1596,17.7,16,12,9,3,12,27,-15,20.1,24.7,-4.6,18,SPA
05384ea1,28,2130,23.7,26,17,2,3,14,37,-23,21.5,41.2,-19.7,18,SPA
05a4465d,30,2439,27.1,27,25,3,5,31,33,-2,28.6,36.2,-7.5,18,SPA
0657888a,23,1448,16.1,18,4,5,0,15,24,-9,16.4,19.1,-2.7,18,SPA
070a3904,35,2782,30.9,32,21,3,0,25,34,-9,31.1,42.5,-11.5,18,SPA
07a0baa9,4,71,0.8,0,0,4,9,1,4,-3,1.0,2.7,-1.7,18,SPA
07d67579,10,467,5.2,4,3,6,4,2,8,-6,4.5,12.4,-7.9,18,SPA
080ac8d8,2,39,0.4,0,0,2,0,0,2,-2,1.0,0.5,0.5,18,SPA
08511d65,26,2289,25.4,26,23,0,0,50,31,19,52.7,29.4,23.3,18,SPA
0959c2a2,24,1233,13.7,12,6,12,4,14,27,-13,18.0,21.7,-3.8,18,SPA
09a9e921,35,2497,27.7,30,11,5,0,43,35,8,38.7,36.8,1.9,18,SPA
0a0cc13c,31,1978,22.0,23,12,8,6,33,37,-4,27.1,28.5,-1.4,18,SPA
0a447501,17,853,9.5,8,5,9,2,22,17,5,12.9,12.6,0.3,18,SPA
0ac94a23,24,926,10.3,9,0,15,3,18,11,7,19.0,13.2,5.9,18,SPA
0ae4e09a,17,963,10.7,10,5,7,2,17,15,2,17.2,16.5,0.8,18,SPA
0af4dcf0,15,1263,14.0,15,9,0,0,22,16,6,18.0,18.4,-0.3,18,SPA
0b90bb97,32,1554,17.3,17,7,15,4,31,23,8,27.3,24.5,2.8,18,SPA
0c3f7197,23,665,7.4,4,2,19,4,11,11,0,11.3,10.0,1.4,18,SPA
0d10333c,29,2377,26.4,28,16,1,1,23,32,-9,29.4,31.2,-1.8,18,SPA
0e7ccfc4,12,821,9.1,9,4,3,6,16,16,0,14.2,14.0,0.2,18,SPA
0ef89a37,18,1296,14.4,16,6,2,0,33,16,17,25.2,18.8,6.4,18,SPA
0f138d5a,12,885,9.8,9,7,3,17,18,16,2,15.2,15.6,-0.4,18,SPA
1001ae82,27,1360,15.1,15,3,12,3,27,22,5,19.3,18.8,0.4,18,SPA
102fda08,1,5,0.1,0,0,1,1,0,0,0,0.0,0.0,0.0,18,SPA
10e25802,8,418,4.6,6,1,2,13,1,12,-11,3.1,9.9,-6.8,18,SPA
113fb4ea,4,360,4.0,4,4,0,32,1,10,-9,5.7,9.3,-3.6,18,SPA
119b9a8e,19,1710,19.0,19,19,0,0,23,22,1,27.7,27.7,0.0,18,SPA
11c30a46,10,476,5.3,6,0,4,4,4,12,-8,5.7,9.7,-4.0,18,SPA
1214f0a6,1,90,1.0,1,1,0,1,1,0,1,1.3,1.6,-0.3,18,SPA
1250086e,11,860,9.6,9,9,2,17,5,23,-18,7.2,19.3,-12.1,18,SPA
12a875ce,2,15,0.2,0,0,2,2,1,0,1,0.4,0.1,0.4,18,SPA
12c50af5,18,595,6.6,4,3,14,9,23,5,18,18.2,10.9,7.3,18,SPA
130a7a3f,30,2074,23.0,25,10,5,1,43,27,16,36.4,31.8,4.7,18,SPA
13b0c150,15,1190,13.2,14,12,1,12,21,14,7,17.7,15.2,2.6,18,SPA
148d4105,8,480,5.3,6,2,2,0,5,4,1,5.5,5.2,0.3,18,SPA
1512328c,21,1209,13.4,15,2,6,7,8,17,-9,11.4,18.8,-7.4,18,SPA
1633fc8a,35,3065,34.1,34,34,1,2,47,55,-8,46.0,47.2,-1.2,18,SPA
167c1bb0,32,2410,26.8,27,22,5,2,41,39,2,28.8,34.1,-5.3,18,SPA
174651c8,17,925,10.3,10,7,7,10,11,13,-2,12.3,13.2,-0.9,18,SPA
174f09a6,20,1773,19.7,20,18,0,2,9,27,-18,18.2,27.3,-9.1,18,SPA
1771f2c1,14,1189,13.2,13,10,1,12,6,24,-18,13.2,18.4,-5.1,18,SPA
1961b2aa,16,635,7.1,6,2,10,10,16,5,11,15.1,6.2,8.9,18,SPA
19b776e9,28,1466,16.3,15,9,13,2,16,25,-9,15.0,28.4,-13.4,18,SPA
1a317a1b,19,1392,15.5,15,15,4,14,18,24,-6,14.2,22.4,-8.3,18,SPA
1b17ed86,25,1230,13.7,11,5,14,6,14,14,0,16.3,16.7,-0.4,18,SPA
1b84dbe1,12,704,7.8,8,6,4,19,17,7,10,12.6,10.3,2.3,18,SPA
1bda5842,37,2997,33.3,35,16,2,0,49,51,-2,43.9,43.3,0.6,18,SPA
1c8dc17d,24,1264,14.1,15,3,9,3,15,26,-11,19.3,22.799999999999997,-3.5,18,SPA
1d1691ad,35,2918,32.4,32,29,3,1,54,56,-2,44.2,45.0,-0.8,18,SPA
1d5f96d9,13,374,4.2,4,0,9,11,2,7,-5,5.9,9.5,-3.6,18,SPA
1f079188,28,1732,19.2,18,12,10,10,20,23,-3,19.2,22.7,-3.5,18,SPA
1fa85681,2,98,1.1,1,1,1,15,2,4,-2,1.9,2.0,-0.1,18,SPA
1fb1c435,37,2684,29.8,31,13,6,0,47,23,24,43.3,35.0,8.3,18,SPA
1fe0492d,24,2138,23.8,24,21,0,2,27,29,-2,25.8,29.9,-4.1,18,SPA
1fe67e86,18,1549,17.2,18,13,0,0,23,24,-1,24.1,22.5,1.6,18,SPA
20b9f052,29,2567,28.5,28,28,1,9,24,31,-7,29.7,39.5,-9.8,18,SPA
21164a21,2,106,1.2,1,1,1,0,2,3,-1,2.5,2.9,-0.3,18,SPA
217011a0,9,279,3.1,2,0,7,3,0,4,-4,3.6,6.1,-2.5,18,SPA
21d4e122,24,2025,22.5,23,20,1,5,19,40,-21,27.0,38.0,-11.0,18,SPA
220c11f1,33,2710,30.1,32,18,1,3,36,44,-8,38.4,37.0,1.4,18,SPA
22df75d8,1,65,0.7,0,0,1,1,0,2,-2,0.6,0.9,-0.2,18,SPA
2306bfde,6,221,2.5,3,0,3,10,5,5,0,4.1,4.2,-0.2,18,SPA
23593121,8,519,5.8,7,2,1,6,5,2,3,9.6,6.1,3.4,18,SPA
23f32ea1,2,27,0.3,0,0,2,2,0,0,0,0.1,0.2,0.0,18,SPA
240d3a0b,32,2775,30.8,32,26,0,3,42,38,4,35.6,35.4,0.2,18,SPA
24279b8b,28,2478,27.5,27,27,1,0,25,58,-33,36.0,43.3,-7.3,18,SPA
244f57b9,5,217,2.4,1,1,4,1,0,8,-8,2.1,5.5,-3.4,18,SPA
24f59bb2,14,1189,13.2,14,13,0,1,19,9,10,14.9,11.8,3.1,18,SPA
251336da,11,721,8.0,6,5,5,8,3,19,-16,8.8,13.1,-4.3,18,SPA
2513a588,20,797,8.9,9,1,11,12,11,9,2,8.6,11.7,-3.0,18,SPA
2515040a,15,1239,13.8,13,12,2,3,11,21,-10,14.0,22.8,-8.8,18,SPA
25c72b36,1,29,0.3,0,0,1,1,0,1,-1,0.0,1.1,-1.1,18,SPA
26f2473f,9,765,8.5,8,8,1,26,8,13,-5,11.9,9.7,2.1,18,SPA
283c7121,3,96,1.1,0,0,3,5,1,6,-5,2.2,2.7,-0.5,18,SPA
28d596a0,30,2700,30.0,30,30,0,1,31,43,-12,38.5,40.3,-1.9,18,SPA
293211e1,33,2152,23.9,21,15,12,2,26,24,2,29.8,27.4,2.4,18,SPA
294450ba,14,676,7.5,7,6,7,9,11,9,2,8.8,11.7,-2.9,18,SPA
2946f9a1,27,2074,23.0,22,20,5,6,66,27,39,52.4,25.0,27.4,18,SPA
29b61deb,31,2559,28.4,30,24,1,3,37,43,-6,38.3,36.9,1.4,18,SPA
2a0c8ba4,35,2427,27.0,25,20,10,2,31,33,-2,27.9,30.3,-2.3,18,SPA
2a70c756,16,562,6.2,6,0,10,11,5,7,-2,3.0,6.3,-3.3,18,SPA
2b15a82a,3,193,2.1,2,2,1,5,2,4,-2,2.9,2.3,0.6,18,SPA
2bee98fd,33,1641,18.2,14,10,19,1,20,15,5,24.2,22.6,1.7,18,SPA
2cea96ce,10,579,6.4,5,5,5,26,6,6,0,9.4,8.1,1.3,18,SPA
2e23c66b,25,1276,14.2,10,5,15,3,24,21,3,22.9,21.5,1.3,18,SPA
2e8fc160,28,1878,20.9,23,14,5,3,13,33,-20,18.8,34.2,-15.4,18,SPA
2ef16f06,2,14,0.2,0,0,2,10,0,1,-1,0.2,0.8,-0.7,18,SPA
2f3e911a,32,2815,31.3,31,30,1,5,28,35,-7,30.3,43.7,-13.4,18,SPA
3024e383,30,2426,27.0,28,21,2,5,31,35,-4,29.6,32.5,-2.9,18,SPA
30672832,2,81,0.9,1,0,1,16,0,3,-3,0.7,1.0,-0.3,18,SPA
307fcd26,3,225,2.5,3,2,0,7,2,6,-4,1.8,3.8,-1.9,18,SPA
31223bcf,18,1019,11.3,10,7,8,5,11,18,-7,11.899999999999999,18.3,-6.5,18,SPA
314eeab1,2,23,0.3,0,0,2,4,0,1,-1,0.1,0.0,0.1,18,SPA
322ba2df,6,423,4.7,5,4,1,9,4,7,-3,3.3,5.2,-1.9,18,SPA
32b84cec,6,68,0.8,0,0,6,5,1,1,0,1.1,1.2,-0.1,18,SPA
335fa267,30,2225,24.7,24,17,6,0,58,12,46,53.5,23.0,30.5,18,SPA
348e4809,20,1748,19.4,19,18,1,8,19,34,-15,27.7,27.6,0.1,18,SPA
3536fdc1,1,23,0.3,0,0,1,0,1,0,1,0.0,0.0,0.0,18,SPA
355c883a,21,1828,20.3,20,19,1,4,28,19,9,24.2,24.0,0.2,18,SPA
35f6db55,36,2677,29.7,31,17,5,1,31,34,-3,33.8,38.4,-4.6,18,SPA
379652be,18,686,7.6,6,0,12,7,8,7,1,10.5,10.5,0.0,18,SPA
37e103f8,2,19,0.2,0,0,2,1,0,1,-1,0.4,0.4,-0.1,18,SPA
37f1cf47,33,2249,25.0,25,20,8,3,28,36,-8,27.1,29.6,-2.5,18,SPA
37f96552,30,1981,22.0,20,11,10,1,20,32,-12,27.3,29.6,-2.3,18,SPA
38699c72,14,471,5.2,4,1,10,2,6,12,-6,6.0,7.2,-1.2,18,SPA
39583cfd,10,503,5.6,5,0,5,3,19,2,17,12.7,3.4,9.3,18,SPA
39e9c09a,1,76,0.8,1,0,0,2,1,0,1,0.8,0.9,-0.1,18,SPA
3a6a49f7,17,486,5.4,3,2,14,11,9,13,-4,9.5,11.5,-2.0,18,SPA
3a9c4b7b,7,447,5.0,5,4,2,14,15,8,7,8.6,8.4,0.1,18,SPA
3aa4a3be,15,1060,11.8,12,5,3,1,17,14,3,13.5,13.3,0.2,18,SPA
3b9f859b,6,424,4.7,5,4,1,5,2,10,-8,4.1,8.8,-4.7,18,SPA
3c7bc9bd,31,2516,28.0,29,23,2,2,27,30,-3,32.7,31.0,1.7,18,SPA
3d7e48ce,22,1102,12.2,14,1,8,6,16,11,5,13.1,13.6,-0.5,18,SPA
3e1858af,13,1060,11.8,13,9,0,0,8,12,-4,13.8,14.7,-0.9,18,SPA
3e4f735d,34,2799,31.1,31,31,3,2,34,31,3,41.8,34.4,7.4,18,SPA
3e5a168c,1,63,0.7,1,0,0,1,1,0,1,1.5,1.1,0.4,18,SPA
3ecc11d8,8,675,7.5,7,7,1,6,7,10,-3,6.7,8.5,-1.9,18,SPA
3eed9821,25,2189,24.3,24,23,1,3,59,17,42,49.2,26.1,23.2,18,SPA
3f10bd22,26,1763,19.6,20,16,6,2,21,28,-7,32.2,27.4,4.8,18,SPA
3f79a1c8,28,1565,17.4,16,9,12,7,16,31,-15,15.6,23.8,-8.2,18,SPA
3fc45c73,28,2495,27.7,28,27,0,0,33,44,-11,35.4,36.1,-0.7,18,SPA
41c12f75,3,103,1.1,1,1,2,3,1,0,1,0.6,1.2,-0.6,18,SPA
42276181,25,1125,12.5,11,3,14,11,19,10,9,17.7,12.3,5.4,18,SPA
4242011c,34,2868,31.9,32,30,2,2,41,49,-8,42.1,43.8,-1.7,18,SPA
42dcf26d,33,2898,32.2,32,30,1,0,44,45,-1,45.3,46.8,-1.5,18,SPA
43f71e77,36,2786,31.0,31,20,5,0,36,27,9,40.5,31.7,8.8,18,SPA
4410f0b0,1,45,0.5,0,0,1,1,0,2,-2,0.2,1.1,-0.9,18,SPA
44b61913,8,673,7.5,8,6,0,6,7,10,-3,7.5,11.7,-4.2,18,SPA
45af8a54,32,1844,20.5,19,12,13,3,51,24,27,47.9,22.0,25.9,18,SPA
45b9b619,21,1193,13.3,15,3,6,9,17,12,5,24.0,15.0,9.0,18,SPA
45e304c8,23,1034,11.5,12,1,11,4,15,12,3,15.0,16.5,-1.4,18,SPA
4601e194,33,2744,30.5,30,27,3,3,81,21,60,70.9,31.7,39.2,18,SPA
46166b49,9,628,7.0,8,3,1,1,9,12,-3,7.7,10.5,-2.8,18,SPA
467bae22,30,1838,20.4,22,7,8,4,22,33,-11,30.6,30.5,0.1,18,SPA
46a8347f,21,1696,18.8,19,16,2,5,28,13,15,21.1,13.2,7.9,18,SPA
46e07328,1,6,0.1,0,0,1,0,1,0,1,0.5,0.1,0.4,18,SPA
4737cebe,28,1573,17.5,18,2,10,3,29,27,2,25.4,20.1,5.3,18,SPA
474ecac8,30,2425,26.9,27,24,3,3,32,39,-7,33.0,43.1,-10.1,18,SPA
48593154,14,433,4.8,4,1,10,12,9,6,3,8.0,6.5,1.5,18,SPA
485e4939,7,304,3.4,4,1,3,6,3,10,-7,5.1,4.6,0.5,18,SPA
487d9b09,29,2373,26.4,28,23,1,4,38,43,-5,31.5,35.5,-4.1,18,SPA
48e4c485,7,251,2.8,3,0,4,6,1,7,-6,1.6,2.9,-1.3,18,SPA
48e89655,30,1738,19.3,22,4,8,0,16,20,-4,21.7,27.4,-5.8,18,SPA
4958bfb2,25,2222,24.7,25,24,0,1,61,30,31,57.4,27.8,29.7,18,SPA
49ea92be,30,1459,16.2,18,5,12,5,23,26,-3,23.0,22.3,0.7,18,SPA
4a478107,35,3058,34.0,35,27,0,0,39,53,-14,40.0,55.7,-15.6,18,SPA
4a895384,5,376,4.2,5,3,0,23,3,4,-1,5.1,4.0,1.1,18,SPA
4ac7608e,18,1429,15.9,17,12,1,11,9,29,-20,17.2,26.0,-8.8,18,SPA
4accb7e0,23,1203,13.4,13,5,10,3,15,18,-3,12.9,18.2,-5.4,18,SPA
4b32b2be,1,1,0.0,0,0,1,2,0,0,0,0.0,0.0,0.0,18,SPA
4b3f2936,13,802,8.9,11,3,2,0,7,16,-9,9.3,14.6,-5.3,18,SPA
4bc5f2b4,5,251,2.8,2,2,3,2,0,4,-4,2.1,6.5,-4.4,18,SPA
4c0a6a48,4,54,0.6,0,0,4,4,1,0,1,1.2,0.9,0.3,18,SPA
4c2e9442,36,3068,34.1,35,25,1,0,50,54,-4,49.5,46.4,3.1,18,SPA
4c5b14d2,35,2479,27.5,29,15,6,0,40,50,-10,33.2,34.3,-1.1,18,SPA
4cafb146,2,71,0.8,1,0,1,3,0,1,-1,0.5,2.7,-2.2,18,SPA
4d224fe8,30,2595,28.8,30,24,0,5,70,33,37,60.5,33.4,27.0,18,SPA
4db76f57,13,1127,12.5,13,11,0,13,15,17,-2,17.8,14.2,3.5,18,SPA
4e2c27bb,1,4,0.0,0,0,1,1,0,0,0,0.0,0.1,-0.1,18,SPA
4efd29bb,10,436,4.8,5,3,5,3,3,8,-5,4.1,6.9,-2.8,18,SPA
4f28a6ff,35,3001,33.3,33,31,2,1,47,50,-3,54.3,47.4,6.9,18,SPA
4f6d9bcd,3,241,2.7,3,2,0,7,0,8,-8,2.7,6.8,-4.0,18,SPA
4ffb647d,14,1022,11.4,10,10,4,4,10,17,-7,10.6,14.3,-3.7,18,SPA
5070881b,7,541,6.0,6,6,1,7,19,1,18,12.2,4.1,8.0,18,SPA
50b51fac,14,1122,12.5,13,11,1,2,14,11,3,13.7,15.7,-2.0,18,SPA
51e3954c,21,1492,16.6,17,14,4,9,26,29,-3,27.0,21.7,5.3,18,SPA
529f49ab,33,2377,26.4,28,18,5,2,35,13,22,35.1,25.6,9.4,18,SPA
532e1e4f,2,52,0.6,0,0,2,13,1,2,-1,0.7,3.0,-2.4,18,SPA
54073b28,22,1837,20.4,21,16,1,0,12,30,-18,19.6,31.9,-12.3,18,SPA
5418d47c,1,64,0.7,1,0,0,1,1,3,-2,0.4,0.2,0.2,18,SPA
54f5ce34,14,1109,12.3,13,10,1,2,4,22,-18,10.2,18.8,-8.6,18,SPA
55126f3b,35,2756,30.6,33,23,2,0,45,15,30,37.5,28.7,8.8,18,SPA
555f3a0b,22,1928,21.4,22,21,0,7,18,28,-10,21.9,30.0,-8.1,18,SPA
56cafd0a,1,29,0.3,0,0,1,0,1,0,1,1.3,0.6,0.7,18,SPA
576575e5,3,173,1.9,3,1,0,0,3,2,1,3.0,1.2,1.8,18,SPA
57ebd662,29,2340,26.0,27,24,2,3,21,41,-20,27.4,40.4,-13.0,18,SPA
581c5276,1,90,1.0,1,1,0,28,4,1,3,1.3,1.7,-0.4,18,SPA
5890cef1,31,1835,20.4,20,13,11,4,29,31,-2,29.4,27.6,1.8,18,SPA
58afe001,27,2124,23.6,26,14,1,0,26,25,1,27.7,23.1,4.6,18,SPA
58bc7d18,10,900,10.0,10,10,0,28,20,11,9,20.7,11.3,9.4,18,SPA
59b7d823,32,2111,23.5,22,19,10,6,24,30,-6,30.4,37.3,-6.9,18,SPA
59d53e8a,14,993,11.0,10,7,4,6,20,15,5,14.2,14.1,0.0,18,SPA
5a3f6fae,15,1046,11.6,11,11,4,21,14,28,-14,15.2,20.1,-4.9,18,SPA
5ab0ea87,31,2593,28.8,30,22,1,2,72,23,49,60.2,31.2,29.1,18,SPA
5b2a4b8d,11,175,1.9,0,0,11,5,3,2,1,5.5,2.7,2.9,18,SPA
5b5724d2,6,540,6.0,6,6,0,4,4,11,-7,7.0,10.1,-3.1,18,SPA
5c256395,2,30,0.3,0,0,2,2,0,1,-1,0.3,0.8,-0.5,18,SPA
5c2da10f,23,1223,13.6,12,6,11,1,17,25,-8,19.2,21.8,-2.5000000000000004,18,SPA
5c7845f6,25,1582,17.6,16,13,9,10,29,29,0,25.0,24.5,0.4,18,SPA
5ca20b7a,30,2557,28.4,29,25,1,5,26,31,-5,33.3,32.4,0.9,18,SPA
5ce0b5ba,36,3163,35.1,35,33,1,0,60,55,5,48.2,47.1,1.1,18,SPA
5cec2487,25,2152,23.9,24,23,1,9,40,23,17,38.2,28.2,10.0,18,SPA
5d311e8d,8,720,8.0,8,8,0,4,15,9,6,11.8,7.5,4.3,18,SPA
5db04597,33,2642,29.4,32,22,1,3,39,46,-7,37.8,39.0,-1.2,18,SPA
5f0241b2,24,2156,24.0,23,23,1,14,29,39,-10,37.9,33.1,4.8,18,SPA
5f5501ed,13,529,5.9,5,2,8,6,7,9,-2,6.1,9.1,-2.9,18,SPA
5f7db81a,18,368,4.1,4,0,14,8,3,8,-5,3.4000000000000004,7.5,-4.2,18,SPA
6025fab1,26,1970,21.9,23,14,3,5,53,19,34,47.0,22.9,24.1,18,SPA
603116a7,28,2260,25.1,26,21,2,2,62,31,31,55.6,29.1,26.5,18,SPA
60713cb3,2,120,1.3,2,0,0,12,2,3,-1,2.3,2.8,-0.5,18,SPA
608f2092,30,2135,23.7,22,18,8,4,30,38,-8,30.9,31.9,-1.0,18,SPA
60ee859c,1,34,0.4,0,0,1,0,2,0,2,1.1,0.2,0.9,18,SPA
61220da2,35,2734,30.4,33,22,2,1,36,46,-10,33.4,50.7,-17.2,18,SPA
61bb7498,1,90,1.0,1,1,0,6,0,0,0,0.6,0.8,-0.2,18,SPA
61bd33d0,34,2631,29.2,31,19,3,1,38,39,-1,32.2,34.9,-2.6,18,SPA
625c144a,26,2340,26.0,26,26,0,4,50,45,5,38.2,36.5,1.7,18,SPA
63f04c6c,33,2440,27.1,27,20,6,2,28,38,-10,28.6,41.7,-13.1,18,SPA
6434f10d,37,3227,35.9,36,34,1,0,54,45,9,49.8,49.8,0.1,18,SPA
6435143e,2,19,0.2,0,0,2,0,0,2,-2,0.1,0.8,-0.8,18,SPA
643b39a6,26,1449,16.1,17,2,9,8,19,36,-17,25.7,26.6,-0.9,18,SPA
64e8ed6d,14,345,3.8,3,1,11,10,13,7,6,10.9,5.1,5.7,18,SPA
65d62814,30,2700,30.0,30,30,0,0,50,53,-3,35.2,41.5,-6.3,18,SPA
65d750b5,34,2349,26.1,25,19,9,3,41,17,24,36.0,25.2,10.8,18,SPA
6639e500,23,1078,12.0,12,3,11,3,22,17,5,19.6,14.1,5.6,18,SPA
6922f806,37,3109,34.5,34,29,3,0,21,67,-46,35.4,63.3,-27.9,18,SPA
6941883f,6,228,2.5,2,1,4,4,2,3,-1,3.7,3.1,0.6,18,SPA
697295b1,12,894,9.9,11,8,1,2,9,26,-17,12.3,16.4,-4.1,18,SPA
69cbc8b6,9,720,8.0,8,7,1,5,9,6,3,8.4,5.9,2.5,18,SPA
6a7586f4,2,143,1.6,2,0,0,4,2,3,-1,1.3,2.1,-0.8,18,SPA
6a99e0b1,38,2851,31.7,31,24,7,0,34,41,-7,41.0,39.6,1.4,18,SPA
6c2f5996,30,1819,20.2,18,14,12,4,32,29,3,23.3,30.2,-6.9,18,SPA
6ca663b4,9,445,4.9,5,2,4,4,6,11,-5,5.3,10.3,-5.0,18,SPA
6ce1f46f,27,2261,25.1,26,18,1,2,60,32,28,55.2,29.5,25.7,18,SPA
6cffc9df,6,115,1.3,1,0,5,0,1,5,-4,1.8,2.6,-0.8,18,SPA
6d5701f2,5,371,4.1,4,4,1,5,9,7,2,7.3,8.3,-1.1,18,SPA
6d8f8441,17,1383,15.4,16,12,1,3,23,23,0,22.2,25.7,-3.5,18,SPA
6dce77a5,30,1904,21.2,20,13,10,2,22,28,-6,30.7,30.8,-0.1,18,SPA
6df0dc74,8,480,5.3,6,3,2,4,2,13,-11,4.4,11.5,-7.2,18,SPA
6f0d613a,8,230,2.6,2,1,6,6,2,5,-3,2.5,3.1,-0.6,18,SPA
6f51e382,37,3330,37.0,37,37,0,1,94,28,66,80.7,41.0,39.8,18,SPA
6f5f82c0,2,76,0.8,1,0,1,6,0,1,-1,0.6,1.3,-0.6,18,SPA
6f7d826d,15,309,3.4,1,1,14,13,4,10,-6,4.7,7.4,-2.7,18,SPA
6fb59070,11,990,11.0,11,11,0,8,12,15,-3,12.1,17.4,-5.3,18,SPA
6fd1ba62,34,2264,25.2,26,12,8,4,31,34,-3,33.2,34.2,-1.0,18,SPA
70438d35,6,435,4.8,6,3,0,6,3,6,-3,3.7,8.2,-4.5,18,SPA
70d74ece,32,2150,23.9,25,12,7,0,62,29,33,54.0,29.3,24.7,18,SPA
71d4e271,29,1501,16.7,20,4,9,4,14,19,-5,14.2,24.2,-10.0,18,SPA
72a99e38,32,1693,18.8,16,9,16,2,32,31,1,21.5,29.0,-7.5,18,SPA
72b92c4e,5,192,2.1,2,1,3,10,2,4,-2,3.2,2.2,1.0,18,SPA
730bd100,10,573,6.4,7,3,3,0,7,15,-8,9.4,13.0,-3.6,18,SPA
7329018e,20,1204,13.3,15,8,5,10,14,16,-2,14.4,20.0,-5.7,18,SPA
73683fa9,10,853,9.5,10,9,0,19,12,11,1,11.4,12.8,-1.4,18,SPA
7460ca0d,34,3001,33.3,34,30,0,0,58,33,25,48.1,41.2,6.9,18,SPA
75751c99,35,3150,35.0,35,35,0,0,29,43,-14,36.0,41.5,-5.6,18,SPA
76ee80ee,1,16,0.2,0,0,1,0,0,0,0,0.1,0.1,-0.1,18,SPA
7789bf63,2,101,1.1,1,1,1,0,0,4,-4,0.2,2.9,-2.7,18,SPA
78c40e94,5,107,1.2,1,0,4,5,0,1,-1,1.3,1.7,-0.4,18,SPA
79135368,31,2385,26.5,26,22,5,4,23,24,-1,29.8,27.4,2.4,18,SPA
7956236f,5,450,5.0,5,5,0,31,7,7,0,8.5,5.4,3.1,18,SPA
79c0821a,21,992,11.0,10,3,11,7,28,18,10,26.0,15.9,10.1,18,SPA
7a4cd784,1,61,0.7,1,0,0,2,0,0,0,0.0,1.0,-0.9,18,SPA
7a9fae62,2,180,2.0,2,2,0,36,2,6,-4,2.6,3.9,-1.3,18,SPA
7c218bf9,4,308,3.4,4,3,0,25,4,0,4,4.6,1.7,2.9,18,SPA
7c2a398c,30,1623,18.0,17,6,13,0,18,26,-8,20.4,23.1,-2.7,18,SPA
7c4243d4,7,343,3.8,4,2,3,5,6,8,-2,6.5,6.5,0.0,18,SPA
7c689c48,2,81,0.9,1,0,1,2,0,1,-1,0.6,1.8,-1.2,18,SPA
7cefa219,9,610,6.8,6,6,3,10,8,11,-3,5.1,10.5,-5.4,18,SPA
7dcf86f6,34,2936,32.6,33,30,1,0,56,46,10,50.2,46.1,4.1,18,SPA
7e28d6f7,1,10,0.1,0,0,1,0,0,0,0,0.4,0.1,0.3,18,SPA
7eb97a8e,18,635,7.1,5,1,13,6,17,11,6,11.7,9.0,2.7,18,SPA
7ebfac0f,6,219,2.4,1,0,5,5,4,1,3,2.8,4.4,-1.6,18,SPA
7f203b54,25,2017,22.4,23,21,2,6,25,34,-9,22.3,38.1,-15.8,18,SPA
808d48f3,30,2536,28.2,29,24,1,3,43,34,9,38.0,39.0,-0.9,18,SPA
81069528,35,3123,34.7,35,33,0,1,24,53,-29,35.4,51.7,-16.3,18,SPA
81f0781e,38,3412,37.9,38,37,0,0,36,42,-6,41.0,52.3,-11.2,18,SPA
82927de4,35,2620,29.1,30,22,5,0,43,38,5,40.4,37.5,3.0,18,SPA
833fb62e,13,717,8.0,7,3,6,2,10,17,-7,14.4,12.2,2.3,18,SPA
83627094,3,134,1.5,1,0,2,14,3,2,1,3.4,1.5,1.9,18,SPA
83a83b0a,2,101,1.1,1,0,1,10,0,1,-1,1.8,1.9,-0.1,18,SPA
84399660,30,1489,16.5,18,4,12,8,30,26,4,20.7,22.3,-1.6,18,SPA
8497faf7,17,1528,17.0,17,16,0,17,22,22,0,18.5,22.9,-4.3,18,SPA
8499c713,2,30,0.3,0,0,2,5,0,0,0,0.3,0.5,-0.2,18,SPA
850c0a0d,29,2414,26.8,26,26,3,1,35,37,-2,30.8,30.3,0.4,18,SPA
8617e3d9,15,1153,12.8,14,10,1,2,7,17,-10,10.9,23.1,-12.2,18,SPA
8696bc90,33,2444,27.2,28,11,5,1,30,35,-5,28.7,34.5,-5.8,18,SPA
8754c7ca,31,2639,29.3,31,25,0,1,29,57,-28,39.4,41.8,-2.4,18,SPA
87882adc,18,1217,13.5,14,10,4,17,13,19,-6,14.4,21.8,-7.4,18,SPA
87ec1a2a,20,958,10.6,10,2,10,10,4,17,-13,10.100000000000001,17.4,-7.3,18,SPA
8875b8c9,17,1476,16.4,16,16,1,21,22,29,-7,24.0,24.2,-0.3,18,SPA
88a359d4,30,2345,26.1,26,20,4,0,22,54,-32,36.6,41.3,-4.7,18,SPA
89151b16,15,1257,14.0,14,13,1,1,23,31,-8,18.1,22.5,-4.4,18,SPA
895ff3ca,8,214,2.4,2,1,6,6,8,5,3,4.3,2.5,1.9,18,SPA
89f951b5,35,2835,31.5,31,24,4,1,82,22,60,70.4,30.0,40.4,18,SPA
8b6d1830,6,267,3.0,4,0,2,3,3,5,-2,3.4,6.4,-3.0,18,SPA
8b8a56ce,20,1571,17.5,18,16,2,3,18,30,-12,24.7,24.4,0.3,18,SPA
8c3c640c,35,2772,30.8,31,19,4,0,53,45,8,44.6,40.1,4.6,18,SPA
8c44e37b,20,985,10.9,8,5,12,5,7,18,-11,13.2,19.9,-6.7,18,SPA
8c83efb6,7,351,3.9,4,1,3,5,3,13,-10,4.2,7.5,-3.2,18,SPA
8ca253a3,28,1672,18.6,17,9,11,4,13,25,-12,18.1,22.1,-4.0,18,SPA
8cc3d96e,26,2061,22.9,26,10,0,2,18,29,-11,21.9,30.0,-8.1,18,SPA
8cfc2f69,33,2293,25.5,26,13,7,3,32,14,18,35.5,23.6,11.8,18,SPA
8d957256,27,2430,27.0,27,27,0,11,18,47,-29,27.5,48.9,-21.4,18,SPA
8db394aa,31,2608,29.0,29,28,2,4,14,49,-35,26.5,55.8,-29.3,18,SPA
8e010ff4,33,2460,27.3,28,15,5,4,31,23,8,37.0,27.7,9.3,18,SPA
8e088e04,16,797,8.9,9,3,7,19,14,10,4,13.2,12.5,0.7,18,SPA
8ef81d2d,7,246,2.7,2,2,5,5,1,9,-8,1.7,5.3,-3.6,18,SPA
8f8c6934,15,1264,14.0,15,14,0,21,20,19,1,21.6,21.3,0.4,18,SPA
9038c2a1,27,1786,19.8,22,10,5,2,19,25,-6,21.7,33.3,-11.6,18,SPA
90f83973,2,108,1.2,1,1,1,8,0,6,-6,1.3,4.1,-2.7,18,SPA
9109185e,8,720,8.0,8,8,0,30,10,6,4,11.2,10.0,1.3,18,SPA
9243fea6,10,469,5.2,5,1,5,2,3,6,-3,6.5,7.4,-0.9,18,SPA
92b4a127,26,1891,21.0,20,15,6,11,32,30,2,28.8,36.0,-7.1,18,SPA
92d38e6c,24,2057,22.9,24,19,0,3,18,27,-9,26.9,27.6,-0.7,18,SPA
93568a16,15,624,6.9,6,4,9,6,5,17,-12,7.2,15.3,-8.1,18,SPA
942b4f90,25,1700,18.9,18,13,7,12,24,27,-3,30.2,22.9,7.3,18,SPA
9592289a,33,2077,23.1,23,12,10,2,44,22,22,35.3,27.8,7.5,18,SPA
960fb42d,22,1979,22.0,22,21,0,6,12,44,-32,19.9,39.5,-19.6,18,SPA
963829d0,34,2698,30.0,32,19,2,0,47,38,9,43.3,42.7,0.6,18,SPA
967f34d3,22,1941,21.6,22,21,0,12,37,31,6,31.0,31.1,-0.1,18,SPA
9704b62b,2,113,1.3,1,1,1,2,1,0,1,1.5,1.8,-0.3,18,SPA
9744ff80,34,2395,26.6,27,15,7,1,36,35,1,42.2,35.3,6.9,18,SPA
97852360,38,3358,37.3,37,37,1,0,40,50,-10,38.5,55.4,-16.9,18,SPA
983ccabe,1,90,1.0,1,1,0,2,3,2,1,1.4,2.2,-0.8,18,SPA
9857e65d,13,673,7.5,8,1,5,6,5,22,-17,8.0,15.1,-7.1,18,SPA
9970da54,1,62,0.7,1,0,0,34,0,0,0,0.0,0.6,-0.5,18,SPA
999908af,21,1098,12.2,12,5,9,11,9,21,-12,10.2,20.2,-10.0,18,SPA
99bebd12,25,1337,14.9,15,3,10,3,20,9,11,16.0,18.9,-3.0,18,SPA
9b337c7c,24,1473,16.4,18,4,6,13,24,28,-4,26.7,24.5,2.2,18,SPA
9b5ce51a,26,2135,23.7,25,21,1,0,24,28,-4,27.6,36.2,-8.6,18,SPA
9b878773,11,226,2.5,1,0,10,9,1,4,-3,3.7,4.1,-0.5,18,SPA
9ba48d64,35,3057,34.0,34,32,1,2,33,64,-31,47.2,51.9,-4.7,18,SPA
9d2a3d5f,34,2319,25.8,26,12,8,2,30,30,0,29.6,35.0,-5.4,18,SPA
9d4c3227,3,158,1.8,2,1,1,5,3,4,-1,1.8,2.9,-1.0,18,SPA
9d4c45d6,22,1139,12.7,11,4,11,2,13,18,-5,15.6,20.9,-5.3,18,SPA
9e098912,1,3,0.0,0,0,1,0,0,0,0,0.1,0.0,0.1,18,SPA
9e1035f8,13,311,3.5,2,0,11,8,5,3,2,4.2,4.7,-0.5,18,SPA
9f0ea33f,23,2070,23.0,23,23,0,2,33,30,3,32.5,34.6,-2.2,18,SPA
9f323c71,21,1658,18.4,20,14,1,1,22,23,-1,25.8,19.0,6.8,18,SPA
9f8e9423,27,2322,25.8,27,25,0,3,62,28,34,57.1,26.3,30.8,18,SPA
9fa0a0b8,13,441,4.9,4,0,9,6,0,11,-11,2.3,9.3,-7.1,18,SPA
a0b4bb3e,30,1774,19.7,21,5,9,3,42,17,25,40.8,17.7,23.1,18,SPA
a10361d2,20,852,9.5,7,5,13,14,13,21,-8,12.3,14.6,-2.2,18,SPA
a190d597,15,1041,11.6,13,4,2,0,22,5,17,14.3,8.2,6.2,18,SPA
a25250f8,34,2848,31.6,33,25,1,1,43,46,-3,42.5,39.8,2.7,18,SPA
a2609621,11,921,10.2,10,9,1,18,13,9,4,12.2,14.5,-2.3,18,SPA
a300ac7e,35,2797,31.1,31,28,4,0,32,63,-31,44.3,48.1,-3.7,18,SPA
a3a306f6,19,1118,12.399999999999999,12,5,7,3,5,15,-10,11.700000000000001,14.6,-2.9,18,SPA
a4971d84,36,3239,36.0,36,35,0,0,41,32,9,45.3,38.4,6.9,18,SPA
a55d8df5,2,9,0.1,0,0,2,2,0,0,0,0.0,0.1,0.0,18,SPA
a58bb1e1,26,1799,20.0,20,10,6,1,50,22,28,46.4,23.5,23.0,18,SPA
a60823a4,21,1594,17.7,18,12,3,13,17,22,-5,17.0,29.2,-12.2,18,SPA
a6154613,33,2899,32.2,32,28,1,2,82,25,57,70.7,34.5,36.2,18,SPA
a68856b5,1,60,0.7,1,0,0,1,1,0,1,0.5,0.7,-0.3,18,SPA
a6951bf8,9,657,7.3,7,6,2,1,12,9,3,9.8,12.2,-2.4,18,SPA
a6b9bd00,20,1304,14.5,16,9,4,3,8,20,-12,12.8,25.4,-12.6,18,SPA
a6de370d,36,1928,21.4,20,10,16,1,36,32,4,29.5,29.2,0.3,18,SPA
a7a9d95a,17,695,7.7,8,1,9,11,19,3,16,20.0,8.1,11.9,18,SPA
a7f00c8c,30,2622,29.1,29,28,1,2,29,60,-31,41.4,45.8,-4.4,18,SPA
a83d8b0c,12,391,4.3,1,1,11,2,3,6,-3,5.8,7.1,-1.4,18,SPA
a8599c17,1,90,1.0,1,1,0,1,1,7,-6,1.8,2.5,-0.7,18,SPA
a8e6bebf,20,1324,14.7,16,3,4,1,17,24,-7,19.9,19.8,0.1,18,SPA
a8fbae1d,26,2214,24.6,25,23,1,7,31,33,-2,27.3,26.6,0.7,18,SPA
a92669f6,5,405,4.5,5,4,0,7,6,7,-1,6.7,6.8,-0.1,18,SPA
a9dc785c,33,2970,33.0,33,33,0,5,57,33,24,49.9,43.0,6.9,18,SPA
aa0ac32d,11,990,11.0,11,11,0,5,10,14,-4,11.6,13.0,-1.4,18,SPA
aa55fe48,1,20,0.2,0,0,1,3,1,0,1,0.8,0.9,-0.1,18,SPA
aaa4239e,2,28,0.3,0,0,2,1,2,1,1,0.3,0.8,-0.5,18,SPA
aad4f74f,13,1125,12.5,12,12,1,18,22,14,8,19.0,15.0,4.0,18,SPA
ab13a5aa,33,2970,33.0,33,33,0,1,35,26,9,39.7,34.3,5.4,18,SPA
ac290817,12,669,7.4,8,2,4,2,7,11,-4,8.6,10.8,-2.2,18,SPA
ac295d9e,36,3240,36.0,36,36,0,2,40,49,-9,39.1,41.9,-2.9,18,SPA
ac3fb1be,24,2028,22.5,23,20,1,3,38,25,13,33.7,29.7,4.0,18,SPA
ac454a4f,25,1434,15.9,16,11,9,7,14,30,-16,13.6,24.6,-11.1,18,SPA
ad178594,20,1791,19.9,20,19,0,4,44,30,14,30.5,24.4,6.1,18,SPA
ad340e17,21,1297,14.4,15,8,6,11,11,26,-15,15.4,29.2,-13.8,18,SPA
ad4d0985,30,2457,27.3,29,22,1,2,28,31,-3,25.6,35.8,-10.2,18,SPA
ad6295d4,16,1184,13.2,11,11,5,1,17,25,-8,23.1,20.2,2.9,18,SPA
adfc9123,30,2632,29.2,29,27,1,6,81,23,58,70.9,30.3,40.6,18,SPA
aec0fb6f,34,2533,28.1,31,20,3,2,22,33,-11,28.8,31.8,-3.0,18,SPA
b037bd4f,24,1120,12.4,12,5,12,9,11,17,-6,11.6,15.7,-4.2,18,SPA
b05e2dbd,34,2916,32.4,33,30,1,2,55,32,23,45.3,41.6,3.7,18,SPA
b0616e3d,27,2332,25.9,26,25,1,2,39,41,-2,40.1,36.6,3.5,18,SPA
b0fce72c,12,806,9.0,11,6,1,14,10,15,-5,11.2,13.4,-2.2,18,SPA
b14d0c5d,21,1778,19.8,21,19,0,3,21,34,-13,26.8,25.9,0.9,18,SPA
b19db005,17,925,10.3,12,2,5,3,30,14,16,22.3,15.0,7.4,18,SPA
b233e8e4,17,1374,15.3,15,13,2,7,33,10,23,22.7,20.2,2.6,18,SPA
b2d03887,24,1252,13.9,14,2,10,9,17,27,-10,16.3,19.8,-3.5,18,SPA
b2d0ec1b,30,1600,17.8,17,5,13,3,27,33,-6,27.5,26.4,1.1,18,SPA
b32b7d1b,3,41,0.5,0,0,3,2,1,1,0,0.1,0.2,-0.1,18,SPA
b35db3f6,22,1442,16.0,15,12,7,2,17,24,-7,16.4,23.1,-6.7,18,SPA
b3dc6eca,27,2416,26.8,27,26,0,8,46,29,17,40.3,34.9,5.4,18,SPA
b418dbd4,34,2627,29.2,30,17,4,0,31,34,-3,40.4,38.8,1.6,18,SPA
b43b81f1,13,994,11.0,11,9,2,16,10,17,-7,8.4,15.9,-7.6,18,SPA
b579e83d,14,1215,13.5,14,13,0,0,7,17,-10,11.7,21.9,-10.3,18,SPA
b5bdf144,26,2340,26.0,26,26,0,10,30,39,-9,32.3,42.1,-9.7,18,SPA
b5dd3469,26,1105,12.3,11,4,15,4,16,24,-8,22.5,16.7,5.8,18,SPA
b742cc0d,16,1420,15.8,16,15,0,0,23,15,8,17.9,15.9,2.0,18,SPA
b7c99b9b,17,1530,17.0,17,17,0,4,20,22,-2,15.8,25.9,-10.1,18,SPA
b7ca5c51,30,2584,28.7,29,28,1,3,49,27,22,43.1,33.0,10.0,18,SPA
b7f2edff,3,233,2.6,2,1,1,10,5,4,1,4.3,2.6,1.7,18,SPA
b8836910,32,2300,25.6,26,16,6,2,26,43,-17,34.6,38.2,-3.6,18,SPA
ba3ca78f,34,3060,34.0,34,34,0,3,23,51,-28,32.7,50.1,-17.4,18,SPA
ba5004e1,33,2877,32.0,33,31,0,0,36,27,9,38.7,31.1,7.7,18,SPA
ba71d071,8,689,7.7,8,7,0,4,10,13,-3,11.6,10.1,1.5,18,SPA
bad38a94,14,731,8.1,7,6,7,11,9,10,-1,11.6,11.0,0.6,18,SPA
bb4b1242,19,1330,14.8,14,8,5,1,19,23,-4,15.7,18.9,-3.2,18,SPA
bb7337cc,34,1945,21.6,21,13,13,2,55,16,39,49.8,26.6,23.1,18,SPA
bba30585,27,2326,25.8,26,23,1,8,33,38,-5,32.9,31.6,1.3,18,SPA
bbe88396,1,77,0.9,1,0,0,1,0,3,-3,0.5,0.9,-0.4,18,SPA
bc6f5f06,33,2680,29.8,31,27,2,3,48,49,-1,41.7,40.7,0.9,18,SPA
bd207a4d,11,561,6.2,7,2,4,4,2,13,-11,5.4,12.3,-6.9,18,SPA
bd6351cd,1,90,1.0,1,1,0,0,1,0,1,1.4,0.2,1.2,18,SPA
bdf7b97d,27,982,10.9,7,4,20,10,10,9,1,14.7,11.6,3.1,18,SPA
be170419,33,2941,32.7,33,32,0,1,35,42,-7,44.7,44.2,0.6,18,SPA
be3a0121,26,2298,25.5,25,25,1,9,35,42,-7,31.8,34.9,-3.1,18,SPA
bf97c188,26,2118,23.5,25,19,1,3,29,30,-1,36.7,34.1,2.6,18,SPA
bfa29677,5,412,4.6,4,4,1,8,6,8,-2,6.2,5.9,0.3,18,SPA
bfb15d99,1,90,1.0,1,1,0,13,3,4,-1,0.3,4.1,-3.8,18,SPA
c00097d2,25,1909,21.2,19,18,6,7,26,34,-8,28.2,38.2,-10.0,18,SPA
c05dfb74,14,780,8.7,7,5,7,1,10,12,-2,13.7,9.6,4.1,18,SPA
c0617e2b,12,401,4.5,4,1,8,11,7,6,1,8.3,6.2,2.2,18,SPA
c0a0c18f,11,556,6.2,6,0,5,4,3,18,-15,7.2,16.6,-9.4,18,SPA
c0b1a6da,1,90,1.0,1,1,0,12,1,0,1,2.6,0.5,2.0,18,SPA
c0c7ff58,34,2659,29.5,30,23,4,2,48,45,3,35.9,39.1,-3.1,18,SPA
c0de5ff5,1,45,0.5,0,0,1,0,0,1,-1,1.0,2.0,-1.1,18,SPA
c14bc029,36,3155,35.1,35,33,1,0,54,22,32,44.8,33.6,11.2,18,SPA
c2111b45,7,630,7.0,7,7,0,9,20,7,13,19.0,8.0,10.9,18,SPA
c2846353,19,1109,12.3,10,7,9,8,11,16,-5,13.0,15.2,-2.2,18,SPA
c3ee18ef,27,2116,23.5,24,22,3,7,33,11,22,27.9,22.5,5.4,18,SPA
c4af5889,4,88,1.0,1,0,3,5,0,2,-2,0.4,1.2,-0.7,18,SPA
c4b8bcf4,30,1582,17.6,18,7,12,3,26,19,7,23.1,17.7,5.4,18,SPA
c5eaff5c,3,37,0.4,0,0,3,6,1,0,1,1.0,0.7,0.4,18,SPA
c5fa58ea,23,1396,15.5,16,8,7,7,14,31,-17,20.7,22.8,-2.1,18,SPA
c67cd65c,19,1555,17.3,17,16,2,8,19,17,2,20.7,22.0,-1.3,18,SPA
c6e8cf1f,16,994,11.0,12,6,4,10,16,23,-7,14.6,24.5,-9.9,18,SPA
c7526c18,27,2214,24.6,26,23,1,2,38,40,-2,41.8,34.2,7.6,18,SPA
c818c4d9,1,90,1.0,1,1,0,3,2,2,0,1.0,1.3,-0.3,18,SPA
c84c1afc,11,232,2.6,2,1,9,5,5,2,3,4.7,2.0,2.7,18,SPA
c8aa95da,25,2219,24.7,25,24,0,8,27,56,-29,31.3,42.8,-11.6,18,SPA
c904f3d5,4,231,2.6,3,2,1,3,0,7,-7,1.9,4.6,-2.7,18,SPA
c90977db,17,1180,13.1,13,8,4,0,18,10,8,14.3,13.8,0.5,18,SPA
c9cb972b,5,450,5.0,5,5,0,33,8,5,3,6.1,5.3,0.8,18,SPA
c9e39d91,20,948,10.5,12,2,8,13,15,18,-3,13.1,17.2,-4.1,18,SPA
cac2537b,26,1580,17.6,16,8,10,8,28,27,1,23.1,24.7,-1.6,18,SPA
cb574619,34,2999,33.3,34,29,0,0,50,51,-1,45.4,48.3,-2.8,18,SPA
cbdf7d5c,1,2,0.0,0,0,1,0,0,0,0,0.0,0.0,0.0,18,SPA
cc29324e,3,270,3.0,3,3,0,7,3,6,-3,3.8,5.8,-2.0,18,SPA
cc2dd8a5,1,7,0.1,0,0,1,0,0,0,0,0.1,0.5,-0.3,18,SPA
cce181df,31,2614,29.0,30,25,1,0,49,30,19,41.9,39.3,2.6,18,SPA
cefb32b1,25,1525,16.9,17,9,8,8,8,37,-29,14.1,30.3,-16.2,18,SPA
cfd65a29,30,1824,20.3,25,3,5,2,45,18,27,38.4,24.9,13.5,18,SPA
cfd68aa7,2,180,2.0,2,2,0,0,1,2,-1,3.0,2.4,0.6,18,SPA
cfd8d664,17,1307,14.5,15,12,2,13,17,8,9,16.8,13.6,3.1,18,SPA
d04b94db,24,1493,16.6,17,11,7,6,50,18,32,36.2,19.8,16.3,18,SPA
d054d8b0,26,1929,21.4,24,11,2,0,41,41,0,30.8,29.8,1.0,18,SPA
d0d79694,14,1018,11.3,12,10,2,9,30,10,20,26.5,14.7,11.8,18,SPA
d109f62b,10,359,4.0,3,1,7,7,8,8,0,7.2,5.0,2.1,18,SPA
d1491e00,26,1946,21.6,21,17,5,0,14,42,-28,21.8,41.0,-19.2,18,SPA
d189e48f,2,18,0.2,0,0,2,0,0,2,-2,0.1,0.9,-0.8,18,SPA
d24e154c,6,540,6.0,6,6,0,8,8,9,-1,8.4,8.2,0.2,18,SPA
d2ac648c,22,1002,11.1,12,1,10,6,8,7,1,14.0,11.4,2.6,18,SPA
d2be40f2,16,1302,14.5,15,12,1,4,12,14,-2,16.4,17.4,-1.0,18,SPA
d2fa73e7,29,1762,19.6,17,9,12,3,22,29,-7,22.3,30.9,-8.6,18,SPA
d3272fba,12,383,4.3,2,1,10,5,3,5,-2,7.0,7.0,0.0,18,SPA
d49f3e6b,13,276,3.1,2,0,11,2,0,8,-8,3.5,4.6,-1.2,18,SPA
d4c9725f,13,963,10.7,10,8,3,21,30,11,19,25.4,11.8,13.7,18,SPA
d4ef9ac5,12,1080,12.0,12,12,0,7,12,19,-7,13.1,19.7,-6.7,18,SPA
d5127c3f,3,55,0.6,0,0,3,2,1,2,-1,0.8,0.8,0.0,18,SPA
d66b9872,12,929,10.3,10,8,2,1,5,10,-5,10.0,10.3,-0.3,18,SPA
d70a2141,25,2045,22.7,24,16,1,9,33,31,2,25.4,27.2,-1.8,18,SPA
d70ce98e,36,3000,33.3,32,32,4,0,91,21,70,76.0,32.7,43.4,18,SPA
d79afcfc,16,610,6.8,5,0,11,5,5,11,-6,7.9,10.7,-2.8,18,SPA
d83bbc54,35,2932,32.6,34,24,1,0,54,53,1,47.6,49.7,-2.2,18,SPA
d8712bf9,9,365,4.1,3,1,6,10,6,6,0,5.2,3.7,1.6,18,SPA
d87e2cae,34,2770,30.8,32,21,2,0,55,44,11,45.4,39.2,6.1,18,SPA
d9764034,19,1528,17.0,17,16,2,13,18,20,-2,17.7,23.1,-5.5,18,SPA
d9b0cc38,1,3,0.0,0,0,1,2,0,0,0,0.0,0.0,0.0,18,SPA
d9ba39fc,26,2228,24.8,26,24,0,7,16,32,-16,26.5,28.4,-1.8,18,SPA
d9bda115,31,2242,24.9,26,15,5,1,42,39,3,33.3,33.9,-0.6,18,SPA
d9faee7e,1,53,0.6,1,0,0,1,1,1,0,1.5,1.3,0.3,18,SPA
da27e268,8,264,2.9,2,1,6,17,6,3,3,5.3,4.6,0.7,18,SPA
dac68523,23,1566,17.4,17,12,6,9,10,34,-24,18.7,33.4,-14.6,18,SPA
db0cd1ae,28,2184,24.3,25,23,3,7,26,33,-7,26.4,37.2,-10.8,18,SPA
db714daf,4,166,1.8,1,1,3,3,1,6,-5,3.1,4.4,-1.3,18,SPA
db750822,23,1307,14.600000000000001,16,7,7,5,18,25,-7,18.0,21.8,-3.6999999999999997,18,SPA
dbe5a587,16,1261,14.0,14,10,2,2,11,33,-22,14.7,25.8,-11.1,18,SPA
dc008610,29,1636,18.2,16,10,13,5,17,30,-13,24.0,23.0,1.0,18,SPA
dc4511f3,4,316,3.5,3,3,1,29,7,6,1,6.5,4.8,1.8,18,SPA
de39485a,17,901,10.0,8,3,9,4,21,5,16,14.9,9.4,5.5,18,SPA
de7d40d6,15,901,10.0,10,6,5,12,13,14,-1,10.8,10.3,0.6,18,SPA
dea698d9,27,2285,25.4,27,19,0,0,64,29,35,56.9,27.5,29.4,18,SPA
debc6b55,11,181,2.0,1,0,10,12,6,5,1,3.3,3.9,-0.6,18,SPA
def69cd0,17,1171,13.0,13,11,4,6,15,10,5,18.0,16.1,2.0,18,SPA
df69b544,32,2519,28.0,30,17,2,1,45,15,30,39.0,24.5,14.5,18,SPA
df9326db,1,90,1.0,1,1,0,1,0,1,-1,1.2,1.6,-0.4,18,SPA
e08647d6,2,137,1.5,2,0,0,1,1,1,0,2.7,3.0,-0.3,18,SPA
e0cd04e0,13,382,4.2,2,1,11,0,6,8,-2,6.8,7.5,-0.7,18,SPA
e12d7851,17,1272,14.1,14,13,3,18,22,17,5,20.3,22.4,-2.1,18,SPA
e185aa52,8,405,4.5,6,0,2,2,3,9,-6,5.5,6.0,-0.4,18,SPA
e1cbb531,38,3061,34.0,34,30,4,0,54,54,0,49.6,50.1,-0.5,18,SPA
e1cea3f7,14,516,5.800000000000001,5,2,9,9,3,10,-7,4.4,11.7,-7.300000000000001,18,SPA
e1deea75,6,460,5.1,5,5,1,4,5,8,-3,8.7,8.3,0.4,18,SPA
e208bcc8,19,1022,11.4,12,6,7,2,9,23,-14,11.8,19.1,-7.3,18,SPA
e28868f3,36,3202,35.6,36,34,0,0,55,56,-1,51.2,49.2,2.0,18,SPA
e42d61c7,9,757,8.4,8,7,1,8,22,7,15,18.5,10.0,8.5,18,SPA
e4b8c5b6,19,1407,15.6,17,14,2,3,11,26,-15,13.4,22.9,-9.6,18,SPA
e4ed2628,20,1659,18.4,19,16,1,3,31,10,21,27.4,15.6,11.7,18,SPA
e54bd0a2,30,2387,26.5,28,20,2,5,29,32,-3,25.3,36.6,-11.4,18,SPA
e5cd9da6,24,2080,23.1,23,22,1,11,39,48,-9,30.7,34.6,-4.0,18,SPA
e6bc67d7,33,2439,27.1,27,18,6,0,54,25,29,43.2,33.0,10.2,18,SPA
e7375367,7,570,6.3,7,5,0,0,4,13,-9,5.2,13.0,-7.9,18,SPA
e7ab4179,14,1040,11.6,12,10,2,6,11,17,-6,11.8,19.0,-7.2,18,SPA
e7f4603c,37,2798,31.1,34,15,3,1,40,43,-3,41.5,39.2,2.3,18,SPA
e897d8ba,35,2460,27.3,28,17,7,1,27,37,-10,29.9,32.6,-2.7,18,SPA
e9a12436,10,784,8.7,9,8,1,0,8,16,-8,9.3,14.8,-5.5,18,SPA
ea6a7ab4,21,1110,12.3,14,2,7,3,13,8,5,16.5,16.0,0.5,18,SPA
eb2fe5b6,29,1608,17.9,17,9,12,7,25,31,-6,27.2,29.9,-2.7,18,SPA
eb5bc3eb,19,1428,15.9,16,12,3,3,12,15,-3,18.5,18.0,0.5,18,SPA
ec3efd7f,23,909,10.1,10,1,13,6,11,20,-9,10.2,17.4,-7.1,18,SPA
ec699fdd,14,983,10.9,10,9,4,13,10,9,1,10.6,12.8,-2.2,18,SPA
ecada4fc,27,2430,27.0,27,27,0,2,72,31,41,63.6,30.5,33.1,18,SPA
ecd8c01e,5,151,1.7,1,0,4,3,4,6,-2,1.6,4.7,-3.1,18,SPA
ed239245,23,2021,22.5,22,21,1,10,27,35,-8,26.3,41.2,-14.9,18,SPA
ed79b7d3,3,182,2.0,2,2,1,5,3,1,2,2.7,4.0,-1.3,18,SPA
ee8508c0,37,3330,37.0,37,37,0,0,57,22,35,47.6,35.2,12.4,18,SPA
ef322658,29,2264,25.2,25,20,4,0,47,42,5,30.8,31.3,-0.5,18,SPA
ef345601,24,1552,17.2,16,8,8,1,10,30,-20,16.9,30.5,-13.5,18,SPA
efa708aa,23,1993,22.1,23,22,0,0,18,46,-28,25.5,41.0,-15.5,18,SPA
f03f284b,37,3330,37.0,37,37,0,0,35,41,-6,40.5,51.1,-10.6,18,SPA
f0a31c00,26,813,9.0,6,2,20,8,13,10,3,13.9,10.1,3.9,18,SPA
f0da930c,23,1690,18.8,17,17,6,8,34,14,20,26.4,19.0,7.4,18,SPA
f11fe861,20,1540,17.1,17,17,3,15,16,11,5,20.5,15.6,4.9,18,SPA
f1bed920,20,1635,18.2,18,18,2,9,39,31,8,31.8,24.5,7.2,18,SPA
f3112790,20,1637,18.2,18,17,2,10,18,30,-12,20.0,21.6,-1.6,18,SPA
f3b1d9a2,37,2859,31.8,36,10,1,0,34,24,10,37.6,32.1,5.5,18,SPA
f519b556,13,733,8.1,8,4,5,0,2,12,-10,7.4,7.9,-0.5,18,SPA
f573a8bf,9,492,5.5,7,1,2,3,4,10,-6,5.7,9.3,-3.6,18,SPA
f6798fc3,30,2655,29.5,30,29,0,8,42,46,-4,38.8,40.7,-1.9,18,SPA
f69d934e,12,895,9.9,9,7,3,1,4,22,-18,6.8,17.7,-10.9,18,SPA
f69e9eee,11,990,11.0,11,11,0,27,6,27,-21,11.0,21.6,-10.6,18,SPA
f6ac68c1,27,2299,25.5,26,25,1,4,31,15,16,30.7,25.2,5.5,18,SPA
f7dc2ae5,19,1596,17.7,18,15,1,14,39,24,15,26.7,26.6,0.1,18,SPA
f8eca1b6,30,1723,19.1,18,12,12,5,20,28,-8,21.799999999999997,28.5,-6.7,18,SPA
fa6561bf,4,58,0.6,0,0,4,3,1,0,1,0.6,0.1,0.4,18,SPA
fa937f7a,31,2399,26.7,25,22,6,1,31,48,-17,37.2,38.5,-1.4,18,SPA
faec2ec4,24,1755,19.5,19,17,5,9,21,26,-5,29.6,29.4,0.2,18,SPA
fb5d47b3,32,2806,31.2,31,31,1,2,47,42,5,45.2,42.6,2.5,18,SPA
fbd6378b,34,3024,33.6,34,33,0,2,54,49,5,41.2,41.6,-0.4,18,SPA
fc4f85b1,30,2554,28.4,28,27,2,5,49,15,34,40.5,28.3,12.2,18,SPA
fc8cb238,1,90,1.0,1,1,0,0,0,2,-2,0.4,2.5,-2.0,18,SPA
fd47b4f2,31,2691,29.9,30,28,1,1,30,40,-10,28.8,45.8,-17.0,18,SPA
fd51b456,33,1679,18.7,16,13,17,5,54,25,29,46.4,21.8,24.5,18,SPA
fd9c4805,34,2517,28.0,31,10,3,3,47,38,9,39.0,41.9,-2.9,18,SPA
fe05804b,20,1800,20.0,20,20,0,2,25,21,4,26.6,23.2,3.3,18,SPA
fed17f5a,33,2365,26.3,27,11,6,0,46,21,25,40.4,30.0,10.4,18,SPA
ffad706e,14,966,10.7,12,9,2,8,14,8,6,13.4,15.1,-1.7,18,SPA
00672021,3,54,0.6,0,0,3,5,0,2,-2,0.4,2.1,-1.7,18,CL
008a6e6d,7,296,3.3,3,3,4,4,13,5,8,9.7,3.9,5.8,18,CL
01b8a2b2,2,90,1.0,1,1,1,8,2,1,1,1.5,1.8,-0.3,18,CL
01eb744d,6,254,2.8,2,1,4,0,4,2,2,7.6,2.1,5.5,18,CL
02c15616,1,21,0.2,0,0,1,3,1,0,1,1.6,0.1,1.5,18,CL
02ce2030,5,359,4.0,5,3,0,0,2,7,-5,3.6,8.8,-5.2,18,CL
042d286e,3,145,1.6,2,0,1,2,1,7,-6,0.8,7.7,-6.9,18,CL
042e8a49,6,388,4.3,4,2,2,0,13,3,10,9.9,5.6,4.2,18,CL
0442183b,2,9,0.1,0,0,2,3,0,1,-1,0.0,0.8,-0.8,18,CL
048a1cbc,3,252,2.8,3,2,0,0,4,6,-2,5.0,4.3,0.7,18,CL
04965583,4,112,1.2,1,0,3,1,2,0,2,1.5,0.3,1.3,18,CL
04ac8285,1,90,1.0,1,1,0,9,2,0,2,1.2,1.0,0.2,18,CL
04f2ed4d,4,316,3.5,4,3,0,2,4,7,-3,2.6,8.3,-5.7,18,CL
05439de2,7,625,6.9,7,6,0,0,18,8,10,16.3,8.8,7.4,18,CL
0562b7f1,2,37,0.4,0,0,2,0,0,2,-2,0.3,0.7,-0.4,18,CL
05a84d52,6,440,4.9,6,4,0,0,10,12,-2,7.3,7.8,-0.4,18,CL
05d548d8,9,679,7.5,8,7,1,3,17,6,11,18.5,7.2,11.3,18,CL
061e8e23,3,172,1.9,2,1,1,2,2,4,-2,4.7,3.9,0.7,18,CL
07802f7f,4,54,0.6,0,0,4,2,1,2,-1,1.0,2.0,-1.0,18,CL
08511d65,11,990,11.0,11,11,0,0,26,13,13,26.7,16.7,10.0,18,CL
089550f5,3,99,1.1,1,0,2,7,2,2,0,2.4,1.4,1.0,18,CL
08a2c314,2,180,2.0,2,2,0,6,3,4,-1,3.0,5.1,-2.0,18,CL
08aa17d0,4,329,3.7,4,2,0,1,3,2,1,4.8,3.4,1.3,18,CL
09586899,9,494,5.5,6,3,3,0,12,1,11,12.6,4.9,7.7,18,CL
0a215326,2,107,1.2,1,1,1,0,1,8,-7,1.5,5.0,-3.5,18,CL
0aa874f4,6,540,6.0,6,6,0,0,4,13,-9,3.4,13.8,-10.3,18,CL
0ab1f153,6,410,4.6,5,2,1,1,4,2,2,6.5,4.1,2.4,18,CL
0b5a292a,2,30,0.3,0,0,2,0,0,1,-1,0.2,0.1,0.0,18,CL
0be28faf,6,520,5.8,6,5,0,0,4,18,-14,4.5,10.3,-5.8,18,CL
0d267745,8,720,8.0,8,8,0,2,18,8,10,12.4,8.8,3.6,18,CL
0d82903c,10,900,10.0,10,10,0,0,14,12,2,16.9,13.6,3.3,18,CL
0d863fdc,5,450,5.0,5,5,0,0,1,16,-15,2.9,14.5,-11.6,18,CL
0e34de55,3,237,2.6,3,2,0,1,1,5,-4,3.4,2.9,0.6,18,CL
0e7ccfc4,3,104,1.2,1,1,2,2,3,0,3,4.0,0.5,3.6,18,CL
0ef05b3e,3,270,3.0,3,3,0,3,1,8,-7,1.5,4.5,-3.0,18,CL
0ef89a37,5,347,3.9,4,3,1,0,18,3,15,13.9,3.1,10.8,18,CL
0f8bd0a6,4,267,3.0,3,1,1,0,4,4,0,3.2,2.4,0.8,18,CL
0ff9eabc,4,360,4.0,4,4,0,0,3,12,-9,4.4,6.0,-1.6,18,CL
10072610,1,90,1.0,1,1,0,9,1,2,-1,1.6,0.6,1.0,18,CL
101da2b5,8,682,7.6,8,6,0,1,17,10,7,11.5,10.0,1.5,18,CL
10d8eff2,1,90,1.0,1,1,0,4,0,4,-4,0.3,1.3,-1.0,18,CL
110338ae,3,225,2.5,3,2,0,0,0,6,-6,1.3,6.2,-4.9,18,CL
111c3236,5,383,4.3,4,4,1,3,12,3,9,8.0,5.8,2.1,18,CL
114b510e,5,450,5.0,5,5,0,1,2,10,-8,2.4,11.1,-8.8,18,CL
119b9a8e,3,270,3.0,3,3,0,1,2,7,-5,3.4,3.0,0.4,18,CL
11b9265b,8,563,6.3,7,5,1,5,19,5,14,18.1,4.6,13.4,18,CL
129af0db,7,383,4.3,4,1,3,1,7,8,-1,9.1,5.3,3.8,18,CL
12c50af5,3,170,1.9,2,1,1,6,3,0,3,2.7,1.3,1.4,18,CL
13c44fc5,4,360,4.0,4,4,0,2,3,9,-6,3.6,6.6,-3.0,18,CL
1467af0d,8,640,7.1,8,3,0,0,21,8,13,14.1,7.7,6.4,18,CL
14a04bea,2,77,0.9,1,0,1,2,1,1,0,0.2,2.5,-2.3,18,CL
14b8fcdf,2,110,1.2,1,1,1,7,1,0,1,0.7,1.0,-0.3,18,CL
157c5e0b,2,158,1.8,2,1,0,2,2,3,-1,2.1,4.5,-2.3,18,CL
15b6e8d7,6,519,5.8,6,5,0,1,10,9,1,6.5,11.9,-5.4,18,CL
16b9d5cf,1,90,1.0,1,1,0,3,3,1,2,0.9,1.6,-0.7,18,CL
16ceb862,1,67,0.7,1,0,0,1,0,3,-3,0.7,0.7,-0.1,18,CL
17370b95,3,114,1.3,1,1,2,3,2,4,-2,1.5,2.7,-1.2,18,CL
1840e36d,8,720,8.0,8,8,0,0,17,12,5,15.5,7.7,7.8,18,CL
1880614f,5,237,2.6,3,0,2,4,5,4,1,4.6,3.5,1.1,18,CL
18b896d6,6,388,4.3,4,4,2,2,7,7,0,7.7,3.9,3.7,18,CL
1932f8f4,2,55,0.6,0,0,2,2,1,1,0,1.2,1.2,0.0,18,CL
1961b2aa,9,170,1.9,1,1,8,0,4,2,2,3.2,1.5,1.7,18,CL
19cda00b,5,143,1.6,1,0,4,2,6,1,5,3.6,2.2,1.3,18,CL
1a2935f6,12,1050,11.7,12,11,0,0,36,16,20,28.2,12.6,15.6,18,CL
1a992676,8,315,3.5,3,1,5,0,13,6,7,7.8,3.7,4.1,18,CL
1b7ec703,5,83,0.9,0,0,5,1,5,0,5,4.7,0.3,4.4,18,CL
1b84dbe1,3,270,3.0,3,3,0,4,5,1,4,5.5,1.7,3.8,18,CL
1bebde9d,1,90,1.0,1,1,0,6,3,0,3,2.3,0.6,1.7,18,CL
1bf33a9a,5,374,4.2,4,4,1,0,5,9,-4,7.6,6.3,1.3,18,CL
1c8dc17d,3,140,1.6,2,0,1,2,1,5,-4,1.8,2.5,-0.7,18,CL
1cb49278,6,454,5.0,5,5,1,2,12,8,4,8.3,4.7,3.6,18,CL
1ddbb0da,3,270,3.0,3,3,0,5,4,3,1,5.0,3.1,1.9,18,CL
1e26e376,2,180,2.0,2,2,0,6,2,2,0,4.4,1.9,2.5,18,CL
1f9328da,11,959,10.7,11,8,0,0,19,15,4,16.8,14.5,2.3,18,CL
1f9a3a04,1,90,1.0,1,1,0,1,2,5,-3,1.7,1.9,-0.2,18,CL
1fbbfbde,5,450,5.0,5,5,0,0,5,8,-3,5.3,6.7,-1.4,18,CL
20030c06,6,477,5.3,6,4,0,0,9,10,-1,8.1,6.4,1.7,18,CL
21512407,3,270,3.0,3,3,0,4,7,3,4,5.9,4.7,1.1,18,CL
21a66f6a,7,597,6.6,7,3,0,0,15,7,8,10.6,11.0,-0.4,18,CL
22a94b80,1,90,1.0,1,1,0,2,2,1,1,0.7,1.3,-0.6,18,CL
22ca11f1,1,3,0.0,0,0,1,0,0,0,0,0.0,0.0,0.0,18,CL
230255f5,1,2,0.0,0,0,1,0,0,0,0,0.0,0.0,0.0,18,CL
2327c29e,2,17,0.2,0,0,2,2,0,1,-1,0.3,0.2,0.1,18,CL
2334478a,5,235,2.6,2,0,3,1,3,4,-1,4.5,1.7,2.8,18,CL
23593121,1,31,0.3,0,0,1,2,1,0,1,0.9,0.1,0.8,18,CL
244a1281,6,540,6.0,6,6,0,0,2,17,-15,3.9,16.5,-12.7,18,CL
2513a588,2,69,0.8,1,0,1,3,0,0,0,1.2,0.8,0.4,18,CL
2557c196,6,540,6.0,6,6,0,0,9,13,-4,6.8,11.4,-4.6,18,CL
2649ff32,3,40,0.4,0,0,3,1,1,0,1,0.6,0.5,0.2,18,CL
273c483b,5,380,4.2,5,3,0,1,3,9,-6,3.0,7.1,-4.0,18,CL
27b89843,5,312,3.5,3,1,2,1,2,11,-9,2.5,9.8,-7.3,18,CL
27c8e860,4,360,4.0,4,4,0,0,1,14,-13,2.1,13.0,-10.9,18,CL
27ff9bdb,6,294,3.3,2,1,4,0,4,11,-7,3.2,6.1,-2.9,18,CL
28b1f3ce,2,90,1.0,1,0,1,2,0,3,-3,1.2,1.2,0.0,18,CL
292a652a,1,45,0.5,1,0,0,0,0,1,-1,0.2,1.6,-1.3,18,CL
294450ba,2,91,1.0,1,1,1,3,3,3,0,2.4,2.4,0.0,18,CL
2946f9a1,8,595,6.6,6,6,2,2,22,8,14,19.4,7.9,11.5,18,CL
29733c72,6,411,4.6,5,1,1,1,7,2,5,10.0,5.2,4.9,18,CL
2973d8ff,4,122,1.4,1,1,3,1,7,0,7,3.2,0.8,2.4,18,CL
2a70dcc9,1,90,1.0,1,1,0,2,1,3,-2,0.2,3.5,-3.3,18,CL
2acd49b9,6,341,3.8,3,1,3,2,10,2,8,7.2,6.7,0.5,18,CL
2b114be3,9,653,7.3,7,5,2,0,9,12,-3,11.3,10.0,1.3,18,CL
2b1c4abd,3,98,1.1,1,0,2,3,1,1,0,0.3,0.6,-0.2,18,CL
2b622f01,1,1,0.0,0,0,1,1,0,0,0,0.0,0.0,0.0,18,CL
2baec6ce,1,18,0.2,0,0,1,1,0,0,0,0.0,0.4,-0.4,18,CL
2bea06e0,2,180,2.0,2,2,0,2,1,4,-3,3.1,2.6,0.5,18,CL
2c0f8e9e,2,165,1.8,2,1,0,0,1,2,-1,2.5,3.5,-1.0,18,CL
2c6e72bf,3,98,1.1,1,0,2,2,1,6,-5,0.7,5.8,-5.1,18,CL
2db2fd7b,9,677,7.5,8,7,1,1,19,4,15,16.7,7.2,9.5,18,CL
2e4f5f03,6,540,6.0,6,6,0,2,18,10,8,12.4,8.1,4.3,18,CL
2e85c59c,3,10,0.1,0,0,3,2,1,0,1,0.6,0.1,0.5,18,CL
2f061b36,1,45,0.5,0,0,1,5,1,1,0,0.9,1.6,-0.8,18,CL
2f3452eb,6,520,5.8,6,5,0,0,10,11,-1,9.2,7.7,1.5,18,CL
2f557579,5,391,4.3,5,3,0,0,7,9,-2,5.9,7.0,-1.1,18,CL
2f7acede,5,426,4.7,5,4,0,1,12,2,10,7.9,7.0,0.9,18,CL
2f7af524,4,174,1.9,2,1,2,1,2,3,-1,2.5,3.9,-1.3,18,CL
2f90f6b8,11,875,9.7,9,8,2,2,32,10,22,23.7,9.8,13.9,18,CL
2f965a72,8,720,8.0,8,8,0,0,27,9,18,17.2,9.5,7.7,18,CL
31c69ef1,2,180,2.0,2,2,0,0,0,3,-3,1.3,3.2,-1.9,18,CL
31d7f557,4,233,2.6,2,1,2,2,6,5,1,5.4,2.9,2.6,18,CL
321f83a2,5,292,3.2,3,2,2,1,1,9,-8,4.2,5.5,-1.3,18,CL
32c0491f,5,445,4.9,5,4,0,0,7,7,0,6.8,5.1,1.7,18,CL
32e73151,6,157,1.7,1,1,5,0,2,1,1,1.7,1.6,0.1,18,CL
32e7ce92,13,1170,13.0,13,13,0,0,41,16,25,33.0,13.2,19.7,18,CL
33508c78,8,691,7.7,8,5,0,0,16,12,4,14.7,7.2,7.5,18,CL
335fa267,8,594,6.6,7,4,1,1,11,6,5,9.0,6.7,2.3,18,CL
341a40ef,5,234,2.6,3,1,2,1,0,7,-7,1.4,6.8,-5.4,18,CL
34269bdf,4,330,3.7,4,2,0,1,3,8,-5,2.6,5.7,-3.1,18,CL
346d51d9,5,325,3.6,3,3,2,0,3,6,-3,6.4,5.7,0.7,18,CL
34c3b935,8,720,8.0,8,8,0,0,11,11,0,9.9,13.7,-3.8,18,CL
34c3ec17,6,540,6.0,6,6,0,0,9,13,-4,6.8,11.4,-4.6,18,CL
352cabbc,1,13,0.1,0,0,1,3,0,1,-1,0.0,0.1,-0.1,18,CL
36b76751,1,90,1.0,1,1,0,0,0,2,-2,1.4,1.4,0.0,18,CL
3708e9fa,6,537,6.0,6,5,0,0,8,10,-2,5.7,12.8,-7.0,18,CL
38ac43d3,8,633,7.0,8,4,0,1,10,8,2,11.9,11.1,0.8,18,CL
38c7feef,7,320,3.6,4,2,3,4,10,2,8,6.3,2.3,4.0,18,CL
39583cfd,3,147,1.6,2,0,1,2,1,0,1,4.2,0.4,3.8,18,CL
3b15ef2d,8,566,6.3,7,5,1,0,8,8,0,9.3,9.2,0.1,18,CL
3b8674e6,5,291,3.2,3,2,2,2,2,6,-4,4.8,4.4,0.4,18,CL
3bb7b8b4,9,810,9.0,9,9,0,1,19,10,9,14.1,10.5,3.6,18,CL
3bb7f478,12,1078,12.0,12,10,0,0,21,19,2,19.1,17.5,1.5,18,CL
3c1b7c60,5,287,3.2,3,2,2,1,2,6,-4,2.4,3.8,-1.4,18,CL
3c6089ab,10,734,8.2,8,7,2,0,18,9,9,20.3,8.9,11.4,18,CL
3ca7254a,7,388,4.3,4,2,3,1,10,6,4,9.2,3.9,5.3,18,CL
3e587547,4,360,4.0,4,4,0,0,3,8,-5,2.2,8.8,-6.6,18,CL
3e6b69c2,6,524,5.8,6,5,0,0,3,15,-12,4.1,14.8,-10.6,18,CL
3e975352,4,39,0.4,0,0,4,0,0,0,0,0.3,1.1,-0.7,18,CL
3e99c613,1,19,0.2,0,0,1,0,1,1,0,0.6,0.9,-0.3,18,CL
3eb22ec9,9,563,6.3,6,5,3,1,14,6,8,9.2,5.3,3.8,18,CL
3eed9821,9,810,9.0,9,9,0,0,15,6,9,12.5,7.9,4.6,18,CL
3ef0fa48,6,462,5.1,5,3,1,0,8,6,2,7.2,5.5,1.7,18,CL
3f0cc58f,5,425,4.7,5,2,0,0,1,13,-12,2.2,10.6,-8.4,18,CL
3f10bd22,8,426,4.7,4,3,4,1,5,6,-1,7.1,6.5,0.5,18,CL
3f359b33,1,16,0.2,1,0,0,0,0,0,0,0.1,0.3,-0.2,18,CL
3f944dad,4,250,2.8,3,2,1,1,3,7,-4,1.6,7.5,-5.9,18,CL
407feb71,3,52,0.6,0,0,3,0,1,1,0,1.3,0.2,1.1,18,CL
41e7ef1c,6,540,6.0,6,6,0,0,25,4,21,15.2,5.0,10.2,18,CL
42276181,3,164,1.8,2,0,1,1,3,1,2,4.2,0.6,3.6,18,CL
42a632ba,4,360,4.0,4,4,0,0,2,7,-5,1.7,10.9,-9.1,18,CL
42ec696a,6,540,6.0,6,6,0,0,8,10,-2,5.7,12.9,-7.2,18,CL
42fd9c7f,8,658,7.3,8,3,0,0,22,9,13,15.6,9.0,6.6,18,CL
433dc9a2,1,46,0.5,1,0,0,4,1,1,0,0.2,0.8,-0.6,18,CL
436a9dd0,6,376,4.2,5,3,1,0,8,3,5,10.2,2.9,7.3,18,CL
44781702,5,450,5.0,5,5,0,2,12,6,6,8.9,8.0,0.9,18,CL
44c3d1d2,4,191,2.1,2,0,2,1,3,4,-1,2.2,4.9,-2.7,18,CL
45af8a54,12,472,5.2,3,1,9,0,17,6,11,14.2,9.2,5.1,18,CL
45b9b619,8,626,7.0,7,4,1,1,10,6,4,11.5,8.7,2.9,18,CL
45db685d,2,162,1.8,2,0,0,4,5,3,2,2.8,2.2,0.7,18,CL
4601e194,8,638,7.1,7,7,1,1,12,5,7,8.2,7.4,0.8,18,CL
460976a2,4,281,3.1,4,0,0,0,2,8,-6,1.5,5.7,-4.3,18,CL
467bae22,7,494,5.5,5,2,2,3,8,5,3,8.8,6.3,2.5,18,CL
46907171,2,96,1.1,1,0,1,0,0,2,-2,0.5,2.0,-1.5,18,CL
46a8347f,1,90,1.0,1,1,0,2,0,0,0,1.9,0.4,1.5,18,CL
47fd5136,7,615,6.8,7,6,0,0,8,10,-2,7.2,12.5,-5.3,18,CL
489a73e9,5,98,1.1,1,0,4,0,2,3,-1,1.2,3.4,-2.2,18,CL
49296448,11,897,10.0,10,9,1,1,21,10,11,23.5,11.5,11.9,18,CL
49312f11,4,269,3.0,3,2,1,0,4,4,0,2.8,3.9,-1.1,18,CL
4958bfb2,8,644,7.2,8,6,0,0,20,6,14,19.6,9.5,10.2,18,CL
49fe9070,6,329,3.7,4,2,2,0,7,7,0,6.1,4.8,1.2,18,CL
4a5a45c7,8,296,3.3,4,0,4,4,4,7,-3,4.2,5.6,-1.4,18,CL
4bd414c1,5,450,5.0,5,5,0,0,8,10,-2,9.2,6.7,2.5,18,CL
4c370d81,13,1056,11.7,13,4,0,0,35,15,20,29.1,11.8,17.2,18,CL
4c45cdc2,5,367,4.1,4,1,1,0,7,7,0,4.8,9.6,-4.8,18,CL
4c5b714f,3,253,2.8,3,1,0,1,2,6,-4,2.3,5.0,-2.6,18,CL
4cde5509,1,16,0.2,0,0,1,0,0,1,-1,0.1,0.6,-0.5,18,CL
4d034881,7,440,4.9,5,1,2,2,13,3,10,7.9,4.4,3.5,18,CL
4d1cea6a,6,484,5.4,6,1,0,0,2,12,-10,3.2,13.4,-10.2,18,CL
4d224fe8,12,945,10.5,11,8,1,1,22,13,9,25.7,15.2,10.5,18,CL
4d425e6e,6,533,5.9,6,3,0,0,2,14,-12,2.3,14.6,-12.3,18,CL
4d982baf,3,180,2.0,2,1,1,1,2,8,-6,2.3,3.7,-1.4,18,CL
4dbd0916,3,179,2.0,3,1,0,0,1,3,-2,0.9,2.8,-1.9,18,CL
4e18cf1c,4,48,0.5,0,0,4,0,0,3,-3,0.4,2.2,-1.8,18,CL
4e358a2d,11,922,10.2,10,10,1,1,19,18,1,16.7,15.6,1.2,18,CL
4f28a6ff,9,810,9.0,9,9,0,0,13,13,0,15.0,11.6,3.4,18,CL
4f56170e,4,360,4.0,4,4,0,2,3,8,-5,2.6,9.5,-6.9,18,CL
4f5a953e,3,270,3.0,3,3,0,0,1,8,-7,1.6,5.8,-4.2,18,CL
4fa7cb9b,10,719,8.0,8,4,2,0,13,9,4,14.3,10.5,3.8,18,CL
4fdf1fd9,5,450,5.0,5,5,0,1,3,10,-7,3.3,10.3,-7.0,18,CL
50310821,2,158,1.8,2,1,0,3,2,2,0,1.9,2.2,-0.2,18,CL
5070881b,2,134,1.5,1,1,1,2,2,1,1,3.2,0.4,2.8,18,CL
507c7bdf,6,537,6.0,6,5,0,0,8,7,1,7.2,6.7,0.5,18,CL
509a4ccb,6,289,3.2,3,2,3,0,4,9,-5,3.2,5.2,-2.1,18,CL
518918ad,6,414,4.6,5,2,1,0,3,10,-7,2.8,11.1,-8.2,18,CL
51a3c4c8,7,578,6.4,7,6,0,0,12,8,4,9.3,7.0,2.3,18,CL
51cf8561,1,90,1.0,1,1,0,2,1,2,-1,1.6,0.6,1.0,18,CL
520c318f,3,159,1.8,2,1,1,0,2,6,-4,2.6,3.6,-1.0,18,CL
523057ea,7,508,5.6,6,4,1,0,11,8,3,6.7,9.2,-2.5,18,CL
5271c8f1,1,90,1.0,1,1,0,0,4,0,4,1.3,0.3,1.0,18,CL
527f063d,8,680,7.6,8,6,0,0,26,7,19,15.8,8.1,7.6,18,CL
529f49ab,6,435,4.8,5,3,1,0,5,3,2,8.7,6.1,2.7,18,CL
532d2690,10,776,8.6,9,6,1,2,11,11,0,11.5,13.5,-2.0,18,CL
53cad200,8,705,7.8,8,7,0,0,15,12,3,14.6,7.6,7.0,18,CL
53fc526b,1,26,0.3,0,0,1,5,0,1,-1,0.1,1.2,-1.1,18,CL
54c9ed15,6,463,5.1,6,5,0,0,5,12,-7,4.4,7.7,-3.2,18,CL
55126f3b,4,333,3.7,4,3,0,0,2,3,-1,5.3,6.3,-1.0,18,CL
56208b05,1,90,1.0,1,1,0,0,0,5,-5,0.4,2.5,-2.1,18,CL
563a68ad,8,431,4.8,4,2,4,0,6,8,-2,4.6,11.2,-6.6,18,CL
56b5d64e,7,568,6.3,7,3,0,1,13,13,0,8.8,8.4,0.4,18,CL
56bf1cc0,6,540,6.0,6,6,0,0,2,14,-12,2.4,14.8,-12.4,18,CL
56f7a928,4,311,3.5,4,2,0,1,4,8,-4,2.9,4.5,-1.6,18,CL
57ef0d97,4,306,3.4,4,1,0,0,11,1,10,7.2,3.0,4.2,18,CL
58a9a4d9,3,168,1.9,2,1,1,5,1,2,-1,1.2,3.1,-2.0,18,CL
58bc7d18,2,180,2.0,2,2,0,11,7,3,4,5.9,2.8,3.1,18,CL
5984e9f9,2,180,2.0,2,2,0,0,2,5,-3,1.6,2.3,-0.7,18,CL
59bf127b,5,361,4.0,4,3,1,2,8,8,0,7.5,5.5,2.1,18,CL
59d93937,3,234,2.6,3,0,0,1,2,6,-4,1.8,4.9,-3.1,18,CL
5a2cb25d,6,528,5.9,6,5,0,0,5,14,-9,5.4,8.6,-3.2,18,CL
5a7301ae,6,540,6.0,6,6,0,0,2,17,-15,5.4,14.2,-8.8,18,CL
5ab0ea87,10,768,8.5,9,5,1,0,14,4,10,11.2,7.5,3.7,18,CL
5af687a1,3,179,2.0,2,1,1,3,0,5,-5,1.9,4.3,-2.4,18,CL
5afafbfe,5,402,4.5,5,2,0,1,6,9,-3,7.9,6.1,1.9,18,CL
5b887c7a,5,437,4.9,5,4,0,0,7,7,0,6.8,5.1,1.7,18,CL
5c2b4f07,6,507,5.6,6,5,0,1,12,5,7,8.5,8.6,-0.1,18,CL
5c4f4e43,8,539,6.0,6,3,2,0,10,10,0,6.5,12.8,-6.3,18,CL
5caa62a7,5,274,3.0,3,1,2,1,4,5,-1,6.3,4.3,2.0,18,CL
5cec2c74,1,66,0.7,1,0,0,2,1,4,-3,1.1,1.3,-0.2,18,CL
5cef5a64,2,64,0.7,0,0,2,3,0,5,-5,0.1,3.5,-3.3,18,CL
5d4f7d61,3,207,2.3,2,1,1,4,8,5,3,6.4,4.1,2.3,18,CL
5d91cf0f,4,226,2.5,3,1,1,2,0,10,-10,1.5,9.3,-7.8,18,CL
5e082d51,6,467,5.2,5,5,1,0,2,14,-12,3.8,12.7,-9.0,18,CL
5e1028e5,3,97,1.1,1,0,2,2,0,3,-3,0.8,1.4,-0.7,18,CL
5eae500a,8,704,7.8,8,7,0,0,13,5,8,18.0,7.7,10.3,18,CL
5eecec3d,5,450,5.0,5,5,0,2,13,5,8,10.2,5.6,4.6,18,CL
5f0241b2,8,720,8.0,8,8,0,2,14,13,1,14.6,11.3,3.2,18,CL
5f424f35,5,397,4.4,4,3,1,0,1,10,-9,4.4,7.9,-3.5,18,CL
5f956fcf,6,300,3.3,3,2,3,0,4,6,-2,2.4,6.5,-4.2,18,CL
6025fab1,11,958,10.6,11,7,0,2,27,13,14,26.0,16.5,9.6,18,CL
603116a7,11,958,10.6,11,10,0,1,27,13,14,26.0,16.8,9.2,18,CL
60a93897,4,360,4.0,4,3,0,1,1,10,-9,4.0,6.2,-2.3,18,CL
61b0b44d,3,51,0.6,0,0,3,3,1,0,1,1.5,0.3,1.1,18,CL
62ba5881,1,90,1.0,1,1,0,3,2,3,-1,1.1,2.6,-1.6,18,CL
632e0184,1,9,0.1,0,0,1,4,0,0,0,0.0,0.1,-0.1,18,CL
635f2732,6,519,5.8,6,5,0,0,5,13,-8,5.4,7.8,-2.4,18,CL
63b0ca6b,5,108,1.2,1,0,4,3,2,0,2,1.5,3.4,-1.9,18,CL
63c3659d,2,180,2.0,2,2,0,4,2,2,0,1.6,4.8,-3.2,18,CL
6438d426,7,555,6.2,6,6,1,0,9,10,-1,5.8,10.9,-5.1,18,CL
64bac8b2,3,180,2.0,2,1,1,1,1,4,-3,1.2,4.5,-3.3,18,CL
64e8ed6d,4,141,1.6,1,1,3,2,4,2,2,4.5,2.4,2.2,18,CL
652d4c37,8,495,5.5,6,3,2,2,13,7,6,13.4,8.3,5.1,18,CL
6554bb97,5,383,4.3,4,3,1,1,4,13,-9,3.2,8.4,-5.3,18,CL
65553d96,1,30,0.3,0,0,1,1,0,0,0,0.3,1.1,-0.8,18,CL
65585e3a,5,228,2.5,3,0,2,1,2,6,-4,2.8,3.5,-0.7,18,CL
65d750b5,5,347,3.9,4,2,1,1,4,2,2,8.2,3.5,4.7,18,CL
66116290,5,383,4.3,4,3,1,0,4,11,-7,3.7,7.0,-3.4,18,CL
67b3d74b,4,259,2.9,3,2,1,0,1,7,-6,3.8,5.2,-1.4,18,CL
67cdbc0e,8,475,5.3,6,2,2,0,10,6,4,11.8,7.9,4.0,18,CL
6800f515,4,295,3.3,3,3,1,2,3,10,-7,2.8,4.5,-1.6,18,CL
68829001,3,132,1.5,1,1,2,2,1,4,-3,1.3,3.6,-2.2,18,CL
68dc0dac,8,641,7.1,7,5,1,0,9,10,-1,8.1,10.3,-2.3,18,CL
691bef82,6,540,6.0,6,6,0,0,12,3,9,15.4,4.4,11.0,18,CL
69384e5d,7,630,7.0,7,7,0,0,26,7,19,16.2,7.4,8.8,18,CL
6b6c793c,1,90,1.0,1,1,0,0,2,1,1,0.7,1.3,-0.6,18,CL
6b6d252d,7,613,6.8,7,5,0,0,9,12,-3,6.7,11.8,-5.1,18,CL
6b85f966,2,93,1.0,1,0,1,0,1,4,-3,1.0,0.5,0.5,18,CL
6c7762c3,1,90,1.0,1,1,0,4,3,0,3,2.3,0.6,1.7,18,CL
6ce1f46f,12,952,10.6,10,9,2,0,28,13,15,27.4,16.8,10.6,18,CL
6d3f2898,4,360,4.0,4,3,0,0,8,5,3,6.0,4.5,1.6,18,CL
6d4d9e18,2,132,1.5,2,0,0,0,1,4,-3,1.3,3.8,-2.5,18,CL
6db16dda,1,1,0.0,0,0,1,4,0,1,-1,0.0,0.4,-0.4,18,CL
6e592fa4,3,198,2.2,2,2,1,3,2,1,1,1.7,2.5,-0.8,18,CL
6f1721f0,2,150,1.7,2,1,0,6,3,3,0,2.2,4.1,-1.9,18,CL
6f51e382,9,810,9.0,9,9,0,1,15,6,9,12.5,7.9,4.6,18,CL
70cf63ca,1,1,0.0,0,0,1,2,0,0,0,0.2,0.0,0.2,18,CL
70d31829,2,83,0.9,1,0,1,3,0,0,0,0.6,0.5,0.2,18,CL
70d74ece,9,600,6.7,8,0,1,2,15,9,6,13.8,10.8,3.0,18,CL
713c144a,6,466,5.2,6,2,0,0,3,12,-9,4.5,7.5,-3.0,18,CL
715bf047,12,779,8.7,8,3,4,0,17,10,7,19.4,9.7,9.7,18,CL
715e5b0e,6,246,2.7,3,0,3,0,1,7,-6,1.1,6.8,-5.8,18,CL
7214c684,1,1,0.0,0,0,1,2,0,0,0,0.0,0.0,0.0,18,CL
7272a72a,8,720,8.0,8,8,0,0,11,11,0,9.9,13.7,-3.8,18,CL
72d0e1b6,2,30,0.3,0,0,2,1,0,0,0,0.9,0.6,0.3,18,CL
732b0cf9,5,131,1.5,1,0,4,1,2,1,1,1.5,1.6,-0.1,18,CL
733fecf1,1,16,0.2,0,0,1,1,1,1,0,0.6,0.9,-0.2,18,CL
75a72a99,7,552,6.1,6,5,1,1,13,12,1,9.5,7.6,1.8,18,CL
769b907d,2,76,0.8,1,0,1,3,0,1,-1,0.1,1.8,-1.7,18,CL
76c131da,2,105,1.2,1,1,1,0,3,0,3,2.3,0.8,1.5,18,CL
77e84962,10,607,6.7,7,4,3,0,12,8,4,14.1,7.9,6.2,18,CL
78150923,5,242,2.7,3,0,2,1,3,3,0,2.3,3.0,-0.7,18,CL
78841da9,6,507,5.6,6,4,0,0,11,9,2,10.0,7.5,2.5,18,CL
78c40e94,1,58,0.6,1,0,0,2,0,0,0,0.4,0.4,0.0,18,CL
79019bf4,2,130,1.4,1,0,1,3,2,2,0,1.0,3.1,-2.1,18,CL
79083382,6,517,5.7,6,5,0,6,11,8,3,8.4,10.6,-2.2,18,CL
7914b9fe,6,448,5.0,5,4,1,2,14,7,7,12.1,5.1,7.0,18,CL
79584585,1,5,0.1,0,0,1,1,0,0,0,0.0,0.2,-0.2,18,CL
79b0d6a0,6,540,6.0,6,6,0,0,8,9,-1,7.3,7.1,0.2,18,CL
79c0821a,7,257,2.9,4,0,3,2,7,5,2,6.5,6.4,0.1,18,CL
7a11550b,5,371,4.1,4,3,1,2,13,5,8,10.6,4.2,6.4,18,CL
7a20d90a,7,630,7.0,7,7,0,0,15,15,0,10.4,9.7,0.7,18,CL
7a2e46a8,12,1080,12.0,12,12,0,0,21,19,2,19.1,18.2,0.9,18,CL
7a69c649,6,540,6.0,6,6,0,0,3,16,-13,4.1,16.1,-12.0,18,CL
7b456af7,8,720,8.0,8,8,0,0,13,10,3,10.4,10.7,-0.3,18,CL
7ba6d84e,6,540,6.0,6,6,0,0,11,3,8,13.6,6.3,7.3,18,CL
7be09c86,5,322,3.6,4,1,1,0,1,8,-7,1.9,8.2,-6.3,18,CL
7c0000fd,8,654,7.3,7,6,1,0,7,8,-1,10.4,8.7,1.6,18,CL
7c1a0c67,6,540,6.0,6,6,0,0,8,10,-2,5.7,12.9,-7.2,18,CL
7c2965bb,5,301,3.3,3,1,2,0,4,12,-8,3.5,6.0,-2.5,18,CL
7c473e12,5,450,5.0,5,5,0,0,5,13,-8,4.4,8.0,-3.6,18,CL
7cab69b5,6,540,6.0,6,6,0,0,6,16,-10,5.9,9.7,-3.8,18,CL
7d3e7da6,11,990,11.0,11,11,0,1,23,12,11,23.3,13.5,9.8,18,CL
7e56d3db,4,144,1.6,2,0,2,0,1,4,-3,0.7,3.2,-2.5,18,CL
7e81a17d,6,388,4.3,4,2,2,0,1,13,-12,4.5,10.0,-5.5,18,CL
7ebfac0f,4,123,1.4,1,0,3,1,0,1,-1,3.3,1.5,1.8,18,CL
7f3b388c,5,450,5.0,5,5,0,1,4,11,-7,4.3,7.8,-3.6,18,CL
7f5ca4f8,5,450,5.0,5,5,0,0,8,12,-4,5.0,10.4,-5.3,18,CL
7f6bff1f,3,270,3.0,3,3,0,2,2,6,-4,0.8,7.3,-6.5,18,CL
7f97771d,10,740,8.2,8,6,2,1,17,9,8,17.8,8.7,9.2,18,CL
7fe90ccd,5,353,3.9,4,2,1,3,13,4,9,9.3,2.9,6.4,18,CL
80b81359,1,18,0.2,0,0,1,1,0,0,0,0.1,0.0,0.1,18,CL
80f36c88,5,345,3.8,3,3,2,6,9,4,5,7.8,6.4,1.5,18,CL
810e3c74,6,244,2.7,3,0,3,2,2,2,0,5.1,1.6,3.5,18,CL
81442ecb,5,433,4.8,5,4,0,0,5,8,-3,5.1,6.2,-1.1,18,CL
819b3158,9,503,5.6,6,3,3,1,11,9,2,7.9,7.3,0.6,18,CL
821233cc,1,90,1.0,1,1,0,1,2,3,-1,1.7,2.7,-1.0,18,CL
82dbf623,7,225,2.5,2,1,5,0,6,2,4,3.9,4.5,-0.5,18,CL
8320fe65,2,179,2.0,2,1,0,3,1,4,-3,3.4,3.0,0.4,18,CL
8325870c,5,391,4.3,4,3,1,0,2,13,-11,4.3,9.3,-5.0,18,CL
833fb62e,3,37,0.4,0,0,3,0,0,0,0,0.4,0.3,0.1,18,CL
834b5c4c,3,270,3.0,3,3,0,3,1,9,-8,3.9,9.7,-5.8,18,CL
83534f30,5,338,3.8,5,3,0,0,2,9,-7,3.4,7.2,-3.9,18,CL
8494acc4,3,262,2.9,3,2,0,0,1,4,-3,4.5,3.1,1.5,18,CL
849c826a,6,377,4.2,4,3,2,0,4,9,-5,4.3,6.5,-2.2,18,CL
84ad89fa,3,270,3.0,3,5,0,0,8,8,0,3.3,4.7,-1.4,18,CL
852351df,6,462,5.1,5,4,1,4,6,9,-3,6.2,8.4,-2.1,18,CL
854ee61a,5,166,1.8,2,0,3,0,3,3,0,3.1,4.2,-1.1,18,CL
85613cf0,1,90,1.0,1,1,0,0,1,2,-1,1.9,1.4,0.4,18,CL
85686f86,5,34,0.4,0,0,5,2,0,3,-3,0.1,2.1,-2.0,18,CL
85b0c4c6,3,32,0.4,0,0,3,0,0,1,-1,0.2,1.0,-0.7,18,CL
862fa9fb,4,104,1.2,1,1,3,3,3,2,1,2.7,2.1,0.6,18,CL
8637e09a,6,495,5.5,6,3,0,0,12,6,6,7.6,6.6,1.0,18,CL
864db10a,8,720,8.0,8,8,0,0,13,10,3,10.4,10.7,-0.3,18,CL
867239d3,5,278,3.1,3,1,2,0,3,3,0,6.9,4.2,2.6,18,CL
86c75897,8,664,7.4,7,5,1,0,11,10,1,9.6,12.1,-2.5,18,CL
86dd77d1,7,630,7.0,7,7,0,3,14,6,8,10.9,6.7,4.2,18,CL
86e7deaf,6,522,5.8,6,5,0,1,22,6,16,12.2,5.5,6.7,18,CL
874d7a32,4,360,4.0,4,4,0,0,0,10,-10,2.7,7.4,-4.7,18,CL
87575fd9,3,221,2.5,2,1,1,0,3,1,2,4.9,2.2,2.8,18,CL
8778c910,1,90,1.0,1,1,0,0,3,0,3,4.2,0.8,3.4,18,CL
8794e251,8,677,7.5,8,6,0,0,24,9,15,16.4,9.2,7.2,18,CL
87d8b5a3,5,287,3.2,3,2,2,3,4,7,-3,3.6,5.6,-1.9,18,CL
881ef58c,3,68,0.8,0,0,3,3,5,1,4,1.7,1.3,0.4,18,CL
8827bf46,6,220,2.4,2,0,4,4,3,3,0,2.5,3.1,-0.6,18,CL
89565ac5,4,271,3.0,3,2,1,0,4,6,-2,4.2,4.7,-0.5,18,CL
89ac64a6,6,540,6.0,6,6,0,0,11,5,6,8.8,8.5,0.4,18,CL
89b2c8a9,6,480,5.3,5,5,1,0,11,9,2,9.7,7.5,2.2,18,CL
89d10e53,3,170,1.9,2,1,1,3,4,1,3,3.2,1.8,1.3,18,CL
89f951b5,10,758,8.4,8,7,2,0,14,6,8,10.8,8.5,2.2,18,CL
8a08491a,10,830,9.2,9,6,1,0,14,11,3,16.1,12.3,3.8,18,CL
8a7a5ad7,7,630,7.0,7,7,0,1,9,10,-1,8.5,11.9,-3.4,18,CL
8b788c01,8,343,3.8,4,0,4,0,8,1,7,11.7,4.1,7.7,18,CL
8b8a56ce,6,540,6.0,6,6,0,0,9,12,-3,7.7,9.3,-1.6,18,CL
8b8e759d,1,5,0.1,0,0,1,0,1,0,1,0.4,0.0,0.4,18,CL
8b9ebd03,8,429,4.8,4,4,4,0,13,5,8,9.0,3.7,5.4,18,CL
8ce30c57,6,530,5.9,6,5,0,0,11,5,6,8.7,8.5,0.2,18,CL
8d78e732,11,955,10.6,11,9,0,0,23,11,12,25.7,12.5,13.2,18,CL
8e92be30,1,8,0.1,0,0,1,3,0,0,0,1.3,0.1,1.3,18,CL
8f62b6ee,7,630,7.0,7,7,0,0,15,8,7,10.8,12.0,-1.2,18,CL
8f898ba8,5,134,1.5,1,0,4,0,1,6,-5,2.4,3.4,-1.0,18,CL
8f8c6934,2,180,2.0,2,2,0,8,1,2,-1,1.6,2.6,-1.0,18,CL
8fd9996f,6,532,5.9,6,5,0,0,15,9,6,9.7,7.0,2.7,18,CL
8fe2101a,1,46,0.5,1,0,0,3,0,0,0,0.1,0.7,-0.7,18,CL
8ff2354e,6,472,5.2,6,4,0,0,8,8,0,8.3,5.9,2.4,18,CL
90339309,5,374,4.2,4,4,1,1,4,12,-8,4.5,6.0,-1.5,18,CL
903b6e8b,5,450,5.0,5,5,0,3,11,12,-1,6.0,8.2,-2.2,18,CL
90f3beec,5,414,4.6,5,2,0,2,9,2,7,6.5,4.8,1.7,18,CL
9139bb12,8,668,7.4,8,2,0,0,11,7,4,9.2,10.0,-0.8,18,CL
91976866,1,15,0.2,0,0,1,0,2,0,2,1.0,0.0,1.0,18,CL
92e7e919,7,426,4.7,5,3,2,1,11,4,7,7.9,5.2,2.7,18,CL
935e6b8f,10,868,9.6,9,8,1,2,24,15,9,23.0,11.0,12.0,18,CL
942b4f90,9,651,7.2,8,2,1,1,13,14,-1,12.4,12.1,0.3,18,CL
947e036f,5,352,3.9,4,2,1,1,5,9,-4,4.7,6.2,-1.5,18,CL
94b2001f,6,368,4.1,4,4,2,3,7,6,1,6.2,4.6,1.5,18,CL
96094cbc,6,480,5.3,6,3,0,0,1,13,-12,5.4,9.4,-4.0,18,CL
962e54cb,2,26,0.3,0,0,2,0,0,1,-1,0.3,0.6,-0.3,18,CL
963a328b,6,323,3.6,4,1,2,0,5,6,-1,3.8,4.3,-0.5,18,CL
96e0490d,3,203,2.3,2,2,1,5,2,2,0,4.7,2.2,2.5,18,CL
972d595a,5,382,4.2,4,4,1,1,7,11,-4,4.9,9.3,-4.4,18,CL
97333cf5,4,236,2.6,4,0,0,2,1,8,-7,1.8,4.6,-2.8,18,CL
9744ff80,10,740,8.2,8,6,2,0,12,12,0,12.6,10.6,2.0,18,CL
97bfa797,5,341,3.8,4,2,1,1,5,8,-3,7.1,5.2,1.9,18,CL
980522ec,6,535,5.9,6,4,0,0,12,8,4,9.0,10.9,-1.9,18,CL
981869fc,3,199,2.2,2,1,1,1,0,5,-5,2.9,3.4,-0.5,18,CL
984a5a64,1,20,0.2,0,0,1,3,1,0,1,0.2,0.0,0.1,18,CL
98e0ad35,5,450,5.0,5,5,0,0,1,16,-15,3.3,13.8,-10.5,18,CL
99813635,2,149,1.7,1,1,1,1,1,3,-2,2.5,2.0,0.5,18,CL
99b1d0e6,2,102,1.1,0,0,2,1,4,1,3,2.6,2.3,0.3,18,CL
9a104dee,6,449,5.0,5,3,1,0,10,5,5,5.6,4.9,0.7,18,CL
9a2e0ccc,5,412,4.6,5,2,0,0,9,9,0,6.3,5.7,0.6,18,CL
9bcd6455,6,287,3.2,3,1,3,0,1,7,-6,3.6,5.5,-1.9,18,CL
9c824717,7,630,7.0,7,7,0,1,13,6,7,9.4,10.1,-0.7,18,CL
9c94165b,1,90,1.0,1,1,0,2,2,1,1,2.9,0.8,2.1,18,CL
9d12e142,6,540,6.0,6,5,0,0,7,13,-6,9.6,9.8,-0.2,18,CL
9d60028d,5,41,0.5,0,0,5,3,0,1,-1,1.3,1.7,-0.5,18,CL
9d73993b,6,479,5.3,5,4,1,0,3,15,-12,4.0,14.0,-10.0,18,CL
9d8586c4,6,486,5.4,5,4,1,1,8,10,-2,5.5,10.8,-5.3,18,CL
9d8ba8ec,6,540,6.0,6,6,0,0,2,17,-15,3.9,16.5,-12.7,18,CL
9efa1d25,5,370,4.1,4,3,1,0,4,6,-2,7.3,5.6,1.7,18,CL
9f31b1d3,4,225,2.5,2,0,2,1,5,2,3,3.8,1.9,1.8,18,CL
9f8e9423,11,938,10.4,11,10,0,1,28,11,17,24.8,16.3,8.5,18,CL
9fb640a8,2,180,2.0,2,2,0,0,2,5,-3,1.6,2.3,-0.7,18,CL
Bruno-Costa,1,90,1.0,1,0,0,0,0,0,0,0.0,0.0,0.0,18,CL
a022e78c,3,136,1.5,1,1,2,2,2,4,-2,1.8,2.8,-1.0,18,CL
a02543c3,6,465,5.2,6,4,0,0,2,16,-14,3.4,14.9,-11.5,18,CL
a0b4bb3e,11,736,8.2,10,1,1,1,15,13,2,20.4,12.8,7.6,18,CL
a1232f4e,3,270,3.0,3,3,0,1,7,3,4,8.9,3.2,5.7,18,CL
a1c2666d,1,22,0.2,0,0,1,0,1,1,0,0.9,0.6,0.3,18,CL
a1d5bd30,8,344,3.8,3,2,5,0,6,5,1,7.2,4.3,2.9,18,CL
a274dccb,1,28,0.3,0,0,1,1,0,1,-1,0.2,0.5,-0.3,18,CL
a372a9f2,6,520,5.8,6,5,0,0,2,11,-9,2.3,13.6,-11.3,18,CL
a382462b,4,259,2.9,3,1,1,0,1,7,-6,1.8,7.9,-6.1,18,CL
a39bb753,8,611,6.8,7,3,1,0,11,12,-1,11.9,6.6,5.2,18,CL
a3e1d20d,4,360,4.0,4,4,0,1,2,8,-6,2.7,9.7,-7.0,18,CL
a40d5a0c,9,729,8.1,8,5,1,0,12,12,0,11.7,11.0,0.7,18,CL
a45eac1f,4,219,2.4,2,2,2,2,1,7,-6,3.7,5.0,-1.3,18,CL
a49fd565,5,450,5.0,5,3,0,1,4,4,0,5.3,11.6,-6.2,18,CL
a4aa453f,5,151,1.7,1,0,4,1,1,6,-5,1.0,5.5,-4.4,18,CL
a4effc55,2,88,1.0,1,0,1,3,1,2,-1,1.1,1.2,-0.1,18,CL
a4f642c5,5,102,1.1,1,0,4,3,2,2,0,1.9,2.6,-0.7,18,CL
a5296e55,5,353,3.9,4,2,1,1,5,7,-2,5.8,5.3,0.6,18,CL
a58bb1e1,7,297,3.3,3,0,4,2,11,3,8,10.1,3.9,6.3,18,CL
a6154613,10,884,9.8,10,8,0,0,16,6,10,13.5,8.7,4.8,18,CL
a65ce836,8,533,5.9,6,3,2,0,20,5,15,16.3,3.0,13.4,18,CL
a6997e06,4,326,3.6,4,2,0,2,1,11,-10,4.2,10.0,-5.8,18,CL
a72c139d,3,93,1.0,0,0,3,1,0,6,-6,0.9,3.5,-2.6,18,CL
a78ff07f,2,40,0.4,0,0,2,2,0,2,-2,0.0,1.6,-1.6,18,CL
a7a9d95a,2,95,1.1,1,1,1,5,2,0,2,1.6,1.0,0.6,18,CL
a8542814,6,531,5.9,6,4,0,1,14,12,2,8.8,8.6,0.2,18,CL
a8741470,2,105,1.2,1,1,1,4,2,1,1,2.0,3.6,-1.6,18,CL
a8c62306,5,248,2.8,3,1,2,1,3,8,-5,1.9,4.7,-2.7,18,CL
a92669f6,2,180,2.0,2,2,0,2,5,2,3,5.1,2.7,2.4,18,CL
a96e5dc0,4,271,3.0,3,2,1,0,4,8,-4,4.3,5.0,-0.7,18,CL
a9e68c94,6,469,5.2,6,2,0,0,5,10,-5,4.0,12.5,-8.5,18,CL
aae44006,1,1,0.0,0,0,1,0,0,0,0,0.1,0.0,0.1,18,CL
ab4b3e35,8,681,7.6,8,4,0,0,11,10,1,8.9,12.7,-3.8,18,CL
ab6928f2,5,410,4.6,5,4,0,0,6,8,-2,4.7,9.8,-5.1,18,CL
abe66106,2,105,1.2,1,0,1,0,2,2,0,2.1,2.6,-0.5,18,CL
ac861941,7,614,6.8,7,6,0,0,15,8,7,10.5,12.0,-1.4,18,CL
ad1d334f,6,540,6.0,6,6,0,0,2,17,-15,5.4,14.2,-8.8,18,CL
ad28ee23,1,6,0.1,0,0,1,1,0,0,0,0.0,0.1,-0.1,18,CL
ad6295d4,2,109,1.2,1,1,1,3,3,3,0,1.9,2.8,-0.9,18,CL
ad6df2d5,8,634,7.0,7,6,1,0,11,9,2,11.5,9.1,2.5,18,CL
ade993b9,5,322,3.6,3,2,2,1,2,5,-3,2.5,3.9,-1.4,18,CL
adfbe1f5,1,1,0.0,0,0,1,2,0,0,0,0.0,0.2,-0.2,18,CL
adfc9123,9,736,8.2,9,7,0,0,14,5,9,10.2,8.3,1.9,18,CL
ae4e2852,6,393,4.4,6,3,0,1,5,6,-1,8.0,7.3,0.6,18,CL
ae8ec371,4,248,2.8,3,1,1,1,1,3,-2,2.2,3.9,-1.7,18,CL
aef6e670,3,198,2.2,2,2,1,5,5,3,2,5.0,4.0,1.0,18,CL
af00baef,5,395,4.4,5,3,0,1,1,12,-11,2.5,12.3,-9.9,18,CL
af245161,6,540,6.0,6,6,0,2,9,9,0,5.6,10.0,-4.4,18,CL
af45e954,8,530,5.9,6,2,2,0,11,7,4,8.4,7.1,1.3,18,CL
af7e69d1,6,354,3.9,4,2,2,0,1,11,-10,1.4,10.5,-9.1,18,CL
afa0d4e0,6,457,5.1,5,4,1,2,10,6,4,11.3,7.9,3.4,18,CL
b0616e3d,10,900,10.0,10,10,0,0,15,15,0,16.1,13.9,2.2,18,CL
b15780e3,6,540,6.0,6,6,0,0,5,18,-13,4.7,10.5,-5.7,18,CL
b182a240,5,430,4.8,5,3,0,0,8,10,-2,6.5,6.7,-0.2,18,CL
b19db005,3,143,1.6,2,0,1,2,6,0,6,2.1,1.1,1.0,18,CL
b1f4086c,4,321,3.6,4,2,0,0,1,9,-8,2.7,7.0,-4.3,18,CL
b20ce5eb,5,450,5.0,5,5,0,0,3,13,-10,3.8,12.2,-8.4,18,CL
b217ef29,6,465,5.2,5,5,1,0,14,3,11,14.2,2.6,11.6,18,CL
b2484b77,3,88,1.0,1,0,2,1,1,1,0,0.5,0.6,-0.1,18,CL
b2d0ec1b,5,315,3.5,4,1,1,4,7,8,-1,6.4,5.6,0.8,18,CL
b33e0095,1,1,0.0,0,0,1,5,0,0,0,0.0,0.5,-0.5,18,CL
b39a793e,8,703,7.8,8,4,0,0,11,10,1,9.8,12.6,-2.8,18,CL
b400bde0,8,495,5.5,5,2,3,1,14,4,10,9.8,5.2,4.6,18,CL
b561db50,5,308,3.4,3,2,2,1,0,8,-8,2.4,6.2,-3.9,18,CL
b6170459,6,510,5.7,6,4,0,0,2,17,-15,3.5,15.4,-11.9,18,CL
b66315ae,9,618,6.9,7,5,2,0,12,10,2,10.8,7.8,3.0,18,CL
b682dcf6,5,450,5.0,5,5,0,0,6,11,-5,8.5,8.8,-0.3,18,CL
b6964eb6,8,720,8.0,8,8,0,0,13,5,8,18.0,8.2,9.8,18,CL
b6b2b820,4,75,0.8,0,0,4,2,2,3,-1,1.6,1.1,0.5,18,CL
b6e50615,2,180,2.0,2,2,0,5,2,5,-3,2.1,4.5,-2.5,18,CL
b742cc0d,4,350,3.9,4,3,0,1,5,6,-1,7.6,5.3,2.3,18,CL
b7e7937d,3,270,3.0,3,3,0,3,3,9,-6,3.4,5.6,-2.3,18,CL
b825a650,6,415,4.6,4,3,2,0,8,7,1,8.1,5.2,2.9,18,CL
b853e0ad,8,720,8.0,8,7,0,0,11,11,0,9.9,13.7,-3.8,18,CL
b8c1de25,6,309,3.4,3,1,3,4,10,7,3,7.7,4.2,3.5,18,CL
b9052bad,2,29,0.3,0,0,2,3,1,2,-1,0.6,0.7,-0.1,18,CL
b9fbae28,6,498,5.5,6,4,0,0,10,6,4,10.8,4.5,6.3,18,CL
ba23a904,6,540,6.0,6,5,0,1,12,8,4,8.9,11.0,-2.1,18,CL
ba6e52b0,2,180,2.0,2,2,0,2,4,2,2,2.5,2.3,0.2,18,CL
bb7337cc,9,401,4.5,4,2,5,1,6,3,3,6.7,3.0,3.8,18,CL
bbcc9c00,1,5,0.1,0,0,1,0,0,0,0,0.0,0.1,-0.1,18,CL
bbddc31f,3,211,2.3,2,1,1,0,3,4,-1,1.3,5.0,-3.7,18,CL
bc1f61c9,6,540,6.0,6,6,0,0,3,16,-13,4.1,16.1,-12.0,18,CL
bcb2ccd8,6,540,6.0,6,6,0,0,10,11,-1,9.6,7.7,2.0,18,CL
bcf5058a,3,270,3.0,3,3,0,0,0,5,-5,2.7,4.7,-1.9,18,CL
bd4f5f94,2,180,2.0,2,2,0,3,2,5,-3,1.9,2.8,-0.9,18,CL
bdf7b97d,5,207,2.3,2,1,3,1,3,1,2,4.3,2.6,1.7,18,CL
bdf8165d,6,540,6.0,6,6,0,0,2,14,-12,2.4,14.8,-12.4,18,CL
be927d03,4,337,3.7,4,3,0,3,8,2,6,9.9,4.7,5.1,18,CL
bf075f6b,6,288,3.2,3,0,3,0,1,11,-10,2.2,10.1,-8.0,18,CL
bf309d24,5,370,4.1,4,4,1,1,6,7,-1,7.2,5.8,1.4,18,CL
bf97c188,8,693,7.7,8,6,0,1,10,13,-3,10.5,12.1,-1.6,18,CL
c0617e2b,4,82,0.9,0,0,4,3,1,0,1,2.9,0.5,2.4,18,CL
c0cddebe,9,494,5.5,5,4,4,0,9,6,3,9.1,8.6,0.6,18,CL
c0e27d1a,4,327,3.6,4,3,0,1,8,5,3,8.8,3.7,5.1,18,CL
c14bc029,6,540,6.0,6,6,0,0,5,4,1,11.3,6.9,4.4,18,CL
c1b7847c,1,11,0.1,0,0,1,5,0,0,0,0.1,0.1,0.0,18,CL
c204f844,3,255,2.8,3,2,0,3,2,4,-2,4.1,2.6,1.5,18,CL
c2111b45,1,90,1.0,1,1,0,4,1,3,-2,2.7,2.7,-0.1,18,CL
c316607a,1,90,1.0,1,1,0,3,3,0,3,1.9,0.5,1.4,18,CL
c3ee18ef,3,270,3.0,3,3,0,3,4,3,1,3.8,5.9,-2.0,18,CL
c44a1d58,4,237,2.6,2,1,2,1,4,2,2,2.6,4.2,-1.6,18,CL
c49afee6,4,119,1.3,2,0,2,0,3,0,3,2.8,0.8,2.0,18,CL
c5224618,8,720,8.0,8,8,0,0,13,10,3,10.4,10.7,-0.3,18,CL
c5adc293,4,301,3.3,4,3,0,0,6,5,1,5.5,5.8,-0.3,18,CL
c5fd13e9,6,338,3.8,4,1,2,0,3,8,-5,5.0,5.1,-0.2,18,CL
c6056d58,6,540,6.0,6,6,0,0,6,16,-10,5.9,9.7,-3.8,18,CL
c67b8590,5,336,3.7,4,3,1,0,7,11,-4,4.8,7.5,-2.8,18,CL
c691bfe2,11,940,10.4,11,7,0,0,31,14,17,23.5,11.2,12.3,18,CL
c7069d87,6,533,5.9,6,5,0,0,4,14,-10,5.3,8.6,-3.4,18,CL
c707411f,11,914,10.2,10,10,1,0,15,16,-1,16.4,15.3,1.0,18,CL
c7526c18,8,676,7.5,8,7,0,0,10,9,1,12.0,11.3,0.7,18,CL
c75e82dc,3,126,1.4,1,1,2,1,0,2,-2,0.4,3.4,-3.0,18,CL
c81d773d,2,91,1.0,1,1,1,0,1,2,-1,1.7,1.7,0.0,18,CL
c8a88acd,5,450,5.0,5,5,0,1,2,10,-8,2.4,11.1,-8.8,18,CL
c8c60119,3,270,3.0,3,3,0,2,4,8,-4,3.5,3.9,-0.5,18,CL
c8d7131c,4,360,4.0,4,4,0,0,3,9,-6,4.4,6.1,-1.7,18,CL
c906ce0f,6,540,6.0,6,6,0,0,9,9,0,5.6,10.0,-4.4,18,CL
c9081f9a,2,180,2.0,2,2,0,2,0,6,-6,1.3,5.3,-4.0,18,CL
c90b2e8f,4,360,4.0,4,4,0,0,4,13,-9,2.7,6.6,-4.0,18,CL
c9e99e49,8,720,8.0,8,8,0,0,27,9,18,17.2,9.5,7.7,18,CL
ca8033cb,6,462,5.1,4,4,2,0,10,9,1,9.4,6.6,2.8,18,CL
cb7786d5,6,502,5.6,6,3,0,0,2,16,-14,3.6,16.0,-12.4,18,CL
cc700722,6,307,3.4,3,1,3,0,10,5,5,8.4,4.4,4.0,18,CL
ccc66d00,6,222,2.5,2,1,4,0,4,4,0,2.5,5.6,-3.2,18,CL
cd1acf9d,10,820,9.1,9,6,1,2,30,10,20,24.3,8.4,15.9,18,CL
ce9e8024,4,360,4.0,4,4,0,0,0,11,-11,3.7,8.3,-4.6,18,CL
cea4ee8f,5,428,4.8,5,1,0,0,11,6,5,9.0,7.5,1.5,18,CL
cf182add,8,694,7.7,8,7,0,0,11,10,1,9.8,12.5,-2.7,18,CL
cf961d8d,3,270,3.0,3,3,0,1,1,7,-6,1.7,7.3,-5.6,18,CL
cfd65a29,8,624,6.9,8,0,0,0,13,4,9,8.0,7.0,1.0,18,CL
cfd8d664,3,270,3.0,3,3,0,0,2,3,-1,7.0,3.2,3.8,18,CL
d003e213,8,506,5.6,5,4,3,3,10,4,6,12.7,5.6,7.1,18,CL
d04b94db,7,625,6.9,7,6,0,1,10,4,6,8.1,7.6,0.6,18,CL
d0a01d27,5,440,4.9,5,4,0,0,8,12,-4,5.3,10.2,-4.9,18,CL
d0d79694,1,90,1.0,1,1,0,6,2,0,2,1.2,1.0,0.2,18,CL
d1675302,4,291,3.2,3,3,1,1,3,7,-4,3.3,5.3,-1.9,18,CL
d18f2675,1,1,0.0,0,0,1,1,0,0,0,0.0,0.0,0.0,18,CL
d2416c2e,4,199,2.2,2,1,2,2,5,3,2,2.5,2.5,0.1,18,CL
d248cd8f,5,450,5.0,5,5,0,0,9,9,0,6.6,5.8,0.8,18,CL
d2bff301,2,180,2.0,2,2,0,1,4,3,1,1.3,2.6,-1.3,18,CL
d3aaad90,10,359,4.0,4,1,6,1,10,5,5,7.6,6.0,1.6,18,CL
d4222f7b,5,379,4.2,4,4,1,1,1,12,-11,1.2,11.9,-10.7,18,CL
d49b243a,5,207,2.3,2,0,3,0,2,7,-5,1.7,6.0,-4.3,18,CL
d49f80d7,5,359,4.0,5,3,0,0,2,6,-4,1.9,8.1,-6.2,18,CL
d4aa40b8,2,37,0.4,0,0,2,0,0,2,-2,0.3,1.2,-0.9,18,CL
d4c9725f,3,131,1.5,1,1,2,9,3,2,1,4.0,2.0,2.0,18,CL
d4f46475,6,233,2.6,2,2,4,2,5,7,-2,3.4,5.8,-2.3,18,CL
d5dd5f1f,6,540,6.0,6,6,0,0,7,13,-6,9.6,9.8,-0.2,18,CL
d5f2f82b,8,720,8.0,8,8,0,0,27,9,18,17.2,9.5,7.7,18,CL
d637fc22,6,537,6.0,6,5,0,0,8,9,-1,7.3,7.0,0.3,18,CL
d70ce98e,10,783,8.7,8,8,2,0,16,6,10,11.9,8.6,3.4,18,CL
d7398ac3,5,450,5.0,5,5,0,0,7,8,-1,5.0,10.0,-5.1,18,CL
d7553721,7,150,1.7,1,0,6,1,7,2,5,3.9,3.4,0.5,18,CL
d7ffd345,3,270,3.0,3,3,0,0,1,10,-9,1.7,8.7,-7.0,18,CL
d807c7f6,1,90,1.0,1,1,0,0,0,4,-4,0.3,1.3,-1.0,18,CL
d8c679be,7,444,4.9,5,4,2,1,8,6,2,6.3,8.5,-2.1,18,CL
d93c2511,4,203,2.3,2,2,2,3,2,0,2,3.5,3.3,0.2,18,CL
d9565625,1,90,1.0,1,1,0,0,0,0,0,0.6,1.6,-1.0,18,CL
da270297,1,21,0.2,0,0,1,0,0,3,-3,0.1,0.8,-0.7,18,CL
da7b447d,8,720,8.0,8,8,0,0,18,8,10,13.1,12.6,0.5,18,CL
da974c7b,5,450,5.0,5,5,0,0,8,11,-3,8.2,7.8,0.4,18,CL
db4ed67b,3,192,2.1,2,1,1,1,3,7,-4,2.8,5.1,-2.4,18,CL
dbe16ade,3,172,1.9,2,1,1,1,5,2,3,3.6,2.9,0.7,18,CL
dc3a9a0d,4,142,1.6,2,0,2,0,0,4,-4,0.7,3.0,-2.2,18,CL
dc3fa3b5,4,325,3.6,3,3,1,2,3,6,-3,5.2,4.2,1.0,18,CL
dc415e39,4,268,3.0,4,0,0,0,0,8,-8,1.0,7.4,-6.4,18,CL
dc90cfbe,6,378,4.2,3,2,3,0,5,9,-4,4.5,5.7,-1.2,18,CL
dd0daf32,4,284,3.2,3,1,1,0,9,0,9,8.1,2.0,6.1,18,CL
dd669209,6,537,6.0,6,4,0,0,10,5,5,7.8,8.5,-0.7,18,CL
de39485a,5,269,3.0,3,0,2,0,1,2,-1,4.0,4.1,-0.1,18,CL
dea698d9,13,1170,13.0,13,13,0,0,33,16,17,33.0,20.0,13.1,18,CL
dee86451,5,450,5.0,5,5,0,0,7,8,-1,6.8,5.2,1.7,18,CL
df324174,6,540,6.0,6,6,0,0,3,16,-13,4.1,16.1,-12.0,18,CL
df69b544,6,529,5.9,6,5,0,0,5,4,1,10.6,6.9,3.7,18,CL
df6bcd09,2,116,1.3,1,0,1,0,2,2,0,1.1,2.4,-1.3,18,CL
dff19848,4,258,2.9,3,1,1,0,4,7,-3,2.5,5.9,-3.4,18,CL
e044ce1e,2,52,0.6,1,0,1,4,0,1,-1,0.1,1.8,-1.7,18,CL
e06683ca,6,540,6.0,6,6,0,1,18,10,8,12.4,8.1,4.3,18,CL
e07c2923,3,103,1.1,1,0,2,1,0,2,-2,1.0,2.7,-1.7,18,CL
e0900238,1,1,0.0,0,0,1,1,0,0,0,0.0,0.0,0.0,18,CL
e0921a4f,8,661,7.3,8,5,0,0,8,8,0,10.9,7.0,3.9,18,CL
e0991c04,1,90,1.0,1,1,0,0,0,1,-1,1.5,1.1,0.4,18,CL
e162b013,1,24,0.3,0,0,1,7,0,2,-2,0.4,0.9,-0.5,18,CL
e26bd2f4,3,245,2.7,3,2,0,2,0,4,-4,1.6,5.1,-3.4,18,CL
e2716bd0,7,426,4.7,5,1,2,1,9,5,4,8.1,5.6,2.5,18,CL
e280527c,5,395,4.4,5,4,0,0,8,8,0,6.4,5.6,0.8,18,CL
e288d4b3,10,708,7.9,8,5,2,1,15,12,3,13.3,11.1,2.2,18,CL
e304acd5,1,19,0.2,0,0,1,6,0,0,0,0.1,0.0,0.1,18,CL
e33c06cf,9,643,7.1,6,6,3,3,14,11,3,15.7,11.3,4.4,18,CL
e342ad68,13,930,10.3,12,4,1,0,37,10,27,29.2,9.4,19.7,18,CL
e358587b,6,540,6.0,6,6,0,0,11,11,0,10.1,8.2,1.8,18,CL
e40d028b,9,810,9.0,9,8,0,0,12,11,1,15.4,11.8,3.6,18,CL
e42d61c7,2,180,2.0,2,2,0,2,2,4,-2,5.1,3.2,2.0,18,CL
e45ee4bc,5,404,4.5,5,2,0,1,2,12,-10,4.4,7.8,-3.5,18,CL
e46012d4,8,667,7.4,8,6,0,1,17,8,9,11.1,8.2,3.0,18,CL
e4ed2628,6,540,6.0,6,6,0,0,5,4,1,11.3,6.9,4.4,18,CL
e50623a0,1,90,1.0,1,1,0,2,2,5,-3,1.7,1.9,-0.2,18,CL
e599253a,6,353,3.9,4,2,2,0,6,5,1,3.8,7.2,-3.4,18,CL
e66e4ddc,6,521,5.8,6,5,0,0,2,14,-12,2.4,13.9,-11.5,18,CL
e6ad16b2,6,465,5.2,6,2,0,0,8,10,-2,7.0,6.4,0.6,18,CL
e6c80256,1,67,0.7,1,0,0,4,1,1,0,1.1,1.4,-0.2,18,CL
e726e11e,4,337,3.7,4,3,0,1,4,6,-2,6.5,3.8,2.7,18,CL
e73659d3,6,306,3.4,3,3,3,0,3,12,-9,2.9,5.6,-2.7,18,CL
e73c9bb2,7,630,7.0,7,7,0,0,15,15,0,10.4,9.7,0.7,18,CL
e77dc3b2,3,36,0.4,0,0,3,6,2,1,1,0.9,0.9,0.0,18,CL
e7986081,4,266,3.0,3,1,1,1,2,8,-6,2.7,5.3,-2.5,18,CL
e7ef333b,5,420,4.7,5,4,0,0,8,10,-2,5.2,8.2,-3.1,18,CL
e85fb9b8,7,630,7.0,7,7,0,0,12,9,3,14.2,10.8,3.4,18,CL
e90af77c,1,11,0.1,0,0,1,1,0,0,0,0.0,0.0,0.0,18,CL
e90dc1d5,6,405,4.5,4,3,2,0,1,15,-14,2.9,10.9,-8.0,18,CL
ea8d470b,4,84,0.9,0,0,4,2,0,1,-1,0.6,2.1,-1.5,18,CL
ead14875,6,523,5.8,6,5,0,0,10,8,2,8.5,7.6,1.0,18,CL
eb2fe5b6,8,252,2.8,2,0,6,2,2,1,1,3.6,1.7,1.9,18,CL
eb58eef0,12,850,9.4,9,7,3,0,32,15,17,25.1,11.8,13.3,18,CL
eb7822d7,7,564,6.3,6,6,1,0,11,4,7,13.8,7.1,6.7,18,CL
ebc49727,6,471,5.2,6,3,0,0,2,13,-11,4.9,12.1,-7.3,18,CL
ecada4fc,11,990,11.0,11,11,0,0,26,13,13,27.2,17.2,10.0,18,CL
ecbb3fdf,1,3,0.0,0,0,1,2,0,0,0,0.3,0.0,0.3,18,CL
ed1e53f3,3,194,2.2,2,1,1,2,3,4,-1,3.9,2.2,1.6,18,CL
ed90babd,3,36,0.4,0,0,3,2,0,2,-2,0.1,0.9,-0.8,18,CL
eda40760,12,1080,12.0,12,12,0,0,21,19,2,19.1,18.2,0.9,18,CL
edd6c8e9,1,90,1.0,1,1,0,0,2,1,1,1.4,1.9,-0.4,18,CL
ee0da7af,3,270,3.0,3,3,0,0,0,5,-5,2.7,4.7,-1.9,18,CL
ee3519f5,8,684,7.6,8,6,0,0,11,9,2,9.8,12.0,-2.2,18,CL
ee8508c0,6,540,6.0,6,6,0,0,5,4,1,11.3,6.9,4.4,18,CL
ee93c1a9,5,136,1.5,1,1,4,1,3,3,0,2.9,2.3,0.6,18,CL
eef95b11,1,90,1.0,1,1,0,0,0,4,-4,0.3,1.3,-1.0,18,CL
ef233486,1,6,0.1,0,0,1,4,0,0,0,0.2,0.0,0.2,18,CL
ef2e5e1a,11,839,9.3,9,8,2,0,15,16,-1,14.4,14.9,-0.4,18,CL
ef8cafeb,3,270,3.0,3,3,0,3,3,3,0,3.4,5.0,-1.7,18,CL
f0da930c,4,272,3.0,3,2,1,1,3,2,1,4.4,3.9,0.5,18,CL
f0faccb9,5,253,2.8,3,0,2,1,4,4,0,3.6,3.0,0.5,18,CL
f175ca0a,2,85,0.9,1,0,1,3,0,4,-4,0.5,1.3,-0.8,18,CL
f179ee11,3,180,2.0,2,1,1,2,1,3,-2,2.2,1.6,0.5,18,CL
f1b55719,7,563,6.3,6,5,1,0,9,10,-1,6.2,10.4,-4.2,18,CL
f2308b33,4,209,2.3,2,2,2,0,4,4,0,3.4,3.8,-0.4,18,CL
f25c8e3a,5,419,4.7,5,4,0,0,9,10,-1,8.1,6.1,1.9,18,CL
f27680d9,1,90,1.0,1,1,0,1,0,3,-3,0.6,3.2,-2.5,18,CL
f33238db,2,31,0.3,0,0,2,1,0,0,0,0.4,0.1,0.4,18,CL
f346787e,6,209,2.3,1,0,5,0,5,6,-1,2.7,6.3,-3.6,18,CL
f36c432f,1,64,0.7,0,0,1,2,1,1,0,1.0,1.2,-0.2,18,CL
f4081572,3,215,2.4,3,1,0,3,4,7,-3,3.2,4.1,-0.9,18,CL
f40dd3c7,4,245,2.7,3,1,1,0,3,7,-4,2.7,6.0,-3.3,18,CL
f4290206,7,598,6.6,7,6,0,1,14,11,3,10.8,6.7,4.1,18,CL
f4b52308,4,267,3.0,4,1,0,0,0,5,-5,2.8,4.1,-1.2,18,CL
f520049f,2,180,2.0,2,2,0,4,2,2,0,3.0,2.0,1.1,18,CL
f533776b,3,187,2.1,1,1,2,3,2,8,-6,2.0,3.6,-1.6,18,CL
f5a00fa4,6,467,5.2,5,4,1,0,5,12,-7,4.7,8.4,-3.6,18,CL
f5deef4c,5,450,5.0,5,5,0,3,10,2,8,11.9,4.5,7.4,18,CL
f619413f,1,90,1.0,1,1,0,3,0,5,-5,0.4,3.2,-2.8,18,CL
f61c7c4e,8,574,6.4,7,3,1,1,13,7,6,14.3,7.0,7.3,18,CL
f69d4d79,6,540,6.0,6,6,0,0,8,10,-2,5.7,12.9,-7.2,18,CL
f6ac68c1,3,268,3.0,3,2,0,2,2,2,0,6.1,3.5,2.6,18,CL
f6db3bd5,3,270,3.0,3,3,0,0,3,7,-4,2.6,4.1,-1.5,18,CL
f6ddac8f,3,181,2.0,2,2,1,1,1,5,-4,0.9,3.7,-2.8,18,CL
f7d50789,4,294,3.3,4,3,0,0,7,2,5,4.0,4.8,-0.8,18,CL
f7ee69fb,6,328,3.6,3,3,3,0,7,6,1,5.3,5.7,-0.4,18,CL
f8280175,1,26,0.3,1,0,0,0,0,1,-1,0.0,1.4,-1.4,18,CL
f864af2c,6,392,4.4,4,3,2,0,3,10,-7,2.9,10.4,-7.5,18,CL
f86ad3f5,1,90,1.0,1,1,0,4,2,1,1,2.2,1.8,0.3,18,CL
fa937f7a,9,792,8.8,9,6,0,0,14,12,2,15.1,11.7,3.4,18,CL
faa1b07d,3,270,3.0,3,3,0,2,2,9,-7,2.6,8.0,-5.4,18,CL
faec2ec4,9,502,5.6,6,5,3,1,9,14,-5,7.9,9.3,-1.4,18,CL
fb938d24,8,318,3.5,3,1,5,0,5,7,-2,4.2,5.2,-1.0,18,CL
fc4f85b1,4,360,4.0,4,4,0,2,2,3,-1,8.9,3.6,5.3,18,CL
fce2302c,6,540,6.0,6,6,0,0,5,18,-13,4.7,10.5,-5.7,18,CL
fd51b456,10,543,6.0,5,5,5,3,20,7,13,15.8,10.2,5.6,18,CL
fe2db476,2,180,2.0,2,2,0,0,2,6,-4,1.9,4.4,-2.5,18,CL
fe4a25be,2,14,0.2,0,0,2,3,0,1,-1,0.1,1.7,-1.6,18,CL
feb5d3ab,6,514,5.7,5,4,1,0,2,16,-14,5.4,12.8,-7.4,18,CL
ffc1c226,5,450,5.0,5,5,0,1,3,13,-10,4.7,7.4,-2.7,18,CL
0000acda,35,2782,30.9,35,20,0,2,41,34,7,44.3,30.0,14.3,18,ITA
00528660,23,1473,16.4,14,8,9,5,15,21,-6,11.9,25.2,-13.4,18,ITA
00823e9a,13,321,3.6,1,0,12,15,2,2,0,3.5,4.2,-0.7,18,ITA
00b0bb87,33,2871,31.9,32,30,1,1,31,51,-20,30.3,44.7,-14.4,18,ITA
019f4d0d,14,1141,12.7,13,11,1,2,8,25,-17,10.2,19.2,-9.0,18,ITA
01b8a2b2,17,1530,17.0,17,17,0,21,31,9,22,23.7,10.6,13.1,18,ITA
01efac19,34,2713,30.1,31,25,3,3,37,44,-7,33.3,37.0,-3.8,18,ITA
023937a9,35,3140,34.9,35,33,0,0,32,51,-19,29.6,49.6,-20.0,18,ITA
02b2937c,17,573,6.4,7,1,10,13,3,11,-8,4.7,10.2,-5.4,18,ITA
02caf6e0,36,3116,34.6,36,31,0,0,33,55,-22,31.8,53.0,-21.2,18,ITA
0375723e,34,2827,31.4,34,24,0,1,31,41,-10,29.1,40.9,-11.8,18,ITA
03760df0,27,2430,27.0,27,27,0,1,37,43,-6,38.2,42.7,-4.5,18,ITA
03f946ed,29,1618,18.0,22,1,7,5,30,18,12,24.5,17.1,7.4,18,ITA
048877f5,38,3420,38.0,38,38,0,0,36,59,-23,34.1,55.2,-21.2,18,ITA
0489bb30,2,34,0.4,0,0,2,7,0,1,-1,0.9,1.3,-0.4,18,ITA
05e19d6a,37,3264,36.3,37,32,0,0,52,40,12,48.5,34.4,14.1,18,ITA
06050480,23,1674,18.6,18,14,5,7,28,29,-1,21.3,24.0,-2.6,18,ITA
060606ec,16,1043,11.6,12,7,4,3,10,20,-10,11.7,18.9,-7.2,18,ITA
07767f42,32,2494,27.7,30,18,2,3,17,39,-22,33.7,32.4,1.4,18,ITA
07abb358,37,3168,35.2,36,32,1,0,26,73,-47,29.6,66.0,-36.4,18,ITA
07ea0ef2,6,214,2.4,2,1,4,30,4,5,-1,3.3,3.7,-0.4,18,ITA
081b6080,15,760,8.4,7,5,8,22,4,18,-14,9.4,17.4,-8.1,18,ITA
0821331c,16,1317,14.6,15,13,1,17,12,25,-13,7.2,21.3,-14.0,18,ITA
085e71a7,3,217,2.4,1,1,2,33,3,8,-5,1.9,3.4,-1.5,18,ITA
0861b8d6,16,880,9.8,12,3,4,6,10,17,-7,10.0,14.4,-4.4,18,ITA
089550f5,19,1568,17.4,18,15,1,18,28,10,18,23.5,12.8,10.7,18,ITA
08aa9cd1,1,14,0.2,0,0,1,33,0,0,0,0.2,0.2,0.0,18,ITA
08f5afaa,38,3420,38.0,38,38,0,0,56,42,14,51.2,36.9,14.3,18,ITA
09538fdb,29,2130,23.7,26,13,3,2,38,31,7,30.4,27.3,3.0,18,ITA
09899de8,8,557,6.2,6,5,2,6,4,6,-2,6.1,9.4,-3.3,18,ITA
0a1efd3c,20,1129,12.5,12,4,8,13,12,12,0,13.6,13.8,-0.2,18,ITA
0ab1f153,21,1353,15.0,15,6,6,3,38,14,24,23.7,12.9,10.9,18,ITA
0b5a292a,25,2087,23.2,24,20,1,11,42,20,22,39.5,19.0,20.5,18,ITA
0c2ac3cb,17,1043,11.6,12,3,5,0,23,6,17,17.4,9.1,8.4,18,ITA
0c971997,12,893,9.9,9,7,3,7,15,16,-1,12.5,14.2,-1.8,18,ITA
0cd0e21b,30,1355,15.1,10,4,20,4,41,14,27,26.0,17.4,8.6,18,ITA
0d2bdb4b,5,178,2.0,2,1,3,21,1,8,-7,0.6,4.8,-4.1,18,ITA
0d422df7,2,180,2.0,2,2,0,36,1,7,-6,0.7,4.1,-3.5,18,ITA
0d72fbca,2,18,0.2,0,0,2,18,0,1,-1,0.1,0.2,-0.1,18,ITA
0d82903c,26,2117,23.5,23,21,3,9,63,15,48,36.6,16.2,20.5,18,ITA
0e21fc3c,36,2564,28.5,29,15,7,2,46,25,21,40.5,30.1,10.4,18,ITA
0f22b650,14,358,4.0,1,1,13,19,2,9,-7,3.0,5.5,-2.5,18,ITA
10dc46f0,37,3330,37.0,37,37,0,1,52,45,7,44.8,45.6,-0.8,18,ITA
10e7f486,13,910,10.1,10,8,3,22,9,12,-3,10.4,12.1,-1.7,18,ITA
117beb8f,22,1857,20.6,22,19,0,8,22,30,-8,19.4,28.0,-8.6,18,ITA
1253a12e,31,2873,31.9,31,31,0,3,30,34,-4,36.0,33.0,2.9,18,ITA
13d820de,23,1829,20.3,20,19,3,14,16,33,-17,19.1,29.4,-10.2,18,ITA
144607cc,30,2102,23.4,23,19,7,6,23,33,-10,22.1,28.6,-6.5,18,ITA
149c5f5d,15,903,10.0,10,5,5,21,13,21,-8,11.1,13.7,-2.6,18,ITA
14b8fcdf,22,1935,21.5,22,21,0,15,54,17,37,32.0,16.6,15.4,18,ITA
1522dab2,25,2250,25.0,25,25,0,0,34,29,5,34.7,25.1,9.7,18,ITA
157d29b6,28,1609,17.9,14,7,14,3,18,26,-8,18.2,29.9,-11.7,18,ITA
15d0c248,18,1168,13.0,12,11,6,19,27,14,13,19.3,13.4,5.9,18,ITA
15e9c7e6,18,387,4.3,2,0,16,11,15,3,12,8.5,4.0,4.5,18,ITA
162efffd,37,2319,25.8,25,14,12,1,27,44,-17,29.8,35.2,-5.4,18,ITA
16657b95,36,2824,31.4,33,19,3,2,48,32,16,51.2,30.4,20.7,18,ITA
16b9d5cf,2,96,1.1,1,1,1,18,3,2,1,1.8,0.3,1.5,18,ITA
16bc48f8,1,6,0.1,0,0,1,0,0,0,0,0.0,0.0,0.0,18,ITA
174944a3,2,83,0.9,1,0,1,14,1,0,1,1.2,0.5,0.6,18,ITA
17cddb4d,16,1216,13.5,15,9,1,2,13,30,-17,13.8,24.6,-10.8,18,ITA
18736214,4,360,4.0,4,4,0,24,3,5,-2,3.7,4.7,-0.9,18,ITA
1880614f,26,1249,13.9,15,0,11,10,24,8,16,26.6,11.4,15.1,18,ITA
197640fd,20,1500,16.7,17,12,3,17,24,14,10,28.4,14.5,13.9,18,ITA
1a584cb2,6,329,3.7,4,2,2,23,1,6,-5,2.6,3.5,-0.9,18,ITA
1ab0b878,12,807,9.0,9,4,3,1,5,14,-9,7.0,18.3,-11.4,18,ITA
1ad1f50d,29,1311,14.6,16,4,13,7,15,24,-9,18.7,24.4,-5.8,18,ITA
1b62a7df,1,11,0.1,0,0,1,11,0,0,0,0.1,0.6,-0.6,18,ITA
1b729ba2,24,1700,18.9,22,11,2,8,14,19,-5,19.1,22.7,-3.6,18,ITA
1c17dfe0,5,99,1.1,0,0,5,7,1,2,-1,0.7,2.1,-1.5,18,ITA
1c50f354,17,967,10.7,11,4,6,19,14,11,3,9.0,15.2,-6.2,18,ITA
1c529186,17,1057,11.7,11,7,6,15,17,10,7,13.8,11.4,2.5,18,ITA
1c8c5aed,20,1564,17.4,17,16,3,14,25,18,7,19.4,21.5,-2.1,18,ITA
1ceeae3e,11,189,2.1,0,0,11,11,2,5,-3,3.2,3.3,-0.2,18,ITA
1e12c53b,30,2616,29.1,30,27,0,5,32,42,-10,27.3,42.6,-15.3,18,ITA
1ea5f91c,36,2654,29.5,28,19,8,0,41,47,-6,33.8,37.0,-3.2,18,ITA
1f9328da,31,2613,29.0,31,23,0,2,42,20,22,46.8,29.6,17.2,18,ITA
1fca9171,24,1591,17.7,20,8,4,6,19,21,-2,16.9,20.7,-3.8,18,ITA
2054d037,26,1532,17.0,18,4,8,4,23,23,0,19.1,18.4,0.7,18,ITA
2146785a,21,1564,17.4,18,15,3,11,26,18,8,24.9,16.8,8.1,18,ITA
2258c078,29,2480,27.6,29,21,0,5,27,44,-17,27.1,40.3,-13.3,18,ITA
22ca11f1,1,18,0.2,0,0,1,12,1,1,0,0.0,0.3,-0.3,18,ITA
23214a49,7,541,6.0,6,3,1,22,5,11,-6,4.7,9.5,-4.8,18,ITA
2334478a,12,613,6.8,7,2,5,21,10,1,9,8.6,3.0,5.6,18,ITA
23f9e9d3,11,468,5.2,4,1,7,5,3,5,-2,4.3,8.6,-4.4,18,ITA
24228180,25,1251,13.899999999999999,13,4,12,12,11,30,-19,11.100000000000001,23.1,-12.1,18,ITA
251d982a,9,326,3.6,2,2,7,28,4,8,-4,4.0,7.5,-3.4,18,ITA
263b855a,5,393,4.4,4,4,1,5,3,10,-7,2.9,6.6,-3.7,18,ITA
2648e18f,27,2166,24.1,23,21,4,6,36,31,5,29.6,31.8,-2.1,18,ITA
269b4638,22,943,10.5,9,3,13,11,9,21,-12,10.6,14.5,-3.9,18,ITA
27f0ddef,29,2499,27.8,27,26,2,5,28,40,-12,26.2,36.2,-10.0,18,ITA
2a1beb34,34,2571,28.6,29,24,5,1,37,25,12,47.5,26.8,20.7,18,ITA
2c851997,37,2214,24.6,28,6,9,0,33,42,-9,31.6,41.6,-10.1,18,ITA
2d970560,21,1451,16.1,17,12,4,17,25,14,11,28.5,14.9,13.6,18,ITA
2ead2809,28,1495,16.6,13,7,15,5,14,21,-7,22.4,18.3,4.1,18,ITA
2ec0f902,15,786,8.7,10,2,5,9,4,13,-9,6.3,16.9,-10.6,18,ITA
2edeb221,23,1696,18.8,20,13,3,6,17,35,-18,16.4,36.3,-19.9,18,ITA
2f3452eb,35,3125,34.7,35,33,0,2,66,25,41,60.2,24.0,36.2,18,ITA
2f557579,37,3090,34.3,36,24,1,0,72,27,45,61.2,25.3,35.8,18,ITA
2fb3ad46,5,288,3.2,3,2,2,9,2,4,-2,1.6,5.9,-4.4,18,ITA
30223b33,33,2970,33.0,33,33,0,0,36,46,-10,32.5,44.8,-12.3,18,ITA
30f5ffa9,38,3420,38.0,38,38,0,0,66,30,36,56.7,37.2,19.6,18,ITA
314f2124,31,2726,30.3,31,28,0,2,51,25,26,44.5,30.8,13.7,18,ITA
31d7f557,13,641,7.1,6,6,7,25,14,4,10,12.0,3.8,8.1,18,ITA
322ba2df,13,1170,13.0,13,13,0,2,18,26,-8,16.1,23.4,-7.3,18,ITA
326d09ef,36,3240,36.0,36,35,0,1,29,71,-42,32.4,65.9,-33.5,18,ITA
32a33c68,7,412,4.6,4,2,3,31,2,10,-8,3.0,6.3,-3.3,18,ITA
32b9b5fa,32,2880,32.0,32,31,0,5,41,52,-11,37.1,41.1,-4.0,18,ITA
32d1c24f,17,1392,15.5,16,12,1,14,14,37,-23,15.6,29.6,-14.0,18,ITA
32ebfe1e,38,3029,33.7,34,22,4,0,32,60,-28,28.2,50.1,-21.9,18,ITA
331c0a43,35,2918,32.4,33,25,2,2,25,44,-19,41.1,39.7,1.4,18,ITA
339c6ed4,14,1077,12.0,10,9,4,24,16,19,-3,17.7,16.1,1.6,18,ITA
339fe0e8,38,3420,38.0,38,38,0,0,89,49,40,63.7,43.9,19.9,18,ITA
33b8d077,31,1926,21.4,21,14,10,3,42,15,27,33.8,19.8,14.0,18,ITA
33ecf462,18,360,4.0,2,1,16,18,5,11,-6,6.4,7.9,-1.4,18,ITA
343c0d52,38,2998,33.3,36,23,2,0,48,41,7,46.2,35.7,10.4,18,ITA
343f753a,1,90,1.0,1,1,0,37,0,0,0,0.7,0.5,0.2,18,ITA
349601c3,1,90,1.0,1,1,0,37,0,1,-1,1.1,1.6,-0.6,18,ITA
3535098b,22,1608,17.9,20,10,2,8,23,17,6,23.7,19.8,3.9,18,ITA
356c9002,36,2537,28.2,33,9,3,2,49,26,23,39.3,29.7,9.6,18,ITA
3626daea,18,1503,16.7,17,13,1,2,26,19,7,29.2,16.5,12.8,18,ITA
3799e138,11,642,7.1,7,6,4,5,7,9,-2,5.3,12.7,-7.5,18,ITA
384dd218,28,1794,19.9,20,13,8,5,24,27,-3,19.9,25.3,-5.4,18,ITA
3858e611,21,1507,16.7,17,13,4,13,16,24,-8,15.6,23.8,-8.2,18,ITA
38ac43d3,26,1912,21.2,24,12,2,5,50,15,35,27.8,16.3,11.6,18,ITA
39bec070,17,1101,12.2,11,9,6,19,6,23,-17,9.9,20.1,-10.1,18,ITA
3b15ef2d,20,1755,19.5,19,19,1,13,40,8,32,26.2,12.6,13.6,18,ITA
3b333ac3,33,2398,26.6,26,21,7,4,38,28,10,42.9,26.6,16.3,18,ITA
3b57f7f8,11,775,8.6,9,5,2,20,19,15,4,12.1,10.9,1.2,18,ITA
3b8674e6,20,581,6.5,5,3,15,17,18,7,11,11.9,5.5,6.5,18,ITA
3b9858f5,4,170,1.9,2,0,2,9,1,5,-4,1.2,3.4,-2.2,18,ITA
3bb7af3b,18,900,10.0,10,2,8,11,15,11,4,17.2,9.8,7.4,18,ITA
3bb7f478,36,3018,33.5,33,29,3,1,55,23,32,56.3,33.6,22.7,18,ITA
3c05c659,7,268,3.0,3,1,4,31,5,6,-1,4.1,3.7,0.4,18,ITA
3d50bcdb,19,1131,12.6,12,4,7,2,13,24,-11,11.8,25.1,-13.2,18,ITA
3d5ed93d,2,32,0.4,0,0,2,9,0,1,-1,0.3,0.5,-0.3,18,ITA
3d936ba9,7,468,5.2,6,4,1,11,9,3,6,5.5,5.4,0.0,18,ITA
3dd45b70,29,2141,23.8,25,16,4,7,18,45,-27,23.3,38.2,-14.9,18,ITA
3ead85f9,28,2353,26.1,27,23,1,2,39,25,14,35.8,23.7,12.1,18,ITA
3effaa34,24,940,10.4,7,4,17,14,14,10,4,14.4,10.0,4.5,18,ITA
40f0ed6c,6,144,1.6,1,0,5,24,2,3,-1,1.8,1.4,0.4,18,ITA
4133cfcf,7,325,3.6,3,2,4,29,4,9,-5,4.7,5.1,-0.4,18,ITA
41bd99ea,6,540,6.0,6,6,0,32,7,11,-4,6.1,8.2,-2.1,18,ITA
422ec08a,29,1198,13.3,9,4,20,9,15,21,-6,19.5,16.2,3.3000000000000003,18,ITA
42591ed0,11,805,8.9,8,6,3,21,9,17,-8,11.4,15.5,-4.1,18,ITA
42fff925,17,934,10.4,10,3,7,3,7,18,-11,7.6,16.6,-8.9,18,ITA
43a1bea5,28,1965,21.8,24,13,4,5,30,42,-12,29.2,36.2,-7.0,18,ITA
43a2e16c,33,2571,28.6,28,21,5,2,33,40,-7,27.2,42.4,-15.2,18,ITA
43b78598,34,2958,32.9,34,22,0,1,60,24,36,49.9,33.9,16.0,18,ITA
440c84ed,37,2821,31.3,34,14,3,0,47,33,14,41.6,33.2,8.4,18,ITA
4431aed2,33,2683,29.8,33,21,0,0,72,35,37,50.6,31.3,19.4,18,ITA
4468b31a,32,2133,23.7,26,8,6,3,24,34,-10,19.5,34.5,-15.0,18,ITA
44ac04e9,29,2137,23.7,25,19,4,5,37,23,14,33.3,24.8,8.5,18,ITA
44eb9093,34,2979,33.1,34,27,0,1,57,28,29,49.7,33.0,16.7,18,ITA
45392b06,24,1850,20.6,20,17,4,11,25,49,-24,24.4,41.7,-17.2,18,ITA
455a2b79,35,2504,27.8,29,13,6,1,29,41,-12,27.5,37.5,-10.0,18,ITA
4590c6e7,5,232,2.6,3,0,2,11,2,2,0,1.2,3.7,-2.4,18,ITA
45db685d,33,2650,29.4,33,18,0,4,56,17,39,50.8,18.0,32.8,18,ITA
4611e028,32,2770,30.8,31,30,1,0,33,44,-11,29.3,41.1,-11.9,18,ITA
46ed55b6,19,1443,16.0,16,16,3,0,9,28,-19,20.3,23.9,-3.6,18,ITA
46f5c54d,15,1350,15.0,15,15,0,0,15,15,0,11.5,20.4,-8.9,18,ITA
47146acb,11,848,9.4,9,9,2,23,10,26,-16,9.9,16.8,-6.8999999999999995,18,ITA
47a500ae,23,2027,22.5,22,22,1,14,23,30,-7,23.1,28.3,-5.2,18,ITA
47dc80f5,22,1615,17.9,18,10,4,5,14,21,-7,19.9,21.0,-1.0,18,ITA
49136c42,2,82,0.9,1,0,1,16,0,2,-2,0.5,1.4,-1.0,18,ITA
49d399d5,5,80,0.9,0,0,5,14,1,2,-1,1.1,1.7,-0.6,18,ITA
4a56052c,36,3209,35.7,36,31,0,0,50,38,12,50.7,35.4,15.4,18,ITA
4a5a45c7,28,1797,20.0,22,7,6,8,32,13,19,34.7,18.3,16.3,18,ITA
4ac07e1b,4,291,3.2,3,3,1,17,3,6,-3,3.1,4.4,-1.3,18,ITA
4ae67f27,1,9,0.1,0,0,1,2,0,0,0,0.0,0.0,0.0,18,ITA
4b029b31,13,1153,12.8,13,10,0,8,10,14,-4,16.4,14.3,2.0,18,ITA
4b6960d2,11,790,8.8,9,5,2,11,16,9,7,14.8,9.0,5.8,18,ITA
4bd414c1,31,2742,30.5,30,29,1,5,58,21,37,52.8,21.4,31.4,18,ITA
4c62d0c8,37,3330,37.0,37,37,0,0,33,42,-9,42.5,41.0,1.5,18,ITA
4c78b5ed,36,2882,32.0,35,22,1,0,78,46,32,54.1,39.5,14.6,18,ITA
4c7940d6,24,1417,15.7,14,9,10,14,14,37,-23,17.0,29.7,-12.7,18,ITA
4cc93246,1,57,0.6,1,0,0,0,0,1,-1,0.4,0.9,-0.6,18,ITA
4d3ab428,22,1292,14.4,18,4,4,6,21,17,4,21.2,12.9,8.3,18,ITA
4dba2a97,23,1574,17.5,19,9,4,9,14,19,-5,20.0,17.0,3.0,18,ITA
4e219ad2,35,2830,31.4,33,20,2,1,47,31,16,42.7,30.3,12.4,18,ITA
4e358a2d,34,2922,32.5,32,32,2,2,53,25,28,54.1,31.9,22.2,18,ITA
4e6dbac4,35,2844,31.6,33,26,2,1,71,42,29,53.2,36.6,16.7,18,ITA
4f2908e5,31,2594,28.8,28,26,3,4,22,41,-19,36.6,35.7,0.9,18,ITA
4f8ce0e1,15,1293,14.4,15,14,0,19,8,32,-24,13.8,28.0,-14.299999999999999,18,ITA
4fa7cb9b,31,1795,19.9,18,8,13,6,49,8,41,30.8,10.7,20.1,18,ITA
50b51fac,9,368,4.1,3,3,6,13,3,6,-3,3.5,8.0,-4.4,18,ITA
5128bde4,21,1242,13.8,12,9,9,15,15,20,-5,18.4,14.8,3.6,18,ITA
51c614fd,2,36,0.4,0,0,2,21,0,0,0,0.6,0.2,0.4,18,ITA
524eb8c5,20,1138,12.6,12,6,8,13,19,20,-1,16.1,19.5,-3.4000000000000004,18,ITA
52611641,36,3180,35.3,36,31,0,1,51,53,-2,49.9,56.0,-6.1,18,ITA
528492ea,26,1947,21.6,23,12,3,6,14,30,-16,28.1,26.2,2.0,18,ITA
5294a83f,34,2669,29.7,32,19,2,1,73,41,32,51.3,32.6,18.7,18,ITA
52e2ef8f,17,1251,13.9,16,10,1,15,26,20,6,18.8,23.2,-4.5,18,ITA
52ec54d0,35,3085,34.3,35,34,0,0,52,39,13,47.5,34.6,12.9,18,ITA
5313ed43,27,1868,20.8,22,12,5,7,27,39,-12,23.7,29.1,-5.4,18,ITA
532d2690,22,1829,20.3,21,14,1,9,31,10,21,28.6,18.7,9.9,18,ITA
53636fce,5,385,4.3,4,3,1,16,5,8,-3,6.0,8.9,-2.9,18,ITA
5370cba7,24,1635,18.2,22,7,2,1,17,34,-17,19.5,27.3,-7.7,18,ITA
539230cf,11,627,7.0,7,5,4,25,15,4,11,9.2,5.9,3.3,18,ITA
53a0e358,31,2296,25.5,29,12,2,0,17,37,-20,30.1,30.6,-0.5,18,ITA
53de807a,31,2588,28.8,31,21,0,2,64,37,27,47.2,32.3,15.0,18,ITA
54e53b7e,34,1809,20.1,19,5,15,3,25,28,-3,28.8,30.4,-1.5,18,ITA
55667895,22,1782,19.8,19,17,3,15,30,20,10,25.8,21.5,4.4,18,ITA
55ae91f0,15,781,8.7,6,5,9,21,16,14,2,12.3,10.6,1.7,18,ITA
56400c01,24,1927,21.4,22,14,2,10,16,29,-13,22.5,31.5,-9.0,18,ITA
56b2957b,25,1985,22.1,23,16,2,3,26,34,-8,21.5,28.0,-6.6,18,ITA
5710a281,28,2039,22.7,24,16,4,3,32,23,9,31.6,20.2,11.4,18,ITA
58027adc,12,397,4.4,2,0,10,20,4,10,-6,3.7,9.4,-5.7,18,ITA
58d97e77,23,914,10.2,7,4,16,13,7,20,-13,16.0,16.8,-0.9,18,ITA
5a325298,29,800,8.9,4,4,25,9,15,6,9,15.9,5.7,10.1,18,ITA
5aa53281,11,684,7.6,8,3,3,26,8,8,0,12.6,7.3,5.4,18,ITA
5bdd44d8,10,204,2.3,2,1,8,6,4,6,-2,2.6,4.0,-1.4000000000000001,18,ITA
5d311e8d,5,230,2.6,2,2,3,17,2,1,1,4.6,1.8,2.8,18,ITA
5d4f7d61,22,992,11.0,10,5,12,6,14,4,10,19.1,8.1,11.0,18,ITA
5e861944,36,2812,31.2,33,15,3,2,23,49,-26,39.0,39.8,-0.8,18,ITA
5eb72339,37,3103,34.5,37,25,0,1,32,51,-19,35.5,53.5,-18.0,18,ITA
5efc5389,11,687,7.6,8,6,3,4,4,12,-8,6.3,9.0,-2.7,18,ITA
61228681,1,90,1.0,1,1,0,13,1,1,0,0.3,1.9,-1.6,18,ITA
614c38fb,22,1247,13.9,16,3,6,5,19,9,10,17.6,12.6,5.0,18,ITA
616aea37,25,2097,23.3,23,22,2,10,32,34,-2,25.3,32.6,-7.199999999999999,18,ITA
61b3978f,31,2480,27.6,28,24,3,4,37,39,-2,36.7,45.9,-9.3,18,ITA
635b0bae,24,2048,22.8,23,21,1,8,24,35,-11,21.0,30.9,-9.9,18,ITA
644faf10,1,13,0.1,0,0,1,26,0,0,0,0.3,0.2,0.1,18,ITA
64cd167d,23,1796,20.0,20,17,3,11,18,24,-6,22.0,21.6,0.4,18,ITA
65c75ea8,23,1638,18.2,19,9,4,2,23,32,-9,17.9,27.5,-9.6,18,ITA
65e4dede,6,318,3.5,3,3,3,6,6,9,-3,4.6,5.6,-0.9,18,ITA
68252d6d,31,2002,22.2,21,9,10,0,38,26,12,39.1,21.4,17.7,18,ITA
686cbe7d,3,225,2.5,3,2,0,11,2,4,-2,2.8,1.3,1.5,18,ITA
68852c0a,13,1007,11.2,11,9,2,8,6,29,-23,9.3,26.5,-17.2,18,ITA
6928979a,34,2955,32.8,34,23,0,0,28,49,-21,34.8,47.6,-12.8,18,ITA
6989550f,13,1126,12.5,11,11,2,25,14,31,-17,12.3,25.4,-13.2,18,ITA
69cbc8b6,5,365,4.1,4,3,1,14,1,10,-9,2.3,5.4,-3.1,18,ITA
6a189491,9,468,5.2,3,2,6,17,8,11,-3,4.6,6.5,-1.9,18,ITA
6aafdc27,29,2436,27.1,28,25,1,5,27,43,-16,26.5,43.1,-16.599999999999998,18,ITA
6c1f7328,34,2782,30.9,33,21,1,1,32,40,-8,31.0,45.0,-13.9,18,ITA
6ca663b4,19,992,11.0,7,4,12,1,10,24,-14,12.9,19.8,-6.9,18,ITA
6cc97b6a,28,2253,25.0,26,17,2,3,30,35,-5,25.9,36.8,-10.9,18,ITA
6e4df551,33,2750,30.6,31,23,2,1,48,34,14,52.6,29.7,22.9,18,ITA
6eee05f1,30,2700,30.0,30,30,0,5,30,61,-31,30.9,54.1,-23.3,18,ITA
6ef56efd,13,957,10.6,10,9,3,1,12,19,-7,11.6,17.6,-6.0,18,ITA
6fe90922,37,3313,36.8,37,34,0,0,66,27,39,55.5,35.5,20.1,18,ITA
70fd593e,11,243,2.7,2,0,9,20,2,7,-5,2.6,5.6,-2.9,18,ITA
7280b54f,18,1148,12.8,12,7,6,15,12,24,-12,8.5,22.1,-13.7,18,ITA
72c803a0,19,797,8.9,6,4,13,17,4,9,-5,10.1,8.4,1.7,18,ITA
741e058f,1,75,0.8,0,0,1,14,1,4,-3,1.7,1.7,0.0,18,ITA
74419746,38,3420,38.0,38,38,0,0,66,30,36,56.7,37.2,19.6,18,ITA
756959aa,15,1193,13.3,14,11,1,1,13,14,-1,13.4,16.3,-2.9,18,ITA
75b86fb3,4,91,1.0,0,0,4,18,0,1,-1,1.2,0.5,0.7,18,ITA
75efed2e,21,857,9.5,10,1,11,9,7,19,-12,10.8,19.6,-8.8,18,ITA
77cf6852,12,946,10.5,10,8,2,25,10,20,-10,8.4,19.6,-11.3,18,ITA
78841da9,38,3238,36.0,38,22,0,0,73,26,47,63.8,23.6,40.2,18,ITA
788b31e2,12,711,7.9,8,3,4,25,10,13,-3,7.7,11.2,-3.6,18,ITA
79083382,22,1658,18.4,18,17,4,15,23,12,11,28.2,17.2,11.0,18,ITA
7a2e46a8,37,3330,37.0,37,37,0,0,60,28,32,62.2,36.1,26.2,18,ITA
7b536033,22,713,7.9,6,2,16,13,12,13,-1,6.1,12.9,-6.8,18,ITA
7b5f516f,1,8,0.1,0,0,1,36,0,1,-1,0.8,0.3,0.5,18,ITA
7c0000fd,25,1447,16.1,14,14,11,12,34,9,25,22.1,10.9,11.2,18,ITA
7cc89a5f,3,43,0.5,0,0,3,23,0,0,0,0.1,0.6,-0.5,18,ITA
7d3cbc67,4,42,0.5,0,0,4,17,0,5,-5,0.3,1.5,-1.2,18,ITA
7d50454d,27,2227,24.7,26,24,1,8,26,34,-8,29.6,36.4,-6.8,18,ITA
7f267d66,13,449,5.0,4,1,9,15,2,8,-6,5.4,6.5,-1.1,18,ITA
7f78ad23,34,3005,33.4,34,32,0,1,50,36,14,46.2,32.0,14.2,18,ITA
7fd58fe3,35,2426,27.0,30,13,5,0,57,35,22,44.3,32.1,12.2,18,ITA
7fe90ccd,2,96,1.1,1,1,1,0,2,1,1,0.6,0.6,-0.1,18,ITA
8011fcf6,17,1258,14.0,15,10,2,9,7,31,-24,13.1,23.3,-10.3,18,ITA
80ad4216,1,6,0.1,0,0,1,4,0,0,0,0.0,0.0,0.0,18,ITA
80dbbd10,23,1219,13.5,11,9,12,13,20,22,-2,13.3,22.6,-9.3,18,ITA
81255c03,22,1656,18.4,19,9,3,1,15,27,-12,17.0,29.5,-12.5,18,ITA
82f32d55,3,127,1.4,1,1,2,11,1,4,-3,1.3,3.3,-2.0,18,ITA
8320fe65,1,45,0.5,0,0,1,17,1,0,1,1.6,0.1,1.5,18,ITA
844a87c2,1,4,0.0,0,0,1,10,0,0,0,0.0,0.4,-0.3,18,ITA
84594618,23,1888,21.0,21,20,2,12,19,42,-23,20.7,40.0,-19.3,18,ITA
852351df,18,1155,12.8,13,9,5,15,18,8,10,17.7,11.9,5.9,18,ITA
854ee61a,15,485,5.4,5,0,10,6,11,8,3,10.9,8.2,2.6,18,ITA
85613cf0,15,448,5.0,3,0,12,3,18,8,10,11.9,4.7,7.2,18,ITA
86015b20,19,764,8.5,8,3,11,12,8,16,-8,8.2,10.0,-1.8,18,ITA
8650af85,30,2645,29.4,29,29,1,8,41,48,-7,38.9,50.0,-11.2,18,ITA
86695068,32,2657,29.5,31,22,1,2,43,44,-1,41.3,45.6,-4.4,18,ITA
8697c095,14,327,3.6,2,0,12,18,6,5,1,3.7,6.2,-2.5,18,ITA
87243064,7,277,3.1,3,0,4,7,3,7,-4,3.5,4.3,-0.8,18,ITA
878ee034,19,560,6.2,2,1,17,19,6,14,-8,7.6,8.1,-0.5,18,ITA
8790f988,3,23,0.3,0,0,3,15,0,0,0,0.9,0.3,0.6,18,ITA
8827bf46,24,909,10.1,8,2,16,14,20,8,12,17.1,8.6,8.5,18,ITA
88895312,28,1827,20.3,21,11,7,4,22,40,-18,22.2,36.0,-13.700000000000001,18,ITA
88c89891,15,836,9.3,9,5,6,19,13,9,4,11.8,11.9,-0.1,18,ITA
89976232,16,1387,15.4,16,15,0,0,10,15,-5,18.8,15.6,3.2,18,ITA
89b2c8a9,38,3002,33.4,35,21,3,0,63,23,40,58.1,22.8,35.4,18,ITA
8a08491a,35,2815,31.3,32,27,3,2,71,22,49,44.3,24.0,20.2,18,ITA
8a2d3fdb,1,10,0.1,0,0,1,20,0,0,0,0.1,0.0,0.1,18,ITA
8b0b02c9,2,96,1.1,1,0,1,0,0,3,-3,1.7,1.0,0.7,18,ITA
8b66d9cc,16,489,5.4,4,1,12,20,14,5,9,11.3,2.9,8.4,18,ITA
8b9b8e43,1,84,0.9,0,0,1,0,0,2,-2,0.4,1.1,-0.6,18,ITA
8c725b43,34,2979,33.1,34,31,0,1,51,37,14,49.8,34.8,15.1,18,ITA
8c964914,11,290,3.2,2,0,9,26,2,3,-1,4.8,4.9,-0.1,18,ITA
8cabdc1e,37,3316,36.8,37,36,0,1,29,58,-29,45.0,47.5,-2.5,18,ITA
8cc29864,4,351,3.9,3,3,1,18,10,7,3,7.7,5.9,1.8,18,ITA
8cea6319,30,2573,28.6,30,27,0,5,25,41,-16,23.5,42.0,-18.5,18,ITA
8cf63012,1,1,0.0,0,0,1,37,0,0,0,0.0,0.0,0.0,18,ITA
8d8178ac,28,2065,22.9,23,16,5,2,26,32,-6,22.0,30.7,-8.6,18,ITA
8e45910b,6,412,4.6,4,4,2,11,5,11,-6,7.4,6.2,1.2,18,ITA
8e4b894b,2,98,1.1,1,1,1,33,0,0,0,0.5,2.3,-1.7,18,ITA
8ea2c099,16,819,9.1,10,4,6,11,10,12,-2,9.0,11.7,-2.7,18,ITA
8ec95452,23,1815,20.2,20,15,3,8,18,32,-14,17.7,28.7,-11.0,18,ITA
8efa621b,8,720,8.0,8,8,0,0,5,17,-12,7.7,17.6,-9.9,18,ITA
8f3565b3,22,1588,17.6,17,11,5,2,11,31,-20,14.6,26.3,-11.7,18,ITA
8fef5412,2,157,1.7,2,1,0,1,5,1,4,2.9,0.9,2.0,18,ITA
905a4f61,10,265,2.9,1,0,9,9,5,5,0,3.1,2.2,0.9,18,ITA
9085dd7c,35,2457,27.3,25,24,10,1,27,46,-19,33.1,40.6,-7.5,18,ITA
90b70194,32,2415,26.8,27,20,5,2,29,39,-10,26.6,32.8,-6.3,18,ITA
91899ca8,15,1202,13.4,12,12,3,23,21,21,0,18.3,14.2,4.1,18,ITA
91976866,2,31,0.3,0,0,2,14,1,1,0,1.1,1.2,-0.2,18,ITA
921f6058,26,1979,22.0,22,20,4,7,31,24,7,36.3,22.0,14.3,18,ITA
92a5ac34,12,267,3.0,2,0,10,21,5,5,0,4.1,4.3,-0.2,18,ITA
92b4758e,31,2569,28.5,30,24,1,2,29,49,-20,28.6,36.0,-7.4,18,ITA
93390969,9,739,8.2,9,6,0,11,4,12,-8,10.6,11.3,-0.7,18,ITA
93b891d1,22,717,8.0,4,3,18,12,20,15,5,16.4,11.2,5.2,18,ITA
93cf32a8,37,3258,36.2,37,35,0,1,46,45,1,42.2,44.7,-2.6,18,ITA
9413b19f,13,1158,12.9,13,12,0,6,8,16,-8,7.5,20.1,-12.6,18,ITA
9417f322,24,2069,23.0,23,22,1,11,31,21,10,28.4,27.0,1.5,18,ITA
951a4ee4,2,11,0.1,0,0,2,20,1,0,1,0.3,0.0,0.2,18,ITA
952a03fe,26,2053,22.8,22,20,4,10,22,30,-8,21.9,32.5,-10.6,18,ITA
957d41d2,9,478,5.3,6,3,3,4,3,20,-17,3.2,16.1,-12.9,18,ITA
958a601f,11,809,9.0,9,6,2,20,5,15,-10,6.9,15.3,-8.5,18,ITA
95cfe655,11,664,7.4,7,5,4,3,9,10,-1,9.9,11.9,-2.1,18,ITA
961a4174,4,231,2.6,2,1,2,9,1,3,-2,3.1,2.0,1.1,18,ITA
96960855,10,458,5.1,5,3,5,25,7,10,-3,4.3,8.0,-3.6,18,ITA
97c9bce3,8,592,6.6,8,5,0,2,4,18,-14,5.8,15.1,-9.2,18,ITA
97e2aa67,11,641,7.1,7,3,4,5,10,10,0,9.4,8.9,0.5,18,ITA
983ff2c7,31,2390,26.6,25,23,6,6,22,65,-43,26.5,57.3,-30.9,18,ITA
98d2c2c4,35,3006,33.4,33,31,2,2,53,33,20,61.0,30.7,30.3,18,ITA
98e958af,15,1279,14.2,15,12,0,0,14,17,-3,16.2,16.4,-0.3,18,ITA
99b1d0e6,27,1704,18.9,21,7,6,7,47,19,28,26.8,16.9,9.9,18,ITA
99d8fc35,33,2857,31.7,32,31,1,4,27,64,-37,28.4,58.1,-29.8,18,ITA
9a560ebe,21,1798,20.0,20,18,1,3,14,15,-1,22.7,19.7,3.0,18,ITA
9b30df1e,22,1725,19.2,20,18,2,9,21,39,-18,18.7,29.8,-11.1,18,ITA
9b7533de,1,90,1.0,1,1,0,8,1,2,-1,0.2,2.2,-2.0,18,ITA
9be4ee80,21,1083,12.0,11,7,10,16,11,25,-14,14.6,17.8,-3.2,18,ITA
9c31bb89,11,329,3.7,3,0,8,15,4,3,1,2.6,5.7,-3.1,18,ITA
9c8f641a,9,429,4.8,5,1,4,8,3,11,-8,3.6,13.1,-9.5,18,ITA
9dabfcf5,15,644,7.2,7,2,8,6,3,20,-17,3.6,16.2,-12.5,18,ITA
9e1577aa,34,2980,33.1,34,31,0,3,51,40,11,50.1,35.3,14.8,18,ITA
9e61c019,12,944,10.5,11,10,1,0,9,29,-20,9.6,19.3,-9.8,18,ITA
9f069180,6,86,1.0,0,0,6,9,1,1,0,1.0,1.6,-0.6,18,ITA
9f1893b9,21,1162,12.9,9,6,12,2,33,16,17,20.3,15.5,4.8,18,ITA
9f84febe,1,81,0.9,1,0,0,3,1,0,1,2.1,0.4,1.8,18,ITA
9fa26bc2,1,90,1.0,1,1,0,32,2,1,1,1.2,1.4,-0.2,18,ITA
Christian-Rutjens,1,1,0.0,0,0,1,0,0,0,0,0.0,0.0,0.0,18,ITA
a128b07e,10,811,9.0,10,8,0,0,14,14,0,11.2,11.4,-0.2,18,ITA
a12d0c05,9,384,4.3,3,2,6,7,4,6,-2,5.1,3.5,1.5,18,ITA
a1c7b425,22,1380,15.3,17,6,5,16,13,28,-15,11.8,20.1,-8.2,18,ITA
a39b9ef6,32,1754,19.5,18,7,14,5,17,22,-5,24.0,21.400000000000002,2.6,18,ITA
a3e1d20d,5,294,3.3,3,2,2,11,3,11,-8,3.5,6.2,-2.7,18,ITA
a3e4b724,11,488,5.4,4,2,7,6,6,13,-7,6.8,11.4,-4.7,18,ITA
a40d5a0c,25,1609,17.9,17,10,8,3,28,17,11,27.8,18.2,9.7,18,ITA
a440d8ca,1,57,0.6,1,0,0,1,1,2,-1,0.4,0.4,-0.1,18,ITA
a44d3a3c,6,282,3.1,3,1,3,7,3,3,0,2.3,4.3,-2.0,18,ITA
a4ec7d09,1,90,1.0,1,1,0,32,0,3,-3,0.6,2.3,-1.7,18,ITA
a4fe8cda,28,1503,16.7,17,3,11,10,30,20,10,25.2,17.4,7.7,18,ITA
a5296e55,36,1667,18.5,14,6,22,2,39,17,22,27.9,15.3,12.6,18,ITA
a5cd894b,5,95,1.1,1,0,4,10,0,3,-3,0.1,1.6,-1.5,18,ITA
a889ffc7,15,773,8.6,9,4,6,2,8,15,-7,6.8,11.4,-4.6,18,ITA
a8a874f1,21,684,7.6,5,4,16,17,17,10,7,10.1,8.5,1.6,18,ITA
aa5a409a,14,1048,11.6,12,7,2,5,7,32,-25,9.2,27.8,-18.6,18,ITA
aae9d04a,28,1754,19.5,18,13,10,10,21,32,-11,18.4,27.3,-8.9,18,ITA
ab1ca213,22,1734,19.3,21,13,1,5,15,23,-8,22.1,22.4,-0.4,18,ITA
ab4449d6,1,90,1.0,1,1,0,37,1,0,1,1.2,1.2,0.0,18,ITA
ac4003af,37,3202,35.6,37,35,0,0,51,38,13,52.6,37.4,15.1,18,ITA
ac7e640b,24,2160,24.0,24,24,0,8,39,24,15,38.7,24.4,14.3,18,ITA
acdad0aa,34,2258,25.1,27,11,7,4,27,39,-12,23.4,36.5,-13.1,18,ITA
ad469944,28,1684,18.7,20,9,8,8,30,34,-4,22.0,25.5,-3.5,18,ITA
ad6df2d5,31,2484,27.6,28,21,3,1,57,15,42,35.4,20.3,15.1,18,ITA
ae4e2852,12,968,10.8,10,9,2,11,21,1,20,15.1,2.9,12.2,18,ITA
ae64d449,26,2024,22.5,24,14,2,2,24,33,-9,27.0,36.6,-9.6,18,ITA
ae82fa48,21,706,7.8,8,2,13,16,13,14,-1,10.4,13.7,-3.3,18,ITA
aeed5c06,2,69,0.8,1,0,1,11,0,1,-1,0.4,0.8,-0.4,18,ITA
afa0d4e0,32,2324,25.8,27,16,5,0,58,18,40,38.1,20.1,18.0,18,ITA
b0243215,8,421,4.7,5,4,3,10,8,6,2,4.3,5.3,-1.1,18,ITA
b02af64f,2,32,0.4,0,0,2,11,0,1,-1,0.1,1.0,-0.9,18,ITA
b0f7e36c,36,3012,33.5,35,24,1,0,51,42,9,49.6,34.2,15.4,18,ITA
b1deecf8,12,994,11.0,11,11,1,24,10,10,0,13.4,9.7,3.7,18,ITA
b1e61f23,4,77,0.9,0,0,4,15,0,3,-3,0.8,2.8,-2.0,18,ITA
b39569c0,2,14,0.2,0,0,2,0,0,0,0,0.4,0.1,0.3,18,ITA
b39dfab0,23,1989,22.1,23,22,0,14,30,38,-8,27.5,37.4,-9.799999999999999,18,ITA
b3a20f18,2,124,1.4,1,1,1,3,1,0,1,1.2,1.6,-0.4,18,ITA
b3fd7075,32,2543,28.3,32,13,0,2,30,39,-9,26.4,38.9,-12.5,18,ITA
b4c3070a,7,206,2.3,2,0,5,25,1,5,-4,2.9,5.0,-2.1,18,ITA
b5365398,9,555,6.2,6,5,3,17,5,11,-6,4.8,9.9,-5.1,18,ITA
b5b27493,26,1632,18.1,20,8,6,8,16,36,-20,13.0,31.5,-18.5,18,ITA
b5bf1770,4,316,3.5,4,3,0,10,7,9,-2,4.1,7.9,-3.8,18,ITA
b5cae4e6,36,2184,24.3,25,7,11,2,28,42,-14,26.2,38.1,-11.9,18,ITA
b6b2b820,28,289,3.2,0,0,28,10,5,4,1,5.8,2.8,2.9,18,ITA
b6ca47a2,34,3060,34.0,34,34,0,4,53,50,3,50.0,53.4,-3.4,18,ITA
b70bde8f,17,1041,11.6,10,7,7,10,10,21,-11,13.6,18.2,-4.5,18,ITA
b746d309,18,1087,12.1,12,6,6,17,13,16,-3,14.6,14.5,0.0,18,ITA
b7a5bc86,30,2604,28.9,29,27,1,1,25,57,-32,28.4,50.9,-22.5,18,ITA
b8c1de25,16,1096,12.2,12,11,4,15,23,9,14,22.9,10.8,12.1,18,ITA
b96b595c,38,3420,38.0,38,38,0,0,29,59,-30,46.3,48.9,-2.6,18,ITA
ba06950a,15,1333,14.8,15,14,0,0,10,28,-18,10.1,28.0,-17.8,18,ITA
ba3d3bea,29,2282,25.4,25,20,4,4,15,57,-42,21.4,50.0,-28.6,18,ITA
bbafc0c4,25,1872,20.8,20,17,5,3,26,27,-1,26.1,28.8,-2.7,18,ITA
bd6351cd,26,1851,20.6,20,18,6,6,33,16,17,30.5,18.2,12.4,18,ITA
bd84fc61,31,1990,22.1,22,14,9,3,22,37,-15,21.9,35.9,-14.0,18,ITA
be5e1c4c,22,823,9.1,6,3,16,13,14,19,-5,12.4,16.2,-3.8,18,ITA
be9938ed,7,416,4.6,5,4,2,6,3,6,-3,6.2,6.6,-0.4,18,ITA
bee704fc,16,1254,13.9,14,11,2,21,19,18,1,20.9,12.7,8.2,18,ITA
bf309d24,18,655,7.3,5,5,13,20,19,8,11,14.3,6.0,8.3,18,ITA
bf57eaab,12,204,2.3,2,0,10,25,2,3,-1,3.0,3.6,-0.40000000000000013,18,ITA
c01c66d9,21,1407,15.6,16,11,5,15,32,21,11,25.3,19.3,6.0,18,ITA
c0cddebe,32,2354,26.2,27,21,5,2,49,15,34,36.6,16.6,20.0,18,ITA
c15d1af9,8,401,4.5,5,2,3,2,1,14,-13,2.4,8.8,-6.4,18,ITA
c1c2c925,14,1153,12.8,13,9,1,3,17,28,-11,13.3,23.7,-10.4,18,ITA
c1d18f10,10,550,6.1,5,5,5,27,5,11,-6,6.1,10.5,-4.3,18,ITA
c23c8e0d,11,702,7.8,7,5,4,10,3,16,-13,8.8,13.9,-5.2,18,ITA
c316607a,7,582,6.5,7,6,0,21,15,7,8,11.0,5.5,5.5,18,ITA
c414df9d,26,1577,17.5,18,9,8,5,13,32,-19,17.0,31.7,-14.7,18,ITA
c4f97172,12,390,4.3,3,2,9,20,4,7,-3,2.7,6.6,-3.9,18,ITA
c53083ad,10,591,6.6,6,5,4,5,11,11,0,9.8,8.7,1.1,18,ITA
c56dc39e,31,2445,27.2,29,23,2,1,40,28,12,44.3,25.3,19.0,18,ITA
c5942695,11,517,5.7,6,1,5,4,2,12,-10,2.7,10.0,-7.3,18,ITA
c5adc293,11,985,10.9,11,10,0,3,32,8,24,22.7,6.3,16.4,18,ITA
c67836b8,6,410,4.6,4,3,2,31,3,11,-8,3.6,8.1,-4.5,18,ITA
c693347d,23,934,10.4,8,2,15,9,14,10,4,19.5,11.0,8.6,18,ITA
c6dda86e,12,591,6.6,6,4,6,20,4,6,-2,6.6,8.6,-2.0,18,ITA
c707411f,29,2338,26.0,27,21,2,6,46,25,21,46.4,28.6,17.8,18,ITA
c710f7d5,13,618,6.9,7,5,6,22,10,12,-2,8.9,10.8,-1.9,18,ITA
c7259b83,36,3240,36.0,36,36,0,1,38,57,-19,32.5,54.1,-21.6,18,ITA
c75b6a02,33,2895,32.2,33,29,0,2,28,35,-7,37.1,34.4,2.7,18,ITA
c77be0cf,6,381,4.2,4,2,2,6,3,3,0,3.4,3.7,-0.3,18,ITA
cc700722,38,2850,31.7,32,19,6,0,62,21,41,57.8,21.9,35.9,18,ITA
cd0fa27b,31,2172,24.1,25,15,6,2,43,20,23,36.2,19.9,16.3,18,ITA
cda2ec29,31,2194,24.4,24,19,7,5,24,43,-19,21.4,41.1,-19.6,18,ITA
ce30bfc8,30,1988,22.1,23,18,7,4,28,17,11,31.7,21.0,10.7,18,ITA
ce5b170a,16,1220,13.6,14,12,2,8,13,22,-9,15.9,16.7,-0.8,18,ITA
cecbce23,26,2261,25.1,25,24,1,12,31,43,-12,28.2,37.6,-9.3,18,ITA
cedb3e36,36,2669,29.7,31,18,5,2,20,47,-27,25.7,46.2,-20.5,18,ITA
cfbf9881,25,1760,19.6,18,15,7,8,26,25,1,21.5,25.6,-4.1,18,ITA
d023d70f,29,2139,23.8,21,18,8,3,40,31,9,35.6,36.3,-0.7,18,ITA
d0643f8f,18,1347,15.0,16,8,2,9,22,26,-4,19.1,22.5,-3.4,18,ITA
d0d8dd44,36,3034,33.7,36,29,0,1,74,42,32,55.3,39.2,16.1,18,ITA
d0dbca9f,25,2136,23.7,25,22,0,1,19,47,-28,18.9,43.7,-24.8,18,ITA
d0e6399c,1,66,0.7,1,0,0,11,0,0,0,0.6,0.4,0.2,18,ITA
d183e9d6,20,1449,16.1,16,13,4,12,19,28,-9,23.0,26.2,-3.2,18,ITA
d3298c99,30,1954,21.7,22,10,8,6,18,48,-30,18.1,42.1,-23.9,18,ITA
d37b0350,33,2719,30.2,31,24,2,1,30,44,-14,32.8,45.5,-12.6,18,ITA
d3aaad90,33,2155,23.9,25,9,8,3,40,20,20,40.5,21.7,18.8,18,ITA
d3d758d8,20,1398,15.5,18,6,2,4,20,22,-2,18.9,17.5,1.4,18,ITA
d3de9af0,31,2108,23.4,24,13,7,1,36,38,-2,33.4,37.9,-4.4,18,ITA
d4535821,32,2523,28.0,28,21,4,3,70,35,35,50.0,32.8,17.2,18,ITA
d4931a5a,31,1812,20.1,20,7,11,1,27,26,1,25.7,19.3,6.3,18,ITA
d49f3e6b,11,155,1.7,0,0,11,8,2,3,-1,2.7,4.1,-1.4,18,ITA
d5bd1abc,1,5,0.1,0,0,1,5,0,0,0,0.0,0.0,0.0,18,ITA
d5c04323,3,247,2.7,3,2,0,14,5,1,4,3.6,1.8,1.8,18,ITA
d61b3354,13,996,11.1,12,10,1,13,29,11,18,18.4,11.5,6.9,18,ITA
d705ba44,32,2683,29.8,29,27,3,0,43,35,8,36.0,38.5,-2.5,18,ITA
d711d04f,32,1803,20.0,22,5,10,3,17,18,-1,23.5,19.6,3.9,18,ITA
d7403bd5,22,951,10.6,9,3,13,11,13,17,-4,9.8,15.4,-5.6,18,ITA
d7d32194,26,1617,18.0,19,11,7,7,22,23,-1,19.9,25.3,-5.4,18,ITA
d85c238b,6,152,1.7,2,0,4,6,0,6,-6,1.1,3.8,-2.7,18,ITA
d9624b51,37,3229,35.9,37,34,0,0,39,62,-23,33.3,56.3,-23.0,18,ITA
d97f2e8d,19,1192,13.2,13,7,6,18,9,20,-11,10.0,23.5,-13.5,18,ITA
d995ed27,33,2541,28.2,30,15,3,0,40,29,11,37.0,27.6,9.4,18,ITA
d9e750e5,8,293,3.3,3,2,5,27,1,8,-7,3.8,5.7,-1.9,18,ITA
da5a981b,13,992,11.0,12,7,1,20,21,16,5,18.0,12.9,5.1,18,ITA
da974c7b,35,3066,34.1,35,34,0,1,68,21,47,60.9,20.9,40.0,18,ITA
dbe5a587,8,701,7.8,8,6,0,9,7,14,-7,6.7,10.0,-3.3,18,ITA
dc1c2fce,22,1043,11.6,11,6,11,13,18,13,5,13.4,13.6,-0.2,18,ITA
dc61b402,20,1017,11.3,10,5,10,18,11,23,-12,12.4,16.6,-4.1,18,ITA
dd06d56c,10,794,8.8,8,8,2,20,12,11,1,11.3,14.9,-3.6,18,ITA
de045b15,34,2850,31.7,34,27,0,1,32,43,-11,31.6,44.8,-13.2,18,ITA
de0f152c,34,2830,31.4,33,22,1,2,31,43,-12,28.4,39.5,-11.1,18,ITA
df301450,20,883,9.8,9,4,11,7,9,14,-5,9.7,15.2,-5.5,18,ITA
dfbb3234,1,32,0.4,0,0,1,8,0,1,-1,0.3,0.8,-0.5,18,ITA
e0314d87,31,2707,30.1,30,29,1,5,47,31,16,52.7,29.1,23.6,18,ITA
e0921a4f,33,2353,26.1,26,17,7,1,62,19,43,41.1,19.2,21.9,18,ITA
e0bc6fdc,1,16,0.2,0,0,1,11,0,0,0,0.8,0.0,0.8,18,ITA
e14ec482,16,466,5.199999999999999,4,2,12,19,5,8,-3,6.6,8.0,-1.4,18,ITA
e288d4b3,32,2387,26.5,26,20,6,5,45,19,26,45.2,25.6,19.6,18,ITA
e304acd5,15,817,9.1,9,4,6,12,23,5,18,16.8,7.3,9.5,18,ITA
e327bd76,15,933,10.4,12,6,3,22,7,17,-10,9.9,17.8,-7.9,18,ITA
e33f36d5,27,2362,26.2,26,26,1,10,36,43,-7,31.6,35.3,-3.7,18,ITA
e34fc66d,7,546,6.1,6,6,1,25,7,13,-6,6.5,9.0,-2.5,18,ITA
e358587b,37,3330,37.0,37,37,0,1,77,29,48,66.4,26.5,39.9,18,ITA
e40d028b,21,1862,20.7,21,20,0,11,55,14,41,30.4,16.5,13.9,18,ITA
e5bf73f3,12,443,4.9,5,0,7,5,11,4,7,12.6,4.1,8.5,18,ITA
e61bdd69,27,1190,13.2,9,2,18,9,17,22,-5,15.9,18.5,-2.6,18,ITA
e66ebabb,38,3420,38.0,38,38,0,0,40,66,-26,34.6,58.6,-24.0,18,ITA
e6ad16b2,38,2371,26.3,32,7,6,0,52,19,33,46.8,17.9,28.9,18,ITA
e74f0e59,35,2955,32.8,35,28,0,2,45,34,11,40.9,36.2,4.7,18,ITA
e85fb9b8,26,2161,24.0,25,23,1,9,56,15,41,37.4,19.3,18.1,18,ITA
e8c930bb,27,2351,26.1,27,22,0,2,38,28,10,40.0,23.6,16.4,18,ITA
e94d79e3,20,1606,17.8,18,15,2,14,27,34,-7,21.7,31.6,-10.0,18,ITA
e967e202,30,825,9.2,7,0,23,7,7,23,-16,11.4,12.8,-1.5,18,ITA
ea06dd97,32,2521,28.0,30,18,2,0,43,32,11,36.7,32.1,4.6,18,ITA
eade5337,6,199,2.2,1,1,5,4,3,8,-5,3.1,4.2,-1.1,18,ITA
eb0d77a4,4,74,0.8,0,0,4,16,1,0,1,3.0,0.2,2.8,18,ITA
ec30b9c8,21,1355,15.1,15,9,6,13,9,24,-15,11.8,25.5,-13.6,18,ITA
eccbe56a,16,978,10.9,13,3,3,9,15,24,-9,11.9,17.8,-6.0,18,ITA
ed5886d2,31,2612,29.0,30,25,1,1,63,36,27,44.8,32.7,12.1,18,ITA
ed90babd,7,96,1.1,0,0,7,28,1,0,1,1.5,0.2,1.2,18,ITA
eda40760,35,3060,34.0,34,32,1,2,55,25,30,56.0,34.4,21.6,18,ITA
ee4f2f3b,35,2719,30.2,33,21,2,1,50,41,9,44.7,44.7,0.0,18,ITA
ee833569,31,2790,31.0,31,31,0,7,46,34,12,51.6,29.6,22.0,18,ITA
ee93c1a9,22,847,9.4,7,1,15,7,23,5,18,14.1,7.3,6.8,18,ITA
ef2e5e1a,32,2258,25.1,26,18,6,3,40,22,18,42.2,28.0,14.2,18,ITA
ef5b337e,29,1610,17.9,19,9,10,7,23,29,-6,19.9,20.0,-0.1,18,ITA
f0021247,14,554,6.2,5,2,9,5,14,2,12,10.1,6.6,3.5,18,ITA
f058ed1f,2,104,1.2,1,1,1,34,0,1,-1,1.3,1.4,-0.1,18,ITA
f0f7f62f,7,622,6.9,7,6,0,31,11,4,7,11.6,6.7,5.0,18,ITA
f124b4c9,17,1112,12.4,13,5,4,12,8,32,-24,11.6,25.7,-14.0,18,ITA
f1cfc209,36,2995,33.3,35,23,1,0,45,41,4,38.9,41.7,-2.9,18,ITA
f2308b33,2,112,1.2,1,1,1,11,3,0,3,1.4,0.9,0.5,18,ITA
f26e3c59,32,2806,31.2,32,28,0,3,28,32,-4,35.6,34.1,1.5,18,ITA
f2c1300a,19,1208,13.4,13,12,6,15,17,14,3,19.7,14.1,5.6,18,ITA
f45f9427,13,531,5.9,5,2,8,25,12,2,10,9.0,5.4,3.7,18,ITA
f54dfca8,8,558,6.2,6,4,2,28,5,10,-5,5.6,11.5,-5.9,18,ITA
f554e29b,29,2536,28.2,29,27,0,5,21,47,-26,27.8,42.0,-14.2,18,ITA
f5e9a8bd,16,1375,15.3,16,13,0,5,11,34,-23,15.5,30.7,-15.2,18,ITA
f68b64fc,24,1625,18.1,18,14,6,3,20,25,-5,17.6,23.5,-5.9,18,ITA
f6a06749,1,28,0.3,0,0,1,33,0,1,-1,1.2,0.3,0.9,18,ITA
f6f6b6e8,4,360,4.0,4,4,0,9,4,8,-4,5.5,6.0,-0.5,18,ITA
f7223718,11,592,6.6,4,4,7,21,24,8,16,16.2,5.3,10.9,18,ITA
f7c9fcd6,22,1582,17.6,19,14,3,15,8,37,-29,13.4,34.0,-20.6,18,ITA
f91e81c9,30,2531,28.1,28,27,2,3,36,43,-7,33.9,36.7,-2.8,18,ITA
f9714604,21,1271,14.1,15,11,6,15,12,28,-16,12.6,27.4,-14.8,18,ITA
fa449bba,9,171,1.9,1,0,8,28,2,2,0,1.6,2.5,-0.9,18,ITA
fac896b0,3,54,0.6,1,0,2,7,0,2,-2,0.1,1.0,-0.9,18,ITA
fb2c533b,16,777,8.6,9,4,7,21,12,12,0,12.8,10.8,2.0,18,ITA
fb77bfef,6,408,4.5,4,3,2,20,13,6,7,6.3,7.7,-1.4,18,ITA
fba81826,29,2204,24.5,24,17,5,2,31,40,-9,28.1,33.9,-5.8,18,ITA
fe48a073,9,260,2.9,1,0,8,6,5,3,2,5.6,4.2,1.4,18,ITA
fed5f993,32,2775,30.8,32,29,0,1,38,50,-12,33.5,39.2,-5.7,18,ITA
ff120e44,2,39,0.4,0,0,2,6,0,0,0,0.6,0.2,0.3,18,ITA
ff219f73,6,277,3.1,2,1,4,24,1,6,-5,1.3,6.6,-5.3,18,ITA
ff800ed8,24,2025,22.5,22,22,2,6,17,37,-20,27.8,29.7,-1.9,18,ITA
00242715,35,3105,34.5,34,34,1,2,33,69,-36,37.5,66.4,-29.0,18,FRA
0049d544,20,644,7.2,5,0,15,10,7,7,0,10.5,6.6,3.8,18,FRA
0515a4cb,37,3320,36.9,37,36,0,1,47,55,-8,45.0,46.2,-1.2,18,FRA
06f33dc8,26,1747,19.5,21,7,5,2,20,27,-7,22.700000000000003,22.4,0.30000000000000004,18,FRA
06f46837,13,437,4.9,5,0,8,1,2,9,-7,3.0,4.6,-1.6,18,FRA
070a3904,3,209,2.3,3,1,0,0,7,1,6,3.6,1.5,2.1,18,FRA
07296190,14,888,9.9,12,3,2,2,6,19,-13,8.7,11.5,-2.8,18,FRA
083525e5,30,2699,30.0,30,29,0,0,45,48,-3,33.7,46.8,-13.1,18,FRA
086d7db3,32,2777,30.9,31,30,1,1,22,45,-23,34.5,39.3,-4.8,18,FRA
0984c5d5,20,1488,16.6,18,14,2,11,13,19,-6,15.8,18.2,-2.4,18,FRA
0b4d8274,29,1846,20.5,22,8,7,0,34,18,16,34.6,27.6,7.0,18,FRA
0d2158d5,27,1883,20.9,21,12,6,6,25,46,-21,21.8,38.4,-16.6,18,FRA
0d57f1c1,3,42,0.5,0,0,3,7,2,3,-1,2.1,1.0,1.1,18,FRA
0e12089d,1,90,1.0,1,1,0,37,0,3,-3,1.3,1.9,-0.6,18,FRA
0e96a5e1,2,69,0.8,1,0,1,1,1,2,-1,0.4,2.1,-1.7,18,FRA
0eb03d5b,16,1440,16.0,16,16,0,2,21,24,-3,21.1,18.5,2.6,18,FRA
0eeafda5,31,2511,27.9,28,25,3,2,61,38,23,59.5,31.1,28.4,18,FRA
0f52f925,33,2657,29.5,30,25,3,1,26,26,0,32.5,28.1,4.4,18,FRA
0fe7f7bc,33,2193,24.4,27,10,6,0,25,23,2,30.0,25.2,4.8,18,FRA
1040e783,24,1808,20.1,22,15,2,10,14,25,-11,24.8,22.2,2.5,18,FRA
1061c207,2,180,2.0,2,2,0,27,0,3,-3,1.2,2.8,-1.6,18,FRA
10650926,11,712,7.9,8,6,3,8,6,17,-11,8.3,13.2,-4.9,18,FRA
10efd0e1,31,2615,29.1,30,21,1,1,47,40,7,41.1,35.8,5.3,18,FRA
11ced928,27,1513,16.8,17,8,10,2,19,24,-5,20.9,23.1,-2.2,18,FRA
1232e1dc,36,2919,32.4,32,30,4,2,45,36,9,43.2,42.8,0.4,18,FRA
1251f42e,12,712,7.9,8,2,4,4,12,15,-3,9.5,17.5,-8.0,18,FRA
13203c45,22,1880,20.9,22,15,0,0,22,15,7,22.9,19.8,3.0,18,FRA
13c44fc5,22,1920,21.3,22,19,0,3,47,28,19,35.6,27.9,7.8,18,FRA
1467af0d,22,1718,19.1,20,12,2,1,55,11,44,40.9,14.0,26.9,18,FRA
148e136f,29,2323,25.8,25,22,4,1,33,30,3,37.199999999999996,40.699999999999996,-3.3999999999999995,18,FRA
15285503,1,39,0.4,0,0,1,17,1,2,-1,0.1,1.8,-1.7,18,FRA
1598599e,14,965,10.7,11,6,3,14,10,21,-11,12.8,17.1,-4.3,18,FRA
15a21c79,3,108,1.2,1,1,2,7,3,1,2,1.5,2.1,-0.5,18,FRA
15e1afd5,15,1048,11.6,12,10,3,4,10,23,-13,13.6,15.7,-2.2,18,FRA
166a981d,7,617,6.9,7,6,0,5,6,8,-2,7.0,7.9,-0.9,18,FRA
16714a62,34,2921,32.5,32,32,2,2,32,37,-5,26.4,49.2,-22.8,18,FRA
167d5018,23,1524,16.9,16,16,7,13,21,33,-12,21.3,26.5,-5.1,18,FRA
176674ab,30,1595,17.7,17,10,13,5,21,23,-2,21.0,25.9,-4.8999999999999995,18,FRA
17f29fb0,26,941,10.5,10,5,16,8,8,26,-18,10.5,21.1,-10.6,18,FRA
19cda00b,30,2111,23.5,26,10,4,3,59,17,42,51.8,20.5,31.3,18,FRA
1a4b9094,29,1789,19.9,18,15,11,6,43,20,23,45.4,18.9,26.5,18,FRA
1a6f2a66,3,189,2.1,2,1,1,3,8,2,6,4.3,2.2,2.1,18,FRA
1a992676,30,1704,18.9,19,6,11,3,62,18,44,49.1,19.7,29.4,18,FRA
1ac3b888,33,2164,24.0,25,13,8,1,19,34,-15,24.1,33.5,-9.3,18,FRA
1ad8cb67,24,2115,23.5,24,23,0,2,23,43,-20,26.5,34.8,-8.2,18,FRA
1b82f8df,37,3283,36.5,37,34,0,0,51,47,4,49.3,42.5,6.8,18,FRA
1bc6135b,2,129,1.4,2,0,0,2,0,1,-1,1.3,2.0,-0.6,18,FRA
1c344204,32,2829,31.4,31,29,1,2,45,63,-18,35.6,50.7,-15.1,18,FRA
1d0900d4,35,3103,34.5,35,34,0,0,24,48,-24,38.9,43.3,-4.5,18,FRA
1d2d5cc8,31,2704,30.0,31,29,0,0,65,37,28,63.1,33.3,29.7,18,FRA
1e23a224,5,321,3.6,4,2,1,1,3,11,-8,4.1,5.7,-1.6,18,FRA
1ec4e202,26,1369,15.2,16,1,10,1,15,26,-11,18.3,20.3,-2.0,18,FRA
1ec7e1c5,32,2836,31.5,32,30,0,0,23,45,-22,36.1,38.9,-2.8,18,FRA
1f713024,28,2462,27.4,27,26,1,5,32,50,-18,33.2,47.1,-13.9,18,FRA
1f8c7aa9,37,3161,35.1,36,30,1,0,25,46,-21,41.4,43.2,-1.8,18,FRA
1f9a3a04,3,257,2.9,3,2,0,8,4,4,0,3.6,3.8,-0.2,18,FRA
20094685,24,1378,15.3,14,10,10,11,31,16,15,30.5,14.4,16.2,18,FRA
20573d10,2,128,1.4,1,1,1,6,3,2,1,4.1,2.3,1.8,18,FRA
20c2c0e8,11,616,6.8,7,4,4,22,8,7,1,5.9,8.1,-2.2,18,FRA
20e73fac,37,3102,34.5,35,30,2,0,46,41,5,45.9,45.8,0.1,18,FRA
2174bc8d,30,2177,24.2,27,16,3,5,19,41,-22,22.7,36.0,-13.3,18,FRA
2235f850,3,144,1.6,2,1,1,9,0,6,-6,0.6,2.7,-2.1,18,FRA
22721b88,27,2193,24.4,24,22,3,2,49,31,18,46.9,25.5,21.4,18,FRA
22a62523,3,76,0.8,1,0,2,7,1,1,0,0.6,1.5,-0.9,18,FRA
22bfb57e,5,246,2.7,2,1,3,15,0,1,-1,1.2,2.7,-1.5,18,FRA
22c77851,3,32,0.4,0,0,3,1,0,0,0,0.6,0.5,0.1,18,FRA
23b6ab66,1,90,1.0,1,1,0,4,0,3,-3,0.8,1.9,-1.2,18,FRA
23c63b7f,6,69,0.8,0,0,6,3,1,0,1,1.8,0.9,0.9,18,FRA
2434f24a,36,3240,36.0,36,36,0,1,53,45,8,49.8,40.8,9.0,18,FRA
243f4a0b,21,1484,16.5,19,9,2,11,20,22,-2,20.0,19.6,0.4,18,FRA
247accfd,32,2778,30.9,31,29,1,3,32,33,-1,29.0,43.3,-14.3,18,FRA
24eb7ed6,28,1543,17.1,16,8,12,7,16,13,3,17.3,19.4,-2.1,18,FRA
2515040a,8,566,6.3,6,5,2,5,3,5,-2,7.9,7.2,0.7,18,FRA
25444898,15,1127,12.5,13,8,2,0,19,21,-2,15.7,21.3,-5.5,18,FRA
26383ea5,3,270,3.0,3,3,0,31,4,5,-1,4.4,4.7,-0.3,18,FRA
26777636,1,8,0.1,0,0,1,0,0,0,0,0.0,0.0,0.0,18,FRA
2677a1de,24,1918,21.3,23,13,1,1,27,21,6,28.1,25.0,3.0,18,FRA
268c3cfc,3,64,0.7,1,0,2,15,0,2,-2,0.3,1.6,-1.3,18,FRA
26975a92,19,1652,18.4,19,18,0,0,21,22,-1,24.8,20.2,4.6,18,FRA
275e2c51,28,2470,27.4,28,26,0,8,30,44,-14,33.2,35.4,-2.1,18,FRA
276cce2e,21,1721,19.1,19,16,2,10,25,23,2,19.1,23.6,-4.5,18,FRA
28a65a2c,4,305,3.4,3,3,1,32,3,6,-3,3.7,6.8,-3.1,18,FRA
29d8ad3f,15,1291,14.3,15,14,0,0,28,13,15,22.1,15.3,6.8,18,FRA
2b16cb1a,31,2262,25.2,26,6,5,2,43,33,10,37.6,31.400000000000002,6.2,18,FRA
2b622f01,5,76,0.8,0,0,5,6,3,1,2,2.7,0.4,2.3,18,FRA
2b9fdeea,35,2950,32.8,35,19,0,0,72,41,31,64.9,34.7,30.2,18,FRA
2bae5658,28,2009,22.3,23,11,5,0,23,41,-18,24.1,39.4,-15.3,18,FRA
2e0367a6,31,2290,25.4,26,14,5,1,35,46,-11,29.3,44.5,-15.2,18,FRA
2e52206e,24,1407,15.6,14,10,10,5,20,32,-12,16.8,28.0,-11.2,18,FRA
2f798b41,8,499,5.5,6,4,2,18,10,4,6,12.0,4.2,7.8,18,FRA
2f8f43f3,20,1109,12.3,11,8,9,9,10,22,-12,15.7,15.4,0.3,18,FRA
2f965a72,34,3060,34.0,34,34,0,3,101,25,76,79.5,29.8,49.7,18,FRA
2fa2a875,38,3420,38.0,38,38,0,0,36,33,3,42.6,39.0,3.6,18,FRA
3010aefb,29,1587,17.6,17,5,12,3,17,32,-15,16.3,25.8,-9.5,18,FRA
30395d3b,29,1648,18.3,18,4,11,6,28,26,2,22.9,24.4,-1.5,18,FRA
3067cbef,12,944,10.5,10,9,2,11,12,20,-8,10.3,15.2,-4.9,18,FRA
3071a619,35,2834,31.5,33,20,2,0,29,58,-29,33.1,58.9,-25.9,18,FRA
31377e38,4,193,2.1,2,0,2,1,4,6,-2,2.1,2.7,-0.6,18,FRA
31bbb7e2,25,1656,18.4,17,15,8,7,13,38,-25,18.1,33.1,-15.0,18,FRA
321a71a7,29,2534,28.2,29,27,0,2,43,40,3,38.9,37.9,1.0,18,FRA
3250c6cd,5,271,3.0,4,0,1,4,2,3,-1,3.0,3.0,0.0,18,FRA
346c15cc,3,105,1.2,1,0,2,2,0,3,-3,1.2,2.0,-0.7,18,FRA
34cfec6b,12,610,6.8,7,4,5,13,7,7,0,5.0,6.8,-1.8,18,FRA
35c5f9b1,16,985,10.9,11,5,5,4,10,5,5,12.0,9.5,2.5,18,FRA
3681cfff,34,2957,32.9,34,32,0,0,29,52,-23,33.0,45.5,-12.5,18,FRA
375622c5,24,638,7.1,4,2,20,11,19,10,9,13.4,6.9,6.5,18,FRA
3767b3b7,35,3146,35.0,35,34,0,1,36,62,-26,34.1,52.9,-18.8,18,FRA
378825c7,29,2342,26.0,26,22,3,2,33,33,0,35.0,35.8,-0.8,18,FRA
3814120d,19,1691,18.8,19,18,0,14,20,32,-12,20.2,27.9,-7.8,18,FRA
392d98fc,37,1867,20.7,18,4,19,1,16,17,-1,16.2,28.9,-12.7,18,FRA
3acddfdd,10,426,4.7,5,0,5,9,7,4,3,7.1,3.8,3.3,18,FRA
3befc2b6,25,1520,16.9,18,10,7,5,17,14,3,18.4,14.4,4.0,18,FRA
3cefcaef,27,2122,23.6,24,21,3,5,48,33,15,39.3,24.6,14.7,18,FRA
3dd738a1,31,2459,27.3,27,25,4,3,30,20,10,32.2,25.4,6.8,18,FRA
3e016e5a,11,357,4.0,3,1,8,8,7,5,2,5.4,4.9,0.5,18,FRA
3e092724,16,951,10.6,10,10,6,0,21,16,5,13.5,15.1,-1.5,18,FRA
3e87d087,1,34,0.4,0,0,1,3,0,0,0,0.4,0.1,0.3,18,FRA
3eaf8817,14,1184,13.2,14,8,0,0,17,29,-12,14.7,20.8,-6.2,18,FRA
3f5b4635,32,2635,29.3,29,28,3,5,26,26,0,32.0,31.4,0.6,18,FRA
3f944dad,1,16,0.2,0,0,1,0,0,0,0,0.2,0.1,0.0,18,FRA
41e7ef1c,20,1704,18.9,19,16,1,10,48,14,34,39.1,17.5,21.6,18,FRA
42eaa028,18,998,11.1,12,4,6,6,11,10,1,10.5,11.4,-0.8,18,FRA
42fd9c7f,28,2168,24.1,25,19,3,4,63,22,41,53.5,23.8,29.7,18,FRA
4315f30d,21,1322,14.7,13,11,8,11,19,18,1,17.7,19.1,-1.3,18,FRA
43e7a164,28,2520,28.0,28,28,0,0,20,33,-13,30.4,31.7,-1.4,18,FRA
446aa6e1,20,1715,19.1,18,17,2,16,10,27,-17,17.1,26.9,-9.8,18,FRA
44f8c299,26,1943,21.6,24,13,2,3,25,37,-12,24.9,25.6,-0.7,18,FRA
45076ff8,13,466,5.2,4,1,9,8,6,2,4,8.0,4.4,3.6,18,FRA
450e277f,24,1966,21.8,22,20,2,10,24,26,-2,26.5,25.8,0.7,18,FRA
45e17712,16,1239,13.8,13,12,3,2,12,24,-12,12.6,19.5,-6.9,18,FRA
4657faba,3,89,1.0,1,0,2,0,1,0,1,2.0,0.7,1.3,18,FRA
468fdbad,36,3025,33.6,36,17,0,0,32,60,-28,38.3,53.0,-14.7,18,FRA
46d50339,15,1174,13.0,13,12,2,2,17,20,-3,17.7,17.7,0.0,18,FRA
46faabfa,30,849,9.4,6,2,24,3,9,23,-14,9.6,17.4,-7.8,18,FRA
4749367a,5,253,2.8,3,2,2,0,4,7,-3,4.5,4.1,0.5,18,FRA
47c2e669,3,142,1.6,1,1,2,4,2,5,-3,1.6,4.5,-2.8,18,FRA
4887118d,3,31,0.3,0,0,3,2,2,0,2,0.6,0.1,0.4,18,FRA
48b28bfd,35,3006,33.4,35,30,0,0,41,58,-17,41.1,52.3,-11.3,18,FRA
4914ed4a,25,2077,23.1,23,19,2,1,29,25,4,33.8,30.2,3.5,18,FRA
4a57580c,30,1763,19.6,21,7,9,1,28,28,0,27.9,27.0,0.9,18,FRA
4b96c347,29,1529,17.0,16,3,13,0,19,28,-9,21.7,21.5,0.2,18,FRA
4be0b467,16,931,10.3,11,3,5,2,10,18,-8,11.8,16.9,-5.1,18,FRA
4bf69118,1,90,1.0,1,1,0,8,2,1,1,0.5,1.5,-1.0,18,FRA
4c5b714f,27,2153,23.9,25,19,2,2,60,30,30,42.2,28.0,14.2,18,FRA
4c700f46,28,2315,25.7,25,24,3,1,34,27,7,35.2,29.3,5.8,18,FRA
4d1666ff,18,1589,17.7,17,17,1,2,31,19,12,25.3,19.9,5.4,18,FRA
4d3e9033,4,360,4.0,4,4,0,34,9,6,3,5.7,4.9,0.8,18,FRA
4db2157a,26,2058,22.9,23,18,3,6,33,27,6,33.6,33.8,-0.2,18,FRA
4dbd0916,30,2378,26.4,27,19,3,0,59,32,27,46.8,32.2,14.6,18,FRA
4df04a86,1,1,0.0,0,0,1,4,0,0,0,0.0,0.0,0.0,18,FRA
4e0afc5d,29,2415,26.8,27,25,2,2,41,37,4,37.8,34.1,3.6,18,FRA
4e7bfc23,21,860,9.6,9,1,12,8,15,22,-7,11.4,15.5,-4.2,18,FRA
4e7d66f8,38,3298,36.6,38,34,0,0,31,71,-40,38.3,67.4,-29.0,18,FRA
4e7db402,38,3420,38.0,38,38,0,0,38,54,-16,45.5,52.1,-6.6,18,FRA
4f093689,6,114,1.3,0,0,6,6,3,3,0,2.5,1.9,0.6,18,FRA
5046b7d4,26,1662,18.5,19,8,7,5,21,28,-7,22.4,27.6,-5.2,18,FRA
509a4ccb,23,1473,16.4,19,3,4,2,36,20,16,22.1,22.5,-0.5,18,FRA
5148dcc5,25,1672,18.6,19,12,6,0,23,34,-11,23.3,31.2,-7.9,18,FRA
516dc25b,22,1044,11.6,11,5,11,11,13,12,1,16.7,15.6,1.1,18,FRA
51a3caf1,4,349,3.9,4,3,0,4,6,3,3,5.9,4.9,1.0,18,FRA
51c30111,19,1565,17.4,18,14,1,2,25,16,9,25.7,19.1,6.6,18,FRA
51fa3fed,2,48,0.5,0,0,2,3,0,0,0,0.4,0.1,0.3,18,FRA
527f063d,32,2581,28.7,30,20,2,0,93,21,72,66.4,24.0,42.5,18,FRA
53283127,23,808,9.0,7,4,16,13,12,18,-6,10.9,12.0,-1.1,18,FRA
535b0343,15,611,6.8,4,2,11,15,7,16,-9,8.0,11.3,-3.3,18,FRA
54131505,4,162,1.8,1,1,3,7,0,4,-4,0.9,3.8,-2.9,18,FRA
542cc80f,37,3062,34.0,34,30,3,0,32,31,1,37.3,35.6,1.7,18,FRA
563fcd6b,3,82,0.9,1,0,2,0,1,1,0,0.8,2.0,-1.2,18,FRA
5693aa98,1,7,0.1,0,0,1,6,0,0,0,0.0,0.1,0.0,18,FRA
56b52c4e,5,96,1.1,0,0,5,4,1,0,1,0.5,1.7,-1.2,18,FRA
56f7a928,27,1569,17.4,18,11,9,5,37,17,20,26.8,21.7,5.0,18,FRA
574aa9ec,2,155,1.7,1,1,1,5,0,2,-2,1.2,2.6,-1.4,18,FRA
57c433c8,13,778,8.6,7,3,6,0,10,6,4,11.8,11.4,0.4,18,FRA
57e3f0c7,36,2841,31.6,31,23,5,2,33,50,-17,30.4,42.5,-12.1,18,FRA
57ef0d97,19,1154,12.8,14,4,5,2,27,8,19,24.7,10.6,14.2,18,FRA
58ae47b2,31,2347,26.1,28,15,3,0,57,34,23,55.8,26.9,28.9,18,FRA
5984e9f9,11,775,8.6,8,7,3,8,7,12,-5,10.7,13.6,-2.9,18,FRA
5aca2a18,1,15,0.2,0,0,1,0,0,2,-2,0.1,0.9,-0.9,18,FRA
5b1bf5e3,36,3083,34.3,36,27,0,0,36,35,1,28.9,47.1,-18.2,18,FRA
5c4dc0ff,34,2507,27.9,30,16,4,0,62,27,35,44.0,28.9,15.1,18,FRA
5cdddffa,35,2588,28.700000000000003,31,14,4,1,64,32,32,47.6,29.3,18.3,18,FRA
5ceba7fc,37,3040,33.8,33,29,4,0,38,47,-9,44.2,41.0,3.3,18,FRA
5cec2c74,20,1431,15.9,16,13,4,1,28,17,11,24.7,15.200000000000001,9.7,18,FRA
5d42d487,12,448,5.0,6,0,6,1,8,7,1,5.1,8.6,-3.5,18,FRA
5d59e0df,36,3031,33.7,34,29,2,0,33,35,-2,38.9,31.7,7.2,18,FRA
5d66c10d,4,275,3.1,3,2,1,3,1,7,-6,2.0,6.3,-4.3,18,FRA
5d8d7454,36,3240,36.0,36,36,0,0,23,49,-26,39.2,45.7,-6.6,18,FRA
5e22e2a4,31,2591,28.8,30,22,1,2,28,43,-15,33.2,35.0,-1.8,18,FRA
5e6342d4,24,1570,17.4,18,13,6,1,15,27,-12,17.4,20.0,-2.6,18,FRA
6043997c,3,270,3.0,3,3,0,3,3,4,-1,3.2,6.2,-3.0,18,FRA
60d90c55,4,316,3.5,3,3,1,33,3,4,-1,3.9,4.6,-0.7,18,FRA
61590953,1,26,0.3,0,0,1,4,1,1,0,0.6,0.9,-0.3,18,FRA
6191093d,31,1793,19.9,17,13,14,3,26,32,-6,23.4,28.3,-4.9,18,FRA
61d618fa,16,342,3.8,2,0,14,9,6,8,-2,5.5,7.9,-2.4,18,FRA
639b42f5,6,189,2.1,2,0,4,6,2,6,-4,2.2,4.1,-1.9,18,FRA
6421dd73,30,2509,27.9,30,22,0,0,23,54,-31,31.5,50.2,-18.7,18,FRA
64ba07c0,16,1170,13.0,13,10,3,9,13,22,-9,15.3,20.6,-5.3,18,FRA
65585e3a,22,850,9.4,10,1,12,10,17,13,4,12.4,12.6,-0.2,18,FRA
6605d143,1,15,0.2,0,0,1,0,0,1,-1,0.0,0.5,-0.5,18,FRA
66116290,26,2129,23.7,25,13,1,2,51,31,20,37.4,30.1,7.3,18,FRA
6690ef25,34,2855,31.7,32,29,2,0,27,28,-1,33.7,30.7,3.0,18,FRA
677ee102,20,1518,16.9,18,13,2,12,14,21,-7,19.2,22.6,-3.4,18,FRA
67ac5bb8,1,84,0.9,0,0,1,4,0,1,-1,0.0,1.9,-1.8,18,FRA
67d251a2,5,313,3.5,3,2,2,6,1,11,-10,3.4,6.1,-2.7,18,FRA
6853490f,35,2856,31.7,32,18,3,0,48,38,10,43.4,33.1,10.3,18,FRA
689c9cf4,21,1422,15.8,16,13,5,3,16,24,-8,16.8,21.3,-4.6,18,FRA
68a87d66,25,966,10.8,11,4,14,4,10,18,-8,10.6,18.9,-8.3,18,FRA
69384e5d,20,1786,19.8,20,18,0,0,68,16,52,51.6,15.0,36.6,18,FRA
6aeb647a,13,1056,11.7,12,9,1,8,15,23,-8,12.3,22.6,-10.2,18,FRA
6afaebf2,4,64,0.7,0,0,4,3,1,2,-1,0.7,1.7,-0.9,18,FRA
6b200d45,28,2464,27.4,28,26,0,0,39,32,7,39.5,36.4,3.1,18,FRA
6b994195,25,2165,24.1,24,24,1,8,27,34,-7,29.9,36.3,-6.4,18,FRA
6b9f2f3e,7,437,4.9,4,3,3,12,6,7,-1,7.1,7.2,-0.1,18,FRA
6ba71da5,25,2092,23.2,24,23,1,12,25,39,-14,26.2,29.9,-3.7,18,FRA
6bb2c084,37,2439,27.1,26,20,11,1,55,33,22,55.0,30.4,24.6,18,FRA
6bca20fe,4,167,1.9,1,1,3,0,4,2,2,3.0,2.6,0.4,18,FRA
6c203af0,24,1561,17.3,15,12,9,6,15,36,-21,18.8,29.6,-10.8,18,FRA
6c6ecdd4,26,1384,15.4,16,10,10,6,21,20,1,18.9,15.3,3.6,18,FRA
6ca88b2a,21,1699,18.9,20,15,1,5,24,25,-1,21.0,24.5,-3.5,18,FRA
6dfd8f05,1,1,0.0,0,0,1,5,0,0,0,0.0,0.0,0.0,18,FRA
6e5b5a45,10,622,6.9,8,6,2,2,9,11,-2,7.5,12.0,-4.5,18,FRA
6e7f1353,33,2165,24.1,25,9,8,3,43,31,12,42.1,28.3,13.7,18,FRA
6f5ead86,14,544,6.0,5,2,9,9,5,15,-10,7.7,8.1,-0.4,18,FRA
6f8cd6d0,32,1929,21.4,20,13,12,3,30,38,-8,30.9,27.4,3.5,18,FRA
6fb7edd3,9,401,4.5,3,1,6,4,3,4,-1,3.6,6.6,-3.0,18,FRA
6fbde63a,31,2288,25.4,30,7,1,3,27,44,-17,26.5,35.7,-9.2,18,FRA
706a60e1,13,331,3.7,2,0,11,9,7,3,4,5.7,3.5,2.3,18,FRA
70d8e84c,22,1512,16.8,16,14,6,7,14,18,-4,17.4,18.2,-0.9,18,FRA
71ec39ef,37,3132,34.8,37,29,0,0,82,38,44,59.1,36.1,23.1,18,FRA
730bd100,6,207,2.3,2,0,4,4,2,2,0,2.2,2.9,-0.7,18,FRA
743fd71f,4,108,1.2,1,0,3,5,0,3,-3,0.5,3.0,-2.5,18,FRA
75a63397,17,1022,11.4,11,7,6,7,2,22,-20,13.1,19.6,-6.5,18,FRA
75d97aa6,23,1706,19.0,20,15,3,0,17,34,-17,18.8,27.4,-8.6,18,FRA
76806215,10,738,8.2,7,7,3,28,15,10,5,15.1,8.5,6.6,18,FRA
770d7eb8,31,2723,30.3,30,28,1,0,37,53,-16,35.2,47.5,-12.3,18,FRA
775185ae,1,1,0.0,0,0,1,4,0,0,0,0.0,0.0,0.0,18,FRA
7768df30,29,2610,29.0,29,29,0,6,40,41,-1,35.8,36.1,-0.3,18,FRA
776972d5,11,307,3.4,2,0,9,10,3,2,1,3.9,4.7,-0.8,18,FRA
779847d6,28,2431,27.0,28,24,0,3,24,33,-9,27.3,29.4,-2.1,18,FRA
77d7c96f,22,1608,17.9,16,16,6,13,34,22,12,25.5,23.3,2.2,18,FRA
77f278a0,22,874,9.7,9,2,13,15,26,9,17,25.0,8.7,16.2,18,FRA
7844c810,4,30,0.3,0,0,4,9,1,0,1,1.0,0.3,0.6,18,FRA
79584585,10,606,6.7,8,3,2,2,17,3,14,13.7,5.8,7.9,18,FRA
7961f7aa,34,2137,23.7,26,12,8,1,36,49,-13,24.3,42.7,-18.4,18,FRA
79685569,12,583,6.5,5,3,7,11,3,8,-5,6.1,8.9,-2.8,18,FRA
796b1c41,32,1956,21.7,21,7,11,2,17,32,-15,21.0,27.4,-6.5,18,FRA
79b2399c,28,1884,20.9,23,7,5,0,24,27,-3,27.7,22.6,5.0,18,FRA
7a137df4,1,7,0.1,0,0,1,6,0,0,0,0.0,0.0,0.0,18,FRA
7abfcbff,19,876,9.7,10,1,9,3,7,12,-5,11.1,13.8,-2.7,18,FRA
7add56e1,3,171,1.9,2,0,1,7,3,1,2,2.3,1.1,1.1,18,FRA
7adea561,21,1890,21.0,21,21,0,0,23,31,-8,25.0,24.6,0.4,18,FRA
7af0e1f8,26,2064,22.9,24,20,2,6,23,43,-20,25.8,42.2,-16.4,18,FRA
7b075c75,14,1192,13.2,14,11,0,3,15,26,-11,11.7,20.4,-8.7,18,FRA
7b536033,1,1,0.0,0,0,1,1,0,0,0,0.0,0.0,0.0,18,FRA
7c2965bb,38,2531,28.1,32,6,6,0,67,32,35,49.2,34.5,14.7,18,FRA
7c56da38,20,631,7.0,6,2,14,14,20,7,13,18.6,7.4,11.2,18,FRA
7c6d6c96,32,2746,30.5,32,27,0,2,27,35,-8,25.6,45.2,-19.6,18,FRA
7cab69b5,33,2855,31.7,33,31,0,0,71,38,33,52.9,41.7,11.2,18,FRA
7cb9de24,1,11,0.1,0,0,1,0,0,1,-1,0.1,0.2,-0.1,18,FRA
7cdda3bf,20,957,10.6,10,3,10,7,15,9,6,13.8,10.7,3.1,18,FRA
7cf431a5,32,1818,20.2,19,13,13,3,30,22,8,26.3,26.3,0.0,18,FRA
7cf9f0ed,17,542,6.0,4,0,13,15,4,10,-6,6.7,9.9,-3.2,18,FRA
7d45b97a,11,919,10.2,10,10,1,14,10,21,-11,9.2,16.0,-6.8,18,FRA
7d9b37bf,33,1688,18.8,18,6,15,3,20,31,-11,21.7,26.2,-4.5,18,FRA
7de29631,1,27,0.3,0,0,1,6,0,0,0,0.5,0.4,0.0,18,FRA
7e82a78f,22,1412,15.7,16,8,6,5,19,32,-13,17.4,29.8,-12.4,18,FRA
7f3b388c,34,3060,34.0,34,34,0,0,77,38,39,56.0,43.3,12.7,18,FRA
7f622eef,25,1344,14.9,17,6,8,12,15,20,-5,15.1,18.4,-3.3,18,FRA
7f9111ea,21,1577,17.5,16,15,5,11,19,28,-9,20.6,25.0,-4.4,18,FRA
7fb301af,4,280,3.1,3,3,1,2,6,1,5,5.9,3.2,2.7,18,FRA
7fecbcdb,18,1533,17.0,17,16,1,9,15,25,-10,21.3,22.0,-0.7,18,FRA
7ffaf233,26,1195,13.3,13,3,13,3,11,23,-12,13.1,17.1,-3.9,18,FRA
813aae2f,16,576,6.4,4,0,12,1,10,13,-3,7.3,9.9,-2.6,18,FRA
81aeb1dd,13,511,5.7,5,0,8,0,5,5,0,6.2,8.1,-1.9,18,FRA
81d3318f,35,2014,22.4,23,5,12,2,32,32,0,32.2,26.6,5.6,18,FRA
81d9a76b,3,23,0.3,0,0,3,18,0,1,-1,0.1,1.1,-1.0,18,FRA
821233cc,16,1440,16.0,16,16,0,0,27,13,14,24.9,21.1,3.8,18,FRA
82671804,34,3019,33.5,34,30,0,0,72,37,35,68.9,32.7,36.2,18,FRA
833a91a1,9,651,7.2,8,3,1,17,6,5,1,9.4,7.4,2.0,18,FRA
8417953b,3,256,2.8,2,2,1,14,8,4,4,3.3,4.8,-1.5,18,FRA
84549a07,26,870,9.7,10,1,16,9,11,12,-1,11.1,10.1,1.1,18,FRA
84d94b91,34,2948,32.8,34,26,0,0,31,38,-7,29.4,48.5,-19.1,18,FRA
85322440,10,680,7.6,8,5,2,3,2,12,-10,7.6,14.5,-6.9,18,FRA
857e2586,7,128,1.4,0,0,7,2,0,6,-6,1.2,3.8,-2.6,18,FRA
85a44ecc,20,838,9.3,8,2,12,11,12,16,-4,11.3,11.9,-0.6,18,FRA
8614496d,3,232,2.6,3,1,0,10,4,7,-3,3.1,5.5,-2.4,18,FRA
86a2ba20,6,201,2.2,1,1,5,3,3,8,-5,3.2,6.5,-3.3,18,FRA
86e7deaf,25,2115,23.5,24,22,1,7,76,16,60,54.9,18.8,36.1,18,FRA
871fc5f8,5,73,0.8,0,0,5,6,1,1,0,1.1,0.9,0.2,18,FRA
872cd68c,23,2070,23.0,23,23,0,2,25,26,-1,29.1,25.7,3.3,18,FRA
8730ed6a,3,47,0.5,0,0,3,5,0,3,-3,0.8,3.0,-2.1,18,FRA
873ce3a2,1,10,0.1,0,0,1,7,1,0,1,0.4,0.1,0.3,18,FRA
8746d5d0,13,897,10.0,10,9,3,18,11,11,0,10.4,12.9,-2.5,18,FRA
8794e251,33,2362,26.2,27,17,6,1,69,19,50,55.5,23.4,32.1,18,FRA
8802c1d5,26,1429,15.9,16,4,10,4,23,28,-5,14.9,23.3,-8.3,18,FRA
881ef58c,25,1347,15.0,14,6,11,3,41,12,29,30.6,13.5,17.2,18,FRA
883f251e,18,779,8.7,8,2,10,2,10,8,2,7.9,11.8,-4.0,18,FRA
88615858,31,1615,17.9,19,7,12,2,13,27,-14,17.5,23.4,-5.9,18,FRA
88fdac8b,7,489,5.4,6,4,1,15,2,12,-10,4.4,10.7,-6.3,18,FRA
8a2248b4,28,2520,28.0,28,28,0,10,40,36,4,33.7,38.0,-4.3,18,FRA
8b298f56,16,1213,13.5,14,10,2,2,23,26,-3,19.6,20.7,-1.0999999999999999,18,FRA
8ba3a754,9,316,3.5,3,1,6,8,3,7,-4,4.0,4.2,-0.2,18,FRA
8c2c48a9,7,227,2.5,2,1,5,8,3,4,-1,4.5,2.9,1.5,18,FRA
8cb8dc58,11,883,9.8,10,7,1,19,14,20,-6,8.5,16.1,-7.6,18,FRA
8d043f1d,19,633,7.0,5,1,14,1,14,10,4,11.4,8.6,2.8,18,FRA
8da74c05,26,1681,18.7,19,11,7,4,26,19,7,22.0,23.1,-1.1,18,FRA
8dbff17c,33,2955,32.8,33,31,0,0,70,36,34,66.9,32.4,34.5,18,FRA
8e2d5426,11,849,9.4,10,6,1,10,5,21,-16,9.7,15.7,-5.9,18,FRA
8e87af42,18,1148,12.8,13,7,5,6,14,16,-2,14.2,15.1,-0.9,18,FRA
8eec784d,3,122,1.4,1,1,2,5,1,0,1,2.1,1.3,0.8,18,FRA
8f325097,9,578,6.4,7,5,2,15,5,11,-6,6.3,9.6,-3.3,18,FRA
8f696594,36,2555,28.4,28,14,8,1,67,25,42,47.9,27.1,20.8,18,FRA
8f898ba8,15,424,4.7,2,1,13,3,14,6,8,9.7,5.1,4.5,18,FRA
8ff07990,28,2269,25.2,26,14,2,0,39,37,2,35.1,34.7,0.4,18,FRA
8ff4872e,28,2420,26.9,26,25,2,1,38,41,-3,35.2,35.9,-0.7,18,FRA
9001138b,15,1042,11.6,12,6,3,8,18,9,9,16.5,14.0,2.5,18,FRA
909222de,26,1727,19.2,22,4,4,2,23,31,-8,21.2,28.4,-7.2,18,FRA
90fcf472,29,1839,20.4,20,10,9,1,32,43,-11,22.1,33.5,-11.4,18,FRA
91e58f66,34,2463,27.4,28,19,6,1,24,53,-29,21.7,44.2,-22.5,18,FRA
91f2da4c,29,1283,14.3,13,1,16,6,13,13,0,18.2,16.7,1.5,18,FRA
92232aad,15,1314,14.6,15,13,0,0,25,12,13,24.3,18.8,5.5,18,FRA
9260926b,30,2405,26.7,30,22,0,0,29,45,-16,21.8,40.8,-19.0,18,FRA
92b56413,14,1192,13.2,14,11,0,0,15,18,-3,14.2,18.3,-4.2,18,FRA
933d3b51,29,2416,26.8,27,24,2,6,27,30,-3,29.5,24.4,5.1,18,FRA
942c6dc3,2,39,0.4,0,0,2,1,0,2,-2,0.3,0.6,-0.4,18,FRA
9453d2f4,16,458,5.1,3,2,13,11,5,6,-1,8.2,7.5,0.7,18,FRA
950ff24d,10,900,10.0,10,10,0,26,13,16,-3,15.5,11.5,4.0,18,FRA
96908f80,1,90,1.0,1,1,0,36,0,1,-1,0.7,1.4,-0.7,18,FRA
96fcd380,13,1170,13.0,13,13,0,4,16,17,-1,17.1,15.8,1.2,18,FRA
97b87472,1,90,1.0,1,1,0,1,1,6,-5,1.5,3.8,-2.3,18,FRA
97fb4608,19,1428,15.9,16,14,3,8,18,24,-6,21.2,18.5,2.7,18,FRA
9836e892,2,33,0.4,0,0,2,1,2,0,2,0.8,1.0,-0.1,18,FRA
9980269a,8,341,3.8,3,0,5,3,4,2,2,3.3,2.9,0.4,18,FRA
9a1f2e1c,24,1812,20.1,22,14,2,11,53,21,32,37.7,18.8,18.9,18,FRA
9a493fb7,15,807,9.0,10,3,5,5,9,13,-4,13.4,10.8,2.6,18,FRA
9a506145,18,1312,14.6,16,12,2,9,17,15,2,14.0,13.2,0.8,18,FRA
9ae9eaea,18,1295,14.4,14,11,4,14,39,9,30,24.6,15.1,9.5,18,FRA
9b6d9b53,36,2780,30.9,31,27,5,1,43,60,-17,33.6,54.1,-20.5,18,FRA
9b8970ce,3,208,2.3,2,2,1,6,3,2,1,3.2,1.8,1.5,18,FRA
9dafff2a,16,743,8.3,7,4,9,4,6,12,-6,6.9,17.3,-10.3,18,FRA
9dd5da03,4,139,1.5,1,1,3,11,0,3,-3,1.6,3.2,-1.6,18,FRA
9e27e5de,14,1056,11.7,14,5,0,0,10,15,-5,14.0,14.4,-0.4,18,FRA
9f29c204,26,2198,24.4,24,23,2,11,22,28,-6,21.4,35.0,-13.6,18,FRA
9f6325f9,4,360,4.0,4,4,0,10,6,4,2,3.4,5.1,-1.7,18,FRA
9ffdf29a,1,29,0.3,0,0,1,2,0,0,0,0.2,0.6,-0.4,18,FRA
a0791826,7,179,2.0,0,0,7,7,5,5,0,2.2,3.7,-1.4,18,FRA
a08b974a,31,2038,22.6,23,15,8,2,50,22,28,47.2,23.1,24.1,18,FRA
a0f9b535,31,2235,24.8,26,9,5,2,28,29,-1,31.2,30.2,0.9,18,FRA
a1017967,19,1630,18.1,18,18,1,14,17,19,-2,14.1,27.3,-13.2,18,FRA
a1d04509,16,725,8.1,10,1,6,7,5,8,-3,9.6,7.7,1.9,18,FRA
a2da58b1,1,1,0.0,0,0,1,7,0,0,0,0.0,0.0,0.0,18,FRA
a3d524cb,9,810,9.0,9,9,0,12,2,14,-12,10.7,15.1,-4.3,18,FRA
a44d3a3c,3,24,0.3,0,0,3,3,4,0,4,2.0,0.1,1.9,18,FRA
a4527d33,29,2569,28.5,29,28,0,8,31,60,-29,29.5,54.4,-24.9,18,FRA
a4b1028a,30,2637,29.3,30,27,0,1,38,34,4,36.5,38.9,-2.3,18,FRA
a4c3f7af,19,1176,13.1,14,9,5,1,17,25,-8,13.3,20.4,-7.1,18,FRA
a51728e3,10,710,7.9,10,6,0,2,3,14,-11,8.4,16.2,-7.8,18,FRA
a557e6b0,13,1051,11.7,13,10,0,3,7,18,-11,10.5,20.2,-9.7,18,FRA
a56bd2ee,38,3420,38.0,38,38,0,0,48,59,-11,45.5,49.0,-3.5,18,FRA
a5876fca,12,681,7.6,9,4,3,24,12,11,1,13.0,10.6,2.3,18,FRA
a5db0bec,32,2433,27.0,27,18,5,4,62,30,32,48.4,31.2,17.2,18,FRA
a6138e4a,12,534,5.9,5,2,7,11,5,10,-5,5.5,9.0,-3.6,18,FRA
a712ca2b,34,3060,34.0,34,34,0,0,33,50,-17,42.8,47.4,-4.7,18,FRA
a8797cf1,26,2084,23.2,24,17,2,1,23,26,-3,19.0,31.9,-12.9,18,FRA
a87e9eb6,3,25,0.3,0,0,3,5,0,0,0,0.1,0.4,-0.3,18,FRA
a8b4a643,26,1540,17.1,15,12,11,7,13,31,-18,18.9,25.2,-6.3,18,FRA
aa1a8c7e,38,2096,23.3,22,8,16,0,20,22,-2,26.7,22.1,4.6,18,FRA
aad56ca3,7,83,0.9,0,0,7,5,2,1,1,2.1,0.9,1.2,18,FRA
ab914649,14,746,8.3,10,2,4,3,8,16,-8,8.3,17.2,-8.8,18,FRA
abccacf7,1,29,0.3,0,0,1,0,0,0,0,0.5,0.6,-0.2,18,FRA
ac62861c,37,3060,34.0,36,24,1,0,23,48,-25,36.7,44.2,-7.5,18,FRA
ac73ec79,33,2791,31.0,31,29,2,2,29,27,2,36.8,32.5,4.3,18,FRA
ad625c12,5,399,4.4,4,3,1,1,4,8,-4,4.8,7.4,-2.6,18,FRA
adf825b9,2,25,0.3,0,0,2,1,0,0,0,0.1,0.2,-0.1,18,FRA
ae59b359,14,511,5.7,3,3,11,17,6,9,-3,4.7,8.3,-3.6,18,FRA
ae7d0ecd,17,1457,16.2,16,15,1,16,19,29,-10,19.3,25.9,-6.6,18,FRA
ae82fa48,1,90,1.0,1,1,0,0,0,1,-1,0.5,0.9,-0.4,18,FRA
aef6e670,28,2423,26.9,27,25,1,7,78,21,57,66.0,24.2,41.9,18,FRA
af0c835b,7,431,4.8,4,1,3,7,3,4,-1,4.8,7.2,-2.5,18,FRA
b0547a87,33,2220,24.7,25,11,8,2,19,33,-14,26.0,31.0,-5.0,18,FRA
b056e3da,37,3330,37.0,37,37,0,0,36,38,-2,40.5,36.2,4.3,18,FRA
b18a3023,34,2781,30.9,30,28,4,3,31,53,-22,26.1,48.4,-22.3,18,FRA
b2bd0f6c,34,2572,28.6,27,22,7,2,39,34,5,42.9,35.8,7.1,18,FRA
b396a0b1,7,162,1.8,1,0,6,12,1,4,-3,1.9,4.6,-2.7,18,FRA
b4a014b1,28,2291,25.5,27,23,1,0,23,31,-8,27.9,26.5,1.5,18,FRA
b4c816a9,9,175,1.9,1,0,8,5,3,4,-1,2.5,2.4,0.1,18,FRA
b51242ef,14,1135,12.6,14,12,0,6,11,20,-9,12.6,13.7,-1.1,18,FRA
b666421b,32,2855,31.7,32,30,0,3,35,44,-9,40.7,38.7,2.0,18,FRA
b6dac747,22,1032,11.5,9,6,13,12,12,13,-1,11.4,15.4,-4.1,18,FRA
b6e50615,22,1716,19.1,19,18,3,13,60,15,45,47.0,16.8,30.1,18,FRA
b7e7937d,3,225,2.5,2,2,1,20,9,0,9,5.9,2.5,3.4,18,FRA
b82880c6,1,90,1.0,1,1,0,0,1,3,-2,0.6,1.9,-1.3,18,FRA
b86fe156,28,2243,24.9,28,14,0,2,21,28,-7,28.3,31.2,-2.9,18,FRA
b92edde2,19,1703,18.9,19,18,0,0,28,18,10,26.8,20.2,6.5,18,FRA
b931d9d1,19,1595,17.7,18,16,1,1,12,21,-9,22.3,23.7,-1.5,18,FRA
b99bec05,25,1602,17.8,17,15,8,10,13,28,-15,17.9,26.6,-8.6,18,FRA
bb4a42be,22,1521,16.9,19,8,3,3,20,18,2,19.3,18.7,0.6,18,FRA
bc270726,37,3330,37.0,37,37,0,0,37,41,-4,32.2,53.6,-21.4,18,FRA
bc6bd723,35,3041,33.8,34,32,1,0,49,47,2,45.5,43.2,2.3,18,FRA
bcb98316,8,170,1.9,0,0,8,9,5,0,5,4.5,1.6,2.9,18,FRA
bcc81786,36,3154,35.0,35,33,1,0,34,47,-13,40.5,46.8,-6.3,18,FRA
bced0375,20,1588,17.6,18,15,2,8,21,25,-4,21.6,25.1,-3.5,18,FRA
bcf1b2e9,38,3420,38.0,38,38,0,0,55,73,-18,41.6,63.8,-22.2,18,FRA
bd4f5f94,20,1607,17.9,18,15,2,10,41,23,18,30.6,22.8,7.7,18,FRA
beb391dd,30,1272,14.1,13,6,17,3,24,19,5,19.8,15.9,3.9,18,FRA
bece776f,30,2477,27.5,28,22,2,1,58,36,22,44.8,31.7,13.1,18,FRA
beff5d14,20,655,7.3,5,0,15,11,9,10,-1,8.8,9.4,-0.6,18,FRA
bf354e77,10,424,4.7,4,1,6,5,3,3,0,7.2,4.8,2.4,18,FRA
bfdb33aa,24,1858,20.6,22,12,2,0,29,24,5,31.4,24.6,6.8,18,FRA
c0cddebe,2,28,0.3,0,0,2,0,1,0,1,0.6,0.2,0.4,18,FRA
c121a641,1,90,1.0,1,1,0,2,2,3,-1,1.3,2.2,-0.9,18,FRA
c1febb46,27,2002,22.2,23,11,4,2,19,31,-12,23.8,31.2,-7.5,18,FRA
c2211709,35,3049,33.9,35,32,0,0,33,28,5,37.8,35.3,2.5,18,FRA
c26a3918,33,2970,33.0,33,33,0,1,41,44,-3,41.7,39.0,2.7,18,FRA
c27dfb82,29,1757,19.5,18,12,11,3,27,33,-6,23.3,29.0,-5.7,18,FRA
c3512013,8,470,5.2,5,3,3,10,2,13,-11,4.8,9.6,-4.8,18,FRA
c3725db2,14,1107,12.3,12,10,2,19,14,23,-9,14.4,19.4,-5.0,18,FRA
c4527123,7,350,3.9,3,3,4,8,8,12,-4,9.4,11.0,-1.6,18,FRA
c46fa34c,27,2047,22.7,25,16,2,0,17,28,-11,23.7,26.9,-3.2,18,FRA
c47541e0,31,2284,25.4,27,15,4,0,64,30,34,43.1,24.0,19.2,18,FRA
c4bbea9f,27,2430,27.0,27,27,0,6,24,23,1,31.4,29.5,1.9,18,FRA
c53083ad,16,1284,14.3,15,10,1,1,16,18,-2,18.1,21.6,-3.4,18,FRA
c58270f8,24,934,10.4,8,2,16,11,11,9,2,10.7,10.9,-0.3,18,FRA
c5a500ca,29,2415,26.8,27,22,2,0,27,36,-9,34.4,35.9,-1.6,18,FRA
c6056d58,36,3240,36.0,36,36,0,0,82,37,45,57.0,45.1,11.9,18,FRA
c650629d,29,1881,20.9,20,11,9,4,32,28,4,29.9,22.8,7.0,18,FRA
c69ef855,26,1886,21.0,20,16,6,9,20,34,-14,23.2,31.7,-8.4,18,FRA
c6ac6579,19,876,9.7,9,5,10,7,26,11,15,23.1,8.9,14.2,18,FRA
c6e5d20f,31,2294,25.5,27,17,4,1,30,40,-10,24.4,37.8,-13.4,18,FRA
c76b7567,36,2578,28.6,29,13,7,1,27,33,-6,30.1,28.5,1.6,18,FRA
c801616a,35,3025,33.6,34,31,1,0,40,48,-8,42.9,41.3,1.6,18,FRA
c8c02ac7,15,989,11.0,11,8,4,7,17,11,6,13.2,11.2,2.1,18,FRA
c8c60119,20,1248,13.9,13,12,7,12,24,21,3,18.3,23.2,-4.9,18,FRA
c9e99e49,25,2063,22.9,23,21,2,7,65,17,48,52.2,20.2,32.1,18,FRA
cac76a72,35,3112,34.6,35,34,0,0,44,44,0,47.3,47.3,0.0,18,FRA
cb9ec45d,7,275,3.1,4,2,3,9,2,4,-2,2.9,3.3,-0.4,18,FRA
cc41f558,6,354,3.9,3,2,3,1,2,7,-5,4.5,8.6,-4.1,18,FRA
cc77354e,6,455,5.1,5,4,1,14,10,6,4,10.9,5.8,5.1,18,FRA
ccb1c3af,17,881,9.8,9,2,8,12,12,12,0,12.3,10.5,1.8,18,FRA
ccbbe661,28,1097,12.2,8,3,20,8,18,21,-3,11.5,19.0,-7.5,18,FRA
cd387ff4,29,2238,24.9,26,19,3,1,26,49,-23,24.6,45.5,-20.9,18,FRA
cdf65d12,23,1929,21.4,22,20,1,4,36,29,7,27.5,30.2,-2.7,18,FRA
ce17b5eb,4,360,4.0,4,4,0,32,7,4,3,6.6,4.5,2.0,18,FRA
ce316f8c,19,847,9.4,7,0,12,7,6,15,-9,11.2,12.7,-1.4,18,FRA
ce492295,17,1201,13.3,13,13,4,11,20,23,-3,17.8,21.0,-3.2,18,FRA
cee88597,25,1951,21.7,22,19,3,5,19,47,-28,22.5,42.4,-20.0,18,FRA
cf4053e2,29,1825,20.3,23,7,6,1,21,16,5,16.2,24.1,-7.9,18,FRA
cfd8dde3,18,1376,15.3,15,8,3,0,14,24,-10,19.4,17.4,2.1,18,FRA
cfe852d8,21,1890,21.0,21,21,0,12,21,31,-10,23.1,26.9,-3.8,18,FRA
d14229f3,24,1458,16.2,17,6,7,7,17,19,-2,19.4,19.4,0.1,18,FRA
d2110326,12,728,8.1,8,7,4,21,20,17,3,12.3,10.3,2.0,18,FRA
d2448564,36,2603,28.9,29,17,7,0,22,39,-17,28.1,38.6,-10.5,18,FRA
d28b4a9d,3,77,0.9,1,0,2,3,0,5,-5,0.8,3.1,-2.3,18,FRA
d2aa8ac0,23,1621,18.0,21,5,2,6,25,28,-3,25.3,23.6,1.7,18,FRA
d33c706e,32,2333,25.9,25,16,7,0,29,36,-7,34.0,35.0,-1.0,18,FRA
d3b58e33,6,212,2.4,2,0,4,4,1,4,-3,2.0,4.6,-2.5,18,FRA
d3ce9f1f,17,1159,12.9,14,9,3,5,12,12,0,14.4,16.5,-2.1,18,FRA
d4133fa1,17,1479,16.4,17,14,0,0,23,14,9,23.2,23.3,-0.1,18,FRA
d504b3e1,10,439,4.9,7,0,3,0,5,1,4,5.5,3.7,1.7,18,FRA
d512db65,7,107,1.2,0,0,7,1,2,2,0,2.3,1.0,1.3,18,FRA
d520120b,26,2055,22.8,23,19,3,1,35,34,1,27.2,34.0,-6.8,18,FRA
d5f2f82b,26,2262,25.1,25,23,1,7,61,20,41,50.6,23.8,26.8,18,FRA
d63e2912,33,2520,28.0,30,24,3,2,60,36,24,57.6,33.5,24.1,18,FRA
d6a889ea,23,1817,20.2,21,19,2,0,26,36,-10,22.1,29.6,-7.4,18,FRA
d72db2f5,8,136,1.5,0,0,8,4,4,2,2,4.5,3.0,1.5,18,FRA
d7553721,33,1776,19.7,18,11,15,4,55,17,38,45.0,20.6,24.5,18,FRA
d7bf3d19,33,2703,30.0,31,26,2,0,47,55,-8,32.2,49.1,-16.9,18,FRA
d8b97bb3,5,304,3.4,3,2,2,5,6,1,5,5.3,3.5,1.8,18,FRA
d9afac11,25,917,10.2,7,1,18,12,12,14,-2,15.4,12.7,2.6,18,FRA
dbb10755,20,1718,19.1,20,19,0,5,20,30,-10,21.4,26.2,-4.8,18,FRA
dc366c36,34,3060,34.0,34,34,0,0,44,36,8,44.1,42.4,1.7,18,FRA
dc3a9a0d,26,1006,11.2,7,2,19,4,29,12,17,24.8,14.1,10.7,18,FRA
dcf7cf44,21,860,9.6,11,0,10,13,13,15,-2,9.6,12.9,-3.3,18,FRA
de343d38,14,968,10.8,11,6,3,2,13,27,-14,12.7,21.3,-8.6,18,FRA
de488e56,34,2998,33.3,33,32,1,0,30,52,-22,33.9,44.6,-10.7,18,FRA
de4fe7a2,23,800,8.9,8,0,15,9,10,12,-2,13.0,12.5,0.5,18,FRA
e067808c,16,795,8.8,8,2,8,1,13,13,0,12.5,9.4,3.1,18,FRA
e0d725fe,15,902,10.0,12,4,3,15,5,11,-6,11.6,12.7,-1.1,18,FRA
e162b013,24,1578,17.5,16,14,8,11,53,13,40,40.8,15.7,25.2,18,FRA
e1b3413d,27,2178,24.2,25,22,2,10,35,44,-9,32.3,37.8,-5.6,18,FRA
e2f9bb5f,6,131,1.5,1,0,5,7,1,3,-2,0.7,1.5,-0.8,18,FRA
e39f8724,7,598,6.6,6,6,1,26,5,13,-8,5.8,9.7,-4.0,18,FRA
e3ad3368,1,12,0.1,0,0,1,2,0,0,0,0.0,0.1,-0.1,18,FRA
e3d0b0c4,35,3105,34.5,35,33,0,1,80,34,46,58.2,35.6,22.5,18,FRA
e3e05edf,3,201,2.2,3,1,0,0,2,2,0,1.5,1.9,-0.4,18,FRA
e50623a0,11,721,8.0,7,6,4,17,8,7,1,7.6,9.4,-1.8,18,FRA
e54a9890,19,887,9.9,9,3,10,7,12,10,2,10.2,11.6,-1.4,18,FRA
e61bdd69,1,8,0.1,0,0,1,0,0,0,0,0.1,0.3,-0.2,18,FRA
e61d33f1,12,363,4.0,2,0,10,3,5,9,-4,5.4,6.7,-1.4,18,FRA
e65dd8dc,4,272,3.0,3,3,1,5,5,6,-1,6.1,4.6,1.5,18,FRA
e68f2cb4,13,1032,11.5,12,6,1,0,13,13,0,11.7,16.3,-4.5,18,FRA
e6bc67d7,1,5,0.1,0,0,1,1,0,0,0,0.0,0.1,-0.1,18,FRA
e750cba4,17,1530,17.0,17,17,0,21,11,28,-17,14.9,25.2,-10.2,18,FRA
e768de1f,13,708,7.9,7,6,6,8,5,16,-11,10.3,12.7,-2.4,18,FRA
e893fc23,2,85,0.9,1,0,1,6,0,4,-4,0.4,2.0,-1.5,18,FRA
e90af77c,5,82,0.9,1,0,4,12,0,1,-1,0.6,1.2,-0.6,18,FRA
e97150c0,33,2916,32.4,32,32,1,0,73,37,36,52.7,34.2,18.5,18,FRA
ea0ff634,35,2167,24.1,24,10,11,3,45,33,12,46.0,30.2,15.8,18,FRA
eacb45fd,21,1727,19.2,20,18,1,4,23,21,2,18.0,26.0,-7.9,18,FRA
eaf71a5e,30,2251,25.0,26,17,4,5,19,33,-14,23.1,31.3,-8.1,18,FRA
eb78322b,1,90,1.0,1,1,0,0,1,0,1,0.9,0.8,0.0,18,FRA
ec1aa15e,7,443,4.9,6,3,1,10,5,5,0,6.2,5.4,0.8,18,FRA
ec400194,33,2503,27.8,27,25,6,1,41,50,-9,31.0,46.0,-15.0,18,FRA
ed45c4a5,32,2350,26.1,29,15,3,2,21,37,-16,28.4,27.8,0.5,18,FRA
edd1466a,23,1613,17.9,19,8,4,9,29,38,-9,21.3,29.3,-8.1,18,FRA
ef7cd87a,36,2810,31.2,31,26,5,1,31,34,-3,33.5,31.7,1.8,18,FRA
ef9c1c95,34,3011,33.5,34,29,0,0,45,36,9,43.8,40.6,3.2,18,FRA
f00de885,34,3060,34.0,34,34,0,0,78,37,41,57.7,35.2,22.5,18,FRA
f09a8b75,20,1028,11.4,12,2,8,8,13,15,-2,15.8,14.4,1.4,18,FRA
f3085377,6,336,3.7,3,2,3,9,4,11,-7,4.1,7.4,-3.4,18,FRA
f323d995,30,2605,28.9,30,28,0,2,30,43,-13,37.1,40.4,-3.3,18,FRA
f329ec76,3,55,0.6,0,0,3,1,1,1,0,1.3,0.5,0.8,18,FRA
f352a2db,26,1421,15.8,14,3,12,9,15,15,0,19.1,17.5,1.6,18,FRA
f3600c02,18,1408,15.7,15,12,3,2,24,28,-4,17.400000000000002,28.5,-11.1,18,FRA
f3642ba8,13,396,4.4,3,2,10,0,3,8,-5,3.5,10.0,-6.5,18,FRA
f36c432f,15,753,8.4,7,2,8,3,22,6,16,16.2,9.5,6.7,18,FRA
f449640d,27,2055,22.8,25,18,2,7,19,37,-18,17.7,34.4,-16.6,18,FRA
f45cf4f7,2,23,0.3,0,0,2,0,0,1,-1,0.2,0.3,-0.1,18,FRA
f5044e54,34,2890,32.1,33,24,1,0,42,40,2,39.8,41.3,-1.5,18,FRA
f51edbf3,5,223,2.5,1,0,4,8,0,4,-4,1.4,3.9,-2.5,18,FRA
f5a00fa4,33,2803,31.1,31,30,2,3,71,42,29,50.9,41.6,9.3,18,FRA
f6496133,6,179,2.0,1,0,5,9,2,2,0,2.9,1.0,1.9,18,FRA
f6db3bd5,34,2939,32.7,34,32,0,0,68,41,27,53.1,41.2,11.9,18,FRA
f7691f63,33,2602,28.9,29,22,4,0,42,49,-7,39.1,43.3,-4.2,18,FRA
f83c8d6c,37,3209,35.7,36,32,1,0,45,51,-6,42.8,44.6,-1.8,18,FRA
f86ca403,20,1290,14.3,15,9,5,6,12,31,-19,14.7,21.8,-7.1,18,FRA
f99fe221,12,851,9.5,9,8,3,12,15,17,-2,13.3,12.9,0.4,18,FRA
fa00f0c9,1,10,0.1,0,0,1,2,0,0,0,0.0,0.1,0.0,18,FRA
fa18c72e,34,2018,22.4,24,10,10,3,25,41,-16,23.4,33.3,-10.0,18,FRA
fa27b5a0,1,89,1.0,1,0,0,5,1,1,0,0.7,0.5,0.3,18,FRA
faf873a7,4,360,4.0,4,4,0,31,4,11,-7,4.4,7.3,-2.9,18,FRA
fbbb9269,35,3093,34.4,35,34,0,0,50,43,7,46.3,38.4,7.8,18,FRA
fca455cc,15,807,9.0,8,7,7,14,6,7,-1,10.3,7.6,2.8,18,FRA
fcb38f57,34,3032,33.7,34,33,0,2,37,53,-16,31.6,49.0,-17.4,18,FRA
fcbcbd94,33,2472,27.5,28,13,5,0,27,28,-1,23.5,37.6,-14.1,18,FRA
fd2bc67d,33,2919,32.4,33,32,0,1,41,50,-9,41.2,42.2,-1.0,18,FRA
fd771f95,14,914,10.2,11,7,3,0,20,11,9,16.5,13.1,3.4,18,FRA
ff0ab48c,34,3021,33.6,34,30,0,2,33,38,-5,37.3,31.8,5.6,18,FRA
ff16ecad,28,2410,26.8,28,24,0,3,21,34,-13,28.0,34.0,-6.0,18,FRA
ffa90327,27,1648,18.3,19,13,8,4,21,31,-10,17.2,28.2,-11.0,18,FRA
00242715,33,2789,31.0,32,30,1,1,41,53,-12,47.6,53.8,-6.3,19,GER
00242b75,1,90,1.0,1,1,0,2,1,5,-4,1.6,3.1,-1.5,19,GER
00844823,30,2637,29.3,30,28,0,0,47,36,11,42.2,46.3,-4.1,19,GER
00a6485f,24,1776,19.7,21,15,3,5,23,35,-12,22.8,33.6,-10.9,19,GER
00c3d4dc,3,29,0.3,0,0,3,0,0,0,0,0.1,0.7,-0.5,19,GER
012c38ec,1,1,0.0,0,0,1,1,0,0,0,0.0,0.0,0.0,19,GER
016ff750,31,2741,30.5,31,29,0,0,45,54,-9,46.2,57.0,-10.9,19,GER
01c3aff5,24,1746,19.4,19,14,5,1,18,32,-14,27.3,24.9,2.3,19,GER
032f894e,17,577,6.4,4,2,13,13,16,9,7,17.0,6.4,10.6,19,GER
03bd0bf4,7,630,7.0,7,7,0,9,5,11,-6,8.3,7.9,0.4,19,GER
042e8a49,21,1378,15.3,17,5,4,0,42,13,29,38.0,12.3,25.6,19,GER
048a1cbc,23,1527,17.0,17,7,6,5,40,21,19,31.7,15.3,16.4,19,GER
04c11885,25,1470,16.3,16,11,9,6,18,35,-17,21.9,30.4,-8.5,19,GER
05439de2,31,2530,28.1,29,24,2,0,71,27,44,68.4,23.6,44.9,19,GER
05d548d8,21,1775,19.7,20,19,1,8,52,19,33,50.3,16.7,33.5,19,GER
05f99a4a,4,259,2.9,4,1,0,1,2,4,-2,5.2,4.6,0.6,19,GER
061e8e23,18,758,8.4,9,1,9,5,19,5,14,11.6,9.0,2.5,19,GER
070ec0b1,27,1991,22.1,25,19,2,2,49,35,14,38.4,27.5,10.9,19,GER
080440a4,32,2717,30.2,32,29,0,0,43,48,-5,46.9,47.400000000000006,-0.4,19,GER
088ca1bd,28,2520,28.0,28,28,0,5,45,58,-13,36.0,51.7,-15.6,19,GER
09586899,12,567,6.3,7,2,5,2,13,9,4,13.8,4.8,9.0,19,GER
096a77c4,16,552,6.1,5,0,11,7,9,4,5,12.4,8.6,3.8,19,GER
0999a593,1,7,0.1,0,0,1,9,0,1,-1,0.1,0.6,-0.5,19,GER
09bcc566,23,1543,17.1,17,10,6,1,11,42,-31,14.7,29.3,-14.6,19,GER
0a1cb833,34,2977,33.1,34,32,0,0,55,47,8,48.1,54.7,-6.6,19,GER
0a89e877,1,63,0.7,1,0,0,0,0,2,-2,0.7,2.1,-1.5,19,GER
0b4f388a,20,1345,14.9,15,6,5,1,17,26,-9,20.1,23.6,-3.4,19,GER
0c3057a9,29,1917,21.3,22,12,7,1,20,41,-21,23.7,31.3,-7.6,19,GER
0c61c77c,31,1972,21.9,22,7,9,1,34,44,-10,31.5,37.8,-6.3,19,GER
0d55d942,33,2970,33.0,33,33,0,1,41,60,-19,40.0,60.0,-20.0,19,GER
0e0ab524,7,284,3.2,3,1,4,5,7,3,4,6.6,5.1,1.5,19,GER
0e4fef6e,8,560,6.2,6,4,2,3,12,8,4,8.6,9.8,-1.2,19,GER
0f26fd24,24,962,10.7,11,1,13,2,12,19,-7,13.3,18.7,-5.4,19,GER
0fbecd11,18,973,10.8,10,7,8,15,17,21,-4,13.7,19.7,-6.0,19,GER
1025db8e,25,2092,23.2,24,22,1,0,35,46,-11,32.6,42.3,-9.7,19,GER
106bca06,15,1004,11.2,11,8,4,3,15,16,-1,17.2,14.4,2.8,19,GER
11fd2b75,14,993,11.0,11,8,3,10,13,14,-1,13.3,14.6,-1.3,19,GER
1238a3f9,30,1739,19.3,16,11,14,1,27,33,-6,27.7,36.7,-9.0,19,GER
13203c45,28,2461,27.3,28,23,0,0,47,42,5,37.1,39.4,-2.3,19,GER
13ddc856,13,699,7.8,9,1,4,6,5,22,-17,6.0,17.5,-11.6,19,GER
150d5992,1,1,0.0,0,0,1,6,0,0,0,0.0,0.0,0.0,19,GER
15ea94de,5,222,2.5,2,2,3,3,6,3,3,3.5,3.3,0.2,19,GER
15fd5593,33,2816,31.3,33,26,0,0,55,45,10,44.8,51.0,-6.3,19,GER
16daec92,29,1626,18.1,16,9,13,0,29,28,1,29.8,29.6,0.3,19,GER
17611373,29,1833,20.4,19,11,10,5,30,34,-4,27.2,39.4,-12.2,19,GER
17695062,3,29,0.3,0,0,3,1,1,1,0,1.3,0.5,0.8,19,GER
17780d2b,29,2293,25.5,26,21,3,5,40,27,13,41.6,38.8,2.9,19,GER
1ae836b1,24,1144,12.7,13,2,11,8,21,16,5,17.0,17.9,-0.9,19,GER
1bcca8b8,28,1564,17.4,17,7,11,6,34,22,12,30.1,23.6,6.5,19,GER
1bf33a9a,20,932,10.4,9,6,11,4,28,13,15,19.9,11.8,8.1,19,GER
1c08a3c8,10,790,8.8,9,7,1,2,10,15,-5,8.0,16.2,-8.2,19,GER
1c96ad85,9,653,7.3,7,6,2,16,12,11,1,15.9,10.3,5.6,19,GER
1cd87320,18,1468,16.3,16,16,2,8,15,32,-17,19.3,37.0,-17.6,19,GER
1d8e9add,28,2391,26.6,28,24,0,0,59,39,20,61.3,38.6,22.7,19,GER
1e43fad8,17,1470,16.3,16,16,1,9,18,26,-8,22.5,22.6,0.0,19,GER
20030c06,24,2049,22.8,23,21,1,9,48,15,33,47.4,26.5,21.0,19,GER
2042d931,30,2317,25.7,27,14,3,1,36,39,-3,39.8,47.4,-7.7,19,GER
206c37d3,1,38,0.4,0,0,1,16,1,1,0,0.6,1.0,-0.4,19,GER
2200181e,28,2449,27.2,28,26,0,2,38,52,-14,36.2,50.6,-14.3,19,GER
22051fbe,9,625,6.9,6,4,3,7,16,6,10,17.2,10.5,6.7,19,GER
229cd98a,20,531,5.9,3,2,17,4,12,20,-8,6.5,13.2,-6.7,19,GER
2374aaca,30,2162,24.0,23,16,7,1,23,48,-25,27.6,42.0,-14.4,19,GER
258a6f4d,4,200,2.2,2,1,2,1,1,6,-5,2.8,3.4,-0.7,19,GER
2590ddf7,1,9,0.1,0,0,1,2,0,0,0,0.1,0.1,0.0,19,GER
25ab9c9c,21,1712,19.0,20,17,1,0,25,31,-6,26.1,34.7,-8.6,19,GER
25c633b0,5,273,3.0,3,2,2,1,2,5,-3,2.9,6.9,-4.0,19,GER
26db8853,26,1996,22.2,23,18,3,4,19,43,-24,25.4,47.7,-22.3,19,GER
278f6efc,1,90,1.0,1,1,0,8,0,1,-1,0.8,1.5,-0.7,19,GER
27d2618c,31,2745,30.5,31,30,0,0,41,48,-7,45.3,54.3,-9.0,19,GER
2903a856,27,1911,21.2,21,12,6,1,39,26,13,34.2,29.7,4.6,19,GER
2979c05a,4,145,1.6,1,0,3,3,2,2,0,1.8,2.6,-0.9,19,GER
2a29eb9b,16,1184,13.2,15,11,1,5,23,15,8,15.1,16.5,-1.4,19,GER
2b09d998,10,721,8.0,8,6,2,1,18,2,16,17.3,6.9,10.4,19,GER
2b350e6b,1,13,0.1,0,0,1,1,0,1,-1,0.1,0.5,-0.4,19,GER
2b5527c4,14,906,10.1,10,7,4,16,23,14,9,22.1,14.5,7.6,19,GER
2bb48e86,1,90,1.0,1,1,0,5,2,5,-3,2.0,1.9,0.1,19,GER
2bcc6d52,24,1526,17.0,17,12,7,0,22,29,-7,23.7,25.1,-1.4,19,GER
2bed2986,19,879,9.8,10,3,9,6,15,17,-2,15.1,15.8,-0.7,19,GER
2d61d13a,15,1350,15.0,15,15,0,1,18,32,-14,17.2,27.4,-10.2,19,GER
2db2fd7b,20,1693,18.8,19,18,1,11,51,17,34,45.8,15.2,30.6,19,GER
2e7ff968,2,180,2.0,2,2,0,31,6,4,2,4.7,3.3,1.3,19,GER
2f3e911a,33,2878,32.0,32,30,1,1,46,50,-4,50.0,55.7,-5.7,19,GER
2ff76adc,6,274,3.0,2,2,4,3,0,1,-1,3.6,3.9,-0.3,19,GER
302527b2,14,614,6.8,7,5,7,9,12,10,2,7.8,10.1,-2.3,19,GER
30a09cb5,4,250,2.8,2,2,2,3,5,8,-3,4.7,5.2,-0.5,19,GER
30c220c3,30,2111,23.5,22,16,8,4,52,38,14,41.8,30.8,10.9,19,GER
31114001,3,51,0.6,0,0,3,2,0,0,0,0.2,1.1,-1.0,19,GER
316162b6,18,1055,11.7,13,5,5,2,20,19,1,17.4,17.5,-0.1,19,GER
3189f61a,25,1792,19.9,19,14,6,0,22,38,-16,28.0,29.9,-1.9,19,GER
33144cc5,7,189,2.1,1,0,6,4,1,3,-2,1.8,2.1,-0.3,19,GER
3376a776,24,2068,23.0,24,22,0,0,28,41,-13,33.5,45.5,-12.1,19,GER
33b554b7,24,1863,20.7,22,8,2,0,31,40,-9,30.0,38.9,-8.9,19,GER
346d51d9,18,1455,16.2,16,14,2,10,37,23,14,27.7,21.3,6.4,19,GER
34a0f5ff,17,898,10.0,7,4,10,1,17,20,-3,15.0,24.2,-9.3,19,GER
34b306a1,13,1049,11.7,11,11,2,6,17,21,-4,17.3,24.0,-6.7,19,GER
34b54da7,14,933,10.4,10,8,4,17,18,10,8,17.4,15.2,2.2,19,GER
34e12499,4,226,2.5,2,2,2,2,3,5,-2,1.9,4.7,-2.9,19,GER
36a3ff67,27,2316,25.7,27,21,0,0,60,32,28,48.4,33.5,14.8,19,GER
36a59ba4,32,2062,22.9,25,9,7,1,39,32,7,37.6,35.8,1.7,19,GER
37c213cf,9,258,2.9,3,0,6,1,2,8,-6,3.3,7.0,-3.8,19,GER
37f606f0,4,246,2.7,2,1,2,0,8,5,3,6.1,4.4,1.8,19,GER
384d58d9,31,1959,21.8,21,14,10,1,28,26,2,30.4,33.8,-3.5,19,GER
3861d9cc,7,74,0.8,0,0,7,11,1,1,0,1.8,2.1,-0.2,19,GER
3a233281,29,1914,21.3,21,8,8,1,36,36,0,33.9,29.2,4.7,19,GER
3c05e082,26,1640,18.2,19,8,7,1,26,28,-2,23.2,30.1,-7.0,19,GER
3c6089ab,32,2378,26.4,28,11,4,2,72,21,51,67.8,19.7,48.1,19,GER
3cb009c5,1,2,0.0,0,0,1,4,0,0,0,0.0,0.0,0.0,19,GER
3dffff26,12,1006,11.2,11,8,1,10,9,27,-18,10.8,23.3,-12.4,19,GER
3e81a228,22,1624,18.0,18,14,4,5,15,35,-20,20.5,27.8,-7.3,19,GER
3eb0f2df,10,376,4.2,3,1,7,7,5,11,-6,7.1,9.0,-1.9,19,GER
3eeb80e0,6,207,2.3,2,0,4,4,0,4,-4,1.7,4.1,-2.4,19,GER
3f65898c,32,2814,31.3,32,31,0,0,53,46,7,46.9,50.8,-3.9,19,GER
3f7cd8f1,15,1079,12.0,13,5,2,1,19,14,5,16.1,14.8,1.3,19,GER
3faa1780,1,25,0.3,0,0,1,3,0,3,-3,0.3,0.7,-0.3,19,GER
41d1fbc6,3,116,1.3,1,0,2,2,0,2,-2,1.1,2.4,-1.3,19,GER
420c18a1,34,3060,34.0,34,34,0,0,55,42,13,52.2,52.3,0.0,19,GER
420ff5a3,4,202,2.2,2,0,2,0,4,2,2,3.6,2.5,1.2,19,GER
434cf5b7,17,942,10.5,9,4,8,8,9,22,-13,13.0,18.1,-5.1,19,GER
437f2b00,2,85,0.9,1,0,1,5,2,0,2,1.6,1.5,0.2,19,GER
441197b8,27,2304,25.6,24,23,3,4,50,37,13,43.5,35.9,7.6,19,GER
442b56fa,15,937,10.4,10,5,5,9,6,14,-8,12.5,16.7,-4.2,19,GER
45954ec7,10,886,9.8,10,8,0,3,18,12,6,13.8,13.5,0.3,19,GER
45a03961,29,2610,29.0,29,29,0,0,26,57,-31,31.5,48.9,-17.4,19,GER
45b7edae,10,522,5.8,5,4,5,11,1,13,-12,4.6,9.3,-4.7,19,GER
463503e2,27,2430,27.0,27,27,0,5,40,51,-11,39.3,48.6,-9.3,19,GER
47064058,33,2970,33.0,33,33,0,0,67,51,16,74.0,50.3,23.7,19,GER
48035304,30,2623,29.1,30,27,0,0,46,37,9,41.9,44.6,-2.7,19,GER
482b70ad,31,2216,24.6,29,8,2,0,36,49,-13,26.6,47.3,-20.7,19,GER
49296448,34,3060,34.0,34,34,0,0,88,32,56,85.6,27.2,58.4,19,GER
496aeede,18,1136,12.6,13,8,5,9,19,21,-2,16.7,21.0,-4.3,19,GER
49fe9070,30,2509,27.9,29,13,1,0,53,22,31,53.3,32.4,20.9,19,GER
49ffe0f2,25,1296,14.4,13,5,12,4,15,24,-9,19.4,27.0,-7.6,19,GER
4a15e95b,22,1932,21.5,22,21,0,7,17,40,-23,22.5,34.4,-11.9,19,GER
4d74201d,4,75,0.8,0,0,4,8,1,3,-2,0.9,3.3,-2.4,19,GER
4d8cd038,32,2243,24.9,25,14,7,2,46,30,16,43.5,35.2,8.2,19,GER
4e204552,24,1265,14.1,16,3,8,7,31,21,10,25.5,19.4,6.1,19,GER
4e3e4138,3,39,0.4,0,0,3,2,3,0,3,1.9,1.0,0.9,19,GER
4f16405e,14,1112,12.4,13,11,1,0,12,27,-15,13.6,24.5,-10.9,19,GER
500cd987,7,110,1.2,0,0,7,5,6,1,5,4.9,0.9,4.0,19,GER
50871bcc,33,2873,31.9,33,28,0,0,51,42,9,49.1,50.9,-1.8,19,GER
50e6dc35,34,2483,27.6,29,15,5,0,38,49,-11,41.7,49.4,-7.8,19,GER
53070b63,15,180,2.0,0,0,15,14,1,6,-5,2.8,4.2,-1.3,19,GER
531807b3,10,607,6.7,6,4,4,1,8,14,-6,6.9,13.8,-6.9,19,GER
536cebe5,28,1978,22.0,23,11,5,0,37,29,8,37.4,32.6,4.8,19,GER
53e07d0b,30,1627,18.1,15,8,15,2,37,33,4,44.7,29.8,15.0,19,GER
541127d5,7,378,4.2,4,2,3,0,3,2,1,5.3,6.1,-0.8,19,GER
541cdd20,19,1580,17.6,18,14,1,6,15,34,-19,19.8,32.0,-12.2,19,GER
54507986,2,80,0.9,1,0,1,4,0,2,-2,0.4,1.3,-0.9,19,GER
549c6ba7,4,245,2.7,3,0,1,2,2,4,-2,3.6,3.6,-0.1,19,GER
54b4dc4e,26,2017,22.4,24,16,2,1,47,32,15,50.9,32.4,18.5,19,GER
54b6ee79,26,692,7.7,3,0,23,6,23,12,11,13.1,15.0,-1.9,19,GER
54e4866f,23,1762,19.6,19,13,4,5,31,37,-6,25.200000000000003,34.4,-9.299999999999999,19,GER
5528407e,27,2075,23.1,25,14,2,1,19,45,-26,24.3,43.5,-19.2,19,GER
555d5edd,13,754,8.4,10,2,3,4,22,8,14,22.2,9.3,12.9,19,GER
56413b1f,24,1891,21.0,22,15,2,2,43,26,17,38.9,22.1,16.9,19,GER
565bf0da,17,1420,15.8,17,15,0,3,28,29,-1,25.9,26.6,-0.6,19,GER
5722eced,11,279,3.1,1,1,10,16,3,2,1,3.5,6.4,-2.9,19,GER
58007d77,2,46,0.5,0,0,2,4,0,3,-3,0.3,1.3,-1.0,19,GER
58ce23e5,12,664,7.4,8,1,4,3,12,14,-2,11.6,13.3,-1.7,19,GER
5939baa2,21,1763,19.6,20,19,1,1,29,31,-2,28.5,31.2,-2.7,19,GER
597ff9d3,1,3,0.0,0,0,1,6,0,0,0,0.0,0.0,0.0,19,GER
59e4b92e,30,2624,29.2,30,27,0,0,43,53,-10,40.3,49.1,-8.8,19,GER
5afafbfe,2,98,1.1,1,0,1,0,3,1,2,1.2,1.2,0.0,19,GER
5c4bf6ba,10,900,10.0,10,10,0,24,16,14,2,15.9,17.7,-1.8,19,GER
5c4d9be7,15,1299,14.4,15,12,0,0,12,30,-18,12.8,22.6,-9.8,19,GER
5caa62a7,14,553,6.1,6,3,8,13,9,5,4,10.6,8.0,2.6,19,GER
5d8e331f,18,1615,17.9,18,17,0,0,23,36,-13,21.0,32.6,-11.5,19,GER
5db04597,8,597,6.6,8,3,0,3,1,15,-14,5.0,12.1,-7.1,19,GER
5ddb8f9f,34,3033,33.7,34,32,0,0,60,48,12,56.8,50.5,6.3,19,GER
5dfc6ad5,33,2873,31.9,32,31,1,0,74,41,33,57.9,37.7,20.2,19,GER
5e1df051,21,1116,12.4,14,5,7,10,7,24,-17,10.8,23.599999999999998,-12.9,19,GER
5e66fa06,34,3060,34.0,34,34,0,0,31,71,-40,37.2,67.8,-30.6,19,GER
5ed9b537,28,2431,27.0,27,27,1,2,52,25,27,51.3,33.8,17.6,19,GER
603cb947,30,2396,26.6,28,18,2,1,55,38,17,59.1,39.2,19.9,19,GER
6190474d,1,5,0.1,0,0,1,3,1,0,1,0.8,0.0,0.8,19,GER
61b0b44d,7,143,1.6,1,0,6,8,1,0,1,3.0,0.6,2.5,19,GER
61fc9685,22,579,6.4,3,1,19,10,13,6,7,16.3,9.3,7.0,19,GER
626fab5f,7,548,6.1,6,6,1,11,7,13,-6,9.1,9.1,0.0,19,GER
62ab9184,30,2455,27.3,28,21,2,2,53,39,14,39.7,39.1,0.6,19,GER
62ba5881,1,45,0.5,0,0,1,16,2,1,1,1.1,0.5,0.6,19,GER
635f2732,30,2127,23.6,25,16,5,2,36,41,-5,37.2,41.8,-4.6,19,GER
638a4d71,16,823,9.1,8,3,8,11,9,19,-10,9.0,18.5,-9.4,19,GER
64c07ae1,6,460,5.1,6,5,0,1,6,7,-1,7.6,6.1,1.4,19,GER
64f69877,34,2814,31.3,32,24,2,0,65,49,16,55.4,40.1,15.3,19,GER
652d4c37,2,52,0.6,1,0,1,2,2,1,1,0.6,0.8,-0.2,19,GER
66385c46,15,921,10.2,11,4,4,10,14,22,-8,11.1,18.6,-7.6,19,GER
664590fa,14,942,10.5,11,6,3,0,11,16,-5,14.4,19.1,-4.7,19,GER
676ff98c,3,28,0.3,0,0,3,6,1,0,1,1.2,0.5,0.7,19,GER
677da306,11,244,2.7,2,2,9,20,6,3,3,2.9,4.3,-1.4,19,GER
68829001,25,1692,18.8,19,12,6,8,19,44,-25,21.3,30.5,-9.1,19,GER
69374ff5,21,1559,17.3,16,14,5,4,43,23,20,33.1,17.1,16.0,19,GER
699fb8db,34,3053,33.9,34,33,0,0,45,61,-16,39.9,61.1,-21.2,19,GER
6b32d0a6,31,2790,31.0,31,31,0,2,23,62,-39,33.0,47.5,-14.5,19,GER
6bba916f,5,61,0.7,0,0,5,7,2,1,1,1.1,1.3,-0.2,19,GER
6bd5cd5d,31,2790,31.0,31,31,0,3,58,47,11,42.8,44.6,-1.8,19,GER
6bd603db,31,2672,29.7,30,27,1,0,39,48,-9,43.0,52.4,-9.3,19,GER
6be813ab,2,27,0.3,0,0,2,7,0,2,-2,0.2,0.7,-0.5,19,GER
6c6a3300,26,1550,17.2,19,4,7,4,28,22,6,25.4,28.0,-2.6,19,GER
6cafd68d,8,470,5.2,4,3,4,0,13,10,3,10.7,11.2,-0.5,19,GER
6e33125f,18,1247,13.9,13,12,5,15,24,31,-7,15.8,26.7,-11.0,19,GER
6ec6fde0,12,812,9.0,9,7,3,2,12,21,-9,12.2,19.4,-7.1,19,GER
6fd8a334,18,1335,14.8,13,12,5,16,28,21,7,24.3,19.4,4.8,19,GER
70678132,22,1623,18.0,17,13,5,1,17,37,-20,19.7,28.4,-8.8,19,GER
70dcf94d,27,2340,26.0,26,22,1,0,34,47,-13,30.9,46.7,-15.8,19,GER
710fbdd1,1,5,0.1,0,0,1,5,0,0,0,0.0,0.0,0.0,19,GER
715bf047,20,1138,12.6,13,3,7,4,32,14,18,32.2,9.3,22.9,19,GER
71a20ce8,31,2211,24.6,25,17,6,2,23,52,-29,29.2,41.2,-12.0,19,GER
7242b495,30,2593,28.8,29,27,1,2,42,49,-7,39.7,47.6,-7.9,19,GER
7391c2d9,6,489,5.4,6,4,0,6,10,9,1,8.6,12.3,-3.7,19,GER
73e2f6eb,1,90,1.0,1,1,0,16,1,3,-2,1.3,2.9,-1.7,19,GER
74c7c2db,28,2194,24.4,25,14,3,1,35,34,1,37.6,39.6,-2.0,19,GER
74d70fb5,21,1414,15.7,15,13,6,10,27,25,2,23.4,25.8,-2.4,19,GER
76e5da9d,18,1012,11.2,11,6,7,9,14,16,-2,17.5,18.1,-0.6,19,GER
773968e4,28,1723,19.1,18,11,10,4,16,39,-23,22.2,39.7,-17.5,19,GER
77b41ac0,30,2639,29.3,30,26,0,0,25,58,-33,30.7,44.4,-13.7,19,GER
77e84962,30,2408,26.8,26,23,4,0,74,21,53,69.1,19.6,49.5,19,GER
78cd577c,18,1341,14.9,15,12,3,6,9,21,-12,14.5,24.1,-9.5,19,GER
791abba1,30,2614,29.0,29,29,1,0,33,49,-16,39.2,42.4,-3.2,19,GER
791af558,13,543,6.0,5,0,8,2,10,5,5,12.3,8.8,3.5,19,GER
79c90e45,29,2509,27.9,28,27,1,2,62,40,22,63.6,43.1,20.5,19,GER
79ca3e23,32,2563,28.5,30,16,2,1,40,49,-9,41.5,49.8,-8.3,19,GER
7aac47fe,25,1790,19.9,20,17,5,3,41,30,11,43.1,30.7,12.3,19,GER
7cd6badb,21,1508,16.8,19,12,2,1,27,23,4,22.5,23.0,-0.5,19,GER
7d3e7da6,9,758,8.4,8,8,1,25,17,9,8,24.5,8.5,16.0,19,GER
7d841904,14,891,9.9,10,7,4,5,14,29,-15,11.7,19.2,-7.5,19,GER
7e689867,13,517,5.7,7,0,6,19,13,9,4,8.3,8.9,-0.6,19,GER
7f609bfc,17,1402,15.6,16,13,1,8,21,22,-1,35.7,20.9,14.8,19,GER
7f97771d,21,1309,14.5,16,9,5,9,37,15,22,32.6,14.1,18.4,19,GER
7fe12375,15,1311,14.6,14,14,1,11,27,22,5,24.1,23.3,0.8,19,GER
80f36c88,21,1356,15.1,17,9,4,10,16,24,-8,19.8,25.5,-5.8,19,GER
815c314f,23,2025,22.5,23,22,0,2,26,46,-20,26.9,39.8,-13.0,19,GER
816192f0,2,111,1.2,1,1,1,4,1,2,-1,2.1,1.6,0.5,19,GER
826e8b63,30,2569,28.5,30,24,0,1,41,50,-9,36.9,48.9,-12.0,19,GER
834d0be5,27,1265,14.1,11,5,16,6,33,16,17,22.9,18.3,4.7,19,GER
83e0eeb4,32,2880,32.0,32,32,0,1,29,66,-37,35.0,63.1,-28.2,19,GER
8494acc4,19,933,10.4,10,8,9,10,13,9,4,16.8,11.7,5.1,19,GER
857a5abe,25,2250,25.0,25,25,0,3,26,44,-18,29.0,42.1,-13.1,19,GER
8593f88c,32,2879,32.0,32,31,0,0,40,57,-17,37.1,56.8,-19.6,19,GER
861e0116,12,920,10.2,11,8,1,2,19,24,-5,13.1,18.8,-5.8,19,GER
864db10a,17,1255,13.9,15,8,2,9,30,14,16,21.6,19.7,2.0,19,GER
867501bf,30,1681,18.7,19,10,11,1,29,41,-12,27.7,34.9,-7.1,19,GER
86b30561,1,56,0.6,1,0,0,4,1,1,0,0.7,2.2,-1.4,19,GER
86e119e0,33,2872,31.9,33,26,0,0,58,46,12,44.7,45.0,-0.3,19,GER
8778c910,26,2302,25.6,26,25,0,0,71,23,48,61.1,18.6,42.5,19,GER
87fdfb9b,21,1179,13.1,17,4,4,6,6,22,-16,13.1,18.9,-5.8,19,GER
88d4144a,25,1804,20.0,20,16,5,7,24,32,-8,28.0,38.8,-10.9,19,GER
88e357ef,30,1762,19.6,21,3,9,0,51,18,33,51.8,15.2,36.6,19,GER
89565ac5,9,566,6.3,6,5,3,11,20,9,11,8.5,6.2,2.3,19,GER
89ac64a6,25,2205,24.5,25,24,0,0,60,35,25,43.2,30.3,12.9,19,GER
8b6e0db2,8,505,5.6,6,4,2,3,8,25,-17,6.0,13.5,-7.5,19,GER
8b8e759d,22,1780,19.8,20,18,2,0,33,35,-2,31.6,31.5,0.0,19,GER
8bdcb6fd,1,2,0.0,0,0,1,8,0,1,-1,0.1,0.3,-0.3,19,GER
8c8b4a01,14,941,10.5,10,8,4,0,7,18,-11,9.4,16.6,-7.3,19,GER
8d78e732,33,2957,32.9,33,31,0,1,87,31,56,84.0,25.8,58.2,19,GER
8dfdc6c3,2,55,0.6,0,0,2,5,1,1,0,2.5,1.3,1.2,19,GER
8e235926,32,2487,27.6,28,18,4,0,36,62,-26,35.5,49.7,-14.2,19,GER
8e58987d,28,2225,24.7,28,17,0,1,36,33,3,38.4,38.6,-0.2,19,GER
8ed9b33a,6,540,6.0,6,6,0,0,10,9,1,8.7,6.7,2.0,19,GER
8f0f2230,21,919,10.2,9,2,12,7,18,17,1,16.1,17.2,-1.1,19,GER
8f6bfe11,8,494,5.5,7,3,1,7,4,14,-10,5.7,8.7,-3.0,19,GER
8fa80ec8,1,90,1.0,1,1,0,3,0,0,0,0.8,0.8,0.1,19,GER
8ff2354e,28,2414,26.8,27,26,1,2,51,18,33,49.9,30.2,19.7,19,GER
9050ddc4,23,730,8.1,7,4,16,7,14,21,-7,14.7,13.5,1.1,19,GER
912e63b5,18,1435,15.9,17,12,1,1,16,33,-17,18.6,30.0,-11.4,19,GER
91cd37b7,7,197,2.2,2,0,5,2,3,5,-2,3.1,4.5,-1.4,19,GER
92432bc6,9,378,4.2,4,2,5,0,8,6,2,10.1,8.3,1.8,19,GER
92948149,10,592,6.6,7,4,3,6,8,12,-4,9.1,11.1,-2.0,19,GER
93a50d2c,13,904,10.0,11,7,2,7,18,15,3,23.3,16.1,7.2,19,GER
94c18565,8,373,4.1,5,0,3,5,5,4,1,3.7,6.0,-2.3,19,GER
9593331d,2,42,0.5,0,0,2,11,0,3,-3,0.1,1.4,-1.4,19,GER
962e54cb,11,390,4.3,4,0,7,8,10,3,7,9.7,4.9,4.8,19,GER
96f8ab0c,1,16,0.2,0,0,1,1,1,1,0,0.1,0.1,0.0,19,GER
97655ccd,2,180,2.0,2,2,0,26,3,2,1,1.6,3.4,-1.8,19,GER
97bfa797,17,461,5.1,4,1,13,10,5,6,-1,9.9,5.8,4.1,19,GER
9853983f,20,1182,13.1,12,6,8,2,13,28,-15,13.9,24.0,-10.2,19,GER
99b7584f,18,828,9.2,10,1,8,8,20,15,5,17.6,15.8,1.7,19,GER
99be8fb5,22,735,8.2,6,2,16,11,9,9,0,14.6,12.9,1.8,19,GER
99de6b6f,10,813,9.0,9,8,1,4,23,13,10,19.4,12.9,6.5,19,GER
99f7e9aa,21,1449,16.1,16,9,5,9,18,31,-13,18.8,33.2,-14.4,19,GER
9a2e0ccc,20,1249,13.9,14,3,6,2,35,16,19,31.9,16.5,15.4,19,GER
9ab16552,28,2520,28.0,28,28,0,1,52,37,15,49.5,42.0,7.4,19,GER
9ab48bde,1,90,1.0,1,1,0,0,1,0,1,1.2,0.9,0.4,19,GER
9af1f9ff,9,720,8.0,8,7,1,5,14,7,7,13.7,14.0,-0.3,19,GER
9b88e120,22,1722,19.1,19,14,3,7,13,39,-26,20.5,28.6,-8.1,19,GER
9c9bd01f,9,655,7.3,8,2,1,12,2,14,-12,7.5,11.4,-3.9,19,GER
9ceb7642,29,1909,21.2,23,12,6,4,28,37,-9,27.7,36.5,-8.8,19,GER
9d12e142,32,2880,32.0,32,32,0,0,75,40,35,56.8,36.6,20.2,19,GER
9efa1d25,26,1674,18.6,19,6,7,3,38,23,15,35.1,21.6,13.5,19,GER
9fec8860,34,3026,33.6,34,32,0,0,57,48,9,49.2,54.5,-5.4,19,GER
a0606ae8,34,3060,34.0,34,34,0,0,32,70,-38,38.0,58.2,-20.1,19,GER
a165a577,2,180,2.0,2,2,0,31,1,5,-4,2.1,5.0,-2.9,19,GER
a167537f,33,2666,29.6,30,20,3,1,64,46,18,52.6,38.7,13.9,19,GER
a2a85828,12,510,5.7,4,2,8,6,8,16,-8,6.0,11.4,-5.4,19,GER
a3ddb1b9,20,1407,15.6,15,9,5,0,10,22,-12,17.6,22.5,-4.8,19,GER
a4effc55,17,1267,14.1,15,13,2,4,37,21,16,26.6,18.4,8.2,19,GER
a4f94a0d,29,2018,22.4,24,14,5,1,20,44,-24,23.8,38.2,-14.4,19,GER
a53b661f,12,1066,11.8,12,10,0,0,15,22,-7,15.6,20.8,-5.2,19,GER
a5ae8f8e,23,1877,20.9,21,18,2,5,37,34,3,31.0,37.2,-6.2,19,GER
a5bea1fb,6,206,2.3,1,0,5,6,2,10,-8,3.3,4.7,-1.4,19,GER
a5ce09f2,23,873,9.7,7,4,16,5,15,11,4,13.3,14.6,-1.3,19,GER
a5ec3ede,14,1020,11.3,11,9,3,9,16,26,-10,18.5,23.8,-5.3,19,GER
a63a995f,29,2172,24.1,24,22,5,3,39,44,-5,38.7,42.2,-3.5,19,GER
a70b8345,2,123,1.4,1,1,1,31,4,0,4,1.2,1.8,-0.6,19,GER
a7813ac4,26,2203,24.5,26,23,0,5,30,50,-20,31.0,45.1,-14.2,19,GER
a7a9d95a,26,1211,13.5,11,3,15,2,42,21,21,27.1,12.6,14.5,19,GER
a8d4428b,10,212,2.4,1,0,9,8,6,3,3,4.2,2.9,1.3,19,GER
a92ab7be,1,90,1.0,1,1,0,27,5,1,4,0.9,1.1,-0.2,19,GER
aad48be9,22,1868,20.8,22,19,0,1,29,31,-2,31.2,39.7,-8.5,19,GER
ab700320,24,2064,22.9,23,18,1,0,35,40,-5,33.0,43.3,-10.3,19,GER
ac73ec79,19,1225,13.6,14,9,5,11,30,11,19,30.0,14.7,15.3,19,GER
acc7b7ec,2,23,0.3,0,0,2,0,2,1,1,1.0,0.7,0.3,19,GER
ad3389d5,32,2880,32.0,32,32,0,1,68,47,21,56.2,39.0,17.2,19,GER
ae961785,17,679,7.5,6,0,11,10,7,12,-5,8.2,13.4,-5.2,19,GER
aeaf1bc1,2,27,0.3,0,0,2,3,0,2,-2,0.1,0.8,-0.7,19,GER
aeda1f69,15,443,4.9,5,0,10,5,8,5,3,7.2,10.7,-3.6,19,GER
af0d79a9,12,616,6.8,7,6,5,5,5,11,-6,9.5,12.2,-2.7,19,GER
afb0c500,18,1588,17.6,18,17,0,14,19,29,-10,23.0,27.5,-4.4,19,GER
b04ee927,19,1232,13.7,16,8,3,6,9,18,-9,15.1,18.8,-3.7,19,GER
b15e93aa,4,176,2.0,2,1,2,3,6,2,4,3.9,2.8,1.0,19,GER
b1cd37e6,34,2956,32.8,33,27,1,0,57,46,11,55.5,48.3,7.1,19,GER
b3325a30,26,1729,19.2,20,7,6,1,17,22,-5,25.4,23.4,1.9,19,GER
b3b7f5a6,1,17,0.2,0,0,1,3,0,0,0,0.1,0.2,-0.1,19,GER
b48215cd,17,1251,13.9,15,6,2,0,14,28,-14,14.2,23.2,-9.0,19,GER
b500b384,26,1692,18.8,20,7,6,1,35,25,10,25.9,25.2,0.7,19,GER
b5114f85,27,2064,22.9,22,22,5,2,20,55,-35,25.1,36.6,-11.5,19,GER
b69261a0,32,2731,30.3,30,29,2,2,52,38,14,47.1,46.7,0.3,19,GER
b6a6e0a7,22,1622,18.0,19,7,3,7,29,35,-6,28.2,29.9,-1.7000000000000002,19,GER
b825a650,27,2113,23.5,25,14,2,0,47,22,25,47.1,30.2,16.9,19,GER
b82880c6,7,600,6.7,7,6,0,19,8,14,-6,9.8,11.3,-1.6,19,GER
b883006f,16,370,4.1,2,0,14,6,4,6,-2,3.6,7.1,-3.5,19,GER
b93b7882,18,941,10.5,10,4,8,1,13,16,-3,15.3,16.9,-1.6,19,GER
b956af7d,6,180,2.0,1,1,5,16,3,1,2,2.4,3.3,-0.9,19,GER
ba115a40,29,2182,24.2,23,19,6,0,48,33,15,42.5,35.2,7.4,19,GER
bb25c778,4,315,3.5,3,3,1,26,8,9,-1,5.6,7.1,-1.5,19,GER
bb8a42fa,21,1596,17.7,20,11,1,5,28,29,-1,25.9,32.6,-6.7,19,GER
bbb496b5,3,125,1.4,1,0,2,8,2,1,1,1.3,1.9,-0.7,19,GER
bc6bd723,34,2503,27.8,28,17,6,0,44,33,11,41.9,43.8,-2.0,19,GER
bcb2ccd8,33,2925,32.5,33,32,0,0,60,27,33,63.1,39.0,24.1,19,GER
bd142efb,33,2937,32.6,33,31,0,0,67,51,16,56.7,42.8,13.9,19,GER
bd7d2e6d,18,1620,18.0,18,18,0,8,14,41,-27,20.9,29.4,-8.5,19,GER
be5e1c4c,10,575,6.4,7,3,3,1,10,12,-2,9.9,13.0,-3.1,19,GER
beb882a8,34,3052,33.9,34,33,0,0,58,49,9,49.6,56.1,-6.5,19,GER
beda9675,13,425,4.7,3,0,10,4,3,11,-8,6.9,8.3,-1.4,19,GER
bee0bab1,19,1057,11.7,14,7,5,1,25,13,12,19.8,14.6,5.2,19,GER
bf075f6b,10,527,5.9,5,3,5,1,7,8,-1,7.9,8.6,-0.7,19,GER
c0dc9fc7,1,4,0.0,0,0,1,2,1,0,1,0.0,0.0,0.0,19,GER
c17bfb65,28,2130,23.7,25,15,3,0,49,32,17,50.1,37.4,12.7,19,GER
c18d22f5,3,217,2.4,2,2,1,11,2,4,-2,2.4,4.4,-2.0,19,GER
c1b7847c,29,1874,20.8,20,9,9,4,32,15,17,33.9,24.5,9.4,19,GER
c311243f,15,1025,11.4,13,8,2,7,10,18,-8,12.5,18.7,-6.1,19,GER
c3fd9887,28,1807,20.1,24,5,4,1,33,29,4,33.3,30.0,3.3,19,GER
c476b0c0,32,2880,32.0,32,32,0,0,47,62,-15,45.7,60.4,-14.7,19,GER
c4e87b8b,34,2925,32.5,33,26,1,0,60,49,11,45.4,46.1,-0.7,19,GER
c50281a0,20,1361,15.1,18,9,2,1,29,24,5,27.3,16.7,10.6,19,GER
c58a9db7,1,13,0.1,0,0,1,0,2,1,1,2.0,0.1,2.0,19,GER
c5bdb6e3,23,643,7.1,5,1,18,4,19,11,8,18.6,12.6,6.0,19,GER
c5fd13e9,9,236,2.6,1,1,8,16,7,4,3,6.1,1.6,4.5,19,GER
c6637acf,14,1006,11.2,10,7,4,0,16,19,-3,18.9,18.8,0.1,19,GER
c89e8aae,9,765,8.5,8,8,1,24,24,12,12,13.3,12.7,0.6,19,GER
c8c60119,7,519,5.8,6,5,1,3,10,11,-1,10.2,8.7,1.5,19,GER
c8cfb04d,6,296,3.3,2,2,4,9,5,8,-3,2.6,8.5,-5.9,19,GER
ca618d23,26,1006,11.2,11,1,15,6,13,19,-6,15.9,22.3,-6.4,19,GER
ca8033cb,26,2003,22.3,22,20,4,4,36,21,15,39.6,28.2,11.4,19,GER
cba16a46,22,1357,15.1,15,4,7,10,13,26,-13,16.1,20.0,-3.9,19,GER
cbac6ec9,24,2160,24.0,24,24,0,0,30,43,-13,35.3,41.5,-6.2,19,GER
cc86b9a3,30,2023,22.5,23,18,7,0,56,24,32,57.1,18.2,38.9,19,GER
cd59b9df,17,1479,16.4,17,16,0,12,21,43,-22,17.3,33.300000000000004,-16.0,19,GER
cd82452e,28,2052,22.8,21,19,7,1,37,43,-6,30.4,40.6,-10.2,19,GER
ce17b5eb,33,2937,32.6,33,32,0,0,56,48,8,56.0,48.9,7.1,19,GER
ce218223,9,455,5.1,5,3,4,14,5,15,-10,4.7,10.1,-5.4,19,GER
cf01fe3a,4,72,0.8,1,0,3,8,0,5,-5,0.3,3.4,-3.1,19,GER
d003e213,16,901,10.0,9,7,7,13,26,9,17,27.9,6.8,21.1,19,GER
d1273f09,31,2756,30.6,31,27,0,0,35,52,-17,42.8,44.8,-2.0,19,GER
d1661819,21,1875,20.8,21,20,0,1,27,31,-4,28.4,32.8,-4.4,19,GER
d2416c2e,31,2451,27.2,27,21,4,0,52,24,28,50.8,31.2,19.6,19,GER
d248cd8f,15,1293,14.4,14,14,1,3,24,17,7,27.5,17.3,10.2,19,GER
d28339cb,13,1128,12.5,12,12,1,19,10,30,-20,13.2,18.5,-5.4,19,GER
d3096421,20,956,10.6,8,4,12,4,10,21,-11,13.5,17.8,-4.3,19,GER
d453346c,2,104,1.2,1,0,1,9,5,1,4,1.7,1.9,-0.2,19,GER
d459281d,22,1660,18.4,19,16,3,6,19,44,-25,18.1,37.6,-19.6,19,GER
d4a2533d,25,1415,15.7,15,6,10,7,25,28,-3,18.4,23.4,-5.0,19,GER
d4d0a9ad,31,2675,29.7,30,28,1,0,57,44,13,44.8,41.5,3.3,19,GER
d571df78,23,1113,12.4,12,1,11,7,21,18,3,21.6,22.6,-1.0,19,GER
d6862409,24,970,10.8,12,0,12,5,11,25,-14,12.7,21.4,-8.7,19,GER
d728acae,10,616,6.8,6,6,4,15,9,16,-7,9.2,12.9,-3.7,19,GER
d73a07e2,1,9,0.1,0,0,1,1,0,2,-2,0.1,1.2,-1.1,19,GER
d781d855,6,80,0.9,0,0,6,7,3,1,2,2.6,1.4,1.2,19,GER
d9a5d930,13,656,7.3,7,3,6,10,6,10,-4,10.2,9.8,0.4,19,GER
db401046,26,2295,25.5,26,25,0,0,40,39,1,34.3,35.6,-1.3,19,GER
db4ed67b,14,697,7.7,7,4,7,17,22,14,8,16.1,11.0,5.0,19,GER
db7161ed,7,113,1.3,1,0,6,15,1,2,-1,1.7,2.5,-0.8,19,GER
dbf053da,34,2461,27.3,26,17,8,0,70,36,34,51.4,32.7,18.6,19,GER
dc29b608,2,135,1.5,1,1,1,19,3,2,1,2.6,1.5,1.1,19,GER
dc3fa3b5,26,2055,22.8,24,16,2,3,40,18,22,42.4,25.3,17.1,19,GER
dc62b55d,25,853,9.5,9,2,16,9,13,8,5,18.1,11.8,6.3,19,GER
dc62fbee,21,1069,11.9,13,5,8,8,16,21,-5,21.9,19.8,2.1,19,GER
dd669209,31,1503,16.7,18,3,13,2,29,28,1,22.8,23.2,-0.4,19,GER
de164de6,17,1095,12.2,14,9,3,1,9,22,-13,11.5,24.6,-13.0,19,GER
debc2f28,16,525,5.8,5,0,11,5,7,12,-5,6.4,8.5,-2.2,19,GER
df8e7b62,19,794,8.8,6,0,13,11,3,22,-19,9.4,16.8,-7.3,19,GER
dfb6490a,24,1079,12.0,10,3,14,6,17,17,0,15.9,15.0,0.8,19,GER
dfc85b89,1,90,1.0,1,1,0,1,1,8,-7,1.0,3.6,-2.6,19,GER
e12b0b5b,12,923,10.3,12,4,0,0,17,8,9,16.8,14.3,2.5,19,GER
e199d5b0,34,3049,33.9,34,33,0,0,49,65,-16,46.9,62.3,-15.3,19,GER
e26c4233,5,380,4.2,3,3,2,18,10,5,5,8.2,6.7,1.5,19,GER
e26fcca3,27,2428,27.0,27,25,0,0,27,55,-28,30.5,46.2,-15.7,19,GER
e27da244,29,2610,29.0,29,29,0,0,46,43,3,40.4,41.0,-0.7,19,GER
e280527c,30,2352,26.1,26,20,4,1,51,18,33,51.9,31.1,20.8,19,GER
e33c06cf,31,2654,29.5,29,29,2,3,73,29,44,75.2,22.7,52.5,19,GER
e385200c,1,90,1.0,1,1,0,16,1,2,-1,1.0,1.7,-0.7,19,GER
e3f6253d,19,1222,13.6,13,12,6,11,9,32,-23,14.5,22.8,-8.2,19,GER
e4086af3,2,162,1.8,2,1,0,1,1,3,-2,2.6,1.4,1.2,19,GER
e42d61c7,21,1740,19.3,19,18,2,6,53,23,30,38.7,20.7,18.0,19,GER
e4a30d8c,2,180,2.0,2,2,0,8,2,3,-1,1.4,1.9,-0.6,19,GER
e5649a78,25,2118,23.5,24,20,1,6,41,46,-5,34.8,42.6,-7.8,19,GER
e5a35ae9,30,1717,19.1,16,5,14,2,29,35,-6,25.5,33.0,-7.5,19,GER
e5be34dd,1,25,0.3,0,0,1,0,0,2,-2,0.2,1.6,-1.3,19,GER
e5d85da8,20,1414,15.7,17,4,3,1,14,27,-13,17.4,29.0,-11.6,19,GER
e5f63987,24,1276,14.2,12,5,12,0,30,16,14,20.8,16.8,4.0,19,GER
e665a2db,1,62,0.7,1,0,0,1,0,1,-1,0.1,1.1,-1.0,19,GER
e6c15f6e,2,94,1.0,1,1,1,4,3,2,1,2.2,0.5,1.7,19,GER
e6c43eec,19,1570,17.4,18,16,1,0,35,26,9,22.2,24.3,-2.1,19,GER
e7d22eae,13,757,8.4,7,2,6,5,14,22,-8,10.0,14.6,-4.6,19,GER
e7d59f4f,18,1082,12.0,12,5,6,7,12,20,-8,14.8,16.1,-1.3,19,GER
ea6bc03a,24,1901,21.1,21,21,3,4,31,35,-4,27.8,35.9,-8.1,19,GER
eafac393,10,646,7.2,7,6,3,9,9,16,-7,8.2,16.9,-8.6,19,GER
eb61713c,1,3,0.0,0,0,1,0,0,0,0,0.0,0.2,-0.1,19,GER
ecab64a0,16,997,11.1,12,8,4,11,14,14,0,16.4,19.1,-2.7,19,GER
ee7cdd0c,6,126,1.4,0,0,6,10,4,5,-1,3.5,2.3,1.2,19,GER
f24ea523,28,2133,23.7,22,20,6,1,23,46,-23,28.0,47.4,-19.4,19,GER
f2571c91,32,2765,30.7,32,29,0,0,23,62,-39,32.1,44.9,-12.8,19,GER
f261abcb,33,2815,31.3,33,24,0,0,46,59,-13,41.3,56.3,-15.0,19,GER
f26834c7,26,1161,12.9,11,6,15,5,21,24,-3,24.2,23.3,0.9,19,GER
f35430a4,28,2449,27.2,28,26,0,3,32,43,-11,36.2,41.7,-5.4,19,GER
f3722c97,21,701,7.8,5,2,16,12,16,15,1,14.2,12.6,1.6,19,GER
f3cccffe,27,2114,23.5,24,18,3,4,24,47,-23,24.5,37.2,-12.8,19,GER
f4081572,20,1476,16.4,19,6,1,9,21,27,-6,21.2,30.2,-9.0,19,GER
f521b80a,27,2379,26.4,27,26,0,0,44,37,7,41.4,41.4,0.0,19,GER
f61c7c4e,25,1174,13.0,10,2,15,2,31,13,18,33.1,11.0,22.0,19,GER
f69fba57,21,1346,15.0,15,5,6,1,20,22,-2,20.7,25.0,-4.3,19,GER
f6bdc830,9,773,8.6,8,8,1,4,6,21,-15,8.5,17.8,-9.3,19,GER
f7097e8a,2,19,0.2,0,0,2,3,0,2,-2,0.7,0.1,0.6,19,GER
f765bb88,3,25,0.3,0,0,3,0,1,2,-1,0.2,0.4,-0.2,19,GER
f7aa75bd,22,1924,21.4,22,20,0,8,32,35,-3,32.9,36.9,-4.0,19,GER
f820504e,16,1121,12.5,13,10,3,15,16,23,-7,18.6,17.5,1.1,19,GER
f86ad3f5,7,474,5.3,5,4,2,27,11,9,2,6.8,10.0,-3.2,19,GER
f86cabbd,14,1158,12.9,13,10,1,8,21,16,5,17.3,17.8,-0.6,19,GER
f93e6e94,24,1929,21.4,20,18,4,1,36,32,4,26.6,36.6,-10.0,19,GER
f9446dcd,32,2832,31.5,32,27,0,0,53,47,6,45.6,50.9,-5.3,19,GER
f956479d,5,160,1.8,2,0,3,8,3,4,-1,2.5,3.5,-1.0,19,GER
f972644c,25,1426,15.8,17,4,8,5,29,35,-6,23.0,30.1,-7.1,19,GER
f99fe221,9,544,6.0,7,4,2,8,4,8,-4,6.7,6.7,0.0,19,GER
f9acca3a,28,2277,25.3,25,22,3,5,54,39,15,43.3,34.1,9.2,19,GER
f9e7c4ac,18,1335,14.8,17,5,1,0,22,24,-2,23.9,21.2,2.7,19,GER
fa274d97,30,2537,28.2,29,23,1,1,53,48,5,61.8,45.0,16.7,19,GER
fa661778,16,828,9.2,10,4,6,3,15,9,6,12.7,10.2,2.6,19,GER
faf55ce4,22,1683,18.7,17,17,5,10,14,47,-33,19.3,39.5,-20.2,19,GER
fbbc8e15,3,155,1.7,3,0,0,1,3,3,0,3.4,3.0,0.5,19,GER
fbefefdb,4,360,4.0,4,4,0,13,6,7,-1,5.8,6.7,-0.9,19,GER
fbffc4b1,9,624,6.9,7,6,2,4,6,16,-10,6.8,14.3,-7.5,19,GER
fc62f087,28,2379,26.4,27,24,1,0,58,38,20,47.2,32.3,14.9,19,GER
fe2db476,20,1756,19.5,20,17,0,3,42,23,19,34.1,23.4,10.7,19,GER
fe641c1a,30,2283,25.4,27,19,3,2,54,26,28,41.8,27.7,14.1,19,GER
fe888e39,1,27,0.3,0,0,1,4,0,0,0,0.1,2.7,-2.6,19,GER
fed7cb61,34,2894,32.2,33,27,1,0,65,49,16,56.6,41.4,15.2,19,GER
ff182fdc,28,1863,20.7,20,13,8,5,45,28,17,49.4,29.0,20.4,19,GER
ff45add5,23,1532,17.0,16,14,7,4,15,40,-25,19.5,34.2,-14.7,19,GER
ffbbc83b,30,2394,26.6,27,23,3,1,51,43,8,56.7,42.4,14.4,19,GER
00459419,28,1990,22.1,24,10,4,0,28,33,-5,27.4,33.4,-6.0,19,ENG
00963611,4,148,1.6,3,0,1,3,1,1,0,2.9,2.4,0.5,19,ENG
01226327,24,2160,24.0,24,24,0,1,26,42,-16,32.1,34.2,-2.1,19,ENG
02b29014,35,3062,34.0,34,33,1,0,51,56,-5,45.3,52.8,-7.5,19,ENG
03e48abb,2,75,0.8,0,0,2,6,1,1,0,0.9,1.0,-0.1,19,ENG
0420d84f,29,2558,28.4,29,27,0,3,43,30,13,37.3,34.4,2.9,19,ENG
0442183b,18,1254,13.899999999999999,14,10,4,3,22,26,-4,20.2,20.2,0.0,19,ENG
059948df,3,112,1.2,1,1,2,7,1,1,0,1.0,2.7,-1.7,19,ENG
074d8166,2,23,0.3,0,0,2,2,2,2,0,1.0,1.2,-0.2,19,ENG
07802f7f,24,1651,18.3,23,5,1,2,23,27,-4,25.2,20.5,4.7,19,ENG
07ace8c3,3,52,0.6,0,0,3,5,0,1,-1,1.3,0.5,0.8,19,ENG
08452314,19,1020,11.3,12,3,7,5,11,16,-5,8.6,18.5,-9.9,19,ENG
08aa17d0,6,466,5.2,5,4,1,3,7,5,2,9.5,4.8,4.7,19,ENG
099e666f,10,791,8.8,8,7,2,6,8,15,-7,9.4,10.6,-1.2,19,ENG
09fec029,34,3039,33.8,34,33,0,0,28,63,-35,37.4,54.8,-17.4,19,ENG
0bad4516,34,3060,34.0,34,34,0,2,44,38,6,49.5,36.5,13.0,19,ENG
0d267745,18,1236,13.7,14,13,4,17,36,7,29,35.2,7.5,27.6,19,ENG
0d4ceb32,13,318,3.5,3,0,10,21,6,7,-1,4.2,8.1,-3.9,19,ENG
0d85a4e8,7,630,7.0,7,7,0,15,10,20,-10,7.6,15.4,-7.8,19,ENG
0db5d2c8,24,2147,23.9,24,23,0,7,11,38,-27,16.9,32.8,-15.9,19,ENG
0f7533cd,27,1424,15.8,16,7,11,11,19,30,-11,17.6,25.9,-8.3,19,ENG
101da2b5,29,2377,26.4,27,21,2,0,70,15,55,61.2,18.4,42.8,19,ENG
10efd0e1,32,2244,24.9,27,14,5,2,26,54,-28,30.2,44.3,-14.1,19,ENG
111c3236,11,725,8.1,8,5,3,6,22,9,13,18.9,8.4,10.5,19,ENG
119b9a8e,35,3057,34.0,34,33,1,1,88,21,67,73.2,22.5,50.7,19,ENG
11b9265b,2,154,1.7,2,1,0,16,5,2,3,3.0,1.6,1.4,19,ENG
129af0db,16,941,10.5,11,4,5,1,15,11,4,15.5,10.1,5.4,19,ENG
12aa7661,28,2393,26.6,27,25,1,3,37,39,-2,36.0,39.6,-3.6,19,ENG
12c50af5,4,71,0.8,0,0,4,4,1,1,0,0.1,2.0,-1.9,19,ENG
1598599e,31,2092,23.2,23,19,8,4,31,29,2,30.1,28.0,2.1,19,ENG
15d561fa,1,18,0.2,0,0,1,4,0,0,0,0.5,0.2,0.3,19,ENG
15ea812b,35,3086,34.3,35,34,0,1,42,63,-21,41.3,55.5,-14.2,19,ENG
15f3ec41,10,393,4.4,4,1,6,3,10,5,5,7.8,4.1,3.8,19,ENG
16380240,24,1735,19.3,20,10,4,3,35,24,11,29.6,26.2,3.4,19,ENG
165bed61,5,245,2.7,3,0,2,4,4,2,2,2.5,4.2,-1.7,19,ENG
16ceb862,27,847,9.4,7,2,20,9,24,5,19,19.5,8.9,10.6,19,ENG
17370b95,22,1752,19.5,19,18,3,12,17,29,-12,16.5,23.6,-7.1,19,ENG
1770bd68,17,754,8.4,9,1,8,14,12,9,3,10.2,10.6,-0.3,19,ENG
178ae8f8,33,2355,26.2,29,9,4,0,32,29,3,35.1,27.1,8.0,19,ENG
189cee7b,25,1334,14.8,14,2,11,4,27,20,7,20.7,24.2,-3.5,19,ENG
18b896d6,33,2871,31.9,33,30,0,2,50,35,15,46.4,31.7,14.7,19,ENG
18b999f4,7,108,1.2,0,0,7,14,0,3,-3,0.5,3.0,-2.5,19,ENG
1900032e,23,2027,22.5,23,20,0,7,29,31,-2,26.1,31.5,-5.4,19,ENG
1931bde9,5,405,4.5,5,3,0,5,2,6,-4,2.9,4.2,-1.3,19,ENG
1961b2aa,27,1980,22.0,24,15,3,0,28,28,0,28.8,30.7,-1.9,19,ENG
19b8b0b9,2,39,0.4,0,0,2,2,1,2,-1,0.7,0.6,0.1,19,ENG
19ba6c6d,31,1778,19.8,19,8,12,2,12,36,-24,14.5,26.1,-11.6,19,ENG
1a2935f6,13,986,11.0,11,10,2,6,30,7,23,21.5,8.7,12.7,19,ENG
1a4ef233,9,641,7.1,7,6,2,1,10,9,1,7.0,8.2,-1.2,19,ENG
1ae30132,19,1670,18.6,19,17,0,12,22,27,-5,23.8,28.0,-4.2,19,ENG
1b7ec703,18,509,5.7,4,3,14,17,17,5,12,10.7,6.3,4.4,19,ENG
1b84dbe1,35,2965,32.9,33,31,2,1,46,38,8,44.1,38.7,5.4,19,ENG
1bebde9d,2,180,2.0,2,2,0,4,2,4,-2,1.6,3.0,-1.4,19,ENG
1c7012b8,34,3003,33.4,34,32,0,2,47,47,0,41.8,55.8,-14.0,19,ENG
1cb49278,8,617,6.9,6,6,2,22,16,7,9,13.0,5.6,7.4,19,ENG
1d6ac165,20,915,10.2,10,2,10,4,8,20,-12,8.6,21.2,-12.7,19,ENG
1d8c99b0,18,1302,14.5,14,10,4,6,17,20,-3,15.5,20.6,-5.1,19,ENG
1e0b6a73,17,1229,13.7,13,12,4,1,19,24,-5,17.7,20.4,-2.7,19,ENG
1ecb65be,37,2119,23.5,24,8,13,1,36,33,3,27.8,29.2,-1.4,19,ENG
1f9a3a04,32,2716,30.2,32,26,0,2,20,65,-45,23.0,50.2,-27.2,19,ENG
20b104bc,25,2066,23.0,25,18,0,0,37,32,5,34.6,30.9,3.6,19,ENG
21166ff4,6,372,4.1,4,3,2,9,5,4,1,8.0,4.9,3.2,19,ENG
21512407,27,2276,25.3,26,23,1,4,43,23,20,35.2,29.7,5.4,19,ENG
21a66f6a,28,2424,26.9,27,23,1,0,50,31,19,38.7,33.7,5.1,19,ENG
24396398,13,375,4.2,3,2,10,13,8,6,2,6.0,8.0,-2.1,19,ENG
2513a588,20,986,11.0,10,3,10,10,14,21,-7,15.1,19.9,-4.8,19,ENG
2628fd2b,32,2836,31.5,31,31,1,6,61,42,19,51.6,46.6,5.1,19,ENG
2642bf6c,38,3420,38.0,38,38,0,0,34,69,-35,42.4,61.5,-19.1,19,ENG
26679cdf,18,940,10.4,9,7,9,19,8,17,-9,6.9,20.2,-13.3,19,ENG
2691c772,37,2388,26.5,26,16,11,1,35,41,-6,34.9,39.2,-4.4,19,ENG
2696b6a9,2,38,0.4,0,0,2,1,0,1,-1,1.2,0.5,0.7,19,ENG
26f6dca8,10,686,7.6,8,4,2,0,13,12,1,8.9,14.3,-5.4,19,ENG
282f75f3,36,3151,35.0,36,34,0,0,31,55,-24,32.0,55.2,-23.2,19,ENG
2876eaa3,2,28,0.3,0,0,2,5,0,2,-2,0.1,0.4,-0.3,19,ENG
28b40c9c,26,2047,22.7,25,20,1,5,18,49,-31,24.6,39.4,-14.8,19,ENG
28d596a0,36,3240,36.0,36,36,0,2,61,39,22,56.4,35.4,21.1,19,ENG
2928dca2,38,3420,38.0,38,38,0,0,47,46,1,52.1,42.1,10.1,19,ENG
29733c72,22,1289,14.3,16,5,6,11,28,15,13,23.1,19.5,3.5,19,ENG
2973d8ff,11,750,8.3,9,1,2,3,18,11,7,12.4,9.6,2.8,19,ENG
2acd49b9,29,2330,25.9,27,19,2,1,45,28,17,35.9,33.5,2.4,19,ENG
2afc7272,13,723,8.0,8,5,5,2,15,10,5,13.1,12.4,0.7,19,ENG
2b114be3,31,1867,20.7,21,11,10,6,54,14,40,49.8,14.2,35.7,19,ENG
2b471f99,21,1613,17.9,18,13,3,2,16,37,-21,21.8,27.7,-5.9,19,ENG
2b622f01,32,2121,23.6,25,12,7,4,40,18,22,34.4,27.5,6.8,19,ENG
2b91cf8e,11,858,9.5,9,8,2,9,9,15,-6,7.7,14.7,-7.0,19,ENG
2c0f8e9e,20,880,9.8,9,1,11,3,19,10,9,16.5,14.9,1.6,19,ENG
2ce2508a,38,3420,38.0,38,38,0,0,51,53,-2,47.6,50.1,-2.5,19,ENG
2e4f5f03,36,3216,35.7,36,33,0,1,81,20,61,68.2,27.0,41.1,19,ENG
2f4c5a52,25,1997,22.2,24,12,1,2,20,39,-19,24.8,30.6,-5.7,19,ENG
2f7acede,26,1597,17.7,17,14,9,2,34,17,17,25.1,20.7,4.4,19,ENG
2f90f6b8,31,1789,19.9,19,11,12,2,45,12,33,38.1,15.1,23.0,19,ENG
2ff964a0,16,1215,13.5,14,10,2,0,12,22,-10,10.9,24.5,-13.6,19,ENG
31dce0c8,3,39,0.4,0,0,3,2,1,0,1,0.4,0.5,-0.1,19,ENG
3201b03d,6,292,3.2,3,1,3,7,4,4,0,3.9,3.8,0.1,19,ENG
321a71a7,26,2250,25.0,25,23,1,8,27,53,-26,29.9,44.0,-14.1,19,ENG
3233eefd,7,331,3.7,4,3,3,6,5,2,3,5.5,2.4,3.1,19,ENG
32f60ed8,26,663,7.4,5,0,21,10,10,12,-2,12.7,10.5,2.2,19,ENG
3312f911,30,1670,18.6,18,11,12,4,23,26,-3,24.1,28.0,-4.0,19,ENG
33508c78,6,180,2.0,1,1,5,9,2,2,0,3.7,0.8,2.9,19,ENG
33af5b9e,32,2141,23.8,23,13,9,3,18,46,-28,25.6,41.8,-16.2,19,ENG
34ccf6fa,12,1080,12.0,12,12,0,26,20,18,2,17.5,17.9,-0.4,19,ENG
3515d404,26,1945,21.6,21,19,5,9,28,41,-13,27.2,33.3,-6.0,19,ENG
356a9a62,3,185,2.1,2,1,1,9,2,5,-3,1.6,4.5,-3.0,19,ENG
3626f7d9,23,2013,22.4,23,22,0,4,33,32,1,30.0,33.9,-3.9,19,ENG
36c2ca73,25,2250,25.0,25,25,0,8,28,44,-16,30.7,36.8,-6.1,19,ENG
3727dd3c,16,948,10.5,10,8,6,7,11,13,-2,11.4,14.7,-3.3,19,ENG
3730fcbc,28,1959,21.8,22,16,6,3,14,40,-26,21.7,39.1,-17.4,19,ENG
381d7d54,4,29,0.3,0,0,4,3,0,2,-2,0.1,1.5,-1.3,19,ENG
3831b9fe,3,228,2.5,3,1,0,12,3,6,-3,3.2,2.5,0.6,19,ENG
38c7feef,2,21,0.2,0,0,2,1,1,0,1,1.8,0.0,1.8,19,ENG
3925dbd6,37,3280,36.4,37,35,0,0,33,78,-45,39.7,64.0,-24.2,19,ENG
3935e52e,24,1887,21.0,22,16,2,5,37,29,8,32.3,29.2,3.2,19,ENG
39583cfd,30,2066,23.0,26,6,4,0,34,29,5,29.2,32.4,-3.1,19,ENG
3a24769f,27,1245,13.8,13,3,14,9,28,13,15,23.8,10.9,12.9,19,ENG
3a949a25,38,3420,38.0,38,38,0,0,42,48,-6,39.1,53.6,-14.5,19,ENG
3bb7b8b4,38,3420,38.0,38,38,0,0,95,23,72,84.3,24.7,59.6,19,ENG
3be1a627,1,38,0.4,0,0,1,3,1,2,-1,1.5,0.6,0.9,19,ENG
3ca7254a,31,1778,19.8,21,9,10,2,31,19,12,29.9,18.6,11.4,19,ENG
3e5e4e63,31,2786,31.0,31,30,0,0,48,56,-8,44.4,47.8,-3.5,19,ENG
3ea50f67,16,1004,11.2,11,3,5,1,19,16,3,21.0,11.2,9.8,19,ENG
3eb22ec9,36,2854,31.7,31,27,5,1,78,22,56,69.6,22.3,47.3,19,ENG
3f2d59fe,31,2611,29.0,31,25,0,4,51,40,11,45.7,43.1,2.6,19,ENG
3fe6bd8c,26,1990,22.1,21,20,5,2,23,27,-4,19.8,30.3,-10.5,19,ENG
4047c976,13,693,7.7,5,3,8,4,5,17,-12,10.5,12.7,-2.2,19,ENG
4115ce4e,25,2151,23.9,24,23,1,1,32,37,-5,28.8,34.1,-5.2,19,ENG
41cc19c2,6,67,0.7,0,0,6,4,2,1,1,2.2,1.1,1.1,19,ENG
41fb0f4e,8,338,3.8,3,1,5,11,8,5,3,6.7,5.9,0.8,19,ENG
422862ea,9,270,3.0,3,1,6,11,1,7,-6,3.0,5.5,-2.5,19,ENG
43458538,35,2961,32.9,34,20,1,0,48,57,-9,44.1,46.5,-2.5,19,ENG
436a9dd0,22,1403,15.6,16,9,6,3,33,18,15,27.5,20.8,6.7,19,ENG
43a166b4,12,371,4.1,4,1,8,13,11,2,9,7.8,2.9,4.9,19,ENG
44361ade,4,34,0.4,0,0,4,4,1,1,0,0.6,1.5,-0.9,19,ENG
4468ec10,34,1985,22.1,23,5,11,1,32,29,3,31.8,23.6,8.2,19,ENG
44781702,27,1844,20.5,20,18,7,7,36,26,10,29.5,23.8,5.6,19,ENG
44bfb6c5,35,3007,33.4,34,31,1,2,41,43,-2,45.9,36.7,9.2,19,ENG
450ab6fc,32,2745,30.5,32,29,0,1,29,36,-7,30.7,41.9,-11.2,19,ENG
4535e4bb,34,3060,34.0,34,34,0,0,31,55,-24,32.4,53.2,-20.9,19,ENG
45963054,34,2726,30.3,30,17,4,0,45,36,9,44.5,34.9,9.6,19,ENG
45da6694,18,1520,16.9,17,15,1,4,26,22,4,17.1,24.8,-7.8,19,ENG
45db685d,37,3156,35.1,37,28,0,1,57,37,20,52.8,34.6,18.2,19,ENG
46b5375e,1,1,0.0,0,0,1,0,0,0,0,0.1,0.0,0.1,19,ENG
4701e130,1,1,0.0,0,0,1,0,0,0,0,0.0,0.0,0.0,19,ENG
47a34c4f,8,380,4.2,5,1,3,21,7,5,2,6.0,5.9,0.1,19,ENG
47b7e3af,29,2330,25.9,25,24,4,0,18,48,-30,20.8,38.5,-17.6,19,ENG
4806ec67,38,3420,38.0,38,38,0,0,54,46,8,49.7,45.7,4.0,19,ENG
4830e0af,2,48,0.5,1,0,1,0,1,3,-2,0.6,1.5,-0.9,19,ENG
495945ef,34,2824,31.4,31,30,3,3,44,55,-11,39.0,48.7,-9.7,19,ENG
4b511457,31,2136,23.7,25,15,6,2,29,37,-8,28.2,35.0,-6.8,19,ENG
4b6bcb0d,2,69,0.8,1,0,1,2,2,1,1,0.4,1.8,-1.4,19,ENG
4c370d81,34,2607,29.0,31,15,3,0,65,15,50,55.6,20.2,35.4,19,ENG
4d034881,33,2459,27.3,31,8,2,1,72,15,57,58.9,17.7,41.2,19,ENG
4e015693,1,1,0.0,0,0,1,1,0,0,0,0.0,0.0,0.0,19,ENG
4e9a0555,38,2588,28.8,29,13,9,0,35,49,-14,34.1,42.7,-8.6,19,ENG
4f974391,20,1589,17.7,18,16,2,7,21,26,-5,19.7,25.2,-5.5,19,ENG
50b51fac,7,245,2.7,2,2,5,0,1,4,-3,2.8,3.7,-1.0,19,ENG
51b41c5c,14,834,9.3,10,7,4,5,16,9,7,12.5,6.4,6.1,19,ENG
51cf8561,14,1151,12.8,14,12,0,7,29,4,25,27.3,5.4,22.0,19,ENG
52105203,10,663,7.4,7,7,3,9,16,10,6,10.5,11.0,-0.5,19,ENG
52611641,34,2382,26.5,24,20,10,0,55,38,17,41.0,38.0,3.0,19,ENG
5271c8f1,10,900,10.0,10,10,0,1,29,6,23,22.7,7.2,15.5,19,ENG
531a4aa8,23,1712,19.0,20,14,3,1,27,29,-2,22.2,25.9,-3.7,19,ENG
5343eb4e,17,524,5.8,5,1,12,10,6,10,-4,7.4,9.8,-2.4,19,ENG
53af52f3,38,3420,38.0,38,38,0,0,51,48,3,52.4,43.7,8.7,19,ENG
53cad200,38,3402,37.8,38,37,0,0,63,39,24,58.5,36.1,22.4,19,ENG
5534217d,28,2474,27.5,28,27,0,1,25,52,-27,30.2,42.7,-12.5,19,ENG
56f7a928,13,1086,12.1,13,7,0,0,19,14,5,19.0,12.2,6.8,19,ENG
57df7a11,23,1759,19.5,19,18,4,12,31,29,2,27.9,33.6,-5.6,19,ENG
58eee997,3,117,1.3,1,1,2,0,1,2,-1,2.6,2.1,0.5,19,ENG
59e6e5bf,35,1784,19.8,19,13,16,2,29,26,3,27.5,21.7,5.8,19,ENG
5a4280b1,6,514,5.7,5,5,1,23,4,9,-5,4.7,9.8,-5.1,19,ENG
5a7301ae,19,1467,16.3,17,13,2,8,22,21,1,22.4,20.4,2.0,19,ENG
5acc4a10,33,2944,32.7,33,30,0,0,44,48,-4,39.9,49.3,-9.4,19,ENG
5bddccc9,20,1182,13.1,13,7,7,10,4,30,-26,9.7,23.3,-13.5,19,ENG
5c2b4f07,8,564,6.3,6,4,2,11,12,9,3,9.8,7.5,2.3,19,ENG
5cec2487,25,2167,24.1,24,24,1,0,25,41,-16,23.3,37.7,-14.4,19,ENG
5e508d0d,19,753,8.4,7,2,12,6,8,19,-11,9.6,17.2,-7.6,19,ENG
5ea8ef20,33,2149,23.9,23,19,10,4,47,32,15,38.1,32.9,5.2,19,ENG
5eae500a,32,2136,23.7,22,18,10,1,38,38,0,35.8,33.9,1.9,19,ENG
5eebbfdf,25,1348,15.0,14,7,11,3,14,18,-4,15.3,22.0,-6.7,19,ENG
5eecec3d,24,1764,19.6,20,18,4,10,48,15,33,41.5,14.9,26.7,19,ENG
5ef608f7,1,45,0.5,1,0,0,1,0,0,0,0.2,0.5,-0.3,19,ENG
5f0241b2,29,2610,29.0,29,29,0,6,23,56,-33,31.5,49.0,-17.4,19,ENG
5f09991f,36,3195,35.5,36,33,0,2,44,46,-2,44.1,46.3,-2.2,19,ENG
601ef102,2,24,0.3,0,0,2,5,0,1,-1,0.7,0.6,0.0,19,ENG
6250083a,8,220,2.4,2,0,6,13,4,1,3,2.3,4.4,-2.1,19,ENG
6265208f,16,596,6.6,5,4,11,12,3,15,-12,5.2,12.7,-7.5,19,ENG
63d17038,3,270,3.0,3,3,0,32,4,2,2,5.0,3.1,2.0,19,ENG
6421ec64,24,1064,11.8,11,4,13,13,34,6,28,24.1,9.6,14.5,19,ENG
6438d426,16,1251,13.9,15,5,1,0,14,26,-12,17.6,25.5,-7.9,19,ENG
645a3363,2,27,0.3,0,0,2,1,0,1,-1,0.5,0.5,0.0,19,ENG
64b08de7,1,15,0.2,0,0,1,6,0,0,0,0.0,0.0,0.0,19,ENG
653ee42d,30,2485,27.6,29,26,1,1,26,45,-19,26.3,44.5,-18.2,19,ENG
65585e3a,12,552,6.1,6,1,6,6,2,16,-14,3.9,11.4,-7.5,19,ENG
6639e500,15,599,6.7,6,1,9,9,8,13,-5,8.9,9.6,-0.7,19,ENG
6813ac34,26,2092,23.2,23,20,3,7,35,35,0,30.8,33.4,-2.7,19,ENG
68796d61,21,288,3.2,1,0,20,8,7,4,3,4.8,4.1,0.7,19,ENG
68dc0dac,16,793,8.8,8,3,8,8,8,10,-2,12.2,9.3,2.9,19,ENG
6992791d,23,1031,11.5,11,3,12,0,12,24,-12,15.4,17.4,-2.0,19,ENG
6a189491,1,5,0.1,0,0,1,2,0,0,0,0.0,0.2,-0.2,19,ENG
6aa3e78b,35,2300,25.6,26,19,9,1,23,60,-37,28.7,48.8,-20.1,19,ENG
6adbc307,24,1700,18.9,19,17,5,8,18,35,-17,21.7,28.4,-6.7,19,ENG
6b47c5db,38,3296,36.6,37,33,1,0,48,47,1,49.4,42.4,6.9,19,ENG
6bb2c084,22,1517,16.9,16,9,6,4,13,32,-19,18.3,29.3,-11.0,19,ENG
6c203af0,28,1774,19.7,17,11,11,6,16,32,-16,16.9,30.8,-13.8,19,ENG
6c679c6d,30,1837,20.4,18,10,12,4,20,38,-18,17.7,34.6,-16.9,19,ENG
6c7762c3,12,888,9.9,10,9,2,11,22,11,11,15.9,14.4,1.5,19,ENG
6ca5ec4b,35,1970,21.9,22,7,13,1,42,32,10,37.8,30.9,6.9,19,ENG
6cafd68d,5,362,4.0,4,4,1,1,3,10,-7,3.1,7.1,-4.0,19,ENG
6cc47ae1,26,1236,13.7,12,7,14,9,11,21,-10,14.9,20.6,-5.6,19,ENG
6cdd8245,13,478,5.3,4,3,9,2,6,7,-1,5.7,12.7,-7.0,19,ENG
6d5701f2,13,892,9.9,10,9,3,6,15,13,2,14.9,15.9,-1.1,19,ENG
6d6f09dc,7,212,2.4,2,0,5,3,4,6,-2,4.2,2.8,1.3,19,ENG
6eaed4eb,12,1054,11.7,12,11,0,1,16,13,3,14.1,14.7,-0.5,19,ENG
71672fa0,7,584,6.5,7,6,0,29,12,9,3,8.4,7.6,0.8,19,ENG
71a08f97,15,841,9.3,10,5,5,4,10,26,-16,7.2,19.6,-12.4,19,ENG
71ef519e,36,2928,32.5,35,21,1,0,35,40,-5,31.9,44.1,-12.2,19,ENG
723ba189,1,45,0.5,0,0,1,1,0,1,-1,0.1,0.7,-0.6,19,ENG
72a0fb65,38,3376,37.5,37,37,1,0,34,67,-33,42.1,59.8,-17.7,19,ENG
72c812f3,33,2822,31.4,32,28,1,0,41,31,10,41.2,37.4,3.9,19,ENG
7314bba4,35,3087,34.3,35,34,0,0,32,54,-22,32.7,54.1,-21.4,19,ENG
73489527,6,448,5.0,6,2,0,3,3,14,-11,3.2,11.8,-8.5,19,ENG
73d9bdc7,6,92,1.0,0,0,6,3,3,3,0,4.2,2.0,2.2,19,ENG
74b2cd7e,24,1874,20.8,20,20,4,12,24,36,-12,23.5,39.2,-15.7,19,ENG
74e12f1e,37,3312,36.8,37,36,0,0,43,63,-20,43.2,58.9,-15.7,19,ENG
758dd7f0,18,1101,12.2,12,10,6,17,14,16,-2,13.4,17.6,-4.2,19,ENG
75a72a99,35,3123,34.7,35,33,0,3,46,45,1,47.5,39.4,8.2,19,ENG
75f2c59f,33,2815,31.3,33,23,0,0,42,53,-11,42.1,47.9,-5.8,19,ENG
76c131da,1,5,0.1,0,0,1,2,1,0,1,0.6,0.0,0.6,19,ENG
76dd1480,38,3117,34.6,36,17,2,0,51,41,10,46.9,40.2,6.7,19,ENG
76eca7e2,18,1576,17.5,17,17,1,15,16,26,-10,19.4,23.3,-3.9,19,ENG
76fa5f80,6,403,4.5,4,2,2,11,7,9,-2,6.1,9.1,-3.0,19,ENG
77128f7e,1,3,0.0,0,0,1,1,0,0,0,0.0,0.0,0.0,19,ENG
78803d03,14,1131,12.6,14,9,0,9,10,17,-7,11.2,19.1,-7.9,19,ENG
78e68b4d,8,594,6.6,5,5,3,18,7,10,-3,5.9,8.7,-2.7,19,ENG
7914b9fe,2,24,0.3,0,0,2,8,0,0,0,0.5,0.3,0.2,19,ENG
79b0d6a0,37,3329,37.0,37,36,0,0,45,46,-1,49.3,41.5,7.8,19,ENG
79c0821a,32,1735,19.3,21,2,11,4,26,19,7,26.1,20.9,5.2,19,ENG
7a11550b,16,1063,11.8,12,11,4,2,17,4,13,20.8,9.6,11.2,19,ENG
7a2e46a8,38,3420,38.0,38,38,0,0,89,22,67,73.7,28.8,44.9,19,ENG
7b4de647,24,2160,24.0,24,24,0,12,32,47,-15,32.4,35.7,-3.2,19,ENG
7ba6d84e,38,3420,38.0,38,38,0,0,65,54,11,61.4,50.6,10.8,19,ENG
7c104bb7,21,618,6.9,3,2,18,9,13,8,5,12.4,8.7,3.7,19,ENG
7d2d3329,9,595,6.6,7,4,2,4,5,4,1,6.0,9.4,-3.3,19,ENG
7d41b619,18,1439,16.0,16,15,2,12,16,37,-21,15.9,26.3,-10.4,19,ENG
7eb67dad,28,1948,21.6,19,15,9,10,17,42,-25,22.0,37.3,-15.3,19,ENG
7f3b388c,28,2017,22.4,21,19,7,6,56,14,42,45.8,17.4,28.4,19,ENG
7fe90ccd,4,128,1.4,1,1,3,19,1,0,1,2.0,0.8,1.2,19,ENG
7fec31a0,25,1739,19.3,19,15,6,1,32,33,-1,30.8,28.8,2.0,19,ENG
80c31c97,22,1925,21.4,21,19,1,9,28,26,2,28.3,24.7,3.6,19,ENG
810e3c74,27,1663,18.5,19,7,8,2,35,26,9,33.3,23.0,10.3,19,ENG
819aa8e7,37,2917,32.4,34,19,3,1,40,35,5,34.8,41.6,-6.8,19,ENG
819b3158,31,2137,23.7,23,17,8,1,60,15,45,50.6,14.9,35.7,19,ENG
82dbf623,20,694,7.7,6,3,14,10,14,8,6,12.4,10.7,1.6,19,ENG
82e34b69,32,2545,28.3,28,21,4,0,42,44,-2,35.5,43.8,-8.3,19,ENG
8397a50c,5,143,1.6,2,1,3,8,1,4,-3,0.7,3.5,-2.8,19,ENG
839c14e1,18,1495,16.6,16,15,2,0,15,31,-16,18.8,24.8,-6.0,19,ENG
849c826a,9,459,5.1,5,1,4,0,5,6,-1,5.2,6.6,-1.4,19,ENG
862a1c15,10,759,8.4,9,4,1,0,11,11,0,11.3,9.2,2.0,19,ENG
867239d3,35,3006,33.4,34,28,1,2,56,43,13,55.4,40.8,14.6,19,ENG
86dd77d1,33,2779,30.9,30,29,3,4,73,17,56,65.2,19.9,45.3,19,ENG
874125a3,3,166,1.8,2,1,1,2,7,3,4,5.5,2.0,3.5,19,ENG
87575fd9,14,752,8.4,6,6,8,3,14,14,0,11.6,12.0,-0.5,19,ENG
875898c7,13,1170,13.0,13,13,0,4,10,24,-14,16.8,19.4,-2.7,19,ENG
87935cf3,27,2416,26.8,27,26,0,0,29,35,-6,32.2,33.9,-1.7,19,ENG
87f7500e,13,877,9.7,9,8,4,1,9,23,-14,9.5,19.2,-9.7,19,ENG
8816329f,28,1493,16.6,15,8,13,5,19,18,1,14.5,24.0,-9.5,19,ENG
892d5bb1,27,1343,14.9,14,5,13,10,36,9,27,34.0,8.1,25.9,19,ENG
89d10e53,26,1798,20.0,20,14,6,5,35,16,19,28.5,25.4,3.1,19,ENG
89e4b358,36,3096,34.4,35,31,1,1,49,54,-5,44.4,52.9,-8.5,19,ENG
8a08491a,14,1085,12.1,13,5,1,1,16,15,1,16.0,11.5,4.5,19,ENG
8a7ff278,7,552,6.1,6,6,1,25,17,14,3,10.5,8.7,1.8,19,ENG
8aa5f52c,26,1927,21.4,20,20,6,10,29,32,-3,24.6,29.9,-5.3,19,ENG
8ae9869d,37,3260,36.2,37,35,0,0,19,71,-52,27.6,57.7,-30.1,19,ENG
8aec0537,25,1864,20.7,24,9,1,0,18,31,-13,21.4,26.6,-5.1,19,ENG
8b04d6c1,31,2760,30.7,31,27,0,2,39,58,-19,38.2,45.3,-7.1,19,ENG
8b788c01,27,1621,18.0,18,7,9,3,30,25,5,28.2,24.3,3.8,19,ENG
8b9ebd03,32,2097,23.3,26,9,6,5,38,25,13,33.5,23.2,10.3,19,ENG
8d228291,25,983,10.9,11,0,14,10,11,17,-6,12.5,17.0,-4.4,19,ENG
8d3c902d,31,1899,21.1,21,13,10,3,25,30,-5,23.0,28.1,-5.1,19,ENG
8df7a2fb,38,3420,38.0,38,38,0,0,45,68,-23,44.4,62.1,-17.7,19,ENG
8e65a5e5,1,90,1.0,1,1,0,4,3,4,-1,0.7,2.6,-1.9,19,ENG
8f62b6ee,33,2970,33.0,33,33,0,0,61,33,28,48.2,41.0,7.2,19,ENG
8f866fe8,12,476,5.3,4,2,8,0,3,12,-9,6.2,8.5,-2.2,19,ENG
914ab9a1,21,1586,17.6,19,16,2,10,23,26,-3,25.0,29.3,-4.3,19,ENG
91b43c98,1,1,0.0,0,0,1,7,0,1,-1,0.0,0.1,-0.1,19,ENG
9228b07c,16,980,10.9,10,9,6,20,13,19,-6,11.2,14.6,-3.4,19,ENG
92e7e919,31,2039,22.7,23,7,8,2,47,22,25,34.9,25.7,9.2,19,ENG
9306d5ea,29,2367,26.3,29,19,0,2,13,44,-31,20.8,38.9,-18.1,19,ENG
9319781b,1,62,0.7,1,0,0,0,0,1,-1,0.3,2.2,-1.9,19,ENG
9328b835,38,3420,38.0,38,38,0,0,52,55,-3,47.6,61.9,-14.3,19,ENG
935e6b8f,32,1987,22.1,21,14,11,1,47,14,33,38.6,16.9,21.6,19,ENG
939bc634,31,2778,30.9,30,30,1,3,18,54,-36,22.0,44.1,-22.1,19,ENG
94b2001f,11,807,9.0,9,8,2,15,19,7,12,20.2,6.2,14.0,19,ENG
96bb8cc2,16,720,8.0,6,2,10,5,8,17,-9,11.1,13.2,-2.1,19,ENG
96e0490d,6,443,4.9,5,4,1,10,5,8,-3,4.7,7.1,-2.4,19,ENG
97333cf5,29,1432,15.9,16,3,13,5,21,26,-5,17.7,23.9,-6.2,19,ENG
979b811d,23,693,7.7,6,0,17,9,10,11,-1,11.4,9.0,2.4,19,ENG
980522ec,35,2774,30.8,30,27,5,1,58,37,21,45.8,40.5,5.3,19,ENG
984a5a64,6,376,4.2,4,4,2,17,13,4,9,6.5,6.3,0.2,19,ENG
989d5705,32,2063,22.9,25,12,7,6,24,44,-20,23.5,37.5,-14.0,19,ENG
98be0d02,4,79,0.9,0,0,4,5,0,2,-2,0.5,2.0,-1.5,19,ENG
99813635,13,468,5.2,5,0,8,11,14,3,11,10.3,2.2,8.1,19,ENG
99b1d0e6,14,938,10.4,10,4,4,13,17,18,-1,14.8,15.8,-1.0,19,ENG
9a104dee,25,1059,11.8,10,4,15,11,21,17,4,16.4,14.1,2.3,19,ENG
9a28eba4,29,902,10.0,8,0,21,8,9,13,-4,14.4,12.2,2.3,19,ENG
9a9c05db,21,1750,19.4,19,19,2,14,23,41,-18,20.6,34.1,-13.5,19,ENG
9aa186b2,24,1842,20.5,19,16,5,9,11,36,-25,14.5,30.5,-16.0,19,ENG
9b5ce51a,30,2506,27.8,29,23,1,2,42,49,-7,40.9,38.9,2.1,19,ENG
9c318325,8,392,4.4,4,3,4,1,7,10,-3,7.3,8.3,-1.0,19,ENG
9c74fa25,11,715,7.9,9,4,2,16,5,20,-15,4.6,16.0,-11.4,19,ENG
9c94165b,29,2591,28.8,29,28,0,0,52,39,13,47.8,37.8,10.0,19,ENG
9d107085,21,1585,17.6,17,15,4,4,25,34,-9,21.1,25.0,-3.9,19,ENG
9dbb75ca,35,2502,27.8,27,18,8,2,51,31,20,40.1,38.3,1.9,19,ENG
9dc69d38,11,561,6.2,4,4,7,3,7,14,-7,8.1,9.4,-1.4,19,ENG
9e525177,35,3134,34.8,35,34,0,0,45,46,-1,43.1,46.0,-2.9,19,ENG
9f1893b9,36,3043,33.8,36,25,0,0,48,49,-1,43.5,54.6,-11.0,19,ENG
9f4647e9,33,2220,24.7,25,15,8,3,32,33,-1,30.4,37.4,-7.0,19,ENG
9f472354,26,1272,14.1,12,2,14,2,16,24,-8,18.5,21.6,-3.1,19,ENG
9f736ed2,19,797,8.9,9,2,10,12,11,23,-12,10.7,16.7,-6.0,19,ENG
9fbbcf39,19,1149,12.8,12,10,7,15,18,17,1,15.6,15.5,0.1,19,ENG
a0666d3e,32,2418,26.9,31,12,1,0,32,39,-7,32.5,38.1,-5.6,19,ENG
a1232f4e,12,638,7.1,8,5,4,9,14,13,1,10.0,10.4,-0.3,19,ENG
a179d516,2,180,2.0,2,2,0,36,2,0,2,2.1,1.0,1.1,19,ENG
a1d5bd30,33,2334,25.9,26,11,7,2,45,35,10,43.0,28.6,14.4,19,ENG
a2b105e0,9,687,7.6,8,6,1,6,11,9,2,8.9,11.0,-2.1,19,ENG
a300ac7e,15,475,5.3,4,0,11,9,11,13,-2,5.5,8.7,-3.2,19,ENG
a39bb753,37,2923,32.5,32,24,5,0,52,35,17,50.4,31.2,19.1,19,ENG
a3b03921,2,64,0.7,1,0,1,4,1,1,0,1.2,2.1,-0.9,19,ENG
a48da055,12,417,4.6,4,1,8,6,2,12,-10,2.8,11.8,-9.0,19,ENG
a4ac4b8f,36,3167,35.2,36,34,0,0,40,41,-1,47.9,38.0,9.9,19,ENG
a53649b7,5,67,0.7,0,0,5,14,3,3,0,1.9,2.7,-0.8,19,ENG
a67a09fb,3,207,2.3,2,2,1,29,2,5,-3,2.4,2.8,-0.4,19,ENG
a6de6361,19,1710,19.0,19,19,0,19,28,27,1,26.5,27.2,-0.7,19,ENG
a712ca2b,33,2970,33.0,33,33,0,5,48,43,5,42.6,51.4,-8.8,19,ENG
a8748947,31,2194,24.4,24,13,7,1,22,51,-29,24.7,40.5,-15.9,19,ENG
a9142dc3,12,793,8.8,10,6,2,4,10,18,-8,9.5,17.8,-8.2,19,ENG
aa1a8c7e,22,986,11.0,10,3,12,6,6,25,-19,8.9,20.0,-11.1,19,ENG
aa5859cb,23,1068,11.9,10,6,13,4,3,23,-20,8.9,20.0,-11.1,19,ENG
aaf1bf05,21,1412,15.7,16,9,5,5,9,37,-28,11.2,28.4,-17.3,19,ENG
ab070c55,16,814,9.0,9,3,7,4,11,13,-2,12.5,15.1,-2.6,19,ENG
ab13a5aa,20,1754,19.5,20,19,0,17,32,23,9,27.6,24.2,3.3,19,ENG
ab4b3e35,34,2116,23.5,25,4,9,1,29,19,10,28.9,26.6,2.3,19,ENG
ab651565,38,3270,36.3,36,28,2,0,43,58,-15,45.5,50.5,-5.0,19,ENG
abe66106,19,974,10.8,9,2,10,3,18,12,6,15.0,13.7,1.3,19,ENG
ac05f970,33,2103,23.4,22,15,11,2,29,30,-1,29.2,41.6,-12.4,19,ENG
ac861941,20,1506,16.7,18,12,2,4,26,18,8,25.0,24.0,1.0,19,ENG
ad1ffcfd,8,229,2.5,3,1,5,9,3,4,-1,4.2,2.8,1.4,19,ENG
ae0a7ddf,29,2473,27.5,28,25,1,5,28,40,-12,27.4,41.8,-14.4,19,ENG
af245161,2,180,2.0,2,2,0,17,1,5,-4,2.3,3.9,-1.6,19,ENG
af341b88,20,1544,17.2,17,16,3,11,17,26,-9,20.5,30.3,-9.8,19,ENG
af69e7f0,28,2345,26.1,27,21,1,4,22,53,-31,28.3,46.4,-18.1,19,ENG
af721f98,18,994,11.0,12,2,6,3,8,13,-5,12.1,16.3,-4.2,19,ENG
afef14da,4,132,1.5,0,0,4,6,1,4,-3,0.6,3.5,-2.8,19,ENG
b017b770,2,13,0.1,0,0,2,8,0,0,0,0.5,0.1,0.4,19,ENG
b18095b6,6,375,4.2,5,3,1,25,8,6,2,4.9,6.2,-1.3,19,ENG
b217ef29,22,1537,17.1,17,17,5,9,41,12,29,30.9,12.0,18.8,19,ENG
b28bbd58,38,3009,33.4,34,21,4,0,41,46,-5,42.1,41.9,0.3,19,ENG
b2bc3b1f,34,3036,33.7,34,29,0,0,48,49,-1,41.4,43.1,-1.7,19,ENG
b2d03887,32,2569,28.5,31,20,1,1,25,53,-28,28.0,46.3,-18.3,19,ENG
b30c7426,29,1817,20.2,22,7,7,4,17,32,-15,26.0,26.6,-0.6,19,ENG
b318a643,32,2603,28.9,30,22,2,3,37,31,6,30.7,38.6,-7.9,19,ENG
b400bde0,34,2771,30.8,31,22,3,4,75,19,56,63.2,19.7,43.4,19,ENG
b4b2f632,20,985,10.9,11,3,9,6,11,18,-7,12.4,18.9,-6.5,19,ENG
b561db50,38,3111,34.6,36,20,2,0,44,40,4,47.0,37.6,9.3,19,ENG
b581987a,12,461,5.1,3,1,9,4,4,7,-3,5.9,9.8,-3.9,19,ENG
b66315ae,29,1036,11.5,8,4,21,7,28,11,17,28.5,8.8,19.7,19,ENG
b682dcf6,25,2198,24.4,25,24,0,3,44,33,11,38.3,33.1,5.2,19,ENG
b6964eb6,24,2127,23.6,24,23,0,4,35,36,-1,35.3,31.8,3.5,19,ENG
b73e459a,1,90,1.0,1,1,0,7,1,1,0,0.7,0.6,0.1,19,ENG
b7d082af,29,2166,24.1,24,20,5,3,21,32,-11,22.2,35.8,-13.6,19,ENG
b827d5b3,27,1625,18.1,18,8,9,2,17,17,0,19.9,23.1,-3.2,19,ENG
b853e0ad,17,1041,11.6,13,5,4,15,18,19,-1,19.2,15.9,3.2,19,ENG
b937e490,17,710,7.9,7,4,10,19,14,9,5,13.8,9.1,4.8,19,ENG
b9e1436c,2,20,0.2,0,0,2,3,0,1,-1,0.1,0.7,-0.6,19,ENG
b9fbae28,36,3092,34.4,36,32,0,1,57,38,19,52.1,33.8,18.3,19,ENG
ba1e04b3,24,1128,12.5,12,7,12,10,14,21,-7,14.2,20.2,-5.9,19,ENG
ba23a904,22,1911,21.2,22,18,0,1,33,23,10,32.6,27.3,5.3,19,ENG
bb5fbd2b,35,2463,27.4,30,16,5,1,26,40,-14,28.8,42.7,-14.0,19,ENG
bc7dc64d,1,8,0.1,0,0,1,2,1,0,1,0.1,0.0,0.1,19,ENG
bcfb0142,1,62,0.7,1,0,0,23,1,3,-2,1.2,1.1,0.1,19,ENG
be4fede9,3,88,1.0,1,0,2,8,0,4,-4,0.7,4.8,-4.1,19,ENG
be927d03,30,2569,28.5,28,27,2,6,50,43,7,45.6,38.2,7.4,19,ENG
c067631c,15,1086,12.1,12,10,3,8,12,16,-4,13.2,23.8,-10.6,19,ENG
c0e27d1a,36,3238,36.0,36,35,0,2,60,36,24,55.9,34.8,21.1,19,ENG
c24dba2a,29,1366,15.2,13,5,16,1,23,23,0,18.5,27.7,-9.2,19,ENG
c2846353,2,84,0.9,1,0,1,5,0,3,-3,2.5,1.8,0.8,19,ENG
c3e39f12,1,90,1.0,1,1,0,4,0,3,-3,0.5,1.9,-1.4,19,ENG
c596fcb0,30,2528,28.1,29,21,1,0,48,47,1,42.7,40.7,2.0,19,ENG
c5b7c315,33,2969,33.0,33,32,0,2,50,39,11,42.1,40.7,1.4,19,ENG
c6896eab,29,2057,22.9,23,17,6,4,13,55,-42,16.0,42.9,-26.9,19,ENG
c691bfe2,36,3077,34.2,35,25,1,0,79,21,58,65.9,25.3,40.6,19,ENG
c73ada83,1,1,0.0,0,0,1,1,0,0,0,0.0,0.0,0.0,19,ENG
c8aa95da,24,1999,22.2,22,17,2,7,30,23,7,26.4,30.1,-3.7,19,ENG
c92e1a31,30,941,10.5,9,3,21,6,17,16,1,16.1,12.8,3.3,19,ENG
c951a6df,25,1859,20.7,21,15,4,4,27,25,2,21.1,28.1,-7.0,19,ENG
ca2bc3df,15,795,8.8,9,4,6,3,11,10,1,7.5,13.5,-6.0,19,ENG
caa1a7f0,6,137,1.5,1,0,5,0,3,3,0,2.7,2.0,0.7,19,ENG
caffaf5a,17,1518,16.9,17,15,0,12,26,29,-3,23.1,22.0,1.1,19,ENG
cb4f24c6,19,1710,19.0,19,19,0,19,17,41,-24,17.9,34.8,-17.0,19,ENG
cc2d7ad5,38,3243,36.0,35,35,3,0,43,64,-21,42.0,60.3,-18.3,19,ENG
cd1acf9d,29,2462,27.4,27,20,2,4,67,14,53,58.8,21.2,37.6,19,ENG
ce4246f5,32,2612,29.0,29,28,3,2,40,39,1,38.1,33.3,4.8,19,ENG
ce5143da,8,153,1.7,1,0,7,2,6,3,3,2.6,3.3,-0.6,19,ENG
cea4ee8f,25,1825,20.3,22,10,3,0,32,21,11,28.7,22.1,6.5,19,ENG
cee31595,38,3058,34.0,36,21,2,0,44,49,-5,41.0,43.6,-2.6,19,ENG
cf15bbb1,3,98,1.1,1,1,2,7,1,4,-3,1.8,2.4,-0.6,19,ENG
cf623c78,28,2055,22.8,21,19,7,2,15,45,-30,19.3,36.0,-16.7,19,ENG
cfb29823,14,445,4.9,4,0,10,2,4,14,-10,6.5,8.7,-2.2,19,ENG
cfd5e123,22,1808,20.1,19,19,3,16,18,34,-16,19.8,38.2,-18.4,19,ENG
d0042ab9,5,408,4.5,4,4,1,3,7,9,-2,4.7,6.4,-1.7,19,ENG
d07e3b41,1,54,0.6,1,0,0,2,0,1,-1,0.8,0.8,0.0,19,ENG
d0b3ceb9,38,3420,38.0,38,38,0,0,52,59,-7,48.2,59.2,-11.0,19,ENG
d0f72bf1,1,1,0.0,0,0,1,5,0,0,0,0.0,0.0,0.0,19,ENG
d1c509d9,1,1,0.0,0,0,1,0,0,0,0,0.1,0.3,-0.2,19,ENG
d2424d1b,36,3240,36.0,36,36,0,0,50,43,7,50.3,41.5,8.8,19,ENG
d2583bce,27,1998,22.2,21,17,6,2,21,41,-20,24.4,34.0,-9.7,19,ENG
d2bff301,17,1224,13.6,13,10,4,9,36,7,29,31.8,7.4,24.4,19,ENG
d328a254,27,2188,24.3,25,19,2,1,15,43,-28,17.5,34.2,-16.6,19,ENG
d368feb8,15,1131,12.6,13,11,2,4,8,26,-18,11.3,23.9,-12.6,19,ENG
d4cb83cc,22,1861,20.7,21,20,1,4,44,24,20,34.3,29.2,5.1,19,ENG
d557d734,38,3144,34.9,35,29,3,0,41,41,0,46.0,38.2,7.9,19,ENG
d56543a0,38,3166,35.2,35,25,3,0,52,64,-12,51.2,51.3,-0.1,19,ENG
d5dd5f1f,36,2726,30.3,30,19,6,0,58,42,16,50.4,44.3,6.1,19,ENG
d6f88a1d,2,88,1.0,1,0,1,2,0,1,-1,0.5,1.4,-0.9,19,ENG
d7492450,13,1111,12.3,12,12,1,21,17,21,-4,16.6,19.7,-3.1,19,ENG
d79a8c87,10,807,9.0,9,8,1,4,23,10,13,13.5,13.0,0.5,19,ENG
d822a850,7,552,6.1,7,6,0,26,3,21,-18,6.1,16.2,-10.1,19,ENG
d8931174,31,2596,28.8,31,28,0,1,36,40,-4,38.3,33.7,4.6,19,ENG
d93c2511,16,867,9.6,9,8,7,7,12,18,-6,12.4,13.7,-1.3,19,ENG
d9565625,16,1013,11.3,12,6,4,6,21,18,3,20.1,16.9,3.2,19,ENG
d9ba39fc,12,612,6.8,5,3,7,15,5,19,-14,6.1,12.9,-6.8,19,ENG
d9cfca3d,24,368,4.1,1,1,23,10,3,15,-12,5.1,9.1,-3.9,19,ENG
da052c14,20,1181,13.1,14,3,6,16,15,13,2,14.0,15.5,-1.5,19,ENG
da23d58d,7,135,1.5,0,0,7,12,4,0,4,5.1,0.8,4.2,19,ENG
da7b447d,23,1942,21.6,22,20,1,7,32,22,10,28.9,26.2,2.7,19,ENG
da8b19e2,1,90,1.0,1,1,0,36,2,0,2,2.8,0.6,2.2,19,ENG
dc008610,23,881,9.8,8,0,15,5,7,14,-7,8.2,14.4,-6.2,19,ENG
dc10b26c,7,630,7.0,7,7,0,20,5,17,-12,7.9,11.0,-3.1,19,ENG
dc31b84c,1,90,1.0,1,1,0,10,1,3,-2,0.2,2.5,-2.2,19,ENG
dc3a9a0d,19,743,8.3,8,2,11,7,6,13,-7,14.5,8.5,6.0,19,ENG
dc4cae05,30,2261,25.1,29,10,1,3,41,41,0,36.0,35.2,0.8,19,ENG
dc6f5bdd,31,2588,28.8,29,28,2,2,26,52,-26,33.2,45.7,-12.5,19,ENG
dc936144,30,2639,29.3,30,28,0,7,25,50,-25,32.7,49.1,-16.5,19,ENG
dd0daf32,25,1641,18.2,19,11,6,3,33,26,7,32.3,24.6,7.7,19,ENG
de0f152c,14,1004,11.2,11,9,3,24,15,20,-5,12.2,19.4,-7.2,19,ENG
de112b84,9,302,3.4,3,0,6,7,1,8,-7,3.4,4.6,-1.2,19,ENG
def899bd,18,1263,14.0,15,12,3,4,29,17,12,26.5,17.7,8.8,19,ENG
e06683ca,38,3384,37.6,38,37,0,0,89,22,67,73.6,28.8,44.8,19,ENG
e082af5b,12,1080,12.0,12,12,0,26,17,18,-1,15.7,16.4,-0.7,19,ENG
e0900238,13,516,5.7,4,2,9,7,8,4,4,8.8,7.4,1.4,19,ENG
e0991c04,5,212,2.4,2,0,3,6,4,5,-1,4.0,4.5,-0.5,19,ENG
e0bc6fdc,10,663,7.4,7,7,3,6,10,11,-1,10.0,7.4,2.7,19,ENG
e2533c20,28,2266,25.2,27,18,1,3,23,40,-17,27.6,37.7,-10.1,19,ENG
e2716bd0,33,2401,26.7,28,13,5,2,60,14,46,57.0,15.5,41.5,19,ENG
e28868f3,33,2771,30.8,32,22,1,1,37,39,-2,39.1,34.3,4.8,19,ENG
e342ad68,38,3250,36.1,37,24,1,0,83,20,63,69.0,27.1,41.9,19,ENG
e3a5814e,16,987,11.0,11,8,5,7,17,17,0,15.6,18.7,-3.1,19,ENG
e3e6502a,5,37,0.4,0,0,5,7,0,3,-3,0.6,1.7,-1.0,19,ENG
e46012d4,19,975,10.8,11,4,8,1,28,3,25,24.8,6.2,18.6,19,ENG
e514ab62,16,1186,13.2,13,11,3,12,18,25,-7,15.3,22.7,-7.4,19,ENG
e5d01ecf,29,2049,22.8,22,19,7,2,30,40,-10,31.4,38.3,-6.9,19,ENG
e608ed4c,4,360,4.0,4,4,0,25,4,5,-1,2.9,5.9,-3.0,19,ENG
e61b8aee,29,2498,27.8,29,25,0,2,54,37,17,45.9,39.5,6.3,19,ENG
e726e11e,2,28,0.3,0,0,2,2,0,1,-1,0.5,0.1,0.4,19,ENG
e77dc3b2,10,347,3.9,2,0,8,1,6,5,1,8.0,6.5,1.4,19,ENG
e7ca0439,29,2560,28.4,29,26,0,0,35,37,-2,33.2,34.1,-0.9,19,ENG
e9208654,15,1141,12.7,13,11,2,10,11,35,-24,10.6,26.3,-15.6,19,ENG
e92cd3f7,12,185,2.1,0,0,12,5,2,3,-1,4.6,3.6,1.0,19,ENG
e97fd090,24,998,11.1,6,3,18,2,22,9,13,19.6,9.2,10.4,19,ENG
eaeca114,38,3411,37.9,38,37,0,0,56,70,-14,53.3,57.1,-3.9,19,ENG
eb58eef0,35,2725,30.3,32,19,3,0,69,16,53,58.0,23.5,34.4,19,ENG
eb7822d7,28,2436,27.1,28,23,0,2,50,37,13,45.5,36.6,8.9,19,ENG
eba42d2b,29,1416,15.7,15,3,14,6,27,24,3,20.7,19.0,1.7,19,ENG
ec9a28ce,5,96,1.1,1,0,4,5,0,1,-1,0.5,1.4,-0.9,19,ENG
ecbb3fdf,24,1641,18.2,21,7,3,4,16,43,-27,17.8,31.7,-13.9,19,ENG
ed1e53f3,13,335,3.7,3,1,10,16,9,0,9,9.6,2.0,7.6,19,ENG
ee38d9c5,36,2831,31.5,35,15,1,1,42,44,-2,41.7,36.2,5.5,19,ENG
ef619b0b,28,1331,14.8,14,4,14,3,32,13,19,20.7,20.1,0.6,19,ENG
f13d02a6,25,1341,14.9,16,2,9,13,16,19,-3,18.6,14.0,4.5,19,ENG
f1e8372d,4,25,0.3,0,0,4,16,0,2,-2,0.8,1.3,-0.5,19,ENG
f25b010f,19,1484,16.5,17,15,2,10,18,24,-6,16.8,26.5,-9.7,19,ENG
f25c8e3a,25,1390,15.4,16,5,9,7,36,8,28,31.6,11.4,20.2,19,ENG
f2f29dda,38,2508,27.9,30,16,8,0,27,45,-18,26.6,42.6,-16.0,19,ENG
f4290206,31,2759,30.7,31,29,0,1,52,28,24,48.4,29.3,19.2,19,ENG
f522d7ec,17,609,6.8,6,0,11,6,6,13,-7,8.2,13.8,-5.6,19,ENG
f573a8bf,30,1052,11.7,9,3,21,3,14,21,-7,16.7,17.1,-0.4,19,ENG
f5a00fa4,38,3032,33.7,35,24,3,0,41,39,2,44.7,36.8,7.9,19,ENG
f5deef4c,30,2601,28.9,29,27,1,2,46,40,6,45.7,38.4,7.3,19,ENG
f5e6d08d,1,13,0.1,0,0,1,3,0,0,0,0.0,0.2,-0.2,19,ENG
f5efb153,17,1331,14.8,13,12,4,2,27,23,4,25.0,22.0,3.0,19,ENG
f72293fc,29,1752,19.5,19,13,10,2,24,39,-15,23.8,33.9,-10.1,19,ENG
f7750aa0,31,2594,28.8,29,28,2,3,28,62,-34,32.2,51.3,-19.1,19,ENG
f7d50789,34,2922,32.5,33,30,1,3,56,31,25,46.7,37.0,9.7,19,ENG
f7ee69fb,10,515,5.7,7,2,3,0,10,6,4,7.3,6.8,0.4,19,ENG
f874dd44,19,1533,17.0,18,15,1,0,36,21,15,24.7,20.4,4.3,19,ENG
f8fcd2a5,24,1996,22.2,21,19,3,10,33,26,7,30.5,23.6,7.0,19,ENG
fa031b34,35,2665,29.6,32,15,3,0,38,34,4,40.4,35.8,4.6,19,ENG
fc15fb84,21,1591,17.7,19,9,2,4,22,25,-3,21.9,25.4,-3.5,19,ENG
fd3f57ce,11,395,4.3,5,3,6,13,0,9,-9,3.3000000000000003,5.199999999999999,-1.9,19,ENG
fd5888a0,16,476,5.3,3,1,13,11,3,13,-10,5.1,10.3,-5.2,19,ENG
fdd85f94,30,2546,28.3,30,25,0,0,27,45,-18,26.9,41.4,-14.5,19,ENG
fe558029,2,180,2.0,2,2,0,0,4,5,-1,3.3,3.6,-0.3,19,ENG
fed96827,13,850,9.4,10,8,3,2,15,17,-2,14.6,14.0,0.5,19,ENG
ff527768,31,2291,25.5,29,10,2,4,40,30,10,33.8,38.5,-4.7,19,ENG
ff9fcd4d,30,2081,23.1,26,11,4,7,17,40,-23,19.5,33.8,-14.3,19,ENG
005ca692,1,45,0.5,0,0,1,1,1,2,-1,0.7,0.8,-0.1,19,EL
00672021,2,180,2.0,2,2,0,0,3,6,-3,2.3,4.6,-2.3,19,EL
0076ab7f,5,430,4.8,5,4,0,2,9,2,7,6.0,5.6,0.4,19,EL
00bc97e8,3,132,1.5,1,1,2,3,3,4,-1,2.6,1.7,0.9,19,EL
01834aa0,4,287,3.2,4,2,0,1,2,2,0,2.7,3.2,-0.5,19,EL
023efc8b,5,314,3.5,4,2,1,0,2,6,-4,2.5,3.3,-0.8,19,EL
02ce2030,9,810,9.0,9,9,0,0,11,9,2,13.5,10.3,3.2,19,EL
02df3a4b,6,509,5.7,6,5,0,2,6,4,2,5.7,6.4,-0.8,19,EL
0331786b,1,90,1.0,1,1,0,1,0,1,-1,0.2,0.2,0.1,19,EL
0366fc78,5,385,4.3,5,2,0,0,8,7,1,5.4,4.4,0.9,19,EL
0375723e,1,90,1.0,1,1,0,2,2,0,2,3.3,0.7,2.6,19,EL
03df04ff,6,570,6.3,6,6,0,0,9,6,3,8.0,6.0,2.0,19,EL
04965583,3,231,2.6,3,2,0,1,9,2,7,5.3,2.6,2.7,19,EL
04da2b40,3,230,2.6,3,1,0,0,1,8,-7,3.1,3.1,0.0,19,EL
0538066d,4,360,4.0,4,4,0,1,5,4,1,2.8,3.2,-0.4,19,EL
0562b7f1,8,551,6.1,6,3,2,0,5,9,-4,5.6,10.1,-4.5,19,EL
059a0231,2,162,1.8,2,0,0,2,0,1,-1,1.8,1.9,-0.1,19,EL
05a6c38b,1,90,1.0,1,1,0,5,0,1,-1,1.1,2.0,-1.0,19,EL
05e19d6a,3,201,2.2,2,2,1,1,2,4,-2,2.7,4.7,-2.0,19,EL
0630eb63,4,228,2.5,2,2,2,2,2,7,-5,2.3,5.4,-3.2,19,EL
0638becf,4,119,1.3,1,0,3,1,1,3,-2,2.0,2.0,0.0,19,EL
06972405,1,5,0.1,0,0,1,4,0,0,0,0.0,0.0,0.0,19,EL
06b2765c,4,178,2.0,1,0,3,1,1,2,-1,2.8,3.2,-0.4,19,EL
06e5b0e4,8,719,8.0,8,7,0,0,8,11,-3,7.4,12.8,-5.4,19,EL
06fee814,2,95,1.1,1,1,1,1,0,0,0,1.2,0.7,0.5,19,EL
070ec0b1,3,262,2.9,3,2,0,1,6,5,1,4.3,4.4,-0.1,19,EL
07ab6542,1,7,0.1,0,0,1,0,0,1,-1,0.4,0.6,-0.2,19,EL
07abb358,1,35,0.4,0,0,1,1,0,1,-1,1.1,0.6,0.4,19,EL
07f8bcc8,5,161,1.8,1,1,4,1,2,3,-1,2.8,4.8,-2.0,19,EL
080440a4,7,660,7.3,7,7,0,0,11,9,2,11.9,8.3,3.6,19,EL
08593525,10,884,9.8,10,9,0,0,25,12,13,21.7,10.9,10.9,19,EL
086d7db3,4,360,4.0,4,4,0,1,2,5,-3,2.8,4.7,-1.9,19,EL
088e6424,6,540,6.0,6,6,0,0,6,8,-2,6.8,7.5,-0.8,19,EL
089550f5,3,270,3.0,3,3,0,0,5,0,5,5.2,3.0,2.2,19,EL
08990838,6,335,3.7,4,3,2,0,2,2,0,2.6,2.5,0.1,19,EL
08a2c314,1,90,1.0,1,1,0,3,1,1,0,1.0,1.0,-0.1,19,EL
08d37c53,4,81,0.9,0,0,4,2,1,1,0,1.9,2.1,-0.2,19,EL
08fe932d,4,275,3.1,4,2,0,2,3,2,1,2.3,3.2,-0.9,19,EL
0990f2fb,6,466,5.2,5,5,1,0,5,9,-4,5.5,7.2,-1.8,19,EL
09a9e921,7,380,4.2,4,3,3,2,5,5,0,4.3,4.7,-0.4,19,EL
0a0cc13c,6,322,3.6,4,0,2,2,5,1,4,6.0,3.8,2.2,19,EL
0a215326,4,360,4.0,4,4,0,0,7,8,-1,6.0,4.7,1.3,19,EL
0a447501,5,342,3.8,4,2,1,1,7,1,6,6.8,2.9,3.9,19,EL
0a6dbbf7,2,180,2.0,2,2,0,0,2,5,-3,2.6,3.4,-0.8,19,EL
0a86fd8b,1,90,1.0,1,1,0,7,1,2,-1,3.0,0.8,2.2,19,EL
0ac94a23,4,195,2.2,2,1,2,2,5,1,4,3.8,0.9,2.9,19,EL
0ad69fd0,4,75,0.8,1,0,3,0,1,2,-1,1.0,0.9,0.1,19,EL
0b5a292a,4,290,3.2,3,3,1,0,4,5,-1,4.5,5.7,-1.2,19,EL
0b90bb97,6,300,3.3,3,2,3,1,3,3,0,5.0,4.1,0.8,19,EL
0be28faf,5,329,3.7,3,3,2,0,2,5,-3,4.3,5.0,-0.7,19,EL
0be3255b,10,900,10.0,10,10,0,0,25,12,13,22.0,11.0,11.1,19,EL
0be95d34,4,150,1.7,2,0,2,6,3,3,0,3.0,1.3,1.7,19,EL
0c09c984,7,465,5.2,5,4,2,1,6,6,0,4.8,8.5,-3.7,19,EL
0d10333c,4,261,2.9,2,2,2,0,4,2,2,3.0,3.2,-0.2,19,EL
0e100630,1,72,0.8,1,0,0,0,1,2,-1,0.7,1.6,-0.8,19,EL
0e21fc3c,4,269,3.0,3,1,1,0,3,1,2,4.6,3.9,0.6,19,EL
0e4fef6e,3,186,2.1,2,2,1,2,6,2,4,3.8,3.2,0.6,19,EL
0e7ccfc4,3,245,2.7,3,2,0,1,6,3,3,4.0,3.3,0.7,19,EL
0eb03d5b,1,90,1.0,1,1,0,5,1,1,0,2.3,1.2,1.1,19,EL
0eeafda5,1,30,0.3,0,0,1,2,0,2,-2,0.2,0.9,-0.7,19,EL
0ef05b3e,1,90,1.0,1,1,0,5,0,0,0,0.4,0.3,0.1,19,EL
0efacb06,6,435,4.8,6,1,0,0,4,7,-3,5.5,5.7,-0.2,19,EL
0f276764,2,180,2.0,2,2,0,3,2,6,-4,2.1,3.4,-1.3,19,EL
0f5e0b8a,1,17,0.2,0,0,1,1,0,0,0,0.0,0.0,0.0,19,EL
0fbecd11,5,442,4.9,5,4,0,2,13,7,6,7.6,5.2,2.5,19,EL
1001ae82,1,16,0.2,0,0,1,2,0,0,0,0.3,0.0,0.3,19,EL
10549b49,4,240,2.7,3,0,1,0,4,6,-2,4.4,2.1,2.2,19,EL
10b9fa99,3,130,1.4,1,1,2,3,4,2,2,2.4,0.7,1.7,19,EL
110a95ca,8,720,8.0,8,8,0,0,10,12,-2,7.8,13.0,-5.2,19,EL
114b510e,3,270,3.0,3,3,0,3,6,4,2,6.8,4.0,2.8,19,EL
115b7ab9,1,10,0.1,0,0,1,1,0,0,0,0.0,0.2,-0.2,19,EL
11c0fa9d,2,155,1.7,2,1,0,0,2,3,-1,2.3,2.4,-0.1,19,EL
121101a4,4,237,2.6,2,2,2,5,6,2,4,6.6,2.3,4.4,19,EL
1232e1dc,2,180,2.0,2,2,0,3,4,4,0,3.9,3.2,0.7,19,EL
1295552e,7,567,6.3,6,6,1,1,6,11,-5,6.0,9.4,-3.3,19,EL
129af0db,4,229,2.5,3,1,1,1,4,1,3,6.7,0.8,5.9,19,EL
12c50af5,2,30,0.3,0,0,2,3,0,0,0,0.1,0.0,0.0,19,EL
130a7a3f,4,322,3.6,4,2,0,0,3,6,-3,6.2,5.3,0.9,19,EL
1321d6f0,7,585,6.5,7,6,0,0,6,11,-5,5.3,10.4,-5.0,19,EL
133faa84,2,180,2.0,2,2,0,0,1,2,-1,1.1,3.2,-2.1,19,EL
13a78e01,6,540,6.0,6,6,0,0,7,7,0,7.5,6.9,0.6,19,EL
13b0c150,3,225,2.5,3,2,0,2,5,5,0,3.5,4.8,-1.3,19,EL
13b44b02,9,823,9.1,9,8,0,0,13,7,6,13.4,8.1,5.4,19,EL
13d74bff,6,492,5.5,6,3,0,0,7,12,-5,7.9,7.3,0.6,19,EL
13ea2544,6,528,5.9,6,5,0,1,11,5,6,11.4,5.2,6.2,19,EL
1453e3cf,1,8,0.1,0,0,1,1,0,0,0,0.0,0.0,0.0,19,EL
146f2615,5,428,4.8,5,0,0,0,6,6,0,4.6,6.1,-1.5,19,EL
150a572c,3,265,2.9,3,2,0,0,2,5,-3,1.9,6.2,-4.3,19,EL
156afd6f,1,7,0.1,0,0,1,4,0,0,0,0.0,0.1,-0.1,19,EL
157c5e0b,4,252,2.8,2,1,2,0,5,4,1,5.2,5.9,-0.6,19,EL
15b6e8d7,5,444,4.9,5,4,0,0,8,10,-2,6.6,10.7,-4.1,19,EL
15d0c248,5,394,4.4,4,4,1,1,4,9,-5,3.3,7.5,-4.3,19,EL
15e9c7e6,5,428,4.8,5,2,0,0,8,3,5,6.8,4.1,2.7,19,EL
15f3ec41,9,421,4.7,4,4,5,0,15,3,12,11.4,3.5,7.9,19,EL
16380240,10,646,7.2,8,1,2,2,16,11,5,9.7,9.7,0.0,19,EL
163bbd4a,2,34,0.4,0,0,2,0,1,1,0,0.6,0.3,0.3,19,EL
167c1bb0,5,377,4.2,4,4,1,1,6,3,3,7.9,3.3,4.5,19,EL
16b9d5cf,4,315,3.5,4,3,0,1,6,4,2,6.3,5.9,0.4,19,EL
16ceb862,14,1126,12.5,12,10,2,0,32,9,23,24.8,9.8,15.0,19,EL
16daec92,14,1121,12.5,13,7,1,0,26,10,16,23.8,12.8,11.0,19,EL
17145c90,10,801,8.9,9,8,1,0,9,11,-2,13.0,10.8,2.1,19,EL
173db1f4,5,415,4.6,5,2,0,1,5,10,-5,4.5,7.2,-2.7,19,EL
17695062,4,265,2.9,3,2,1,0,6,2,4,6.3,2.0,4.4,19,EL
179d2851,12,1110,12.3,12,12,0,0,17,14,3,14.9,13.2,1.7,19,EL
17e3e467,7,546,6.1,7,2,0,1,6,12,-6,6.1,13.6,-7.6,19,EL
18abe173,5,450,5.0,5,5,0,2,9,3,6,6.9,3.8,3.1,19,EL
18b896d6,4,360,4.0,4,4,0,3,10,0,10,8.5,1.9,6.5,19,EL
19003991,6,112,1.2,0,0,6,0,0,2,-2,1.0,2.0,-0.9,19,EL
1978a39a,6,532,5.9,6,4,0,0,6,13,-7,8.6,8.0,0.6,19,EL
199cd404,7,410,4.6,5,1,2,1,7,6,1,6.4,4.9,1.5,19,EL
19b776e9,4,226,2.5,3,1,1,2,2,0,2,2.9,1.5,1.4,19,EL
19c9e24e,2,132,1.5,1,0,1,2,1,3,-2,1.5,3.3,-1.7,19,EL
19f8e480,3,270,3.0,3,3,0,3,3,3,0,4.1,3.1,0.9,19,EL
1a4b9094,6,280,3.1,2,2,4,0,4,9,-5,3.7,5.2,-1.5,19,EL
1a799243,10,900,10.0,10,10,0,0,25,12,13,22.0,11.0,11.1,19,EL
1ac58ba6,3,270,3.0,3,3,0,5,2,5,-3,1.8,4.9,-3.1,19,EL
1adcf39e,1,90,1.0,1,1,0,1,1,4,-3,0.9,2.4,-1.5,19,EL
1ae8b66d,6,534,5.9,6,5,0,0,4,13,-9,2.3,11.6,-9.3,19,EL
1b09b065,7,457,5.1,5,3,2,0,6,5,1,5.3,6.6,-1.3,19,EL
1b4f1169,2,24,0.3,0,0,2,2,0,0,0,0.1,0.5,-0.5,19,EL
1b82f8df,4,347,3.9,4,3,0,2,4,2,2,6.5,3.7,2.8,19,EL
1bcca8b8,9,375,4.2,3,1,6,4,7,3,4,7.3,5.2,2.1,19,EL
1c07b06e,5,251,2.8,4,1,1,2,2,2,0,4.2,2.9,1.3,19,EL
1c0ddebb,6,540,6.0,6,6,0,0,4,7,-3,4.6,10.6,-6.0,19,EL
1c37137f,4,177,2.0,2,1,2,2,3,4,-1,1.6,2.8,-1.3,19,EL
1c529186,3,195,2.2,2,2,1,1,2,3,-1,3.9,4.1,-0.1,19,EL
1c639185,1,57,0.6,1,0,0,5,1,0,1,0.2,1.0,-0.8,19,EL
1c78737d,5,407,4.5,5,3,0,0,5,3,2,5.6,6.5,-0.9,19,EL
1c96ad85,5,289,3.2,4,2,1,0,3,4,-1,3.8,2.9,0.9,19,EL
1cb49278,15,1333,14.8,15,14,0,0,36,10,26,31.2,10.4,20.7,19,EL
1d2d5cc8,1,90,1.0,1,1,0,3,1,3,-2,0.9,1.8,-0.9,19,EL
1d5cab82,5,201,2.2,2,0,3,4,4,2,2,4.5,3.3,1.3,19,EL
1e064bfb,9,810,9.0,9,9,0,1,13,16,-3,8.8,17.9,-9.2,19,EL
1e101451,1,90,1.0,1,1,0,7,1,1,0,0.6,1.2,-0.6,19,EL
1e9bde92,6,540,6.0,6,6,0,0,7,9,-2,7.8,13.2,-5.5,19,EL
1ec5df8f,1,90,1.0,1,1,0,4,2,1,1,2.4,1.1,1.3,19,EL
1ec7e1c5,10,900,10.0,10,10,0,0,16,16,0,15.4,13.5,1.9,19,EL
1eec640e,6,500,5.6,6,4,0,0,5,7,-2,3.2,7.4,-4.2,19,EL
1ef6f38d,2,126,1.4,2,0,0,1,2,4,-2,0.9,3.4,-2.5,19,EL
1f44ac21,1,5,0.1,0,0,1,2,1,0,1,0.3,0.0,0.3,19,EL
1f9328da,2,171,1.9,2,1,0,0,5,0,5,3.6,1.3,2.3,19,EL
1fa665d0,2,33,0.4,0,0,2,2,1,1,0,0.1,1.4,-1.4,19,EL
1fb1c435,5,343,3.8,4,1,1,0,9,7,2,8.9,4.9,4.0,19,EL
1fbbfbde,8,720,8.0,8,8,0,0,14,5,9,12.1,6.9,5.2,19,EL
20030c06,5,450,5.0,5,5,0,1,7,5,2,7.2,5.0,2.3,19,EL
20094685,5,420,4.7,5,4,0,1,5,11,-6,6.5,7.4,-0.9,19,EL
2054d037,9,545,6.1,5,4,4,0,9,12,-3,10.2,10.1,0.1,19,EL
2077ae86,2,25,0.3,0,0,2,1,0,0,0,0.4,0.1,0.3,19,EL
20b9f052,2,180,2.0,2,2,0,6,3,2,1,2.7,1.8,0.8,19,EL
20c1ef47,4,49,0.5,0,0,4,0,1,0,1,1.1,0.7,0.3,19,EL
20e73fac,10,647,7.2,7,3,3,0,9,13,-4,10.7,10.4,0.3,19,EL
2146785a,4,360,4.0,4,4,0,1,10,8,2,6.3,5.7,0.6,19,EL
21519148,6,520,5.8,6,5,0,0,4,14,-10,3.2,11.8,-8.6,19,EL
21a4bd09,6,322,3.6,4,2,2,2,3,8,-5,3.7,6.3,-2.6,19,EL
2224380e,1,90,1.0,1,1,0,2,1,0,1,0.9,0.7,0.2,19,EL
2233ef48,3,230,2.6,3,2,0,0,2,5,-3,1.5,6.0,-4.5,19,EL
2249e65b,3,117,1.3,0,0,3,0,1,2,-1,0.6,1.9,-1.3,19,EL
22517bbe,5,436,4.8,5,4,0,0,3,13,-10,2.1,10.7,-8.7,19,EL
22721b88,3,247,2.7,3,1,0,2,2,8,-6,2.2,6.8,-4.5,19,EL
228f73ae,3,42,0.5,0,0,3,0,0,1,-1,0.4,0.4,0.1,19,EL
22db7a5e,3,270,3.0,3,3,0,5,6,2,4,3.7,3.6,0.1,19,EL
23135233,3,200,2.2,2,2,1,2,4,2,2,2.1,1.6,0.5,19,EL
23c5db70,6,323,3.6,4,1,2,2,7,2,5,4.6,2.7,2.0,19,EL
24228180,9,515,5.7,5,2,4,1,8,3,5,7.3,4.7,2.5,19,EL
2434f24a,6,540,6.0,6,6,0,0,6,6,0,8.3,7.9,0.4,19,EL
243f4a0b,4,276,3.1,3,3,1,0,3,4,-1,4.2,4.3,-0.1,19,EL
244a31b9,6,459,5.1,5,5,1,0,4,7,-3,4.8,5.2,-0.4,19,EL
245d9bfc,5,371,4.1,5,1,0,0,2,8,-6,1.7,7.0,-5.3,19,EL
24b98f95,2,26,0.3,0,0,2,0,0,2,-2,0.1,0.7,-0.5,19,EL
24c1439d,1,7,0.1,0,0,1,1,1,0,1,0.2,0.1,0.2,19,EL
24d9435b,5,450,5.0,5,5,0,1,7,10,-3,7.7,6.8,0.9,19,EL
24f59bb2,4,296,3.3,4,3,0,2,4,4,0,4.1,3.8,0.4,19,EL
2535e885,6,540,6.0,6,6,0,0,5,7,-2,3.9,8.2,-4.3,19,EL
254147d4,5,373,4.1,4,2,1,0,7,6,1,6.0,7.7,-1.7,19,EL
2557c196,3,243,2.7,3,1,0,0,5,7,-2,4.0,4.6,-0.6,19,EL
2580854e,1,90,1.0,1,1,0,5,0,0,0,1.6,1.3,0.3,19,EL
258aff54,6,526,5.8,6,5,0,0,3,5,-2,4.0,5.2,-1.3,19,EL
258b0d9b,4,360,4.0,4,4,0,0,4,13,-9,4.2,6.4,-2.2,19,EL
25b74470,1,90,1.0,1,1,0,2,3,0,3,1.9,0.4,1.5,19,EL
25e8594b,6,485,5.4,4,4,2,0,10,9,1,7.1,8.4,-1.3,19,EL
2628fd2b,3,270,3.0,3,3,0,9,8,2,6,6.8,2.0,4.8,19,EL
26383ea5,3,270,3.0,3,3,0,1,3,4,-1,5.2,1.8,3.4,19,EL
2648e18f,5,344,3.8,4,2,1,0,5,5,0,6.6,7.7,-1.1,19,EL
26b3d752,5,450,5.0,5,5,0,0,4,14,-10,5.3,7.2,-2.0,19,EL
26ce2263,7,488,5.4,6,4,1,1,3,6,-3,4.0,7.5,-3.5,19,EL
271b8617,2,7,0.1,0,0,2,3,0,0,0,0.6,0.0,0.6,19,EL
273c483b,7,366,4.1,4,1,3,1,4,5,-1,3.1,6.0,-2.9,19,EL
27669186,1,24,0.3,0,0,1,0,0,1,-1,0.1,0.3,-0.2,19,EL
27af684a,1,90,1.0,1,1,0,2,2,0,2,0.8,0.6,0.2,19,EL
27f54333,5,112,1.2,1,1,4,0,0,2,-2,2.2,1.4,0.8,19,EL
27fc233a,2,106,1.2,1,1,1,4,0,1,-1,0.3,0.8,-0.5,19,EL
27ff9bdb,4,327,3.6,4,3,0,0,4,3,1,4.8,3.7,1.0,19,EL
284f2ce6,2,135,1.5,2,1,0,2,2,1,1,1.9,0.9,1.0,19,EL
28d596a0,13,1200,13.3,13,13,0,0,31,8,23,28.2,10.4,17.8,19,EL
292a652a,1,90,1.0,1,1,0,0,2,2,0,1.3,2.1,-0.8,19,EL
29a506e1,1,10,0.1,0,0,1,0,0,0,0,0.0,0.4,-0.3,19,EL
29d8ad3f,6,540,6.0,6,6,0,0,6,6,0,8.3,7.9,0.4,19,EL
29e33bf3,6,454,5.0,6,0,0,0,6,8,-2,8.2,5.9,2.3,19,EL
2a5fab54,1,3,0.0,0,0,1,0,0,0,0,0.0,0.0,0.0,19,EL
2a6cd437,6,526,5.8,6,5,0,2,14,5,9,12.8,4.3,8.5,19,EL
2a709dc0,2,135,1.5,2,1,0,0,4,3,1,2.8,1.4,1.4,19,EL
2b15a82a,4,301,3.3,3,2,1,3,8,4,4,6.4,3.3,3.2,19,EL
2b3efa4a,11,1020,11.3,11,11,0,0,15,14,1,13.6,12.9,0.7,19,EL
2b9fdeea,3,225,2.5,3,0,0,0,3,6,-3,4.9,2.9,2.0,19,EL
2ba38347,4,315,3.5,4,3,0,1,5,2,3,4.4,2.9,1.5,19,EL
2c44a35d,2,180,2.0,2,2,0,0,2,5,-3,2.6,3.4,-0.8,19,EL
2c8b7022,6,531,5.9,6,5,0,0,6,8,-2,6.6,7.3,-0.7,19,EL
2ccd89a3,4,146,1.6,2,0,2,1,1,2,-1,2.6,1.2,1.4,19,EL
2e2ec9cf,3,122,1.4,1,0,2,2,1,1,0,1.4,0.9,0.5,19,EL
2e8fc160,4,259,2.9,3,2,1,0,3,1,2,3.2,2.8,0.4,19,EL
2ebc1b44,7,596,6.6,7,3,0,0,10,7,3,8.8,10.9,-2.1,19,EL
2f3452eb,4,360,4.0,4,4,0,2,6,5,1,7.6,6.4,1.3,19,EL
2f557579,5,317,3.5,4,1,1,0,4,3,1,6.8,4.4,2.4,19,EL
2f7407fa,1,6,0.1,0,0,1,0,0,0,0,0.0,0.0,0.0,19,EL
2f7af524,6,455,5.1,5,5,1,0,6,11,-5,8.2,11.5,-3.3,19,EL
2fabebc0,2,117,1.3,1,1,1,5,1,2,-1,0.9,1.7,-0.8,19,EL
305a3820,4,360,4.0,4,4,0,1,5,3,2,5.3,3.8,1.5,19,EL
30643ce2,6,384,4.3,5,1,1,0,7,3,4,8.0,3.5,4.5,19,EL
307fcd26,12,1080,12.0,12,12,0,0,20,13,7,18.8,16.5,2.3,19,EL
30c220c3,8,676,7.5,7,7,1,0,17,9,8,11.6,7.4,4.2,19,EL
30d4a2e5,8,720,8.0,8,8,0,1,9,13,-4,9.0,17.0,-8.0,19,EL
30f5ffa9,3,256,2.8,3,2,0,0,2,1,1,3.0,4.5,-1.4,19,EL
314bdac5,4,315,3.5,3,3,1,4,2,4,-2,3.0,4.6,-1.6,19,EL
314c2af0,5,450,5.0,5,5,0,1,2,4,-2,2.5,4.4,-1.9,19,EL
314f2124,2,104,1.2,1,1,1,1,3,0,3,2.6,0.7,1.9,19,EL
316de854,3,269,3.0,3,2,0,0,4,3,1,4.1,1.6,2.4,19,EL
31c07205,5,163,1.8,1,0,4,1,1,2,-1,0.9,3.6,-2.7,19,EL
31c69ef1,6,570,6.3,6,6,0,0,9,6,3,8.0,6.0,2.0,19,EL
321f83a2,3,72,0.8,1,0,2,2,0,0,0,0.4,0.2,0.3,19,EL
322ba2df,4,360,4.0,4,4,0,1,4,5,-1,5.1,4.9,0.2,19,EL
32c0491f,5,345,3.8,4,2,1,1,8,6,2,7.6,4.4,3.1,19,EL
32e7ce92,5,450,5.0,5,5,0,1,8,10,-2,8.9,11.8,-3.0,19,EL
3300c14c,1,90,1.0,1,1,0,0,1,3,-2,2.1,2.2,-0.1,19,EL
33182cb8,5,450,5.0,5,5,0,2,7,6,1,7.8,4.7,3.2,19,EL
33508c78,5,386,4.3,4,4,1,0,10,3,7,10.4,2.3,8.0,19,EL
339fe0e8,4,360,4.0,4,4,0,0,5,5,0,4.8,6.3,-1.5,19,EL
33b11df6,3,202,2.2,2,2,1,0,7,2,5,4.1,2.6,1.5,19,EL
33b8d077,2,151,1.7,2,1,0,1,2,0,2,2.4,2.2,0.2,19,EL
33bd3dae,5,307,3.4,4,2,1,1,4,7,-3,2.9,6.6,-3.6,19,EL
3423f250,4,215,2.4,2,2,2,0,4,2,2,4.0,2.2,1.8,19,EL
3470f44e,1,90,1.0,1,1,0,5,2,3,-1,1.6,1.4,0.3,19,EL
34c3b935,2,180,2.0,2,2,0,0,3,6,-3,2.3,4.6,-2.3,19,EL
34c3ec17,4,360,4.0,4,4,0,0,7,8,-1,6.0,4.7,1.3,19,EL
3519df17,6,540,6.0,6,6,0,0,4,13,-9,2.4,12.2,-9.8,19,EL
35375f7c,3,30,0.3,0,0,3,0,1,1,0,0.5,1.8,-1.3,19,EL
356c9002,4,226,2.5,2,2,2,0,4,1,3,2.8,4.0,-1.2,19,EL
35862524,6,319,3.5,3,2,3,0,2,5,-3,2.2,6.4,-4.3,19,EL
35af81f5,1,14,0.2,0,0,1,4,0,0,0,0.0,0.1,-0.1,19,EL
35bd124a,1,90,1.0,1,1,0,4,3,4,-1,1.2,1.7,-0.6,19,EL
35c54115,6,495,5.5,6,5,0,0,2,13,-11,4.9,7.7,-2.8,19,EL
35cf43aa,6,313,3.5,4,0,2,1,2,6,-4,2.3,6.2,-3.9,19,EL
360e3062,6,328,3.6,4,3,2,1,6,4,2,5.4,5.1,0.4,19,EL
3628b9b9,8,720,8.0,8,8,0,0,8,11,-3,9.0,10.2,-1.2,19,EL
36334b41,5,450,5.0,5,5,0,0,5,8,-3,5.4,5.1,0.3,19,EL
3640af28,4,284,3.2,3,3,1,1,2,4,-2,3.3,4.0,-0.7,19,EL
365836c9,8,720,8.0,8,8,0,0,15,12,3,11.3,9.9,1.4,19,EL
367d7444,3,270,3.0,3,3,0,1,7,4,3,4.3,3.2,1.0,19,EL
378825c7,9,691,7.7,7,6,2,1,11,14,-3,12.6,9.1,3.6,19,EL
37f827ec,2,154,1.7,1,1,1,2,5,4,1,3.3,4.8,-1.5,19,EL
387750b7,8,720,8.0,8,8,0,0,6,14,-8,7.2,11.7,-4.4,19,EL
38cd5b8f,8,687,7.6,8,7,0,0,15,10,5,10.9,8.9,1.9,19,EL
38ceb24a,6,525,5.8,6,4,0,0,10,9,1,6.8,7.0,-0.1,19,EL
38d14822,4,360,4.0,4,4,0,1,0,7,-7,2.1,5.2,-3.1,19,EL
390ab439,2,180,2.0,2,2,0,5,6,4,2,3.3,2.3,1.0,19,EL
392a7aea,2,180,2.0,2,2,0,0,2,5,-3,2.6,3.4,-0.8,19,EL
3935e52e,10,726,8.1,8,6,2,1,16,9,7,15.0,11.6,3.3,19,EL
3958025f,2,6,0.1,0,0,2,3,0,0,0,0.1,0.1,0.0,19,EL
3a233281,8,536,6.0,6,3,2,0,9,6,3,6.9,7.5,-0.5,19,EL
3a24769f,12,804,8.9,9,5,3,3,18,6,12,18.1,6.6,11.5,19,EL
3aa4a3be,6,349,3.9,4,2,2,2,3,7,-4,5.9,5.5,0.3,19,EL
3b571db6,2,125,1.4,2,1,0,2,1,2,-1,0.3,1.9,-1.6,19,EL
3b57f7f8,2,134,1.5,2,1,0,1,3,3,0,3.7,1.8,1.9,19,EL
3bf81c50,3,115,1.3,1,1,2,2,2,3,-1,1.6,2.1,-0.5,19,EL
3ca7254a,14,939,10.4,11,3,3,0,23,7,16,20.7,6.3,14.4,19,EL
3d13d9e4,1,8,0.1,0,0,1,1,1,0,1,0.7,0.0,0.7,19,EL
3d68d631,7,542,6.0,6,4,1,4,4,4,0,6.5,4.4,2.1,19,EL
3da8cba0,5,47,0.5,0,0,5,3,0,2,-2,0.2,1.3,-1.1,19,EL
3dab8efd,4,86,1.0,0,0,4,2,1,0,1,1.2,1.0,0.2,19,EL
3de25195,3,255,2.8,3,1,0,2,2,3,-1,2.4,3.1,-0.7,19,EL
3e975352,1,16,0.2,0,0,1,1,0,0,0,0.0,0.4,-0.4,19,EL
3ead85f9,4,279,3.1,3,3,1,0,5,3,2,6.0,2.6,3.4,19,EL
3ef0af0d,5,273,3.0,3,2,2,2,5,6,-1,4.9,2.7,2.2,19,EL
3effaa34,6,314,3.5,3,1,3,3,6,4,2,6.4,5.2,1.2,19,EL
3f10bd22,8,631,7.0,7,5,1,1,18,9,9,14.2,8.4,5.7,19,EL
3f2d59fe,6,470,5.2,5,5,1,6,11,5,6,10.2,6.1,4.1,19,EL
3f359b33,5,450,5.0,5,5,0,1,6,10,-4,8.2,10.8,-2.6,19,EL
3f65d5ce,2,180,2.0,2,2,0,0,2,5,-3,2.6,3.4,-0.8,19,EL
41b9d0c0,3,207,2.3,2,2,1,2,0,1,-1,2.2,2.2,0.0,19,EL
41f32541,1,90,1.0,1,1,0,0,1,2,-1,0.9,1.6,-0.7,19,EL
42276181,8,384,4.3,4,2,4,0,9,7,2,8.8,5.7,3.1,19,EL
42353de8,6,499,5.5,6,5,0,0,8,10,-2,9.1,6.7,2.4,19,EL
42a55711,3,161,1.8,2,0,1,0,1,2,-1,2.2,1.7,0.5,19,EL
42a632ba,1,90,1.0,1,1,0,3,0,3,-3,1.0,2.5,-1.5,19,EL
42dcf26d,7,630,7.0,7,7,0,2,14,5,9,11.6,8.5,3.1,19,EL
42fe6b05,4,290,3.2,4,1,0,0,0,7,-7,1.0,6.2,-5.2,19,EL
43688fa3,2,96,1.1,1,1,1,3,0,3,-3,0.4,3.5,-3.1,19,EL
4383b0da,4,267,3.0,3,1,1,1,3,4,-1,2.5,3.7,-1.2,19,EL
438ae11e,3,160,1.8,2,0,1,2,0,3,-3,0.5,3.1,-2.6,19,EL
43b23d3a,4,250,2.8,4,0,0,1,1,6,-5,4.2,3.9,0.3,19,EL
441197b8,9,708,7.9,8,7,1,4,16,7,9,14.6,10.3,4.2,19,EL
4431aed2,5,390,4.3,4,4,1,0,7,9,-2,6.9,8.2,-1.3,19,EL
448a3608,7,622,6.9,7,5,0,0,9,7,2,9.5,7.1,2.4,19,EL
44ac04e9,4,360,4.0,4,4,0,0,5,1,4,5.6,5.2,0.5,19,EL
44c3d1d2,2,38,0.4,0,0,2,2,0,2,-2,0.4,1.5,-1.0,19,EL
44eb9093,3,189,2.1,2,2,1,1,0,1,-1,2.0,3.9,-1.9,19,EL
44f050bc,10,900,10.0,10,10,0,0,13,17,-4,11.2,19.3,-8.1,19,EL
4574720b,6,540,6.0,6,6,0,0,3,5,-2,4.0,5.2,-1.3,19,EL
45b9b619,6,452,5.0,5,3,1,0,4,10,-6,4.9,7.8,-2.9,19,EL
45db685d,11,740,8.2,8,5,3,2,14,3,11,12.8,6.3,6.5,19,EL
45f5aa2f,5,450,5.0,5,5,0,0,5,11,-6,5.6,6.4,-0.8,19,EL
460976a2,5,384,4.3,5,2,0,0,6,6,0,3.7,6.3,-2.6,19,EL
467bae22,9,614,6.8,7,4,2,0,20,7,13,13.2,7.1,6.2,19,EL
46e58246,5,437,4.9,5,4,0,1,4,8,-4,6.6,11.5,-4.9,19,EL
474cf8e0,4,198,2.2,2,2,2,3,4,4,0,2.6,2.7,-0.1,19,EL
479ccb18,5,219,2.4,1,0,4,1,3,4,-1,1.3,3.7,-2.4,19,EL
47a34c4f,7,461,5.1,5,4,2,4,11,2,9,10.2,3.0,7.2,19,EL
47dbe004,5,450,5.0,5,5,0,0,7,12,-5,9.0,6.6,2.4,19,EL
47fd5136,4,360,4.0,4,4,0,0,5,7,-2,6.0,3.5,2.5,19,EL
4802f157,7,594,6.6,7,4,0,1,7,9,-2,8.4,8.4,0.0,19,EL
487d9b09,5,285,3.2,3,3,2,3,6,1,5,5.7,3.0,2.7,19,EL
489e5d93,8,482,5.4,5,1,3,0,8,9,-1,6.8,10.5,-3.7,19,EL
48d5bd33,8,600,6.7,7,5,1,0,11,12,-1,9.1,9.4,-0.3,19,EL
48e4c485,4,250,2.8,4,0,0,0,5,2,3,5.1,2.7,2.4,19,EL
494bff86,2,180,2.0,2,2,0,3,1,6,-5,1.0,4.9,-3.8,19,EL
49fe9070,1,90,1.0,1,1,0,3,0,1,-1,0.5,1.7,-1.2,19,EL
4a1abff3,6,507,5.6,6,4,0,0,2,12,-10,3.8,7.8,-3.9,19,EL
4a537185,2,87,1.0,1,0,1,0,2,2,0,1.4,1.5,-0.2,19,EL
4adc7b42,8,587,6.5,8,1,0,2,13,13,0,7.4,8.2,-0.7999999999999999,19,EL
4aea5077,10,900,10.0,10,10,0,0,25,12,13,22.0,11.0,11.1,19,EL
4b3c863f,4,390,4.3,4,4,0,1,5,2,3,5.5,3.7,1.8,19,EL
4b3e1a38,7,615,6.8,6,6,1,3,11,6,5,11.4,6.2,5.3,19,EL
4b6960d2,2,180,2.0,2,2,0,0,1,2,-1,1.1,3.2,-2.1,19,EL
4b751020,3,180,2.0,2,1,1,0,1,2,-1,0.5,2.9,-2.5,19,EL
4b803b3c,1,90,1.0,1,1,0,1,2,2,0,0.9,0.3,0.7,19,EL
4bd00a50,1,33,0.4,1,0,0,2,0,0,0,0.2,0.1,0.1,19,EL
4c5039bd,6,540,6.0,6,6,0,0,5,12,-7,5.8,9.0,-3.2,19,EL
4c537d70,3,112,1.2,1,1,2,1,4,0,4,2.1,0.6,1.4,19,EL
4c5b14d2,6,409,4.5,5,0,1,1,6,6,0,7.2,5.0,2.2,19,EL
4c5e78da,11,860,9.6,10,6,1,0,13,12,1,10.3,10.6,-0.3,19,EL
4c700f46,7,300,3.3,3,2,4,2,4,6,-2,5.6,2.2,3.4,19,EL
4c78b5ed,4,242,2.7,3,1,1,1,3,5,-2,4.1,4.1,0.0,19,EL
4c82730b,5,368,4.1,4,3,1,1,8,5,3,4.5,5.9,-1.4,19,EL
4cc82fe1,1,90,1.0,1,1,0,0,2,1,1,1.9,0.9,0.9,19,EL
4d1666ff,5,450,5.0,5,5,0,1,5,5,0,6.0,6.7,-0.7,19,EL
4d425e6e,6,453,5.0,5,4,1,0,2,12,-10,3.8,7.0,-3.2,19,EL
4d8cd038,14,950,10.6,11,5,3,0,21,11,10,18.9,10.8,8.1,19,EL
4e219ad2,4,252,2.8,2,1,2,0,9,3,6,4.4,1.9,2.6,19,EL
4e3f5992,2,20,0.2,0,0,2,4,0,0,0,0.8,0.1,0.7,19,EL
4e6dbac4,5,301,3.3,4,1,1,0,5,5,0,4.8,4.5,0.3,19,EL
4e80a8ef,8,701,7.8,8,5,0,0,10,12,-2,7.4,12.7,-5.3,19,EL
4f0fbd15,4,213,2.4,2,2,2,1,0,3,-3,1.7,3.0,-1.3,19,EL
4f255115,4,283,3.1,3,3,1,2,4,4,0,3.4,5.3,-1.9,19,EL
4f56170e,4,292,3.2,3,3,1,0,4,2,2,6.5,4.1,2.4,19,EL
4f5a953e,3,270,3.0,3,3,0,3,0,6,-6,1.5,5.1,-3.5,19,EL
4fe7e935,8,484,5.4,5,3,3,1,5,6,-1,6.2,7.2,-1.0,19,EL
500cd987,4,105,1.2,1,0,3,2,4,1,3,3.1,0.8,2.3,19,EL
50310821,1,90,1.0,1,1,0,4,1,2,-1,0.6,1.9,-1.3,19,EL
507c7bdf,8,702,7.8,8,7,0,0,14,5,9,11.2,6.7,4.5,19,EL
509a4ccb,1,90,1.0,1,1,0,0,0,1,-1,0.5,2.2,-1.7,19,EL
516dc25b,3,257,2.9,3,1,0,3,2,2,0,2.9,3.4,-0.6,19,EL
51960957,3,134,1.5,2,0,1,1,0,1,-1,2.3,1.6,0.8,19,EL
51a56075,2,180,2.0,2,2,0,0,2,4,-2,2.3,2.9,-0.6,19,EL
51e3954c,3,237,2.6,3,2,0,1,4,4,0,4.8,5.0,-0.2,19,EL
51e9bb3f,4,310,3.4,4,2,0,2,6,5,1,4.3,4.0,0.3,19,EL
51ffa295,10,806,9.0,9,7,1,0,13,7,6,13.3,8.0,5.3,19,EL
520c318f,6,460,5.1,5,5,1,0,4,9,-5,6.6,8.1,-1.4,19,EL
52611641,12,621,6.9,6,2,6,1,15,8,7,10.8,9.6,1.2,19,EL
5294a83f,5,217,2.4,3,1,2,0,2,4,-2,2.6,4.3,-1.7,19,EL
52e101a8,3,270,3.0,3,3,0,4,3,5,-2,2.7,5.1,-2.5,19,EL
52eab58c,3,204,2.3,2,2,1,2,5,4,1,4.4,2.9,1.4,19,EL
52fdf512,5,450,5.0,5,5,0,2,6,6,0,7.2,5.3,1.9,19,EL
53070b63,4,254,2.8,3,2,1,4,7,4,3,4.4,2.7,1.8,19,EL
536cebe5,9,504,5.6,5,2,4,1,11,9,2,10.7,6.5,4.2,19,EL
5384e3bf,2,180,2.0,2,2,0,4,2,8,-6,1.2,5.6,-4.3,19,EL
539230cf,2,119,1.3,1,1,1,2,4,0,4,2.5,1.3,1.1,19,EL
53cad200,9,696,7.7,7,6,2,1,16,7,9,11.8,6.4,5.4,19,EL
53de807a,3,270,3.0,3,3,0,0,3,4,-1,4.0,4.7,-0.7,19,EL
546bb36e,2,27,0.3,0,0,2,3,1,1,0,0.8,0.6,0.2,19,EL
54771b10,4,201,2.2,2,2,2,1,4,2,2,2.2,2.7,-0.5,19,EL
54c9ed15,6,400,4.4,5,3,1,2,5,4,1,3.8,6.1,-2.3,19,EL
55043155,1,9,0.1,0,0,1,4,0,0,0,0.0,0.2,-0.2,19,EL
5512b1a9,1,46,0.5,0,0,1,9,0,0,0,2.2,0.1,2.1,19,EL
55305521,2,5,0.1,0,0,2,4,0,1,-1,0.0,0.8,-0.8,19,EL
55537f53,7,563,6.3,7,2,0,0,12,3,9,10.9,4.5,6.4,19,EL
55ae91f0,5,325,3.6,4,2,1,1,6,4,2,5.1,3.6,1.5,19,EL
5626f324,2,135,1.5,2,1,0,1,2,3,-1,1.0,1.3,-0.2,19,EL
562893c2,5,450,5.0,5,5,0,0,4,8,-4,4.1,6.7,-2.6,19,EL
563a68ad,5,450,5.0,5,5,0,0,6,9,-3,7.7,9.6,-1.9,19,EL
5640992b,8,720,8.0,8,8,0,0,9,10,-1,9.8,8.3,1.5,19,EL
56413b1f,4,303,3.4,4,2,0,0,2,1,1,3.3,3.2,0.1,19,EL
565bf0da,8,727,8.1,8,7,0,0,17,10,7,11.5,9.7,1.8,19,EL
568de36f,1,62,0.7,0,0,1,5,0,3,-3,0.5,1.7,-1.1,19,EL
56901a62,2,180,2.0,2,2,0,6,0,3,-3,1.3,3.4,-2.1,19,EL
56923ba9,1,90,1.0,1,1,0,4,0,2,-2,0.2,1.3,-1.1,19,EL
56f6f826,6,540,6.0,6,6,0,0,8,8,0,6.5,6.3,0.2,19,EL
5710a281,2,169,1.9,2,1,0,1,3,3,0,2.9,1.9,1.0,19,EL
572498c7,8,709,7.9,8,7,0,0,8,11,-3,6.8,11.8,-4.9,19,EL
57376761,6,261,2.9,3,1,3,0,4,4,0,3.2,2.5,0.7,19,EL
5832ebfe,2,180,2.0,2,2,0,0,2,5,-3,2.6,3.4,-0.8,19,EL
58640e66,5,228,2.5,2,2,3,3,1,6,-5,2.5,4.1,-1.6,19,EL
586b19eb,6,495,5.5,5,5,1,0,2,7,-5,4.2,6.5,-2.3,19,EL
58ae47b2,5,365,4.1,4,3,1,0,5,10,-5,5.3,5.5,-0.2,19,EL
58b154d6,2,97,1.1,1,1,1,1,0,5,-5,0.4,3.7,-3.3,19,EL
58f077c0,10,930,10.3,10,10,0,0,16,8,8,15.8,9.1,6.7,19,EL
5906ab00,1,1,0.0,0,0,1,1,0,0,0,0.0,0.0,0.0,19,EL
597d0f13,3,154,1.7,2,0,1,0,1,4,-3,1.3,3.6,-2.3,19,EL
59bf127b,6,495,5.5,6,5,0,0,11,8,3,8.6,7.1,1.6,19,EL
59d53e8a,1,90,1.0,1,1,0,1,0,0,0,1.5,0.1,1.4,19,EL
5a28b2d9,8,668,7.4,8,6,0,0,7,8,-1,7.0,11.3,-4.3,19,EL
5a2cb25d,2,107,1.2,2,0,0,0,0,4,-4,1.2,2.1,-0.9,19,EL
5a969ba8,8,188,2.1,2,1,6,2,1,3,-2,1.3,3.9,-2.6,19,EL
5af687a1,3,157,1.7,2,0,1,3,4,4,0,2.2,2.2,0.0,19,EL
5b6cf07c,2,158,1.8,2,1,0,0,1,3,-2,1.3,3.9,-2.6,19,EL
5b887c7a,2,160,1.8,2,0,0,1,1,0,1,1.4,1.6,-0.3,19,EL
5bf476ad,2,11,0.1,0,0,2,3,0,1,-1,0.0,0.2,-0.2,19,EL
5c6ba09a,8,658,7.3,8,4,0,0,8,11,-3,5.9,11.4,-5.5,19,EL
5c97684b,2,140,1.6,2,0,0,0,2,1,1,2.1,1.7,0.4,19,EL
5c9ac7f0,6,356,4.0,4,1,2,0,5,6,-1,3.7,10.7,-7.0,19,EL
5caa62a7,6,495,5.5,6,5,0,0,7,7,0,7.4,5.8,1.6,19,EL
5ceba7fc,7,449,5.0,5,2,2,4,11,1,10,10.2,5.6,4.6,19,EL
5cef5a64,1,57,0.6,1,0,0,5,0,1,-1,0.4,1.0,-0.6,19,EL
5d4e9f31,6,415,4.6,4,3,2,0,4,10,-6,4.3,7.7,-3.4,19,EL
5d9577aa,1,27,0.3,0,0,1,0,0,1,-1,0.2,0.9,-0.7,19,EL
5da33b33,10,845,9.4,10,5,0,0,10,11,-1,13.5,11.5,2.0,19,EL
5dbefa9d,5,291,3.2,3,2,2,1,5,3,2,4.9,2.7,2.2,19,EL
5ddb8f9f,14,1255,13.9,14,13,0,0,30,14,16,24.8,15.3,9.5,19,EL
5e1028e5,4,284,3.2,3,1,1,2,6,4,2,4.7,3.3,1.4,19,EL
5e1280ff,8,607,6.7,7,3,1,0,12,11,1,9.7,8.0,1.7,19,EL
5e1df051,4,141,1.6,1,0,3,2,4,2,2,2.1,3.1,-1.0,19,EL
5e861944,4,271,3.0,3,1,1,0,3,1,2,4.6,4.1,0.6,19,EL
5e91ddf8,6,540,6.0,6,6,0,0,4,14,-10,3.4,12.1,-8.6,19,EL
5ea8ef20,11,665,7.4,7,4,4,4,15,7,8,13.6,7.4,6.2,19,EL
5ed9b537,3,270,3.0,3,3,0,2,6,5,1,5.3,3.4,2.0,19,EL
5f2caf8f,4,209,2.3,2,1,2,1,5,1,4,2.3,5.4,-3.2,19,EL
5f424f35,2,66,0.7,1,0,1,0,1,0,1,1.0,0.3,0.7,19,EL
5faa73aa,8,691,7.7,8,7,0,0,8,9,-1,7.4,12.1,-4.7,19,EL
6043997c,1,73,0.8,1,0,0,2,0,3,-3,0.8,1.8,-1.0,19,EL
60a5ee50,6,523,5.8,6,5,0,0,3,16,-13,1.7,13.8,-12.1,19,EL
60c81972,5,374,4.2,5,2,0,3,4,5,-1,5.8,6.8,-1.0,19,EL
60e86875,10,750,8.3,9,3,1,0,10,10,0,11.5,9.3,2.2,19,EL
60fd5334,6,448,5.0,6,4,0,0,4,13,-9,3.2,11.1,-7.9,19,EL
6115fddd,7,630,7.0,7,7,0,1,7,10,-3,8.4,8.9,-0.6,19,EL
611d68ee,2,4,0.0,0,0,2,4,0,0,0,0.0,0.4,-0.4,19,EL
61707054,1,72,0.8,1,0,0,1,0,1,-1,0.7,0.8,-0.1,19,EL
6186e141,5,229,2.5,2,1,3,1,2,5,-3,1.8,5.8,-4.0,19,EL
61911828,6,540,6.0,6,6,0,0,8,13,-5,9.7,8.0,1.8,19,EL
61bd33d0,4,197,2.2,2,1,2,2,1,0,1,4.0,0.7,3.4,19,EL
6228469d,2,135,1.5,1,1,1,0,2,3,-1,2.0,2.2,-0.2,19,EL
625869d0,1,90,1.0,1,1,0,1,1,1,0,0.6,1.2,-0.6,19,EL
62b7d469,5,257,2.9,3,2,2,1,3,1,2,2.2,1.8,0.5,19,EL
62c7067a,4,218,2.4,4,0,0,1,3,7,-4,2.0,3.4,-1.4,19,EL
62d0dcc5,5,263,2.9,3,2,2,0,3,3,0,3.5,4.8,-1.3,19,EL
62f427bb,5,450,5.0,5,5,0,0,3,7,-4,3.4,9.7,-6.2,19,EL
63a304f3,1,11,0.1,0,0,1,3,0,0,0,0.0,0.2,-0.2,19,EL
63f04c6c,8,566,6.3,6,6,2,3,7,10,-3,7.8,9.2,-1.5,19,EL
6438d426,3,167,1.9,1,1,2,0,4,3,1,2.6,3.6,-1.0,19,EL
644faf10,2,112,1.2,1,0,1,3,5,0,5,2.8,0.3,2.6,19,EL
64679418,2,162,1.8,2,1,0,1,5,2,3,3.3,1.7,1.5,19,EL
6492ae54,6,457,5.1,5,5,1,0,3,15,-12,1.6,11.8,-10.2,19,EL
64f69877,5,361,4.0,3,3,2,2,9,5,4,6.4,4.3,2.1,19,EL
6503ae16,1,90,1.0,1,1,0,5,1,1,0,1.2,0.6,0.6,19,EL
6554bb97,4,303,3.4,3,3,1,1,3,7,-4,3.4,7.0,-3.6,19,EL
65adf2db,8,360,4.0,4,0,4,1,8,4,4,6.5,4.6,2.0,19,EL
6605c8ae,2,78,0.9,1,0,1,2,0,0,0,0.8,0.5,0.3,19,EL
6613c819,11,1020,11.3,11,11,0,0,17,13,4,14.2,12.5,1.7,19,EL
66e86f2e,4,191,2.1,2,1,2,2,1,5,-4,1.9,4.1,-2.2,19,EL
66f5432f,6,181,2.0,1,1,5,0,0,3,-3,1.3,2.5,-1.2,19,EL
675b0427,9,810,9.0,9,9,0,0,10,11,-1,13.3,10.3,2.9,19,EL
677267d1,4,120,1.3,1,0,3,2,1,1,0,0.4,0.8,-0.4,19,EL
67b3d74b,3,288,3.2,3,2,0,1,3,2,1,3.7,2.5,1.2,19,EL
6800f515,8,720,8.0,8,8,0,0,6,11,-5,7.1,12.6,-5.4,19,EL
691f64f5,2,172,1.9,2,1,0,0,1,2,-1,1.1,3.2,-2.1,19,EL
692a8d3b,3,237,2.6,3,2,0,1,0,6,-6,1.7,4.1,-2.4,19,EL
692cd6de,4,360,4.0,4,4,0,1,3,6,-3,3.9,4.7,-0.7,19,EL
692e9958,2,59,0.7,0,0,2,0,0,0,0,1.2,0.5,0.7,19,EL
69374ff5,4,262,2.9,2,2,2,1,8,3,5,5.1,2.4,2.6,19,EL
69986380,1,32,0.4,0,0,1,1,0,0,0,1.6,0.0,1.6,19,EL
69b9be7e,5,405,4.5,5,4,0,1,4,12,-8,1.6,9.3,-7.7,19,EL
6a479195,8,651,7.2,8,3,0,0,6,10,-4,7.2,7.9,-0.8,19,EL
6b14ce11,3,209,2.3,2,2,1,2,4,6,-2,2.3,5.1,-2.9,19,EL
6b6cbca4,9,663,7.4,7,7,2,2,13,13,0,8.6,10.7,-2.1,19,EL
6b6d252d,4,265,2.9,3,2,1,1,3,7,-4,3.8,6.3,-2.5,19,EL
6b71ba6c,1,10,0.1,0,0,1,0,0,0,0,0.0,0.0,0.0,19,EL
6b994195,9,839,9.3,9,8,0,0,14,7,7,13.4,7.9,5.4,19,EL
6b9f2f3e,1,90,1.0,1,1,0,1,1,2,-1,1.4,2.7,-1.4,19,EL
6bfaecc4,5,450,5.0,5,5,0,1,4,6,-2,4.5,5.4,-0.9,19,EL
6c6e2719,3,229,2.5,3,2,0,2,9,2,7,5.7,1.2,4.5,19,EL
6ca5ec4b,11,557,6.2,6,3,5,2,11,3,8,13.3,5.4,7.9,19,EL
6d1d3dc3,4,268,3.0,3,2,1,1,0,4,-4,2.7,4.6,-1.9,19,EL
6d3f2898,2,179,2.0,2,1,0,1,4,4,0,3.8,3.0,0.8,19,EL
6d470bb6,3,52,0.6,0,0,3,3,0,1,-1,0.7,0.7,0.0,19,EL
6d4d9e18,5,239,2.7,2,1,3,1,5,6,-1,4.3,5.9,-1.6,19,EL
6e7f1353,2,134,1.5,2,0,0,1,1,4,-3,2.3,2.3,0.0,19,EL
6ec1ddf1,4,91,1.0,1,0,3,0,0,0,0,0.9,1.0,0.0,19,EL
6f1721f0,5,370,4.1,5,3,0,0,8,9,-1,7.0,9.7,-2.7,19,EL
6f4e1c93,5,450,5.0,5,5,0,1,7,10,-3,7.7,6.8,0.9,19,EL
6f5ead86,6,428,4.8,5,3,1,3,4,6,-2,4.1,4.1,0.1,19,EL
6f8a10be,1,2,0.0,0,0,1,0,1,1,0,0.6,0.5,0.1,19,EL
6fbde63a,3,227,2.5,3,1,0,1,3,6,-3,3.1,2.8,0.3,19,EL
6fd8a334,8,587,6.5,7,5,1,0,14,8,6,10.5,7.9,2.6,19,EL
6fe90922,4,327,3.6,4,3,0,0,5,1,4,5.6,4.1,1.5,19,EL
706722a8,4,315,3.5,4,3,0,0,2,4,-2,4.6,4.6,0.0,19,EL
70a9cba5,4,68,0.8,0,0,4,1,2,2,0,2.3,0.8,1.4,19,EL
70c52749,4,360,4.0,4,4,0,0,3,8,-5,2.4,7.2,-4.8,19,EL
70cf63ca,5,315,3.5,3,1,2,0,7,3,4,4.6,3.5,1.1,19,EL
712dd708,2,174,1.9,2,1,0,1,2,3,-1,1.4,1.4,-0.1,19,EL
715e5b0e,8,557,6.2,7,4,1,0,11,4,7,10.9,6.4,4.5,19,EL
71672fa0,11,990,11.0,11,11,0,0,21,11,10,18.5,13.6,4.9,19,EL
717f39e8,1,32,0.4,0,0,1,0,0,0,0,1.3,0.3,1.0,19,EL
71d5ca31,7,630,7.0,7,7,0,1,10,12,-2,8.5,14.1,-5.6,19,EL
7214c684,5,323,3.6,4,2,1,2,3,3,0,4.9,2.6,2.3,19,EL
7230b807,1,8,0.1,0,0,1,0,0,0,0,0.0,0.0,0.0,19,EL
7272a72a,2,180,2.0,2,2,0,0,3,6,-3,2.3,4.6,-2.3,19,EL
72a99e38,6,466,5.2,5,4,1,0,5,2,3,7.8,3.7,4.1,19,EL
733e7ad8,2,180,2.0,2,2,0,0,2,5,-3,2.6,3.4,-0.8,19,EL
73affbb6,2,18,0.2,0,0,2,1,1,0,1,0.1,0.8,-0.7,19,EL
73fc8cc3,10,572,6.4,6,1,4,0,7,5,2,8.6,6.5,2.1,19,EL
74419746,4,360,4.0,4,4,0,0,5,1,4,5.6,5.2,0.5,19,EL
7460ca0d,7,556,6.2,7,5,0,0,12,9,3,12.2,7.4,4.8,19,EL
746b64a7,1,90,1.0,1,1,0,0,2,0,2,1.4,0.5,0.9,19,EL
746fec7d,2,146,1.6,2,0,0,0,1,4,-3,1.5,2.6,-1.2,19,EL
74733221,5,450,5.0,5,5,0,3,8,3,5,8.4,3.3,5.1,19,EL
7483d9f9,9,810,9.0,9,9,0,0,21,12,9,19.4,9.3,10.1,19,EL
74bafc9c,2,111,1.2,1,1,1,0,1,3,-2,1.5,2.1,-0.5,19,EL
74d52033,2,132,1.5,2,0,0,3,0,1,-1,0.9,2.7,-1.7,19,EL
74dc806c,9,596,6.6,6,5,3,0,13,12,1,12.6,10.0,2.6,19,EL
75229233,8,720,8.0,8,8,0,0,8,11,-3,7.4,12.8,-5.4,19,EL
758da372,6,292,3.2,3,2,3,0,3,13,-10,1.3,8.2,-6.9,19,EL
762179d9,6,315,3.5,3,0,3,0,2,2,0,2.3,2.1,0.2,19,EL
76806215,4,360,4.0,4,4,0,1,4,10,-6,5.4,6.4,-1.0,19,EL
76d5857d,6,480,5.3,5,5,1,1,6,9,-3,6.1,5.4,0.7,19,EL
76d753f8,5,450,5.0,5,5,0,0,7,9,-2,5.5,8.8,-3.3,19,EL
76ecfb22,3,181,2.0,1,1,2,1,2,5,-3,1.0,3.6,-2.6,19,EL
770ebf00,8,576,6.4,7,1,1,0,6,8,-2,5.0,10.0,-5.0,19,EL
7750462c,5,450,5.0,5,5,0,1,8,7,1,5.7,8.7,-3.0,19,EL
779fe525,4,275,3.1,3,3,1,0,0,8,-8,1.0,6.8,-5.8,19,EL
77f278a0,3,131,1.5,1,1,2,0,2,3,-1,1.8,1.0,0.8,19,EL
78150923,5,195,2.2,2,1,3,1,4,6,-2,3.5,3.9,-0.4,19,EL
781cff03,4,174,1.9,3,0,1,2,1,1,0,1.2,0.9,0.3,19,EL
7825393b,2,47,0.5,0,0,2,3,1,0,1,0.7,0.2,0.4,19,EL
7847ad0c,4,360,4.0,4,4,0,2,3,11,-8,4.0,7.0,-2.9,19,EL
78841da9,5,450,5.0,5,5,0,1,7,7,0,7.9,8.4,-0.5,19,EL
78af782c,3,186,2.1,2,2,1,0,2,2,0,2.2,2.1,0.2,19,EL
7914b9fe,4,360,4.0,4,4,0,4,9,1,8,9.6,2.8,6.8,19,EL
7956236f,1,90,1.0,1,1,0,5,1,0,1,1.0,0.1,0.9,19,EL
797cf5cb,6,471,5.2,5,5,1,0,4,10,-6,2.0,10.1,-8.1,19,EL
79c0821a,12,913,10.1,10,7,2,1,26,6,20,22.5,7.1,15.4,19,EL
7a4cea18,4,275,3.1,3,1,1,1,3,0,3,3.6,2.2,1.3,19,EL
7a68aefa,6,332,3.7,3,1,3,0,3,9,-6,2.7,7.0,-4.2,19,EL
7a7f9e0d,6,503,5.6,6,3,0,0,5,10,-5,4.2,9.0,-4.7,19,EL
7a854622,3,159,1.8,2,1,1,3,4,1,3,4.2,0.5,3.8,19,EL
7a8779f3,2,180,2.0,2,2,0,4,0,3,-3,1.0,4.9,-3.9,19,EL
7ab2fee8,5,419,4.7,5,4,0,1,2,15,-13,1.6,11.4,-9.8,19,EL
7ab59ec0,4,351,3.9,4,3,0,0,3,7,-4,3.0,8.3,-5.3,19,EL
7b456af7,10,884,9.8,10,9,0,0,26,12,14,18.7,12.8,5.8,19,EL
7b4a8d08,4,165,1.8,1,1,3,2,1,0,1,2.0,1.8,0.2,19,EL
7b602cee,6,495,5.5,5,5,1,0,4,10,-6,2.3,10.6,-8.3,19,EL
7b66eec0,2,96,1.1,2,1,0,3,0,1,-1,0.2,2.6,-2.5,19,EL
7b8ff0ac,2,180,2.0,2,2,0,8,1,4,-3,1.0,3.5,-2.5,19,EL
7bcd6098,1,81,0.9,1,0,0,3,0,1,-1,0.7,0.8,-0.1,19,EL
7be09c86,6,357,4.0,4,2,2,0,1,11,-10,2.1,7.7,-5.5,19,EL
7c224498,2,180,2.0,2,2,0,1,4,4,0,2.2,2.3,-0.1,19,EL
7c4243d4,8,616,6.8,6,4,2,2,19,7,12,15.8,9.3,6.5,19,EL
7c473e12,7,630,7.0,7,7,0,0,5,9,-4,5.3,10.3,-5.1,19,EL
7c4740ec,2,22,0.2,0,0,2,1,0,1,-1,0.2,0.3,-0.1,19,EL
7c7fdb0f,8,690,7.7,8,7,0,0,7,10,-3,6.8,12.4,-5.6,19,EL
7cc5bd9c,5,450,5.0,5,5,0,1,5,7,-2,4.5,7.0,-2.5,19,EL
7cd78926,6,540,6.0,6,6,0,0,5,7,-2,5.8,6.0,-0.2,19,EL
7cf431a5,6,279,3.1,3,2,3,1,3,4,-1,3.9,5.3,-1.4,19,EL
7d036b4a,8,566,6.3,7,2,1,0,5,8,-3,5.5,8.7,-3.2,19,EL
7d48aed2,3,100,1.1,1,1,2,3,3,2,1,2.3,0.9,1.4,19,EL
7d5e2c80,5,450,5.0,5,5,0,0,5,12,-7,7.8,7.5,0.3,19,EL
7d6921f8,4,148,1.6,1,0,3,1,1,1,0,2.0,0.6,1.4,19,EL
7d974435,6,392,4.4,4,4,2,0,2,4,-2,2.2,4.3,-2.1,19,EL
7dca49f6,2,76,0.8,1,0,1,1,2,1,1,1.6,0.5,1.1,19,EL
7df95c14,2,173,1.9,2,1,0,1,4,2,2,3.9,0.9,3.0,19,EL
7e56d3db,5,343,3.8,4,1,1,1,6,1,5,4.5,2.6,1.9,19,EL
7e927fda,4,360,4.0,4,4,0,2,4,6,-2,5.6,6.1,-0.4,19,EL
7e964a67,5,105,1.2,0,0,5,1,3,0,3,2.0,1.2,0.9,19,EL
7eb97a8e,3,228,2.5,3,1,0,2,4,3,1,2.8,3.3,-0.6,19,EL
7f043eec,3,120,1.3,1,0,2,0,3,0,3,1.5,0.8,0.7,19,EL
7f66ea09,1,90,1.0,1,1,0,5,1,1,0,1.5,0.9,0.7,19,EL
7f78ad23,3,264,2.9,3,2,0,2,5,5,0,4.0,5.1,-1.1,19,EL
7f78f582,3,95,1.1,1,0,2,2,1,3,-2,1.6,1.8,-0.2,19,EL
7fac99d4,6,495,5.5,5,4,1,0,7,9,-2,7.6,12.3,-4.8,19,EL
7fcc71d8,8,623,6.9,7,4,1,0,12,7,5,13.6,7.2,6.4,19,EL
7fd58fe3,7,379,4.2,3,2,4,0,4,8,-4,6.6,8.5,-1.9,19,EL
7fe90ccd,10,719,8.0,8,6,2,4,18,3,15,19.5,5.9,13.6,19,EL
7ff93107,1,18,0.2,0,0,1,0,0,0,0,0.1,0.5,-0.4,19,EL
8023bcab,7,585,6.5,7,6,0,0,5,12,-7,6.0,10.2,-4.1,19,EL
80490d7f,3,270,3.0,3,3,0,1,6,9,-3,4.4,6.1,-1.6,19,EL
808d48f3,6,527,5.9,6,4,0,1,11,4,7,10.2,6.7,3.5,19,EL
8104e41e,1,28,0.3,0,0,1,1,0,1,-1,1.3,1.2,0.1,19,EL
81442ecb,6,526,5.8,6,5,0,0,7,3,4,8.1,4.3,3.8,19,EL
819a94a2,1,90,1.0,1,1,0,2,0,6,-6,0.7,1.9,-1.2,19,EL
81d3318f,5,237,2.6,3,0,2,0,3,2,1,4.7,3.1,1.7,19,EL
81f0781e,11,713,7.9,7,5,4,0,12,12,0,12.9,14.0,-1.1,19,EL
8229a21c,3,270,3.0,3,3,0,3,2,3,-1,1.9,4.1,-2.1,19,EL
826313e2,7,630,7.0,7,7,0,1,8,12,-4,6.4,12.6,-6.1,19,EL
82671804,6,518,5.8,5,4,1,0,5,15,-10,7.0,9.7,-2.7,19,EL
82927de4,12,875,9.7,10,6,2,0,19,11,8,16.0,13.6,2.4,19,EL
82988fd8,2,26,0.3,0,0,2,5,0,0,0,0.1,0.3,-0.2,19,EL
831cf3ac,5,396,4.4,4,4,1,0,4,4,0,3.9,3.5,0.4,19,EL
834d0be5,7,414,4.6,4,3,3,1,11,4,7,8.1,4.9,3.2,19,EL
83534f30,3,270,3.0,3,3,0,1,2,5,-3,2.5,4.6,-2.1,19,EL
839c14e1,4,253,2.8,3,2,1,0,5,1,4,3.9,3.0,0.9,19,EL
83b9c48f,5,245,2.7,2,2,3,1,2,3,-1,2.4,2.6,-0.2,19,EL
8454388c,2,163,1.8,2,1,0,0,2,4,-2,2.3,2.8,-0.6,19,EL
8455ad90,2,38,0.4,0,0,2,2,0,0,0,1.1,0.3,0.8,19,EL
84570bef,6,540,6.0,6,6,0,0,3,16,-13,1.7,14.1,-12.3,19,EL
8474cb83,2,41,0.5,0,0,2,6,1,1,0,1.3,1.5,-0.2,19,EL
8494acc4,6,435,4.8,5,4,1,0,6,7,-1,6.2,5.4,0.7,19,EL
84fb6aff,1,90,1.0,1,1,0,3,1,3,-2,1.8,1.8,0.0,19,EL
854a2041,2,166,1.8,2,1,0,2,1,4,-3,2.6,2.2,0.4,19,EL
85613cf0,6,389,4.3,4,3,2,0,7,5,2,8.5,6.5,1.9,19,EL
85a44ecc,6,489,5.4,6,2,0,0,7,7,0,5.2,5.4,-0.2,19,EL
85b4255f,2,180,2.0,2,2,0,1,0,4,-4,0.7,5.4,-4.7,19,EL
85d5ccdb,6,297,3.3,3,3,3,0,4,5,-1,3.0,4.9,-1.9,19,EL
85f8571a,8,720,8.0,8,8,0,0,10,9,1,11.0,8.4,2.6,19,EL
86012f0e,2,180,2.0,2,2,0,0,2,4,-2,2.3,2.9,-0.6,19,EL
862fa9fb,2,180,2.0,2,2,0,0,3,6,-3,2.3,4.6,-2.3,19,EL
8652a85c,2,34,0.4,0,0,2,0,1,1,0,1.1,0.7,0.4,19,EL
86765ca8,3,181,2.0,2,2,1,1,0,4,-4,0.8,4.4,-3.6,19,EL
8696bc90,3,199,2.2,2,1,1,1,4,4,0,5.1,2.2,2.9,19,EL
86f9fb71,5,450,5.0,5,5,0,0,4,7,-3,3.9,9.4,-5.5,19,EL
874125a3,3,239,2.7,3,2,0,2,4,0,4,4.1,1.0,3.1,19,EL
874d7a32,3,300,3.3,3,3,0,0,7,4,3,4.2,3.6,0.6,19,EL
8754c7ca,5,440,4.9,5,4,0,2,6,8,-2,7.0,7.0,0.0,19,EL
88062e83,7,368,4.1,4,1,3,0,9,4,5,6.6,4.2,2.4,19,EL
881cd6be,3,237,2.6,3,2,0,2,2,2,0,3.6,2.4,1.2,19,EL
8821f471,5,298,3.3,3,2,2,1,2,4,-2,2.9,3.5,-0.6,19,EL
88392398,4,113,1.3,1,0,3,1,0,4,-4,0.4,3.6,-3.2,19,EL
884a8908,4,266,3.0,3,1,1,0,3,7,-4,2.4,6.4,-4.0,19,EL
886f9aac,2,68,0.8,1,0,1,0,0,2,-2,0.3,2.3,-2.0,19,EL
88b5445c,2,180,2.0,2,2,0,4,1,3,-2,2.5,1.9,0.6,19,EL
88b748d2,6,540,6.0,6,6,0,0,7,7,0,7.5,6.9,0.6,19,EL
890fa4b5,1,90,1.0,1,1,0,5,1,0,1,0.7,0.4,0.3,19,EL
89151b16,3,181,2.0,2,2,1,2,1,1,0,2.7,0.7,2.1,19,EL
89b2c8a9,5,358,4.0,4,1,1,0,6,4,2,7.2,5.1,2.1,19,EL
89cbc961,10,817,9.1,9,7,1,2,16,7,9,13.4,10.9,2.6,19,EL
8a08491a,6,475,5.3,5,5,1,7,11,8,3,8.9,6.7,2.4,19,EL
8a1d7b51,8,677,7.5,8,7,0,0,9,10,-1,10.0,9.5,0.6,19,EL
8a387393,3,20,0.2,0,0,3,1,0,0,0,0.3,0.1,0.2,19,EL
8a6ab963,9,783,8.7,9,8,0,1,10,10,0,11.5,10.2,1.4,19,EL
8a7a5ad7,2,155,1.7,2,1,0,0,3,4,-1,2.1,3.9,-1.8,19,EL
8aafd64f,6,493,5.5,5,4,1,0,9,6,3,7.6,6.0,1.6,19,EL
8ae07c1c,1,90,1.0,1,1,0,5,0,0,0,1.0,1.0,0.0,19,EL
8b298f56,9,752,8.4,9,5,0,0,15,11,4,12.7,9.6,3.1,19,EL
8b66d9cc,6,190,2.1,1,0,5,0,4,3,1,4.2,4.7,-0.5,19,EL
8b8a56ce,7,660,7.3,7,7,0,0,14,10,4,14.7,10.2,4.5,19,EL
8b92fc98,4,256,2.8,3,1,1,3,2,8,-6,2.0,5.4,-3.4,19,EL
8b9ebd03,15,895,9.9,11,3,4,0,22,3,19,20.1,5.8,14.3,19,EL
8bc373ea,7,630,7.0,7,7,0,0,13,9,4,13.0,7.9,5.1,19,EL
8beb3c36,1,9,0.1,0,0,1,0,0,0,0,0.1,0.2,-0.1,19,EL
8c5f1522,1,61,0.7,1,0,0,3,0,0,0,0.4,0.1,0.3,19,EL
8c70d3ee,3,62,0.7,0,0,3,2,1,2,-1,0.7,1.6,-0.9,19,EL
8ce063f9,6,221,2.5,2,1,4,1,2,4,-2,2.2,2.7,-0.5,19,EL
8d7323e8,5,332,3.7,4,0,1,0,5,5,0,6.5,3.0,3.5,19,EL
8dbff17c,4,264,2.9,4,2,0,0,4,8,-4,4.3,4.4,-0.1,19,EL
8e088e04,4,360,4.0,4,4,0,3,7,1,6,6.1,3.6,2.5,19,EL
8e371868,6,540,6.0,6,6,0,0,6,8,-2,6.8,7.5,-0.8,19,EL
8e58987d,9,769,8.5,9,6,0,3,18,9,9,15.5,9.5,6.0,19,EL
8e7f49d3,4,315,3.5,4,3,0,0,4,6,-2,5.3,2.5,2.8,19,EL
8ea2c099,6,347,3.9,4,2,2,2,8,4,4,7.3,3.5,3.8,19,EL
8ec4c2f7,5,450,5.0,5,5,0,1,5,11,-6,5.6,6.4,-0.8,19,EL
8ed1d91b,4,315,3.5,3,3,1,1,7,5,2,4.4,4.8,-0.4,19,EL
8eec784d,1,32,0.4,0,0,1,1,0,0,0,0.1,0.1,0.0,19,EL
8f056768,8,624,6.9,7,4,1,0,16,9,7,14.6,7.0,7.7,19,EL
8f5bfaac,2,39,0.4,0,0,2,2,0,2,-2,0.6,1.4,-0.8,19,EL
8ff2354e,4,206,2.3,1,0,3,2,6,2,4,4.3,2.8,1.5,19,EL
90104ffb,4,360,4.0,4,4,0,0,3,6,-3,4.4,5.9,-1.5,19,EL
901d3e51,5,185,2.1,0,0,5,0,1,2,-1,3.0,1.6,1.4,19,EL
903b6e8b,7,630,7.0,7,7,0,1,13,9,4,13.0,7.9,5.1,19,EL
9050ddc4,11,514,5.7,5,3,6,1,14,5,9,12.2,6.5,5.7,19,EL
90573602,4,360,4.0,4,4,0,0,5,3,2,5.1,3.1,2.0,19,EL
90decc12,2,171,1.9,2,1,0,0,1,3,-2,2.5,1.7,0.8,19,EL
9139bb12,2,157,1.7,2,1,0,0,3,6,-3,2.2,3.9,-1.6,19,EL
91538ba3,1,16,0.2,0,0,1,3,1,0,1,0.3,0.6,-0.3,19,EL
91899ca8,1,81,0.9,1,0,0,2,1,1,0,0.5,0.8,-0.3,19,EL
92432bc6,4,360,4.0,4,4,0,0,14,5,9,11.2,2.5,8.6,19,EL
925e1359,1,1,0.0,0,0,1,0,0,1,-1,0.0,0.2,-0.2,19,EL
9260926b,6,193,2.1,2,1,4,2,7,2,5,4.2,2.6,1.6,19,EL
92b17b2a,4,316,3.5,4,2,0,0,0,7,-7,1.4,6.1,-4.7,19,EL
934e1968,1,73,0.8,1,0,0,3,2,1,1,1.6,1.1,0.5,19,EL
93b891d1,5,427,4.7,5,3,0,0,4,6,-2,7.8,6.3,1.5,19,EL
93bf37c5,6,278,3.1,4,0,2,0,6,6,0,3.6,5.8,-2.2,19,EL
940efd73,6,412,4.6,4,3,2,0,5,9,-4,5.8,5.2,0.6,19,EL
94130fc4,2,30,0.3,0,0,2,0,0,0,0,0.6,0.5,0.1,19,EL
9413b19f,6,540,6.0,6,6,0,0,9,7,2,11.2,9.1,2.1,19,EL
942b4f90,8,619,6.9,7,4,1,1,16,8,8,15.3,8.6,6.6,19,EL
947239ca,2,93,1.0,1,0,1,2,2,1,1,1.4,1.4,0.0,19,EL
94d260aa,5,450,5.0,5,5,0,0,4,6,-2,4.5,5.4,-0.9,19,EL
94d628b1,3,105,1.2,1,1,2,2,0,1,-1,0.9,1.2,-0.3,19,EL
94f8d10c,5,450,5.0,5,5,0,1,5,13,-8,6.7,8.3,-1.6,19,EL
952e0df2,4,360,4.0,4,4,0,4,4,8,-4,4.4,5.5,-1.0,19,EL
953597a1,5,450,5.0,5,5,0,4,5,5,0,6.0,7.9,-1.9,19,EL
958bba56,9,573,6.4,7,3,2,0,8,3,5,10.3,7.0,3.3,19,EL
96094cbc,4,246,2.7,2,0,2,0,3,1,2,3.7,1.7,1.9,19,EL
960acc0a,2,162,1.8,2,1,0,0,1,2,-1,0.9,3.1,-2.2,19,EL
962e54cb,6,72,0.8,0,0,6,2,1,0,1,1.2,0.8,0.4,19,EL
963829d0,7,496,5.5,6,3,1,2,11,8,3,10.1,8.1,2.0,19,EL
963a328b,3,84,0.9,1,0,2,2,1,3,-2,0.7,2.1,-1.5,19,EL
96ddfa79,6,475,5.3,5,2,1,0,3,15,-12,1.4,11.8,-10.4,19,EL
96f2d977,4,331,3.7,4,3,0,0,3,5,-2,3.4,3.8,-0.4,19,EL
9744ff80,8,444,4.9,5,2,3,1,12,6,6,11.5,5.6,5.9,19,EL
9778d8dd,1,14,0.2,0,0,1,2,1,0,1,0.6,0.4,0.2,19,EL
97b87472,1,90,1.0,1,1,0,2,0,4,-4,0.6,3.8,-3.2,19,EL
97bfa797,6,420,4.7,6,2,0,0,6,5,1,5.9,4.3,1.6,19,EL
98554bfd,4,192,2.1,3,0,1,2,2,2,0,2.0,5.5,-3.5,19,EL
98afb06c,5,111,1.2,1,0,4,0,2,2,0,1.6,1.9,-0.3,19,EL
98d5ecc2,6,451,5.0,5,5,1,1,7,6,1,7.8,4.7,3.2,19,EL
9916979a,5,366,4.1,5,0,0,0,5,4,1,2.5,5.7,-3.1,19,EL
997fff07,3,140,1.6,1,1,2,0,3,4,-1,3.4,4.0,-0.7,19,EL
99a4bb79,1,11,0.1,0,0,1,1,0,0,0,0.0,0.5,-0.5,19,EL
99b1d0e6,6,523,5.8,6,5,0,2,14,2,12,12.2,3.5,8.6,19,EL
9ab16552,14,1231,13.7,14,13,0,0,28,13,15,25.1,15.3,9.8,19,EL
9ada6f1d,3,163,1.8,2,1,1,2,3,7,-4,1.4,4.6,-3.2,19,EL
9bc78273,1,90,1.0,1,1,0,5,0,3,-3,0.4,3.0,-2.6,19,EL
9bcd6455,3,103,1.1,0,0,3,0,3,0,3,1.6,1.2,0.4,19,EL
9bd3b683,2,170,1.9,2,0,0,0,2,2,0,2.0,2.1,-0.1,19,EL
9bd73cce,2,51,0.6,0,0,2,1,1,0,1,0.6,1.2,-0.6,19,EL
9c0c2413,6,495,5.5,5,5,1,0,5,10,-5,5.0,8.1,-3.1,19,EL
9c145144,7,484,5.4,6,2,1,0,3,6,-3,4.1,6.7,-2.6,19,EL
9d40ca9c,9,840,9.3,9,9,0,2,17,11,6,12.6,10.8,1.8,19,EL
9d60028d,2,159,1.8,2,0,0,0,3,4,-1,2.2,3.8,-1.6,19,EL
9d689a5b,2,50,0.6,0,0,2,0,0,1,-1,1.3,0.4,0.9,19,EL
9d7d5334,1,90,1.0,1,1,0,0,1,1,0,1.0,2.0,-1.0,19,EL
9d8586c4,2,167,1.9,2,1,0,0,2,3,-1,4.1,5.4,-1.3,19,EL
9d971f13,6,457,5.1,5,3,1,0,5,6,-1,5.6,5.3,0.3,19,EL
9dbb75ca,10,648,7.2,8,3,2,1,15,8,7,10.4,9.9,0.5,19,EL
9e1035f8,4,260,2.9,3,2,1,4,4,2,2,4.4,4.1,0.3,19,EL
9e49c320,1,8,0.1,0,0,1,0,0,0,0,0.0,0.0,0.0,19,EL
9f810e29,1,17,0.2,0,0,1,0,0,0,0,0.1,0.0,0.1,19,EL
9f9c57f0,3,235,2.6,3,2,0,0,2,8,-6,1.2,5.5,-4.3,19,EL
9fc2531b,4,304,3.4,3,3,1,1,3,4,-1,4.4,3.3,1.1,19,EL
a0255c67,5,315,3.5,3,2,2,2,4,6,-2,5.5,4.6,0.9,19,EL
a0313275,4,331,3.7,4,3,0,1,0,8,-8,1.2,6.9,-5.8,19,EL
a04e2dd2,8,720,8.0,8,8,0,0,8,11,-3,7.4,12.8,-5.4,19,EL
a08b5224,2,146,1.6,2,0,0,0,1,3,-2,1.7,2.6,-0.9,19,EL
a08b974a,4,340,3.8,4,2,0,1,4,9,-5,5.6,4.8,0.9,19,EL
a0aa4566,2,34,0.4,0,0,2,0,0,0,0,0.4,1.4,-1.1,19,EL
a0d59251,5,391,4.3,4,4,1,0,7,6,1,5.1,7.5,-2.5,19,EL
a165a577,1,90,1.0,1,1,0,7,1,1,0,1.1,0.9,0.2,19,EL
a167537f,7,409,4.5,5,3,2,0,9,5,4,6.9,4.8,2.0,19,EL
a179d516,2,180,2.0,2,2,0,13,5,2,3,3.3,0.9,2.4,19,EL
a275b145,2,85,0.9,1,0,1,1,1,3,-2,0.2,3.5,-3.3,19,EL
a2947130,6,489,5.4,6,4,0,0,4,6,-2,4.3,10.3,-6.0,19,EL
a2950e2d,7,368,4.1,3,1,4,1,5,4,1,6.0,3.6,2.5,19,EL
a2abe631,2,180,2.0,2,2,0,0,1,2,-1,1.1,3.2,-2.1,19,EL
a30a166e,4,288,3.2,4,1,0,1,2,4,-2,0.6,5.4,-4.7,19,EL
a33a0dc0,1,45,0.5,1,0,0,1,0,1,-1,0.2,0.6,-0.4,19,EL
a372a9f2,6,533,5.9,6,5,0,0,2,13,-11,4.1,8.4,-4.3,19,EL
a39bb753,8,452,5.0,4,1,4,3,12,6,6,9.3,5.7,3.6,19,EL
a3b03921,3,194,2.2,2,2,1,0,4,0,4,4.2,1.1,3.1,19,EL
a3bf2258,5,344,3.8,4,1,1,1,2,3,-1,3.1,4.5,-1.4000000000000001,19,EL
a3d524cb,5,450,5.0,5,5,0,1,2,7,-5,4.2,7.1,-2.9,19,EL
a45eac1f,5,335,3.7,4,3,1,0,2,4,-2,4.4,2.6,1.8,19,EL
a4b1028a,8,675,7.5,8,7,0,1,12,11,1,10.9,10.8,0.1,19,EL
a4fe8cda,5,328,3.6,3,1,2,0,10,6,4,4.4,4.5,-0.1,19,EL
a51728e3,2,180,2.0,2,2,0,0,1,7,-6,0.6,5.7,-5.1,19,EL
a5212312,4,360,4.0,4,4,0,2,5,3,2,5.0,3.9,1.1,19,EL
a5296e55,6,473,5.3,6,3,0,0,8,6,2,8.6,7.6,1.0,19,EL
a53649b7,2,180,2.0,2,2,0,9,4,0,4,3.2,0.8,2.3,19,EL
a5d101a9,8,670,7.4,8,5,0,0,10,11,-1,7.6,12.0,-4.4,19,EL
a5e16eba,7,629,7.0,7,6,0,0,9,8,1,7.4,11.4,-4.1,19,EL
a5e96539,5,370,4.1,4,3,1,3,6,8,-2,4.3,11.4,-7.1,19,EL
a5f458d9,2,93,1.0,1,1,1,1,0,2,-2,0.8,3.3,-2.5,19,EL
a637251f,6,199,2.2,1,0,5,0,2,6,-4,2.0,2.9,-0.9,19,EL
a64b4786,1,90,1.0,1,1,0,1,1,1,0,1.0,2.0,-1.0,19,EL
a6951bf8,7,442,4.9,3,3,4,0,9,6,3,9.4,4.4,5.0,19,EL
a69cf944,6,297,3.3,3,2,3,0,4,10,-6,6.4,6.2,0.2,19,EL
a6b9bd00,3,61,0.7,1,0,2,1,1,2,-1,0.6,0.3,0.2,19,EL
a6de370d,6,470,5.2,5,5,1,0,8,8,0,8.3,7.1,1.2,19,EL
a70b8345,2,180,2.0,2,2,0,11,4,1,3,4.2,2.1,2.1,19,EL
a801669e,3,269,3.0,3,2,0,1,6,5,1,4.2,2.5,1.7,19,EL
a81ed730,9,633,7.0,7,5,2,0,5,14,-9,7.1,14.9,-7.8,19,EL
a8c0acb7,3,161,1.8,1,1,2,1,1,3,-2,3.0,4.1,-1.1,19,EL
a8c62306,3,99,1.1,1,0,2,0,2,1,1,0.6,1.9,-1.3,19,EL
a8f41212,6,218,2.4,2,1,4,0,0,6,-6,2.0,5.8,-3.8,19,EL
a96e5dc0,2,126,1.4,2,1,0,0,0,2,-2,0.7,1.3,-0.6,19,EL
a98a9189,1,33,0.4,0,0,1,4,0,2,-2,0.5,1.0,-0.5,19,EL
a9dc785c,8,720,8.0,8,8,0,0,14,10,4,14.8,9.1,5.6,19,EL
aa1ecac3,6,446,5.0,5,3,1,0,4,11,-7,3.7,8.3,-4.6,19,EL
aa21406e,1,12,0.1,0,0,1,1,0,0,0,0.1,0.5,-0.4,19,EL
aa5fd980,3,92,1.0,1,0,2,1,2,1,1,1.2,1.7,-0.5,19,EL
aad9c3f3,8,410,4.6,5,0,3,0,8,5,3,8.6,4.4,4.2,19,EL
aae023c4,3,34,0.4,0,0,3,3,2,1,1,2.3,0.5,1.8,19,EL
aaee68f1,4,156,1.7,2,0,2,0,2,3,-1,1.3,2.7,-1.4,19,EL
aaf0fd15,3,22,0.2,0,0,3,3,0,1,-1,0.3,0.4,-0.1,19,EL
ab77f2d9,3,270,3.0,3,3,0,3,5,6,-1,4.9,4.0,0.9,19,EL
abcfaa50,5,222,2.5,2,2,3,1,1,7,-6,1.1,5.3,-4.2,19,EL
ac1f056e,2,31,0.3,0,0,2,0,0,0,0,0.2,0.1,0.1,19,EL
ac290817,5,220,2.4,2,1,3,0,2,4,-2,4.5,6.6,-2.1,19,EL
ac3fb1be,5,382,4.2,5,4,0,0,8,8,0,8.2,5.4,2.9,19,EL
ac73ec79,5,342,3.8,5,0,0,1,4,4,0,4.9,3.5,1.4,19,EL
ac7d7378,2,91,1.0,1,1,1,1,0,1,-1,0.4,0.7,-0.3,19,EL
ac7e640b,1,90,1.0,1,1,0,1,1,0,1,2.5,0.2,2.2,19,EL
ad10eae0,1,86,1.0,1,0,0,0,0,3,-3,0.4,1.9,-1.5,19,EL
ad1d334f,4,346,3.8,4,3,0,0,2,7,-5,3.0,5.9,-2.9,19,EL
ad1ffcfd,5,264,2.9,3,1,2,1,7,2,5,4.8,4.5,0.4,19,EL
ad3389d5,6,540,6.0,6,6,0,0,11,8,3,8.0,7.6,0.5,19,EL
ad6295d4,3,165,1.8,2,1,1,2,6,2,4,4.5,2.8,1.7,19,EL
ae0f7da7,12,884,9.8,10,4,2,0,10,6,4,10.4,8.7,1.7,19,EL
ae44e8e2,10,923,10.3,10,8,0,0,16,8,8,15.5,9.1,6.4,19,EL
aec63b70,6,361,4.0,4,2,2,0,5,7,-2,5.1,4.9,0.1,19,EL
af3ddb2e,1,1,0.0,0,0,1,1,0,0,0,0.0,0.0,0.0,19,EL
af43f64f,4,341,3.8,4,3,0,1,6,11,-5,3.9,7.1,-3.2,19,EL
af686bed,2,20,0.2,0,0,2,1,2,1,1,1.0,1.5,-0.5,19,EL
af7e69d1,5,450,5.0,5,5,0,0,2,10,-8,3.1,6.1,-3.0,19,EL
af8ccfb1,4,174,1.9,2,1,2,3,2,1,1,2.1,1.0,1.1,19,EL
af8e4246,5,445,4.9,5,4,0,0,5,7,-2,6.8,5.9,0.9,19,EL
afbf187b,4,360,4.0,4,4,0,1,3,7,-4,5.9,8.7,-2.8,19,EL
b0547a87,4,149,1.7,2,0,2,0,1,1,0,0.9,0.9,0.0,19,EL
b05e2dbd,4,360,4.0,4,4,0,3,7,9,-2,8.6,5.5,3.2,19,EL
b0616e3d,4,259,2.9,4,2,0,1,7,2,5,5.8,2.3,3.5,19,EL
b0edd538,3,264,2.9,3,2,0,4,3,1,2,3.8,2.0,1.8,19,EL
b1313ec4,5,450,5.0,5,5,0,0,8,8,0,5.7,6.1,-0.4,19,EL
b148f34c,3,135,1.5,1,0,2,0,1,1,0,1.8,3.3,-1.5,19,EL
b14d0c5d,7,630,7.0,7,7,0,1,10,7,3,11.9,7.9,4.0,19,EL
b15780e3,6,540,6.0,6,6,0,2,6,8,-2,5.8,9.2,-3.4,19,EL
b182a240,10,758,8.4,7,5,3,0,23,9,14,16.7,12.0,4.7,19,EL
b1b99435,1,90,1.0,1,1,0,0,0,2,-2,1.3,1.1,0.2,19,EL
b1cd37e6,12,1035,11.5,11,10,1,1,21,11,10,18.9,13.1,5.7,19,EL
b1deecf8,5,450,5.0,5,5,0,1,11,9,2,6.9,6.9,-0.1,19,EL
b1f4086c,5,435,4.8,4,4,1,0,7,5,2,6.1,5.1,1.0,19,EL
b220064a,2,104,1.2,1,0,1,0,4,3,1,1.5,1.1,0.5,19,EL
b2484b77,6,462,5.1,6,1,0,0,5,6,-1,3.0,7.0,-4.1,19,EL
b2d0ec1b,4,186,2.1,2,0,2,1,5,2,3,3.9,2.9,0.9,19,EL
b33e0095,2,96,1.1,1,0,1,1,0,2,-2,0.6,1.1,-0.6,19,EL
b352cfa6,1,10,0.1,0,0,1,0,1,0,1,0.5,0.0,0.5,19,EL
b35db3f6,5,256,2.8,3,2,2,2,4,4,0,5.5,4.1,1.3,19,EL
b36b3f96,1,13,0.1,0,0,1,5,0,1,-1,0.1,0.5,-0.4,19,EL
b387af71,6,540,6.0,6,6,0,0,6,8,-2,6.8,7.5,-0.8,19,EL
b3a712de,9,770,8.6,9,7,0,0,6,10,-4,11.5,11.1,0.4,19,EL
b3dc6eca,10,900,10.0,10,10,0,0,15,13,2,13.7,15.3,-1.6,19,EL
b3e4a674,2,145,1.6,2,1,0,0,1,2,-1,0.9,2.8,-1.9,19,EL
b4819112,8,642,7.1,7,5,1,0,8,6,2,8.8,6.9,2.0,19,EL
b5365398,1,90,1.0,1,1,0,1,5,2,3,1.5,0.4,1.1,19,EL
b5920350,2,159,1.8,2,0,0,0,1,2,-1,1.7,1.5,0.3,19,EL
b5f63410,3,256,2.8,3,1,0,0,0,5,-5,1.6,5.1,-3.4,19,EL
b675e328,2,79,0.9,1,0,1,2,0,2,-2,0.2,1.8,-1.6,19,EL
b682dcf6,12,975,10.8,11,10,1,0,22,9,13,17.7,11.8,5.9,19,EL
b684a484,3,184,2.0,2,1,1,1,5,2,3,5.0,0.6,4.4,19,EL
b686f4c0,9,432,4.8,4,1,5,0,14,5,9,11.5,5.7,5.8,19,EL
b6972deb,5,266,3.0,3,1,2,1,2,5,-3,4.1,4.9,-0.8,19,EL
b69c4388,7,368,4.1,4,4,3,0,3,6,-3,3.8,4.7,-1.0,19,EL
b6b2b820,3,117,1.3,1,1,2,1,2,3,-1,3.2,1.0,2.2,19,EL
b6ccdcda,1,15,0.2,0,0,1,5,0,1,-1,0.1,0.5,-0.4,19,EL
b737f944,1,28,0.3,0,0,1,1,0,0,0,0.2,0.0,0.2,19,EL
b742cc0d,6,450,5.0,5,4,1,1,8,5,3,8.4,5.6,2.8,19,EL
b75af9ce,5,324,3.6,4,1,1,1,5,6,-1,4.1,7.8,-3.7,19,EL
b7705481,5,450,5.0,5,5,0,0,7,10,-3,7.7,6.4,1.3,19,EL
b7ca5c51,6,495,5.5,5,5,1,0,10,10,0,10.4,7.6,2.8,19,EL
b825a650,4,286,3.2,3,1,1,0,6,4,2,5.1,2.8,2.4,19,EL
b82880c6,7,598,6.6,6,5,1,5,15,4,11,11.9,5.9,6.1,19,EL
b8441408,5,418,4.6,5,3,0,1,4,5,-1,5.7,4.6,1.2,19,EL
b8798a46,4,360,4.0,4,4,0,1,3,4,-1,3.7,5.1,-1.3,19,EL
b87a2715,5,328,3.6,4,2,1,0,1,9,-8,3.1,5.4,-2.4,19,EL
b8814868,7,597,6.6,7,4,0,0,12,8,4,7.1,9.9,-2.8,19,EL
b8a642fc,9,502,5.6,5,2,4,2,10,6,4,8.9,8.8,0.1,19,EL
b8a6bf56,3,270,3.0,3,3,0,0,5,7,-2,2.5,7.9,-5.4,19,EL
b8ae831b,3,225,2.5,3,2,0,0,0,4,-4,1.8,4.5,-2.6,19,EL
b8c1de25,1,47,0.5,0,0,1,0,1,2,-1,0.7,1.3,-0.6,19,EL
b8d22478,5,440,4.9,5,4,0,1,4,6,-2,6.7,7.0,-0.3,19,EL
b921a3aa,1,18,0.2,0,0,1,0,0,0,0,0.9,0.2,0.7,19,EL
b92edde2,4,360,4.0,4,4,0,0,4,5,-1,6.3,5.5,0.9,19,EL
b956af7d,6,347,3.9,4,2,2,1,10,5,5,5.9,4.7,1.2,19,EL
b96b595c,8,720,8.0,8,8,0,0,9,14,-5,10.3,12.4,-2.2,19,EL
b9814dcc,2,21,0.2,0,0,2,3,0,0,0,0.2,0.3,-0.2,19,EL
b9ec784d,2,11,0.1,0,0,2,2,0,0,0,0.1,0.1,0.1,19,EL
b9fbae28,10,581,6.5,6,4,4,2,19,7,12,15.1,5.8,9.3,19,EL
ba06950a,5,450,5.0,5,5,0,0,7,4,3,9.4,5.2,4.2,19,EL
ba115a40,10,770,8.6,9,5,1,1,21,4,17,19.3,8.7,10.6,19,EL
ba3378a5,8,451,5.0,5,2,3,0,5,8,-3,5.5,8.5,-3.0,19,EL
ba3d3bea,6,422,4.7,4,4,2,1,4,8,-4,4.5,6.5,-2.0,19,EL
ba6e52b0,6,466,5.2,5,5,1,2,12,4,8,9.7,3.2,6.5,19,EL
ba7673a6,2,67,0.7,1,0,1,2,0,0,0,0.4,0.6,-0.2,19,EL
baa82726,4,63,0.7,0,0,4,4,0,1,-1,1.5,0.9,0.5,19,EL
bab077a4,6,305,3.4,3,1,3,0,4,4,0,5.0,3.6,1.4,19,EL
bb17ccd0,6,513,5.7,6,5,0,0,5,6,-1,3.7,7.3,-3.6,19,EL
bb19da7c,5,115,1.3,1,1,4,1,2,1,1,3.9,0.4,3.5,19,EL
bb300266,1,63,0.7,1,0,0,0,1,4,-3,0.8,1.5,-0.7,19,EL
bb6ab7af,3,70,0.8,0,0,3,5,0,0,0,0.2,1.0,-0.8,19,EL
bb6c6331,5,190,2.1,2,0,3,3,2,1,1,3.2,1.4,1.8,19,EL
bbb496b5,3,165,1.8,2,1,1,3,6,1,5,6.0,1.4,4.5,19,EL
bc1ef1f4,2,99,1.1,1,1,1,0,1,3,-2,2.2,3.1,-0.9,19,EL
bc5b5be5,5,338,3.8,4,1,1,0,7,1,6,5.3,3.1,2.1,19,EL
bc647827,1,89,1.0,1,0,0,6,2,0,2,1.2,0.2,1.0,19,EL
bc6f5f06,9,805,8.9,9,8,0,0,25,10,15,18.8,9.3,9.5,19,EL
bc7dc64d,2,113,1.3,1,1,1,1,1,0,1,1.6,0.6,1.0,19,EL
bd142efb,3,270,3.0,3,3,0,2,4,3,1,3.3,3.4,-0.1,19,EL
bdf8165d,6,402,4.5,6,0,0,0,3,5,-2,5.2,4.0,1.2,19,EL
be42a291,10,767,8.5,9,4,1,0,19,10,9,17.5,9.2,8.3,19,EL
be765073,6,540,6.0,6,6,0,0,8,8,0,6.5,6.3,0.2,19,EL
bea81d41,5,450,5.0,5,5,0,1,4,10,-6,2.0,9.2,-7.2,19,EL
beb6c168,1,45,0.5,0,0,1,4,0,2,-2,0.3,1.6,-1.3,19,EL
bee0bab1,3,270,3.0,3,3,0,2,6,5,1,4.5,4.4,0.1,19,EL
beec76cc,9,472,5.2,3,2,6,1,6,2,4,6.1,5.5,0.6,19,EL
bf12926c,2,77,0.9,0,0,2,0,3,2,1,2.3,1.6,0.7,19,EL
bf309d24,4,164,1.8,1,1,3,0,3,2,1,5.4,3.9,1.5,19,EL
bf721ea0,2,22,0.2,0,0,2,0,0,0,0,0.9,0.2,0.7,19,EL
bf97c188,6,540,6.0,6,6,0,1,14,3,11,11.8,6.1,5.7,19,EL
bfae110f,2,173,1.9,2,1,0,0,2,4,-2,2.2,2.8,-0.6,19,EL
bfc5768b,8,401,4.5,4,2,4,0,6,10,-4,4.5,8.6,-4.2,19,EL
bfdb33aa,9,730,8.1,9,5,0,0,14,11,3,11.9,11.9,0.0,19,EL
c01c66d9,5,329,3.7,4,2,1,2,3,6,-3,5.1,3.9,1.2,19,EL
c08fc464,5,405,4.5,5,3,0,0,3,12,-9,5.8,7.8,-2.0,19,EL
c0c7ff58,5,442,4.9,5,4,0,0,7,7,0,7.8,8.3,-0.5,19,EL
c0e27d1a,6,570,6.3,6,6,0,4,15,7,8,12.0,5.9,6.1,19,EL
c1b7847c,6,540,6.0,6,6,0,0,9,8,1,8.4,6.5,1.9,19,EL
c204f844,2,110,1.2,1,0,1,1,2,4,-2,1.6,2.1,-0.5,19,EL
c24544c7,2,180,2.0,2,2,0,0,2,5,-3,2.6,3.4,-0.8,19,EL
c2c29554,9,770,8.6,9,7,0,0,6,11,-5,11.5,9.6,1.9,19,EL
c2dfedeb,2,100,1.1,1,1,1,0,0,1,-1,0.7,1.5,-0.9,19,EL
c316607a,3,222,2.5,3,1,0,3,2,3,-1,4.3,2.9,1.4,19,EL
c35363f2,4,271,3.0,3,2,1,0,2,3,-1,1.9,5.4,-3.4,19,EL
c3b6fa1e,6,516,5.7,6,5,0,0,5,6,-1,3.8,8.0,-4.2,19,EL
c43e5e7e,2,179,2.0,2,1,0,0,3,6,-3,2.3,4.6,-2.3,19,EL
c44a1d58,8,300,3.3,2,1,6,0,8,5,3,6.1,4.4,1.8,19,EL
c4527123,1,16,0.2,0,0,1,1,0,1,-1,0.0,0.4,-0.4,19,EL
c455a2b2,8,616,6.8,7,6,1,0,4,14,-10,5.6,11.3,-5.7,19,EL
c459a650,8,720,8.0,8,8,0,0,15,12,3,11.3,9.9,1.4,19,EL
c50281a0,5,296,3.3,3,2,2,1,10,8,2,5.4,5.0,0.4,19,EL
c52b28d0,1,90,1.0,1,1,0,5,1,5,-4,0.8,2.7,-1.9,19,EL
c5adc293,3,235,2.6,3,1,0,3,4,1,3,5.9,1.7,4.2,19,EL
c603ad6a,7,469,5.2,5,4,2,0,3,11,-8,4.6,7.6,-3.0,19,EL
c64c254c,4,111,1.2,0,0,4,0,3,2,1,2.7,1.6,1.0,19,EL
c6500a29,5,215,2.4,1,1,4,0,6,5,1,4.5,5.2,-0.7,19,EL
c650629d,5,354,3.9,4,3,1,0,4,6,-2,6.9,5.9,1.0,19,EL
c67b8590,3,211,2.3,2,2,1,0,1,4,-3,2.8,4.5,-1.8,19,EL
c693347d,5,244,2.7,3,1,2,0,4,1,3,4.4,3.0,1.5,19,EL
c6ac6579,5,216,2.4,3,1,2,0,0,7,-7,1.9,5.9,-4.0,19,EL
c6dd017b,2,152,1.7,2,0,0,0,1,3,-2,0.5,3.6,-3.1,19,EL
c6e7789b,2,26,0.3,0,0,2,1,1,0,1,1.1,0.7,0.4,19,EL
c71e97ba,8,470,5.2,5,4,3,2,5,13,-8,6.2,11.4,-5.2,19,EL
c75b6a02,4,139,1.5,2,0,2,1,3,2,1,2.7,0.5,2.2,19,EL
c78b352d,2,44,0.5,0,0,2,1,2,0,2,2.0,0.2,1.8,19,EL
c7e9eefb,3,116,1.3,1,1,2,3,6,1,5,2.6,1.8,0.8,19,EL
c80c8364,2,81,0.9,1,0,1,0,1,0,1,0.9,0.4,0.5,19,EL
c8a88acd,4,360,4.0,4,4,0,4,4,9,-5,5.4,6.1,-0.7,19,EL
c8c02ac7,6,464,5.2,5,5,1,4,9,9,0,7.6,7.5,0.1,19,EL
c906ce0f,3,270,3.0,3,3,0,0,4,4,0,3.9,4.1,-0.3,19,EL
c90b2e8f,4,344,3.8,4,3,0,1,1,7,-6,3.4,6.7,-3.3,19,EL
c9bdb329,3,252,2.8,3,2,0,1,4,3,1,5.1,5.8,-0.7,19,EL
ca45605e,4,157,1.7,2,1,2,2,4,3,1,3.4,3.0,0.3,19,EL
ca8033cb,4,148,1.6,1,1,3,1,2,3,-1,1.8,1.7,0.1,19,EL
ca9da30f,4,278,3.1,3,3,1,2,3,6,-3,2.0,4.0,-2.0,19,EL
cbb8620f,5,431,4.8,5,4,0,1,4,13,-9,5.4,7.8,-2.4,19,EL
cbec1196,12,882,9.8,10,5,2,0,15,12,3,11.5,9.4,2.1,19,EL
cc41eec1,2,180,2.0,2,2,0,2,4,2,2,1.8,4.5,-2.6,19,EL
cc700722,6,443,4.9,5,4,1,0,7,6,1,8.4,6.8,1.6,19,EL
cc77354e,5,367,4.1,5,4,0,0,4,11,-7,4.8,7.4,-2.6,19,EL
cc89c822,5,195,2.2,2,0,3,0,2,2,0,2.5,1.7,0.7,19,EL
cce181df,2,180,2.0,2,2,0,0,3,1,2,3.1,0.9,2.2,19,EL
ccf5926f,2,47,0.5,0,0,2,3,0,1,-1,0.2,0.8,-0.5,19,EL
cd0fa27b,5,315,3.5,3,2,2,0,10,6,4,5.2,5.4,-0.1,19,EL
cd1b2304,2,180,2.0,2,2,0,0,2,4,-2,2.3,2.9,-0.6,19,EL
cda08080,6,540,6.0,6,6,0,0,7,7,0,7.5,6.9,0.6,19,EL
cda0b317,6,540,6.0,6,6,0,2,8,6,2,10.4,6.6,3.8,19,EL
ce17b5eb,12,1110,12.3,12,12,0,1,26,13,13,22.0,14.1,7.8,19,EL
ce492295,7,630,7.0,7,7,0,1,14,9,5,10.2,10.2,0.0,19,EL
ce5143da,4,289,3.2,4,2,0,1,8,2,6,7.1,2.0,5.1,19,EL
ce538b0b,8,672,7.5,8,6,0,0,9,11,-2,7.1,11.5,-4.3,19,EL
ce9e8024,2,180,2.0,2,2,0,0,4,4,0,2.5,2.3,0.1,19,EL
cea0df32,4,293,3.3,4,1,0,0,5,5,0,3.8,4.4,-0.6,19,EL
ceb30355,6,127,1.4,1,1,5,5,1,0,1,1.3,0.2,1.1,19,EL
cf007308,7,606,6.7,7,5,0,0,9,9,0,9.0,7.3,1.7,19,EL
cf182add,2,180,2.0,2,2,0,0,3,6,-3,2.3,4.6,-2.3,19,EL
d02e0cab,2,146,1.6,2,1,0,0,2,3,-1,2.2,2.5,-0.3,19,EL
d04d34c4,4,285,3.2,3,1,1,0,4,4,0,5.4,3.8,1.6,19,EL
d06ae2ba,4,159,1.8,1,0,3,1,1,2,-1,1.8,3.4,-1.6,19,EL
d072a976,1,77,0.9,1,0,0,1,0,0,0,0.2,1.5,-1.3,19,EL
d0a01d27,1,90,1.0,1,1,0,1,1,2,-1,0.6,1.9,-1.3,19,EL
d0b6129f,5,391,4.3,4,4,1,0,10,5,5,6.4,3.3,3.0,19,EL
d0d8dd44,3,270,3.0,3,3,0,1,1,1,0,3.4,4.5,-1.1,19,EL
d14229f3,6,276,3.1,3,1,3,1,8,5,3,5.2,5.7,-0.6,19,EL
d1675302,3,256,2.8,3,1,0,0,5,6,-1,4.8,5.7,-1.0,19,EL
d1992a3b,4,265,2.9,2,2,2,2,0,3,-3,1.6,2.0,-0.4,19,EL
d1fea02e,6,540,6.0,6,6,0,0,4,14,-10,3.4,12.1,-8.6,19,EL
d2110326,6,540,6.0,6,6,0,2,9,5,4,10.4,6.6,3.8,19,EL
d2131e09,5,245,2.7,3,0,2,1,3,6,-3,3.3,5.5,-2.2,19,EL
d2416c2e,4,120,1.3,0,0,4,1,3,3,0,2.5,2.2,0.2,19,EL
d248cd8f,4,360,4.0,4,4,0,1,5,6,-1,4.1,4.7,-0.5,19,EL
d2795011,1,19,0.2,0,0,1,1,0,0,0,0.2,0.3,-0.1,19,EL
d28b8f40,2,135,1.5,1,1,1,0,2,4,-2,2.3,3.2,-0.8,19,EL
d2a802b8,6,481,5.3,6,2,0,0,3,11,-8,1.3,11.0,-9.6,19,EL
d3013717,6,540,6.0,6,6,0,0,4,7,-3,4.6,10.6,-6.0,19,EL
d3272fba,1,11,0.1,0,0,1,1,0,2,-2,0.1,0.6,-0.5,19,EL
d3bd981b,4,340,3.8,4,3,0,1,0,5,-5,2.3,5.4,-3.1,19,EL
d3ce9f1f,1,26,0.3,1,0,0,0,0,0,0,0.0,0.2,-0.1,19,EL
d3ec34cf,2,8,0.1,0,0,2,2,0,0,0,0.0,0.1,-0.1,19,EL
d4222f7b,6,534,5.9,6,5,0,0,2,13,-11,4.2,8.2,-4.0,19,EL
d4232ba9,3,257,2.9,3,2,0,0,3,5,-2,2.7,4.0,-1.3,19,EL
d4535821,4,293,3.3,3,2,1,1,4,4,0,3.5,5.4,-1.9,19,EL
d49f80d7,4,360,4.0,4,4,0,0,2,8,-6,2.7,4.5,-1.8,19,EL
d4cb83cc,12,858,9.5,10,8,2,0,20,11,9,17.0,10.1,6.9,19,EL
d4e93bab,7,429,4.8,4,3,3,1,7,5,2,7.3,5.8,1.4,19,EL
d4f46475,4,345,3.8,4,3,0,2,5,7,-2,5.4,4.4,1.0,19,EL
d5575935,5,289,3.2,3,1,2,0,4,7,-3,2.1,5.3,-3.2,19,EL
d57d680c,2,180,2.0,2,2,0,0,2,5,-3,1.7,4.6,-2.9,19,EL
d5dd5f1f,12,933,10.4,10,7,2,0,22,9,13,17.9,12.4,5.4,19,EL
d61b3354,3,236,2.6,3,2,0,3,6,5,1,3.0,5.2,-2.1,19,EL
d637fc22,2,180,2.0,2,2,0,0,2,1,1,2.1,2.1,0.1,19,EL
d63e2912,4,315,3.5,4,3,0,1,3,8,-5,4.2,4.6,-0.4,19,EL
d6a889ea,2,103,1.1,1,1,1,4,3,2,1,2.2,2.4,-0.2,19,EL
d6d8582b,2,13,0.1,0,0,2,4,0,0,0,0.0,0.3,-0.3,19,EL
d6f5490e,4,27,0.3,0,0,4,3,0,1,-1,0.3,1.1,-0.8,19,EL
d717630e,2,99,1.1,1,1,1,1,1,0,1,2.0,0.1,1.9,19,EL
d72f8d9e,6,540,6.0,6,6,0,0,6,8,-2,6.8,7.5,-0.8,19,EL
d7398ac3,3,270,3.0,3,3,0,3,0,6,-6,0.8,5.0,-4.1,19,EL
d7553721,7,563,6.3,6,5,1,0,10,8,2,9.5,8.0,1.5,19,EL
d75cf9bf,2,25,0.3,0,0,2,2,0,0,0,0.0,0.8,-0.8,19,EL
d75f3980,6,469,5.2,5,4,1,1,13,7,6,10.2,6.3,3.9,19,EL
d79a8c87,5,419,4.7,5,4,0,0,11,2,9,9.7,2.5,7.2,19,EL
d820a7c8,2,123,1.4,1,0,1,2,0,2,-2,1.4,1.2,0.2,19,EL
d83bbc54,7,545,6.1,6,5,1,1,11,7,4,10.0,6.3,3.7,19,EL
d83f09ff,5,354,3.9,4,3,1,1,10,5,5,5.6,4.8,0.8,19,EL
d8988c46,1,17,0.2,0,0,1,1,0,0,0,0.1,0.2,0.0,19,EL
d8c679be,6,427,4.7,5,3,1,0,9,9,0,7.5,10.4,-2.9,19,EL
d8feae4a,8,720,8.0,8,8,0,0,8,11,-3,8.9,16.4,-7.6,19,EL
d94653be,8,137,1.5,0,0,8,1,5,3,2,2.2,2.1,0.0,19,EL
d97b252e,5,450,5.0,5,5,0,2,7,6,1,7.2,6.2,1.0,19,EL
d97cccc9,3,235,2.6,3,1,0,1,0,0,0,1.4,2.5,-1.1,19,EL
d995ed27,2,144,1.6,2,1,0,0,1,3,-2,2.3,1.6,0.7,19,EL
da09d0c3,5,450,5.0,5,5,0,0,4,10,-6,2.0,9.2,-7.2,19,EL
da121b3a,4,315,3.5,4,3,0,0,5,7,-2,4.8,6.9,-2.1,19,EL
da270297,1,90,1.0,1,1,0,0,0,2,-2,0.3,1.3,-0.9,19,EL
da3bf1b3,8,594,6.6,6,6,2,0,6,11,-5,6.2,10.2,-4.0,19,EL
da617483,5,295,3.3,2,1,3,1,1,4,-3,2.3,3.4,-1.1,19,EL
da6cb94b,4,360,4.0,4,4,0,0,2,6,-4,2.2,6.5,-4.3,19,EL
da974c7b,5,450,5.0,5,5,0,0,8,4,4,10.1,7.1,3.0,19,EL
dab75831,4,165,1.8,2,1,2,2,3,4,-1,1.8,3.3,-1.5,19,EL
dade14fe,4,136,1.5,2,0,2,0,2,6,-4,1.1,2.3,-1.2,19,EL
dae8623e,7,603,6.7,7,4,0,1,11,12,-1,9.2,9.2,-0.1,19,EL
db1aced4,6,540,6.0,6,6,0,0,3,13,-10,4.6,10.7,-6.1,19,EL
db265666,6,316,3.5,3,1,3,0,2,9,-7,2.5,4.9,-2.4,19,EL
db3cb6ee,8,705,7.8,8,7,0,1,10,6,4,9.7,7.5,2.2,19,EL
dba67bc4,8,516,5.7,6,4,2,0,12,6,6,12.1,6.2,5.9,19,EL
dbd3a428,1,90,1.0,1,1,0,0,1,4,-3,0.7,2.3,-1.6,19,EL
dc29b608,6,540,6.0,6,6,0,0,9,8,1,8.4,6.5,1.9,19,EL
dc366c36,7,630,7.0,7,7,0,3,13,12,1,10.2,11.7,-1.5,19,EL
dc3fa3b5,3,129,1.4,1,0,2,0,6,2,4,3.7,2.0,1.7,19,EL
dc415e39,6,521,5.8,6,4,0,0,7,9,-2,6.3,11.8,-5.5,19,EL
dc4511f3,5,450,5.0,5,5,0,1,5,7,-2,4.5,7.0,-2.5,19,EL
dc52c72f,10,900,10.0,10,10,0,0,13,17,-4,11.2,19.3,-8.1,19,EL
dc62b55d,6,540,6.0,6,6,0,0,9,8,1,8.4,6.5,1.9,19,EL
dc90cfbe,4,272,3.0,3,2,1,0,5,3,2,3.3,3.3,0.0,19,EL
dca7b0fb,1,3,0.0,0,0,1,1,0,0,0,0.0,0.0,0.0,19,EL
dd0daf32,11,675,7.5,6,5,5,2,14,6,8,14.0,5.8,8.3,19,EL
dd2044f4,4,329,3.7,4,3,0,2,4,8,-4,4.2,8.6,-4.5,19,EL
dda3969e,2,180,2.0,2,2,0,0,1,2,-1,1.1,3.2,-2.1,19,EL
de4517dd,6,453,5.0,5,5,1,0,5,3,2,6.3,3.8,2.5,19,EL
dee86451,7,612,6.8,7,5,0,0,11,8,3,11.8,7.4,4.4,19,EL
def6943f,3,203,2.3,3,1,0,2,2,5,-3,1.6,3.2,-1.5,19,EL
defb905a,7,630,7.0,7,7,0,0,8,6,2,8.7,6.1,2.6,19,EL
df525574,6,540,6.0,6,6,0,0,3,5,-2,4.0,5.2,-1.3,19,EL
df746364,1,31,0.3,0,0,1,1,0,1,-1,0.2,1.5,-1.2,19,EL
df791bca,3,47,0.5,0,0,3,0,0,2,-2,0.2,2.0,-1.8,19,EL
df8b52a5,1,2,0.0,0,0,1,0,0,1,-1,0.0,0.5,-0.4,19,EL
dff153a4,5,450,5.0,5,5,0,0,6,3,3,6.2,7.2,-1.0,19,EL
e0238966,1,90,1.0,1,1,0,2,1,3,-2,1.3,1.9,-0.6,19,EL
e03c2d97,6,540,6.0,6,6,0,0,6,8,-2,6.8,7.5,-0.8,19,EL
e040aecf,3,189,2.1,3,1,0,0,1,3,-2,1.5,1.9,-0.3,19,EL
e054ee4e,5,180,2.0,2,0,3,1,1,3,-2,3.9,2.4,1.5,19,EL
e09436fb,1,29,0.3,0,0,1,2,0,1,-1,0.0,0.6,-0.5,19,EL
e0a1c004,6,460,5.1,6,1,0,0,5,6,-1,5.1,5.4,-0.3,19,EL
e0bc6fdc,11,1020,11.3,11,11,0,0,26,10,16,22.0,9.2,12.8,19,EL
e0fd942a,5,401,4.5,4,2,1,0,4,10,-6,5.4,6.7,-1.3,19,EL
e12b0b5b,8,608,6.8,8,1,0,0,10,8,2,9.4,7.5,1.9,19,EL
e12d7851,6,540,6.0,6,6,0,0,7,7,0,7.5,6.9,0.6,19,EL
e1550a44,6,531,5.9,6,5,0,0,3,16,-13,1.7,13.8,-12.1,19,EL
e16dd48e,2,180,2.0,2,2,0,0,2,4,-2,2.3,2.9,-0.6,19,EL
e18098de,8,417,4.6,4,4,4,0,8,1,7,6.6,2.9,3.7,19,EL
e1bbb68d,5,287,3.2,2,2,3,1,5,5,0,3.3,6.9,-3.6,19,EL
e1deea75,6,451,5.0,5,4,1,1,15,6,9,9.5,7.0,2.5,19,EL
e204ec12,2,180,2.0,2,2,0,0,1,2,-1,1.1,3.2,-2.1,19,EL
e248e62f,2,79,0.9,1,0,1,3,0,1,-1,0.2,0.5,-0.3,19,EL
e26c4233,4,293,3.3,3,3,1,7,10,2,8,8.7,3.2,5.5,19,EL
e26f559f,2,108,1.2,1,1,1,0,0,0,0,0.4,1.6,-1.3,19,EL
e280527c,5,273,3.0,3,2,2,0,5,6,-1,4.0,3.8,0.2,19,EL
e2b384d2,3,79,0.9,0,0,3,1,1,0,1,2.6,0.3,2.3,19,EL
e2bf2abc,4,246,2.7,3,1,1,2,1,2,-1,1.8,2.9,-1.1,19,EL
e2dde94c,6,427,4.7,5,3,1,0,6,6,0,6.2,4.7,1.5,19,EL
e2e9c250,10,399,4.4,3,3,7,1,6,8,-2,7.9,7.4,0.5,19,EL
e2f9bb5f,2,99,1.1,1,0,1,0,1,1,0,0.9,0.9,0.0,19,EL
e304acd5,5,236,2.6,2,2,3,1,1,4,-3,1.6,4.8,-3.2,19,EL
e34e086c,7,232,2.6,2,1,5,1,8,2,6,6.6,1.4,5.3,19,EL
e358587b,6,540,6.0,6,6,0,0,12,9,3,9.4,7.2,2.2,19,EL
e373f1ec,2,153,1.7,2,1,0,0,0,5,-5,0.8,3.5,-2.7,19,EL
e3a5814e,10,804,8.9,9,8,1,1,18,8,10,15.5,11.3,4.2,19,EL
e3e32fbb,6,529,5.9,6,5,0,0,6,12,-6,5.1,9.5,-4.4,19,EL
e45ee4bc,4,273,3.0,3,2,1,1,2,4,-2,2.4,3.7,-1.4,19,EL
e4a26a91,4,209,2.3,2,1,2,2,2,3,-1,2.7,3.4,-0.7,19,EL
e4c35d02,1,90,1.0,1,1,0,3,0,3,-3,0.6,2.2,-1.6,19,EL
e556a911,6,526,5.8,6,4,0,0,5,7,-2,3.7,8.0,-4.3,19,EL
e5cd9da6,7,439,4.9,5,4,2,0,5,8,-3,6.0,6.2,-0.1,19,EL
e61b8aee,9,758,8.4,9,7,0,1,17,11,6,14.4,11.9,2.5,19,EL
e61bdd69,2,130,1.4,2,0,0,0,2,2,0,0.9,1.8,-1.0,19,EL
e61d33f1,3,212,2.4,3,1,0,2,1,7,-6,1.2,5.5,-4.3,19,EL
e652624a,1,18,0.2,0,0,1,0,0,0,0,0.1,0.2,-0.1,19,EL
e65dd8dc,4,360,4.0,4,4,0,2,3,12,-9,1.0,8.7,-7.7,19,EL
e66e4ddc,6,511,5.7,6,5,0,0,2,12,-10,4.1,8.0,-3.9,19,EL
e6bc67d7,8,505,5.6,6,2,2,0,12,8,4,11.1,7.4,3.7,19,EL
e6dda1c7,6,458,5.1,6,5,0,0,3,4,-1,3.1,4.6,-1.5,19,EL
e707e3a7,5,450,5.0,5,5,0,1,6,6,0,7.2,5.3,1.9,19,EL
e717705a,6,467,5.2,5,3,1,0,12,11,1,7.3,8.3,-1.0,19,EL
e726e11e,4,224,2.5,2,1,2,1,2,4,-2,2.8,3.6999999999999997,-0.8,19,EL
e73659d3,7,529,5.9,7,2,0,0,5,7,-2,6.0,7.8,-1.8,19,EL
e7af9060,4,212,2.4,3,1,1,2,3,4,-1,4.6,6.3,-1.8,19,EL
e7ec3c71,4,348,3.9,4,3,0,0,5,9,-4,4.5,7.0,-2.5,19,EL
e7ef333b,5,450,5.0,5,5,0,1,4,9,-5,6.6,7.6,-1.0,19,EL
e81f0356,5,450,5.0,5,5,0,4,14,7,7,11.2,7.9,3.3,19,EL
e82d2807,1,7,0.1,0,0,1,2,0,0,0,0.0,0.0,0.0,19,EL
e85ec097,3,172,1.9,2,1,1,0,0,0,0,1.7,1.1,0.6,19,EL
e8c930bb,2,135,1.5,2,0,0,2,1,1,0,3.1,1.9,1.3,19,EL
e8ed3abc,2,109,1.2,1,1,1,0,1,0,1,1.4,0.4,1.1,19,EL
e90dc1d5,2,172,1.9,2,1,0,0,1,2,-1,1.1,3.2,-2.1,19,EL
e9356a25,1,76,0.8,1,0,0,0,1,4,-3,0.5,2.6,-2.2,19,EL
e94d79e3,4,344,3.8,4,3,0,1,6,6,0,6.4,3.7,2.7,19,EL
e9517008,6,540,6.0,6,6,0,0,5,7,-2,3.9,8.2,-4.3,19,EL
e97fd090,11,716,8.0,8,4,3,1,21,5,16,15.9,5.7,10.1,19,EL
ea0ff634,4,223,2.5,2,1,2,1,4,8,-4,3.4,4.6,-1.2,19,EL
ea6a7ab4,5,261,2.9,4,0,1,1,4,2,2,3.9,2.8,1.1,19,EL
eac044ad,10,850,9.4,10,4,0,0,24,11,13,19.8,9.4,10.4,19,EL
eac8cdb6,2,180,2.0,2,2,0,0,2,3,-1,1.3,2.8,-1.5,19,EL
ead51916,7,582,6.5,7,5,0,1,6,10,-4,5.4,8.6,-3.2,19,EL
ead960f2,6,537,6.0,6,5,0,0,6,7,-1,7.1,6.9,0.2,19,EL
eb2b33aa,1,90,1.0,1,1,0,9,0,1,-1,2.4,1.3,1.1,19,EL
eb2fe5b6,5,242,2.7,3,1,2,0,9,1,8,4.4,4.8,-0.4,19,EL
eb3f56e5,2,180,2.0,2,2,0,2,2,2,0,2.1,1.7,0.5,19,EL
eb8b2a35,7,445,4.9,6,3,1,0,3,10,-7,2.6,8.0,-5.4,19,EL
ebc06041,6,505,5.6,6,5,0,0,8,11,-3,9.6,6.9,2.7,19,EL
ebc49727,5,293,3.3,3,1,2,0,7,6,1,5.4,4.8,0.6,19,EL
ebca82e8,5,450,5.0,5,5,0,1,7,9,-2,6.2,11.9,-5.8,19,EL
ebdc9c7e,5,392,4.4,5,4,0,1,5,6,-1,4.3,4.7,-0.4,19,EL
ec30b9c8,4,187,2.1,2,1,2,0,2,0,2,4.1,3.0,1.0,19,EL
ec3efd7f,4,346,3.8,4,2,0,0,2,6,-4,2.4,5.0,-2.6,19,EL
ecb68eea,9,748,8.3,8,7,1,0,11,12,-1,11.4,10.5,0.9,19,EL
ed54971a,3,270,3.0,3,3,0,3,2,6,-4,3.3,4.6,-1.3,19,EL
ed560575,5,450,5.0,5,5,0,0,4,6,-2,4.8,4.9,-0.1,19,EL
ed5886d2,4,315,3.5,4,3,0,2,6,7,-1,3.4,6.8,-3.4,19,EL
ed90babd,4,117,1.3,1,0,3,0,3,1,2,3.4,3.1,0.3,19,EL
eda890e3,4,130,1.4,1,0,3,0,1,0,1,1.0,0.9,0.1,19,EL
edd20aef,5,450,5.0,5,5,0,0,3,4,-1,4.3,7.5,-3.2,19,EL
edd38473,6,516,5.7,6,5,0,0,8,4,4,7.8,4.4,3.4,19,EL
eddcbbc4,3,183,2.0,2,2,1,0,2,7,-5,1.5,4.7,-3.2,19,EL
ee251371,3,181,2.0,2,0,1,1,2,4,-2,1.8,2.9,-1.2,19,EL
ee3519f5,1,10,0.1,1,0,0,0,1,1,0,0.8,0.4,0.4,19,EL
ee926a02,6,540,6.0,6,6,0,0,11,4,7,10.6,5.2,5.4,19,EL
ee950928,10,843,9.4,10,2,0,0,16,7,9,14.1,7.1,7.0,19,EL
eeb032db,1,6,0.1,0,0,1,0,0,0,0,0.5,0.2,0.3,19,EL
eec32585,1,65,0.7,1,0,0,0,0,2,-2,0.3,1.0,-0.7,19,EL
ef13f203,6,540,6.0,6,6,0,0,5,7,-2,3.9,8.2,-4.3,19,EL
ef2e5e1a,5,418,4.6,5,4,0,0,6,12,-6,6.7,6.0,0.7,19,EL
ef322658,5,340,3.8,4,2,1,1,5,5,0,6.8,4.7,2.1,19,EL
ef5b337e,5,244,2.7,3,1,2,0,3,2,1,4.4,2.9,1.5,19,EL
ef619b0b,7,477,5.3,6,3,1,1,9,1,8,10.0,3.1,6.9,19,EL
ef88f778,5,436,4.8,5,3,0,0,6,6,0,4.9,4.7,0.2,19,EL
ef8cafeb,3,270,3.0,3,3,0,1,5,7,-2,4.1,5.2,-1.1,19,EL
ef8f266e,1,23,0.3,0,0,1,0,1,0,1,1.0,0.5,0.5,19,EL
ef9c1c95,8,707,7.9,8,7,0,1,12,12,0,10.8,9.5,1.3,19,EL
efc33b33,2,180,2.0,2,2,0,4,2,2,0,2.1,1.7,0.5,19,EL
f08a8947,6,540,6.0,6,6,0,0,7,7,0,7.5,6.9,0.6,19,EL
f0e3b343,4,289,3.2,3,2,1,1,1,7,-6,2.4,6.0,-3.5,19,EL
f15b778f,5,449,5.0,5,4,0,0,3,4,-1,3.6,4.6,-0.9,19,EL
f1eee8b3,2,42,0.5,0,0,2,0,0,0,0,0.1,0.2,-0.1,19,EL
f2428fd4,4,351,3.9,4,3,0,1,6,5,1,4.2,4.7,-0.5,19,EL
f26e3c59,5,358,4.0,4,3,1,1,8,6,2,5.8,3.6,2.2,19,EL
f27680d9,2,70,0.8,1,0,1,1,0,2,-2,0.2,1.1,-0.9,19,EL
f294b8cc,2,25,0.3,0,0,2,4,0,3,-3,0.2,1.4,-1.2,19,EL
f2d063ec,2,180,2.0,2,2,0,0,2,4,-2,2.3,2.9,-0.6,19,EL
f2eaebe9,5,137,1.5,0,0,5,0,4,0,4,2.2,1.4,0.8,19,EL
f301f363,6,539,6.0,6,5,0,0,6,8,-2,6.8,7.5,-0.8,19,EL
f315ca93,5,432,4.8,5,4,0,1,7,5,2,7.1,4.3,2.8,19,EL
f346787e,6,530,5.9,6,5,0,0,8,11,-3,8.3,7.7,0.6,19,EL
f373db50,6,540,6.0,6,6,0,0,10,10,0,7.3,10.1,-2.8,19,EL
f3a97d02,6,540,6.0,6,6,0,0,8,8,0,6.5,6.3,0.2,19,EL
f4021366,6,540,6.0,6,6,0,0,3,16,-13,1.7,14.1,-12.3,19,EL
f4290206,4,334,3.7,4,3,0,6,10,0,10,9.3,2.0,7.2,19,EL
f45eb18d,9,491,5.5,5,1,4,0,7,5,2,9.3,7.2,2.0,19,EL
f47009ce,2,103,1.1,1,0,1,2,0,1,-1,0.2,2.8,-2.6,19,EL
f4b852b5,6,540,6.0,6,6,0,0,4,13,-9,2.4,12.2,-9.8,19,EL
f50a668a,2,100,1.1,2,1,0,0,1,2,-1,0.8,3.5,-2.7,19,EL
f553b2b3,4,51,0.6,0,0,4,1,2,4,-2,1.3,1.5,-0.2,19,EL
f5eedf74,4,355,3.9,4,3,0,0,3,5,-2,3.4,4.3,-0.9,19,EL
f5efb153,10,837,9.3,10,7,0,0,17,11,6,13.7,12.7,1.0,19,EL
f631c17f,2,162,1.8,2,1,0,0,0,3,-3,1.2,2.3,-1.1,19,EL
f6c579bd,4,79,0.9,0,0,4,2,1,2,-1,0.3,2.9,-2.5,19,EL
f7036e1c,3,245,2.7,3,2,0,0,3,0,3,3.8,2.8,1.0,19,EL
f70e46e6,1,90,1.0,1,1,0,1,5,1,4,2.7,0.8,1.9,19,EL
f7223718,1,47,0.5,1,0,0,1,0,1,-1,0.3,1.3,-1.0,19,EL
f7288611,6,500,5.6,5,5,1,0,3,12,-9,5.8,8.1,-2.3,19,EL
f73abe54,4,194,2.2,1,1,3,0,7,2,5,5.6,1.3,4.2,19,EL
f7e87032,9,802,8.9,9,7,0,0,11,15,-4,10.2,16.7,-6.5,19,EL
f80f8e10,2,99,1.1,2,0,0,0,0,1,-1,0.1,1.0,-0.9,19,EL
f820504e,3,188,2.1,2,2,1,3,5,4,1,2.8,3.6,-0.7,19,EL
f8280175,4,148,1.6,2,0,2,0,0,1,-1,0.9,2.3,-1.4,19,EL
f833a830,10,398,4.4,4,0,6,0,12,5,7,11.4,4.0,7.4,19,EL
f83c8d6c,5,364,4.0,4,2,1,0,2,4,-2,4.0,5.4,-1.4,19,EL
f93c876b,4,273,3.0,3,3,1,1,3,7,-4,2.4,5.1,-2.7,19,EL
f94eb380,5,416,4.6,5,2,0,0,3,3,0,4.0,7.1,-3.1,19,EL
f95cb908,6,540,6.0,6,6,0,0,8,13,-5,9.7,8.0,1.8,19,EL
f99b71de,2,180,2.0,2,2,0,1,0,0,0,1.6,1.0,0.6,19,EL
f9acca3a,8,693,7.7,8,6,0,0,16,10,6,10.9,9.3,1.7,19,EL
f9bd541e,6,482,5.4,6,3,0,0,3,6,-3,3.4,9.1,-5.7,19,EL
fa14dd4f,7,480,5.3,6,2,1,0,3,6,-3,4.5,6.4,-1.9,19,EL
fa73ccc7,4,309,3.4,4,2,0,0,2,3,-1,4.2,4.7,-0.5,19,EL
fa937f7a,8,714,7.9,8,6,0,1,18,12,6,15.6,10.4,5.2,19,EL
faa1b07d,4,360,4.0,4,4,0,1,7,8,-1,6.0,4.7,1.3,19,EL
fad3e13e,5,256,2.8,3,0,2,1,4,4,0,3.0,4.6,-1.6,19,EL
fae880d5,5,450,5.0,5,5,0,1,7,9,-2,6.2,11.9,-5.8,19,EL
fb054320,6,536,6.0,6,5,0,0,5,7,-2,5.7,6.0,-0.3,19,EL
fb2c533b,3,239,2.7,3,2,0,1,3,4,-1,4.6,2.2,2.4,19,EL
fb517645,1,69,0.8,1,0,0,1,1,1,0,0.7,0.8,-0.1,19,EL
fb5d47b3,8,709,7.9,8,7,0,3,10,6,4,12.8,11.0,1.8,19,EL
fbbb9269,4,360,4.0,4,4,0,1,4,2,2,4.8,4.5,0.3,19,EL
fbd6378b,6,540,6.0,6,6,0,0,8,8,0,8.7,7.9,0.8,19,EL
fc1cf07a,11,942,10.5,10,10,1,0,11,11,0,12.2,10.0,2.2,19,EL
fcda82c7,5,450,5.0,5,5,0,2,6,5,1,5.1,7.9,-2.8,19,EL
fce2302c,6,540,6.0,6,6,0,0,6,8,-2,5.8,9.2,-3.4,19,EL
fd14b16c,4,332,3.7,4,2,0,1,0,5,-5,0.9,8.3,-7.4,19,EL
fdf3cb77,9,802,8.9,9,8,0,0,10,7,3,10.5,8.5,1.9,19,EL
feb5d3ab,2,180,2.0,2,2,0,1,0,0,0,1.6,1.0,0.6,19,EL
fec5accc,1,28,0.3,0,0,1,0,1,0,1,0.8,0.9,-0.1,19,EL
fed17f5a,7,507,5.6,6,3,1,0,8,6,2,10.6,5.2,5.4,19,EL
fed7cb61,6,422,4.7,5,3,1,1,8,6,2,5.8,6.1,-0.3,19,EL
ff579c7e,4,184,2.0,1,1,3,1,1,4,-3,1.8,3.0,-1.1,19,EL
ff764de3,4,299,3.3,4,2,0,2,0,8,-8,1.1,5.7,-4.6,19,EL
ff98492b,6,436,4.8,5,2,1,0,2,5,-3,3.3,4.0,-0.6,19,EL
ffec9769,7,452,5.0,5,3,2,1,7,3,4,7.5,4.6,2.9,19,EL
ffed43e3,2,106,1.2,1,1,1,3,1,3,-2,0.3,4.2,-3.9,19,EL
000b3da6,3,74,0.8,1,0,2,6,0,2,-2,1.0,1.5,-0.4,19,SPA
003a5c72,33,1733,19.3,16,15,17,2,16,23,-7,21.2,24.6,-3.4,19,SPA
00b28772,36,3209,35.7,36,34,0,0,47,33,14,44.2,41.4,2.7,19,SPA
011d8c56,11,990,11.0,11,11,0,22,9,11,-2,13.7,10.2,3.6,19,SPA
014b57f5,1,14,0.2,0,0,1,3,0,0,0,1.2,0.0,1.2,19,SPA
01eb744d,36,1919,21.3,20,5,16,1,32,22,10,27.8,25.9,1.9,19,SPA
02319ad7,34,2432,27.0,27,16,7,2,38,24,14,32.3,31.0,1.3,19,SPA
02c15616,7,540,6.0,6,5,1,10,6,5,1,7.8,7.3,0.5,19,SPA
02ef8778,33,2813,31.3,32,24,1,0,39,55,-16,40.5,47.8,-7.3,19,SPA
036bba5f,34,2976,33.1,34,31,0,1,29,43,-14,34.7,49.6,-14.9,19,SPA
04965583,11,528,5.9,5,2,6,12,12,6,6,12.0,8.2,3.8,19,SPA
04a65a8f,3,53,0.6,0,0,3,1,1,2,-1,0.4,1.0,-0.6,19,SPA
04ac8285,3,270,3.0,3,3,0,27,4,4,0,4.0,4.6,-0.7,19,SPA
04e17fd5,31,2106,23.4,22,13,9,2,24,28,-4,23.6,25.0,-1.4,19,SPA
05a4465d,34,2330,25.9,25,21,9,3,26,36,-10,26.8,34.1,-7.3,19,SPA
06efa9dc,2,180,2.0,2,2,0,11,3,4,-1,1.8,2.6,-0.7,19,SPA
070a3904,34,2709,30.1,32,21,2,1,39,39,0,40.1,42.5,-2.5,19,SPA
07750704,3,45,0.5,0,0,3,1,0,1,-1,0.3,0.7,-0.3,19,SPA
08511d65,28,2474,27.5,28,26,0,0,46,33,13,48.1,34.4,13.7,19,SPA
0959c2a2,16,656,7.3,6,2,10,9,13,6,7,13.0,5.3,7.7,19,SPA
09a9e921,33,1270,14.1,12,2,21,2,17,17,0,21.7,20.3,1.4,19,SPA
0a0cc13c,16,638,7.1,6,2,10,8,7,10,-3,8.8,9.2,-0.4,19,SPA
0a447501,15,811,9.0,8,4,7,4,14,12,2,10.6,12.2,-1.6,19,SPA
0ac94a23,27,1706,19.0,19,9,8,1,21,19,2,33.8,22.3,11.4,19,SPA
0ae4e09a,31,1887,21.0,23,9,8,6,32,41,-9,30.0,46.2,-16.2,19,SPA
0b90bb97,30,1852,20.6,23,9,7,2,30,21,9,34.5,21.9,12.5,19,SPA
0c2ac3cb,5,223,2.5,3,0,2,3,4,4,0,3.9,2.6,1.3,19,SPA
0c3f7197,10,369,4.1,4,0,6,8,4,8,-4,2.4,7.3,-4.9,19,SPA
0ef89a37,34,2018,22.4,22,8,12,1,47,19,28,45.8,25.7,20.1,19,SPA
0f0aa5b4,28,2433,27.0,27,25,1,3,26,27,-1,29.1,26.8,2.3,19,SPA
0f134faf,6,235,2.6,3,0,3,9,2,1,1,2.5,4.0,-1.6,19,SPA
1001ae82,20,1256,14.0,14,4,6,7,12,18,-6,18.8,21.3,-2.5,19,SPA
112521d1,12,763,8.5,8,8,4,6,13,9,4,11.2,9.9,1.4,19,SPA
1163de29,15,556,6.2,6,2,9,3,8,18,-10,8.3,11.6,-3.3,19,SPA
1232e1dc,7,446,5.0,4,3,3,13,4,6,-2,5.0,5.9,-0.9,19,SPA
129af0db,15,1083,12.0,13,5,2,1,16,13,3,14.4,13.0,1.4,19,SPA
129dd8e7,12,1080,12.0,12,12,0,20,11,19,-8,17.0,16.3,0.8,19,SPA
12c50af5,2,19,0.2,0,0,2,7,1,0,1,1.0,0.3,0.7,19,SPA
13b0c150,5,230,2.6,4,1,1,4,4,5,-1,4.5,3.5,1.0,19,SPA
13e0eb29,10,305,3.4,2,0,8,7,6,4,2,4.9,4.8,0.1,19,SPA
148d4105,10,453,5.0,4,2,6,9,6,8,-2,4.2,6.4,-2.2,19,SPA
1512328c,26,1533,17.0,20,3,6,4,11,23,-12,16.3,26.2,-9.9,19,SPA
1519a888,1,67,0.7,0,0,1,6,1,2,-1,0.7,1.1,-0.4,19,SPA
1633fc8a,33,2767,30.7,31,29,2,1,31,44,-13,36.9,41.5,-4.6,19,SPA
167c1bb0,13,524,5.8,6,4,7,12,8,8,0,5.7,7.7,-1.9,19,SPA
16e9d0ea,36,3136,34.8,36,32,0,0,36,60,-24,44.8,53.4,-8.7,19,SPA
174651c8,2,163,1.8,2,1,0,0,1,4,-3,0.9,3.9,-3.0,19,SPA
174f09a6,7,316,3.5,4,3,3,16,3,1,2,3.9,4.3,-0.4,19,SPA
17a1299d,1,90,1.0,1,1,0,3,0,1,-1,0.9,1.0,-0.1,19,SPA
17d9e354,17,1530,17.0,17,17,0,21,18,35,-17,23.1,29.9,-6.7,19,SPA
1840e36d,27,2430,27.0,27,27,0,5,43,36,7,46.2,38.0,8.2,19,SPA
18dc8533,6,344,3.8,4,1,2,20,1,5,-4,3.1,4.9,-1.8,19,SPA
19709006,31,2504,27.8,29,16,2,1,29,25,4,30.5,25.1,5.5,19,SPA
19b776e9,24,1158,12.799999999999999,12,4,12,5,13,16,-3,14.200000000000001,17.7,-3.4,19,SPA
1a1609ab,3,37,0.4,0,0,3,12,2,1,1,1.0,0.7,0.3,19,SPA
1a317a1b,15,1231,13.600000000000001,14,10,1,7,10,19,-9,11.5,16.799999999999997,-5.300000000000001,19,SPA
1b17ed86,28,2013,22.4,24,13,4,7,26,30,-4,27.4,33.7,-6.3,19,SPA
1bda5842,34,2821,31.3,33,20,1,0,31,47,-16,35.6,39.1,-3.5,19,SPA
1d1691ad,14,1178,13.1,14,12,0,6,24,15,9,25.7,17.5,8.2,19,SPA
1d5f96d9,12,295,3.3,2,0,10,5,3,5,-2,4.9,4.2,0.7,19,SPA
1daec722,31,2354,26.2,26,19,5,3,33,30,3,38.3,29.1,9.2,19,SPA
1e1bea09,3,60,0.7,0,0,3,8,0,0,0,0.8,1.7,-0.9,19,SPA
1f079188,31,2674,29.7,30,29,1,1,40,41,-1,47.5,36.7,10.8,19,SPA
1f54ed90,26,2110,23.4,25,21,1,5,27,34,-7,31.9,33.2,-1.3,19,SPA
1fb1c435,33,2528,28.1,29,20,4,1,41,23,18,47.7,30.4,17.3,19,SPA
1fe0492d,33,2772,30.8,33,28,0,1,26,41,-15,30.5,41.9,-11.4,19,SPA
1fe67e86,11,523,5.8,6,4,5,18,5,7,-2,5.7,8.7,-3.0,19,SPA
200e89e1,9,399,4.4,5,0,4,3,8,5,3,6.4,3.9,2.6,19,SPA
20b9f052,33,2970,33.0,33,33,0,5,40,47,-7,39.1,43.5,-4.4,19,SPA
220c11f1,32,2729,30.3,30,26,2,0,29,40,-11,36.1,37.1,-1.0,19,SPA
228b0d9d,11,951,10.6,11,8,0,9,14,10,4,15.0,13.6,1.4,19,SPA
2306bfde,24,1368,15.2,16,3,8,7,17,19,-2,18.4,19.6,-1.2,19,SPA
23fffc06,4,65,0.7,0,0,4,4,1,0,1,1.0,0.8,0.2,19,SPA
240d3a0b,29,2476,27.5,29,23,0,2,29,27,2,29.4,29.3,0.1,19,SPA
244f57b9,36,2971,33.0,34,18,2,0,35,37,-2,37.3,45.4,-8.1,19,SPA
248c409d,3,270,3.0,3,3,0,11,0,6,-6,3.7,5.0,-1.3,19,SPA
24f59bb2,24,1937,21.5,22,20,2,1,22,30,-8,27.1,28.1,-1.0,19,SPA
253a06b9,34,1997,22.2,20,9,14,0,26,36,-10,29.5,35.5,-6.0,19,SPA
25c72b36,12,517,5.7,7,1,5,6,5,3,2,5.0,6.8,-1.8,19,SPA
2683eda7,15,359,4.0,2,1,13,11,5,9,-4,8.0,6.6,1.4,19,SPA
26f2473f,7,559,6.2,6,6,1,27,4,10,-6,4.6,10.2,-5.5,19,SPA
274ab13c,2,176,2.0,2,1,0,0,3,4,-1,3.3,3.5,-0.2,19,SPA
27a013f7,32,2682,29.8,30,29,2,2,35,47,-12,34.5,44.0,-9.5,19,SPA
27d0a506,32,2211,24.6,25,16,7,5,25,33,-8,28.0,36.0,-8.0,19,SPA
293211e1,20,943,10.5,10,4,10,3,6,14,-8,11.4,13.2,-1.8,19,SPA
2946f9a1,20,1698,18.9,19,16,1,12,31,24,7,35.1,22.3,12.7,19,SPA
2973d8ff,15,527,5.9,4,1,11,2,6,4,2,7.2,4.6,2.6,19,SPA
29b61deb,34,2792,31.0,32,25,2,3,27,42,-15,33.1,42.0,-8.9,19,SPA
29e48848,6,481,5.3,6,3,0,2,2,6,-4,4.1,5.5,-1.4,19,SPA
2a0c8ba4,36,2875,31.9,32,25,4,0,37,38,-1,42.2,36.7,5.5,19,SPA
2a8c9f98,1,29,0.3,0,0,1,1,1,0,1,0.9,0.9,0.0,19,SPA
2b15a82a,9,629,7.0,8,4,1,14,12,8,4,11.1,7.6,3.5,19,SPA
2bee98fd,29,1486,16.5,17,6,12,2,18,23,-5,21.1,24.7,-3.6,19,SPA
2e23c66b,16,699,7.8,7,2,9,2,11,15,-4,10.2,17.0,-6.8,19,SPA
2e8fc160,5,233,2.6,3,0,2,6,2,4,-2,2.2,5.0,-2.9,19,SPA
2ef16f06,15,359,4.0,2,0,13,6,6,10,-4,5.1,6.0,-0.8,19,SPA
3024e383,35,3028,33.6,34,27,1,1,40,43,-3,49.7,41.3,8.4,19,SPA
3061e1ec,5,365,4.1,4,4,1,25,2,5,-3,3.1,6.0,-2.8,19,SPA
30672832,1,90,1.0,1,1,0,2,0,2,-2,0.6,1.4,-0.8,19,SPA
307fcd26,6,540,6.0,6,6,0,32,9,7,2,5.9,8.7,-2.7,19,SPA
31223bcf,21,1149,12.8,12,4,9,4,13,24,-11,18.1,20.7,-2.6,19,SPA
32974271,20,1544,17.1,17,15,3,6,15,26,-11,21.700000000000003,29.0,-7.199999999999999,19,SPA
32c0491f,23,1868,20.8,21,19,2,3,30,22,8,34.7,25.0,9.7,19,SPA
335039a2,5,341,3.8,5,1,0,16,2,4,-2,2.0,4.2,-2.2,19,SPA
3353737a,14,1119,12.4,13,10,1,10,26,9,17,22.7,12.9,9.8,19,SPA
335fa267,29,2088,23.2,23,19,6,2,58,26,32,50.2,29.4,20.9,19,SPA
355c883a,27,2032,22.6,23,18,4,4,24,30,-6,24.4,31.6,-7.2,19,SPA
35f6db55,20,1233,13.7,14,5,6,1,16,23,-7,16.8,19.6,-2.7,19,SPA
36d5469c,25,1009,11.2,10,3,15,9,14,25,-11,17.2,17.9,-0.7,19,SPA
375a669e,5,193,2.1,2,0,3,3,2,4,-2,2.0,3.2,-1.2,19,SPA
379652be,32,1997,22.2,22,6,10,6,34,20,14,33.2,29.6,3.5,19,SPA
37e103f8,11,417,4.6,5,1,6,10,6,5,1,7.6,7.4,0.3,19,SPA
37f1cf47,25,1642,18.2,17,15,8,4,19,19,0,20.7,20.6,0.2,19,SPA
37f96552,27,966,10.7,9,3,18,9,10,15,-5,12.5,12.7,-0.2,19,SPA
38699c72,20,730,8.1,7,0,13,11,8,9,-1,12.3,13.4,-1.1,19,SPA
3902e91b,22,1345,14.9,14,7,8,0,13,25,-12,20.7,24.0,-3.3,19,SPA
3aa4a3be,33,1957,21.7,22,10,11,4,24,27,-3,27.5,24.4,3.1,19,SPA
3c05c659,15,450,5.0,4,2,11,16,7,1,6,6.3,5.9,0.4,19,SPA
3c7bc9bd,31,2474,27.5,27,25,4,0,27,31,-4,30.7,29.2,1.6,19,SPA
3cb6f224,16,557,6.2,5,0,11,8,7,8,-1,8.6,8.0,0.6,19,SPA
3d7e48ce,4,146,1.6,2,0,2,4,1,0,1,1.1,1.2,-0.1,19,SPA
3e1858af,1,10,0.1,0,0,1,0,0,1,-1,0.0,0.3,-0.3,19,SPA
3e4f735d,28,2181,24.2,25,21,3,3,31,21,10,27.9,25.6,2.3,19,SPA
3e5a168c,1,90,1.0,1,1,0,0,3,0,3,0.9,0.9,0.1,19,SPA
3e96f3e7,9,404,4.5,4,2,5,12,6,5,1,6.4,7.0,-0.5,19,SPA
3ecc11d8,30,2613,29.0,30,28,0,3,32,30,2,32.6,31.9,0.6,19,SPA
3ee0dd59,1,7,0.1,0,0,1,2,0,1,-1,0.5,0.0,0.5,19,SPA
3eed9821,14,1189,13.2,13,12,1,8,30,16,14,24.5,13.5,11.1,19,SPA
3ef0fa48,8,229,2.5,1,0,7,7,6,2,4,2.8,4.6,-1.8,19,SPA
3effaa34,27,2159,24.0,25,18,2,1,34,26,8,45.0,29.2,15.8,19,SPA
3f10bd22,32,2712,30.1,31,28,1,0,50,42,8,50.9,37.0,14.0,19,SPA
3f79a1c8,32,1789,19.9,18,12,14,1,23,29,-6,30.6,25.1,5.5,19,SPA
3fc45c73,33,2902,32.2,33,32,0,1,33,40,-7,34.9,39.4,-4.4,19,SPA
407feb71,9,376,4.2,5,0,4,3,8,4,4,10.4,4.7,5.7,19,SPA
418f8f61,35,2553,28.4,27,20,8,2,26,35,-9,32.4,44.0,-11.6,19,SPA
41b3069f,36,3130,34.8,35,34,1,0,30,46,-16,37.8,52.9,-15.1,19,SPA
41c12f75,14,1007,11.2,12,6,2,1,12,10,2,12.2,14.1,-1.8,19,SPA
42276181,33,1612,17.9,16,7,17,1,20,18,2,27.8,21.9,5.9,19,SPA
4242011c,31,2727,30.3,31,29,0,4,31,43,-12,33.9,43.3,-9.5,19,SPA
42dcf26d,33,2964,32.9,33,31,0,0,44,47,-3,47.0,47.9,-0.9,19,SPA
43f71e77,38,2648,29.4,28,16,10,0,40,27,13,37.9,31.4,6.5,19,SPA
4442fbcd,16,670,7.4,9,1,7,7,13,9,4,8.7,12.0,-3.3,19,SPA
44e07fac,1,63,0.7,1,0,0,0,0,0,0,0.0,0.2,-0.2,19,SPA
45af8a54,30,1779,19.8,19,9,11,2,31,26,5,33.1,25.7,7.5,19,SPA
45e17712,25,1799,20.0,23,11,2,4,22,19,3,20.4,21.7,-1.3,19,SPA
45e304c8,16,555,6.2,5,1,11,7,6,14,-8,6.0,11.5,-5.5,19,SPA
4601e194,36,2991,33.2,32,32,4,0,86,30,56,70.0,38.6,31.4,19,SPA
46166b49,9,140,1.6,0,0,9,4,0,6,-6,1.8,3.3,-1.5,19,SPA
467bae22,34,2280,25.3,26,13,8,1,42,28,14,45.3,30.5,14.9,19,SPA
46e07328,6,113,1.3,0,0,6,5,4,0,4,0.8,1.6,-0.8,19,SPA
4737cebe,20,1254,13.9,13,8,7,0,21,11,10,21.9,17.3,4.6,19,SPA
474ecac8,21,1449,16.1,17,12,4,1,26,30,-4,22.6,29.4,-6.8,19,SPA
487d9b09,14,934,10.4,12,7,2,7,9,16,-7,10.6,14.2,-3.6,19,SPA
48b3dd60,27,1430,15.9,19,0,8,3,32,15,17,29.9,18.8,11.0,19,SPA
48e89655,20,743,8.3,6,2,14,3,8,12,-4,9.4,10.0,-0.7,19,SPA
4958bfb2,24,2107,23.4,23,23,1,1,38,23,15,36.8,24.8,11.9,19,SPA
49ea92be,23,1321,14.7,15,4,8,4,21,17,4,16.9,18.2,-1.3,19,SPA
4a478107,37,3195,35.5,35,32,2,0,53,62,-9,49.9,69.9,-20.0,19,SPA
4a537185,14,779,8.7,9,2,5,2,9,17,-8,10.2,14.2,-4.0,19,SPA
4a895384,31,2677,29.7,30,28,1,3,35,52,-17,42.3,48.0,-5.7,19,SPA
4accb7e0,24,1580,17.6,17,10,7,7,18,22,-4,20.3,24.3,-4.0,19,SPA
4acd733a,17,888,9.9,10,5,7,4,8,18,-10,12.1,13.4,-1.4,19,SPA
4b5e7e90,10,776,8.6,10,7,0,8,9,10,-1,12.9,12.7,0.3,19,SPA
4b803b3c,7,536,6.0,6,5,1,0,11,8,3,13.7,6.3,7.4,19,SPA
4c2e9442,35,2960,32.9,33,28,2,0,47,51,-4,40.2,50.3,-10.2,19,SPA
4c5b14d2,30,1696,18.8,17,7,13,2,22,21,1,25.5,24.2,1.3,19,SPA
4cee5954,10,897,10.0,10,9,0,0,17,15,2,17.2,15.7,1.5,19,SPA
4d224fe8,29,2312,25.7,27,21,2,3,43,32,11,48.1,31.0,17.1,19,SPA
4db76f57,19,1406,15.6,15,13,4,11,15,24,-9,16.2,22.2,-6.0,19,SPA
4dbd0916,31,1817,20.2,22,5,9,1,29,11,18,23.6,19.4,4.1,19,SPA
4f28a6ff,23,1933,21.5,22,19,1,12,57,19,38,45.4,27.4,18.0,19,SPA
4ffb647d,9,701,7.8,6,6,3,2,15,18,-3,14.9,15.4,-0.5,19,SPA
5083a734,16,1154,12.8,14,8,2,1,14,18,-4,14.2,20.2,-6.0,19,SPA
51c30111,10,532,5.9,6,1,4,6,11,16,-5,9.8,14.6,-4.8,19,SPA
51e3954c,19,1671,18.6,19,16,0,11,27,25,2,21.4,24.3,-2.8999999999999995,19,SPA
525f9bf4,12,222,2.5,1,1,11,9,7,7,0,5.4,6.8,-1.4,19,SPA
529f49ab,32,2070,23.0,22,16,10,4,33,21,12,30.5,28.7,1.9,19,SPA
54073b28,18,1285,14.3,15,10,3,5,14,16,-2,15.8,14.3,1.5,19,SPA
545e2f01,15,1173,13.0,13,12,2,14,14,19,-5,15.7,24.4,-8.7,19,SPA
549c6ba7,6,172,1.9,1,1,5,4,2,7,-5,3.5,6.1,-2.6,19,SPA
55126f3b,30,2586,28.7,29,26,1,0,42,22,20,37.6,31.9,5.6,19,SPA
5512b1a9,4,359,4.0,4,3,0,32,10,2,8,7.9,3.8,4.0,19,SPA
555f3a0b,32,2806,31.2,31,30,1,0,42,36,6,38.8,43.1,-4.3,19,SPA
581c5276,14,1260,14.0,14,14,0,21,20,22,-2,24.6,17.1,7.5,19,SPA
5890cef1,10,645,7.2,8,4,2,0,10,10,0,9.4,9.5,-0.1,19,SPA
58afe001,33,2676,29.7,32,20,1,2,32,25,7,36.0,32.4,3.7,19,SPA
59b7d823,4,211,2.3,2,2,2,1,2,4,-2,2.8,3.3,-0.5,19,SPA
59d53e8a,22,1778,19.8,22,10,0,4,18,21,-3,20.6,20.4,0.2,19,SPA
59d93937,19,601,6.7,6,0,13,7,7,9,-2,7.7,11.5,-3.8,19,SPA
5a626448,36,3055,33.9,35,28,1,2,37,58,-21,44.2,56.0,-11.7,19,SPA
5ab0ea87,35,2715,30.2,30,20,5,0,77,26,51,62.0,33.1,28.9,19,SPA
5ae499d0,25,2032,22.6,23,21,2,6,25,37,-12,25.5,31.4,-5.9,19,SPA
5b1bf5e3,12,717,8.0,9,3,3,3,8,19,-11,10.0,13.6,-3.7,19,SPA
5c4dc0ff,13,447,5.0,3,2,10,5,8,10,-2,10.5,8.4,2.1,19,SPA
5c7845f6,33,2549,28.3,29,23,4,2,28,37,-9,31.1,36.8,-5.7,19,SPA
5ca20b7a,26,2139,23.8,25,21,1,3,29,29,0,31.6,31.0,0.6,19,SPA
5ce0b5ba,23,1821,20.2,20,16,3,1,23,21,2,25.5,24.0,1.4,19,SPA
5ceba7fc,34,2144,23.8,24,11,10,3,35,28,7,38.2,30.3,7.8,19,SPA
5d311e8d,25,1933,21.5,21,21,4,7,30,29,1,29.6,27.3,2.3,19,SPA
5dcf3e90,7,630,7.0,7,7,0,31,9,13,-4,8.1,12.0,-4.0,19,SPA
5efb80d5,18,1277,14.2,14,12,4,10,19,29,-10,16.4,25.2,-8.8,19,SPA
5f186f5c,4,120,1.3,1,1,3,10,0,3,-3,1.3,1.6,-0.2,19,SPA
5f3eaaf5,19,785,8.7,8,3,11,13,15,12,3,13.4,16.3,-2.9,19,SPA
5fa714d5,1,90,1.0,1,1,0,0,3,0,3,1.7,1.2,0.5,19,SPA
6025fab1,34,2608,29.0,31,18,3,1,45,36,9,45.5,36.2,9.4,19,SPA
603116a7,23,1853,20.6,21,18,2,8,30,33,-3,38.2,29.2,9.0,19,SPA
60359288,1,46,0.5,0,0,1,5,3,2,1,1.1,0.5,0.6,19,SPA
608f2092,1,20,0.2,0,0,1,0,0,1,-1,0.5,0.2,0.2,19,SPA
61220da2,36,3210,35.7,36,33,0,0,56,61,-5,52.4,71.3,-18.9,19,SPA
61bb7498,3,270,3.0,3,3,0,31,4,6,-2,4.4,4.3,0.1,19,SPA
61bd33d0,20,1205,13.399999999999999,15,3,5,8,14,13,1,17.5,17.0,0.5,19,SPA
625c144a,27,2430,27.0,27,27,0,11,36,35,1,36.0,38.4,-2.4,19,SPA
636eae97,26,1762,19.6,21,5,5,3,13,23,-10,18.3,27.3,-8.9,19,SPA
63f04c6c,34,2095,23.3,22,17,12,4,32,41,-9,35.4,37.5,-2.1,19,SPA
6434f10d,34,2735,30.4,32,23,2,3,42,20,22,38.8,32.5,6.3,19,SPA
6435143e,5,82,0.9,1,0,4,4,0,2,-2,1.6,1.4,0.2,19,SPA
64e8ed6d,29,1621,18.0,16,10,13,5,28,34,-6,24.7,37.7,-13.0,19,SPA
65d62814,1,90,1.0,1,1,0,35,5,4,1,1.9,2.7,-0.8,19,SPA
6763373d,2,12,0.1,0,0,2,8,0,0,0,0.4,0.0,0.4,19,SPA
67cdbc0e,33,1929,21.4,22,11,11,4,49,22,27,42.5,27.6,14.9,19,SPA
6853490f,15,614,6.8,6,3,9,13,15,10,5,11.8,7.8,4.0,19,SPA
6922f806,34,2869,31.9,33,23,1,0,34,37,-3,36.6,41.2,-4.6,19,SPA
697295b1,10,585,6.5,7,4,3,15,8,13,-5,7.4,7.1,0.3,19,SPA
69cbc8b6,32,2794,31.0,31,30,1,3,42,33,9,39.5,38.3,1.2,19,SPA
6a99e0b1,38,3025,33.6,36,19,2,0,38,39,-1,39.0,38.7,0.3,19,SPA
6b5ea2f4,6,50,0.6,0,0,6,6,1,3,-2,1.1,2.0,-0.9,19,SPA
6c811eb7,17,637,7.1,6,1,11,10,16,8,8,14.3,11.0,3.3,19,SPA
6cbf8d0d,1,22,0.2,0,0,1,2,1,0,1,0.5,0.7,-0.2,19,SPA
6ce1f46f,28,2221,24.7,26,18,2,2,41,35,6,44.3,33.4,10.9,19,SPA
6d8f8441,27,1817,20.2,19,14,8,2,32,34,-2,28.0,40.8,-12.7,19,SPA
6dce77a5,3,98,1.1,1,0,2,4,1,4,-3,1.5,1.1,0.4,19,SPA
6f51e382,35,3150,35.0,35,35,0,1,86,32,54,71.8,40.7,31.1,19,SPA
6f5f82c0,7,455,5.1,6,4,1,6,3,6,-3,5.1,5.6,-0.4,19,SPA
6f7d826d,23,1490,16.6,16,12,7,3,19,22,-3,21.0,24.4,-3.5,19,SPA
6fd1ba62,22,1379,15.3,15,6,7,11,16,18,-2,17.4,19.7,-2.3,19,SPA
70438d35,9,749,8.3,8,7,1,6,11,13,-2,8.6,14.3,-5.7,19,SPA
70d74ece,36,2953,32.8,35,24,1,0,56,39,17,57.6,40.0,17.6,19,SPA
7106f0a0,14,1026,11.4,11,8,3,1,10,24,-14,13.3,21.1,-7.8,19,SPA
7111d552,18,869,9.7,9,5,9,5,15,13,2,16.2,13.2,3.0,19,SPA
71b47ab9,34,2150,23.9,25,11,9,0,27,45,-18,37.3,38.0,-0.8,19,SPA
72a99e38,29,1573,17.5,13,12,16,3,31,22,9,27.0,22.8,4.2,19,SPA
72b07a9c,35,3100,34.4,35,33,0,0,31,45,-14,37.3,53.2,-15.8,19,SPA
72b92c4e,7,419,4.7,4,2,3,5,5,3,2,4.6,8.6,-4.0,19,SPA
7329018e,28,2352,26.1,27,22,1,3,33,36,-3,39.6,31.2,8.4,19,SPA
73683fa9,38,3420,38.0,38,38,0,0,48,50,-2,48.9,53.8,-4.9,19,SPA
7460ca0d,36,3061,34.0,35,32,1,0,48,31,17,55.9,39.0,16.9,19,SPA
74e0a984,24,1686,18.7,20,13,4,9,20,42,-22,24.4,32.9,-8.4,19,SPA
75645f0e,37,3075,34.2,35,25,2,0,45,42,3,45.1,48.5,-3.5,19,SPA
75751c99,34,3055,33.9,34,33,0,2,35,38,-3,37.5,35.2,2.2,19,SPA
7958dc65,18,999,11.1,12,3,6,10,15,17,-2,14.1,16.3,-2.2,19,SPA
7b309e55,5,285,3.2,3,2,2,2,2,5,-3,4.4,3.1,1.2,19,SPA
7b456af7,33,2970,33.0,33,33,0,0,52,44,8,57.9,40.6,17.4,19,SPA
7b5ab7f2,11,167,1.9,0,0,11,7,6,3,3,3.3,3.1,0.2,19,SPA
7c388b20,33,2693,29.9,30,23,3,1,29,46,-17,35.1,45.7,-10.6,19,SPA
7c4243d4,31,1746,19.4,20,11,11,4,34,27,7,34.0,23.4,10.5,19,SPA
7c689c48,1,3,0.0,0,0,1,3,0,0,0,0.3,0.2,0.1,19,SPA
7cefa219,15,1098,12.2,12,10,3,9,10,24,-14,17.1,20.7,-3.6,19,SPA
7dcf86f6,27,2251,25.0,26,14,1,1,44,39,5,34.7,36.5,-1.8,19,SPA
7eb97a8e,3,37,0.4,0,0,3,5,2,0,2,0.2,0.3,-0.1,19,SPA
7f203b54,19,1254,13.9,13,9,6,9,25,23,2,21.6,29.4,-7.7,19,SPA
7f4c7c9f,30,2492,27.7,30,26,0,0,26,42,-16,34.2,40.3,-6.0,19,SPA
7f8fb807,9,216,2.4,1,1,8,4,3,3,0,3.0,3.4,-0.4,19,SPA
808d48f3,21,1495,16.6,18,12,3,11,19,22,-3,22.1,25.3,-3.2,19,SPA
808df563,3,225,2.5,2,2,1,0,0,2,-2,1.7,3.1,-1.4,19,SPA
81069528,21,1749,19.4,20,17,1,10,26,20,6,24.2,25.4,-1.1,19,SPA
81f0781e,35,2315,25.7,25,16,10,1,24,32,-8,34.5,37.2,-2.7,19,SPA
82927de4,35,2479,27.5,28,19,7,1,33,38,-5,38.0,39.0,-0.9,19,SPA
82e9b89d,19,1539,17.1,17,13,2,0,23,25,-2,20.6,26.5,-5.9,19,SPA
833fb62e,24,1055,11.7,10,4,14,5,7,17,-10,15.0,16.0,-1.0,19,SPA
84399660,30,1523,16.9,16,6,14,5,20,23,-3,21.1,22.2,-1.1,19,SPA
8455ad90,3,24,0.3,0,0,3,7,1,0,1,0.4,0.1,0.2,19,SPA
84fb6aff,7,627,7.0,7,6,0,5,11,10,1,8.2,11.4,-3.2,19,SPA
850c0a0d,25,1950,21.7,22,19,3,2,26,31,-5,30.8,25.9,4.9,19,SPA
857cb4f3,8,464,5.2,4,3,4,4,7,11,-4,6.3,10.1,-3.8,19,SPA
85dace26,1,85,0.9,0,0,1,0,0,2,-2,0.3,1.9,-1.5,19,SPA
8696bc90,23,1194,13.299999999999999,13,6,10,10,28,22,6,25.0,16.7,8.3,19,SPA
873619c6,1,45,0.5,0,0,1,2,2,0,2,1.0,0.9,0.0,19,SPA
875898c7,10,893,9.9,9,8,1,1,11,21,-10,12.6,23.6,-11.0,19,SPA
87882adc,2,71,0.8,1,0,1,4,0,1,-1,0.1,1.7,-1.6,19,SPA
88050721,7,328,3.6,3,1,4,9,4,8,-4,5.7,7.8,-2.1,19,SPA
8875b8c9,13,1170,13.0,13,13,0,25,23,22,1,13.3,19.5,-6.2,19,SPA
88d91621,19,1069,11.9,12,9,7,17,7,14,-7,11.0,16.2,-5.2,19,SPA
88f130ed,2,157,1.7,2,1,0,1,0,1,-1,1.5,1.1,0.3,19,SPA
89151b16,21,1702,18.9,19,16,2,9,20,23,-3,25.4,24.3,1.1,19,SPA
896b5df2,1,45,0.5,0,0,1,2,1,1,0,0.2,0.7,-0.5,19,SPA
8970907e,35,2280,25.3,23,17,12,1,28,41,-13,39.0,37.3,1.8,19,SPA
89cbc961,31,2627,29.2,29,27,2,5,41,36,5,43.6,41.2,2.5,19,SPA
89f951b5,34,2643,29.4,29,24,5,0,76,25,51,59.9,36.3,23.7,19,SPA
8b0b02c9,18,687,7.6,6,3,12,5,9,13,-4,9.4,13.4,-4.0,19,SPA
8b8a56ce,26,2008,22.3,25,16,1,4,31,30,1,35.5,29.8,5.7,19,SPA
8c3c640c,37,3153,35.0,36,28,1,0,42,41,1,45.8,43.8,2.0,19,SPA
8c44e37b,27,1439,16.0,18,3,9,4,16,25,-9,18.3,24.0,-5.7,19,SPA
8cfc2f69,37,1819,20.2,20,3,17,1,21,16,5,23.7,23.3,0.4,19,SPA
8d2ad5c0,13,482,5.4,5,0,8,3,5,9,-4,5.2,8.3,-3.1,19,SPA
8d957256,1,90,1.0,1,1,0,37,2,1,1,1.4,0.9,0.5,19,SPA
8db394aa,31,2533,28.1,28,26,3,6,29,35,-6,31.8,36.5,-4.7,19,SPA
8e010ff4,32,1994,22.2,19,10,13,3,31,23,8,29.0,26.5,2.4,19,SPA
8e088e04,4,270,3.0,3,2,1,26,4,5,-1,5.2,6.7,-1.5,19,SPA
8e48dc61,1,90,1.0,1,1,0,2,1,1,0,2.9,1.3,1.6,19,SPA
8ef81d2d,22,1692,18.8,19,14,3,3,25,31,-6,29.7,31.4,-1.8,19,SPA
8f898ba8,32,1992,22.1,23,11,9,2,20,18,2,25.4,22.0,3.5,19,SPA
8f8c6934,37,3330,37.0,37,37,0,0,46,34,12,44.8,42.7,2.1,19,SPA
8fae77ea,35,3150,35.0,35,35,0,3,28,45,-17,36.7,54.3,-17.6,19,SPA
9038c2a1,30,2330,25.9,26,19,4,6,37,39,-2,32.5,47.9,-15.4,19,SPA
90bbd822,35,1766,19.6,17,7,18,2,21,35,-14,23.4,31.1,-7.6,19,SPA
9109185e,31,2790,31.0,31,31,0,1,32,32,0,35.4,33.7,1.7,19,SPA
9127f9ce,19,841,9.3,10,5,9,12,4,17,-13,7.0,12.6,-5.5,19,SPA
9260926b,17,762,8.5,7,4,10,10,9,14,-5,13.7,13.0,0.7,19,SPA
92b4a127,24,1897,21.1,21,19,3,7,34,33,1,26.3,30.4,-4.2,19,SPA
92d38e6c,34,2962,32.9,34,31,0,0,32,38,-6,36.6,35.9,0.6,19,SPA
933e8c8a,27,2098,23.3,25,14,2,7,15,23,-8,21.2,32.8,-11.6,19,SPA
942b4f90,35,2812,31.2,31,21,4,2,56,33,23,57.7,34.7,22.9,19,SPA
958bba56,23,1588,17.6,17,10,6,6,19,26,-7,23.4,29.6,-6.2,19,SPA
960fb42d,17,1412,15.7,17,11,0,10,13,28,-15,17.9,27.0,-9.1,19,SPA
963829d0,24,1547,17.2,18,11,6,4,14,18,-4,22.1,23.6,-1.5,19,SPA
967f34d3,25,2250,25.0,25,25,0,12,30,40,-10,33.3,41.4,-8.1,19,SPA
9744ff80,33,2724,30.3,30,23,3,0,55,36,19,56.9,34.0,22.9,19,SPA
97572117,23,1708,19.0,20,13,3,8,19,19,0,21.6,18.6,3.0,19,SPA
97852360,35,3150,35.0,35,35,0,1,34,46,-12,38.0,49.9,-11.9,19,SPA
978cd030,32,2785,30.9,32,27,0,1,35,50,-15,40.0,50.1,-10.1,19,SPA
98554bfd,6,372,4.1,5,3,1,3,4,8,-4,6.7,7.7,-0.9,19,SPA
9970da54,3,270,3.0,3,3,0,33,5,4,1,3.1,3.3,-0.1,19,SPA
999908af,29,1669,18.5,18,12,11,6,17,21,-4,17.5,26.9,-9.4,19,SPA
99bebd12,22,631,7.0,6,1,16,11,9,13,-4,6.0,8.6,-2.5,19,SPA
9a64e67e,4,284,3.2,3,3,1,4,1,5,-4,4.5,2.9,1.6,19,SPA
9ab48bde,24,1520,16.9,16,13,8,8,16,24,-8,19.1,18.5,0.6,19,SPA
9b337c7c,20,1155,12.8,14,7,6,9,17,18,-1,17.6,18.7,-1.0,19,SPA
9ba48d64,23,1459,16.2,17,11,6,11,16,21,-5,17.6,20.4,-2.8,19,SPA
9d2a3d5f,32,2029,22.5,23,9,9,2,27,21,6,23.3,26.900000000000002,-3.7,19,SPA
9e098912,1,90,1.0,1,1,0,8,2,0,2,1.5,0.5,1.0,19,SPA
9e1035f8,24,850,9.4,8,1,16,12,12,8,4,14.0,11.9,2.1,19,SPA
9f0ea33f,32,2880,32.0,32,32,0,4,40,45,-5,48.0,46.4,1.6,19,SPA
9f323c71,30,2421,26.9,28,20,2,5,31,32,-1,32.3,32.4,-0.1,19,SPA
9f8e9423,32,2754,30.6,31,28,1,1,44,34,10,48.3,37.8,10.5,19,SPA
a01c3d54,16,1440,16.0,16,16,0,21,25,24,1,21.8,28.2,-6.4,19,SPA
a0255c67,10,610,6.8,7,1,3,12,16,11,5,10.3,8.4,1.9,19,SPA
a03c82b2,18,1429,15.9,15,13,3,8,16,16,0,16.2,14.7,1.5,19,SPA
a0b4bb3e,27,1192,13.2,11,2,16,4,25,18,7,27.7,16.8,10.9,19,SPA
a10361d2,31,1663,18.5,20,6,11,6,15,24,-9,20.8,24.6,-3.9,19,SPA
a190d597,16,1112,12.4,14,8,2,0,16,8,8,13.0,12.9,0.1,19,SPA
a230ebcc,2,14,0.2,0,0,2,3,0,0,0,0.0,0.2,-0.1,19,SPA
a25250f8,32,2391,26.6,26,20,6,3,28,40,-12,31.2,35.8,-4.6,19,SPA
a2609621,16,1362,15.1,16,12,0,5,20,18,2,20.3,20.5,-0.1,19,SPA
a4971d84,34,2976,33.1,34,29,0,0,45,31,14,40.7,36.0,4.6,19,SPA
a4b00319,16,1440,16.0,16,16,0,0,25,23,2,21.7,25.7,-4.0,19,SPA
a58bb1e1,29,1786,19.8,21,6,8,2,34,23,11,36.1,24.6,11.5,19,SPA
a60823a4,8,465,5.2,4,2,4,19,9,13,-4,8.0,9.5,-1.5,19,SPA
a6154613,33,2827,31.4,31,27,2,0,81,29,52,67.6,37.3,30.3,19,SPA
a685f013,6,521,5.8,5,5,1,5,7,11,-4,7.1,8.3,-1.2,19,SPA
a6951bf8,26,1761,19.6,20,9,6,2,29,15,14,29.2,20.3,8.9,19,SPA
a6de370d,32,2655,29.5,30,25,2,1,34,43,-9,34.3,38.8,-4.5,19,SPA
a7f00c8c,7,507,5.6,6,4,1,2,6,17,-11,5.9,9.7,-3.9,19,SPA
a8f21b9f,1,18,0.2,0,0,1,0,0,0,0,0.2,0.5,-0.4,19,SPA
a8fbae1d,28,2245,24.9,24,23,4,8,31,33,-2,35.5,30.9,4.6,19,SPA
a9dc785c,34,3060,34.0,34,34,0,3,46,34,12,55.8,39.7,16.1,19,SPA
aa0ac32d,11,660,7.3,7,6,4,14,4,13,-9,7.4,10.6,-3.2,19,SPA
aa386464,8,236,2.6,1,1,7,3,4,7,-3,5.5,3.8,1.8,19,SPA
ac295d9e,24,2160,24.0,24,24,0,5,29,30,-1,30.2,28.7,1.5,19,SPA
ac3fb1be,24,2136,23.7,24,23,0,3,31,23,8,39.9,24.2,15.7,19,SPA
ac454a4f,16,1199,13.3,13,12,3,11,8,19,-11,12.7,17.7,-4.9,19,SPA
ad178594,16,1310,14.6,15,13,1,11,13,17,-4,16.8,19.8,-3.0,19,SPA
ad1ffcfd,19,1665,18.5,19,17,0,0,27,27,0,26.4,26.3,0.1,19,SPA
ad4d0985,24,1265,14.1,13,9,11,10,18,22,-4,16.0,20.2,-4.2,19,SPA
ad6295d4,8,506,5.6,5,4,3,5,5,7,-2,6.9,8.4,-1.4,19,SPA
adfc9123,35,3150,35.0,35,35,0,1,86,30,56,71.5,41.0,30.6,19,SPA
aec0fb6f,13,631,7.0,9,1,4,6,3,12,-9,5.7,9.2,-3.5,19,SPA
b037bd4f,27,2031,22.6,25,10,2,3,28,28,0,27.5,27.8,-0.4,19,SPA
b05e2dbd,35,3137,34.9,35,34,0,0,47,30,17,55.4,36.4,18.9,19,SPA
b0616e3d,21,1545,17.2,18,11,3,2,19,16,3,24.0,17.0,6.9,19,SPA
b0c71810,35,2085,23.2,25,2,10,1,35,36,-1,28.3,37.3,-9.0,19,SPA
b0fce72c,26,2070,23.0,23,15,3,8,26,22,4,23.6,23.0,0.6,19,SPA
b14d0c5d,24,1742,19.4,20,16,4,10,22,31,-9,21.9,29.1,-7.2,19,SPA
b182a240,33,1583,17.6,15,11,18,2,28,28,0,32.2,20.9,11.3,19,SPA
b18a3023,9,536,6.0,6,4,3,5,8,8,0,6.2,7.3,-1.1,19,SPA
b19db005,29,1661,18.5,20,2,9,0,49,13,36,38.2,20.1,18.0,19,SPA
b233e8e4,3,203,2.3,2,2,1,15,1,2,-1,2.2,1.6,0.6,19,SPA
b2d0ec1b,4,76,0.8,1,0,3,12,2,2,0,1.4,2.6,-1.2,19,SPA
b39a793e,9,211,2.3,1,1,8,3,5,2,3,3.6,2.3,1.3,19,SPA
b3dc6eca,22,1975,21.9,22,21,0,11,28,31,-3,32.9,31.1,1.8,19,SPA
b418dbd4,33,2369,26.3,27,14,6,0,28,24,4,30.2,26.8,3.4,19,SPA
b5bdf144,21,1890,21.0,21,21,0,14,32,40,-8,29.5,46.1,-16.6,19,SPA
b6b2b820,10,357,4.0,4,0,6,6,5,5,0,5.1,3.0,2.0,19,SPA
b6e50615,35,3120,34.7,35,34,0,0,38,40,-2,38.0,41.0,-2.9,19,SPA
b742cc0d,33,2928,32.5,33,31,0,4,38,43,-5,42.4,41.3,1.1,19,SPA
b7c99b9b,36,3240,36.0,36,36,0,0,37,44,-7,39.4,49.2,-9.7,19,SPA
b7ca5c51,30,2623,29.1,30,28,0,3,38,28,10,45.1,33.6,11.5,19,SPA
b7f2edff,6,290,3.2,2,2,4,9,5,6,-1,4.3,7.9,-3.6,19,SPA
b86a64b2,13,839,9.3,9,8,4,12,5,16,-11,10.5,18.1,-7.5,19,SPA
b86fe156,22,1732,19.2,21,13,1,3,24,35,-11,23.8,28.0,-4.3,19,SPA
b8a642fc,26,1706,19.0,19,8,7,2,28,26,2,24.4,28.1,-3.7,19,SPA
b8c1de25,10,540,6.0,5,4,5,0,6,5,1,9.6,6.7,2.9,19,SPA
b92b456a,17,604,6.7,6,1,11,8,9,9,0,11.2,7.2,3.9,19,SPA
ba5004e1,36,3240,36.0,36,36,0,0,43,34,9,42.4,40.5,1.9,19,SPA
ba5a9545,6,340,3.8,4,1,2,7,2,6,-4,3.4000000000000004,5.3,-1.9,19,SPA
ba71d071,25,1868,20.8,20,18,5,10,21,32,-11,23.7,28.1,-4.5,19,SPA
bad38a94,27,2354,26.2,27,23,0,4,30,38,-8,34.8,39.4,-4.6,19,SPA
baf5665c,1,49,0.5,1,0,0,2,0,1,-1,0.5,0.7,-0.2,19,SPA
bb4b1242,35,2582,28.7,30,14,5,2,39,38,1,43.3,35.1,8.2,19,SPA
bba30585,21,1752,19.5,20,17,1,3,28,17,11,25.6,22.4,3.3,19,SPA
bbfaeda4,4,157,1.7,1,1,3,2,2,7,-5,3.2,6.8,-3.7,19,SPA
bc39454c,1,20,0.2,0,0,1,9,1,1,0,0.7,1.0,-0.3,19,SPA
bc6f5f06,32,2765,30.7,31,29,1,6,40,43,-3,49.4,39.1,10.3,19,SPA
bca21ef3,20,1800,20.0,20,20,0,10,26,30,-4,27.0,34.2,-7.2,19,SPA
bdef8cdb,1,1,0.0,0,0,1,4,0,0,0,0.0,0.0,0.0,19,SPA
be170419,12,1064,11.8,11,11,1,21,12,15,-3,14.5,14.6,0.0,19,SPA
be3a0121,22,1619,18.0,18,13,4,5,15,21,-6,19.4,25.4,-6.0,19,SPA
bf12926c,12,353,3.9,3,0,9,4,7,6,1,6.8,4.6,2.2,19,SPA
bf97c188,23,1738,19.3,19,15,4,4,37,23,14,37.7,22.7,15.0,19,SPA
bfb15d99,1,90,1.0,1,1,0,3,2,2,0,2.7,1.9,0.8,19,SPA
c00097d2,33,2854,31.7,32,31,1,2,49,58,-9,45.1,67.0,-22.0,19,SPA
c05dfb74,34,2383,26.5,27,16,7,3,30,35,-5,32.7,31.4,1.2,19,SPA
c0617e2b,23,1248,13.9,13,5,10,10,24,13,11,22.7,18.5,4.1,19,SPA
c0b1a6da,6,540,6.0,6,6,0,8,6,16,-10,6.8,9.7,-3.0,19,SPA
c14bc029,33,2925,32.5,32,32,1,1,46,26,20,38.6,35.2,3.4,19,SPA
c2111b45,5,311,3.5,4,3,1,9,7,4,3,6.0,4.1,1.9,19,SPA
c3ee18ef,14,1117,12.4,13,10,1,2,16,8,8,13.2,12.9,0.3,19,SPA
c49afee6,17,541,6.0,5,1,12,12,6,9,-3,7.1,10.8,-3.7,19,SPA
c4b8bcf4,34,1739,19.3,17,7,17,2,31,23,8,31.5,23.2,8.2,19,SPA
c4dce677,2,16,0.2,0,0,2,3,0,2,-2,0.3,1.1,-0.8,19,SPA
c67cd65c,19,1535,17.1,17,16,2,9,25,21,4,22.1,29.3,-7.2,19,SPA
c7429db3,7,76,0.8,0,0,7,8,2,0,2,0.7,1.0,-0.3,19,SPA
c818c4d9,1,90,1.0,1,1,0,7,3,2,1,4.1,1.7,2.5,19,SPA
c8764028,1,45,0.5,1,0,0,2,0,0,0,0.2,0.0,0.2,19,SPA
c904f3d5,11,850,9.4,9,9,2,3,4,16,-12,8.6,11.9,-3.3,19,SPA
c90977db,33,2733,30.4,31,24,2,1,37,40,-3,47.1,37.2,9.9,19,SPA
c93231dc,19,1081,12.0,12,5,7,12,7,13,-6,12.9,21.7,-8.8,19,SPA
c9cb972b,4,360,4.0,4,4,0,31,5,1,4,4.9,3.2,1.7,19,SPA
c9e39d91,31,2349,26.1,27,19,4,3,34,44,-10,28.5,42.2,-13.7,19,SPA
cac2537b,36,2836,31.5,31,23,5,0,51,51,0,47.4,61.4,-14.0,19,SPA
cacadf4f,28,2389,26.5,27,24,1,6,33,48,-15,33.1,41.2,-8.1,19,SPA
cb574619,35,3092,34.4,35,33,0,0,48,53,-5,42.9,53.1,-10.2,19,SPA
ccaa5728,8,492,5.5,5,1,3,2,6,4,2,6.8,7.5,-0.7,19,SPA
cce181df,19,1245,13.8,14,10,5,4,12,13,-1,17.8,14.0,3.8,19,SPA
cda0b317,5,450,5.0,5,5,0,33,4,5,-1,8.0,5.9,2.0,19,SPA
cfd8d664,22,1609,17.9,18,15,4,10,22,14,8,22.3,20.4,1.9,19,SPA
d04b94db,26,1600,17.8,20,13,6,11,38,17,21,31.4,20.2,11.2,19,SPA
d080ed5e,29,2055,22.8,24,14,5,1,27,29,-2,31.7,30.8,0.9,19,SPA
d0d79694,9,587,6.5,7,5,2,4,11,8,3,10.4,9.5,0.9,19,SPA
d1491e00,15,513,5.699999999999999,5,0,10,5,4,10,-6,8.1,10.4,-2.3,19,SPA
d2110326,22,1580,17.6,16,16,6,9,28,18,10,30.3,25.7,4.6,19,SPA
d2ac648c,7,389,4.3,5,2,2,10,5,6,-1,4.4,5.9,-1.5,19,SPA
d2be40f2,21,1677,18.6,20,13,1,5,25,18,7,31.8,23.7,8.1,19,SPA
d2fa73e7,3,20,0.2,0,0,3,5,1,1,0,0.2,0.3,-0.1,19,SPA
d3298c99,22,657,7.3,4,2,18,4,8,14,-6,9.6,11.4,-1.8,19,SPA
d4931a5a,17,642,7.1,7,0,10,14,11,4,7,9.1,5.2,3.9,19,SPA
d4c9725f,24,1976,22.0,22,19,2,3,26,30,-4,27.0,27.8,-0.8,19,SPA
d4ef9ac5,21,1763,19.6,21,17,0,3,34,25,9,28.2,37.5,-9.4,19,SPA
d4f46475,6,320,3.6,4,2,2,6,3,6,-3,2.5,5.6,-3.1,19,SPA
d66b9872,9,425,4.7,5,1,4,3,5,5,0,4.3,5.4,-1.0,19,SPA
d70a2141,31,2763,30.7,31,30,0,3,34,60,-26,38.2,48.0,-9.8,19,SPA
d70a3661,2,69,0.8,0,0,2,4,0,2,-2,0.9,0.8,0.1,19,SPA
d70ce98e,34,2713,30.1,29,28,5,0,75,25,50,60.4,34.6,25.8,19,SPA
d717630e,10,773,8.6,9,5,1,11,7,12,-5,9.5,8.7,0.8,19,SPA
d7553721,32,2397,26.6,27,19,5,1,35,39,-4,35.7,34.7,1.0,19,SPA
d79afcfc,14,670,7.4,8,0,6,2,11,8,3,9.5,9.6,0.0,19,SPA
d83bbc54,32,2354,26.2,26,18,6,5,41,27,14,46.6,32.9,13.7,19,SPA
d83f09ff,8,544,6.0,5,3,3,4,11,9,2,10.1,8.1,2.0,19,SPA
d8712bf9,29,1364,15.2,14,7,15,8,16,31,-15,19.4,27.2,-7.800000000000001,19,SPA
d87e2cae,31,2367,26.3,28,18,3,2,34,27,7,35.7,31.5,4.3,19,SPA
d9764034,23,2008,22.3,22,21,1,5,27,26,1,25.3,31.5,-6.2,19,SPA
d9bda115,21,1222,13.6,13,6,8,3,20,15,5,19.6,16.7,2.9,19,SPA
da27e268,35,3112,34.6,35,31,0,1,46,44,2,44.8,48.3,-3.4,19,SPA
db750822,20,753,8.4,5,1,15,10,15,6,9,12.5,10.5,2.0,19,SPA
db8f0eba,36,2282,25.4,27,9,9,1,25,41,-16,31.9,41.8,-9.9,19,SPA
dbe519cf,30,1863,20.7,18,16,12,6,19,36,-17,24.5,36.8,-12.3,19,SPA
ddd5348b,1,6,0.1,0,0,1,0,0,0,0,0.0,0.0,0.0,19,SPA
de7d40d6,21,1754,19.5,21,17,0,2,27,34,-7,21.3,32.9,-11.6,19,SPA
debc6b55,18,597,6.6,4,2,14,13,6,9,-3,9.3,7.7,1.6,19,SPA
dee86451,30,2385,26.5,26,20,4,0,32,37,-5,31.3,38.3,-7.0,19,SPA
def69cd0,4,242,2.7,3,1,1,4,1,1,0,1.4,1.8,-0.4,19,SPA
df69b544,37,3198,35.5,37,31,0,0,52,29,23,44.5,38.8,5.7,19,SPA
df8b52a5,6,317,3.5,4,2,2,6,5,8,-3,3.6,6.4,-2.8,19,SPA
e1cbb531,31,2489,27.7,27,21,4,2,37,41,-4,33.0,43.9,-11.0,19,SPA
e1cea3f7,19,795,8.8,10,0,9,4,8,12,-4,9.4,13.6,-4.2,19,SPA
e1deea75,24,2130,23.7,24,22,0,2,49,23,26,45.9,26.1,19.8,19,SPA
e208bcc8,9,318,3.5,3,1,6,4,5,10,-5,4.5,9.3,-4.7,19,SPA
e29d1111,35,3150,35.0,35,35,0,0,32,45,-13,37.4,53.5,-16.1,19,SPA
e2e9c250,35,2647,29.4,30,21,5,3,42,42,0,43.8,38.9,4.9,19,SPA
e3993b65,11,170,1.9,0,0,11,7,2,5,-3,1.6,2.6,-1.0,19,SPA
e3fabb0a,16,1061,11.8,12,4,4,1,19,9,10,15.9,13.9,1.9,19,SPA
e49ce451,30,2198,24.4,26,15,4,4,35,45,-10,34.7,41.4,-6.8,19,SPA
e4b8c5b6,3,211,2.3,2,1,1,0,2,6,-4,2.5,4.6,-2.1,19,SPA
e4ed2628,27,2030,22.6,24,15,3,2,33,18,15,23.5,24.7,-1.2,19,SPA
e54bd0a2,28,2340,26.0,27,23,1,1,26,34,-8,29.9,37.8,-7.9,19,SPA
e6bc67d7,25,1465,16.3,18,5,7,1,26,10,16,22.9,13.8,9.2,19,SPA
e7ab4179,21,1632,18.1,20,12,1,6,23,35,-12,23.7,36.7,-13.0,19,SPA
e7f4603c,33,2629,29.2,30,19,3,0,31,38,-7,32.6,39.5,-6.9,19,SPA
e82d2807,11,161,1.8,0,0,11,2,2,2,0,2.0,3.6,-1.6,19,SPA
e897d8ba,30,1298,14.4,15,3,15,4,14,22,-8,20.7,16.6,4.2,19,SPA
e98f3a6a,1,90,1.0,1,1,0,2,1,4,-3,2.1,2.8,-0.7,19,SPA
e9fbcc21,1,1,0.0,0,0,1,8,0,0,0,0.0,0.0,0.0,19,SPA
ea6a7ab4,8,191,2.1,2,1,6,8,2,4,-2,2.8,4.0,-1.2,19,SPA
eb2fe5b6,6,123,1.4,1,0,5,9,4,5,-1,1.7,2.2,-0.6,19,SPA
ecada4fc,10,900,10.0,10,10,0,24,17,8,9,16.4,7.5,8.9,19,SPA
ecd8c01e,27,1800,20.0,23,4,4,2,29,29,0,28.3,36.9,-8.6,19,SPA
ed239245,16,1258,14.0,14,11,2,5,18,27,-9,19.7,27.5,-7.7,19,SPA
ed5c5fa3,30,1517,16.9,16,9,14,6,24,31,-7,19.2,29.2,-9.9,19,SPA
ee8508c0,37,3330,37.0,37,37,0,0,53,27,26,45.4,39.2,6.2,19,SPA
ee923664,4,220,2.4,2,2,2,15,1,6,-5,1.6,5.7,-4.1,19,SPA
ef322658,31,2335,25.9,27,19,4,0,31,40,-9,33.9,33.5,0.5,19,SPA
f03f284b,21,1819,20.2,21,20,0,0,24,29,-5,26.4,30.6,-4.2,19,SPA
f090a37a,2,156,1.7,2,1,0,2,0,2,-2,1.5,2.1,-0.6,19,SPA
f0da930c,21,1772,19.7,19,17,2,4,29,12,17,27.2,21.1,6.0,19,SPA
f11fe861,23,1701,18.9,18,17,5,7,25,15,10,25.5,21.0,4.5,19,SPA
f1887f53,4,112,1.2,1,1,3,9,2,5,-3,1.9,3.1,-1.2,19,SPA
f1bed920,7,484,5.4,5,5,2,10,5,6,-1,6.1,7.2,-1.1,19,SPA
f2308b33,30,2700,30.0,30,30,0,1,33,34,-1,32.8,32.6,0.2,19,SPA
f2a68b97,13,1023,11.4,12,10,1,5,9,16,-7,12.5,15.9,-3.4,19,SPA
f3112790,25,2023,22.5,24,18,1,3,21,22,-1,22.6,21.4,1.2,19,SPA
f3b1d9a2,15,1002,11.1,13,2,2,0,13,10,3,15.1,10.7,4.4,19,SPA
f4b7f2ec,2,38,0.4,0,0,2,1,0,0,0,0.1,1.8,-1.7,19,SPA
f4ec4fd0,3,239,2.7,3,2,0,7,1,2,-1,3.0,2.3,0.7,19,SPA
f6798fc3,32,2861,31.8,32,31,0,1,33,43,-10,38.8,42.5,-3.7,19,SPA
f69d934e,8,647,7.2,7,6,1,16,6,14,-8,6.2,11.9,-5.7,19,SPA
f6ac68c1,18,1398,15.5,17,14,1,4,22,12,10,18.3,15.2,3.1,19,SPA
f7dc2ae5,27,2254,25.0,24,22,3,3,28,35,-7,32.9,34.8,-1.9,19,SPA
f8eca1b6,33,2148,23.9,24,11,9,1,26,30,-4,27.1,34.5,-7.4,19,SPA
fa937f7a,32,2667,29.6,32,18,0,0,51,33,18,53.3,34.1,19.2,19,SPA
fb5d47b3,31,2599,28.9,30,26,1,3,34,36,-2,38.8,40.1,-1.3,19,SPA
fbd6378b,35,3059,34.0,34,32,1,1,40,46,-6,40.1,45.2,-5.1,19,SPA
fc4f85b1,30,2509,27.9,28,27,2,1,41,24,17,35.9,32.0,3.9,19,SPA
fc647b34,26,1764,19.6,22,8,4,5,19,33,-14,23.0,26.1,-3.0,19,SPA
fc70e345,21,1890,21.0,21,21,0,15,23,35,-12,25.6,30.1,-4.6,19,SPA
fc8b614b,29,1617,18.0,16,8,13,8,18,34,-16,27.1,28.4,-1.3,19,SPA
fd47b4f2,5,430,4.8,5,4,0,6,4,11,-7,4.4,7.0,-2.5,19,SPA
fd51b456,31,1510,16.8,15,9,16,3,30,18,12,30.3,18.2,12.2,19,SPA
fd771f95,19,1402,15.6,16,8,3,0,18,19,-1,16.4,16.2,0.2,19,SPA
fd9c4805,25,844,9.4,8,1,17,7,13,14,-1,10.2,13.4,-3.2,19,SPA
fdd60087,25,1772,19.7,20,16,5,6,30,10,20,25.7,19.6,6.1,19,SPA
fed17f5a,31,2460,27.3,27,18,4,6,35,26,9,44.4,30.2,14.2,19,SPA
ffad706e,23,1948,21.6,21,18,2,7,25,33,-8,26.3,32.8,-6.5,19,SPA
005ca692,6,451,5.0,5,4,1,0,7,12,-5,6.4,11.3,-5.0,19,CL
00672021,5,206,2.3,2,0,3,1,4,7,-3,3.3,4.6,-1.3,19,CL
0174ba21,1,6,0.1,0,0,1,0,0,0,0,0.1,0.1,-0.1,19,CL
0193a8bf,6,201,2.2,2,0,4,0,3,5,-2,3.2,4.5,-1.2,19,CL
01a49bd2,2,10,0.1,0,0,2,2,0,1,-1,0.3,0.2,0.1,19,CL
01b8a2b2,10,900,10.0,10,10,0,0,14,9,5,18.9,10.1,8.8,19,CL
01c3aff5,6,373,4.1,4,2,2,1,5,7,-2,4.6,7.1,-2.5,19,CL
01e5f06e,1,1,0.0,0,0,1,0,0,0,0,0.0,0.0,0.0,19,CL
01eb744d,8,355,3.9,3,0,5,0,10,5,5,5.0,5.6,-0.6,19,CL
02c15616,2,147,1.6,2,1,0,2,2,2,0,2.7,2.9,-0.1,19,CL
032f894e,6,130,1.4,1,1,5,2,4,2,2,3.1,2.1,1.0,19,CL
0331786b,2,120,1.3,0,0,2,0,4,1,3,2.0,1.8,0.2,19,CL
0375723e,1,23,0.3,0,0,1,0,1,0,1,1.5,0.0,1.5,19,CL
03bd0bf4,4,360,4.0,4,4,0,1,4,4,0,5.0,5.3,-0.3,19,CL
03df04ff,6,540,6.0,6,6,0,0,6,11,-5,6.2,10.7,-4.5,19,CL
042d286e,6,505,5.6,6,2,0,0,7,8,-1,5.8,9.8,-4.0,19,CL
042e8a49,3,130,1.4,1,0,2,0,2,4,-2,1.5,4.3,-2.8,19,CL
048a1cbc,6,285,3.2,3,0,3,1,5,2,3,6.6,2.7,3.9,19,CL
04ac8285,1,90,1.0,1,1,0,9,1,1,0,1.3,2.4,-1.1,19,CL
0534149c,2,2,0.0,0,0,2,4,0,0,0,0.0,0.2,-0.2,19,CL
05439de2,7,630,7.0,7,7,0,1,14,8,6,12.4,9.0,3.4,19,CL
05a84d52,9,840,9.3,9,9,0,0,19,13,6,16.3,17.9,-1.6,19,CL
05d548d8,6,539,6.0,6,5,0,1,8,4,4,9.6,5.9,3.8,19,CL
061e8e23,2,85,0.9,1,0,1,4,2,0,2,2.8,0.7,2.1,19,CL
06df8256,2,180,2.0,2,2,0,0,0,4,-4,1.9,3.5,-1.6,19,CL
075fe5a3,3,225,2.5,2,2,1,3,2,9,-7,1.4,10.3,-8.8,19,CL
07750704,3,134,1.5,1,1,2,3,2,2,0,1.8,2.2,-0.4,19,CL
07ab6542,1,81,0.9,1,0,0,1,0,0,0,0.4,0.8,-0.4,19,CL
08511d65,5,418,4.6,5,4,0,0,13,2,11,10.7,6.6,4.0,19,CL
089550f5,6,518,5.8,6,5,0,0,5,7,-2,7.7,7.7,0.0,19,CL
08aa17d0,3,251,2.8,3,2,0,0,1,2,-1,3.7,2.2,1.5,19,CL
09586899,4,312,3.5,4,2,0,0,9,2,7,7.0,2.1,4.9,19,CL
0959c2a2,4,142,1.6,1,1,3,1,1,4,-3,2.6,1.2,1.4,19,CL
099b9c78,1,1,0.0,0,0,1,2,0,0,0,0.0,0.0,0.0,19,CL
0a6dbbf7,5,450,5.0,5,5,0,1,6,4,2,4.9,5.4,-0.5,19,CL
0a89e877,4,297,3.3,3,3,1,2,1,7,-6,2.0,7.9,-5.9,19,CL
0ab1f153,5,326,3.6,4,1,1,1,6,2,4,7.9,1.1,6.8,19,CL
0ac94a23,3,108,1.2,1,0,2,0,2,0,2,3.0,0.9,2.1,19,CL
0acf0e1c,5,207,2.3,3,0,2,1,2,9,-7,1.1,8.0,-6.9,19,CL
0aeeed3f,6,381,4.2,5,0,1,0,4,11,-7,5.0,8.8,-3.8,19,CL
0b4f388a,5,381,4.2,5,1,0,0,3,4,-1,5.2,5.9,-0.8,19,CL
0b5a292a,6,519,5.8,6,5,0,0,7,5,2,9.9,4.3,5.6,19,CL
0b90bb97,4,221,2.5,3,0,1,0,5,2,3,4.7,3.0,1.8,19,CL
0c2ac3cb,2,79,0.9,1,0,1,2,2,0,2,2.2,1.0,1.2,19,CL
0d10333c,4,221,2.5,2,2,2,1,2,7,-5,2.2,4.1,-1.9,19,CL
0d267745,5,400,4.4,5,3,0,4,7,5,2,10.2,5.5,4.6,19,CL
0d82903c,9,743,8.3,8,7,1,0,10,9,1,14.9,9.5,5.4,19,CL
0e100630,5,402,4.5,5,3,0,1,3,4,-1,5.8,7.2,-1.4,19,CL
0e21fc3c,6,234,2.6,2,1,4,0,3,4,-1,4.8,3.8,1.0,19,CL
0e61c46b,2,180,2.0,2,2,0,4,3,2,1,3.1,3.1,0.0,19,CL
0e6bc38c,4,53,0.6,0,0,4,4,2,1,1,1.4,0.3,1.1,19,CL
0ef89a37,12,852,9.5,11,2,1,0,18,8,10,16.5,11.0,5.5,19,CL
0f5e0b8a,5,450,5.0,5,5,0,0,5,15,-10,5.8,11.1,-5.3,19,CL
0f888175,2,96,1.1,1,1,1,4,0,3,-3,0.2,3.6,-3.4,19,CL
101da2b5,8,643,7.1,7,6,1,0,15,9,6,13.8,8.2,5.6,19,CL
106bca06,4,299,3.3,3,3,1,1,5,2,3,5.3,4.5,0.8,19,CL
111c3236,6,261,2.9,2,2,4,0,6,4,2,4.5,2.5,2.0,19,CL
116c35df,6,177,2.0,1,1,5,0,3,6,-3,3.0,5.1,-2.0,19,CL
119b9a8e,10,881,9.8,10,9,0,0,28,12,16,22.0,10.1,11.9,19,CL
11b9265b,1,9,0.1,0,0,1,5,0,0,0,0.5,0.1,0.4,19,CL
11fd2b75,3,225,2.5,3,2,0,0,2,3,-1,3.3,2.8,0.5,19,CL
129af0db,2,123,1.4,1,1,1,0,2,3,-1,1.0,2.8,-1.9,19,CL
12c50af5,2,26,0.3,0,0,2,1,0,2,-2,0.7,1.4,-0.6,19,CL
12e6d21a,4,140,1.6,1,0,3,2,0,0,0,1.1,1.6,-0.5,19,CL
13ac19de,4,290,3.2,4,2,0,0,1,9,-8,3.9,5.1,-1.3,19,CL
13c44fc5,1,18,0.2,0,0,1,0,0,0,0,0.0,0.1,-0.1,19,CL
1432d037,6,61,0.7,0,0,6,0,1,2,-1,0.5,1.2,-0.7,19,CL
1453e3cf,1,5,0.1,0,0,1,1,0,0,0,0.0,0.3,-0.3,19,CL
1467af0d,7,598,6.6,7,4,0,0,16,9,7,15.6,7.9,7.7,19,CL
149895bf,6,511,5.7,6,4,0,0,4,8,-4,9.1,9.1,-0.1,19,CL
14b8fcdf,4,272,3.0,3,3,1,4,3,5,-2,3.7,5.8,-2.0,19,CL
14e8e9d7,1,25,0.3,0,0,1,3,0,3,-3,0.1,0.6,-0.5,19,CL
15eb04ec,6,484,5.4,6,2,0,0,8,8,0,6.4,10.1,-3.7,19,CL
163bbd4a,3,244,2.7,3,0,0,2,3,7,-4,3.9,4.8,-0.9,19,CL
16657b95,7,517,5.7,5,5,2,1,10,7,3,11.7,7.3,4.4,19,CL
16b9d5cf,5,435,4.8,5,4,0,1,7,5,2,9.2,5.9,3.3,19,CL
1840e36d,5,450,5.0,5,5,0,3,10,8,2,8.6,8.2,0.4,19,CL
1880614f,6,436,4.8,5,3,1,0,8,7,1,8.8,8.1,0.8,19,CL
19053e31,4,269,3.0,2,2,2,2,1,7,-6,3.4,5.5,-2.1,19,CL
1971591f,1,8,0.1,0,0,1,0,1,0,1,0.4,0.0,0.4,19,CL
19cda00b,8,656,7.3,8,3,0,0,18,11,7,15.4,10.0,5.4,19,CL
19e4dca5,5,435,4.8,5,4,0,0,3,8,-5,6.0,7.5,-1.5,19,CL
19e4eab9,6,540,6.0,6,6,0,0,8,9,-1,6.9,11.6,-4.8,19,CL
1a2935f6,3,181,2.0,2,2,1,6,3,2,1,4.2,2.7,1.5,19,CL
1a6b7ea4,6,531,5.9,6,5,0,0,6,12,-6,7.0,13.5,-6.5,19,CL
1a6f2a66,1,22,0.2,0,0,1,0,0,0,0,0.1,0.0,0.1,19,CL
1a992676,7,287,3.2,3,2,4,1,7,5,2,6.5,4.7,1.8,19,CL
1adcf39e,5,450,5.0,5,5,0,0,6,14,-8,6.3,11.4,-5.0,19,CL
1b7ec703,7,211,2.3,2,1,5,5,3,4,-1,5.4,1.8,3.7,19,CL
1bacc518,11,985,10.9,11,10,0,0,21,12,9,21.0,15.9,5.1,19,CL
1bebde9d,2,100,1.1,1,1,1,2,1,3,-2,0.8,1.7,-0.8,19,CL
1bf33a9a,7,453,5.0,5,2,2,0,5,4,1,6.3,4.1,2.2,19,CL
1d1691ad,3,228,2.5,2,2,1,1,5,3,2,4.1,1.6,2.5,19,CL
1d8e9add,4,360,4.0,4,4,0,0,9,10,-1,9.1,6.7,2.4,19,CL
1ddbb0da,10,930,10.3,10,10,0,0,20,15,5,16.9,19.4,-2.5,19,CL
1e26e376,1,90,1.0,1,1,0,9,1,2,-1,1.8,1.4,0.3,19,CL
1e43fad8,6,540,6.0,6,6,0,1,6,14,-8,6.8,10.6,-3.8,19,CL
1f9328da,4,278,3.1,4,0,0,1,3,2,1,3.5,3.2,0.3,19,CL
1fb1c435,6,428,4.8,5,4,1,0,4,5,-1,5.4,9.0,-3.6,19,CL
21512407,8,625,6.9,7,5,1,1,12,15,-3,9.3,10.5,-1.2,19,CL
21a66f6a,9,776,8.6,9,7,0,0,10,11,-1,13.0,9.5,3.5,19,CL
2319ebe3,4,237,2.6,3,1,1,1,1,9,-8,0.9,9.3,-8.4,19,CL
2327c29e,6,127,1.4,1,0,5,3,6,3,3,3.4,5.6,-2.2,19,CL
2475dcc6,12,1080,12.0,12,12,0,0,22,13,9,22.3,17.8,4.5,19,CL
24b98f95,4,172,1.9,2,1,2,1,1,9,-8,1.3,5.4,-4.1,19,CL
24fc70d3,4,347,3.9,4,3,0,1,2,8,-6,3.7,8.2,-4.5,19,CL
2696b6a9,1,11,0.1,0,0,1,1,1,0,1,0.8,0.1,0.7,19,CL
2784f898,9,822,9.1,9,8,0,0,16,13,3,14.3,14.8,-0.5,19,CL
27f0fcda,3,189,2.1,2,1,1,0,0,6,-6,0.8,7.3,-6.5,19,CL
28b1f3ce,8,514,5.7,6,1,2,0,7,8,-1,9.2,9.3,-0.1,19,CL
28eea0fc,6,520,5.8,6,5,0,0,5,13,-8,5.9,12.8,-6.8,19,CL
292a652a,5,450,5.0,5,5,0,1,6,14,-8,6.3,11.4,-5.0,19,CL
2946f9a1,5,449,5.0,5,4,0,1,10,7,3,10.3,7.2,3.1,19,CL
29733c72,6,278,3.1,2,2,4,3,4,5,-1,3.3,5.8,-2.5,19,CL
2973d8ff,5,345,3.8,4,2,1,1,3,4,-1,3.4,8.4,-5.0,19,CL
29c02c9f,1,10,0.1,0,0,1,1,0,0,0,0.1,0.1,0.0,19,CL
2a8683b9,4,288,3.2,3,3,1,2,3,4,-1,7.1,5.9,1.2,19,CL
2acd49b9,10,729,8.1,8,5,2,2,12,8,4,12.9,9.4,3.4,19,CL
2b114be3,8,398,4.4,4,3,4,2,15,3,12,11.6,4.5,7.0,19,CL
2b5527c4,2,135,1.5,2,1,0,3,2,3,-1,1.7,3.2,-1.5,19,CL
2b622f01,12,724,8.0,8,3,4,1,14,16,-2,14.1,9.2,4.9,19,CL
2b8360f1,1,68,0.8,1,0,0,0,0,0,0,0.1,0.4,-0.3,19,CL
2bcc6d52,6,233,2.6,2,1,4,0,3,9,-6,2.0,5.8,-3.8,19,CL
2c0f8e9e,4,210,2.3,2,0,2,1,0,3,-3,1.3,4.1,-2.8,19,CL
2c20f2fb,1,46,0.5,0,0,1,0,1,2,-1,0.0,2.2,-2.1,19,CL
2c44a35d,3,179,2.0,2,0,1,1,1,2,-1,1.4,2.5,-1.1,19,CL
2d24d7a2,1,30,0.3,0,0,1,2,0,1,-1,0.1,0.3,-0.1,19,CL
2d3f7367,1,27,0.3,0,0,1,0,0,0,0,0.2,0.2,0.0,19,CL
2d61d13a,4,360,4.0,4,4,0,2,2,7,-5,6.6,6.9,-0.3,19,CL
2db2fd7b,5,450,5.0,5,5,0,2,13,5,8,11.7,5.8,5.8,19,CL
2e06f387,3,107,1.2,1,1,2,3,0,3,-3,0.5,3.7,-3.2,19,CL
2e4f5f03,12,1006,11.2,12,9,0,0,17,12,5,22.2,12.5,9.7,19,CL
2e7ff968,1,90,1.0,1,1,0,7,2,0,2,2.6,0.6,2.0,19,CL
2f3452eb,3,150,1.7,1,1,2,3,1,1,0,2.1,1.2,0.9,19,CL
2f557579,6,488,5.4,6,4,0,0,6,3,3,10.0,6.2,3.8,19,CL
2f7acede,10,673,7.5,8,3,2,0,10,10,0,10.8,8.8,2.0,19,CL
2f895007,2,97,1.1,1,0,1,1,2,1,1,1.2,0.8,0.4,19,CL
2f90f6b8,12,899,10.0,10,5,2,1,19,11,8,19.0,10.2,8.8,19,CL
2f965a72,3,270,3.0,3,3,0,5,10,6,4,7.3,4.3,3.0,19,CL
30223b33,2,180,2.0,2,2,0,6,3,3,0,2.6,2.6,0.1,19,CL
30941e96,6,540,6.0,6,6,0,0,6,13,-7,7.1,13.9,-6.8,19,CL
30f5ffa9,6,540,6.0,6,6,0,0,6,7,-1,8.6,7.8,0.8,19,CL
314f2124,3,189,2.1,2,2,1,3,2,3,-1,2.3,3.0,-0.7,19,CL
3189f61a,6,424,4.7,4,4,2,1,5,14,-9,4.9,9.3,-4.4,19,CL
31c69ef1,5,404,4.5,5,4,0,0,5,8,-3,5.5,6.9,-1.5,19,CL
321f83a2,2,72,0.8,0,0,2,3,1,0,1,1.8,0.6,1.2,19,CL
32c0491f,3,270,3.0,3,3,0,2,3,2,1,2.8,4.6,-1.8,19,CL
3353737a,4,360,4.0,4,4,0,0,8,6,2,7.7,5.7,2.0,19,CL
335fa267,9,706,7.8,8,4,1,0,17,6,11,15.8,8.0,7.8,19,CL
33b8d077,6,534,5.9,6,5,0,0,5,7,-2,8.3,7.8,0.6,19,CL
346d51d9,4,289,3.2,3,2,1,2,4,1,3,7.1,2.3,4.8,19,CL
34c3b935,6,540,6.0,6,6,0,0,8,16,-8,6.9,13.2,-6.3,19,CL
34e38ddf,1,90,1.0,1,1,0,4,1,1,0,0.8,1.5,-0.7,19,CL
356c9002,5,138,1.5,2,0,3,1,3,3,0,2.3,2.5,-0.2,19,CL
3626daea,1,66,0.7,1,0,0,3,2,0,2,1.0,0.4,0.6,19,CL
36a3ff67,6,523,5.8,6,5,0,0,8,3,5,8.8,4.4,4.4,19,CL
3708e9fa,3,228,2.5,3,1,0,0,1,5,-4,1.4,4.7,-3.3,19,CL
375622c5,1,9,0.1,0,0,1,2,0,1,-1,0.1,1.6,-1.5,19,CL
37f606f0,1,62,0.7,1,0,0,0,1,2,-1,1.2,2.7,-1.5,19,CL
38ac43d3,4,104,1.2,2,0,2,1,0,0,0,3.6,0.4,3.2,19,CL
392a7aea,6,539,6.0,6,5,0,0,6,5,1,5.4,6.3,-0.9,19,CL
39769cff,1,10,0.1,0,0,1,7,0,0,0,0.1,0.1,0.0,19,CL
3984a078,2,82,0.9,1,0,1,3,0,4,-4,0.6,2.4,-1.8,19,CL
3b15ef2d,1,90,1.0,1,1,0,4,3,0,3,3.3,0.2,3.1,19,CL
3b61c9ec,2,27,0.3,0,0,2,0,1,0,1,0.1,0.0,0.1,19,CL
3b8674e6,7,551,6.1,6,6,1,1,5,7,-2,8.5,5.2,3.3,19,CL
3b9858f5,4,337,3.7,4,3,0,1,2,8,-6,3.3,6.8,-3.5,19,CL
3bb7b8b4,10,900,10.0,10,10,0,0,30,12,18,22.9,10.1,12.8,19,CL
3bb7f478,6,570,6.3,6,6,0,0,13,8,5,11.8,10.3,1.5,19,CL
3c6089ab,6,353,3.9,4,2,2,0,9,3,6,8.8,3.6,5.2,19,CL
3cefcaef,8,706,7.8,8,7,0,0,13,13,0,12.2,16.0,-3.8,19,CL
3d50bcdb,3,69,0.8,0,0,3,4,1,1,0,1.9,1.3,0.6,19,CL
3e96f3e7,2,135,1.5,1,1,1,2,1,0,1,1.3,1.1,0.2,19,CL
3eb22ec9,8,579,6.4,6,5,2,0,25,8,17,16.6,5.9,10.8,19,CL
3eed9821,1,78,0.9,1,0,0,6,3,0,3,1.1,0.6,0.6,19,CL
3ef0fa48,2,88,1.0,1,0,1,2,1,0,1,0.9,0.7,0.2,19,CL
3f65d5ce,3,270,3.0,3,3,0,3,4,0,4,2.7,2.8,0.0,19,CL
41df88b8,1,1,0.0,0,0,1,2,0,0,0,0.0,0.0,0.0,19,CL
41f32541,4,323,3.6,4,2,0,0,5,6,-1,7.9,5.3,2.5,19,CL
42276181,5,132,1.5,0,0,5,0,0,1,-1,1.9,2.2,-0.3,19,CL
42ec696a,5,449,5.0,5,4,0,0,8,6,2,6.3,9.3,-3.0,19,CL
42fd9c7f,8,699,7.8,8,6,0,0,19,12,7,16.2,10.5,5.7,19,CL
433dc9a2,8,675,7.5,8,7,0,0,18,11,7,16.5,9.7,6.8,19,CL
436a9dd0,2,168,1.9,2,1,0,2,0,3,-3,0.7,4.2,-3.6,19,CL
43a166b4,8,221,2.5,2,0,6,2,7,0,7,4.4,3.3,1.1,19,CL
43b78598,6,540,6.0,6,6,0,0,6,7,-1,8.6,7.8,0.8,19,CL
43cd8b69,3,240,2.7,3,1,0,0,3,7,-4,3.4,6.2,-2.8,19,CL
44781702,9,570,6.3,6,6,3,3,10,9,1,10.2,7.2,3.1,19,CL
44ac04e9,5,450,5.0,5,5,0,0,5,6,-1,6.7,6.6,0.1,19,CL
44eb9093,4,360,4.0,4,4,0,2,3,5,-2,6.4,5.4,1.1,19,CL
4515f00d,4,66,0.7,0,0,4,4,1,1,0,1.5,0.6,0.9,19,CL
45af8a54,7,306,3.4,2,2,5,1,3,8,-5,7.4,4.0,3.4,19,CL
4601e194,11,990,11.0,11,11,0,1,25,9,16,21.8,12.0,9.8,19,CL
46a8347f,2,98,1.1,1,1,1,1,1,1,0,1.3,1.7,-0.4,19,CL
47064058,6,540,6.0,6,6,0,0,11,14,-3,11.1,12.3,-1.2,19,CL
47af88b8,8,720,8.0,8,8,0,0,13,16,-3,12.3,17.2,-5.0,19,CL
47fd5136,4,360,4.0,4,4,0,1,4,13,-9,3.6,10.6,-6.9,19,CL
481c9ece,6,540,6.0,6,6,0,0,6,13,-7,7.1,13.9,-6.8,19,CL
4887118d,1,33,0.4,0,0,1,2,0,0,0,0.2,0.0,0.2,19,CL
48a2b92a,2,34,0.4,0,0,2,9,0,0,0,1.0,1.0,0.0,19,CL
48b28bfd,3,176,2.0,2,1,1,0,1,5,-4,1.2,4.7,-3.6,19,CL
48b3dd60,9,562,6.2,7,1,2,1,12,5,7,11.4,6.5,4.9,19,CL
49296448,7,630,7.0,7,7,0,0,15,5,10,14.4,8.2,6.2,19,CL
493924a7,5,450,5.0,5,5,0,0,4,9,-5,6.3,8.2,-1.9,19,CL
4958bfb2,6,419,4.7,5,4,1,0,8,6,2,10.5,7.6,2.8,19,CL
497228f9,6,540,6.0,6,6,0,0,2,13,-11,4.7,11.9,-7.2,19,CL
4a5a45c7,6,391,4.3,4,0,2,0,11,5,6,8.7,5.8,3.0,19,CL
4a6914ff,3,270,3.0,3,3,0,3,2,5,-3,2.7,3.6,-0.9,19,CL
4b6960d2,5,441,4.9,5,4,0,0,5,6,-1,9.1,7.9,1.2,19,CL
4b803b3c,4,251,2.8,3,2,1,2,4,2,2,4.9,4.5,0.4,19,CL
4bd414c1,6,495,5.5,6,5,0,0,6,4,2,10.5,5.8,4.6,19,CL
4c370d81,11,700,7.8,8,2,3,1,15,7,8,18.6,7.7,10.9,19,CL
4c3a6744,5,319,3.5,3,2,2,0,8,5,3,8.5,5.0,3.5,19,CL
4c45cdc2,3,171,1.9,2,0,1,0,2,2,0,1.3,3.4,-2.1,19,CL
4c5b714f,4,333,3.7,4,3,0,0,2,10,-8,3.0,6.3,-3.3,19,CL
4c6facae,6,507,5.6,6,4,0,0,4,11,-7,5.7,10.6,-4.9,19,CL
4cc82fe1,6,540,6.0,6,6,0,0,7,16,-9,7.8,12.3,-4.5,19,CL
4d034881,7,507,5.6,6,2,1,2,14,8,6,11.2,6.1,5.0,19,CL
4d224fe8,6,503,5.6,6,4,0,0,13,7,6,12.7,7.7,5.0,19,CL
4d3e9033,1,57,0.6,0,0,1,7,1,3,-2,0.5,2.4,-1.8,19,CL
4d982baf,4,273,3.0,3,1,1,0,4,8,-4,4.5,7.4,-2.8,19,CL
4dbd0916,7,409,4.5,5,2,2,0,7,7,0,4.5,4.4,0.1,19,CL
4dbdf7f7,5,268,3.0,2,2,3,1,3,5,-2,1.5,8.6,-7.1,19,CL
4dedd469,5,450,5.0,5,5,0,0,5,13,-8,2.4,14.4,-12.0,19,CL
4e133a88,4,330,3.7,4,2,0,0,4,5,-1,6.7,6.1,0.7,19,CL
4e204552,5,152,1.7,1,0,4,1,4,1,3,4.1,1.2,2.9,19,CL
4e358a2d,6,540,6.0,6,6,0,1,12,7,5,11.9,7.8,4.0,19,CL
4f1e6a0b,11,848,9.4,10,5,1,0,18,9,9,17.3,11.7,5.6,19,CL
4f28a6ff,12,1001,11.1,11,11,1,0,23,10,13,22.0,13.9,8.1,19,CL
4fa7cb9b,5,160,1.8,1,1,4,0,1,2,-1,2.6,2.3,0.3,19,CL
5042e5c2,5,99,1.1,1,0,4,7,4,1,3,3.5,0.6,2.9,19,CL
5064d4c1,4,206,2.3,3,0,1,0,3,2,1,1.9,1.6,0.3,19,CL
509a4ccb,4,76,0.8,0,0,4,2,3,1,2,2.3,0.4,1.9,19,CL
50c1ff86,4,302,3.4,3,3,1,2,2,11,-9,1.7,11.0,-9.3,19,CL
50ccf47d,6,519,5.8,6,5,0,0,2,11,-9,4.7,11.4,-6.7,19,CL
50dc94ce,12,981,10.9,11,6,1,0,18,10,8,19.0,15.7,3.3,19,CL
5148dcc5,3,158,1.8,2,0,1,2,3,2,1,1.8,4.2,-2.4,19,CL
51a3c4c8,10,930,10.3,10,10,0,0,20,15,5,16.9,19.4,-2.5,19,CL
51a56075,1,90,1.0,1,1,0,5,2,2,0,1.5,1.7,-0.2,19,CL
51cf8561,5,337,3.7,4,3,1,1,18,3,15,11.1,4.0,7.1,19,CL
51dbeea9,7,488,5.4,5,3,2,1,13,6,7,10.4,6.1,4.3,19,CL
526541e5,3,235,2.6,3,2,0,1,4,4,0,2.4,5.0,-2.6,19,CL
5271c8f1,2,173,1.9,2,1,0,0,7,3,4,4.6,1.8,2.9,19,CL
527f063d,7,413,4.6,5,2,2,0,14,6,8,11.2,5.0,6.2,19,CL
529f49ab,6,415,4.6,6,2,0,1,5,2,3,4.7,3.2,1.4,19,CL
52ec54d0,10,900,10.0,10,10,0,0,14,9,5,18.9,10.1,8.8,19,CL
532d2690,4,304,3.4,4,2,0,0,6,5,1,4.9,5.8,-0.9,19,CL
53e07d0b,5,269,3.0,4,0,1,0,8,6,2,5.9,5.1,0.8,19,CL
549c6ba7,1,90,1.0,1,1,0,2,1,3,-2,0.9,1.6,-0.7,19,CL
54b4dc4e,5,369,4.1,4,2,1,0,7,11,-4,7.2,7.9,-0.7,19,CL
54e4866f,1,6,0.1,0,0,1,4,0,1,-1,0.0,0.5,-0.5,19,CL
54f2d108,5,105,1.2,0,0,5,1,1,0,1,1.3,2.0,-0.7,19,CL
55126f3b,7,561,6.2,7,5,0,0,7,9,-2,5.8,7.0,-1.2,19,CL
555d5edd,1,28,0.3,0,0,1,0,0,0,0,0.2,0.7,-0.5,19,CL
55abe554,4,209,2.3,2,1,2,0,3,2,1,2.8,3.7,-0.9,19,CL
5631b735,5,432,4.8,5,4,0,0,4,13,-9,2.4,15.9,-13.5,19,CL
56b5d64e,9,620,6.9,7,1,2,1,12,6,6,10.3,9.5,0.8,19,CL
56f7a928,6,540,6.0,6,6,0,0,2,14,-12,5.1,11.0,-5.9,19,CL
580d52dd,6,540,6.0,6,6,0,0,4,12,-8,6.6,9.2,-2.5,19,CL
5832ebfe,6,540,6.0,6,6,0,0,6,5,1,5.4,6.3,-0.9,19,CL
58a160e1,1,14,0.2,0,0,1,4,1,0,1,0.6,0.2,0.5,19,CL
58a9a4d9,5,349,3.9,4,1,1,5,9,5,4,5.9,6.3,-0.3,19,CL
58ce23e5,4,95,1.1,1,0,3,1,0,5,-5,0.4,1.7,-1.2,19,CL
58eee997,1,4,0.0,0,0,1,1,1,0,1,0.8,0.0,0.8,19,CL
591477c9,3,270,3.0,3,3,0,1,0,7,-7,1.1,6.7,-5.6,19,CL
5939baa2,5,430,4.8,5,4,0,0,3,9,-6,6.0,6.9,-0.9,19,CL
5a2cb25d,2,180,2.0,2,2,0,1,0,0,0,0.9,1.6,-0.8,19,CL
5ab0ea87,12,1033,11.5,11,9,1,0,25,10,15,22.1,13.7,8.4,19,CL
5afafbfe,1,29,0.3,0,0,1,0,1,0,1,0.6,0.1,0.4,19,CL
5b54bf3b,5,313,3.5,4,2,1,0,2,10,-8,3.0,5.7,-2.7,19,CL
5c2b4f07,5,434,4.8,5,4,0,2,6,3,3,7.6,4.1,3.6,19,CL
5c4dc0ff,5,78,0.9,0,0,5,0,2,0,2,2.7,0.8,1.9,19,CL
5cb1d026,6,518,5.8,6,5,0,0,4,11,-7,6.5,7.8,-1.3,19,CL
5cdddffa,8,635,7.1,7,4,1,0,12,14,-2,10.7,15.6,-4.9,19,CL
5d0d1ec7,5,405,4.5,5,4,0,0,2,10,-8,5.0,8.6,-3.6,19,CL
5d4f7d61,6,254,2.8,2,2,4,1,2,6,-4,4.5,5.5,-1.1,19,CL
5d5219b1,5,381,4.2,4,4,1,1,2,8,-6,5.2,6.6,-1.5,19,CL
5dfc6ad5,7,629,7.0,7,6,0,0,8,6,2,9.6,6.2,3.5,19,CL
5e1028e5,6,310,3.4,3,3,3,0,3,9,-6,3.9,6.4,-2.5,19,CL
5e861944,6,449,5.0,5,0,1,0,3,5,-2,6.5,6.7,-0.2,19,CL
5e8936be,6,540,6.0,6,6,0,0,5,17,-12,2.9,19.4,-16.6,19,CL
5eae500a,9,547,6.1,6,4,3,0,7,5,2,6.9,7.7,-0.7,19,CL
5eecec3d,6,421,4.7,5,3,1,3,14,5,9,9.4,5.2,4.2,19,CL
5f424f35,4,242,2.7,4,1,0,0,3,3,0,2.9,4.8,-1.9,19,CL
6025fab1,6,466,5.2,5,3,1,2,9,6,3,12.7,8.9,3.8,19,CL
603116a7,4,343,3.8,4,3,0,2,7,4,3,8.8,5.1,3.8,19,CL
60359288,2,122,1.4,1,1,1,1,1,3,-2,1.6,1.1,0.5,19,CL
603cb947,6,481,5.3,5,4,1,0,10,13,-3,10.6,10.6,0.0,19,CL
615c4d8f,5,342,3.8,4,1,1,0,1,8,-7,3.9,7.0,-3.1,19,CL
6190474d,1,10,0.1,0,0,1,1,0,0,0,0.0,0.0,0.0,19,CL
61b0b44d,3,22,0.2,0,0,3,3,0,0,0,0.2,0.0,0.2,19,CL
61f63784,6,452,5.0,5,5,1,0,5,15,-10,6.3,11.4,-5.1,19,CL
6228469d,5,424,4.7,5,4,0,0,4,14,-10,6.2,10.0,-3.8,19,CL
63d17038,1,90,1.0,1,1,0,11,2,1,1,3.5,0.6,2.8,19,CL
6421ec64,4,176,2.0,2,0,2,8,8,0,8,5.0,2.1,2.9,19,CL
6434f10d,8,607,6.7,6,6,2,0,9,7,2,6.9,8.3,-1.5,19,CL
66116290,5,339,3.8,4,2,1,0,1,9,-8,4.0,8.0,-4.0,19,CL
6622454d,11,983,10.9,11,9,0,0,20,13,7,20.1,17.4,2.7,19,CL
6639e500,4,191,2.1,2,1,2,3,3,3,0,3.2,2.9,0.3,19,CL
67b3d74b,6,540,6.0,6,6,0,0,6,11,-5,6.2,10.7,-4.5,19,CL
67cdbc0e,11,363,4.0,3,2,8,1,12,5,7,9.2,7.2,2.0,19,CL
6822ea0c,1,89,1.0,1,0,0,1,3,2,1,2.1,1.3,0.8,19,CL
6853490f,3,42,0.5,0,0,3,6,2,2,0,1.4,1.7,-0.2,19,CL
691bef82,12,1080,12.0,12,12,0,0,22,13,9,22.3,17.8,4.5,19,CL
691f64f5,3,138,1.5,1,0,2,1,2,3,-1,5.0,2.9,2.1,19,CL
69384e5d,6,531,5.9,6,5,0,0,17,9,8,12.4,8.0,4.4,19,CL
6938d79b,5,313,3.5,3,3,2,0,2,11,-9,1.0,13.1,-12.1,19,CL
6941883f,2,100,1.1,1,0,1,3,0,1,-1,0.2,2.3,-2.1,19,CL
69960ac3,4,293,3.3,3,3,1,2,0,7,-7,1.9,6.2,-4.3,19,CL
6a189491,1,90,1.0,1,1,0,3,0,4,-4,1.1,1.9,-0.7,19,CL
6a829019,5,405,4.5,4,4,1,0,4,7,-3,4.8,8.2,-3.3,19,CL
6bd05d38,1,90,1.0,1,1,0,3,0,3,-3,0.5,2.3,-1.8,19,CL
6c7762c3,2,101,1.1,1,1,1,4,3,0,3,1.8,0.3,1.5,19,CL
6c811eb7,3,92,1.0,1,1,2,6,1,1,0,1.8,2.5,-0.7,19,CL
6cafd68d,3,185,2.1,2,1,1,0,5,4,1,3.9,2.8,1.2,19,CL
6ce1f46f,8,645,7.2,7,6,1,0,15,8,7,15.8,9.9,5.9,19,CL
6ceef869,3,270,3.0,3,3,0,1,3,7,-4,3.1,4.5,-1.5,19,CL
6e5497ca,1,66,0.7,1,0,0,0,0,0,0,0.3,0.8,-0.5,19,CL
6e592fa4,8,634,7.0,7,6,1,2,16,8,8,11.9,13.0,-1.1,19,CL
6ec6fde0,2,180,2.0,2,2,0,2,4,5,-1,4.7,3.8,0.9,19,CL
6f51e382,11,990,11.0,11,11,0,1,25,9,16,21.8,12.0,9.8,19,CL
6f639ec7,4,295,3.3,3,2,1,0,5,8,-3,4.0,4.9,-1.0,19,CL
6fdac234,3,270,3.0,3,3,0,2,4,4,0,3.2,6.0,-2.8,19,CL
6fe90922,6,499,5.5,6,4,0,0,4,6,-2,7.6,7.1,0.5,19,CL
70cf63ca,6,368,4.1,4,1,2,0,4,8,-4,3.5,7.5,-4.1,19,CL
70d74ece,8,582,6.5,8,2,0,0,12,8,4,14.2,9.0,5.2,19,CL
70d8e84c,1,9,0.1,0,0,1,3,0,0,0,0.0,0.1,-0.1,19,CL
7111d552,4,233,2.6,3,1,1,3,2,6,-4,3.1,4.1,-1.1,19,CL
715bf047,5,333,3.7,4,0,1,1,4,2,2,4.2,3.8,0.4,19,CL
716e7308,1,12,0.1,0,0,1,0,1,0,1,0.6,0.5,0.0,19,CL
71ec39ef,7,484,5.4,5,5,2,1,9,13,-4,8.8,14.0,-5.2,19,CL
7230b807,1,90,1.0,1,1,0,0,3,0,3,1.8,0.9,0.9,19,CL
7272a72a,5,436,4.8,5,4,0,0,8,11,-3,5.6,10.4,-4.7,19,CL
73000a79,2,95,1.1,0,0,2,4,2,2,0,2.6,2.1,0.4,19,CL
731e29b8,2,90,1.0,1,0,1,0,2,3,-1,1.5,1.9,-0.5,19,CL
732b0cf9,2,28,0.3,0,0,2,4,1,1,0,1.1,0.5,0.6,19,CL
733e7ad8,5,270,3.0,3,2,2,1,5,3,2,2.7,3.3,-0.6,19,CL
73d6a176,1,16,0.2,0,0,1,1,0,0,0,0.1,0.1,0.1,19,CL
74419746,6,540,6.0,6,6,0,0,6,7,-1,8.6,7.8,0.8,19,CL
7460ca0d,5,450,5.0,5,5,0,0,3,5,-2,5.1,10.1,-5.1,19,CL
746fec7d,2,72,0.8,1,0,1,3,1,1,0,0.7,0.5,0.2,19,CL
74bafc9c,4,227,2.5,2,0,2,0,3,5,-2,4.2,5.0,-0.7,19,CL
77d7c96f,3,197,2.2,2,2,1,3,5,5,0,3.3,5.4,-2.1,19,CL
77e84962,5,389,4.3,4,4,1,0,6,6,0,6.1,6.3,-0.2,19,CL
78841da9,6,514,5.7,6,3,0,0,7,4,3,10.7,6.3,4.3,19,CL
79019bf4,6,540,6.0,6,6,0,0,8,9,-1,6.9,11.6,-4.8,19,CL
79083382,3,213,2.4,2,2,1,4,6,3,3,5.1,4.5,0.5,19,CL
791abba1,6,540,6.0,6,6,0,2,6,11,-5,7.5,9.6,-2.1,19,CL
79370f8c,2,180,2.0,2,2,0,0,4,2,2,3.1,3.3,-0.2,19,CL
79c90e45,6,540,6.0,6,6,0,0,11,14,-3,11.1,12.3,-1.2,19,CL
7a11550b,9,527,5.9,5,5,4,1,10,9,1,13.9,7.6,6.3,19,CL
7a20d90a,2,166,1.8,2,1,0,6,2,4,-2,2.3,4.9,-2.6,19,CL
7a2e46a8,13,1170,13.0,13,13,0,0,24,12,12,28.3,13.9,14.4,19,CL
7aac47fe,3,252,2.8,3,2,0,1,6,8,-2,5.7,6.0,-0.4,19,CL
7b18b6db,3,270,3.0,3,3,0,2,4,8,-4,2.3,6.2,-3.9,19,CL
7b4c1f6e,2,28,0.3,0,0,2,2,0,1,-1,0.1,0.9,-0.8,19,CL
7b9ecf02,1,1,0.0,0,0,1,0,0,0,0,0.0,0.2,-0.2,19,CL
7ba6d84e,9,810,9.0,9,9,0,0,9,9,0,8.7,12.2,-3.6,19,CL
7bcc0708,2,54,0.6,0,0,2,3,0,1,-1,0.1,0.9,-0.7,19,CL
7c0000fd,3,108,1.2,1,1,2,2,3,2,1,3.5,0.8,2.7,19,CL
7c1a0c67,6,461,5.1,6,5,0,0,7,8,-1,5.8,9.7,-3.9,19,CL
7c9fa389,1,26,0.3,0,0,1,0,0,1,-1,0.1,0.9,-0.8,19,CL
7cab69b5,5,450,5.0,5,5,0,1,2,12,-10,4.5,8.4,-3.9,19,CL
7d9397f8,2,50,0.6,0,0,2,0,0,1,-1,1.0,0.6,0.3,19,CL
7ec7738e,6,389,4.3,5,1,1,0,3,10,-7,3.7,10.2,-6.5,19,CL
7f3b388c,11,730,8.1,7,7,4,2,19,6,13,20.6,9.5,11.1,19,CL
7f609bfc,2,180,2.0,2,2,0,1,3,4,-1,2.4,2.8,-0.4,19,CL
7f97771d,6,518,5.8,6,4,0,2,8,3,5,9.2,5.2,4.0,19,CL
7fb301af,1,13,0.1,0,0,1,0,0,1,-1,0.0,0.5,-0.5,19,CL
807e869a,6,391,4.3,4,3,2,0,4,9,-5,5.1,7.9,-2.8,19,CL
80f36c88,4,239,2.7,3,1,1,3,3,1,2,4.3,2.3,2.0,19,CL
8104e41e,2,6,0.1,1,0,1,0,0,0,0,0.5,0.0,0.5,19,CL
810e3c74,6,294,3.3,4,0,2,0,1,4,-3,2.7,3.5,-0.7,19,CL
816192f0,1,90,1.0,1,1,0,2,1,2,-1,0.6,2.2,-1.7,19,CL
819b3158,8,589,6.5,7,5,1,0,19,10,9,15.2,5.8,9.4,19,CL
824bd41a,5,450,5.0,5,5,0,0,5,12,-7,5.9,12.0,-6.1,19,CL
82b1198a,6,540,6.0,6,6,0,0,7,5,2,10.9,6.5,4.4,19,CL
82dbf623,9,241,2.7,1,1,8,4,8,4,4,7.1,5.2,2.0,19,CL
8387afe6,3,270,3.0,3,3,0,2,1,8,-7,2.3,4.3,-1.9,19,CL
8454388c,4,223,2.5,3,1,1,2,3,6,-3,4.2,5.0,-0.8,19,CL
85613cf0,4,188,2.1,2,1,2,2,0,1,-1,3.1,2.6,0.5,19,CL
85686f86,2,13,0.1,0,0,2,1,1,0,1,0.8,0.1,0.6,19,CL
862fa9fb,3,225,2.5,3,2,0,3,6,4,2,3.1,4.1,-1.0,19,CL
8637e09a,1,59,0.7,1,0,0,0,0,0,0,1.4,0.3,1.1,19,CL
8652a85c,5,111,1.2,1,0,4,1,0,2,-2,1.2,1.3,-0.1,19,CL
867239d3,9,728,8.1,8,6,1,0,7,10,-3,7.3,11.8,-4.5,19,CL
8696bc90,2,65,0.7,1,0,1,3,1,0,1,1.2,1.2,-0.1,19,CL
86dd16a8,2,180,2.0,2,2,0,0,2,1,1,2.2,3.4,-1.2,19,CL
86dd77d1,10,746,8.3,8,7,2,0,23,11,12,18.5,8.4,10.1,19,CL
86e7deaf,7,615,6.8,7,6,0,0,17,10,7,15.1,8.8,6.3,19,CL
873ce3a2,5,105,1.2,1,1,4,3,2,3,-1,1.1,3.2,-2.1,19,CL
874d7a32,5,435,4.8,5,4,0,0,5,10,-5,4.4,9.8,-5.4,19,CL
87575fd9,5,304,3.4,3,3,2,0,4,2,2,4.7,3.5,1.3,19,CL
8778c910,8,720,8.0,8,8,0,0,16,8,8,14.7,9.3,5.4,19,CL
8794e251,5,284,3.2,3,3,2,1,11,6,5,7.7,4.3,3.4,19,CL
881ef58c,1,58,0.6,1,0,0,1,0,0,0,1.0,0.4,0.7,19,CL
88a359d4,4,121,1.3,1,0,3,4,5,5,0,2.9,5.3,-2.4,19,CL
88a9ea33,6,433,4.8,5,2,1,0,2,13,-11,4.4,10.9,-6.5,19,CL
88c89891,4,258,2.9,3,2,1,4,6,3,3,5.9,3.5,2.4,19,CL
88e357ef,7,445,4.9,5,1,2,0,6,4,2,8.1,5.7,2.3,19,CL
892d5bb1,6,389,4.3,4,3,2,4,12,3,9,8.9,4.8,4.1,19,CL
89565ac5,3,194,2.2,2,2,1,1,3,2,1,3.6,2.0,1.6,19,CL
89ac64a6,5,450,5.0,5,5,0,1,4,3,1,7.4,3.8,3.5,19,CL
89b2c8a9,6,374,4.2,4,1,2,0,7,4,3,8.5,3.7,4.8,19,CL
89d10e53,8,527,5.9,6,3,2,3,7,11,-4,8.5,9.9,-1.4,19,CL
89f951b5,12,1018,11.3,12,9,0,0,25,9,16,22.3,12.3,10.0,19,CL
8a7a5ad7,3,136,1.5,1,1,2,3,2,3,-1,1.3,2.1,-0.7,19,CL
8aafd64f,1,76,0.8,1,0,0,1,0,0,0,1.2,0.2,0.9,19,CL
8b788c01,8,507,5.6,6,4,2,0,6,5,1,5.1,7.5,-2.4,19,CL
8d3d3b0a,3,51,0.6,0,0,3,3,1,2,-1,1.5,0.2,1.3,19,CL
8d78e732,8,712,7.9,8,6,0,0,16,8,8,14.5,9.3,5.3,19,CL
8e088e04,1,50,0.6,1,0,0,3,2,0,2,0.7,0.6,0.1,19,CL
8e34b9f5,4,360,4.0,4,4,0,0,3,5,-2,5.3,5.7,-0.3,19,CL
8f62b6ee,11,978,10.9,11,10,0,0,17,15,2,16.2,13.8,2.4,19,CL
8f696594,8,615,6.8,7,3,1,0,13,9,4,11.4,12.0,-0.7,19,CL
8fd9996f,10,930,10.3,10,10,0,0,20,15,5,16.9,19.4,-2.5,19,CL
90d7dda6,4,301,3.3,4,2,0,0,2,9,-7,4.6,5.9,-1.4,19,CL
9139bb12,3,265,2.9,3,1,0,0,5,5,0,3.2,5.9,-2.7,19,CL
92e7e919,12,900,10.0,11,4,1,0,17,14,3,16.8,11.4,5.4,19,CL
935e6b8f,11,801,8.9,8,7,3,0,15,8,7,18.2,11.1,7.1,19,CL
93a50d2c,2,140,1.6,2,1,0,1,1,4,-3,2.3,4.4,-2.2,19,CL
947e036f,4,99,1.1,1,0,3,2,4,2,2,2.1,4.1,-2.0,19,CL
94b2001f,2,120,1.3,1,1,1,3,10,0,10,4.9,0.2,4.6,19,CL
95a24690,2,50,0.6,0,0,2,0,1,2,-1,0.6,0.7,-0.1,19,CL
96094cbc,6,319,3.5,5,0,1,0,2,6,-4,3.2,5.8,-2.6,19,CL
960acc0a,5,423,4.7,5,3,0,0,4,7,-3,7.4,7.5,-0.2,19,CL
96b03fe2,5,353,3.9,4,3,1,1,4,7,-3,4.7,7.5,-2.8,19,CL
980522ec,12,1003,11.1,11,10,1,0,18,15,3,19.5,13.8,5.7,19,CL
984a5a64,1,60,0.7,1,0,0,7,0,1,-1,1.2,1.1,0.1,19,CL
9907b1c8,7,385,4.3,4,1,3,1,5,9,-4,5.8,10.1,-4.3,19,CL
99813635,3,105,1.2,1,0,2,2,1,2,-1,4.2,0.8,3.4,19,CL
99de6b6f,1,90,1.0,1,1,0,0,1,2,-1,1.4,3.4,-2.0,19,CL
9a1f2e1c,3,238,2.6,3,1,0,1,5,4,1,5.2,3.7,1.5,19,CL
9ae9eaea,3,270,3.0,3,3,0,4,4,8,-4,4.3,6.4,-2.1,19,CL
9bcd6455,2,112,1.2,2,0,0,2,2,4,-2,1.2,2.1,-1.0,19,CL
9c94165b,8,720,8.0,8,8,0,0,9,6,3,8.3,10.8,-2.5,19,CL
9d12e142,7,630,7.0,7,7,0,1,8,6,2,9.6,6.2,3.5,19,CL
9d60028d,6,367,4.1,4,1,2,0,4,11,-7,4.3,9.4,-5.1,19,CL
9e1035f8,3,106,1.2,1,0,2,1,1,2,-1,1.1,2.7,-1.6,19,CL
9efa1d25,6,437,4.9,5,4,1,1,6,5,1,6.7,4.8,1.9,19,CL
9f84febe,2,76,0.8,1,0,1,1,1,2,-1,1.1,2.8,-1.7,19,CL
9f8e9423,4,360,4.0,4,4,0,2,6,5,1,9.8,5.7,4.2,19,CL
a022e78c,5,414,4.6,5,2,0,0,5,12,-7,2.3,13.3,-11.0,19,CL
a0b4bb3e,4,251,2.8,3,2,1,0,4,3,1,6.3,3.0,3.3,19,CL
a1232f4e,4,305,3.4,4,3,0,4,3,5,-2,4.4,5.6,-1.2,19,CL
a190d597,4,305,3.4,4,2,0,0,4,6,-2,3.5,3.3,0.2,19,CL
a1c5b23e,1,90,1.0,1,1,0,2,3,0,3,1.7,0.4,1.3,19,CL
a1d5bd30,10,722,8.0,8,4,2,0,10,8,2,9.2,10.8,-1.5,19,CL
a29b1131,5,400,4.4,5,1,0,0,3,8,-5,5.3,10.1,-4.8,19,CL
a2abe631,6,540,6.0,6,6,0,0,5,8,-3,9.9,9.6,0.2,19,CL
a33a0dc0,5,348,3.9,4,2,1,0,5,9,-4,5.8,8.3,-2.4,19,CL
a382462b,4,115,1.3,1,0,3,1,1,6,-5,0.7,4.1,-3.4,19,CL
a3b0ed18,6,540,6.0,6,6,0,0,4,12,-8,6.6,9.2,-2.5,19,CL
a3ddb1b9,5,392,4.4,5,1,0,0,6,2,4,6.7,4.7,2.0,19,CL
a40d5a0c,2,149,1.7,1,1,1,0,1,4,-3,2.2,5.1,-2.9,19,CL
a45eac1f,6,428,4.8,4,4,2,0,4,7,-3,5.0,8.5,-3.5,19,CL
a4effc55,4,346,3.8,4,3,0,3,7,1,6,6.7,2.3,4.4,19,CL
a5296e55,6,185,2.1,1,0,5,0,2,2,0,4.8,3.0,1.8,19,CL
a5549ec1,1,22,0.2,0,0,1,0,0,0,0,0.5,0.0,0.4,19,CL
a58bb1e1,7,486,5.4,5,1,2,0,13,3,10,11.2,6.9,4.3,19,CL
a5db0bec,7,630,7.0,7,7,0,1,12,11,1,11.6,13.0,-1.3,19,CL
a6154613,10,899,10.0,10,9,0,0,23,8,15,18.9,9.0,9.8,19,CL
a65ce836,6,338,3.8,2,2,4,0,8,5,3,7.9,5.4,2.5,19,CL
a6951bf8,4,278,3.1,3,2,1,1,3,2,1,2.5,3.8,-1.2,19,CL
a69e4806,6,539,6.0,6,5,0,0,6,13,-7,7.1,13.9,-6.8,19,CL
a7a9d95a,5,356,4.0,4,3,1,0,4,2,2,6.8,2.8,4.0,19,CL
a8327abd,6,486,5.4,6,2,0,0,2,10,-8,4.6,10.8,-6.2,19,CL
a8542814,9,832,9.2,9,7,0,0,19,12,7,15.3,16.3,-1.0,19,CL
a8741470,1,90,1.0,1,1,0,5,0,1,-1,0.6,1.0,-0.4,19,CL
a9aa0d1d,6,513,5.7,6,3,0,0,4,10,-6,6.2,8.1,-1.9,19,CL
a9dc785c,5,450,5.0,5,5,0,1,4,5,-1,5.5,9.3,-3.9,19,CL
aa8e289e,6,540,6.0,6,6,0,0,8,9,-1,6.9,11.6,-4.8,19,CL
aae44006,2,49,0.5,0,0,2,0,0,0,0,0.4,1.0,-0.6,19,CL
ab6928f2,3,214,2.4,2,1,1,1,5,1,4,3.7,4.2,-0.6,19,CL
abb3bb95,6,530,5.9,6,5,0,0,6,12,-6,6.7,13.5,-6.8,19,CL
abe66106,9,335,3.7,3,0,6,1,7,4,3,5.2,4.2,0.9,19,CL
ac1f056e,3,221,2.5,3,1,0,1,0,3,-3,2.8,4.7,-1.9,19,CL
ac3fb1be,3,220,2.4,2,2,1,0,3,2,1,3.0,3.1,-0.1,19,CL
ac861941,6,271,3.0,2,2,4,3,4,6,-2,3.8,3.4,0.5,19,CL
ad10eae0,6,495,5.5,6,5,0,0,5,16,-11,6.8,11.7,-4.9,19,CL
ad6df2d5,10,809,9.0,10,6,0,0,13,6,7,17.4,7.9,9.5,19,CL
adfc9123,11,990,11.0,11,11,0,1,25,9,16,21.8,12.0,9.8,19,CL
ae4e2852,4,306,3.4,4,1,0,2,2,5,-3,4.9,4.4,0.5,19,CL
aeed5c06,1,8,0.1,0,0,1,5,1,0,1,0.0,0.2,-0.1,19,CL
aef6e670,8,648,7.2,7,7,1,0,19,11,8,16.0,8.5,7.5,19,CL
afa0d4e0,8,576,6.4,7,4,1,0,10,5,5,13.3,6.5,6.7,19,CL
afb0c500,2,180,2.0,2,2,0,6,2,0,2,3.7,1.3,2.4,19,CL
b05e2dbd,5,450,5.0,5,5,0,0,4,5,-1,5.5,9.3,-3.9,19,CL
b1062a37,3,225,2.5,3,2,0,1,2,4,-2,1.0,6.3,-5.2,19,CL
b19db005,8,414,4.6,5,0,3,3,9,0,9,8.8,5.8,2.9,19,CL
b1f4086c,6,540,6.0,6,6,0,0,6,11,-5,6.2,10.7,-4.5,19,CL
b20f5a66,5,450,5.0,5,5,0,1,2,10,-8,4.3,10.2,-5.9,19,CL
b217ef29,8,720,8.0,8,8,0,3,14,7,7,17.2,8.3,8.9,19,CL
b233e8e4,1,90,1.0,1,1,0,2,0,2,-2,2.0,3.7,-1.7,19,CL
b2db927b,1,70,0.8,1,0,0,2,0,3,-3,0.3,1.9,-1.6,19,CL
b3325a30,7,503,5.6,5,4,2,1,5,11,-6,8.1,9.1,-1.0,19,CL
b400bde0,10,869,9.7,10,8,0,0,29,12,17,22.3,10.0,12.3,19,CL
b4825073,5,118,1.3,1,0,4,1,0,3,-3,0.6,3.0,-2.4,19,CL
b65c42cf,3,116,1.3,1,0,2,2,0,4,-4,0.9,3.3,-2.4,19,CL
b66315ae,6,375,4.2,4,2,2,2,14,4,10,11.3,3.6,7.6,19,CL
b6964eb6,8,720,8.0,8,8,0,0,9,7,2,8.3,9.7,-1.5,19,CL
b6a6e0a7,3,103,1.1,1,0,2,1,3,3,0,2.4,1.3,1.1,19,CL
b6b2b820,2,10,0.1,0,0,2,2,0,1,-1,0.1,0.1,0.0,19,CL
b74277a0,11,825,9.2,10,7,1,0,18,11,7,16.9,15.3,1.6,19,CL
b7ca5c51,5,450,5.0,5,5,0,0,4,5,-1,5.5,9.3,-3.9,19,CL
b7e7937d,5,404,4.5,5,4,0,0,1,10,-9,4.0,6.6,-2.6,19,CL
b853e0ad,6,458,5.1,6,3,0,4,6,7,-1,6.2,5.7,0.5,19,CL
ba23a904,10,848,9.4,10,9,0,0,14,12,2,13.9,12.9,1.0,19,CL
bafcf742,5,418,4.6,5,4,0,0,4,14,-10,2.0,16.3,-14.3,19,CL
bd4f5f94,4,360,4.0,4,4,0,1,1,8,-7,3.2,8.2,-5.0,19,CL
bd6351cd,7,480,5.3,5,4,2,2,8,2,6,10.3,5.0,5.2,19,CL
be927d03,7,581,6.5,6,5,1,1,5,10,-5,4.8,10.3,-5.5,19,CL
beb391dd,5,216,2.4,2,0,3,0,4,6,-2,3.3,3.9,-0.6,19,CL
bece776f,6,502,5.6,6,2,0,0,10,12,-2,9.7,9.8,-0.1,19,CL
beda9675,1,19,0.2,0,0,1,2,1,0,1,1.3,0.1,1.2,19,CL
bef09ca8,1,10,0.1,0,0,1,3,0,0,0,0.0,0.1,-0.1,19,CL
bfae110f,6,520,5.8,6,4,0,0,5,5,0,5.2,6.3,-1.1,19,CL
c0617e2b,3,186,2.1,2,2,1,3,6,1,5,3.8,1.0,2.9,19,CL
c0c7ff58,6,468,5.2,6,3,0,0,6,5,1,8.4,3.9,4.5,19,CL
c0cddebe,9,682,7.6,8,5,1,1,12,7,5,13.7,8.4,5.3,19,CL
c14bc029,8,631,7.0,7,6,1,0,9,6,3,7.2,7.2,-0.1,19,CL
c17bfb65,5,391,4.3,4,4,1,0,7,9,-2,7.6,9.1,-1.5,19,CL
c2111b45,1,90,1.0,1,1,0,3,0,3,-3,1.3,0.9,0.4,19,CL
c24544c7,6,539,6.0,6,5,0,0,6,5,1,5.4,6.3,-0.9,19,CL
c2e41cfb,6,540,6.0,6,6,0,0,2,13,-11,4.7,11.9,-7.2,19,CL
c3a8bcd8,11,881,9.8,11,6,0,1,18,8,10,16.3,11.6,4.7,19,CL
c3ee18ef,5,450,5.0,5,5,0,0,9,6,3,5.8,5.2,0.6,19,CL
c43e5e7e,6,504,5.6,6,4,0,0,8,13,-5,6.6,12.0,-5.4,19,CL
c46fa34c,3,247,2.7,3,2,0,3,1,6,-5,2.4,5.7,-3.3,19,CL
c47541e0,8,320,3.6,4,0,4,0,4,9,-5,4.0,8.0,-4.0,19,CL
c4987edc,1,90,1.0,1,1,0,3,3,2,1,1.7,3.9,-2.2,19,CL
c5adc293,1,21,0.2,0,0,1,0,0,0,0,1.0,2.2,-1.2,19,CL
c5bdb6e3,5,117,1.3,0,0,5,1,3,2,1,3.7,4.9,-1.3,19,CL
c5fd13e9,3,270,3.0,3,3,0,1,2,5,-3,3.5,3.9,-0.3,19,CL
c6056d58,5,435,4.8,5,4,0,0,2,11,-9,3.7,9.9,-6.2,19,CL
c67cd65c,3,150,1.7,2,1,1,2,2,3,-1,2.0,5.5,-3.5,19,CL
c691bfe2,13,1148,12.8,13,9,0,0,24,11,13,28.2,13.1,15.1,19,CL
c707411f,7,660,7.3,7,7,0,0,9,12,-3,11.9,13.7,-1.8,19,CL
c7526c18,8,608,6.8,7,4,1,0,12,10,2,13.3,12.4,0.9,19,CL
c7842dab,4,98,1.1,1,0,3,2,2,2,0,2.5,2.5,0.0,19,CL
c886b062,4,303,3.4,3,1,1,0,3,5,-2,3.5,5.0,-1.5,19,CL
c8bfb695,2,100,1.1,1,1,1,4,1,2,-1,1.6,2.2,-0.7,19,CL
c8c60119,1,15,0.2,0,0,1,1,0,1,-1,0.1,0.3,-0.2,19,CL
c8e65157,6,540,6.0,6,6,0,0,5,17,-12,2.9,19.4,-16.6,19,CL
c906ce0f,3,300,3.3,3,3,0,0,5,7,-2,5.8,7.0,-1.2,19,CL
c952f633,2,135,1.5,1,1,1,3,2,2,0,1.6,2.9,-1.3,19,CL
c9cb972b,1,90,1.0,1,1,0,5,2,1,1,1.4,1.8,-0.3,19,CL
c9e99e49,3,205,2.3,2,1,1,1,3,3,0,4.2,2.5,1.7,19,CL
ca3e2783,1,45,0.5,1,0,0,2,0,2,-2,0.1,2.0,-1.8,19,CL
cbbfa2e7,3,118,1.3,1,0,2,0,2,2,0,1.8,2.0,-0.2,19,CL
cc1a0c57,6,540,6.0,6,6,0,0,6,13,-7,7.1,13.9,-6.8,19,CL
cc700722,6,510,5.7,6,5,0,0,7,5,2,10.1,6.4,3.7,19,CL
cc83b74d,9,301,3.3,3,1,6,3,7,5,2,7.1,6.6,0.4,19,CL
cc86b9a3,6,328,3.6,3,2,3,1,10,4,6,9.7,4.0,5.7,19,CL
ccbbe661,6,489,5.4,6,3,0,0,1,11,-10,3.2,11.7,-8.5,19,CL
ccc66d00,2,21,0.2,0,0,2,0,0,1,-1,0.1,0.7,-0.6,19,CL
ccd88b8e,4,145,1.6,1,0,3,0,1,2,-1,1.5,2.7,-1.2,19,CL
cce181df,5,406,4.5,5,2,0,0,6,4,2,4.6,6.7,-2.1,19,CL
cd1acf9d,11,919,10.2,11,8,0,2,21,6,15,21.5,9.2,12.2,19,CL
cd1b2304,2,180,2.0,2,2,0,4,2,7,-5,1.8,4.7,-2.9,19,CL
ce9e8024,4,360,4.0,4,4,0,0,2,4,-2,4.5,5.9,-1.3,19,CL
cea4ee8f,8,707,7.9,8,6,0,0,11,10,1,14.1,10.7,3.4,19,CL
cf182add,6,540,6.0,6,6,0,0,8,16,-8,6.9,13.2,-6.3,19,CL
cf8ef0a1,3,243,2.7,3,2,0,0,3,7,-4,1.8,9.4,-7.6,19,CL
cfd8d664,5,450,5.0,5,5,0,1,6,8,-2,5.0,6.5,-1.6,19,CL
cff7dcb0,5,406,4.5,5,2,0,0,4,11,-7,5.4,9.8,-4.4,19,CL
d003e213,6,368,4.1,4,4,2,0,11,7,4,7.8,4.8,3.0,19,CL
d02e0cab,5,216,2.4,2,0,3,1,3,5,-2,2.1,3.6,-1.5,19,CL
d04b94db,10,559,6.2,5,5,5,2,12,5,7,10.7,8.4,2.3,19,CL
d072a976,6,472,5.2,6,4,0,0,4,7,-3,7.1,8.3,-1.2,19,CL
d0d79694,2,91,1.0,1,1,1,1,1,1,0,1.3,2.4,-1.1,19,CL
d0d8dd44,5,441,4.9,5,4,0,1,6,5,1,7.4,5.6,1.8,19,CL
d1273f09,6,511,5.7,6,5,0,1,6,6,0,7.5,6.6,0.9,19,CL
d1661819,2,180,2.0,2,2,0,0,2,10,-8,1.9,5.3,-3.5,19,CL
d2110326,3,270,3.0,3,3,0,3,3,3,0,2.6,5.4,-2.8,19,CL
d2448564,3,187,2.1,2,1,1,1,1,6,-5,2.2,3.4,-1.2,19,CL
d28b8f40,6,540,6.0,6,6,0,0,6,5,1,5.4,6.3,-0.9,19,CL
d2bff301,4,207,2.3,2,2,2,4,8,4,4,5.2,1.4,3.8,19,CL
d3272fba,3,44,0.5,0,0,3,2,0,3,-3,0.4,1.2,-0.8,19,CL
d38174c3,1,1,0.0,0,0,1,4,0,0,0,0.0,0.0,0.0,19,CL
d3aaad90,4,261,2.9,4,1,0,3,5,3,2,4.0,3.8,0.3,19,CL
d4931a5a,3,111,1.2,1,0,2,4,1,0,1,1.3,1.5,-0.2,19,CL
d49f3e6b,4,124,1.4,1,0,3,0,0,0,0,0.4,1.7,-1.3,19,CL
d4aa40b8,6,511,5.7,6,4,0,0,4,16,-12,2.7,17.7,-15.0,19,CL
d5980989,1,58,0.6,1,0,0,0,0,0,0,0.5,0.6,-0.1,19,CL
d5c04323,5,450,5.0,5,5,0,1,2,12,-10,5.2,7.8,-2.6,19,CL
d5f2f82b,7,630,7.0,7,7,0,1,14,11,3,11.5,10.2,1.3,19,CL
d6e53a3a,11,990,11.0,11,11,0,0,19,13,6,20.6,17.4,3.2,19,CL
d70ce98e,10,838,9.3,9,9,1,0,22,9,13,18.2,11.3,6.8,19,CL
d7c09951,4,284,3.2,3,3,1,2,1,5,-4,3.9,4.6,-0.8,19,CL
d83bbc54,3,270,3.0,3,3,0,3,3,4,-1,4.1,6.5,-2.3,19,CL
d849ef0f,4,201,2.2,2,1,2,0,0,5,-5,0.9,4.5,-3.6,19,CL
d8b97bb3,6,344,3.8,4,2,2,0,1,9,-8,2.4,6.3,-3.9,19,CL
d93c2511,3,270,3.0,3,3,0,2,3,5,-2,2.9,3.9,-1.0,19,CL
d9565625,4,244,2.7,2,1,2,1,4,1,3,3.3,3.0,0.3,19,CL
d9a5d930,6,462,5.1,5,4,1,1,3,11,-8,6.3,8.2,-1.9,19,CL
d9d43555,2,84,0.9,1,0,1,1,0,3,-3,0.9,2.5,-1.5,19,CL
da59a197,1,8,0.1,0,0,1,0,0,0,0,0.1,0.0,0.1,19,CL
da7b447d,8,631,7.0,7,7,1,2,11,10,1,10.2,7.1,3.1,19,CL
da974c7b,6,540,6.0,6,6,0,0,7,5,2,10.9,6.5,4.4,19,CL
dab0da1c,5,316,3.5,4,2,1,0,2,8,-6,3.6,4.9,-1.3,19,CL
dad4b285,5,312,3.5,3,3,2,1,4,3,1,6.4,4.1,2.2,19,CL
db4ed67b,5,318,3.5,3,2,2,2,6,3,3,5.7,3.1,2.6,19,CL
db750822,4,99,1.1,0,0,4,1,0,1,-1,0.3,2.8,-2.5,19,CL
dbf053da,7,436,4.8,5,1,2,0,4,5,-1,6.2,4.9,1.3,19,CL
dc62fbee,3,141,1.6,2,0,1,1,3,4,-1,2.9,3.6,-0.6,19,CL
de40e38c,2,167,1.9,2,1,0,0,0,3,-3,1.9,3.0,-1.1,19,CL
de5b5570,5,395,4.4,4,4,1,0,5,3,2,4.6,4.9,-0.3,19,CL
dea698d9,9,748,8.3,9,8,0,0,9,9,0,14.0,8.0,6.1,19,CL
dead55e5,2,180,2.0,2,2,0,0,2,5,-3,3.1,3.5,-0.4,19,CL
def899bd,3,270,3.0,3,3,0,2,2,5,-3,3.5,3.5,0.0,19,CL
df69b544,8,720,8.0,8,8,0,0,11,9,2,8.1,9.1,-1.0,19,CL
dff153a4,2,37,0.4,0,0,2,0,0,1,-1,0.2,0.9,-0.8,19,CL
e06683ca,12,1080,12.0,12,12,0,0,24,12,12,26.2,13.4,12.7,19,CL
e0900238,6,292,3.2,4,2,2,4,4,10,-6,2.2,5.4,-3.2,19,CL
e0921a4f,9,518,5.8,6,2,3,1,9,4,5,11.1,3.7,7.4,19,CL
e0991c04,1,45,0.5,1,0,0,2,0,1,-1,0.6,0.7,-0.1,19,CL
e0d3e18d,4,300,3.3,3,2,1,0,4,5,-1,3.4,6.9,-3.5,19,CL
e162b013,5,363,4.0,4,3,1,1,11,8,3,8.4,7.1,1.2,19,CL
e16dd48e,4,360,4.0,4,4,0,0,6,9,-3,5.7,8.1,-2.3,19,CL
e204ec12,4,325,3.6,4,2,0,0,2,3,-1,3.2,5.6,-2.4,19,CL
e26f559f,3,183,2.0,2,2,1,3,2,5,-3,4.7,3.3,1.4,19,CL
e2716bd0,9,714,7.9,9,4,0,0,21,10,11,17.1,8.0,9.0,19,CL
e288d4b3,8,619,6.9,6,5,2,0,12,8,4,12.8,9.4,3.4,19,CL
e2dde94c,6,463,5.1,5,3,1,0,6,8,-2,5.3,9.5,-4.1,19,CL
e33c06cf,6,451,5.0,5,5,1,2,11,7,4,8.2,6.9,1.3,19,CL
e342ad68,12,1056,11.7,12,10,0,0,18,12,6,23.4,12.3,11.0,19,CL
e38f1636,6,515,5.7,6,5,0,0,6,10,-4,7.0,13.3,-6.3,19,CL
e3d0b0c4,8,720,8.0,8,8,0,0,13,16,-3,12.3,17.2,-5.0,19,CL
e4086af3,1,75,0.8,0,0,1,2,1,0,1,2.1,0.7,1.3,19,CL
e40d028b,5,450,5.0,5,5,0,0,10,6,4,9.5,6.2,3.4,19,CL
e42d61c7,5,371,4.1,4,4,1,3,6,5,1,5.5,4.5,1.0,19,CL
e46012d4,4,246,2.7,3,1,1,0,8,5,3,6.1,2.9,3.2,19,CL
e4ed2628,5,405,4.5,4,4,1,2,8,4,4,6.0,5.0,1.0,19,CL
e50623a0,1,90,1.0,1,1,0,1,1,2,-1,0.7,0.9,-0.2,19,CL
e6ad16b2,6,456,5.1,5,4,1,0,6,5,1,7.9,6.3,1.6,19,CL
e6bc67d7,4,314,3.5,4,1,0,0,3,4,-1,2.8,7.2,-4.4,19,CL
e73c9bb2,10,930,10.3,10,10,0,0,20,15,5,16.9,19.4,-2.5,19,CL
e7986081,6,298,3.3,3,2,3,1,3,9,-6,4.4,10.9,-6.5,19,CL
e7d59f4f,5,142,1.6,1,0,4,1,3,4,-1,3.6,2.4,1.2,19,CL
e7ee38c3,6,570,6.3,6,6,0,2,11,9,2,12.3,11.4,0.9,19,CL
e85fb9b8,6,540,6.0,6,6,0,2,8,4,4,11.9,5.3,6.7,19,CL
e90dc1d5,5,324,3.6,3,3,2,0,2,6,-4,6.9,5.3,1.6,19,CL
e97150c0,1,90,1.0,1,1,0,4,2,2,0,2.5,1.9,0.5,19,CL
e9c0c1b2,12,1080,12.0,12,12,0,0,22,13,9,22.3,17.8,4.5,19,CL
ead61f73,1,90,1.0,1,1,0,1,1,1,0,1.3,2.4,-1.1,19,CL
eb58eef0,12,968,10.8,11,8,1,1,20,11,9,24.2,10.8,13.5,19,CL
eb7822d7,6,540,6.0,6,6,0,1,6,4,2,5.8,8.4,-2.6,19,CL
eba1e557,3,181,2.0,2,1,1,0,0,4,-4,2.0,3.3,-1.3,19,CL
ebc56869,1,5,0.1,0,0,1,4,0,0,0,0.1,0.0,0.1,19,CL
ecada4fc,3,270,3.0,3,3,0,4,5,2,3,8.2,2.6,5.7,19,CL
ed1e53f3,4,122,1.4,1,1,3,3,5,1,4,4.5,1.6,2.9,19,CL
ed87a229,2,33,0.4,0,0,2,2,0,1,-1,0.2,0.4,-0.2,19,CL
ed90babd,2,24,0.3,0,0,2,1,0,0,0,0.2,0.4,-0.2,19,CL
eda40760,8,661,7.3,7,6,1,0,10,12,-2,12.9,13.6,-0.7,19,CL
ee3519f5,6,526,5.8,6,5,0,0,7,16,-9,5.8,12.5,-6.7,19,CL
ee8508c0,8,720,8.0,8,8,0,0,11,9,2,8.1,9.1,-1.0,19,CL
ee93c1a9,8,552,6.1,6,4,2,0,11,6,5,13.6,7.6,6.0,19,CL
eed332df,4,216,2.4,2,1,2,2,4,4,0,1.3,7.3,-6.0,19,CL
f00de885,8,663,7.4,8,7,0,0,12,13,-1,11.7,14.9,-3.2,19,CL
f0661424,10,900,10.0,10,10,0,0,18,12,6,17.9,16.6,1.3,19,CL
f08490a6,2,165,1.8,2,1,0,0,1,3,-2,1.0,2.2,-1.2,19,CL
f0da930c,5,360,4.0,5,3,0,0,6,5,1,3.8,4.3,-0.5,19,CL
f0fc9d0e,6,310,3.4,4,1,2,0,2,8,-6,3.9,5.3,-1.4,19,CL
f209b81e,6,355,3.9,4,2,2,0,6,7,-1,5.7,8.5,-2.9,19,CL
f25c8e3a,6,243,2.7,4,1,2,3,2,0,2,5.6,2.2,3.4,19,CL
f2d063ec,6,540,6.0,6,6,0,0,7,16,-9,7.8,12.3,-4.5,19,CL
f35430a4,6,540,6.0,6,6,0,1,7,7,0,9.4,7.5,1.9,19,CL
f36c432f,1,11,0.1,1,0,0,0,0,0,0,0.0,0.0,0.0,19,CL
f4eb377b,4,360,4.0,4,4,0,2,5,9,-4,6.0,7.6,-1.6,19,CL
f5b6fb78,6,540,6.0,6,6,0,0,4,12,-8,6.5,11.5,-5.0,19,CL
f5deef4c,7,630,7.0,7,7,0,1,8,9,-1,6.4,11.2,-4.8,19,CL
f61c7c4e,7,434,4.8,6,0,1,0,12,4,8,9.8,4.3,5.5,19,CL
f6ac68c1,1,81,0.9,1,0,0,3,2,0,2,0.9,0.4,0.5,19,CL
f6db3bd5,1,46,0.5,0,0,1,0,0,3,-3,0.3,2.9,-2.7,19,CL
f7036e1c,3,56,0.6,0,0,3,2,2,1,1,1.2,0.9,0.3,19,CL
f76d7a41,3,41,0.5,0,0,3,0,0,0,0,0.1,0.7,-0.6,19,CL
f7b10c66,4,360,4.0,4,4,0,1,1,10,-9,3.5,8.5,-5.0,19,CL
f7d50789,12,1080,12.0,12,12,0,0,19,17,2,19.7,14.9,4.8,19,CL
f7ee69fb,2,163,1.8,2,1,0,0,3,3,0,2.7,1.5,1.2,19,CL
f956479d,2,83,0.9,1,0,1,0,0,1,-1,0.8,0.8,-0.1,19,CL
f99fe221,6,366,4.1,5,3,1,1,4,6,-2,5.9,4.9,0.9,19,CL
f9c927de,4,228,2.5,2,2,2,2,2,3,-1,2.7,4.3,-1.7,19,CL
fa274d97,5,444,4.9,5,4,0,0,10,11,-1,10.5,9.6,1.0,19,CL
fa661778,4,211,2.3,3,1,1,1,2,1,1,2.5,1.6,0.9,19,CL
fb517645,2,35,0.4,0,0,2,3,1,2,-1,0.1,1.5,-1.4,19,CL
fb938d24,8,556,6.2,7,1,1,0,13,9,4,10.0,10.6,-0.6,19,CL
fbb23472,6,469,5.2,5,5,1,0,4,12,-8,6.1,8.2,-2.1,19,CL
fbffc4b1,2,180,2.0,2,2,0,0,2,10,-8,1.9,5.3,-3.5,19,CL
fc4f85b1,6,540,6.0,6,6,0,0,7,9,-2,5.7,7.1,-1.5,19,CL
fc62f087,7,619,6.9,7,6,0,0,10,4,6,11.6,5.2,6.4,19,CL
fd4ee68b,4,348,3.9,4,3,0,0,2,10,-8,3.8,7.9,-4.1,19,CL
fd51b456,6,385,4.3,5,3,1,2,10,5,5,8.5,6.9,1.5,19,CL
fdd60087,4,346,3.8,4,3,0,3,5,3,2,3.6,4.0,-0.4,19,CL
fe2d2289,2,51,0.6,0,0,2,3,0,3,-3,0.3,1.9,-1.5,19,CL
fe2db476,5,450,5.0,5,5,0,0,8,2,6,7.9,3.5,4.5,19,CL
fe641c1a,6,296,3.3,4,2,2,0,1,5,-4,2.4,3.7,-1.3,19,CL
fed17f5a,6,392,4.4,4,4,2,0,6,5,1,6.3,8.9,-2.6,19,CL
ff0ab48c,5,287,3.2,3,3,2,0,3,7,-4,3.8,8.2,-4.3,19,CL
ff182fdc,5,346,3.8,4,2,1,0,6,10,-4,5.5,7.9,-2.4,19,CL
ffbbc83b,6,414,4.6,5,3,1,0,7,11,-4,8.7,9.1,-0.4,19,CL
0000acda,32,2282,25.4,29,12,3,4,31,28,3,35.1,24.0,11.2,19,ITA
00528660,9,564,6.3,6,5,3,28,10,11,-1,7.9,10.2,-2.3,19,ITA
008a6e6d,15,1230,13.7,15,12,0,2,12,18,-6,15.9,21.3,-5.3,19,ITA
00b0bb87,14,1077,11.9,12,9,2,3,13,17,-4,12.899999999999999,19.299999999999997,-6.4,19,ITA
01b8a2b2,28,2520,28.0,28,28,0,10,55,20,35,48.1,26.6,21.6,19,ITA
01efac19,8,329,3.7,4,0,4,7,3,10,-7,2.6,7.7,-5.1,19,ITA
023937a9,35,2984,33.2,34,28,1,1,20,53,-33,36.599999999999994,46.2,-9.7,19,ITA
02b2937c,11,352,3.9,3,3,8,8,3,4,-1,3.1,5.7,-2.6,19,ITA
02caf6e0,33,2835,31.5,33,26,0,0,38,43,-5,37.3,41.0,-3.6,19,ITA
02febfdc,29,2043,22.7,22,13,7,5,18,33,-15,22.7,34.0,-11.2,19,ITA
0375723e,22,704,7.8,9,0,13,8,16,10,6,13.2,9.6,3.7,19,ITA
03760df0,17,1524,16.9,17,16,0,2,26,25,1,19.4,24.0,-4.6,19,ITA
03f946ed,36,3031,33.7,35,21,1,1,42,51,-9,40.6,44.8,-4.2,19,ITA
0412b9cd,5,32,0.4,0,0,5,12,0,1,-1,0.4,0.9,-0.5,19,ITA
048877f5,31,2789,31.0,31,30,0,0,21,60,-39,32.1,48.5,-16.3,19,ITA
0497a545,1,12,0.1,0,0,1,4,0,0,0,0.0,0.0,0.0,19,ITA
05e19d6a,34,3018,33.5,34,31,0,1,51,32,19,43.1,35.6,7.5,19,ITA
06050480,3,166,1.8,2,1,1,13,3,5,-2,3.5,2.9,0.6,19,ITA
060606ec,24,1495,16.6,16,9,8,8,14,21,-7,18.1,27.9,-9.8,19,ITA
07767f42,26,1859,20.7,21,16,5,10,27,26,1,25.9,32.1,-6.2,19,ITA
07abb358,27,2127,23.6,26,17,1,10,35,36,-1,29.299999999999997,37.1,-7.8,19,ITA
07ea0ef2,12,772,8.6,9,4,3,20,11,17,-6,13.0,11.9,1.0,19,ITA
07f55871,1,6,0.1,0,0,1,25,0,0,0,0.0,0.0,0.0,19,ITA
0821331c,30,2610,29.0,29,26,1,3,19,48,-29,28.1,44.7,-16.5,19,ITA
0830a4f9,1,58,0.6,0,0,1,24,0,0,0,0.1,0.6,-0.5,19,ITA
085e71a7,17,1485,16.5,16,16,1,18,24,26,-2,22.5,28.7,-6.2,19,ITA
089550f5,32,2671,29.7,30,27,2,5,42,26,16,48.8,31.2,17.6,19,ITA
08aa9cd1,27,1625,18.1,17,9,10,9,17,32,-15,19.3,29.4,-10.1,19,ITA
08f5afaa,36,3090,34.3,36,34,0,0,50,31,19,42.6,36.5,6.1,19,ITA
091795f2,1,5,0.1,0,0,1,7,0,0,0,0.0,0.0,0.0,19,ITA
09538fdb,36,2453,27.3,26,19,10,2,31,41,-10,32.4,43.0,-10.6,19,ITA
098139eb,10,252,2.8,1,1,9,7,1,8,-7,2.6,6.2,-3.5,19,ITA
0a3065c8,25,2023,22.5,23,18,2,7,28,34,-6,30.1,27.3,2.8,19,ITA
0a447501,15,766,8.5,9,4,6,2,9,6,3,12.4,7.2,5.2,19,ITA
0ab1f153,18,1220,13.6,14,7,4,3,18,14,4,18.2,13.4,4.8,19,ITA
0acda699,3,270,3.0,3,3,0,26,1,5,-4,4.8,3.8,1.0,19,ITA
0b5a292a,20,1417,15.7,17,12,3,13,27,17,10,23.0,16.5,6.5,19,ITA
0cd0e21b,7,175,1.9,1,0,6,5,3,4,-1,2.7,2.3,0.4,19,ITA
0d077b88,32,2010,22.3,21,15,11,2,28,32,-4,31.5,31.9,-0.5,19,ITA
0d82903c,31,2387,26.5,28,21,3,2,50,19,31,46.0,25.5,20.4,19,ITA
0e21fc3c,27,1231,13.7,12,3,15,9,20,12,8,20.9,14.2,6.8,19,ITA
0f933743,6,269,3.0,2,2,4,8,4,7,-3,4.0,6.3,-2.3,19,ITA
1079c685,15,670,7.4,7,2,8,15,6,11,-5,8.2,12.9,-4.7,19,ITA
10dc46f0,36,3169,35.2,36,35,0,0,48,35,13,44.5,43.6,0.9,19,ITA
10e25802,19,1046,11.6,10,6,9,14,10,15,-5,13.3,17.2,-3.9,19,ITA
10e7f486,33,2672,29.7,29,27,4,2,41,48,-7,39.8,42.1,-2.3,19,ITA
117beb8f,12,746,8.3,8,4,4,17,8,13,-5,9.1,11.9,-2.8,19,ITA
1253a12e,25,1960,21.8,22,20,3,10,21,34,-13,28.0,27.2,0.8,19,ITA
12851227,6,175,1.9,2,0,4,28,2,5,-3,1.4,3.1,-1.7,19,ITA
130a7a3f,31,1023,11.4,8,3,23,7,16,11,5,16.2,11.2,4.9,19,ITA
13c8e5f6,4,105,1.2,0,0,4,10,2,1,1,3.3,2.8,0.5,19,ITA
13d820de,11,752,8.4,8,7,3,24,3,22,-19,3.4,13.4,-10.100000000000001,19,ITA
144607cc,30,2557,28.4,29,24,1,0,35,41,-6,29.7,38.9,-9.2,19,ITA
149c5f5d,9,296,3.2,3,2,6,25,2,6,-4,3.1,6.6,-3.5,19,ITA
14b8fcdf,15,1350,15.0,15,15,0,18,29,13,16,23.8,12.9,10.9,19,ITA
157d29b6,32,1893,21.1,23,6,9,1,29,31,-2,29.700000000000003,37.8,-8.1,19,ITA
15d0c248,17,1289,14.3,15,10,2,13,20,16,4,22.7,19.4,3.3,19,ITA
162efffd,36,3189,35.4,36,31,0,0,35,51,-16,38.7,55.2,-16.5,19,ITA
16657b95,35,2425,26.9,26,22,9,1,46,41,5,44.1,38.6,5.5,19,ITA
16b9d5cf,17,1375,15.3,15,13,2,17,31,12,19,26.7,13.4,13.3,19,ITA
173061c0,34,3045,33.8,34,33,0,1,35,51,-16,36.1,58.3,-22.2,19,ITA
17f3620a,37,2966,33.0,34,24,3,0,51,44,7,40.3,45.5,-5.1000000000000005,19,ITA
1880614f,26,1375,15.3,17,5,9,4,29,17,12,27.5,22.8,4.8,19,ITA
18f9dbd0,13,973,10.8,12,4,1,21,11,16,-5,9.2,18.0,-8.8,19,ITA
197640fd,28,2006,22.3,21,18,7,10,49,29,20,41.7,24.9,16.8,19,ITA
1ab0b878,6,139,1.5,1,0,5,10,0,6,-6,0.8,5.5,-4.7,19,ITA
1ad1f50d,19,613,6.8,5,1,14,16,7,10,-3,6.9,9.4,-2.4000000000000004,19,ITA
1b82f8df,14,1122,12.5,13,10,1,2,7,14,-7,14.7,13.4,1.3,19,ITA
1c50f354,26,2009,22.3,22,19,4,1,15,50,-35,24.6,36.6,-12.0,19,ITA
1c529186,19,1302,14.5,15,8,4,19,22,13,9,19.9,14.2,5.7,19,ITA
1c8c5aed,14,1159,12.9,13,11,1,22,9,31,-22,13.2,25.0,-11.8,19,ITA
1cac99dc,29,1639,18.2,19,4,10,4,23,27,-4,20.1,27.6,-7.5,19,ITA
1cadaf34,2,48,0.5,0,0,2,10,2,0,2,2.3,0.1,2.3,19,ITA
1ea5f91c,25,963,10.7,7,5,18,12,14,22,-8,15.3,20.7,-5.3,19,ITA
1f9328da,29,1967,21.9,22,11,7,2,33,17,16,38.9,19.6,19.3,19,ITA
1fca9171,19,1074,11.9,14,2,5,18,16,19,-3,13.7,16.1,-2.3,19,ITA
2114abf9,33,2454,27.3,28,15,5,1,23,47,-24,30.0,41.7,-11.7,19,ITA
2146785a,26,1950,21.7,22,15,4,4,27,20,7,24.5,25.6,-1.1,19,ITA
2258c078,5,337,3.7,5,2,0,3,2,8,-6,3.8,5.5,-1.7,19,ITA
228f73ae,12,498,5.5,6,0,6,6,12,10,2,8.3,6.5,1.8,19,ITA
230a2fac,37,3330,37.0,37,37,0,0,51,69,-18,51.8,62.5,-10.7,19,ITA
2334478a,5,213,2.4,4,0,1,4,2,5,-3,2.3,3.8,-1.5,19,ITA
246d153b,30,2160,24.0,22,15,8,2,31,23,8,30.3,31.7,-1.4,19,ITA
259deea9,1,3,0.0,0,0,1,28,0,0,0,0.0,1.2,-1.2,19,ITA
2648e18f,1,30,0.3,0,0,1,1,1,0,1,0.4,0.2,0.2,19,ITA
269b4638,7,480,5.3,6,3,1,7,1,11,-10,4.5,10.5,-6.0,19,ITA
277da414,16,1440,16.0,16,16,0,22,24,36,-12,21.1,26.3,-5.3,19,ITA
27f0ddef,20,1713,19.0,19,19,1,9,15,32,-17,21.1,26.2,-5.1,19,ITA
28237d7e,1,9,0.1,0,0,1,3,0,0,0,0.1,0.2,-0.1,19,ITA
283699b4,14,1016,11.3,10,8,4,22,12,21,-9,14.5,16.4,-1.8,19,ITA
2876eaa3,5,199,2.2,2,1,3,12,1,4,-3,2.6,4.5,-1.9,19,ITA
2a1beb34,35,2975,33.1,34,31,1,0,64,36,28,62.3,35.4,26.9,19,ITA
2a82aa85,1,60,0.7,1,0,0,4,1,1,0,0.2,0.9,-0.6,19,ITA
2b28ba9f,15,970,10.8,12,2,3,23,9,19,-10,13.9,16.6,-2.7,19,ITA
2b71b88a,9,788,8.8,9,7,0,25,7,19,-12,9.6,13.9,-4.3,19,ITA
2c38b327,19,750,8.3,8,1,11,6,12,9,3,12.2,7.1,5.1,19,ITA
2c851997,27,1578,17.5,19,3,8,5,23,21,2,20.8,24.2,-3.4,19,ITA
2d3f7367,2,24,0.3,0,0,2,23,0,0,0,0.3,0.4,-0.1,19,ITA
2d970560,28,1942,21.6,23,14,5,10,42,23,19,39.6,24.9,14.7,19,ITA
2ead2809,8,404,4.5,4,2,4,16,2,4,-2,7.1,5.9,1.2,19,ITA
2ec0f902,24,1548,17.2,18,8,6,12,10,33,-23,13.8,26.9,-13.1,19,ITA
2f3452eb,27,2107,23.4,24,19,3,11,45,21,24,41.2,21.3,19.8,19,ITA
2f557579,28,2073,23.0,24,13,4,1,38,21,17,36.3,21.3,15.0,19,ITA
2f7407fa,1,38,0.4,0,0,1,1,2,1,1,0.8,0.7,0.0,19,ITA
30144daa,1,22,0.2,0,0,1,3,0,1,-1,0.2,0.3,-0.1,19,ITA
30223b33,11,990,11.0,11,11,0,24,16,6,10,16.3,12.6,3.7,19,ITA
30f5ffa9,35,3150,35.0,35,35,0,3,53,32,21,60.9,36.2,24.7,19,ITA
314f2124,14,1158,12.9,14,11,0,20,16,11,5,18.0,16.6,1.4,19,ITA
3300c14c,3,126,1.4,1,1,2,16,1,2,-1,2.1,2.5,-0.5,19,ITA
331c0a43,34,2741,30.5,33,23,1,1,35,40,-5,35.4,38.2,-2.8,19,ITA
339c6ed4,4,81,0.9,1,0,3,11,0,0,0,0.8,0.6,0.2,19,ITA
339fe0e8,35,3150,35.0,35,35,0,0,50,39,11,55.6,40.8,14.9,19,ITA
33b8d077,32,2650,29.4,31,23,1,0,39,29,10,49.8,30.2,19.6,19,ITA
343c0d52,36,2454,27.3,27,15,9,2,39,32,7,40.4,28.3,12.0,19,ITA
343f753a,37,3330,37.0,37,37,0,1,40,59,-19,39.2,63.7,-24.5,19,ITA
34bb6fbd,18,1412,15.7,16,14,2,19,14,27,-13,13.9,22.4,-8.5,19,ITA
3535098b,15,920,10.2,10,4,5,20,16,19,-3,16.1,12.0,4.1,19,ITA
356c9002,18,502,5.6,5,0,13,20,11,4,7,10.6,4.8,5.8,19,ITA
35dd6d80,35,3070,34.1,35,34,0,0,36,44,-8,42.9,44.1,-1.2,19,ITA
3626daea,10,601,6.7,6,5,4,17,12,11,1,9.6,6.4,3.3,19,ITA
3799e138,10,317,3.5,2,0,8,8,3,8,-5,4.6,5.9,-1.4,19,ITA
384dd218,6,153,1.7,1,1,5,20,2,6,-4,1.2,2.4,-1.1,19,ITA
38ac43d3,10,706,7.8,8,1,2,5,19,9,10,16.2,7.9,8.3,19,ITA
3b15ef2d,5,450,5.0,5,5,0,14,10,3,7,8.4,3.7,4.8,19,ITA
3b333ac3,35,2973,33.0,33,31,2,2,65,39,26,63.1,35.2,27.9,19,ITA
3b387cc7,2,8,0.1,0,0,2,6,0,1,-1,0.2,0.2,-0.1,19,ITA
3b61c9ec,16,1101,12.200000000000001,13,9,3,15,12,19,-7,13.7,23.8,-10.100000000000001,19,ITA
3b8674e6,31,2003,22.3,21,18,10,3,39,16,23,32.7,20.4,12.3,19,ITA
3bb625ac,29,1970,21.9,23,13,6,3,23,26,-3,31.9,23.7,8.2,19,ITA
3bb7af3b,22,905,10.1,11,1,11,9,16,14,2,13.3,14.5,-1.2,19,ITA
3bb7f478,33,2579,28.7,28,26,5,1,47,38,9,48.6,41.5,7.1,19,ITA
3c1e4e84,8,553,6.1,6,4,2,14,5,9,-4,8.3,8.8,-0.5,19,ITA
3d50bcdb,13,541,6.0,5,3,8,19,11,5,6,9.3,4.6,4.8,19,ITA
3d936ba9,21,1714,19.0,21,15,0,7,26,36,-10,27.2,31.1,-3.9,19,ITA
3ead85f9,32,2847,31.6,32,30,0,0,44,32,12,39.7,34.1,5.6,19,ITA
40f0ed6c,13,755,8.4,10,4,3,8,10,18,-8,9.1,14.6,-5.5,19,ITA
4133cfcf,3,97,1.1,1,0,2,9,0,3,-3,1.5,1.0,0.5,19,ITA
41bd99ea,9,810,9.0,9,9,0,10,8,13,-5,9.9,12.7,-2.8,19,ITA
41ff002d,3,88,1.0,1,0,2,14,0,4,-4,0.3,2.4,-2.1,19,ITA
422ec08a,29,1488,16.5,16,4,13,7,31,24,7,22.7,23.1,-0.3,19,ITA
42b1a58a,2,114,1.3,1,1,1,28,0,2,-2,0.3,1.2,-0.9,19,ITA
434b8c73,12,699,7.8,9,1,3,6,9,11,-2,8.0,14.5,-6.5,19,ITA
438dfc6a,27,2226,24.7,25,22,2,11,20,37,-17,24.6,36.0,-11.4,19,ITA
43a1bea5,12,785,8.7,9,7,3,5,12,7,5,9.9,10.7,-0.8,19,ITA
43a2e16c,35,2133,23.7,22,19,13,3,26,35,-9,27.8,35.0,-7.2,19,ITA
43b78598,29,2267,25.2,24,18,5,2,31,21,10,41.0,27.3,13.8,19,ITA
440c84ed,26,1612,17.9,19,6,7,4,31,22,9,26.0,23.6,2.4,19,ITA
4431aed2,36,2859,31.8,31,27,5,0,45,41,4,51.2,41.4,9.9,19,ITA
44510fde,6,170,1.9,0,0,6,9,2,3,-1,3.9,1.8,2.1,19,ITA
44ac04e9,30,2015,22.4,23,14,7,5,31,24,7,34.4,28.1,6.3,19,ITA
44eb9093,30,2579,28.7,29,26,1,7,45,29,16,50.6,29.6,21.0,19,ITA
455a2b79,29,1454,16.099999999999998,16,5,13,4,12,24,-12,18.0,23.900000000000002,-6.0,19,ITA
45b9b619,34,1927,21.4,18,12,16,2,37,25,12,37.4,25.8,11.7,19,ITA
4611e028,28,2357,26.2,27,20,1,5,37,42,-5,35.0,34.5,0.5,19,ITA
46a8347f,10,727,8.1,8,7,2,5,11,7,4,12.1,9.1,3.0,19,ITA
46f5c54d,31,2542,28.2,29,22,2,3,35,42,-7,32.0,37.0,-5.1,19,ITA
47a500ae,21,1823,20.3,20,20,1,7,18,44,-26,22.3,37.3,-15.0,19,ITA
4a56052c,33,2941,32.7,33,30,0,0,36,39,-3,46.3,35.3,11.0,19,ITA
4a5a45c7,25,1821,20.2,21,11,4,4,32,25,7,32.9,28.4,4.5,19,ITA
4b029b31,29,2610,29.0,29,29,0,8,21,56,-35,27.6,49.6,-22.0,19,ITA
4bd414c1,20,1713,19.0,19,19,1,6,33,22,11,30.4,21.2,9.3,19,ITA
4c3a6744,29,1341,14.9,14,1,15,8,26,15,11,26.0,17.0,9.0,19,ITA
4c62d0c8,9,810,9.0,9,9,0,21,15,8,7,12.1,8.5,3.7,19,ITA
4c78b5ed,27,1987,22.1,22,16,5,2,32,25,7,33.1,29.2,3.9,19,ITA
4cc93246,25,1185,13.2,12,3,13,11,10,19,-9,11.8,24.0,-12.2,19,ITA
4d3ab428,7,161,1.8,1,0,6,23,3,3,0,1.5,2.8000000000000003,-1.3,19,ITA
4dba2a97,23,1761,19.6,20,15,3,10,17,32,-15,18.5,33.5,-15.0,19,ITA
4e219ad2,35,3018,33.5,35,22,0,1,51,33,18,42.6,36.5,6.1,19,ITA
4e358a2d,34,2806,31.2,31,30,3,2,50,38,12,51.4,42.8,8.6,19,ITA
4e6dbac4,31,2396,26.6,29,18,2,1,39,27,12,43.9,28.4,15.4,19,ITA
4e7db402,34,3015,33.5,34,33,0,3,43,40,3,50.0,36.2,13.9,19,ITA
4f2908e5,16,1356,15.1,14,13,2,11,20,26,-6,19.5,24.6,-5.1,19,ITA
4fa7cb9b,17,621,6.9,7,0,10,1,13,8,5,10.6,7.2,3.4,19,ITA
4fac8f81,5,282,3.1,3,2,2,33,6,5,1,4.2,6.4,-2.2,19,ITA
509a4ccb,24,889,9.9,8,1,16,7,17,5,12,16.3,9.7,6.6,19,ITA
5128bde4,33,2542,28.2,30,19,3,2,28,43,-15,33.6,41.7,-8.1,19,ITA
514f0896,3,251,2.8,2,2,1,35,4,2,2,2.1,4.1,-2.0,19,ITA
528492ea,26,1848,20.5,21,14,5,3,32,35,-3,24.2,34.9,-10.7,19,ITA
5294a83f,27,1990,22.1,25,9,2,4,30,22,8,35.0,23.3,11.7,19,ITA
52ec54d0,29,2472,27.5,27,26,2,6,50,21,29,42.8,26.7,16.0,19,ITA
5313ed43,31,2639,29.3,31,24,0,0,28,43,-15,32.8,44.6,-11.8,19,ITA
532d2690,18,1270,14.1,15,8,3,5,22,18,4,24.3,19.6,4.7,19,ITA
539230cf,4,62,0.7,0,0,4,34,2,0,2,0.7,0.9,-0.2,19,ITA
53a0e358,35,2875,31.9,32,26,3,1,45,46,-1,42.4,45.3,-2.9,19,ITA
53de807a,28,2243,24.9,28,17,0,2,36,26,10,42.3,26.4,15.8,19,ITA
548902cc,22,1342,14.9,13,7,9,10,20,31,-11,19.6,25.0,-5.4,19,ITA
54ab361e,11,208,2.3,0,0,11,10,4,5,-1,2.8,3.1,-0.2,19,ITA
54c356b0,11,990,11.0,11,11,0,24,6,23,-17,13.9,18.3,-4.5,19,ITA
54e0c0cc,1,4,0.0,0,0,1,25,0,0,0,0.2,0.1,0.1,19,ITA
54e53b7e,21,1031,11.5,12,0,9,3,18,15,3,10.2,16.7,-6.5,19,ITA
550985aa,2,65,0.7,0,0,2,3,0,3,-3,0.5,1.5,-1.0,19,ITA
55667895,24,2010,22.3,22,21,2,12,31,19,12,27.5,25.5,2.0,19,ITA
56400c01,27,2266,25.2,24,22,3,10,22,37,-15,28.5,42.1,-13.6,19,ITA
56b2957b,12,896,10.0,10,5,2,2,12,11,1,11.2,13.3,-2.1,19,ITA
570bb4b9,32,2259,25.1,26,13,6,6,37,50,-13,35.2,48.8,-13.7,19,ITA
5710a281,16,1114,12.4,13,10,3,9,21,15,6,20.1,11.9,8.2,19,ITA
58027adc,18,1065,11.8,11,9,7,19,18,22,-4,12.9,18.7,-5.8,19,ITA
585a73a8,33,2922,32.5,33,31,0,0,36,56,-20,34.5,57.7,-23.2,19,ITA
58d97e77,19,603,6.7,6,1,13,18,8,12,-4,12.5,9.2,3.3,19,ITA
58e933d2,38,3066,34.1,33,24,5,0,35,53,-18,42.2,50.2,-8.0,19,ITA
59a3efba,3,44,0.5,0,0,3,26,2,0,2,1.2,0.0,1.2,19,ITA
59bf127b,31,2301,25.6,26,21,5,6,30,23,7,29.5,30.2,-0.7,19,ITA
5aa53281,30,2246,25.0,25,17,5,7,48,32,16,47.2,24.9,22.3,19,ITA
5aaef9ef,18,1535,17.1,17,14,1,0,20,33,-13,18.2,28.5,-10.3,19,ITA
5bd72174,38,3420,38.0,38,38,0,0,51,70,-19,52.4,63.6,-11.3,19,ITA
5bdd44d8,2,9,0.1,0,0,2,10,0,0,0,0.1,0.1,0.0,19,ITA
5cec2c74,35,2659,29.5,30,21,5,0,39,29,10,36.0,34.6,1.4,19,ITA
5d4f7d61,24,1314,14.6,15,6,9,11,29,16,13,24.4,17.7,6.6,19,ITA
5df4ef30,13,838,9.299999999999999,9,4,4,22,18,11,7,15.8,15.9,0.0,19,ITA
5e861944,36,2549,28.3,31,8,5,0,42,20,22,46.5,28.0,18.4,19,ITA
5eb72339,30,1915,21.3,22,15,8,7,20,33,-13,25.6,35.1,-9.5,19,ITA
5efc5389,11,830,9.2,9,8,2,14,7,14,-7,11.2,14.0,-2.7,19,ITA
5fd5ed86,5,183,2.0,2,1,3,33,3,3,0,2.4,2.8,-0.4,19,ITA
601ef102,16,970,10.8,11,3,5,2,16,15,1,14.3,19.3,-5.0,19,ITA
605873e1,27,1494,16.6,17,8,10,8,14,23,-9,18.0,26.1,-8.1,19,ITA
614c38fb,11,659,7.3,9,1,2,2,5,13,-8,8.7,10.7,-2.0,19,ITA
616aea37,27,2307,25.6,27,21,0,7,23,42,-19,24.5,41.6,-17.1,19,ITA
618ab91f,1,17,0.2,0,0,1,23,1,1,0,0.1,0.1,0.0,19,ITA
61b3978f,27,2200,24.4,24,22,3,6,40,33,7,29.2,36.1,-6.9,19,ITA
6213fd82,3,49,0.5,0,0,3,27,2,0,2,2.2,0.2,2.0,19,ITA
62437b4f,35,2178,24.2,24,10,11,1,22,30,-8,25.8,35.2,-9.4,19,ITA
63071a3f,38,3346,37.2,38,34,0,0,39,58,-19,39.0,62.5,-23.5,19,ITA
635b0bae,16,1183,13.1,13,11,3,21,11,26,-15,10.2,25.7,-15.5,19,ITA
6378443d,5,227,2.5,3,2,2,9,0,6,-6,1.7,3.3,-1.6,19,ITA
644faf10,5,208,2.3,2,0,3,27,3,2,1,1.9,1.8,0.1,19,ITA
649b01d8,36,3240,36.0,36,36,0,2,58,51,7,48.9,53.8,-4.8,19,ITA
64cd167d,34,2841,31.6,32,27,2,3,34,48,-14,37.4,44.7,-7.4,19,ITA
65e4dede,8,238,2.6,2,1,6,22,1,6,-5,3.1,4.6,-1.4,19,ITA
67f649be,33,2970,33.0,33,33,0,4,32,46,-14,41.7,44.7,-3.0,19,ITA
6817095b,1,1,0.0,0,0,1,9,0,0,0,0.0,0.0,0.0,19,ITA
68252d6d,31,2145,23.8,23,10,8,1,56,27,29,50.9,24.6,26.4,19,ITA
68b78c2a,19,1682,18.7,19,17,0,10,13,33,-20,18.9,28.4,-9.6,19,ITA
6928979a,35,3107,34.5,35,30,0,0,32,50,-18,36.6,56.8,-20.2,19,ITA
6aafdc27,10,739,8.2,9,6,1,11,6,20,-14,8.1,17.2,-9.1,19,ITA
6b99d135,18,1069,11.9,12,5,6,7,12,26,-14,13.2,22.8,-9.7,19,ITA
6c1f7328,25,1965,21.8,23,17,2,0,26,37,-11,24.6,37.6,-13.1,19,ITA
6cc97b6a,7,462,5.1,5,3,2,2,8,6,2,6.7,9.0,-2.3,19,ITA
6e058f06,1,1,0.0,0,0,1,1,0,0,0,0.0,0.0,0.0,19,ITA
6e4df551,35,2899,32.2,34,20,1,1,70,34,36,63.9,33.4,30.5,19,ITA
6eee05f1,24,1807,20.1,20,18,4,13,47,26,21,37.9,22.8,15.1,19,ITA
6fe90922,34,2701,30.0,30,22,4,4,43,30,13,51.2,31.5,19.6,19,ITA
714ffae7,1,45,0.5,0,0,1,2,0,0,0,0.3,0.2,0.1,19,ITA
71dac2c2,1,90,1.0,1,1,0,37,1,2,-1,1.0,1.7,-0.6,19,ITA
71dc23da,9,514,5.7,6,3,3,21,4,11,-7,5.5,9.1,-3.6,19,ITA
72c803a0,3,57,0.6,0,0,3,12,0,5,-5,0.2,1.3,-1.1,19,ITA
74419746,38,3420,38.0,38,38,0,0,57,33,24,63.8,38.3,25.6,19,ITA
75374ee7,1,16,0.2,0,0,1,15,0,0,0,0.0,0.3,-0.3,19,ITA
756959aa,28,1750,19.4,20,11,8,6,25,23,2,26.1,25.9,0.3,19,ITA
75b86fb3,24,1690,18.8,18,17,6,9,22,31,-9,21.6,33.9,-12.2,19,ITA
75e60d75,14,599,6.7,6,3,8,24,13,12,1,8.2,9.3,-1.1,19,ITA
75efed2e,17,377,4.2,2,0,15,14,3,5,-2,4.6,6.4,-1.8,19,ITA
7602ddf6,1,25,0.3,0,0,1,7,2,1,1,1.0,0.6,0.4,19,ITA
7737dee2,1,12,0.1,0,0,1,1,0,0,0,0.0,0.1,-0.1,19,ITA
77e401c7,1,90,1.0,1,1,0,32,3,3,0,2.1,2.6,-0.5,19,ITA
780e3631,12,235,2.6,1,0,11,26,8,6,2,5.5,3.8,1.7,19,ITA
78841da9,34,2650,29.4,29,22,5,4,59,28,31,48.3,32.2,16.2,19,ITA
788b31e2,14,975,10.8,10,10,4,20,9,18,-9,9.4,14.3,-4.9,19,ITA
79083382,20,1403,15.6,15,14,5,15,25,21,4,24.6,21.0,3.6,19,ITA
79443529,10,160,1.8,1,0,9,16,0,2,-2,3.7,1.1,2.6,19,ITA
7a20d90a,10,810,9.0,9,8,1,28,14,13,1,14.4,10.9,3.4,19,ITA
7afb1573,2,77,0.9,1,0,1,15,1,3,-2,0.6,0.8,-0.1,19,ITA
7b536033,35,2476,27.5,27,18,8,2,20,59,-39,25.8,43.6,-17.8,19,ITA
7b5f516f,1,1,0.0,0,0,1,37,0,0,0,0.0,0.0,0.0,19,ITA
7ba2eaa9,4,46,0.5,0,0,4,11,0,1,-1,0.4,0.3,0.1,19,ITA
7c0000fd,7,260,2.9,4,0,3,17,5,3,2,3.5,2.8,0.7,19,ITA
7d3cbc67,23,1607,17.9,18,11,5,12,10,36,-26,16.3,24.8,-8.5,19,ITA
7d50454d,24,2051,22.8,24,21,0,1,22,33,-11,25.7,39.1,-13.4,19,ITA
7d86864c,10,329,3.7,2,2,8,11,3,6,-3,3.5,5.2,-1.7,19,ITA
7e81a17d,16,400,4.4,2,1,14,6,7,3,4,5.6,7.0,-1.5,19,ITA
7eb97a8e,15,1139,12.7,13,8,2,0,20,16,4,20.1,11.5,8.5,19,ITA
7ed4921e,35,3064,34.0,35,32,0,0,37,47,-10,38.7,52.0,-13.3,19,ITA
7f267d66,20,995,11.1,10,6,10,15,6,13,-7,9.6,17.8,-8.1,19,ITA
7f50c23b,1,28,0.3,0,0,1,11,0,0,0,0.0,0.6,-0.5,19,ITA
7f622eef,14,892,9.9,9,6,5,1,3,22,-19,8.0,14.1,-6.1,19,ITA
7f78ad23,35,3047,33.9,35,30,0,2,49,32,17,41.9,36.6,5.2,19,ITA
7fd58fe3,35,2923,32.5,34,25,1,1,49,34,15,53.9,39.1,14.7,19,ITA
806f7a26,2,180,2.0,2,2,0,35,2,0,2,1.5,1.2,0.3,19,ITA
81255c03,34,2555,28.4,30,11,4,0,27,44,-17,32.7,48.9,-16.2,19,ITA
817c6964,33,2772,30.8,33,21,0,0,38,55,-17,41.2,52.1,-10.9,19,ITA
822a7761,22,1090,12.1,12,3,10,0,16,26,-10,17.7,18.7,-1.0,19,ITA
82b1198a,17,1457,16.2,16,15,1,16,25,20,5,25.1,16.3,8.8,19,ITA
82efe6fa,1,2,0.0,0,0,1,15,0,0,0,0.0,0.0,0.0,19,ITA
839c14e1,4,259,2.9,3,2,1,13,4,1,3,3.6,1.1,2.5,19,ITA
83e4643e,20,1166,13.0,12,4,8,0,15,25,-10,17.5,18.5,-0.9,19,ITA
84594618,18,1474,16.4,16,15,2,19,15,23,-8,16.1,25.2,-9.1,19,ITA
854ee61a,36,2339,26.0,26,14,10,2,42,33,9,38.0,35.7,2.3,19,ITA
85613cf0,35,2396,26.6,27,17,8,3,55,25,30,42.1,27.0,15.2,19,ITA
85b011bb,9,810,9.0,9,9,0,29,21,7,14,15.5,9.4,6.1,19,ITA
85ea4399,1,90,1.0,1,1,0,17,0,1,-1,0.9,1.7,-0.7,19,ITA
86015b20,9,529,5.9,6,4,3,5,5,14,-9,5.199999999999999,13.899999999999999,-8.8,19,ITA
8650af85,31,2790,31.0,31,31,0,6,45,45,0,38.7,45.1,-6.4,19,ITA
86695068,34,2890,32.1,33,27,1,0,50,39,11,43.0,43.8,-0.8,19,ITA
868c6958,1,5,0.1,0,0,1,3,0,0,0,0.0,0.0,0.0,19,ITA
8697c095,7,273,3.1,4,0,3,26,1,2,-1,3.3,3.1,0.2,19,ITA
878ee034,19,953,10.6,12,5,7,14,9,14,-5,12.0,16.3,-4.3,19,ITA
881ef58c,14,597,6.6,7,1,7,14,10,10,0,13.5,10.1,3.4,19,ITA
8827bf46,36,2426,27.0,27,12,9,1,35,29,6,38.3,28.9,9.5,19,ITA
88895312,34,2441,27.1,25,15,9,3,26,38,-12,33.4,37.9,-4.5,19,ITA
88c89891,17,1009,11.2,11,9,6,13,19,17,2,15.2,16.3,-1.0,19,ITA
895ff3ca,17,891,9.9,11,2,6,1,10,23,-13,9.4,16.8,-7.4,19,ITA
89976232,37,3271,36.3,37,34,0,0,50,32,18,44.0,43.8,0.1,19,ITA
89b2c8a9,35,2252,25.0,23,13,12,2,55,19,36,41.8,23.6,18.2,19,ITA
8a08491a,15,1277,14.2,15,12,0,0,17,16,1,21.1,11.3,9.8,19,ITA
8abd0c03,12,956,10.6,10,9,2,5,15,19,-4,11.4,18.2,-6.8,19,ITA
8b66d9cc,1,5,0.1,0,0,1,0,0,0,0,0.2,0.0,0.2,19,ITA
8b95acda,21,1762,19.6,21,18,0,16,32,24,8,30.2,26.6,3.5,19,ITA
8c725b43,32,2850,31.7,32,30,0,1,39,38,1,43.1,35.6,7.4,19,ITA
8cabdc1e,36,3213,35.7,36,35,0,1,51,56,-5,46.4,53.8,-7.4,19,ITA
8cc29864,19,1655,18.4,17,17,2,16,28,27,1,20.3,28.3,-8.1,19,ITA
8cea6319,30,2361,26.2,27,21,3,5,26,36,-10,30.9,33.0,-2.0,19,ITA
8d8178ac,28,2329,25.9,26,18,2,1,38,36,2,35.4,31.5,3.9,19,ITA
8e45910b,27,2102,23.4,24,19,3,9,17,45,-28,23.0,38.0,-15.0,19,ITA
8e809937,1,1,0.0,0,0,1,13,0,0,0,0.0,0.0,0.0,19,ITA
8f866fe8,18,812,9.0,8,4,10,0,18,16,2,14.3,13.6,0.7,19,ITA
8fef5412,12,500,5.6,4,1,8,15,8,3,5,7.4,6.8,0.5,19,ITA
905a4f61,8,257,2.9,2,1,6,13,1,4,-3,2.1,4.4,-2.3,19,ITA
9085dd7c,26,1703,18.9,17,15,9,4,19,27,-8,23.1,30.0,-6.9,19,ITA
90b70194,30,2156,24.0,25,15,5,5,22,43,-21,24.2,37.5,-13.3,19,ITA
91899ca8,29,2610,29.0,29,29,0,5,48,29,19,40.4,33.4,7.0,19,ITA
921f6058,30,2261,25.1,25,21,5,3,51,29,22,51.8,27.1,24.6,19,ITA
92948398,26,1452,16.1,17,10,9,5,15,19,-4,15.6,29.2,-13.6,19,ITA
92b4758e,21,1797,20.0,21,18,0,2,23,29,-6,20.5,29.6,-9.0,19,ITA
92d83c27,23,1176,13.1,13,5,10,14,15,24,-9,14.4,19.2,-4.7,19,ITA
93390969,20,921,10.2,9,5,11,17,11,14,-3,11.1,15.5,-4.4,19,ITA
933d3b51,17,1387,15.4,16,14,1,12,18,18,0,18.0,23.6,-5.6,19,ITA
93b891d1,28,1371,15.2,17,2,11,7,26,17,9,22.6,17.9,4.8,19,ITA
93cf32a8,36,3214,35.7,36,35,0,0,50,36,14,44.3,43.0,1.3,19,ITA
9413b19f,14,1151,12.8,13,12,1,11,28,9,19,21.2,12.6,8.6,19,ITA
94230890,1,90,1.0,1,1,0,0,1,2,-1,0.5,1.2,-0.7,19,ITA
94816803,2,20,0.2,0,0,2,11,0,0,0,0.4,0.1,0.3,19,ITA
952a03fe,22,1664,18.5,19,13,3,14,21,22,-1,18.8,29.8,-10.9,19,ITA
958a601f,19,1348,15.0,15,10,4,10,10,30,-20,15.2,22.4,-7.2,19,ITA
9592289a,29,1437,16.0,11,6,18,6,26,17,9,21.9,21.5,0.4,19,ITA
96960855,19,1124,12.5,14,4,5,15,13,25,-12,10.7,22.0,-11.3,19,ITA
970b8574,13,892,9.9,10,6,3,11,11,13,-2,9.9,12.6,-2.7,19,ITA
97e2aa67,2,106,1.2,2,0,0,14,2,6,-4,1.4,2.8,-1.4,19,ITA
9866afec,4,54,0.6,0,0,4,5,1,0,1,0.6,0.6,0.0,19,ITA
98d2c2c4,35,3022,33.6,35,25,0,2,61,38,23,60.4,34.6,25.8,19,ITA
98e958af,17,1196,13.3,15,7,2,2,20,23,-3,16.4,22.5,-6.0,19,ITA
9907b1c8,27,1766,19.6,20,9,7,10,35,23,12,33.8,27.6,6.3,19,ITA
997fff07,12,728,8.1,6,5,6,22,19,10,9,14.2,10.7,3.5,19,ITA
9a560ebe,7,538,6.0,7,5,0,5,9,12,-3,6.9,9.3,-2.4,19,ITA
9b30df1e,20,1725,19.2,19,19,1,11,16,32,-16,20.4,31.1,-10.7,19,ITA
9b6f7fd5,13,842,9.4,12,2,1,1,16,6,10,9.3,12.0,-2.7,19,ITA
9be4ee80,4,27,0.3,0,0,4,8,0,1,-1,0.4,0.2,0.2,19,ITA
9d4c45d6,28,1957,21.7,23,12,5,9,31,26,5,31.0,22.099999999999998,8.9,19,ITA
9e1577aa,36,3194,35.5,36,34,0,1,41,40,1,50.2,36.8,13.4,19,ITA
9f84febe,11,593,6.6,7,1,4,15,12,11,1,11.5,9.2,2.4,19,ITA
9fa26bc2,2,164,1.8,2,1,0,16,3,4,-1,2.5,3.4,-0.9,19,ITA
a111cf41,29,2610,29.0,29,29,0,8,31,40,-9,32.6,47.1,-14.4,19,ITA
a1216563,12,522,5.8,6,2,6,4,7,11,-4,8.7,8.5,0.2,19,ITA
a1bedc05,3,157,1.7,2,1,1,22,1,6,-5,0.6,2.7,-2.1,19,ITA
a1c7b425,10,302,3.4,3,0,7,17,0,9,-9,0.9,4.8,-3.9,19,ITA
a39b9ef6,16,703,7.8,8,1,8,20,7,15,-8,7.9,12.5,-4.6,19,ITA
a3d94a58,27,2336,26.0,27,24,0,0,23,35,-12,32.9,35.9,-2.9,19,ITA
a40d5a0c,13,668,7.4,6,3,7,9,12,13,-1,15.3,8.0,7.3,19,ITA
a440d8ca,2,95,1.1,1,1,1,14,1,2,-1,3.9,1.3,2.7,19,ITA
a4fe8cda,34,1457,16.2,12,9,22,2,20,13,7,20.2,17.8,2.5,19,ITA
a5296e55,36,2875,31.9,33,23,3,1,57,30,27,51.1,29.4,21.7,19,ITA
a64cbd35,31,2618,29.1,30,23,1,3,33,40,-7,31.5,49.9,-18.4,19,ITA
a65ce836,29,1811,20.1,20,16,9,1,35,15,20,30.2,19.7,10.6,19,ITA
a6e316c1,4,143,1.6,2,1,2,1,0,1,-1,1.5,1.9,-0.3,19,ITA
a6fc1a22,2,16,0.2,0,0,2,5,0,1,-1,0.0,0.0,0.0,19,ITA
a74d2999,9,204,2.3,1,0,8,3,1,2,-1,3.4,1.5,1.9,19,ITA
a8a874f1,29,1847,20.5,21,11,8,8,31,35,-4,27.2,30.3,-3.1,19,ITA
aa51343f,27,1299,14.4,15,4,12,6,13,14,-1,21.3,14.2,7.1,19,ITA
aa5a409a,32,2622,29.1,30,24,2,2,22,56,-34,26.3,50.0,-23.7,19,ITA
ab1ca213,21,1257,14.0,14,7,7,7,13,17,-4,19.8,18.0,1.8,19,ITA
ab4449d6,38,3420,38.0,38,38,0,0,48,56,-8,46.8,49.0,-2.2,19,ITA
ac4003af,35,3150,35.0,35,35,0,0,28,64,-36,34.1,58.2,-24.1,19,ITA
acdad0aa,13,404,4.5,4,0,9,15,4,7,-3,6.8,7.9,-1.0,19,ITA
ad6df2d5,31,2280,25.3,27,15,4,3,46,17,29,42.9,21.7,21.2,19,ITA
ae4e2852,22,1743,19.4,19,17,3,10,34,12,22,28.7,18.7,10.0,19,ITA
ae64d449,25,1682,18.7,20,9,5,12,19,25,-6,19.3,29.7,-10.4,19,ITA
ae82fa48,8,358,4.0,4,2,4,10,8,3,5,5.5,3.4,2.1,19,ITA
af45e954,5,139,1.5,0,0,5,11,1,0,1,0.5,4.6,-4.0,19,ITA
afa0d4e0,25,2014,22.4,23,15,2,2,44,12,32,37.7,20.5,17.2,19,ITA
afe31d55,3,81,0.9,1,0,2,7,1,5,-4,1.2,3.0,-1.8,19,ITA
b0243215,15,1145,12.7,13,12,2,18,19,20,-1,18.3,25.599999999999998,-7.300000000000001,19,ITA
b09a3ecc,31,1618,18.0,17,9,14,2,15,30,-15,19.6,29.5,-9.9,19,ITA
b0f7e36c,37,3034,33.7,34,29,3,0,41,40,1,47.0,37.6,9.4,19,ITA
b136c945,3,57,0.6,0,0,3,9,0,4,-4,0.2,0.9,-0.6,19,ITA
b1deecf8,13,1026,11.4,12,11,1,16,13,9,4,13.3,9.6,3.7,19,ITA
b32e8c5f,5,122,1.4,1,0,4,4,0,2,-2,0.9,2.2,-1.3,19,ITA
b3fd7075,30,1932,21.5,23,4,7,1,22,27,-5,23.1,25.3,-2.1,19,ITA
b5bf1770,15,1209,13.4,14,10,1,10,29,19,10,21.400000000000002,16.7,4.699999999999999,19,ITA
b5cae4e6,23,863,9.6,8,5,15,14,10,15,-5,11.3,16.2,-4.9,19,ITA
b6667741,3,144,1.6,1,1,2,7,0,1,-1,0.3,2.0,-1.7,19,ITA
b6b2b820,9,333,3.7,4,1,5,10,10,3,7,7.3,3.6,3.7,19,ITA
b6ca47a2,34,3060,34.0,34,34,0,0,48,62,-14,49.6,53.7,-4.1,19,ITA
b70bde8f,28,1972,21.9,23,11,5,7,29,40,-11,26.3,32.7,-6.4,19,ITA
b7a5bc86,35,2949,32.8,32,31,3,0,34,45,-11,37.7,42.3,-4.5,19,ITA
b8673e18,5,279,3.1,3,2,2,9,2,5,-3,5.1,5.1,0.0,19,ITA
b871bf55,12,910,10.1,9,7,3,2,10,16,-6,11.1,17.0,-5.8,19,ITA
b96b595c,37,3309,36.8,37,36,0,0,55,44,11,58.7,45.2,13.6,19,ITA
ba3d3bea,12,578,6.4,4,3,8,26,12,12,0,11.0,10.9,0.1,19,ITA
bbafc0c4,24,1807,20.1,23,13,1,4,23,15,8,20.9,26.2,-5.3,19,ITA
bd6351cd,25,1968,21.9,22,20,3,7,44,17,27,34.3,21.4,12.9,19,ITA
bd84fc61,28,1841,20.5,20,11,8,6,17,32,-15,22.3,27.1,-4.8,19,ITA
bdd0692f,16,644,7.2,5,2,11,21,9,10,-1,8.7,11.0,-2.3,19,ITA
be5e1c4c,13,168,1.9,0,0,13,6,4,4,0,4.7,5.2,-0.5,19,ITA
be6c1ccc,6,170,1.9,2,0,4,15,1,4,-3,3.1,3.6,-0.5,19,ITA
bee704fc,34,3008,33.4,34,32,0,1,36,37,-1,46.9,32.0,14.8,19,ITA
bef22bc4,3,92,1.0,1,0,2,1,1,0,1,0.8,0.4,0.4,19,ITA
bf309d24,13,661,7.3,8,3,5,14,15,5,10,13.2,6.1,7.1,19,ITA
c010b898,30,2483,27.6,29,26,1,2,17,48,-31,28.0,40.3,-12.3,19,ITA
c01c66d9,18,1139,12.7,11,8,7,19,15,20,-5,16.6,20.0,-3.3,19,ITA
c0c7ff58,27,1992,22.1,20,15,7,8,41,19,22,37.5,24.2,13.3,19,ITA
c0cddebe,31,2418,26.9,29,17,2,4,50,17,33,43.2,24.5,18.7,19,ITA
c1bcb2df,1,78,0.9,1,0,0,7,0,1,-1,0.7,2.3,-1.5,19,ITA
c1c2c925,25,1305,14.5,16,4,9,1,22,28,-6,17.5,22.200000000000003,-4.7,19,ITA
c1d18f10,14,1079,12.0,11,11,3,17,9,23,-14,9.9,17.0,-7.1,19,ITA
c316607a,3,147,1.6,3,1,0,8,3,1,2,1.7,0.5,1.2,19,ITA
c414df9d,24,1222,13.6,14,1,10,10,14,23,-9,15.2,19.8,-4.6,19,ITA
c4efe2b4,1,8,0.1,0,0,1,11,0,0,0,0.0,0.4,-0.3,19,ITA
c4f573f4,2,91,1.0,1,1,1,12,1,7,-6,0.7,4.1,-3.3,19,ITA
c53083ad,23,831,9.2,6,4,17,14,13,14,-1,12.7,13.0,-0.3,19,ITA
c56dc39e,21,1746,19.4,20,17,1,1,42,25,17,37.8,23.5,14.3,19,ITA
c5adc293,16,1154,12.8,12,9,4,11,28,12,16,21.1,11.7,9.4,19,ITA
c6e8cf1f,24,989,11.0,11,5,13,13,12,6,6,12.1,14.5,-2.4,19,ITA
c707411f,27,2324,25.8,27,23,0,3,51,32,19,46.9,36.9,10.1,19,ITA
c710f7d5,15,668,7.4,8,1,7,23,7,11,-4,10.9,11.5,-0.6,19,ITA
c7259b83,35,2918,32.4,33,27,2,0,33,41,-8,38.1,47.9,-9.8,19,ITA
c7526c18,30,2617,29.1,29,27,1,5,55,35,20,48.0,40.0,8.0,19,ITA
c77be0cf,26,1384,15.4,15,9,11,12,13,25,-12,17.3,23.1,-5.8,19,ITA
c8a88acd,2,180,2.0,2,2,0,35,3,4,-1,2.8,3.7,-0.9,19,ITA
c8c0dccd,1,33,0.4,0,0,1,0,0,2,-2,0.1,0.5,-0.4,19,ITA
cc700722,33,2616,29.1,28,26,5,0,57,29,28,45.8,30.5,15.3,19,ITA
cce9f582,19,1516,16.8,17,16,2,14,24,27,-3,23.6,25.7,-2.1,19,ITA
cd0fa27b,36,2884,32.0,34,19,2,0,43,25,18,40.8,35.1,5.7,19,ITA
cdf65d12,18,1508,16.8,18,15,0,6,21,24,-3,20.4,22.3,-1.9,19,ITA
ce1806be,23,816,9.1,9,2,14,13,5,20,-15,6.1,17.9,-11.8,19,ITA
ce30bfc8,19,1087,12.1,13,8,6,19,24,9,15,22.2,11.0,11.1,19,ITA
ce5b170a,5,270,3.0,3,1,2,21,3,2,1,2.2,4.1,-2.0,19,ITA
cecbce23,20,1724,19.2,19,19,1,18,15,27,-12,22.0,23.9,-1.9,19,ITA
cedb3e36,37,2968,33.0,34,19,3,0,33,48,-15,36.1,51.1,-15.1,19,ITA
cf961d8d,4,348,3.9,4,3,0,13,4,7,-3,3.2,10.6,-7.4,19,ITA
cfbf9881,23,2010,22.3,22,22,1,13,37,26,11,32.3,27.1,5.2,19,ITA
d023d70f,32,2507,27.9,30,16,2,3,45,35,10,34.8,38.9,-4.1,19,ITA
d0643f8f,7,175,1.9,2,0,5,24,3,5,-2,3.9,4.4,-0.5,19,ITA
d0d8dd44,28,2520,28.0,28,28,0,5,43,22,21,48.8,23.8,24.9,19,ITA
d0dbca9f,6,540,6.0,6,6,0,32,8,9,-1,9.2,8.7,0.5,19,ITA
d183e9d6,35,2934,32.6,34,29,1,0,53,47,6,46.3,50.2,-3.9,19,ITA
d37b0350,32,2734,30.4,31,26,1,2,30,40,-10,34.9,46.4,-11.5,19,ITA
d3aaad90,28,2104,23.4,23,15,5,4,43,24,19,39.1,30.3,8.8,19,ITA
d3d758d8,19,1361,15.1,17,8,2,4,12,15,-3,16.7,22.0,-5.3,19,ITA
d3de9af0,37,2896,32.2,32,24,5,0,67,40,27,63.0,35.6,27.4,19,ITA
d417b306,10,231,2.6,1,0,9,28,5,4,1,5.0,3.2,1.8,19,ITA
d4535821,26,2111,23.5,24,20,2,7,32,29,3,34.5,29.3,5.2,19,ITA
d541e703,31,2539,28.2,28,28,3,5,35,53,-18,37.2,46.8,-9.5,19,ITA
d5575935,8,198,2.2,1,0,7,9,3,1,2,4.4,2.2,2.2,19,ITA
d61b3354,16,1233,13.7,14,11,2,17,19,15,4,22.6,15.0,7.6,19,ITA
d6a889ea,24,1805,20.1,20,15,4,14,42,19,23,30.7,22.6,8.2,19,ITA
d705ba44,37,3299,36.7,37,35,0,0,51,35,16,45.0,46.1,-1.1,19,ITA
d711d04f,26,1122,12.5,12,3,14,10,18,18,0,18.2,17.6,0.7,19,ITA
d7403bd5,28,1510,16.8,19,5,9,6,20,29,-9,18.4,25.2,-6.8,19,ITA
d7d32194,17,493,5.5,5,0,12,14,9,12,-3,6.4,7.6,-1.2,19,ITA
d9624b51,15,994,11.0,11,8,4,23,12,15,-3,13.0,14.8,-1.8,19,ITA
d97f2e8d,33,2468,27.4,27,21,6,1,21,55,-34,25.1,45.7,-20.6,19,ITA
d995ed27,8,646,7.2,8,3,0,0,14,10,4,11.4,6.9,4.4,19,ITA
da5a981b,21,1518,16.9,16,13,5,14,26,23,3,24.1,22.0,2.0,19,ITA
da974c7b,35,3132,34.8,35,33,0,0,67,29,38,55.4,34.8,20.7,19,ITA
db092d3b,37,2961,32.9,32,28,5,0,44,60,-16,45.2,57.3,-12.0,19,ITA
dbe5a587,3,179,2.0,3,0,0,31,5,7,-2,2.7,4.7,-2.0,19,ITA
dc1c2fce,31,1486,16.5,15,7,16,7,25,16,9,22.5,19.9,2.6,19,ITA
dc61b402,10,323,3.6,3,0,7,12,2,4,-2,2.8,3.9,-1.1,19,ITA
dd52d069,1,6,0.1,0,0,1,11,0,0,0,0.5,0.0,0.5,19,ITA
dd7febd8,1,6,0.1,0,0,1,20,0,0,0,0.2,0.0,0.2,19,ITA
de045b15,28,2335,25.9,26,21,2,7,30,37,-7,28.9,35.1,-6.2,19,ITA
dea698d9,31,2688,29.9,30,28,1,1,59,20,39,50.6,28.7,22.0,19,ITA
df0a4c90,6,323,3.6,4,1,2,29,7,5,2,5.2,4.0,1.2,19,ITA
df301450,20,976,10.8,11,2,9,14,15,16,-1,12.3,9.9,2.4,19,ITA
df3cda47,3,105,1.2,0,0,3,12,1,3,-2,1.0,1.1,-0.1,19,ITA
df85d472,32,2065,22.9,23,16,9,3,24,33,-9,26.6,32.4,-5.8,19,ITA
dfb933e0,13,634,7.0,6,4,7,10,3,13,-10,9.3,10.1,-0.9,19,ITA
e0314d87,24,1836,20.4,22,15,2,8,34,23,11,35.6,21.1,14.4,19,ITA
e0921a4f,30,2137,23.7,24,18,6,3,42,21,21,37.1,22.0,15.1,19,ITA
e14ec482,35,1964,21.8,19,12,16,1,39,31,8,31.5,25.5,6.0,19,ITA
e1b0a70d,10,900,10.0,10,10,0,26,7,13,-6,12.8,13.4,-0.5999999999999999,19,ITA
e288d4b3,29,2180,24.2,24,16,5,3,40,28,12,41.7,31.9,9.7,19,ITA
e327bd76,24,1951,21.7,23,15,1,7,15,48,-33,21.3,36.8,-15.6,19,ITA
e33f36d5,27,2127,23.6,24,21,3,3,18,31,-13,24.7,38.2,-13.5,19,ITA
e34fc66d,32,2880,32.0,32,32,0,1,52,42,10,41.3,46.2,-5.0,19,ITA
e358587b,4,330,3.7,2,2,2,29,5,5,0,6.2,4.7,1.5,19,ITA
e3cceee6,14,1260,14.0,14,14,0,2,19,21,-2,15.8,23.7,-7.9,19,ITA
e468c053,30,2304,25.6,27,18,3,1,31,42,-11,29.8,43.1,-13.3,19,ITA
e50613bd,1,3,0.0,0,0,1,0,0,0,0,0.6,0.0,0.6,19,ITA
e599253a,33,1618,18.0,17,7,16,5,33,22,11,28.8,18.6,10.2,19,ITA
e5b98a70,14,1123,12.5,12,12,2,3,10,18,-8,15.0,19.0,-4.0,19,ITA
e5bf73f3,22,601,6.7,6,0,16,13,15,8,7,12.4,6.1,6.3,19,ITA
e5cd9da6,10,326,3.6,2,2,8,21,5,7,-2,6.1,6.4,-0.4,19,ITA
e6ad16b2,13,916,10.2,12,5,1,7,20,9,11,15.9,9.2,6.7,19,ITA
e74f0e59,32,2415,26.8,30,18,2,4,40,25,15,32.7,31.8,0.9,19,ITA
e7ee38c3,27,2430,27.0,27,27,0,9,50,42,8,48.1,39.5,8.6,19,ITA
e85fb9b8,25,1991,22.1,22,20,3,9,41,13,28,39.2,21.4,17.8,19,ITA
e8c930bb,23,1141,12.7,14,4,9,12,15,22,-7,16.8,15.6,1.2,19,ITA
e921b9db,1,90,1.0,1,1,0,23,1,2,-1,1.0,1.7,-0.6,19,ITA
e94d79e3,13,935,10.4,10,9,3,15,17,16,1,14.5,11.0,3.5,19,ITA
ea06dd97,34,2379,26.4,27,10,7,1,37,27,10,33.3,31.9,1.4,19,ITA
ea164f99,22,1459,16.2,17,4,5,3,20,27,-7,19.0,26.5,-7.5,19,ITA
eb2fe5b6,19,1441,16.0,16,11,3,0,19,19,0,20.8,19.6,1.1,19,ITA
eb823875,1,20,0.2,0,0,1,1,0,0,0,0.0,0.1,-0.1,19,ITA
ec5dae45,10,655,7.3,8,0,2,12,3,12,-9,4.8,10.9,-6.2,19,ITA
eccbe56a,23,1252,13.9,16,2,7,12,12,17,-5,14.9,19.9,-5.1,19,ITA
ed5886d2,34,2563,28.5,28,24,6,2,44,36,8,47.7,36.7,11.1,19,ITA
ed6ea4d9,13,463,5.1,4,1,9,6,6,5,1,8.0,7.1,1.0,19,ITA
ed90babd,18,538,6.0,6,0,12,11,9,4,5,9.0,4.6,4.4,19,ITA
eda40760,33,2906,32.3,32,31,1,0,60,41,19,56.7,45.7,10.9,19,ITA
edd6c8e9,26,2087,23.2,24,19,2,7,20,34,-14,23.0,40.3,-17.3,19,ITA
ee4f2f3b,37,3199,35.5,37,25,0,1,55,45,10,45.8,50.8,-5.1,19,ITA
ee833569,18,1620,18.0,18,18,0,20,37,25,12,31.7,19.7,11.9,19,ITA
ee93c1a9,28,1473,16.4,14,3,14,5,34,12,22,30.6,14.9,15.7,19,ITA
ef2e5e1a,1,90,1.0,1,1,0,0,1,0,1,1.2,0.6,0.6,19,ITA
ef5b337e,20,1054,11.7,10,6,10,14,19,12,7,14.5,16.1,-1.6,19,ITA
f0021247,20,1082,12.0,12,5,8,16,19,5,14,20.5,8.8,11.7,19,ITA
f02dde20,6,540,6.0,6,6,0,31,3,8,-5,3.2,7.8,-4.6,19,ITA
f058ed1f,3,203,2.3,2,2,1,34,2,4,-2,2.1,3.6,-1.5,19,ITA
f0f7f62f,20,1799,20.0,20,19,0,18,40,21,19,40.5,21.3,19.2,19,ITA
f1675fdd,3,184,2.0,2,1,1,33,1,1,0,1.7,1.6,0.1,19,ITA
f1cfc209,34,2799,31.1,32,25,2,1,43,32,11,37.0,41.8,-4.8,19,ITA
f1f1f238,14,835,9.3,8,7,6,20,7,18,-11,8.5,15.4,-6.9,19,ITA
f201798c,4,84,0.9,0,0,4,12,0,0,0,1.2,1.1,0.1,19,ITA
f26e3c59,20,651,7.2,6,3,14,18,11,9,2,11.1,5.5,5.7,19,ITA
f2c1300a,30,2470,27.4,27,25,3,5,38,31,7,41.3,28.2,13.1,19,ITA
f45f9427,11,778,8.6,9,7,2,23,15,8,7,13.1,7.3,5.7,19,ITA
f4ec4fd0,13,938,10.4,11,5,2,1,17,19,-2,13.4,16.1,-2.7,19,ITA
f503ea63,32,2646,29.4,30,22,2,2,47,38,9,40.6,43.3,-2.6,19,ITA
f54dfca8,8,507,5.6,5,4,3,10,0,11,-11,4.9,12.1,-7.2,19,ITA
f554e29b,38,3420,38.0,38,38,0,0,36,54,-18,42.1,62.1,-20.0,19,ITA
f6a06749,1,90,1.0,1,1,0,37,0,2,-2,0.5,0.7,-0.3,19,ITA
f7036e1c,27,1344,14.9,13,9,14,7,29,17,12,29.2,13.4,15.8,19,ITA
f7223718,15,1085,12.1,12,9,3,16,22,12,10,21.4,11.7,9.7,19,ITA
f794b426,4,360,4.0,4,4,0,27,7,10,-3,4.3,7.0,-2.7,19,ITA
f91e81c9,36,3234,35.9,36,34,0,0,36,51,-15,40.7,54.7,-14.1,19,ITA
fb2c533b,16,1081,12.0,11,7,5,20,22,19,3,13.8,15.0,-1.1,19,ITA
fb77bfef,27,2301,25.6,26,23,1,7,34,39,-5,29.1,36.1,-7.0,19,ITA
fba81826,17,1333,14.8,16,13,1,5,9,20,-11,13.0,20.4,-7.5,19,ITA
fcd20025,1,90,1.0,1,1,0,6,0,4,-4,0.5,2.0,-1.5,19,ITA
fe012aca,25,1443,16.0,14,7,11,2,22,27,-5,17.5,26.2,-8.6,19,ITA
fe0b8f0e,4,161,1.8,2,0,2,7,2,5,-3,1.8,4.9,-3.2,19,ITA
fe154b26,14,259,2.9,1,0,13,21,5,8,-3,4.7,3.4,1.3,19,ITA
fed5f993,35,3077,34.2,35,31,0,2,42,47,-5,41.5,43.0,-1.6,19,ITA
ff800ed8,35,2975,33.1,32,30,3,3,47,53,-6,42.3,49.2,-7.0,19,ITA
0118c54c,29,2298,25.5,26,20,3,5,39,29,10,27.5,34.0,-6.4,19,FRA
03bd0bf4,7,301,3.3,5,1,2,7,4,5,-1,4.5,4.2,0.4,19,FRA
0515a4cb,25,2095,23.3,25,21,0,6,17,47,-30,23.1,31.3,-8.2,19,FRA
0557ff4f,22,1548,17.2,18,10,4,5,15,17,-2,20.9,22.9,-2.0,19,FRA
05816e19,33,2175,24.2,24,12,9,1,18,33,-15,21.7,32.2,-10.4,19,FRA
0589c701,1,14,0.2,0,0,1,0,0,0,0,0.5,0.0,0.5,19,FRA
0630eb63,17,681,7.6,7,5,10,10,5,11,-6,7.0,11.8,-4.7,19,FRA
0670ee51,1,59,0.7,1,0,0,7,0,1,-1,0.8,0.2,0.6,19,FRA
06c48679,24,2010,22.3,23,19,1,6,11,30,-19,14.9,35.5,-20.7,19,FRA
06df8256,20,1762,19.6,20,19,0,5,20,33,-13,22.4,29.0,-6.6,19,FRA
06f33dc8,33,2260,25.1,28,10,5,1,17,35,-18,20.9,41.7,-20.8,19,FRA
07a821e4,2,169,1.9,2,1,0,2,4,1,3,4.5,1.3,3.2,19,FRA
08082af0,22,1591,17.7,19,17,3,3,27,23,4,21.4,28.8,-7.4,19,FRA
083525e5,4,175,1.9,2,1,2,6,0,8,-8,1.3,4.2,-2.9,19,FRA
095e4199,15,810,9.0,8,4,7,1,12,15,-3,11.8,13.3,-1.5,19,FRA
0984c5d5,19,833,9.3,8,4,11,15,4,9,-5,13.4,13.1,0.3,19,FRA
09f24df6,2,91,1.0,1,0,1,0,1,1,0,0.9,1.9,-1.0,19,FRA
0a63446f,11,571,6.3,6,6,5,11,7,16,-9,6.6,10.2,-3.5,19,FRA
0a89e877,22,1824,20.3,21,17,1,13,17,35,-18,21.0,27.9,-6.9,19,FRA
0aa874f4,36,3160,35.1,36,31,0,0,38,39,-1,36.0,42.3,-6.3,19,FRA
0b0cbe5b,35,2633,29.3,29,15,6,1,41,44,-3,39.5,41.8,-2.3,19,FRA
0b4d8274,27,1586,17.6,19,2,8,1,26,16,10,24.8,23.4,1.5,19,FRA
0bd57eb0,1,1,0.0,0,0,1,1,0,0,0,0.0,0.0,0.0,19,FRA
0be95d34,29,1343,14.9,15,6,14,9,21,27,-6,23.4,18.6,4.8,19,FRA
0c291a1a,10,550,6.1,7,2,3,4,8,10,-2,8.6,7.0,1.5,19,FRA
0d2158d5,26,1803,20.0,20,15,6,6,15,34,-19,19.2,29.8,-10.7,19,FRA
0e12089d,11,940,10.4,10,10,1,25,19,17,2,14.7,14.0,0.7,19,FRA
0e6bc38c,22,802,8.9,8,4,14,9,17,9,8,19.5,9.4,10.1,19,FRA
0eb03d5b,16,1377,15.3,15,14,1,13,15,11,4,17.2,22.6,-5.4,19,FRA
0ee664db,1,17,0.2,0,0,1,0,1,0,1,0.3,0.1,0.2,19,FRA
0eeafda5,10,804,8.9,9,8,1,7,10,12,-2,11.2,11.2,0.0,19,FRA
0f4c0bad,1,5,0.1,0,0,1,0,1,0,1,0.0,0.0,0.0,19,FRA
0f52f925,31,2496,27.7,28,26,3,5,36,40,-4,35.2,35.6,-0.4,19,FRA
0f8418aa,32,2665,29.6,30,24,2,3,42,35,7,28.6,36.5,-7.9,19,FRA
0fb21da9,5,313,3.5,4,3,1,6,3,6,-3,1.8,7.2,-5.4,19,FRA
0fe7f7bc,1,63,0.7,1,0,0,0,1,1,0,0.6,0.8,-0.2,19,FRA
1040e783,6,357,4.0,5,3,1,4,4,10,-6,2.8,8.2,-5.4,19,FRA
10650926,18,1293,14.4,14,9,4,2,11,26,-15,9.6,24.8,-15.1,19,FRA
11ced928,21,1243,13.8,13,6,8,6,11,16,-5,20.5,19.8,0.7,19,FRA
132a82f1,2,161,1.8,1,1,1,2,4,1,3,3.6,3.3,0.3,19,FRA
132bb875,8,713,7.9,7,7,1,26,10,12,-2,10.1,10.6,-0.6,19,FRA
1467af0d,26,1879,20.9,23,12,3,2,52,18,34,48.2,16.9,31.3,19,FRA
148e136f,34,2997,33.3,34,31,0,0,53,33,20,50.6,41.4,9.2,19,FRA
15e1afd5,2,180,2.0,2,2,0,11,1,1,0,1.6,2.0,-0.3,19,FRA
15e99107,6,162,1.8,2,0,4,2,1,4,-3,1.9,2.6,-0.7,19,FRA
16324e1d,33,2924,32.5,33,32,0,0,48,48,0,43.3,49.3,-6.0,19,FRA
166a981d,9,503,5.6,6,5,3,17,6,7,-1,6.4,8.6,-2.2,19,FRA
16714a62,23,1994,22.2,22,20,1,10,16,32,-16,18.3,28.1,-9.7,19,FRA
167d5018,27,2426,27.0,27,26,0,7,20,50,-30,26.6,40.6,-14.0,19,FRA
171bf11d,5,50,0.6,0,0,5,4,0,1,-1,1.5,0.3,1.2,19,FRA
176674ab,15,465,5.2,4,1,11,11,7,12,-5,6.6,9.5,-2.9,19,FRA
17f29fb0,1,10,0.1,0,0,1,3,1,1,0,0.2,0.2,0.0,19,FRA
19053e31,13,741,8.2,9,4,4,6,5,13,-8,7.7,11.6,-3.9,19,FRA
19a12bed,16,926,10.3,9,8,7,9,14,9,5,11.6,11.8,-0.2,19,FRA
19cda00b,30,2324,25.8,28,12,2,1,70,20,50,55.1,25.1,30.0,19,FRA
19f8e480,25,1986,22.1,22,21,3,7,22,28,-6,23.6,33.2,-9.5,19,FRA
1a4b9094,29,2242,24.9,25,20,4,4,35,36,-1,33.7,29.5,4.1,19,FRA
1a6f2a66,6,240,2.7,3,0,3,4,2,5,-3,3.3,2.9,0.4,19,FRA
1a992676,31,2046,22.7,22,15,9,1,65,26,39,52.3,24.4,27.9,19,FRA
1ad8cb67,32,2815,31.3,32,29,0,1,54,39,15,32.8,41.9,-9.1,19,FRA
1b82f8df,18,1298,14.4,15,10,3,2,17,18,-1,15.6,21.3,-5.7,19,FRA
1bfb6fef,9,633,7.0,7,6,2,11,7,9,-2,7.5,9.1,-1.6,19,FRA
1c344204,33,2805,31.2,30,29,3,2,24,50,-26,33.3,46.8,-13.5,19,FRA
1d2d5cc8,31,2735,30.4,31,29,0,1,42,40,2,41.0,35.5,5.5,19,FRA
1ec7e1c5,33,2874,31.9,32,31,1,1,47,42,5,48.4,39.6,8.7,19,FRA
1ef37668,15,1261,14.0,14,14,1,1,12,14,-2,15.5,14.6,0.9,19,FRA
1f8c7aa9,17,788,8.8,8,2,9,3,3,17,-14,8.1,13.1,-5.0,19,FRA
20094685,32,2180,24.2,25,12,7,6,38,24,14,34.3,24.2,10.1,19,FRA
2054d037,29,1793,19.9,19,9,10,2,29,22,7,26.9,22.8,4.1,19,FRA
20730eae,24,1287,14.3,16,0,8,3,20,7,13,22.3,12.7,9.6,19,FRA
20e73fac,34,2425,26.9,28,13,6,2,37,39,-2,35.4,35.9,-0.5,19,FRA
22721b88,28,2177,24.2,24,20,4,4,40,34,6,33.1,31.0,2.1,19,FRA
22a62523,1,3,0.0,0,0,1,7,0,1,-1,0.2,0.5,-0.3,19,FRA
22bfb57e,25,1029,11.4,11,2,14,7,9,11,-2,12.9,13.5,-0.5,19,FRA
23593121,12,520,5.8,5,1,7,0,6,11,-5,5.3,8.3,-3.0,19,FRA
2384dbed,1,8,0.1,0,0,1,1,0,0,0,0.8,0.0,0.8,19,FRA
23c63b7f,20,1036,11.5,9,3,11,2,10,11,-1,16.5,16.8,-0.3,19,FRA
242b350c,2,3,0.0,0,0,2,7,0,0,0,0.1,0.0,0.1,19,FRA
2434f24a,37,3330,37.0,37,37,0,1,33,42,-9,37.9,52.4,-14.5,19,FRA
243f4a0b,33,2875,31.9,33,27,0,2,28,32,-4,32.4,45.1,-12.8,19,FRA
244bc2c8,18,747,8.3,8,0,10,1,9,11,-2,10.3,10.8,-0.5,19,FRA
247accfd,34,2942,32.7,32,31,2,4,24,45,-21,26.8,43.0,-16.2,19,FRA
249cdcff,2,180,2.0,2,2,0,30,2,1,1,2.9,2.1,0.8,19,FRA
24eb7ed6,30,926,10.3,7,2,23,5,12,10,2,13.8,13.9,0.0,19,FRA
2515040a,21,1862,20.7,20,19,1,6,18,29,-11,18.3,31.3,-12.9,19,FRA
26383ea5,6,495,5.5,6,5,0,16,8,4,4,9.8,4.8,5.1,19,FRA
26777636,7,216,2.4,2,0,5,3,0,2,-2,2.0,2.9,-1.0,19,FRA
2677a1de,32,2817,31.3,32,24,0,0,43,34,9,43.8,40.6,3.2,19,FRA
26975a92,36,3239,36.0,36,35,0,0,42,48,-6,47.8,45.7,2.1,19,FRA
275e2c51,28,2394,26.6,27,25,1,8,31,32,-1,36.1,32.4,3.7,19,FRA
276cce2e,36,3240,36.0,36,36,0,2,28,59,-31,40.1,48.8,-8.7,19,FRA
279ddf6a,36,3240,36.0,36,36,0,0,36,39,-3,35.7,41.0,-5.2,19,FRA
28129034,12,736,8.2,7,6,5,3,4,12,-8,4.3,17.7,-13.4,19,FRA
288e1e13,13,1050,11.7,12,10,1,7,11,17,-6,11.1,15.9,-4.8,19,FRA
28a65a2c,1,90,1.0,1,1,0,37,1,1,0,1.6,2.1,-0.6,19,FRA
28dabd43,38,3420,38.0,38,38,0,0,57,58,-1,50.0,56.5,-6.5,19,FRA
29c02c9f,17,918,10.2,9,7,8,4,26,15,11,22.9,12.0,10.9,19,FRA
29d8ad3f,25,1936,21.5,25,18,0,0,21,23,-2,24.6,28.7,-4.0,19,FRA
29ef0f49,28,1444,16.0,15,9,13,5,15,23,-8,16.0,21.4,-5.4,19,FRA
2a657da0,34,2095,23.3,24,8,10,1,22,22,0,21.9,24.8,-2.9,19,FRA
2b16cb1a,34,2900,32.2,34,21,0,0,28,29,-1,41.2,41.1,0.2,19,FRA
2b9fdeea,33,2613,29.0,30,16,3,0,49,39,10,40.1,34.4,5.8,19,FRA
2c92d3c0,27,1456,16.2,15,8,12,9,12,17,-5,14.8,18.5,-3.8,19,FRA
2d22cea7,1,4,0.0,0,0,1,11,0,0,0,0.0,0.0,0.0,19,FRA
2e0367a6,35,2286,25.4,25,12,10,0,24,33,-9,29.9,33.6,-3.7,19,FRA
2e52206e,21,1436,16.0,19,5,2,6,16,24,-8,17.6,21.1,-3.5,19,FRA
2ef637bd,18,950,10.6,11,7,7,6,20,11,9,15.7,15.5,0.1,19,FRA
2f8f43f3,7,407,4.5,5,1,2,7,2,8,-6,2.8,9.0,-6.2,19,FRA
2f965a72,21,1890,21.0,21,21,0,13,55,17,38,48.2,20.4,27.8,19,FRA
2fa2a875,37,3330,37.0,37,37,0,0,53,42,11,49.6,41.0,8.5,19,FRA
3010aefb,33,1840,20.4,21,8,12,1,17,41,-24,22.3,25.0,-2.7,19,FRA
30395d3b,25,1666,18.5,18,12,7,0,11,28,-17,18.6,23.9,-5.3,19,FRA
3067cbef,12,782,8.7,8,8,4,20,16,10,6,11.9,10.9,1.0,19,FRA
3071a619,26,1536,17.1,17,9,9,1,16,24,-8,21.2,20.2,1.0,19,FRA
31a62dc7,34,2971,33.0,34,29,0,1,60,26,34,51.7,35.8,15.9,19,FRA
32c2d95f,38,3420,38.0,38,38,0,0,39,42,-3,38.1,45.0,-6.9,19,FRA
33508c78,13,966,10.7,12,8,1,0,13,16,-3,13.6,13.4,0.2,19,FRA
33887998,38,3420,38.0,38,38,0,0,39,42,-3,38.1,45.0,-6.9,19,FRA
3681cfff,33,2937,32.6,33,32,0,1,27,26,1,38.4,40.8,-2.4,19,FRA
3708e9fa,30,2290,25.4,27,14,3,0,26,36,-10,29.9,31.2,-1.2,19,FRA
375622c5,28,1990,22.1,22,15,6,7,38,32,6,32.2,31.8,0.4,19,FRA
3767b3b7,16,1015,11.3,10,8,6,10,18,15,3,14.4,15.100000000000001,-0.7,19,FRA
378825c7,25,2152,23.9,24,21,1,1,33,33,0,34.6,28.3,6.2,19,FRA
380a15e2,1,90,1.0,1,1,0,30,0,0,0,0.5,0.8,-0.3,19,FRA
392d98fc,8,74,0.8,0,0,8,5,0,3,-3,1.3,1.0,0.4,19,FRA
397ba086,1,2,0.0,0,0,1,1,0,0,0,0.0,0.0,0.0,19,FRA
39901146,10,434,4.8,3,0,7,0,5,10,-5,6.1,6.6,-0.5,19,FRA
3acddfdd,8,134,1.5,0,0,8,1,2,3,-1,2.7,2.6,0.1,19,FRA
3befc2b6,20,1475,16.4,18,12,2,2,25,16,9,22.6,17.1,5.5,19,FRA
3cefcaef,30,2531,28.1,27,26,3,1,52,34,18,51.5,33.4,18.1,19,FRA
3d3b0206,11,239,2.7,2,0,9,8,6,5,1,3.4,4.0,-0.6,19,FRA
3dd738a1,29,2528,28.1,29,26,0,0,39,30,9,37.7,31.8,5.8,19,FRA
3e092724,29,2360,26.2,27,22,2,1,20,22,-2,30.1,32.4,-2.3,19,FRA
3e87d087,16,1119,12.4,12,8,4,4,9,17,-8,8.5,23.4,-15.0,19,FRA
3eaf8817,35,2024,22.5,21,9,14,2,40,27,13,28.4,30.5,-2.1,19,FRA
3ef0fa48,16,1389,15.4,16,12,0,0,18,19,-1,21.8,19.3,2.5,19,FRA
3f5b4635,37,3292,36.6,37,36,0,0,51,41,10,48.8,39.9,8.9,19,FRA
403f5d20,14,863,9.6,10,7,4,14,4,12,-8,9.2,12.5,-3.3,19,FRA
41e7ef1c,19,1010,11.2,11,3,8,3,32,13,19,27.7,9.5,18.2,19,FRA
4207e578,30,1973,21.9,23,12,7,0,20,25,-5,20.0,27.0,-6.9,19,FRA
42c8ede1,4,56,0.6,0,0,4,2,2,1,1,1.6,0.1,1.5,19,FRA
42e8eba2,3,107,1.2,1,0,2,12,0,3,-3,0.4,3.0,-2.6,19,FRA
42eaa028,38,2796,31.1,34,12,4,0,49,25,24,46.0,32.8,13.3,19,FRA
42fd9c7f,29,2343,26.0,24,22,5,0,81,21,60,67.2,23.5,43.7,19,FRA
4315f30d,35,2994,33.3,34,32,1,2,27,29,-2,40.2,45.2,-5.0,19,FRA
433dc9a2,25,1836,20.4,21,15,4,0,55,15,40,46.7,20.6,26.1,19,FRA
43af5b1b,1,5,0.1,0,0,1,0,0,0,0,0.3,0.2,0.1,19,FRA
43e7a164,31,2754,30.6,31,30,0,1,19,40,-21,27.2,47.2,-19.9,19,FRA
44f8c299,18,1188,13.2,17,6,1,5,9,17,-8,13.0,17.0,-4.0,19,FRA
450e277f,30,2490,27.7,28,26,2,3,28,34,-6,33.1,35.7,-2.7,19,FRA
462475ed,25,1531,17.0,18,6,7,3,22,25,-3,17.6,23.3,-5.7,19,FRA
46291841,16,984,10.9,10,6,6,17,10,16,-6,13.8,17.3,-3.5,19,FRA
468fdbad,23,2059,22.9,23,21,0,1,36,28,8,24.6,26.6,-2.1,19,FRA
46907171,33,2246,25.0,25,8,8,0,32,31,1,29.6,30.3,-0.7,19,FRA
469d3d84,3,32,0.4,0,0,3,4,0,0,0,1.0,1.3,-0.2,19,FRA
46d50339,14,885,9.8,11,7,3,9,9,7,2,10.5,13.8,-3.2,19,FRA
4749367a,4,292,3.2,4,1,0,14,2,4,-2,3.5,4.1,-0.6,19,FRA
475583ff,20,1329,14.8,14,13,6,18,19,29,-10,20.4,23.8,-3.4,19,FRA
47af88b8,31,2754,30.6,31,29,0,2,55,43,12,60.7,36.7,24.0,19,FRA
4887118d,7,276,3.1,3,0,4,3,2,3,-1,2.9,3.2,-0.2,19,FRA
48b28bfd,17,1075,11.9,12,7,5,5,10,13,-3,15.6,13.9,1.7,19,FRA
49000148,9,721,8.0,9,4,0,1,7,12,-5,8.8,13.0,-4.1,19,FRA
4914ed4a,19,1429,15.9,16,10,3,0,17,17,0,21.1,19.9,1.3,19,FRA
4a57580c,23,1482,16.5,16,9,7,2,22,21,1,23.9,22.1,1.8,19,FRA
4b96c347,31,1635,18.2,18,4,13,2,25,29,-4,26.1,21.5,4.6,19,FRA
4be0b467,30,1591,17.7,19,2,11,1,25,17,8,28.3,21.4,6.9,19,FRA
4bf69118,30,2040,22.7,22,18,8,4,26,28,-2,27.5,27.2,0.2,19,FRA
4c5b714f,26,2076,23.1,22,22,4,0,21,36,-15,30.4,31.0,-0.6,19,FRA
4c700f46,22,1278,14.2,12,11,10,8,18,25,-7,21.1,17.8,3.3,19,FRA
4d1666ff,37,3330,37.0,37,37,0,0,34,41,-7,39.2,52.6,-13.5,19,FRA
4d3e9033,4,360,4.0,4,4,0,33,8,5,3,6.5,3.2,3.4,19,FRA
4db2157a,20,1669,18.5,19,13,1,0,28,22,6,26.4,22.5,4.0,19,FRA
4e7bfc23,20,1076,12.0,15,4,5,8,9,25,-16,10.4,21.6,-11.2,19,FRA
4f255115,10,704,7.8,8,4,2,7,6,6,0,8.3,9.4,-1.0,19,FRA
4fdf1fd9,33,2970,33.0,33,33,0,0,33,36,-3,34.0,38.4,-4.4,19,FRA
5046b7d4,32,2469,27.4,31,6,1,0,31,28,3,33.7,33.4,0.3,19,FRA
5113d9a7,9,717,8.0,7,7,2,3,5,19,-14,8.0,15.4,-7.4,19,FRA
51450467,1,15,0.2,0,0,1,7,2,0,2,0.9,0.1,0.8,19,FRA
5148dcc5,32,1486,16.5,16,5,16,4,36,21,15,35.9,20.6,15.4,19,FRA
516dc25b,23,1443,16.0,16,11,7,9,10,20,-10,17.4,20.7,-3.4,19,FRA
51c30111,13,1053,11.7,12,11,1,1,13,20,-7,10.0,20.9,-10.9,19,FRA
51dbeea9,27,1902,21.1,19,17,8,4,64,23,41,52.2,23.7,28.5,19,FRA
527f063d,21,1671,18.6,20,14,1,2,57,15,42,45.0,20.1,24.9,19,FRA
5314e067,25,1895,21.1,23,14,2,3,28,36,-8,23.8,37.3,-13.6,19,FRA
53283127,5,168,1.9,2,0,3,7,1,4,-3,0.9,1.8,-0.9,19,FRA
542cc80f,35,1789,19.9,18,13,17,1,28,22,6,23.1,24.6,-1.5,19,FRA
56f7a928,20,1680,18.7,20,15,0,0,18,30,-12,20.5,23.6,-3.1,19,FRA
574aa9ec,3,136,1.5,1,1,2,4,1,1,0,1.9,2.1,-0.2,19,FRA
57c433c8,2,144,1.6,2,0,0,1,2,2,0,0.7,1.5,-0.8,19,FRA
57e3f0c7,38,3324,36.9,37,28,1,0,66,28,38,57.8,39.0,18.9,19,FRA
58ae47b2,31,1904,21.2,23,8,8,3,33,31,2,31.7,25.8,5.9,19,FRA
5b54bf3b,16,691,7.7,9,2,7,11,6,10,-4,7.2,10.2,-3.1,19,FRA
5b5724d2,23,1727,19.2,20,15,3,1,32,25,7,20.2,27.7,-7.6,19,FRA
5c2da10f,26,1204,13.4,14,2,12,3,33,14,19,23.6,17.1,6.6,19,FRA
5c4dc0ff,3,143,1.6,2,0,1,0,2,1,1,2.0,0.8,1.2,19,FRA
5cdddffa,34,2690,29.9,31,26,3,3,56,35,21,58.2,34.3,23.8,19,FRA
5d42d487,5,209,2.3,3,0,2,4,1,5,-4,1.6,2.4,-0.8,19,FRA
5d59e0df,19,1369,15.2,16,6,3,0,24,22,2,18.3,19.2,-0.9,19,FRA
5d8d7454,34,2916,32.4,33,31,1,0,27,45,-18,28.0,53.6,-25.6,19,FRA
5e22e2a4,38,3245,36.1,37,33,1,0,38,48,-10,46.2,45.3,0.9,19,FRA
5ee6e943,21,1890,21.0,21,21,0,13,16,34,-18,22.2,31.5,-9.3,19,FRA
5f4ce4b6,14,720,8.0,9,2,5,13,8,12,-4,8.2,14.0,-5.8,19,FRA
6043997c,8,539,6.0,6,5,2,7,9,12,-3,7.9,10.3,-2.5,19,FRA
60d90c55,38,3420,38.0,38,38,0,0,29,54,-25,31.0,63.8,-32.8,19,FRA
61590953,12,698,7.8,8,5,4,15,18,9,9,14.9,6.4,8.5,19,FRA
6191093d,34,2372,26.4,27,15,7,2,20,42,-22,26.6,35.2,-8.6,19,FRA
62a54183,1,1,0.0,0,0,1,8,0,0,0,0.0,0.0,0.0,19,FRA
63a10528,6,204,2.3,2,1,4,2,3,5,-2,1.9,4.4,-2.5,19,FRA
6421dd73,35,2469,27.4,30,11,5,0,23,42,-19,29.5,38.4,-8.9,19,FRA
6453830e,1,1,0.0,0,0,1,3,0,0,0,0.0,0.0,0.0,19,FRA
6481421d,28,1600,17.8,18,7,10,2,20,19,1,18.5,19.8,-1.3,19,FRA
64ba07c0,4,355,3.9,4,3,0,3,7,2,5,5.9,3.7,2.2,19,FRA
65391fa7,2,92,1.0,1,1,1,2,2,1,1,1.0,1.6,-0.5,19,FRA
66116290,33,2557,28.4,29,18,4,0,29,45,-16,36.2,37.1,-0.9,19,FRA
6644712a,1,12,0.1,0,0,1,3,0,0,0,0.2,0.0,0.2,19,FRA
6690ef25,31,2667,29.6,31,29,0,0,41,24,17,40.0,25.9,14.2,19,FRA
677ee102,23,1431,15.9,15,10,8,9,12,28,-16,17.6,25.7,-8.1,19,FRA
67ac5bb8,14,1066,11.8,11,11,3,7,22,5,17,19.0,10.3,8.7,19,FRA
67b7357e,9,411,4.6,6,4,3,9,2,6,-4,4.5,6.5,-2.0,19,FRA
68a87d66,13,442,4.9,4,1,9,6,6,2,4,8.4,5.4,3.0,19,FRA
69384e5d,17,1439,16.0,16,11,1,0,50,14,36,37.3,17.6,19.7,19,FRA
698b37b8,1,19,0.2,0,0,1,1,0,0,0,0.8,0.0,0.7,19,FRA
6a189491,7,593,6.6,7,4,0,2,9,9,0,10.7,8.0,2.7,19,FRA
6a827d8e,29,2263,25.1,25,23,4,0,21,21,0,33.1,31.2,1.9,19,FRA
6b200d45,31,2700,30.0,31,29,0,1,44,33,11,43.3,41.7,1.6,19,FRA
6b2c894b,20,1800,20.0,20,20,0,0,16,19,-3,18.3,21.9,-3.6,19,FRA
6b9f2f3e,6,449,5.0,3,3,3,13,4,8,-4,4.0,6.4,-2.4,19,FRA
6bca20fe,12,850,9.4,10,6,2,9,11,16,-5,13.2,15.0,-1.8,19,FRA
6bde367b,32,2864,31.8,32,30,0,0,51,48,3,42.8,45.8,-3.0,19,FRA
6c6ecdd4,7,455,5.1,6,1,1,0,4,9,-5,4.6,9.5,-4.9,19,FRA
6c8ddd52,1,14,0.2,0,0,1,4,0,0,0,0.5,0.2,0.3,19,FRA
6c9642ae,8,357,4.0,4,2,4,13,1,6,-5,3.0,5.7,-2.7,19,FRA
6ca88b2a,22,1935,21.5,21,21,1,7,19,32,-13,24.9,32.0,-7.1,19,FRA
6e2c94ad,25,1235,13.7,14,2,11,11,21,23,-2,19.7,20.1,-0.4,19,FRA
6e5b5a45,34,3024,33.6,34,31,0,1,26,51,-25,35.7,51.4,-15.7,19,FRA
6e7f1353,33,2403,26.7,27,17,6,2,49,34,15,36.7,28.8,7.9,19,FRA
6ed1a2a2,31,1843,20.5,21,7,10,6,18,30,-12,26.5,26.3,0.3,19,FRA
6f8cd6d0,32,2571,28.6,32,20,0,0,22,56,-34,31.8,40.1,-8.2,19,FRA
6fb7edd3,1,14,0.2,0,0,1,1,0,1,-1,0.0,1.1,-1.1,19,FRA
6fbde63a,2,160,1.8,2,0,0,0,3,1,2,2.1,1.7,0.4,19,FRA
6fea4e00,1,90,1.0,1,1,0,0,2,1,1,0.7,2.3,-1.6,19,FRA
6ff8ef56,18,627,7.0,5,0,13,6,12,7,5,10.8,7.2,3.5,19,FRA
706a60e1,14,952,10.6,10,2,4,1,8,11,-3,11.8,12.5,-0.8,19,FRA
71ec39ef,30,1727,19.2,20,11,10,5,35,22,13,34.1,18.5,15.6,19,FRA
743fdcd3,8,469,5.2,4,2,4,6,3,12,-9,6.4,8.5,-2.1,19,FRA
745ca0a3,1,90,1.0,1,1,0,1,0,2,-2,0.6,1.1,-0.4,19,FRA
74dc806c,26,2033,22.6,23,16,3,2,30,30,0,32.2,26.4,5.7,19,FRA
76806215,9,682,7.6,7,7,2,29,18,12,6,11.7,10.1,1.6,19,FRA
76c131da,3,23,0.3,0,0,3,2,0,0,0,0.1,0.3,-0.3,19,FRA
770d7eb8,34,3060,34.0,34,34,0,0,56,42,14,39.1,44.8,-5.7,19,FRA
775185ae,20,627,7.0,6,0,14,6,10,4,6,8.4,8.7,-0.3,19,FRA
7768df30,33,2647,29.4,29,28,4,5,21,50,-29,33.6,40.5,-6.9,19,FRA
779847d6,24,2160,24.0,24,24,0,6,31,28,3,31.7,27.1,4.5,19,FRA
77cf6852,35,2974,33.0,33,32,2,2,28,43,-15,31.7,43.9,-12.2,19,FRA
77d7c96f,13,1048,11.6,12,9,1,11,22,18,4,24.0,10.0,14.0,19,FRA
77f278a0,17,364,4.0,3,0,14,11,9,6,3,7.1,4.5,2.7,19,FRA
79135368,36,3240,36.0,36,36,0,0,28,54,-26,29.7,60.8,-31.1,19,FRA
79584585,3,159,1.8,2,0,1,6,6,0,6,3.5,1.5,2.0,19,FRA
7961f7aa,19,938,10.4,10,4,9,2,6,19,-13,9.0,19.1,-10.1,19,FRA
796b1c41,25,1353,15.0,17,1,8,7,13,26,-13,10.1,26.8,-16.6,19,FRA
797f6070,2,116,1.3,2,0,0,2,0,2,-2,1.8,1.8,0.0,19,FRA
79b2399c,26,1842,20.5,21,14,5,4,27,29,-2,31.4,27.0,4.4,19,FRA
7a137df4,1,5,0.1,0,0,1,6,1,0,1,0.5,0.0,0.5,19,FRA
7add56e1,1,90,1.0,1,1,0,2,1,2,-1,1.3,2.0,-0.7,19,FRA
7b075c75,20,1723,19.1,20,17,0,2,35,19,16,30.3,21.9,8.4,19,FRA
7b9a86e6,15,468,5.2,3,1,12,7,4,6,-2,4.7,7.4,-2.7,19,FRA
7b9a9e25,25,1050,11.7,11,1,14,11,23,11,12,20.2,16.5,3.7,19,FRA
7b9c2d84,7,364,4.0,4,1,3,7,8,5,3,8.1,7.1,1.0,19,FRA
7c2965bb,24,1849,20.5,22,12,2,0,24,31,-7,26.4,28.9,-2.5,19,FRA
7c56da38,22,1156,12.8,13,7,9,14,35,9,26,33.8,11.3,22.5,19,FRA
7c6d6c96,30,2620,29.1,30,28,0,0,25,44,-19,29.1,40.4,-11.2,19,FRA
7cab69b5,25,2224,24.7,25,23,0,6,26,37,-11,28.8,35.7,-6.9,19,FRA
7cdda3bf,37,2985,33.2,36,16,1,0,45,32,13,41.300000000000004,33.4,7.8999999999999995,19,FRA
7cf431a5,24,1220,13.6,14,5,10,4,14,17,-3,19.3,16.6,2.8,19,FRA
7d937aa1,30,2153,23.9,24,17,6,8,36,34,2,31.9,36.3,-4.4,19,FRA
7d9b37bf,19,629,7.0,6,1,13,8,9,13,-4,9.8,14.7,-4.9,19,FRA
7e82a78f,32,2564,28.5,31,12,1,0,41,32,9,35.8,30.6,5.2,19,FRA
7f622eef,7,217,2.4,2,1,5,12,3,4,-1,5.0,4.3,0.7,19,FRA
7fb301af,3,119,1.3,1,1,2,3,1,2,-1,1.1,1.8,-0.7,19,FRA
7fecbcdb,30,2573,28.6,29,27,1,4,36,33,3,37.7,36.8,0.9,19,FRA
7ffaf233,22,793,8.8,7,0,15,7,10,7,3,10.6,7.3,3.3,19,FRA
80556f08,23,1333,14.8,16,6,7,8,11,18,-7,14.5,23.6,-9.1,19,FRA
813aae2f,15,566,6.3,4,1,11,8,6,16,-10,8.4,10.6,-2.2,19,FRA
81d3318f,37,2561,28.5,29,12,8,0,26,32,-6,28.8,37.5,-8.7,19,FRA
821233cc,26,2149,23.9,26,22,0,0,37,32,5,38.2,30.7,7.5,19,FRA
822d51d7,17,912,10.1,10,7,7,10,19,14,5,12.7,18.0,-5.4,19,FRA
82671804,30,2436,27.1,26,25,4,3,43,43,0,38.9,35.3,3.6,19,FRA
8325870c,6,506,5.6,6,5,0,7,8,5,3,7.3,7.4,-0.2,19,FRA
834b5c4c,37,3330,37.0,37,37,0,1,57,48,9,40.4,49.5,-9.1,19,FRA
8417953b,3,226,2.5,2,2,1,12,4,7,-3,4.2,3.3,0.9,19,FRA
84549a07,22,817,9.1,8,1,14,8,5,9,-4,13.9,9.5,4.4,19,FRA
84d94b91,33,2818,31.3,32,28,1,1,23,42,-19,28.9,40.4,-11.5,19,FRA
854a2041,2,29,0.3,0,0,2,13,1,0,1,0.2,0.2,-0.1,19,FRA
8577e60a,1,10,0.1,0,0,1,4,0,0,0,0.0,0.0,0.0,19,FRA
86574238,1,68,0.8,1,0,0,0,1,2,-1,0.4,0.9,-0.6,19,FRA
86df8ac0,1,1,0.0,0,0,1,7,0,0,0,0.0,0.0,0.0,19,FRA
86e7deaf,25,2077,23.1,24,21,1,2,69,15,54,56.9,19.5,37.4,19,FRA
872cd68c,1,4,0.0,0,0,1,2,0,1,-1,0.0,0.4,-0.4,19,FRA
873ce3a2,12,454,5.0,5,0,7,24,10,6,4,10.2,4.9,5.3,19,FRA
8746d5d0,17,1352,15.0,15,11,2,12,10,16,-6,16.7,21.9,-5.2,19,FRA
8794e251,14,1063,11.8,12,10,2,0,38,8,30,29.1,11.7,17.5,19,FRA
8802c1d5,14,538,6.0,6,0,8,7,6,4,2,7.1,8.1,-1.0,19,FRA
885b7aa7,11,744,8.3,8,3,3,5,6,14,-8,7.2,11.7,-4.5,19,FRA
8870154f,13,1170,13.0,13,13,0,25,7,17,-10,10.6,20.3,-9.7,19,FRA
88f130ed,10,834,9.3,10,8,0,1,10,14,-4,10.6,13.2,-2.6,19,FRA
8a2248b4,35,3150,35.0,35,35,0,3,29,29,0,42.4,46.7,-4.3,19,FRA
8b28686a,18,1620,18.0,18,18,0,0,15,26,-11,23.0,25.8,-2.8,19,FRA
8b298f56,33,2668,29.6,29,25,4,2,48,36,12,44.0,36.7,7.4,19,FRA
8b529245,16,523,5.8,3,2,13,0,8,5,3,9.9,7.6,2.4,19,FRA
8b66d9cc,22,1224,13.6,13,5,9,5,13,14,-1,17.4,18.7,-1.3,19,FRA
8c2c48a9,1,13,0.1,0,0,1,3,0,0,0,0.1,0.0,0.1,19,FRA
8c955557,17,456,5.1,2,1,15,7,7,8,-1,8.3,9.4,-1.1,19,FRA
8ca253a3,25,1499,16.7,16,8,9,3,13,23,-10,15.0,27.3,-12.3,19,FRA
8da74c05,37,2942,32.7,34,23,3,0,25,33,-8,37.9,45.8,-7.9,19,FRA
8dbff17c,16,1412,15.7,16,14,0,8,26,22,4,22.7,19.9,2.8,19,FRA
8eec784d,2,54,0.6,1,0,1,0,1,1,0,1.2,1.1,0.1,19,FRA
8f325097,12,984,10.9,11,8,1,17,17,17,0,14.4,16.3,-1.8,19,FRA
8f4d116f,36,2805,31.2,31,19,5,0,43,33,10,43.0,31.7,11.2,19,FRA
8f534f8e,2,180,2.0,2,2,0,3,6,1,5,4.4,3.2,1.2,19,FRA
8f696594,36,2737,30.4,29,22,7,2,54,34,20,58.0,35.1,22.9,19,FRA
8fa8f8d2,25,2250,25.0,25,25,0,12,24,43,-19,29.2,37.9,-8.7,19,FRA
8ff07990,25,1685,18.8,21,4,4,0,19,18,1,22.200000000000003,21.7,0.3999999999999999,19,FRA
8ff4872e,20,1707,19.0,19,18,1,5,16,44,-28,22.2,29.7,-7.5,19,FRA
9001138b,23,1175,13.1,12,5,11,12,26,13,13,20.7,16.7,4.1,19,FRA
909222de,34,2052,22.8,22,9,12,3,37,31,6,26.2,33.0,-6.8,19,FRA
90eb507d,32,2880,32.0,32,32,0,0,32,32,0,33.6,35.0,-1.3,19,FRA
90f87966,36,3110,34.6,36,34,0,0,60,28,32,55.4,38.4,17.0,19,FRA
90fcf472,34,2253,25.0,25,9,9,3,18,44,-26,23.1,40.0,-16.9,19,FRA
91e58f66,24,1021,11.3,10,5,14,9,15,19,-4,18.3,16.1,2.2,19,FRA
91f2da4c,33,2468,27.4,28,16,5,2,20,36,-16,22.0,46.2,-24.2,19,FRA
92232aad,24,1941,21.6,23,15,1,2,29,22,7,30.0,27.3,2.7,19,FRA
923f4dda,13,1111,12.3,13,9,0,0,11,11,0,13.7,10.7,2.9,19,FRA
92b1763b,5,50,0.6,0,0,5,9,3,2,1,0.8,2.4,-1.6,19,FRA
92b56413,20,1344,14.9,17,3,3,4,18,16,2,15.1,17.8,-2.7,19,FRA
92cd4bef,3,80,0.9,1,0,2,0,1,2,-1,1.1,1.2,-0.2,19,FRA
933d3b51,1,90,1.0,1,1,0,0,1,3,-2,1.4,2.6,-1.2,19,FRA
934a0957,2,22,0.2,0,0,2,3,0,0,0,0.2,0.5,-0.2,19,FRA
93c942fb,1,1,0.0,0,0,1,0,0,0,0,0.0,0.0,0.0,19,FRA
9453d2f4,24,1183,13.1,15,2,9,9,13,19,-6,13.7,18.4,-4.7,19,FRA
94f8d10c,20,1547,17.2,17,15,3,14,23,22,1,22.8,20.0,2.8,19,FRA
950ff24d,3,270,3.0,3,3,0,6,1,6,-5,3.9,3.3,0.6,19,FRA
972aeb2a,16,1277,14.2,13,11,3,14,28,11,17,20.5,18.7,1.7,19,FRA
97b87472,2,69,0.8,0,0,2,7,1,0,1,1.2,1.3,-0.1,19,FRA
97fb4608,6,495,5.5,6,5,0,5,6,8,-2,8.7,5.9,2.8,19,FRA
9836e892,1,8,0.1,0,0,1,1,0,0,0,0.0,0.1,0.0,19,FRA
9980269a,32,1751,19.5,19,13,13,4,24,22,2,27.0,22.4,4.5,19,FRA
9a1f2e1c,18,1023,11.4,11,9,7,2,19,13,6,21.4,14.0,7.3,19,FRA
9a506145,16,1057,11.7,12,7,4,10,9,14,-5,13.4,13.7,-0.2,19,FRA
9ae9eaea,12,878,9.8,12,7,0,10,16,9,7,14.7,10.2,4.5,19,FRA
9b398aea,3,57,0.6,0,0,3,16,1,3,-2,0.9,2.0,-1.1,19,FRA
9b6d9b53,18,1460,16.2,16,16,2,0,16,28,-12,20.3,24.5,-4.2,19,FRA
9daeac61,7,605,6.7,7,6,0,3,9,9,0,8.6,9.2,-0.6,19,FRA
9dafff2a,13,665,7.4,6,3,7,11,4,19,-15,7.6000000000000005,10.6,-3.0,19,FRA
9dd5da03,29,1853,20.6,20,16,9,6,18,29,-11,17.7,35.5,-17.8,19,FRA
9e27e5de,31,2343,26.0,26,21,5,2,18,33,-15,21.3,44.3,-23.0,19,FRA
9f29c204,11,544,6.0,6,3,5,27,3,11,-8,4.5,8.8,-4.3,19,FRA
9f6325f9,1,90,1.0,1,1,0,1,0,2,-2,0.2,1.5,-1.3,19,FRA
9f90c06b,7,420,4.7,4,4,3,18,3,6,-3,3.8,5.7,-1.9,19,FRA
9fc0f253,8,720,8.0,8,8,0,5,7,13,-6,8.8,11.2,-2.4,19,FRA
a0434482,34,2243,24.9,24,14,10,2,20,36,-16,21.6,35.6,-14.0,19,FRA
a08b974a,34,2708,30.1,31,21,3,0,49,36,13,44.6,33.0,11.6,19,FRA
a0f9b535,36,2985,33.2,34,23,2,0,40,40,0,44.9,41.0,4.0,19,FRA
a1d04509,17,923,10.3,9,6,8,5,9,11,-2,10.0,14.2,-4.1,19,FRA
a44d3a3c,3,82,0.9,0,0,3,0,1,2,-1,1.1,1.3,-0.2,19,FRA
a4527d33,1,90,1.0,1,1,0,6,1,0,1,0.9,1.7,-0.8,19,FRA
a46472d0,27,2152,23.9,23,23,4,3,32,30,2,26.8,32.7,-5.9,19,FRA
a4b1028a,34,2972,33.0,33,31,1,2,51,46,5,49.1,39.7,9.4,19,FRA
a4c3f7af,26,2023,22.5,23,16,3,1,18,30,-12,22.2,31.3,-9.2,19,FRA
a56bd2ee,17,1530,17.0,17,17,0,19,12,34,-22,18.2,21.9,-3.6,19,FRA
a5db0bec,37,3061,34.0,35,26,2,1,62,45,17,65.3,41.5,23.9,19,FRA
a6138e4a,20,1269,14.1,15,7,5,11,10,17,-7,9.4,21.9,-12.6,19,FRA
a634b9d2,11,469,5.2,4,4,7,13,10,9,1,9.0,6.5,2.6,19,FRA
a671316d,1,42,0.5,0,0,1,3,0,2,-2,0.3,2.1,-1.8,19,FRA
a7e4760c,3,204,2.3,3,1,0,7,0,2,-2,1.3,3.1,-1.8,19,FRA
a8797cf1,5,230,2.6,3,0,2,5,4,3,1,2.2,2.7,-0.5,19,FRA
a8b4a643,15,651,7.2,6,2,9,12,6,8,-2,6.8,12.9,-6.1,19,FRA
aa21406e,1,3,0.0,0,0,1,3,1,1,0,0.4,0.5,0.0,19,FRA
ab096c6f,36,3184,35.4,35,34,1,1,54,39,15,53.3,45.9,7.4,19,FRA
acde3581,13,340,3.8,2,0,11,2,4,6,-2,4.4,6.6,-2.3,19,FRA
ad82197c,4,159,1.8,1,1,3,18,4,4,0,1.4,3.0,-1.7,19,FRA
ae59b359,18,564,6.3,5,5,13,15,19,7,12,13.9,9.1,4.8,19,FRA
ae6941ec,3,257,2.9,3,2,0,2,1,6,-5,1.9,4.0,-2.1,19,FRA
ae82fa48,5,209,2.3,3,0,2,2,2,6,-4,3.6,4.1,-0.6,19,FRA
aeed036d,1,2,0.0,0,0,1,2,0,0,0,0.0,0.1,-0.1,19,FRA
aeed5c06,25,1141,12.7,10,6,15,11,32,12,20,31.7,12.0,19.7,19,FRA
aef6e670,24,2005,22.3,23,21,1,4,55,25,30,46.5,25.4,21.0,19,FRA
af0c835b,28,1648,18.3,19,8,9,5,20,26,-6,21.6,22.7,-1.1,19,FRA
b0547a87,23,1271,14.1,14,8,9,9,13,13,0,14.7,19.9,-5.2,19,FRA
b056e3da,27,2390,26.6,27,26,0,1,29,30,-1,32.7,32.1,0.6,19,FRA
b1adaefa,2,173,1.9,1,1,1,1,0,1,-1,1.3,1.9,-0.6,19,FRA
b2459674,3,15,0.2,0,0,3,1,0,1,-1,0.1,0.8,-0.8,19,FRA
b2bd0f6c,38,3004,33.4,35,25,3,0,62,29,33,53.0,37.9,15.0,19,FRA
b4a014b1,35,3148,35.0,35,34,0,1,46,44,2,45.2,42.5,2.7,19,FRA
b4c816a9,18,493,5.5,4,1,14,11,6,5,1,7.9,7.0,1.0,19,FRA
b666421b,30,2636,29.3,29,28,1,2,34,38,-4,37.7,38.1,-0.3,19,FRA
b66d1d8a,13,1117,12.4,12,11,1,11,19,22,-3,17.7,17.7,0.0,19,FRA
b684a484,15,608,6.8,7,1,8,5,11,9,2,11.4,7.5,3.9,19,FRA
b6dac747,24,1928,21.4,23,18,1,8,14,36,-22,22.3,31.8,-9.5,19,FRA
b7e7937d,23,2058,22.9,22,22,1,11,20,38,-18,25.9,33.1,-7.2,19,FRA
b8d22478,21,1281,14.2,14,9,7,0,13,14,-1,17.3,19.6,-2.3,19,FRA
b92edde2,30,2537,28.2,28,27,2,5,23,27,-4,30.9,36.7,-5.8,19,FRA
b931d9d1,11,739,8.2,8,5,3,10,5,12,-7,7.0,14.5,-7.5,19,FRA
b99bec05,24,1994,22.2,23,21,1,10,19,31,-12,27.3,33.3,-6.0,19,FRA
bb4a42be,22,901,10.0,9,1,13,6,18,17,1,17.7,16.3,1.4,19,FRA
bc0bfc64,7,198,2.2,3,0,4,4,2,2,0,2.2,4.3,-2.1,19,FRA
bc270726,38,3420,38.0,38,38,0,0,31,52,-21,35.4,49.8,-14.5,19,FRA
bc7b4580,20,1276,14.2,15,6,5,7,19,20,-1,19.5,20.2,-0.7,19,FRA
bcc81786,32,2880,32.0,32,32,0,1,31,47,-16,40.8,47.8,-7.1,19,FRA
bced0375,28,2467,27.4,27,27,1,0,27,41,-14,34.2,41.5,-7.3,19,FRA
bcf1b2e9,31,2704,30.0,31,30,0,2,25,45,-20,35.7,45.8,-10.1,19,FRA
bd4f5f94,6,494,5.5,6,5,0,4,4,9,-5,6.6,7.2,-0.5,19,FRA
bdedd861,27,1252,13.9,11,9,16,4,23,21,2,19.7,20.0,-0.3,19,FRA
beae3a73,38,3006,33.4,34,28,4,0,52,54,-2,44.5,51.4,-6.9,19,FRA
beb391dd,27,1281,14.2,12,5,15,2,26,22,4,31.1,17.4,13.6,19,FRA
bece776f,29,1988,22.1,24,16,5,0,39,24,15,43.4,26.0,17.4,19,FRA
bfcef334,20,1508,16.8,16,16,4,11,11,25,-14,16.0,24.7,-8.7,19,FRA
bfdb33aa,35,2788,31.0,32,22,3,0,48,39,9,46.4,39.2,7.2,19,FRA
c0b3669f,6,122,1.4,1,0,5,4,0,3,-3,1.4,0.6,0.8,19,FRA
c20bdcd7,3,97,1.1,1,1,2,6,1,3,-2,1.1,2.2,-1.1,19,FRA
c2211709,37,3090,34.3,35,31,2,0,48,36,12,45.2,36.1,9.2,19,FRA
c252c705,1,90,1.0,1,1,0,37,1,0,1,1.8,1.1,0.7,19,FRA
c26a3918,31,2790,31.0,31,31,0,1,35,39,-4,38.8,37.2,1.6,19,FRA
c27dfb82,18,1058,11.8,12,6,6,6,19,15,4,13.9,16.8,-2.9,19,FRA
c39d9657,5,446,5.0,5,4,0,2,4,10,-6,5.9,8.5,-2.6,19,FRA
c3e4ecbb,23,1802,20.0,21,18,2,12,19,27,-8,20.2,28.8,-8.7,19,FRA
c4527123,4,108,1.2,1,0,3,7,3,3,0,1.7,2.3,-0.6,19,FRA
c46fa34c,26,2009,22.3,23,17,3,5,29,27,2,27.3,31.0,-3.5999999999999996,19,FRA
c47541e0,34,2117,23.5,24,9,10,3,40,32,8,44.8,26.7,18.1,19,FRA
c4bbea9f,36,3232,35.9,36,35,0,0,49,41,8,46.3,40.0,6.3,19,FRA
c58270f8,12,137,1.5,0,0,12,24,5,2,3,3.1,2.3,0.9,19,FRA
c5a500ca,36,3240,36.0,36,36,0,0,32,53,-21,44.3,53.4,-9.0,19,FRA
c6056d58,33,2970,33.0,33,33,0,0,33,48,-15,42.6,40.7,1.9,19,FRA
c650629d,22,1476,16.4,17,8,5,2,19,21,-2,15.9,22.9,-7.0,19,FRA
c693347d,20,792,8.8,6,4,14,0,13,7,6,9.9,13.2,-3.3,19,FRA
c69ef855,27,1990,22.1,25,14,2,3,15,27,-12,20.3,29.3,-9.0,19,FRA
c6ac6579,14,580,6.4,7,1,7,6,12,11,1,9.7,8.8,0.9,19,FRA
c6e5d20f,35,3074,34.2,35,27,0,0,64,24,40,54.0,35.1,18.9,19,FRA
c76577a0,19,372,4.1,2,0,17,7,6,10,-4,6.0,5.8,0.2,19,FRA
c76b7567,34,2479,27.5,28,13,6,3,41,33,8,30.3,35.1,-4.8,19,FRA
c801616a,29,1598,17.8,18,7,11,4,17,26,-9,25.6,20.9,4.7,19,FRA
c8090cb3,31,1770,19.7,20,9,11,7,24,32,-8,24.5,28.9,-4.4,19,FRA
c8c02ac7,20,1214,13.5,14,9,6,7,18,17,1,21.7,17.6,4.0,19,FRA
c8c60119,4,346,3.8,4,3,0,0,2,4,-2,4.4,4.4,0.0,19,FRA
c977ef13,1,90,1.0,1,1,0,11,0,1,-1,1.7,0.9,0.8,19,FRA
c9e99e49,23,1622,18.0,19,12,4,0,45,22,23,42.4,19.9,22.5,19,FRA
cac76a72,37,3330,37.0,37,37,0,1,58,40,18,55.1,48.3,6.8,19,FRA
cb9ec45d,1,90,1.0,1,1,0,0,0,4,-4,0.3,3.2,-2.9,19,FRA
cc77354e,31,2411,26.8,27,25,4,4,40,38,2,34.5,32.6,1.9,19,FRA
ccb1c3af,3,88,1.0,2,0,1,2,1,1,0,1.0,1.1,-0.1,19,FRA
ccee698e,29,1237,13.7,12,2,17,3,25,14,11,22.8,11.4,11.4,19,FRA
ce492295,29,2469,27.4,29,26,0,3,43,32,11,41.4,32.7,8.7,19,FRA
ce84946a,6,44,0.5,0,0,6,3,2,0,2,0.8,0.6,0.1,19,FRA
cfd41fad,1,8,0.1,0,0,1,0,0,0,0,0.0,0.1,-0.1,19,FRA
cfd8dde3,17,671,7.5,6,0,11,10,16,6,10,9.7,6.5,3.3,19,FRA
d14229f3,19,1240,13.8,14,8,5,5,24,20,4,22.3,17.5,4.9,19,FRA
d21e361a,18,328,3.6,0,0,18,8,7,4,3,8.9,5.2,3.7,19,FRA
d2448564,20,706,7.800000000000001,6,1,14,5,10,14,-4,10.7,14.3,-3.7,19,FRA
d29202c2,9,232,2.6,2,0,7,6,2,4,-2,3.0,4.1,-1.2,19,FRA
d2aa8ac0,31,2105,23.4,23,16,8,6,18,47,-29,24.7,33.7,-9.0,19,FRA
d33c706e,36,3115,34.6,36,19,0,0,49,35,14,46.2,35.0,11.2,19,FRA
d3ce9f1f,2,126,1.4,1,1,1,0,3,3,0,1.2,2.2,-1.0,19,FRA
d4133fa1,37,3258,36.2,37,35,0,0,58,36,22,53.3,46.3,7.0,19,FRA
d504b3e1,35,2556,28.4,29,14,6,0,31,39,-8,37.7,39.3,-1.6,19,FRA
d512db65,5,204,2.3,2,0,3,1,3,5,-2,2.5,5.9,-3.4,19,FRA
d520120b,36,2805,31.2,31,27,5,0,24,48,-24,33.1,48.0,-15.0,19,FRA
d5f2f82b,30,2693,29.9,30,28,0,1,86,22,64,69.3,27.0,42.3,19,FRA
d63e2912,27,2374,26.4,26,26,1,2,46,32,14,39.7,29.9,9.8,19,FRA
d6f88a1d,15,1184,13.2,13,12,2,0,14,16,-2,17.9,17.6,0.3,19,FRA
d7553721,1,11,0.1,0,0,1,2,2,0,2,1.1,0.0,1.1,19,FRA
d7bf3d19,32,2522,28.0,30,21,2,2,20,46,-26,25.9,43.2,-17.3,19,FRA
d880dc16,3,177,2.0,2,1,1,7,1,2,-1,3.4,2.7,0.7,19,FRA
d8b97bb3,18,769,8.5,7,4,11,7,8,18,-10,10.2,12.3,-2.1,19,FRA
d8fc044e,1,25,0.3,0,0,1,7,0,0,0,1.2,0.2,1.0,19,FRA
d9a66c60,28,603,6.7,4,2,24,10,10,13,-3,11.4,9.8,1.6,19,FRA
dc366c36,33,2925,32.5,32,32,1,5,47,48,-1,45.7,42.8,2.9,19,FRA
dc709ab5,17,1480,16.4,15,15,2,13,25,30,-5,21.6,22.2,-0.5,19,FRA
dcf7cf44,14,440,4.9,3,0,11,4,9,7,2,7.7,7.9,-0.20000000000000007,19,FRA
dd73120f,3,37,0.4,0,0,3,2,0,0,0,0.5,0.3,0.2,19,FRA
de40e38c,1,90,1.0,1,1,0,5,0,2,-2,0.6,1.1,-0.4,19,FRA
de488e56,13,1163,12.9,13,12,0,11,12,10,2,15.7,14.4,1.3,19,FRA
df819670,12,408,4.5,4,3,8,7,4,6,-2,3.9,8.4,-4.5,19,FRA
dff153a4,16,1249,13.9,14,11,2,0,28,19,9,29.5,15.0,14.5,19,FRA
e067808c,16,767,8.5,8,2,8,3,6,16,-10,9.3,15.4,-6.1,19,FRA
e110ea4b,1,70,0.8,1,0,0,0,1,2,-1,0.4,0.9,-0.6,19,FRA
e162b013,22,1610,17.9,19,11,3,3,50,12,38,41.9,14.3,27.6,19,FRA
e1df6989,1,88,1.0,1,0,0,6,0,1,-1,1.6,0.9,0.7,19,FRA
e2f9bb5f,11,422,4.7,7,0,4,8,2,6,-4,3.4,6.4,-2.9,19,FRA
e3d0b0c4,33,2878,32.0,33,31,0,4,59,34,25,59.9,35.1,24.7,19,FRA
e3e05edf,26,2136,23.7,25,19,1,7,33,27,6,30.4,26.2,4.1,19,FRA
e4086af3,11,964,10.7,11,10,0,2,13,15,-2,11.5,15.1,-3.6,19,FRA
e40d028b,17,1530,17.0,17,17,0,20,50,18,32,40.7,17.2,23.4,19,FRA
e493cff8,2,25,0.3,0,0,2,2,1,0,1,1.0,0.3,0.7,19,FRA
e4a26a91,16,712,7.9,7,3,9,5,9,12,-3,11.4,12.4,-1.0,19,FRA
e50623a0,4,195,2.2,2,2,2,10,1,4,-3,3.8,2.7,1.1,19,FRA
e53ab10b,17,441,4.9,4,0,13,2,11,4,7,7.9,7.1,0.8,19,FRA
e54a9890,27,2137,23.7,25,22,2,4,38,29,9,32.2,33.1,-0.8,19,FRA
e562a02e,2,31,0.3,0,0,2,7,0,0,0,0.6,0.8,-0.2,19,FRA
e6777e6b,34,3026,33.6,34,32,0,0,50,45,5,35.3,46.1,-10.7,19,FRA
e68f2cb4,25,1877,20.9,22,13,3,1,15,28,-13,16.9,26.1,-9.2,19,FRA
e6eadfb8,20,1709,19.0,19,17,1,5,36,13,23,30.7,17.9,12.8,19,FRA
e7986081,33,2016,22.4,21,12,12,1,49,26,23,46.5,24.9,21.5,19,FRA
e8a65bc8,2,32,0.4,0,0,2,5,0,3,-3,0.7,1.0,-0.3,19,FRA
e8b5ad37,1,78,0.9,1,0,0,2,0,2,-2,0.3,1.5,-1.2,19,FRA
e90af77c,29,1319,14.7,14,1,15,4,19,23,-4,19.0,21.7,-2.7,19,FRA
e97150c0,12,1064,11.8,12,11,0,16,24,15,9,21.0,15.0,6.1,19,FRA
ea02beaf,37,2612,29.0,32,10,5,1,31,33,-2,27.9,34.2,-6.3,19,FRA
ea0aa7e0,10,326,3.6,3,1,7,4,6,3,3,5.6,4.2,1.4,19,FRA
ea0ff634,36,2170,24.1,23,13,13,2,41,32,9,31.9,28.6,3.3,19,FRA
ea540835,20,1259,14.0,18,5,2,5,11,18,-7,15.8,18.3,-2.5,19,FRA
eb78322b,1,90,1.0,1,1,0,1,0,1,-1,1.7,0.9,0.8,19,FRA
eba1e557,3,61,0.7,0,0,3,3,1,0,1,1.1,0.2,0.8,19,FRA
ec400194,32,2674,29.7,30,24,2,2,24,42,-18,33.0,44.9,-11.8,19,FRA
ed0c3318,29,1473,16.4,16,8,13,7,19,23,-4,15.9,26.0,-10.1,19,FRA
ed45c4a5,36,3226,35.8,36,34,0,0,47,44,3,47.1,42.9,4.2,19,FRA
edd1466a,21,1847,20.5,21,14,0,13,15,25,-10,18.2,30.8,-12.6,19,FRA
ef2e5e1a,28,1942,21.6,21,17,7,3,31,34,-3,29.0,27.5,1.5,19,FRA
ef7cd87a,34,2749,30.5,30,27,4,3,42,37,5,41.5,40.0,1.4,19,FRA
ef9c1c95,30,2495,27.7,28,24,2,0,37,40,-3,38.5,34.2,4.3,19,FRA
f00de885,34,3060,34.0,34,34,0,0,62,42,20,67.2,40.7,26.5,19,FRA
f09a8b75,36,1899,21.1,21,3,15,0,25,30,-5,28.5,31.9,-3.5,19,FRA
f10983ae,10,863,9.6,10,8,0,14,6,16,-10,10.9,13.1,-2.1,19,FRA
f18d7ab2,4,275,3.1,4,1,0,8,1,4,-3,2.5,5.0,-2.6,19,FRA
f1b2365a,27,2334,25.9,26,23,1,1,27,27,0,30.3,30.4,0.0,19,FRA
f3085377,3,66,0.7,0,0,3,5,0,2,-2,0.6,2.3,-1.7,19,FRA
f323d995,34,3015,33.5,34,33,0,1,32,50,-18,38.2,50.0,-11.8,19,FRA
f3600c02,27,2260,25.1,26,20,1,0,41,19,22,35.4,26.8,8.6,19,FRA
f3642ba8,26,1073,11.9,10,5,16,8,11,21,-10,10.5,18.8,-8.3,19,FRA
f36c432f,8,399,4.4,4,1,4,0,4,2,2,8.7,3.1,5.6,19,FRA
f4319ee8,13,623,6.9,8,0,5,18,8,4,4,6.2,5.1,1.1,19,FRA
f449640d,36,3187,35.4,36,33,0,0,50,43,7,50.0,45.099999999999994,4.9,19,FRA
f4bc42b1,38,2476,27.5,27,11,11,0,48,40,8,36.5,38.1,-1.7,19,FRA
f5044e54,30,2394,26.6,26,24,4,0,20,24,-4,33.2,32.9,0.3,19,FRA
f54d2149,1,59,0.7,1,0,0,0,0,0,0,0.0,0.3,-0.3,19,FRA
f6db3bd5,14,1136,12.6,14,12,0,0,14,12,2,17.3,13.8,3.5,19,FRA
f7691f63,22,1291,14.3,15,9,7,13,18,17,1,17.0,16.6,0.4,19,FRA
f7b1d4e0,27,1827,20.3,20,9,7,0,19,27,-8,21.4,26.5,-5.1,19,FRA
f83c8d6c,35,2495,27.7,28,18,7,1,25,34,-9,29.2,41.1,-12.0,19,FRA
f86ca403,13,713,7.9,10,0,3,6,9,12,-3,11.3,9.7,1.5,19,FRA
fa18c72e,25,781,8.7,6,1,19,11,12,11,1,12.0,11.0,1.0,19,FRA
fbbb9269,23,1908,21.2,21,17,2,4,20,22,-2,22.3,29.8,-7.5,19,FRA
fbf76716,4,177,2.0,1,1,3,2,0,2,-2,1.3,1.4,-0.1,19,FRA
fca455cc,6,116,1.3,0,0,6,18,1,4,-3,0.8,3.0,-2.3,19,FRA
fcb38f57,38,3420,38.0,38,38,0,0,68,33,35,59.5,42.1,17.4,19,FRA
fcbcbd94,27,1876,20.8,21,9,6,0,20,25,-5,23.0,25.5,-2.4,19,FRA
fd2bc67d,36,3226,35.8,36,35,0,0,30,31,-1,44.2,46.4,-2.2,19,FRA
fe006f82,1,90,1.0,1,1,0,5,0,1,-1,0.7,0.6,0.1,19,FRA
ff0ab48c,25,2044,22.7,21,17,4,5,43,30,13,49.8,27.1,22.6,19,FRA
ff3a6a60,5,266,3.0,3,1,2,4,4,2,2,4.1,4.8,-0.7,19,FRA
00242715,33,2970,33.0,33,33,0,0,44,57,-13,47.6,56.3,-8.7,20,GER
00242b75,18,938,10.4,11,4,7,14,12,15,-3,15.0,14.8,0.2,20,GER
00844823,22,1979,22.0,22,21,0,0,25,40,-15,24.1,31.3,-7.2,20,GER
009a4f60,14,368,4.1,3,3,11,10,5,8,-3,4.8,7.3,-2.5,20,GER
01834aa0,28,2447,27.2,28,26,0,1,38,56,-18,37.5,43.6,-6.2,20,GER
01c3aff5,28,2074,23.0,24,17,4,0,26,41,-15,25.7,31.9,-6.1,20,GER
028e70b9,9,297,3.3,3,1,6,12,13,1,12,9.5,2.0,7.5,20,GER
032f894e,1,6,0.1,0,0,1,0,0,0,0,0.2,0.0,0.2,20,GER
042e8a49,24,1505,16.7,17,8,7,2,48,18,30,39.1,19.4,19.6,20,GER
048a1cbc,29,2335,25.9,26,18,3,3,63,29,34,45.3,28.6,16.7,20,GER
05439de2,28,2498,27.8,27,26,1,3,86,24,62,75.3,30.1,45.2,20,GER
054849d2,10,674,7.5,7,7,3,8,9,15,-6,7.4,15.5,-8.1,20,GER
056d2d95,32,2863,31.8,32,31,0,0,38,53,-15,39.5,49.4,-10.0,20,GER
05d548d8,31,2581,28.7,31,26,0,0,74,36,38,51.4,36.2,15.2,20,GER
05f99a4a,8,253,2.8,3,0,5,17,6,4,2,3.9,5.6,-1.7,20,GER
070ec0b1,33,2726,30.3,33,28,0,1,55,36,19,51.5,44.6,6.9,20,GER
080440a4,31,2721,30.2,30,29,1,2,51,54,-3,51.3,45.5,5.7,20,GER
08593525,21,1310,14.6,16,10,5,5,23,25,-2,25.4,31.2,-5.8,20,GER
088ca1bd,33,2836,31.5,31,26,2,0,47,43,4,43.7,56.6,-13.0,20,GER
096a77c4,7,152,1.7,1,0,6,13,4,1,3,3.5,1.9,1.6,20,GER
099e666f,31,2717,30.2,31,23,0,0,36,49,-13,33.8,47.6,-13.7,20,GER
0a1cb833,33,2970,33.0,33,33,0,0,40,67,-27,38.2,54.3,-16.1,20,GER
0a3d6d2b,1,7,0.1,0,0,1,1,0,0,0,0.0,0.3,-0.3,20,GER
0a3f6cde,34,2470,27.4,28,20,6,0,30,60,-30,31.5,54.2,-22.8,20,GER
0b4f388a,28,1550,17.2,17,5,11,1,35,19,16,35.9,22.8,13.1,20,GER
0c61c77c,30,2031,22.6,24,6,6,4,28,37,-9,27.8,36.5,-8.7,20,GER
0cc5f4a5,6,131,1.5,1,0,5,6,1,4,-3,2.2,2.4,-0.2,20,GER
0d55d942,24,2091,23.2,24,23,0,1,32,32,0,31.5,39.1,-7.5,20,GER
0db5d2c8,9,498,5.5,5,4,4,5,5,16,-11,3.9,12.7,-8.9,20,GER
0e0102eb,5,81,0.9,0,0,5,4,0,3,-3,0.4,2.1,-1.7,20,GER
0e4fef6e,7,331,3.7,4,2,3,11,3,6,-3,5.9,4.6,1.3,20,GER
0ef89a37,23,1411,15.7,15,5,8,2,45,13,32,45.1,15.2,30.0,20,GER
0fbb73c2,22,1571,17.5,19,10,3,12,19,33,-14,21.0,31.3,-10.2,20,GER
0fbecd11,26,1445,16.1,16,4,10,5,32,29,3,31.2,21.8,9.4,20,GER
1025db8e,21,1645,18.3,18,18,3,4,27,34,-7,23.1,31.1,-8.0,20,GER
106bca06,22,1432,15.9,15,14,7,3,12,31,-19,15.7,22.4,-6.6,20,GER
10b9fa99,3,81,0.9,0,0,3,17,3,1,2,1.6,0.5,1.1,20,GER
1151fb6e,2,37,0.4,0,0,2,15,2,0,2,2.1,0.0,2.1,20,GER
11fd2b75,23,2026,22.5,23,20,0,0,32,30,2,27.7,35.0,-7.3,20,GER
1238a3f9,30,1423,15.799999999999999,15,8,15,2,13,29,-16,16.4,24.6,-8.2,20,GER
13203c45,29,2364,26.3,27,21,2,2,38,37,1,42.5,33.9,8.6,20,GER
140afefb,6,132,1.5,0,0,6,12,4,1,3,3.4,1.7,1.7,20,GER
14a7af33,14,872,9.7,10,9,4,16,14,22,-8,11.1,21.1,-10.1,20,GER
15b287da,28,1969,21.9,22,13,6,4,33,39,-6,39.7,30.4,9.3,20,GER
15fd5593,33,2936,32.6,33,28,0,0,40,65,-25,37.5,52.5,-15.1,20,GER
16b4260e,1,21,0.2,0,0,1,1,0,2,-2,0.2,0.2,0.0,20,GER
16daec92,23,1048,11.6,11,0,12,5,19,15,4,18.0,18.5,-0.5,20,GER
17376543,33,2970,33.0,33,33,0,1,41,54,-13,41.0,52.0,-11.0,20,GER
1748c9f7,5,91,1.0,0,0,5,11,0,3,-3,0.7,3.0,-2.2,20,GER
17611373,32,2459,27.3,27,22,5,1,31,56,-25,30.7,47.2,-16.5,20,GER
17780d2b,10,615,6.8,6,4,4,9,14,11,3,12.0,10.2,1.8,20,GER
17f3620a,15,909,10.1,9,5,6,0,16,21,-5,13.6,18.1,-4.4,20,GER
1a1033a1,32,1629,18.1,18,4,14,2,19,24,-5,24.6,23.4,1.2,20,GER
1ae836b1,13,623,6.9,7,3,6,3,17,15,2,11.1,10.4,0.7,20,GER
1b278bf5,8,545,6.1,7,3,1,8,7,13,-6,5.8,12.9,-7.1,20,GER
1bcca8b8,8,87,1.0,0,0,8,6,5,1,4,2.8,0.3,2.5,20,GER
1c08a3c8,13,663,7.4,8,3,5,14,9,9,0,9.6,12.2,-2.6,20,GER
1c96ad85,4,179,2.0,1,1,3,7,2,3,-1,3.0,2.7,0.3,20,GER
1cbe4984,5,380,4.2,4,3,1,7,7,5,2,6.4,4.9,1.4,20,GER
1d1691ad,3,152,1.7,2,0,1,13,3,1,2,4.0,1.7,2.3,20,GER
1d8e9add,25,2065,23.0,25,18,0,2,33,37,-4,27.700000000000003,31.9,-4.300000000000001,20,GER
1e274a0a,29,1376,15.3,13,7,16,2,18,46,-28,18.9,36.4,-17.4,20,GER
1f44ac21,15,1063,11.8,11,7,4,0,31,12,19,19.3,13.8,5.5,20,GER
1fda91b3,2,51,0.6,1,0,1,4,1,0,1,1.6,0.6,0.9,20,GER
1fdec858,17,1119,12.4,14,3,3,0,12,26,-14,12.2,24.8,-12.6,20,GER
20030c06,12,856,9.5,9,9,3,6,18,12,6,19.2,15.6,3.6,20,GER
2042d931,5,146,1.6,1,0,4,12,2,4,-2,3.2,3.6,-0.4,20,GER
217c93a1,3,34,0.4,0,0,3,5,0,1,-1,0.1,2.2,-2.1,20,GER
2200181e,31,2731,30.3,31,29,0,0,34,54,-20,34.0,51.2,-17.2,20,GER
226ddf9d,1,90,1.0,1,1,0,31,0,4,-4,0.5,2.3,-1.8,20,GER
22919e97,15,746,8.3,6,2,9,3,16,10,6,15.3,16.3,-0.9,20,GER
229cd98a,16,367,4.1,4,0,12,5,9,5,4,7.6,8.1,-0.5,20,GER
23a10591,1,9,0.1,0,0,1,1,0,0,0,0.1,0.0,0.1,20,GER
25ab9c9c,17,1371,15.2,15,11,2,6,17,26,-9,19.5,31.7,-12.2,20,GER
271b8617,28,1716,19.1,20,4,8,3,23,28,-5,22.2,25.6,-3.5,20,GER
27d2618c,29,2547,28.3,29,28,0,2,39,46,-7,35.7,44.5,-8.9,20,GER
289b90cd,9,742,8.2,8,8,1,20,7,18,-11,9.3,15.7,-6.4,20,GER
28eaa0f3,9,665,7.4,7,5,2,3,6,15,-9,7.4,12.9,-5.6,20,GER
2903a856,24,1633,18.1,18,12,6,3,36,24,12,38.3,24.6,13.7,20,GER
2979c05a,24,1065,11.8,13,2,11,7,11,22,-11,14.2,23.6,-9.3,20,GER
2a29eb9b,5,209,2.3,3,0,2,1,1,3,-2,1.1,3.8,-2.7,20,GER
2a6cd437,11,928,10.3,11,9,0,1,18,19,-1,15.6,15.1,0.5,20,GER
2b09d998,14,953,10.6,10,4,4,1,14,13,1,17.6,11.3,6.2,20,GER
2b53f7a5,13,717,8.0,8,2,5,4,7,21,-14,8.6,17.0,-8.4,20,GER
2bcc6d52,21,1234,13.7,13,9,8,8,16,17,-1,16.8,16.7,0.1,20,GER
2c0558b8,1,3,0.0,0,0,1,1,0,0,0,0.0,0.3,-0.3,20,GER
2d61d13a,26,1777,19.7,21,18,5,4,22,37,-15,19.8,36.5,-16.8,20,GER
2db2fd7b,24,1796,20.0,23,14,1,6,56,15,41,49.8,17.1,32.7,20,GER
2e7ff968,4,290,3.2,3,3,1,27,8,1,7,6.1,5.3,0.8,20,GER
2f3e911a,22,1792,19.9,21,16,1,9,29,49,-20,27.5,40.6,-13.1,20,GER
2ff76adc,4,315,3.5,4,3,0,9,5,2,3,5.6,3.4,2.2,20,GER
302527b2,22,1817,20.2,20,19,2,7,35,23,12,28.3,36.2,-7.9,20,GER
30941e96,13,1095,12.2,12,11,1,1,22,11,11,20.4,13.3,7.1,20,GER
30c220c3,18,1172,13.0,14,10,4,8,26,14,12,23.5,18.6,5.0,20,GER
316162b6,14,675,7.5,8,2,6,7,9,18,-9,8.3,16.2,-7.9,20,GER
33144cc5,20,1162,12.9,14,3,6,9,12,28,-16,14.6,21.3,-6.7,20,GER
33340bd6,5,71,0.8,1,0,4,25,0,3,-3,0.5,1.8,-1.3,20,GER
3376a776,14,1260,14.0,14,14,0,8,17,29,-12,17.2,21.5,-4.3,20,GER
33a95e0a,30,2668,29.6,30,29,0,0,31,60,-29,33.8,57.2,-23.4,20,GER
33b554b7,23,1373,15.3,15,7,8,4,16,24,-8,19.8,24.9,-5.1,20,GER
346d51d9,13,1019,11.3,12,9,1,3,25,17,8,19.1,17.5,1.7,20,GER
3489184e,1,12,0.1,0,0,1,5,0,0,0,0.6,0.1,0.5,20,GER
34a0f5ff,23,1309,14.5,16,6,7,3,17,21,-4,15.4,22.2,-6.8,20,GER
34b306a1,29,2428,27.0,27,23,2,3,30,51,-21,27.5,45.8,-18.3,20,GER
34b54da7,17,1012,11.2,11,6,6,11,21,11,10,27.2,15.1,12.1,20,GER
34e12499,13,373,4.1,4,3,9,20,10,8,2,7.5,10.9,-3.4,20,GER
34e4343c,27,1138,12.6,11,4,16,6,16,33,-17,16.3,23.4,-7.1,20,GER
3588d4fe,1,90,1.0,1,1,0,2,1,5,-4,1.6,2.9,-1.4,20,GER
364445b2,13,1012,11.2,11,9,2,2,21,21,0,17.7,15.4,2.3,20,GER
36a3ff67,19,1495,16.6,18,10,1,0,47,24,23,33.2,20.5,12.6,20,GER
36a59ba4,30,2356,26.2,26,17,4,3,52,29,23,59.7,33.8,25.9,20,GER
3745e8bd,13,330,3.7,2,0,11,13,10,5,5,6.7,6.8,0.0,20,GER
378825c7,19,1448,16.1,16,12,3,7,34,19,15,36.0,21.4,14.6,20,GER
37c213cf,2,43,0.5,0,0,2,13,1,2,-1,0.3,0.7,-0.4,20,GER
37f606f0,21,1136,12.6,13,3,8,5,11,23,-12,15.3,23.6,-8.3,20,GER
384d58d9,23,1947,21.6,22,21,1,0,43,25,18,47.1,29.3,17.8,20,GER
3861d9cc,4,121,1.3,1,0,3,13,0,2,-2,1.7,1.0,0.8,20,GER
3a233281,22,1090,12.1,12,1,10,1,23,17,6,22.0,16.5,5.6,20,GER
3acad81a,9,628,7.0,6,5,3,15,10,12,-2,10.3,10.9,-0.6,20,GER
3bb625ac,24,1484,16.5,18,10,6,3,22,32,-10,23.5,30.9,-7.4,20,GER
3c6089ab,33,2255,25.1,26,14,7,0,78,24,54,66.4,29.8,36.6,20,GER
3cd9e95a,34,3060,34.0,34,34,0,0,51,69,-18,48.9,53.3,-4.4,20,GER
3eb0f2df,28,2256,25.1,25,17,3,2,37,43,-6,31.1,38.2,-7.0,20,GER
3eeb80e0,10,457,5.1,5,1,5,6,13,12,1,10.3,9.7,0.6,20,GER
3effaa34,25,1575,17.5,16,7,9,4,33,35,-2,33.5,27.8,5.7,20,GER
3f65898c,28,2427,27.0,28,26,0,0,39,50,-11,33.8,42.3,-8.5,20,GER
3f7cd8f1,15,586,6.5,6,0,9,6,6,11,-5,8.3,8.3,0.0,20,GER
3faa1780,7,340,3.8,4,0,3,8,7,6,1,5.5,5.4,0.1,20,GER
4114f306,15,676,7.5,6,1,9,16,6,24,-18,6.7,16.7,-10.0,20,GER
420c18a1,34,3060,34.0,34,34,0,0,66,40,26,72.0,45.9,26.1,20,GER
42130443,17,1530,17.0,17,17,0,0,18,36,-18,18.5,34.7,-16.2,20,GER
431c837b,29,2280,25.3,28,12,1,1,27,52,-25,28.3,49.4,-21.1,20,GER
437f2b00,26,1493,16.6,17,6,9,6,24,29,-5,29.7,30.7,-1.0,20,GER
441197b8,22,1721,19.1,20,15,2,12,28,35,-7,30.0,28.0,2.0,20,GER
442b56fa,30,2351,26.1,26,23,4,1,32,54,-22,36.5,46.0,-9.5,20,GER
45954ec7,15,1204,13.4,14,12,1,14,9,16,-7,19.3,14.1,5.2,20,GER
45a03961,32,2790,31.0,31,30,1,1,94,28,66,82.2,34.1,48.1,20,GER
45f6f52b,2,151,1.7,1,1,1,11,1,4,-3,1.3,4.1,-2.8,20,GER
47064058,30,2700,30.0,30,30,0,0,47,49,-2,49.3,51.7,-2.4,20,GER
48035304,32,2618,29.1,30,25,2,0,57,34,23,62.4,38.3,24.1,20,GER
482b70ad,18,350,3.9,3,0,15,8,9,2,7,6.9,6.8,0.1,20,GER
4830e0af,24,1048,11.6,9,5,15,5,15,26,-11,13.3,23.5,-10.2,20,GER
49296448,33,2818,31.3,32,28,1,0,90,31,59,82.1,32.9,49.2,20,GER
493924a7,20,1696,18.8,18,18,2,13,30,30,0,32.9,27.7,5.1,20,GER
4942dad3,3,110,1.2,1,0,2,3,0,6,-6,0.6,2.8,-2.2,20,GER
496aeede,22,1464,16.3,17,12,5,11,33,15,18,34.7,18.5,16.2,20,GER
49fe9070,34,2795,31.1,33,19,1,0,75,29,46,64.6,32.6,32.0,20,GER
49ffe0f2,2,120,1.3,2,0,0,7,2,1,1,2.6,2.2,0.4,20,GER
4aea5077,31,2710,30.1,31,27,0,0,60,37,23,63.7,41.9,21.8,20,GER
4b6dd263,15,325,3.6,1,0,14,7,5,3,2,5.9,3.0,2.9,20,GER
4ba886c6,2,72,0.8,1,0,1,8,3,1,2,2.1,1.1,1.0,20,GER
4bd00a50,3,114,1.3,1,0,2,15,0,3,-3,0.5,3.4,-2.9,20,GER
4c6facae,29,1746,19.4,18,13,11,2,34,32,2,35.4,27.5,7.9,20,GER
4d50454e,28,1210,13.4,14,2,14,6,16,28,-12,17.7,23.9,-6.3,20,GER
4d7faad1,15,378,4.2,3,0,12,15,6,8,-2,4.8,7.1,-2.3,20,GER
4e204552,15,459,5.1,5,0,10,13,8,9,-1,10.5,10.5,0.0,20,GER
4e3a947f,1,33,0.4,1,0,0,16,0,0,0,0.1,0.9,-0.8,20,GER
4f16405e,8,403,4.5,4,2,4,0,12,7,5,9.1,5.5,3.6,20,GER
50871bcc,33,2380,26.4,28,11,5,0,65,26,39,46.1,29.3,16.8,20,GER
50e6dc35,18,1053,11.7,12,3,6,1,13,18,-5,16.3,18.3,-1.9,20,GER
53070b63,13,304,3.4,1,1,12,16,10,2,8,6.2,4.6,1.6,20,GER
536cebe5,1,90,1.0,1,1,0,0,1,0,1,1.8,0.8,1.0,20,GER
53e07d0b,27,1147,12.7,12,4,15,4,15,20,-5,19.2,18.3,0.9,20,GER
541127d5,11,419,4.7,3,0,8,12,2,11,-9,4.9,9.0,-4.2,20,GER
543ddcaf,10,336,3.7,4,1,6,11,3,9,-6,3.4,3.8,-0.4,20,GER
54b4dc4e,25,1573,17.5,18,8,7,7,29,22,7,35.1,28.3,6.8,20,GER
54b6ee79,18,234,2.6,0,0,18,8,2,5,-3,3.7,4.2,-0.6,20,GER
54e4866f,27,1633,18.2,17,4,10,0,26,25,1,26.099999999999998,31.200000000000003,-5.1000000000000005,20,GER
55557b25,5,192,2.1,2,1,3,6,1,5,-4,1.8,4.1,-2.3,20,GER
555d5edd,30,1857,20.6,22,11,8,4,31,25,6,30.9,30.8,0.1,20,GER
56413b1f,27,2118,23.5,23,14,4,0,41,26,15,38.0,33.3,4.7,20,GER
565bf0da,20,1688,18.8,19,15,1,5,32,27,5,30.9,24.3,6.6,20,GER
5722eced,9,307,3.4,3,1,6,18,13,2,11,9.0,4.9,4.1,20,GER
582a5247,2,96,1.1,1,1,1,11,1,5,-4,1.0,3.2,-2.3,20,GER
58ce23e5,11,530,5.9,6,3,5,3,4,14,-10,5.3,9.6,-4.3,20,GER
5939baa2,9,810,9.0,9,9,0,0,14,9,5,12.8,9.0,3.8,20,GER
59e4b92e,32,2649,29.4,32,23,0,1,38,53,-15,36.8,46.8,-10.0,20,GER
5c4bf6ba,22,1935,21.5,22,21,0,3,31,40,-9,30.3,35.9,-5.6,20,GER
5d4f7d61,22,1298,14.4,15,4,7,2,32,15,17,26.9,15.7,11.3,20,GER
5d8e331f,32,2783,30.9,31,28,1,0,43,42,1,42.4,58.7,-16.3,20,GER
5db45ee5,6,109,1.2,0,0,6,7,2,3,-1,4.5,1.0,3.6,20,GER
5ddb8f9f,19,1389,15.4,15,12,4,13,34,27,7,33.3,22.2,11.1,20,GER
5dfc6ad5,28,2245,24.9,25,22,3,0,62,32,30,45.5,32.2,13.3,20,GER
5ed9b537,8,569,6.3,6,6,2,4,15,5,10,13.9,6.9,7.0,20,GER
5fd5e542,5,197,2.2,2,1,3,16,3,4,-1,3.8,4.8,-1.0,20,GER
603cb947,19,1422,15.8,14,12,5,1,34,26,8,30.3,30.6,-0.3,20,GER
607d64c6,2,65,0.7,0,0,2,18,1,3,-2,0.6,2.4,-1.7,20,GER
60dfc525,1,6,0.1,0,0,1,5,0,0,0,0.0,0.0,0.0,20,GER
610aa1e9,15,1261,14.0,14,13,1,5,16,29,-13,16.6,28.2,-11.6,20,GER
612cb8d3,1,16,0.2,0,0,1,1,0,0,0,0.1,0.3,-0.2,20,GER
61fc9685,5,117,1.3,0,0,5,14,3,2,1,2.6,0.8,1.8,20,GER
625e41b1,24,1521,16.9,18,7,6,6,19,29,-10,19.8,30.4,-10.6,20,GER
626fab5f,18,1175,13.1,12,10,6,4,18,16,2,16.7,19.0,-2.3,20,GER
62ab9184,18,828,9.2,7,5,11,12,11,11,0,12.2,9.6,2.6,20,GER
62ba5881,1,90,1.0,1,1,0,32,2,2,0,1.1,1.0,0.1,20,GER
635f2732,28,2266,25.2,26,19,2,5,34,56,-22,34.1,49.6,-15.5,20,GER
64ba07c0,8,574,6.4,8,3,0,12,4,22,-18,5.8,15.1,-9.3,20,GER
64f69877,27,2047,22.7,24,17,3,1,41,28,13,40.4,33.6,6.8,20,GER
652d4c37,13,638,7.1,7,3,6,9,19,7,12,18.5,9.4,9.1,20,GER
66385c46,27,1778,19.8,19,11,8,7,27,40,-13,30.4,32.7,-2.4,20,GER
664590fa,18,701,7.8,8,2,10,9,4,15,-11,6.0,14.4,-8.4,20,GER
677da306,26,1966,21.8,21,21,5,6,21,39,-18,24.0,34.8,-10.8,20,GER
69374ff5,27,1791,19.9,20,13,7,2,37,30,7,35.9,32.5,3.4,20,GER
699fb8db,28,2434,27.0,27,26,1,6,37,37,0,37.2,52.7,-15.5,20,GER
6bba916f,6,177,2.0,1,0,5,8,2,5,-3,2.1,4.1,-2.0,20,GER
6bd5cd5d,21,1594,17.7,17,15,4,13,29,19,10,26.9,20.0,7.0,20,GER
6c6a3300,28,2264,25.2,27,13,1,2,32,53,-21,26.8,42.8,-16.0,20,GER
6cafd68d,11,701,7.8,7,6,4,14,9,15,-6,8.2,19.7,-11.5,20,GER
6cb0211b,1,1,0.0,0,0,1,2,0,0,0,0.1,0.0,0.0,20,GER
6cc47ae1,11,530,5.9,5,2,6,5,12,10,2,11.5,8.8,2.6,20,GER
6ec6fde0,18,1142,12.7,12,11,6,14,19,19,0,19.9,24.1,-4.2,20,GER
6ecbddf6,33,2530,28.1,29,17,4,0,34,54,-20,35.2,47.7,-12.6,20,GER
6f8cd6d0,31,2202,24.5,28,10,3,0,43,26,17,46.9,33.1,13.8,20,GER
6fd8a334,15,1029,11.4,10,7,5,17,18,17,1,19.9,17.0,2.9,20,GER
6fe90922,22,1206,13.4,11,4,11,3,45,12,33,35.7,13.2,22.5,20,GER
70678132,23,985,11.0,9,4,14,4,12,23,-11,9.8,19.700000000000003,-10.0,20,GER
70dcf94d,26,1721,19.1,20,12,6,0,20,30,-10,24.9,37.1,-12.2,20,GER
7124239e,1,14,0.2,0,0,1,2,1,0,1,0.6,0.1,0.5,20,GER
7242b495,25,2057,22.9,22,20,3,8,22,46,-24,24.4,40.3,-15.9,20,GER
73000a79,13,909,10.1,11,5,2,12,23,9,14,19.6,14.7,4.9,20,GER
7391c2d9,21,1339,14.9,16,10,5,3,17,24,-7,15.5,24.2,-8.8,20,GER
74c7c2db,32,2602,28.9,31,19,1,2,37,55,-18,40.5,50.1,-9.6,20,GER
74d70fb5,5,314,3.5,3,2,2,17,3,6,-3,4.5,4.1,0.4,20,GER
76b2817e,31,2329,25.9,29,18,2,1,36,46,-10,34.9,36.3,-1.4,20,GER
76e5da9d,6,271,3.0,3,0,3,6,5,4,1,5.4,5.3,0.1,20,GER
77e84962,24,1771,19.7,20,15,4,1,54,23,31,54.2,24.8,29.4,20,GER
78b9e99c,1,9,0.1,0,0,1,0,0,0,0,0.0,0.0,0.0,20,GER
791abba1,15,1126,12.5,13,12,2,0,16,18,-2,14.7,13.7,1.0,20,GER
791af558,8,64,0.7,0,0,8,19,3,1,2,3.5,1.3,2.2,20,GER
792ffa71,1,16,0.2,0,0,1,4,0,0,0,0.1,0.3,-0.2,20,GER
7961f7aa,23,676,7.5,6,1,17,9,9,10,-1,11.8,15.3,-3.5,20,GER
79c90e45,30,2474,27.5,28,24,2,3,45,40,5,47.6,43.4,4.1,20,GER
79ca3e23,7,447,5.0,6,1,1,6,6,8,-2,7.3,8.1,-0.9,20,GER
7aac47fe,21,1176,13.1,13,9,8,13,17,20,-3,19.6,23.0,-3.4,20,GER
7bd5b8fd,2,2,0.0,0,0,2,6,0,0,0,0.0,0.0,0.0,20,GER
7bf8ad6c,9,448,5.0,5,1,4,12,3,10,-7,5.0,6.3,-1.3,20,GER
7c104bb7,11,309,3.4,1,1,10,19,6,7,-1,7.3,6.0,1.2,20,GER
7c3ed041,7,133,1.5,1,0,6,17,3,4,-1,3.0,4.4,-1.4,20,GER
7c473e12,28,2436,27.1,28,25,0,0,39,40,-1,33.3,41.5,-8.1,20,GER
7c56da38,32,1925,21.4,21,9,11,2,56,20,36,50.1,19.6,30.5,20,GER
7ca196eb,5,92,1.0,1,0,4,10,1,2,-1,0.7,2.2,-1.5,20,GER
7cd6badb,25,1432,15.9,14,2,11,2,30,21,9,34.6,18.3,16.4,20,GER
7d3e7da6,1,90,1.0,1,1,0,32,4,6,-2,2.1,1.7,0.4,20,GER
7d841904,4,102,1.1,1,0,3,9,0,2,-2,0.6,1.8,-1.2,20,GER
7f609bfc,28,2308,25.6,27,19,1,4,38,34,4,42.9,39.2,3.7,20,GER
7f97771d,16,675,7.5,6,3,10,6,21,9,12,21.5,10.0,11.5,20,GER
7fa4e703,15,355,3.9,2,0,13,2,7,6,1,6.6,6.0,0.7,20,GER
7fe12375,10,900,10.0,10,10,0,23,10,12,-2,11.1,15.3,-4.1,20,GER
809940aa,27,1587,17.6,18,11,9,4,19,40,-21,23.5,30.1,-6.5,20,GER
80f36c88,32,2734,30.4,31,25,1,1,46,47,-1,47.3,52.4,-5.0,20,GER
821233cc,23,1965,21.8,23,16,0,8,26,38,-12,24.3,36.4,-12.1,20,GER
826e8b63,31,2706,30.1,31,24,0,1,43,50,-7,39.4,43.7,-4.3,20,GER
834d0be5,24,1174,13.0,11,7,13,9,18,20,-2,22.4,19.7,2.7,20,GER
8494acc4,18,1256,13.9,14,11,4,13,32,29,3,27.9,19.4,8.5,20,GER
8593f88c,34,3029,33.7,34,31,0,0,47,47,0,46.0,64.1,-18.0,20,GER
861e0116,7,398,4.4,4,3,3,14,7,10,-3,4.8,8.4,-3.6,20,GER
863ff1ee,23,813,9.0,7,4,16,6,11,16,-5,14.8,14.8,0.0,20,GER
864db10a,9,544,6.0,6,5,3,12,8,18,-10,7.4,13.8,-6.4,20,GER
867501bf,25,1601,17.8,19,4,6,4,19,31,-12,18.8,29.2,-10.5,20,GER
86e119e0,33,2821,31.3,32,26,1,0,44,43,1,48.3,39.5,8.9,20,GER
8778c910,33,2970,33.0,33,33,0,1,97,31,66,87.3,36.2,51.2,20,GER
88d4144a,26,1887,21.0,19,16,7,3,30,37,-7,23.8,32.2,-8.4,20,GER
88e357ef,31,2193,24.4,26,11,5,2,67,22,45,64.9,26.3,38.6,20,GER
88f130ed,8,365,4.1,4,1,4,3,2,7,-5,3.7,4.3,-0.6,20,GER
8954fddc,18,1455,16.2,16,10,2,15,17,42,-25,17.2,34.9,-17.7,20,GER
89565ac5,7,66,0.7,0,0,7,14,3,1,2,1.3,0.9,0.4,20,GER
89ac64a6,29,2309,25.7,25,24,4,2,70,31,39,49.4,27.9,21.5,20,GER
8a080a61,31,2079,23.1,22,15,9,3,29,47,-18,26.7,43.1,-16.4,20,GER
8b6e0db2,12,375,4.2,2,1,10,10,4,13,-9,3.2,7.7,-4.5,20,GER
8b8e759d,29,2415,26.8,29,22,0,4,35,44,-9,32.1,41.8,-9.6,20,GER
8d78e732,31,2759,30.7,31,29,0,0,89,30,59,79.5,35.0,44.5,20,GER
8e235926,20,1132,12.6,14,5,6,11,7,27,-20,13.3,23.700000000000003,-10.399999999999999,20,GER
8e58987d,11,775,8.6,10,5,1,9,17,15,2,14.8,13.2,1.7,20,GER
8eb55dbb,13,540,6.0,5,1,8,10,7,13,-6,6.6,13.6,-7.0,20,GER
8f056768,23,1719,19.1,21,14,2,2,34,26,8,32.8,26.2,6.6,20,GER
8f0f2230,20,1354,15.0,16,7,4,0,20,21,-1,17.3,21.7,-4.4,20,GER
8ff2354e,29,2520,28.0,28,25,1,1,63,28,35,60.3,31.6,28.7,20,GER
90339309,25,2113,23.5,24,20,1,1,30,43,-13,32.7,41.1,-8.4,20,GER
912e63b5,17,719,8.0,8,1,9,9,6,14,-8,9.4,12.0,-2.6,20,GER
92432bc6,19,756,8.4,5,3,14,15,16,15,1,17.9,12.9,5.0,20,GER
924f9191,16,924,10.3,9,7,7,1,9,26,-17,9.3,19.7,-10.4,20,GER
92948149,23,1878,20.9,20,20,3,10,29,38,-9,26.3,32.6,-6.3,20,GER
93a50d2c,13,999,11.1,11,10,2,7,10,28,-18,12.9,23.0,-10.1,20,GER
94c18565,28,1561,17.3,16,6,12,2,30,34,-4,29.6,26.5,3.1,20,GER
95a24690,4,150,1.7,2,1,2,12,2,4,-2,1.8,2.3,-0.5,20,GER
962e54cb,23,1283,14.3,15,10,8,1,26,22,4,25.7,18.8,6.9,20,GER
9908c518,1,2,0.0,0,0,1,3,0,0,0,0.1,0.0,0.1,20,GER
99b1d0e6,20,1343,14.9,17,9,3,11,21,33,-12,20.6,27.8,-7.2,20,GER
99b7584f,2,9,0.1,0,0,2,1,0,1,-1,0.0,0.2,-0.2,20,GER
99be8fb5,24,949,10.5,10,0,14,10,14,19,-5,11.8,18.3,-6.5,20,GER
99de6b6f,25,2070,23.0,25,20,0,2,42,32,10,40.2,38.5,1.7,20,GER
9a2e0ccc,22,1141,12.7,14,4,8,8,19,20,-1,21.4,18.7,2.8,20,GER
9ab16552,23,1968,21.9,21,21,2,8,42,38,4,42.2,32.4,9.9,20,GER
9af1f9ff,3,110,1.2,0,0,3,8,2,3,-1,1.2,1.8,-0.6,20,GER
9c2394c9,16,1363,15.1,16,15,0,16,18,40,-22,18.6,30.7,-12.1,20,GER
9ceb7642,28,1866,20.7,22,10,6,5,31,44,-13,30.1,39.0,-8.9,20,GER
9d12e142,31,2770,30.8,31,30,0,1,76,40,36,54.9,35.7,19.3,20,GER
9efa1d25,15,521,5.8,5,1,10,12,11,8,3,8.7,7.7,1.0,20,GER
9f381d8b,29,1998,22.2,23,10,6,1,36,41,-5,31.8,32.9,-1.1,20,GER
9f77012e,1,4,0.0,0,0,1,9,0,0,0,0.0,0.0,0.0,20,GER
9f979eb2,11,619,6.9,5,3,6,14,12,12,0,12.9,8.3,4.5,20,GER
9fec8860,12,924,10.3,10,8,2,3,12,26,-14,11.9,20.9,-9.0,20,GER
a0415710,20,1672,18.6,20,13,0,0,35,38,-3,27.2,28.3,-1.2,20,GER
a167537f,33,2203,24.5,25,12,8,0,61,30,31,46.4,32.5,13.9,20,GER
a2a85828,3,79,0.9,1,0,2,3,0,3,-3,0.2,2.4,-2.2,20,GER
a3ddb1b9,23,1515,16.8,18,7,5,3,33,33,0,26.8,23.400000000000002,3.3,20,GER
a4effc55,15,983,10.9,10,10,5,10,32,12,20,20.6,10.9,9.8,20,GER
a4f94a0d,31,2443,27.1,29,17,2,2,35,39,-4,34.2,38.0,-3.9,20,GER
a53b661f,32,2102,23.4,20,15,12,1,38,37,1,36.5,40.9,-4.5,20,GER
a5ae8f8e,24,2051,22.8,23,18,1,3,27,48,-21,26.1,38.5,-12.4,20,GER
a5ce09f2,1,74,0.8,0,0,1,1,2,3,-1,1.2,0.8,0.4,20,GER
a5ec3ede,14,805,8.9,9,7,5,13,12,27,-15,11.9,18.5,-6.6,20,GER
a65ce836,12,955,10.6,10,7,2,0,20,8,12,16.9,10.3,6.6,20,GER
a70b8345,9,810,9.0,9,9,0,20,16,14,2,18.0,13.1,4.9,20,GER
a73c8f95,14,1058,11.8,12,11,2,0,28,20,8,19.6,17.9,1.7,20,GER
a7813ac4,26,1709,19.0,16,13,10,8,21,28,-7,28.2,26.8,1.4,20,GER
a7a9d95a,11,530,5.9,6,3,5,3,13,12,1,12.1,7.8,4.3,20,GER
a8d4428b,28,1416,15.7,15,1,13,2,24,23,1,18.5,25.3,-6.8,20,GER
a92ab7be,10,900,10.0,10,10,0,16,16,14,2,14.8,24.1,-9.3,20,GER
aad48be9,21,1731,19.2,20,15,1,6,26,40,-14,24.1,30.6,-6.4,20,GER
ab5b7dc1,32,2321,25.8,28,12,4,2,29,47,-18,31.5,44.6,-13.1,20,GER
ab700320,14,535,5.9,5,3,9,5,8,12,-4,7.5,11.8,-4.2,20,GER
abf0cad0,6,157,1.7,1,0,5,5,2,5,-3,3.1,4.0,-1.0,20,GER
ac73ec79,25,1783,19.8,21,15,4,8,51,23,28,37.5,23.9,13.6,20,GER
acc7b7ec,14,340,3.8,1,0,13,2,1,9,-8,3.5,6.2,-2.7,20,GER
ad00b1a8,18,1158,12.9,13,8,5,12,24,23,1,22.5,18.0,4.5,20,GER
ad3389d5,34,3060,34.0,34,34,0,0,61,44,17,59.1,51.2,7.8,20,GER
ae44e8e2,12,747,8.3,9,1,3,3,20,5,15,17.0,7.3,9.7,20,GER
aeaf1bc1,2,12,0.1,0,0,2,4,1,0,1,0.5,0.7,-0.2,20,GER
aeda1f69,23,670,7.4,6,0,17,8,7,7,0,11.0,10.4,0.6,20,GER
aeed5c06,28,1771,19.7,18,12,10,6,33,29,4,32.5,33.4,-0.9,20,GER
afb0c500,26,2315,25.7,26,25,0,4,31,40,-9,28.5,35.9,-7.4,20,GER
b0a0698b,26,2207,24.5,26,23,0,0,36,51,-15,32.6,40.8,-8.2,20,GER
b1823b08,2,86,1.0,1,0,1,8,1,0,1,1.7,2.2,-0.5,20,GER
b1cd37e6,33,2958,32.9,33,32,0,0,58,57,1,58.3,48.3,10.0,20,GER
b3325a30,20,1599,17.8,19,12,1,0,28,28,0,23.3,29.4,-6.1,20,GER
b3b7f5a6,22,1220,13.6,12,9,10,12,22,26,-4,19.1,19.4,-0.3,20,GER
b48215cd,7,213,2.4,1,0,6,4,1,5,-4,2.6,4.6,-1.9,20,GER
b4cf5806,33,2682,29.8,31,19,2,0,34,51,-17,37.1,46.6,-9.5,20,GER
b4d90315,7,298,3.3,4,0,3,20,5,6,-1,4.4,8.3,-3.9,20,GER
b500b384,21,1200,13.3,14,2,7,0,20,15,5,18.9,15.5,3.4,20,GER
b50ec54b,9,623,6.9,7,2,2,6,5,10,-5,7.6,10.1,-2.6,20,GER
b69261a0,25,1680,18.7,18,16,7,8,33,22,11,36.4,27.0,9.4,20,GER
b6a6e0a7,14,749,8.3,10,3,4,4,10,15,-5,14.1,15.8,-1.7,20,GER
b77f44a4,31,2789,31.0,31,30,0,1,38,55,-17,37.5,50.2,-12.7,20,GER
b7828a08,1,13,0.1,0,0,1,10,0,0,0,0.1,0.0,0.1,20,GER
b797f558,3,235,2.6,3,1,0,1,2,6,-4,3.1,4.4,-1.2,20,GER
b825a650,11,675,7.5,8,2,3,4,18,6,12,16.8,8.3,8.5,20,GER
b82880c6,1,90,1.0,1,1,0,6,1,2,-1,1.9,1.9,0.0,20,GER
b93b7882,7,195,2.2,1,1,6,7,5,5,0,2.6,4.9,-2.2,20,GER
bb25c778,4,360,4.0,4,4,0,19,8,9,-1,6.1,5.9,0.2,20,GER
bb8a42fa,28,2015,22.4,22,15,6,0,24,44,-20,25.1,42.7,-17.6,20,GER
bbd86530,26,2267,25.2,26,24,0,0,32,44,-12,32.7,42.6,-9.9,20,GER
bc249af8,4,85,0.9,0,0,4,5,2,2,0,1.9,2.6,-0.6,20,GER
bc6bd723,27,2143,23.8,25,16,2,1,39,27,12,46.8,33.3,13.5,20,GER
bcb2ccd8,32,2880,32.0,32,32,0,0,76,34,42,67.7,37.0,30.7,20,GER
bd142efb,25,2092,23.2,22,21,3,6,41,27,14,42.0,33.8,8.2,20,GER
bd527260,13,849,9.4,9,4,4,12,10,23,-13,11.6,16.8,-5.2,20,GER
bd992863,1,26,0.3,0,0,1,10,0,0,0,0.0,0.1,0.0,20,GER
be42a291,5,58,0.6,0,0,5,13,1,2,-1,0.2,1.3,-1.1,20,GER
be5e1c4c,20,1093,12.1,11,4,9,3,13,26,-13,14.1,27.3,-13.2,20,GER
beb882a8,32,2855,31.7,32,31,0,0,40,65,-25,36.6,51.8,-15.2,20,GER
beda9675,25,679,7.5,3,0,22,6,12,19,-7,8.6,10.8,-2.2,20,GER
bee0bab1,26,1424,15.8,17,6,9,2,29,20,9,32.4,25.2,7.1,20,GER
bf075f6b,21,1162,12.9,15,1,6,11,15,17,-2,14.4,23.2,-8.8,20,GER
bf9d9070,28,2520,28.0,28,28,0,3,29,57,-28,32.0,55.0,-23.0,20,GER
c18d22f5,9,769,8.5,9,8,0,6,16,10,6,12.2,13.0,-0.8,20,GER
c1b7847c,29,2115,23.5,26,16,3,2,60,24,36,51.0,24.0,26.9,20,GER
c2009df3,29,2433,27.0,28,25,1,2,41,54,-13,39.1,41.8,-2.7,20,GER
c2211709,32,2672,29.7,31,26,1,2,47,61,-14,44.5,45.9,-1.4,20,GER
c3ee18ef,19,920,10.2,10,6,9,2,30,10,20,23.3,14.4,8.8,20,GER
c3fd9887,25,1257,14.0,15,3,10,9,25,22,3,18.8,23.1,-4.3,20,GER
c41f7379,4,360,4.0,4,4,0,30,6,4,2,6.8,7.8,-1.0,20,GER
c46607bf,1,90,1.0,1,1,0,8,0,2,-2,1.2,1.9,-0.7,20,GER
c4e87b8b,32,2739,30.4,30,27,2,0,42,40,2,48.6,37.8,10.8,20,GER
c50281a0,18,1373,15.3,16,12,2,2,30,22,8,29.2,22.0,7.2,20,GER
c5224618,7,397,4.4,4,3,3,13,4,13,-9,5.1,9.3,-4.2,20,GER
c5fd13e9,10,715,7.9,9,5,1,2,7,15,-8,7.3,11.3,-4.0,20,GER
c6608135,1,21,0.2,0,0,1,1,1,0,1,0.8,0.2,0.6,20,GER
c89e8aae,8,720,8.0,8,8,0,26,5,8,-3,10.5,8.9,1.7,20,GER
c8c60119,19,1491,16.6,18,13,1,11,30,35,-5,28.0,27.2,0.8,20,GER
c8cfb04d,3,111,1.2,1,1,2,7,1,6,-5,1.0,3.8,-2.8,20,GER
ca618d23,34,2485,27.6,28,12,6,0,39,41,-2,38.4,55.2,-16.8,20,GER
ca8033cb,31,2643,29.4,31,27,0,2,77,30,47,64.6,31.6,33.0,20,GER
cac55e10,1,69,0.8,0,0,1,16,0,1,-1,0.4,1.4,-1.0,20,GER
cbac6ec9,13,1125,12.5,12,12,1,18,13,25,-12,17.9,23.7,-5.8,20,GER
cc86b9a3,24,1512,16.8,17,9,7,1,46,13,33,43.9,18.5,25.4,20,GER
cce7087c,6,156,1.7,2,0,4,5,2,6,-4,2.2,4.9,-2.7,20,GER
cd82452e,15,702,7.8,8,3,7,11,8,17,-9,10.9,13.2,-2.3,20,GER
ce17b5eb,22,1980,22.0,22,22,0,1,40,38,2,37.2,31.7,5.5,20,GER
ce2c51c0,11,435,4.8,3,1,8,12,6,10,-4,5.7,11.7,-6.0,20,GER
cf623c78,9,511,5.7,6,2,3,20,5,7,-2,7.7,7.3,0.3,20,GER
d01b9ad6,1,1,0.0,0,0,1,3,0,0,0,0.0,0.0,0.0,20,GER
d1273f09,28,2293,25.5,26,16,2,0,26,42,-16,26.5,38.8,-12.3,20,GER
d1661819,34,3015,33.5,33,33,1,0,38,57,-19,37.7,51.2,-13.5,20,GER
d2416c2e,22,1222,13.6,12,8,10,2,42,16,26,34.3,16.5,17.9,20,GER
d248cd8f,28,2357,26.2,27,24,1,0,66,32,34,56.4,29.6,26.8,20,GER
d2c580ce,3,174,1.9,2,0,1,7,5,3,2,2.8,3.1,-0.3,20,GER
d3112d86,32,2808,31.2,32,28,0,0,33,64,-31,35.8,59.0,-23.2,20,GER
d4a2533d,30,1670,18.6,19,3,11,4,28,25,3,32.0,23.9,8.1,20,GER
d4d0a9ad,16,1364,15.2,16,14,0,5,19,17,2,20.5,15.2,5.4,20,GER
d5575935,13,941,10.5,12,2,1,2,11,14,-3,9.6,11.4,-1.8,20,GER
d571df78,14,510,5.7,4,1,10,10,5,13,-8,8.1,8.7,-0.6,20,GER
d5980989,10,288,3.2,2,2,8,8,2,6,-4,2.5,5.0,-2.4,20,GER
d6862409,33,2720,30.2,31,18,2,0,41,54,-13,39.2,48.2,-8.9,20,GER
d728acae,3,181,2.0,2,2,1,18,1,4,-3,0.9,5.7,-4.8,20,GER
d781d855,29,2234,24.8,24,20,5,4,77,21,56,68.8,26.0,42.8,20,GER
d8f5dc3d,5,179,2.0,2,0,3,17,4,3,1,3.1,4.2,-1.1,20,GER
db401046,26,2340,26.0,26,26,0,0,43,38,5,42.3,34.1,8.2,20,GER
db4ed67b,12,558,6.2,6,1,6,15,13,8,5,6.7,6.4,0.3,20,GER
dbf053da,32,2287,25.4,25,15,7,1,72,31,41,49.9,26.9,23.1,20,GER
dc29b608,2,180,2.0,2,2,0,32,5,3,2,3.7,1.8,1.8,20,GER
dc2e4736,17,1530,17.0,17,17,0,17,18,31,-13,17.4,26.0,-8.6,20,GER
dc366c36,24,2160,24.0,24,24,0,9,35,51,-16,31.9,41.3,-9.4,20,GER
dc3fa3b5,17,1211,13.5,14,10,3,0,37,18,19,32.8,17.8,15.0,20,GER
dc62b55d,21,1023,11.4,11,5,10,7,25,16,9,21.3,15.899999999999999,5.4,20,GER
dc62fbee,29,1892,21.0,23,7,6,3,21,48,-27,20.900000000000002,36.3,-15.4,20,GER
dc90cfbe,24,1475,16.4,16,8,8,0,31,26,5,30.9,23.4,7.5,20,GER
dd669209,27,1585,17.6,19,6,8,5,31,25,6,28.9,22.4,6.5,20,GER
deee6467,3,121,1.3,1,0,2,1,0,1,-1,1.2,2.7,-1.5,20,GER
df8e7b62,34,2259,25.1,25,11,9,0,32,46,-14,27.6,44.4,-16.8,20,GER
dfb6490a,27,1453,16.1,16,6,11,7,38,20,18,41.8,20.7,21.1,20,GER
e0b113a7,30,2572,28.6,30,23,0,0,33,51,-18,35.8,45.9,-10.1,20,GER
e12b0b5b,29,1936,21.5,25,8,4,1,34,41,-7,34.3,36.1,-1.8,20,GER
e199d5b0,34,2923,32.5,33,30,1,0,35,65,-30,34.0,59.6,-25.6,20,GER
e26fcca3,8,634,7.0,7,7,1,0,7,16,-9,7.4,13.4,-6.0,20,GER
e27da244,25,2224,24.7,25,23,0,5,37,34,3,40.8,32.6,8.2,20,GER
e27de4fa,18,1316,14.6,16,11,2,3,24,30,-6,20.2,24.1,-3.9,20,GER
e280527c,32,2499,27.8,30,21,2,0,73,26,47,57.7,29.6,28.1,20,GER
e2d34771,3,270,3.0,3,3,0,10,3,8,-5,4.2,5.1,-0.8,20,GER
e33c06cf,8,641,7.1,8,7,0,0,20,9,11,16.4,7.0,9.3,20,GER
e42d61c7,33,2715,30.2,29,25,4,0,73,34,39,52.6,35.7,16.9,20,GER
e5478b87,12,483,5.4,5,2,7,8,7,9,-2,9.6,8.4,1.3,20,GER
e5649a78,17,1268,14.1,14,11,3,0,18,24,-6,15.3,21.2,-5.9,20,GER
e5a35ae9,23,1268,14.1,14,4,9,1,22,18,4,18.8,24.7,-5.9,20,GER
e5cad51e,1,11,0.1,0,0,1,1,0,1,-1,0.2,0.3,-0.1,20,GER
e5f63987,18,768,8.5,9,0,9,3,19,18,1,14.8,12.1,2.7,20,GER
e6c15f6e,3,35,0.4,0,0,3,14,0,0,0,0.4,0.4,0.0,20,GER
e6c43eec,25,2062,22.9,23,20,2,1,28,30,-2,34.0,28.0,6.0,20,GER
e7199efb,12,500,5.6,5,1,7,8,3,16,-13,4.6,13.2,-8.6,20,GER
e7d22eae,11,474,5.3,4,2,7,7,10,13,-3,8.9,11.0,-2.0,20,GER
e7d59f4f,25,2102,23.4,24,16,1,0,30,37,-7,26.6,35.4,-8.9,20,GER
e7fcf289,7,367,4.1,3,1,4,2,8,5,3,5.9,5.2,0.7,20,GER
e82adcab,3,177,2.0,2,1,1,7,3,1,2,2.6,1.7,0.9,20,GER
e87ad81a,11,850,9.4,9,8,2,8,9,14,-5,14.2,13.3,1.0,20,GER
e881ed15,7,533,5.9,6,4,1,14,7,9,-2,5.2,9.7,-4.6,20,GER
e8fd2e5b,6,540,6.0,6,6,0,28,8,17,-9,7.3,12.4,-5.1,20,GER
ea003d07,1,2,0.0,0,0,1,7,0,0,0,0.0,0.1,-0.1,20,GER
ea6bc03a,32,2705,30.1,31,27,1,0,42,43,-1,40.4,58.6,-18.2,20,GER
eac044ad,14,766,8.5,11,1,3,0,17,8,9,17.6,12.5,5.2,20,GER
ead61f73,11,781,8.7,8,5,3,16,7,15,-8,9.9,16.7,-6.8,20,GER
ecab64a0,24,1628,18.1,21,10,3,5,30,19,11,24.8,22.8,2.0,20,GER
efd623db,23,2070,23.0,23,23,0,0,24,44,-20,26.8,43.5,-16.7,20,GER
f261abcb,23,1941,21.6,22,16,1,4,30,42,-12,28.8,35.4,-6.6,20,GER
f26834c7,32,1728,19.2,16,7,16,0,29,33,-4,29.0,37.6,-8.6,20,GER
f2dd9a21,11,886,9.8,10,7,1,8,11,17,-6,10.0,17.0,-7.0,20,GER
f35430a4,16,1365,15.2,15,15,1,6,10,29,-19,13.9,22.6,-8.6,20,GER
f3722c97,13,673,7.5,9,0,4,3,9,13,-4,8.4,9.7,-1.4,20,GER
f4081572,16,1249,13.9,16,7,0,8,20,33,-13,17.4,24.3,-6.9,20,GER
f42456eb,16,1209,13.4,13,12,3,12,14,30,-16,14.6,27.6,-13.0,20,GER
f4c7c708,1,1,0.0,0,0,1,2,0,0,0,0.0,0.0,0.0,20,GER
f521b80a,31,2780,30.9,31,30,0,0,57,35,22,62.1,41.6,20.5,20,GER
f69fba57,28,1848,20.5,22,6,6,1,26,41,-15,27.3,31.7,-4.4,20,GER
f6bdc830,23,1939,21.5,23,20,0,2,25,35,-10,23.8,31.2,-7.4,20,GER
f7aa75bd,17,1396,15.5,17,14,0,12,23,24,-1,21.5,26.0,-4.5,20,GER
f820504e,31,2638,29.3,30,25,1,1,42,48,-6,38.6,45.4,-6.9,20,GER
f86ad3f5,27,2183,24.3,24,19,3,6,29,47,-18,27.8,37.7,-9.9,20,GER
f86cabbd,18,1462,16.2,16,16,2,14,25,26,-1,22.7,27.4,-4.6,20,GER
f935709c,2,34,0.4,0,0,2,7,0,0,0,1.2,0.8,0.4,20,GER
f93e6e94,34,2436,27.1,24,21,10,0,39,36,3,40.2,51.8,-11.6,20,GER
f972644c,31,2280,25.3,26,13,5,1,36,41,-5,31.6,40.6,-9.1,20,GER
f9acca3a,24,1903,21.1,21,17,3,5,35,29,6,34.0,30.9,3.1,20,GER
f9e7c4ac,21,966,10.7,10,3,11,1,12,16,-4,13.7,15.8,-2.0,20,GER
fa274d97,11,594,6.6,7,5,4,14,12,11,1,11.0,11.3,-0.3,20,GER
fa661778,21,1410,15.7,15,9,6,0,23,31,-8,19.4,24.8,-5.4,20,GER
fbbc8e15,10,381,4.2,4,1,6,8,5,6,-1,5.7,6.1,-0.4,20,GER
fbffc4b1,17,1485,16.5,17,16,0,9,14,21,-7,21.9,22.5,-0.7000000000000002,20,GER
fd53759d,12,554,6.2,7,0,5,7,9,10,-1,6.3,9.5,-3.2,20,GER
fe2db476,29,2106,23.4,25,18,4,4,57,26,31,42.4,27.2,15.3,20,GER
fe641c1a,11,830,9.2,11,5,0,5,19,6,13,16.2,8.5,7.7,20,GER
fe888e39,22,898,10.0,10,5,12,9,21,14,7,20.3,17.0,3.2,20,GER
fed7cb61,30,2454,27.3,29,20,1,1,50,35,15,45.5,40.8,4.8,20,GER
ff182fdc,5,269,3.0,3,1,2,0,2,5,-3,2.9,3.9,-1.0,20,GER
ff45add5,27,1730,19.2,18,13,9,2,19,45,-26,18.9,38.9,-20.1,20,GER
ff5ea0bf,4,76,0.8,0,0,4,5,1,3,-2,0.5,1.4,-0.9,20,GER
ff98492b,31,2608,29.0,29,23,2,1,48,45,3,50.3,52.9,-2.6,20,GER
ffbbc83b,31,2408,26.8,28,20,3,0,40,44,-4,45.2,44.0,1.2,20,GER
007b39a5,26,1384,15.4,14,6,12,2,10,32,-22,10.4,26.9,-16.5,20,ENG
01226327,32,2742,30.5,31,29,1,2,43,44,-1,45.5,38.6,6.9,20,ENG
016ff750,13,480,5.3,4,1,9,0,4,13,-9,3.8,9.9,-6.1,20,ENG
02b29014,37,3156,35.1,36,25,1,0,33,61,-28,45.3,52.0,-6.7,20,ENG
0313a347,25,2039,22.7,24,19,1,13,23,39,-16,24.1,39.6,-15.5,20,ENG
03622183,11,101,1.1,0,0,11,2,3,0,3,4.5,1.2,3.3,20,ENG
0420d84f,27,1839,20.4,21,15,6,6,19,28,-9,24.6,28.3,-3.8,20,ENG
04e195ee,4,51,0.6,0,0,4,8,2,1,1,0.7,1.1,-0.4,20,ENG
0745b37d,36,2886,32.1,33,22,3,1,24,59,-35,32.7,54.7,-21.9,20,ENG
07666c20,5,436,4.8,4,4,1,8,3,6,-3,3.7,7.3,-3.7,20,ENG
07802f7f,38,2804,31.2,32,15,6,0,42,44,-2,45.0,38.8,6.2,20,ENG
08452314,10,311,3.5,3,0,7,9,4,4,0,3.6,3.9,-0.2,20,ENG
0bad4516,16,937,10.4,10,6,6,7,12,17,-5,14.399999999999999,14.2,0.09999999999999987,20,ENG
0d267745,24,1715,19.1,18,17,6,12,51,21,30,45.4,20.2,25.2,20,ENG
0d4ceb32,19,819,9.1,7,2,12,9,13,7,6,10.3,11.0,-0.6,20,ENG
0df2b165,34,2458,27.3,26,21,8,1,27,29,-2,31.1,38.8,-7.6,20,ENG
10072610,4,347,3.9,3,3,1,27,7,7,0,5.4,5.7,-0.3,20,ENG
101da2b5,30,2397,26.6,26,21,4,6,63,26,37,60.0,26.9,33.0,20,ENG
111c3236,16,1190,13.2,13,10,3,1,17,24,-7,20.6,16.5,4.1,20,ENG
119b9a8e,15,1097,12.2,14,6,1,2,36,5,31,34.3,10.1,24.2,20,ENG
1265a93a,24,1515,16.8,16,13,8,5,26,23,3,29.4,15.7,13.7,20,ENG
12aa7661,14,1025,11.4,11,9,3,7,8,28,-20,12.5,20.5,-8.1,20,ENG
1598599e,7,291,3.2,4,1,3,7,5,3,2,7.0,3.5,3.5,20,ENG
15ea812b,38,3420,38.0,38,38,0,0,43,50,-7,47.4,49.8,-2.4,20,ENG
15ea94de,21,647,7.2,5,1,16,4,1,11,-10,7.2,10.8,-3.7,20,ENG
15f3ec41,22,863,9.6,7,4,15,3,17,14,3,18.1,10.4,7.7,20,ENG
16380240,18,1438,16.0,18,7,0,4,24,20,4,19.4,21.9,-2.5,20,ENG
16ceb862,18,993,11.0,12,0,6,7,20,16,4,19.1,9.9,9.2,20,ENG
16fa6881,20,636,7.1,6,2,14,9,5,19,-14,7.5,12.7,-5.1,20,ENG
17370b95,14,679,7.5,7,4,7,9,6,17,-11,8.3,11.5,-3.3,20,ENG
17695062,2,97,1.1,1,0,1,2,0,0,0,0.6,0.9,-0.3,20,ENG
178ae8f8,34,2284,25.4,27,6,7,0,26,28,-2,33.1,25.4,7.7,20,ENG
17d4507a,38,3345,37.2,38,36,0,0,39,39,0,41.7,48.7,-7.0,20,ENG
189cee7b,2,107,1.2,1,0,1,0,1,4,-3,1.2,3.8,-2.6,20,ENG
18b896d6,20,1710,19.0,19,18,1,3,33,24,9,33.8,16.0,17.8,20,ENG
1900032e,19,1497,16.6,17,15,2,12,22,26,-4,24.5,20.5,4.0,20,ENG
1961b2aa,19,1458,16.2,17,13,2,0,15,20,-5,17.6,18.3,-0.6,20,ENG
1a2935f6,10,777,8.6,9,8,1,10,19,11,8,15.4,9.4,6.0,20,ENG
1aa84968,38,3242,36.0,38,25,0,0,33,37,-4,39.1,47.2,-8.1,20,ENG
1ae30132,21,1890,21.0,21,21,0,10,26,19,7,28.5,25.6,2.9,20,ENG
1b84dbe1,35,3030,33.7,35,30,0,1,37,49,-12,42.1,42.3,-0.2,20,ENG
1bf33a9a,25,1722,19.1,19,8,6,4,38,28,10,36.0,20.8,15.1,20,ENG
1bf811d4,17,1293,14.4,15,13,2,9,15,23,-8,17.2,21.2,-4.0,20,ENG
1c7012b8,38,3420,38.0,38,38,0,0,49,62,-13,48.6,63.8,-15.2,20,ENG
1cb49278,21,1751,19.5,21,18,0,14,37,33,4,36.3,21.7,14.7,20,ENG
1d8c99b0,3,137,1.5,1,0,2,2,0,6,-6,0.9,2.6,-1.7,20,ENG
1e0b6a73,15,969,10.8,10,9,5,4,7,21,-14,10.5,20.1,-9.6,20,ENG
1e43fad8,1,21,0.2,1,0,0,19,0,1,-1,0.1,0.9,-0.8,20,ENG
1ecb65be,25,1287,14.3,17,1,8,3,21,19,2,22.2,16.4,5.8,20,ENG
1ef37668,24,1878,20.9,21,17,3,12,22,35,-13,25.4,27.0,-1.6,20,ENG
1fdec858,8,47,0.5,0,0,8,10,2,2,0,1.6,1.3,0.3,20,ENG
20b104bc,24,2055,22.8,24,19,0,0,23,40,-17,27.6,36.7,-9.1,20,ENG
21166ff4,34,3036,33.7,34,33,0,1,63,33,30,54.6,40.3,14.2,20,ENG
21a66f6a,29,2587,28.7,29,26,0,0,49,36,13,35.1,36.1,-0.9,20,ENG
254147d4,18,928,10.3,10,4,8,3,15,13,2,17.9,12.2,5.6,20,ENG
2628fd2b,30,2649,29.4,30,29,0,0,40,39,1,36.5,42.7,-6.2,20,ENG
2649ff32,5,317,3.5,5,0,0,11,2,11,-9,2.5,9.3,-6.7,20,ENG
2691c772,19,1352,15.0,17,5,2,0,19,21,-2,18.2,15.4,2.8,20,ENG
2696b6a9,3,37,0.4,0,0,3,4,0,0,0,0.6,0.1,0.5,20,ENG
26f6dca8,24,1379,15.3,14,6,10,8,17,30,-13,23.2,32.9,-9.7,20,ENG
27c01749,24,1258,14.0,14,0,10,4,17,22,-5,17.9,19.4,-1.5,20,ENG
282f75f3,36,3230,35.9,36,35,0,0,38,50,-12,43.8,50.4,-6.6,20,ENG
28d596a0,33,2970,33.0,33,33,0,5,61,47,14,62.6,34.8,27.8,20,ENG
291e3ec3,12,228,2.5,1,0,11,5,0,9,-9,1.6,5.9,-4.3,20,ENG
2928dca2,38,3420,38.0,38,38,0,0,51,40,11,54.1,38.0,16.1,20,ENG
29733c72,19,758,8.4,8,2,11,19,9,8,1,13.1,8.0,5.1,20,ENG
2973d8ff,16,239,2.7,1,0,15,12,5,8,-3,5.8,3.4,2.4,20,ENG
2acd49b9,29,2452,27.2,28,23,1,0,44,31,13,30.7,34.9,-4.2,20,ENG
2afc7272,27,1352,15.0,14,8,13,7,18,30,-12,18.0,25.4,-7.4,20,ENG
2b114be3,1,12,0.1,0,0,1,2,0,0,0,0.2,0.0,0.2,20,ENG
2b16cb1a,26,1863,20.7,23,9,3,1,26,22,4,22.0,34.4,-12.4,20,ENG
2b1c4abd,9,139,1.5,0,0,9,19,2,3,-1,2.7,1.4,1.2,20,ENG
2b622f01,35,2242,24.9,25,11,10,2,40,29,11,32.9,32.5,0.4,20,ENG
2b91cf8e,14,1186,13.2,14,11,0,4,13,14,-1,10.4,24.1,-13.8,20,ENG
2baec6ce,5,189,2.1,2,2,3,9,1,3,-2,1.9,3.1,-1.2,20,ENG
2bd83368,11,440,4.9,4,0,7,5,4,6,-2,5.1,7.2,-2.1,20,ENG
2bed3eab,13,793,8.8,8,6,5,7,23,7,16,20.9,8.0,12.8,20,ENG
2ce2508a,31,2513,27.9,28,24,3,1,22,38,-16,24.1,41.7,-17.7,20,ENG
2d5f03bf,17,1430,15.9,16,15,1,1,13,27,-14,17.1,25.5,-8.4,20,ENG
2e4f5f03,36,3111,34.6,34,30,2,0,80,31,49,64.7,33.3,31.5,20,ENG
2f7acede,31,2221,24.7,26,16,5,5,37,31,6,29.1,35.7,-6.6,20,ENG
2f90f6b8,22,937,10.4,9,7,13,5,26,9,17,20.8,8.9,11.9,20,ENG
2ff964a0,16,496,5.5,4,3,12,10,3,15,-12,4.4,10.0,-5.5,20,ENG
30941e96,6,423,4.7,4,4,2,9,11,7,4,11.4,4.9,6.5,20,ENG
312626c1,33,2916,32.4,32,32,1,0,35,28,7,37.9,41.5,-3.6,20,ENG
3189f61a,12,751,8.3,8,6,4,2,7,16,-9,7.0,14.4,-7.4,20,ENG
3233eefd,6,244,2.7,2,2,4,30,5,6,-1,3.7,4.8,-1.2,20,ENG
32f60ed8,7,129,1.4,1,0,6,19,2,2,0,2.4,3.1,-0.8,20,ENG
3312f911,17,1036,11.5,11,5,6,2,11,16,-5,10.1,16.2,-6.1,20,ENG
3515d404,38,3420,38.0,38,38,0,0,51,60,-9,56.1,52.8,3.3,20,ENG
3626f7d9,17,1177,13.1,13,13,4,21,12,24,-12,14.9,23.5,-8.6,20,ENG
3631ad41,5,440,4.9,5,4,0,2,5,8,-3,5.5,8.1,-2.6,20,ENG
36c2ca73,28,2520,28.0,28,28,0,8,42,35,7,41.7,37.2,4.5,20,ENG
3727dd3c,26,2119,23.5,25,19,1,6,29,34,-5,25.4,41.9,-16.5,20,ENG
38c7feef,30,1485,16.5,17,0,13,4,35,12,23,27.6,17.4,10.2,20,ENG
38ceb24a,31,2011,22.3,22,10,9,3,23,34,-11,27.4,32.9,-5.5,20,ENG
3935e52e,26,1701,18.9,19,14,7,3,28,26,2,25.5,23.1,2.4,20,ENG
394854c4,38,3420,38.0,38,38,0,0,39,39,0,43.0,51.0,-7.9,20,ENG
39583cfd,28,2098,23.3,25,11,3,0,22,33,-11,27.7,35.5,-7.8,20,ENG
3a24769f,21,1103,12.3,13,4,8,7,27,14,13,26.8,11.0,15.8,20,ENG
3a949a25,38,3420,38.0,38,38,0,0,38,58,-20,35.5,65.6,-30.1,20,ENG
3ae14ed1,34,1950,21.7,20,5,14,3,22,28,-6,20.6,37.7,-17.1,20,ENG
3bb7b8b4,35,3071,34.1,35,34,0,0,95,28,67,86.6,30.5,56.1,20,ENG
3ca7254a,11,661,7.3,8,5,3,13,10,12,-2,12.9,7.3,5.6,20,ENG
3d50bcdb,29,852,9.5,6,1,23,7,12,15,-3,15.7,13.5,2.2,20,ENG
3e5e4e63,29,2428,27.0,28,25,1,3,30,47,-17,32.7,44.4,-11.7,20,ENG
3e9e06cb,29,2361,26.2,26,25,3,5,25,49,-24,36.3,40.9,-4.6,20,ENG
3ea50f67,36,2083,23.1,24,4,12,2,38,24,14,38.1,27.9,10.2,20,ENG
3eb22ec9,34,2030,22.6,23,13,11,3,57,24,33,57.0,20.3,36.7,20,ENG
3f072a68,5,37,0.4,0,0,5,3,0,2,-2,0.9,1.1,-0.2,20,ENG
3f2d59fe,15,1207,13.4,13,12,2,3,21,17,4,16.1,20.3,-4.2,20,ENG
3faa1780,12,695,7.7,8,1,4,4,2,18,-16,6.1,16.1,-10.0,20,ENG
3fe6bd8c,16,1228,13.6,14,11,2,3,14,20,-6,10.7,21.0,-10.4,20,ENG
4115ce4e,34,3057,34.0,34,33,0,2,43,57,-14,50.1,48.9,1.2,20,ENG
41cc19c2,6,96,1.1,0,0,6,7,3,2,1,2.1,1.7,0.5,20,ENG
41fb0f4e,4,22,0.2,0,0,4,12,1,2,-1,0.6,1.1,-0.5,20,ENG
41ff002d,1,7,0.1,0,0,1,11,0,0,0,0.1,0.2,-0.1,20,ENG
422862ea,22,930,10.3,10,4,12,13,11,14,-3,13.7,17.1,-3.4,20,ENG
43439614,38,3090,34.3,37,25,1,0,35,36,-1,37.8,46.4,-8.6,20,ENG
43458538,26,2011,22.3,24,13,2,0,23,37,-14,28.5,35.2,-6.7,20,ENG
4357f557,2,7,0.1,0,0,2,1,0,0,0,0.1,0.0,0.1,20,ENG
43a166b4,28,717,8.0,7,0,21,9,23,12,11,14.2,10.9,3.3,20,ENG
4468ec10,21,622,6.9,3,0,18,11,16,6,10,11.0,6.3,4.8,20,ENG
44781702,18,1431,15.9,16,13,2,6,24,19,5,19.2,21.2,-2.0,20,ENG
44bfb6c5,38,3056,34.0,35,27,3,0,48,35,13,49.1,33.5,15.6,20,ENG
450ab6fc,24,2076,23.1,24,21,0,0,24,31,-7,23.2,39.6,-16.3,20,ENG
4535e4bb,38,3420,38.0,38,38,0,0,39,54,-15,45.4,55.0,-9.5,20,ENG
45963054,35,3033,33.7,34,32,1,0,58,38,20,53.3,41.2,12.2,20,ENG
45ab2170,2,33,0.4,0,0,2,0,0,1,-1,0.1,0.4,-0.3,20,ENG
45da6694,8,607,6.7,7,5,1,4,5,5,0,8.4,6.7,1.7,20,ENG
45db685d,31,2379,26.4,27,19,4,4,45,40,5,48.0,27.0,21.0,20,ENG
45e17712,3,59,0.7,1,0,2,6,0,6,-6,0.3,3.6,-3.3,20,ENG
466fb2c5,37,3330,37.0,37,37,0,0,40,62,-22,44.4,60.2,-15.8,20,ENG
471f16b3,37,2968,33.0,32,29,5,1,17,63,-46,31.8,57.5,-25.6,20,ENG
47369df8,10,805,8.9,9,8,1,3,8,10,-2,7.8,11.5,-3.7,20,ENG
47b7e3af,31,2085,23.2,25,14,6,5,19,31,-12,25.0,33.4,-8.3,20,ENG
4806ec67,38,3420,38.0,38,38,0,0,44,56,-12,50.8,48.3,2.5,20,ENG
48a5a5d6,14,663,7.4,6,5,8,10,7,9,-2,8.4,11.2,-2.8,20,ENG
495945ef,35,3150,35.0,35,35,0,0,42,39,3,44.0,44.2,-0.3,20,ENG
4ab53cdb,36,2016,22.4,20,13,16,0,28,34,-6,30.5,30.8,-0.3,20,ENG
4b40d9ca,38,3420,38.0,38,38,0,0,43,50,-7,47.4,49.8,-2.4,20,ENG
4b511457,30,1860,20.7,20,13,10,8,23,38,-15,27.7,33.3,-5.6,20,ENG
4bcf39f6,37,2766,30.7,30,20,7,1,33,36,-3,39.5,45.1,-5.6,20,ENG
4c370d81,38,2988,33.2,34,14,4,0,75,26,49,62.2,31.9,30.3,20,ENG
4c5b714f,25,1824,20.3,18,15,7,6,27,30,-3,29.9,23.4,6.5,20,ENG
4d034881,24,1452,16.1,18,8,6,2,44,18,26,39.5,16.2,23.2,20,ENG
4e015693,1,9,0.1,0,0,1,6,0,1,-1,0.4,0.1,0.2,20,ENG
4e9a0555,32,2437,27.1,29,17,3,0,27,33,-6,35.3,36.0,-0.6,20,ENG
4f974391,31,2727,30.3,31,28,0,0,41,51,-10,38.7,49.6,-10.9,20,ENG
4fb9c88f,6,126,1.4,1,0,5,10,4,1,3,2.6,0.5,2.1,20,ENG
4fdf1fd9,17,1447,16.1,15,14,2,4,20,32,-12,21.7,32.9,-11.2,20,ENG
507c7bdf,14,1186,13.2,14,7,0,0,28,6,22,20.8,11.6,9.2,20,ENG
50b51fac,6,117,1.3,1,0,5,12,3,2,1,1.8,3.2,-1.3,20,ENG
51a19d04,2,159,1.8,1,1,1,18,1,6,-5,3.2,3.6,-0.4,20,ENG
51b41c5c,15,1001,11.1,12,6,3,4,15,20,-5,18.7,14.0,4.7,20,ENG
51cf8561,19,1276,14.2,13,11,6,5,34,13,21,34.2,15.9,18.3,20,ENG
52105203,16,1266,14.1,14,13,2,15,10,14,-4,14.8,19.8,-5.0,20,ENG
52611641,29,1512,16.8,17,8,12,4,23,23,0,19.5,24.9,-5.5,20,ENG
5271c8f1,19,1492,16.6,18,12,1,8,49,13,36,40.1,13.7,26.4,20,ENG
531a4aa8,11,779,8.7,10,4,1,10,9,20,-11,11.2,14.3,-3.0,20,ENG
5343eb4e,8,212,2.4,2,1,6,9,1,7,-6,1.8,5.6,-3.9,20,ENG
53af52f3,38,3420,38.0,38,38,0,0,67,41,26,62.2,45.5,16.7,20,ENG
53cad200,36,3229,35.9,36,35,0,2,67,53,14,63.1,37.3,25.8,20,ENG
5526deb1,1,16,0.2,0,0,1,5,1,0,1,0.4,0.1,0.4,20,ENG
552aa16c,16,1130,12.6,14,4,2,14,12,25,-13,12.3,19.5,-7.2,20,ENG
558807c0,19,1549,17.2,17,14,2,9,20,27,-7,20.1,27.6,-7.5,20,ENG
56f7a928,37,2828,31.4,32,21,5,1,57,35,22,52.0,38.8,13.2,20,ENG
57df7a11,17,937,10.4,10,7,7,7,7,18,-11,10.3,20.7,-10.4,20,ENG
57e3f0c7,31,2010,22.3,22,11,9,6,38,30,8,29.8,34.6,-4.8,20,ENG
58eee997,31,1320,14.7,12,3,19,6,35,13,22,25.5,12.4,13.0,20,ENG
59d93937,3,26,0.3,0,0,3,4,1,2,-1,1.1,0.2,0.9,20,ENG
59e6e5bf,36,2626,29.2,30,20,6,2,36,43,-7,40.3,38.4,1.9,20,ENG
5a4280b1,8,564,6.3,6,6,2,21,7,5,2,8.0,7.5,0.5,20,ENG
5a7301ae,38,2795,31.1,32,27,6,0,41,34,7,43.9,29.6,14.3,20,ENG
5acc4a10,30,2627,29.2,30,25,0,0,29,48,-19,37.4,43.7,-6.3,20,ENG
5c2b4f07,33,2700,30.0,31,23,2,2,51,32,19,38.6,39.4,-0.8,20,ENG
5cbd1eb0,4,195,2.2,2,2,2,7,1,4,-3,1.9,2.5,-0.6,20,ENG
5cdddffa,21,1009,11.2,12,2,9,6,17,17,0,13.0,17.3,-4.2,20,ENG
5cec2487,27,1896,21.1,23,13,4,7,19,32,-13,25.3,31.9,-6.6,20,ENG
5d8d7454,25,2041,22.7,22,19,3,6,29,36,-7,27.8,43.3,-15.4,20,ENG
5e105217,9,393,4.4,4,0,5,5,8,4,4,8.0,4.4,3.6,20,ENG
5e74d6c8,17,1006,11.2,11,6,6,12,20,10,10,19.7,11.1,8.5,20,ENG
5ea8ef20,24,1748,19.4,19,15,5,5,24,31,-7,23.9,28.7,-4.8,20,ENG
5eecec3d,16,1122,12.5,12,11,4,5,33,16,17,28.4,11.9,16.5,20,ENG
5f09991f,29,2507,27.9,29,25,0,0,21,38,-17,28.3,42.3,-14.0,20,ENG
5f1d07f6,7,585,6.5,7,6,0,1,1,13,-12,3.8,11.2,-7.4,20,ENG
603e4f0b,1,17,0.2,0,0,1,2,0,1,-1,0.0,0.1,-0.1,20,ENG
615ef733,18,1031,11.5,11,9,7,14,11,28,-17,12.4,24.5,-12.1,20,ENG
62437b4f,7,74,0.8,0,0,7,7,1,3,-2,0.1,2.5,-2.5,20,ENG
6250083a,7,77,0.9,1,0,6,17,0,1,-1,0.3,2.2,-1.9,20,ENG
636b64cd,11,366,4.1,3,1,8,13,5,5,0,5.5,4.1,1.5,20,ENG
6385ebfb,2,180,2.0,2,2,0,15,2,5,-3,2.9,4.5,-1.6,20,ENG
63d17038,18,1613,17.9,17,17,1,20,25,26,-1,23.6,23.2,0.4,20,ENG
6421ec64,7,185,2.1,2,1,5,10,6,2,4,3.5,3.1,0.4,20,ENG
6434f10d,35,2486,27.6,29,21,6,1,75,27,48,65.3,24.9,40.4,20,ENG
645a3363,2,21,0.2,0,0,2,3,0,1,-1,0.2,0.2,0.0,20,ENG
64b08de7,33,1680,18.7,16,11,17,5,15,29,-14,18.3,26.4,-8.1,20,ENG
653ee42d,33,2530,28.1,28,24,5,2,31,42,-11,33.9,40.7,-6.9,20,ENG
6613c819,13,1040,11.6,12,10,1,0,18,18,0,15.5,15.5,0.0,20,ENG
6639e500,25,1484,16.5,18,5,7,7,24,16,8,25.1,16.9,8.2,20,ENG
66b76d44,36,2464,27.4,28,19,8,0,21,52,-31,28.6,45.6,-17.0,20,ENG
6813ac34,10,592,6.6,6,5,4,19,5,14,-9,8.3,12.6,-4.3,20,ENG
6992791d,15,712,7.9,7,1,8,4,9,17,-8,11.8,11.0,0.7,20,ENG
6aa3e78b,6,342,3.8,4,3,2,13,5,5,0,5.4,3.9,1.5,20,ENG
6adbc307,28,2451,27.2,27,25,1,6,38,38,0,39.0,38.8,0.2,20,ENG
6b47c5db,32,2674,29.7,29,26,3,0,56,32,24,49.8,36.4,13.4,20,ENG
6bd603db,2,136,1.5,1,1,1,0,1,0,1,0.9,1.8,-0.9,20,ENG
6c203af0,22,1259,14.0,15,4,7,7,8,18,-10,13.8,21.4,-7.6,20,ENG
6c7762c3,4,68,0.8,1,0,3,7,0,3,-3,0.9,0.6,0.2,20,ENG
6ca5ec4b,25,1596,17.7,19,6,6,5,23,30,-7,22.4,24.8,-2.4,20,ENG
6cc47ae1,2,86,1.0,1,0,1,1,1,1,0,0.4,1.4,-1.0,20,ENG
6cdd8245,18,971,10.8,11,8,7,2,7,26,-19,13.2,21.4,-8.2,20,ENG
6d5701f2,29,2284,25.4,25,23,4,2,29,37,-8,35.1,31.9,3.1,20,ENG
6e33125f,6,277,3.1,3,1,3,16,3,8,-5,3.8,6.5,-2.7,20,ENG
6eaed4eb,6,442,4.9,4,3,2,6,5,10,-5,5.1,10.4,-5.3,20,ENG
6f7d826d,36,2612,29.0,28,24,8,1,29,51,-22,32.0,52.8,-20.8,20,ENG
71ef519e,18,1315,14.6,14,9,4,2,11,19,-8,15.0,21.9,-6.9,20,ENG
7314bba4,19,1238,13.8,12,12,7,13,13,18,-5,14.6,18.5,-3.9,20,ENG
7399c7a8,6,504,5.6,6,5,0,5,4,11,-7,5.1,9.5,-4.4,20,ENG
74b2cd7e,31,2786,31.0,31,30,0,5,45,44,1,40.1,50.3,-10.2,20,ENG
74e12f1e,30,2613,29.0,30,24,0,0,31,41,-10,36.1,38.3,-2.2,20,ENG
75566759,30,2338,26.0,28,13,2,3,17,44,-27,22.0,43.6,-21.5,20,ENG
758dd7f0,21,1599,17.8,18,15,3,5,19,21,-2,17.4,26.5,-9.0,20,ENG
75a72a99,28,2520,28.0,28,28,0,0,56,27,29,45.9,33.8,12.2,20,ENG
75f2c59f,28,1648,18.3,17,5,11,5,15,27,-12,23.0,25.7,-2.7,20,ENG
76c131da,1,3,0.0,0,0,1,0,1,0,1,0.1,0.1,0.1,20,ENG
76dd1480,35,2560,28.4,28,19,7,0,35,45,-10,38.7,36.9,1.8,20,ENG
76eca7e2,3,270,3.0,3,3,0,34,2,8,-6,2.6,7.2,-4.7,20,ENG
76fa5f80,4,241,2.7,1,1,3,17,1,6,-5,3.1,5.7,-2.6,20,ENG
774cf58b,36,3240,36.0,36,36,0,0,23,71,-48,34.6,62.1,-27.5,20,ENG
77cf6852,17,1020,11.3,11,7,6,14,13,23,-10,10.3,19.0,-8.8,20,ENG
78b8ac63,36,2113,23.5,24,7,12,2,22,25,-3,27.5,32.3,-4.8,20,ENG
78e87179,2,11,0.1,0,0,2,1,0,1,-1,0.2,0.2,0.0,20,ENG
7914b9fe,25,2167,24.1,25,24,0,2,20,35,-15,22.9,37.8,-14.9,20,ENG
7956236f,9,771,8.6,8,8,1,29,16,9,7,10.5,12.6,-2.1,20,ENG
79b0d6a0,38,3420,38.0,38,38,0,0,51,40,11,54.1,38.0,16.1,20,ENG
79bc4c45,13,594,6.6,6,4,7,17,9,4,5,8.0,7.6,0.4,20,ENG
79c0821a,31,2073,23.0,23,15,8,3,40,37,3,39.8,24.0,15.8,20,ENG
79c84d1c,13,917,10.2,11,4,2,0,15,13,2,17.0,11.3,5.7,20,ENG
79ca3e23,10,724,8.0,9,3,1,3,3,9,-6,9.6,12.0,-2.4,20,ENG
7a11550b,28,2004,22.3,22,21,6,9,53,16,37,42.2,20.9,21.4,20,ENG
7a1f2c08,17,769,8.5,7,4,10,11,7,9,-2,7.6,13.7,-6.1,20,ENG
7a2e46a8,29,2543,28.3,29,27,0,0,61,23,38,50.0,27.3,22.7,20,ENG
7ba2eaa9,29,939,10.4,9,1,20,6,19,12,7,17.1,11.8,5.3,20,ENG
7ba6d84e,38,3420,38.0,38,38,0,0,66,36,30,62.2,37.7,24.5,20,ENG
7ca9f0f0,9,250,2.8,2,0,7,14,1,2,-1,4.1,4.2,0.0,20,ENG
7d2d3329,20,893,9.9,10,4,10,9,16,12,4,11.4,9.9,1.5,20,ENG
7d41b619,5,235,2.6,2,1,3,24,2,6,-4,4.1,7.0,-3.0,20,ENG
7edfbb8a,15,1291,14.3,15,13,0,12,27,18,9,26.6,14.4,12.2,20,ENG
7f3b388c,28,2079,23.1,22,21,6,2,50,26,24,41.0,25.8,15.2,20,ENG
7fcc71d8,9,289,3.2,3,0,6,4,4,0,4,5.6,1.8,3.8,20,ENG
7fec31a0,24,1264,14.0,14,7,10,3,10,23,-13,15.1,24.0,-8.9,20,ENG
80c31c97,11,436,4.8,4,4,7,24,9,6,3,10.6,4.8,5.9,20,ENG
810e3c74,22,935,10.4,9,0,13,4,16,14,2,18.3,11.1,7.2,20,ENG
819aa8e7,33,2004,22.3,26,4,7,5,36,25,11,36.3,22.9,13.4,20,ENG
819b3158,31,2020,22.4,21,16,10,5,50,28,22,49.7,26.0,23.6,20,ENG
82927de4,36,2172,24.1,24,7,12,1,34,35,-1,31.6,37.8,-6.3,20,ENG
82e34b69,27,2225,24.7,26,16,1,2,27,39,-12,32.7,34.3,-1.6,20,ENG
8397a50c,33,2902,32.2,33,32,0,0,36,53,-17,38.3,53.2,-14.9,20,ENG
839c14e1,21,1555,17.3,19,12,2,4,23,20,3,23.2,20.0,3.1,20,ENG
83d074ff,9,352,3.9,4,0,5,1,4,6,-2,4.7,5.2,-0.5,20,ENG
849c826a,23,991,11.0,10,2,13,1,11,17,-6,14.3,17.5,-3.2,20,ENG
862a1c15,36,3021,33.6,35,21,1,1,35,48,-13,31.7,57.5,-25.8,20,ENG
86695068,27,1134,12.6,12,0,15,7,24,17,7,20.0,19.2,0.8,20,ENG
867239d3,16,1204,13.4,13,10,3,0,31,9,22,24.8,12.0,12.7,20,ENG
86dd77d1,29,2392,26.6,28,22,1,7,75,24,51,65.5,26.2,39.3,20,ENG
87935cf3,14,931,10.3,11,8,3,2,7,21,-14,9.4,17.9,-8.6,20,ENG
8816329f,19,749,8.3,6,3,13,9,4,15,-11,4.6,15.4,-10.8,20,ENG
892d5bb1,33,1944,21.6,21,12,12,5,65,15,50,54.6,19.8,34.8,20,ENG
89d10e53,23,1756,19.5,20,14,3,5,23,28,-5,21.7,29.0,-7.300000000000001,20,ENG
89e4b358,29,2488,27.6,28,26,1,7,25,37,-12,32.7,36.9,-4.2,20,ENG
8a7ff278,29,2382,26.5,27,24,2,0,20,36,-16,26.4,37.4,-11.0,20,ENG
8aa5f52c,20,1513,16.8,15,14,5,9,16,33,-17,19.6,33.5,-13.9,20,ENG
8aec0537,29,1796,20.0,22,8,7,9,21,32,-11,24.4,29.0,-4.5,20,ENG
8b04d6c1,33,2752,30.6,30,29,3,1,39,51,-12,45.5,42.4,3.2,20,ENG
8b788c01,32,2624,29.2,31,14,1,0,56,27,29,48.0,29.4,18.7,20,ENG
8b9ebd03,36,2600,28.9,29,18,7,0,52,35,17,53.7,28.3,25.5,20,ENG
8c44e37b,2,18,0.2,0,0,2,3,0,2,-2,0.0,1.3,-1.3,20,ENG
8d3c902d,35,2528,28.1,29,14,6,3,24,36,-12,27.8,41.9,-14.0,20,ENG
8df7a2fb,32,2880,32.0,32,32,0,0,36,45,-9,39.5,42.7,-3.2,20,ENG
8f62b6ee,21,1807,20.1,21,20,0,0,36,21,15,24.2,31.0,-6.7,20,ENG
9050ddc4,19,1493,16.6,18,12,1,2,18,24,-6,14.5,31.4,-16.9,20,ENG
90f91999,28,2312,25.7,27,21,1,0,29,41,-12,32.3,41.6,-9.3,20,ENG
914ab9a1,27,2250,25.0,26,23,1,7,29,35,-6,33.4,33.9,-0.5,20,ENG
91c975a0,2,35,0.4,0,0,2,2,0,2,-2,0.6,1.7,-1.2,20,ENG
9228b07c,30,2027,22.5,23,16,7,6,21,34,-13,25.8,31.5,-5.7,20,ENG
9260926b,11,759,8.4,8,7,3,9,8,20,-12,9.1,18.6,-9.5,20,ENG
92e7e919,30,2476,27.5,28,16,2,0,48,31,17,37.6,37.9,-0.3,20,ENG
9319781b,3,270,3.0,3,3,0,6,5,3,2,3.2,3.1,0.1,20,ENG
9328b835,25,2117,23.5,25,23,0,0,36,34,2,32.2,36.8,-4.6,20,ENG
935e6b8f,30,2238,24.9,26,16,4,1,54,14,40,45.1,22.7,22.4,20,ENG
9460aaed,9,685,7.6,7,4,2,4,7,16,-9,9.1,14.3,-5.2,20,ENG
9674002f,37,2867,31.9,32,20,5,1,60,44,16,56.7,31.8,24.9,20,ENG
96bb8cc2,17,454,5.0,5,0,12,13,7,10,-3,7.4,8.0,-0.6,20,ENG
97220da2,1,5,0.1,0,0,1,0,0,0,0,0.0,0.0,0.0,20,ENG
97333cf5,30,1715,19.1,19,7,11,2,32,25,7,27.8,28.0,-0.2,20,ENG
980522ec,20,1097,12.2,10,6,10,3,20,18,2,14.1,18.2,-4.1,20,ENG
984a5a64,13,944,10.5,10,8,3,4,19,12,7,16.3,13.8,2.5,20,ENG
989d5705,24,1931,21.5,22,16,2,4,25,30,-5,29.7,29.9,-0.2,20,ENG
99813635,15,382,4.2,3,0,12,11,9,5,4,8.0,4.3,3.7,20,ENG
9a104dee,10,468,5.2,4,1,6,11,3,6,-3,5.9,7.4,-1.5,20,ENG
9a28eba4,37,2605,28.9,27,18,10,1,44,33,11,43.7,28.6,15.1,20,ENG
9a526299,2,15,0.2,0,0,2,15,1,0,1,0.9,0.2,0.8,20,ENG
9a9c05db,17,1530,17.0,17,17,0,9,17,31,-14,18.9,24.1,-5.3,20,ENG
9b5ce51a,33,2703,30.0,31,24,2,1,34,48,-14,34.6,46.6,-12.0,20,ENG
9c318325,8,215,2.4,2,0,6,8,2,5,-3,2.1,3.7,-1.7,20,ENG
9c94165b,24,1733,19.3,20,15,4,0,38,15,23,32.0,18.4,13.6,20,ENG
9d107085,2,126,1.4,2,1,0,1,2,2,0,1.8,2.8,-1.1,20,ENG
9d9a71c1,1,1,0.0,0,0,1,2,0,0,0,0.0,0.1,-0.1,20,ENG
9dbb75ca,30,1874,20.8,22,9,8,4,36,25,11,27.4,29.6,-2.2,20,ENG
9deaf2c8,18,548,6.1,4,0,14,3,6,7,-1,8.4,6.3,2.1,20,ENG
9e525177,35,3070,34.1,34,32,1,1,63,33,30,56.9,33.2,23.7,20,ENG
9f1893b9,25,1497,16.6,20,6,5,4,21,27,-6,19.8,27.8,-8.0,20,ENG
9f351459,10,335,3.7,4,0,6,11,1,5,-4,3.2,5.7,-2.5,20,ENG
9f4647e9,24,1509,16.8,17,7,7,4,20,33,-13,17.1,32.4,-15.2,20,ENG
9f472354,26,1395,15.5,15,2,11,5,21,20,1,21.9,18.3,3.6,20,ENG
9f736ed2,2,50,0.6,0,0,2,6,0,1,-1,0.7,1.2,-0.5,20,ENG
9f7c837d,30,2644,29.4,30,28,0,1,21,62,-41,28.2,52.9,-24.7,20,ENG
9fbbcf39,33,2705,30.1,31,28,2,2,41,34,7,45.9,28.0,17.8,20,ENG
a0666d3e,30,2252,25.0,27,13,3,3,23,46,-23,29.7,39.7,-10.0,20,ENG
a07579ee,1,16,0.2,0,0,1,7,1,0,1,0.1,0.3,-0.2,20,ENG
a1232f4e,4,150,1.7,1,1,3,10,5,1,4,2.0,2.2,-0.2,20,ENG
a179d516,5,450,5.0,5,5,0,33,8,7,1,6.6,3.8,2.8,20,ENG
a1d5bd30,31,2643,29.4,31,19,0,0,56,29,27,50.3,28.6,21.7,20,ENG
a29b1131,14,704,7.8,8,2,6,0,11,9,2,9.5,13.8,-4.3,20,ENG
a2b105e0,23,1378,15.3,14,11,9,3,15,26,-11,11.3,24.5,-13.2,20,ENG
a3b03921,29,857,9.5,8,1,21,6,16,16,0,13.1,16.9,-3.8,20,ENG
a4ac4b8f,22,1979,22.0,22,21,0,1,26,15,11,28.3,21.1,7.2,20,ENG
a4fe8cda,12,297,3.3,3,0,9,8,6,6,0,5.5,6.2,-0.7,20,ENG
a53649b7,13,633,7.0,7,2,6,1,8,8,0,7.3,11.5,-4.2,20,ENG
a67a09fb,11,772,8.6,8,7,3,5,15,10,5,15.9,10.3,5.6,20,ENG
a6de6361,20,1794,19.9,20,19,0,0,26,35,-9,25.4,39.8,-14.4,20,ENG
a6e316c1,8,361,4.0,4,0,4,8,6,8,-2,5.2,3.4,1.8,20,ENG
a712ca2b,32,2766,30.7,31,30,1,4,39,54,-15,41.1,53.0,-11.9,20,ENG
a8a3d139,1,7,0.1,1,0,0,12,0,0,0,0.0,0.1,-0.1,20,ENG
a9142dc3,3,136,1.5,2,1,1,0,3,1,2,2.7,1.7,1.1,20,ENG
aa54ec6f,2,113,1.3,2,1,0,0,1,0,1,1.3,1.6,-0.3,20,ENG
ab070c55,24,1261,14.0,13,6,11,3,11,18,-7,14.8,23.7,-8.9,20,ENG
ab13a5aa,35,3150,35.0,35,35,0,0,29,42,-13,33.3,49.8,-16.5,20,ENG
ab4b3e35,27,1280,14.2,15,3,12,6,14,12,2,18.3,13.8,4.5,20,ENG
ab651565,32,2762,30.7,32,24,0,0,43,51,-8,45.8,41.5,4.3,20,ENG
abe66106,25,1215,13.5,12,4,13,2,22,12,10,17.1,22.0,-4.9,20,ENG
ac05f970,24,1768,19.6,19,12,5,0,31,30,1,27.5,29.9,-2.4,20,ENG
ac861941,19,1344,14.9,15,13,4,13,26,23,3,21.7,22.1,-0.4,20,ENG
ad1f61f3,19,1188,13.2,12,10,7,3,19,18,1,18.6,18.6,0.1,20,ENG
ae0a7ddf,16,938,10.4,10,8,6,9,9,18,-9,11.1,21.2,-10.1,20,ENG
af721f98,3,22,0.2,0,0,3,1,0,2,-2,0.2,1.3,-1.2,20,ENG
b017b770,4,27,0.3,0,0,4,8,0,2,-2,0.9,1.6,-0.8,20,ENG
b0b4fd3e,36,3233,35.9,36,35,0,0,39,63,-24,42.6,62.7,-20.1,20,ENG
b0c71810,20,764,8.5,8,1,12,7,10,17,-7,15.1,14.2,0.9,20,ENG
b105919e,1,20,0.2,0,0,1,0,0,0,0,0.1,0.1,0.0,20,ENG
b18095b6,8,404,4.5,4,2,4,19,7,8,-1,8.5,6.3,2.2,20,ENG
b217ef29,9,703,7.8,8,7,1,7,15,5,10,12.0,7.7,4.3,20,ENG
b28bbd58,24,1294,14.4,14,8,10,5,8,23,-15,11.6,22.3,-10.7,20,ENG
b2bc3b1f,38,3280,36.4,37,36,1,0,31,46,-15,34.9,53.8,-18.9,20,ENG
b2d03887,1,6,0.1,0,0,1,10,0,0,0,0.2,0.1,0.1,20,ENG
b2d31e83,34,2880,32.0,33,31,1,0,32,42,-10,37.6,45.5,-7.9,20,ENG
b400bde0,33,2651,29.5,30,19,3,3,71,31,40,70.1,30.0,40.0,20,ENG
b547f08c,1,1,0.0,0,0,1,3,0,0,0,0.0,0.1,-0.1,20,ENG
b561db50,38,3236,36.0,37,20,1,0,48,36,12,50.2,32.7,17.5,20,ENG
b581987a,19,632,7.0,4,3,15,2,9,10,-1,6.6,13.3,-6.8,20,ENG
b606638c,24,1180,13.1,14,0,10,10,13,32,-19,13.5,26.4,-12.9,20,ENG
b63e789d,30,2516,28.0,28,26,2,0,26,30,-4,32.0,40.6,-8.6,20,ENG
b66315ae,34,2030,22.6,21,12,13,1,64,14,50,57.6,18.0,39.6,20,ENG
b682dcf6,19,1696,18.8,19,18,0,13,27,25,2,24.8,26.7,-1.9,20,ENG
b827d5b3,20,867,9.6,9,2,11,16,16,11,5,15.3,12.0,3.2,20,ENG
b853e0ad,29,2163,24.0,23,21,6,5,35,26,9,39.1,25.4,13.7,20,ENG
b937e490,16,652,7.2,6,4,10,18,10,6,4,11.8,6.3,5.5,20,ENG
b9e1436c,2,8,0.1,0,0,2,10,0,0,0,0.2,0.0,0.2,20,ENG
b9fbae28,22,1732,19.2,20,17,2,0,28,25,3,31.3,17.9,13.4,20,ENG
ba115a40,32,2266,25.2,24,20,8,1,31,41,-10,32.0,44.6,-12.5,20,ENG
ba23a904,23,1645,18.3,19,16,4,11,27,24,3,21.1,27.7,-6.5,20,ENG
ba3ca78f,8,687,7.6,7,7,1,12,8,17,-9,9.7,15.1,-5.4,20,ENG
bb5fbd2b,19,1143,12.7,11,3,8,6,15,15,0,14.8,19.9,-5.1,20,ENG
bc7dc64d,26,1753,19.5,19,10,7,6,22,18,4,20.6,26.5,-5.9,20,ENG
bd6351cd,17,1208,13.4,13,12,4,17,35,11,24,32.5,11.0,21.5,20,ENG
bdedffac,7,539,6.0,5,5,2,20,4,12,-8,6.7,8.1,-1.4,20,ENG
be927d03,12,955,10.6,10,9,2,8,12,10,2,16.4,10.9,5.5,20,ENG
bf59c794,1,13,0.1,0,0,1,1,0,0,0,0.2,0.0,0.2,20,ENG
bf8fad51,18,1545,17.2,17,17,1,2,14,34,-20,17.8,30.7,-12.9,20,ENG
bfae110f,21,1782,19.8,21,13,0,0,26,31,-5,23.9,38.4,-14.5,20,ENG
bfdb33aa,28,2028,22.5,22,14,6,2,24,35,-11,32.5,31.9,0.6,20,ENG
c0027d2d,9,575,6.4,6,5,3,13,7,11,-4,4.8,11.1,-6.3,20,ENG
c0617e2b,24,1692,18.8,18,6,6,4,29,21,8,21.6,27.4,-5.7,20,ENG
c067631c,27,2237,24.9,25,23,2,1,35,39,-4,32.8,42.0,-9.3,20,ENG
c0e27d1a,33,2809,31.2,32,30,1,3,47,38,9,40.5,46.6,-6.1,20,ENG
c13c24c8,2,7,0.1,0,0,2,11,0,0,0,0.0,0.0,0.0,20,ENG
c17bfb65,38,2683,29.8,32,11,6,0,23,46,-23,25.5,51.0,-25.4,20,ENG
c1949191,4,300,3.3,2,2,2,5,3,6,-3,3.2,4.9,-1.7,20,ENG
c2111b45,2,163,1.8,1,1,1,10,3,6,-3,2.6,4.0,-1.4,20,ENG
c24dba2a,23,755,8.4,7,2,16,14,6,17,-11,11.8,14.1,-2.3,20,ENG
c2f9d19f,14,1091,12.1,11,10,3,13,11,25,-14,12.2,20.2,-8.0,20,ENG
c40b6180,31,2668,29.6,31,29,0,5,29,44,-15,36.3,45.7,-9.3,20,ENG
c596fcb0,35,2908,32.3,32,27,3,0,36,53,-17,37.5,54.5,-17.1,20,ENG
c5b7c315,31,2559,28.4,28,28,3,6,32,42,-10,36.3,38.0,-1.7,20,ENG
c5bdb6e3,17,631,7.0,7,1,10,10,9,7,2,7.6,10.6,-3.1,20,ENG
c691bfe2,35,2747,30.5,31,19,4,1,66,28,38,54.0,29.3,24.8,20,ENG
c6dc9ecd,31,1646,18.3,20,2,11,3,21,32,-11,23.0,31.3,-8.3,20,ENG
c8aa95da,22,1672,18.6,18,15,4,10,14,37,-23,15.3,33.9,-18.6,20,ENG
c92e1a31,20,960,10.7,12,2,8,9,18,9,9,20.7,11.0,9.7,20,ENG
c931d9f9,33,2287,25.4,26,15,7,4,33,29,4,37.7,26.0,11.7,20,ENG
c951a6df,29,2223,24.7,26,20,3,2,26,32,-6,25.6,43.1,-17.6,20,ENG
caa1a7f0,21,665,7.4,8,0,13,10,12,12,0,9.8,11.3,-1.5,20,ENG
caffaf5a,8,560,6.2,6,6,2,15,5,18,-13,8.2,11.9,-3.7,20,ENG
cc2d7ad5,24,1945,21.6,22,20,2,6,24,18,6,24.8,29.4,-4.5,20,ENG
cd1acf9d,38,3175,35.3,35,31,3,0,80,32,48,65.7,36.7,29.0,20,ENG
ce4246f5,28,2344,26.0,25,24,3,7,47,37,10,45.3,27.6,17.6,20,ENG
ce5143da,18,822,9.1,8,4,10,2,9,15,-6,14.6,12.7,1.9,20,ENG
cea4ee8f,25,1847,20.5,21,12,4,3,32,25,7,29.5,31.2,-1.7,20,ENG
cee31595,37,3090,34.3,37,22,0,0,30,38,-8,31.7,49.9,-18.3,20,ENG
cfd5e123,4,59,0.7,0,0,4,0,0,3,-3,0.7,1.9,-1.3,20,ENG
d0042ab9,27,2054,22.8,24,22,3,7,30,34,-4,32.5,27.9,4.7,20,ENG
d0b3ceb9,38,3420,38.0,38,38,0,0,36,64,-28,48.9,58.1,-9.3,20,ENG
d0b6129f,14,943,10.5,12,5,2,0,11,11,0,9.3,11.8,-2.5,20,ENG
d0f72bf1,3,185,2.1,2,2,1,30,1,2,-1,1.8,2.9,-1.1,20,ENG
d2424d1b,27,2373,26.4,27,25,0,1,48,26,22,41.4,33.7,7.7,20,ENG
d2d74d9c,5,112,1.2,0,0,5,4,1,4,-3,0.6,2.5,-1.9,20,ENG
d328a254,34,2530,28.1,29,19,5,1,31,41,-10,33.4,45.3,-11.9,20,ENG
d484c261,1,90,1.0,1,1,0,7,1,1,0,2.5,0.7,1.8,20,ENG
d4cb83cc,3,270,3.0,3,3,0,0,4,4,0,2.9,4.4,-1.5,20,ENG
d557d734,36,2839,31.5,32,26,4,1,45,31,14,46.9,29.5,17.4,20,ENG
d56543a0,28,2067,23.0,21,19,7,0,22,34,-12,26.6,38.7,-12.1,20,ENG
d5dd5f1f,36,3136,34.8,35,31,1,0,51,44,7,43.4,49.9,-6.5,20,ENG
d7492450,19,1549,17.2,17,14,2,11,18,16,2,15.5,26.6,-11.0,20,ENG
d7553721,28,1492,16.6,15,7,13,4,24,18,6,20.9,23.5,-2.7,20,ENG
d79a8c87,8,581,6.5,6,5,2,10,11,9,2,8.0,10.2,-2.3,20,ENG
d8931174,38,3420,38.0,38,38,0,0,66,36,30,62.2,37.7,24.5,20,ENG
d93c2511,27,1772,19.7,20,13,7,2,28,20,8,30.6,20.3,10.3,20,ENG
d9565625,4,67,0.7,1,0,3,4,0,1,-1,1.2,1.1,0.1,20,ENG
d9ba39fc,27,2332,25.9,27,23,0,10,31,38,-7,30.2,39.2,-9.0,20,ENG
d9cfca3d,30,1240,13.8,11,0,19,3,20,15,5,17.0,20.0,-3.0,20,ENG
da052c14,37,3148,35.0,37,23,0,1,28,45,-17,32.5,51.1,-18.5,20,ENG
da7b447d,29,2431,27.0,27,26,2,6,49,37,12,36.7,39.8,-3.1,20,ENG
dae8623e,14,943,10.5,11,5,3,0,7,18,-11,11.0,16.2,-5.1,20,ENG
dbe56a33,28,1815,20.2,22,6,6,1,23,18,5,24.7,24.8,-0.1,20,ENG
dc008610,3,73,0.8,1,0,2,0,2,0,2,1.3,0.7,0.6,20,ENG
dc4cae05,9,506,5.6,8,0,1,0,6,12,-6,5.0,7.5,-2.5,20,ENG
dc6f5bdd,14,1102,12.2,13,11,1,5,16,15,1,15.2,11.9,3.3,20,ENG
dd0daf32,3,112,1.2,1,0,2,1,2,0,2,2.1,0.4,1.6,20,ENG
dd323728,6,230,2.6,3,0,3,9,5,2,3,3.2,1.9,1.3,20,ENG
de0f152c,26,1821,20.2,20,16,6,3,18,31,-13,26.8,28.5,-1.7,20,ENG
de5b5570,29,1836,20.4,19,10,10,5,24,37,-13,23.9,38.9,-15.0,20,ENG
debe38a0,36,3187,35.4,36,34,0,0,36,30,6,40.8,45.8,-5.0,20,ENG
def899bd,2,135,1.5,2,1,0,10,0,3,-3,1.4,1.6,-0.2,20,ENG
df10e27c,6,194,2.2,2,1,4,5,8,3,5,4.1,2.0,2.1,20,ENG
e06683ca,38,3420,38.0,38,38,0,0,85,33,52,68.9,37.7,31.2,20,ENG
e082af5b,10,900,10.0,10,10,0,28,9,25,-16,14.4,15.6,-1.2,20,ENG
e0900238,2,25,0.3,0,0,2,2,0,2,-2,0.2,0.5,-0.3,20,ENG
e0991c04,3,122,1.4,1,1,2,5,1,2,-1,1.2,1.3,-0.1,20,ENG
e0bc6fdc,15,1024,11.4,13,10,2,7,13,21,-8,20.9,11.6,9.3,20,ENG
e2716bd0,27,1826,20.3,22,10,5,6,59,15,44,49.5,18.9,30.7,20,ENG
e28868f3,35,2887,32.1,33,27,2,1,42,35,7,43.8,33.0,10.8,20,ENG
e2dde94c,7,68,0.8,0,0,7,8,2,1,1,2.7,1.6,1.2,20,ENG
e342ad68,34,2876,32.0,33,20,1,3,68,26,42,58.9,31.2,27.8,20,ENG
e358587b,12,1080,12.0,12,12,0,4,11,20,-9,12.1,19.8,-7.7,20,ENG
e3a5814e,20,1386,15.4,15,14,5,8,22,21,1,19.3,22.7,-3.4,20,ENG
e46012d4,35,2791,31.0,32,20,3,1,87,22,65,79.2,26.1,53.1,20,ENG
e514ab62,28,2291,25.5,27,22,1,2,30,40,-10,31.7,45.3,-13.6,20,ENG
e58a03c6,20,850,9.4,10,2,10,7,14,15,-1,11.0,13.6,-2.5,20,ENG
e5a76dfe,36,3240,36.0,36,36,0,0,36,33,3,41.6,47.3,-5.7,20,ENG
e5d01ecf,28,2237,24.9,26,20,2,3,23,46,-23,32.4,40.7,-8.3,20,ENG
e61b8aee,31,2586,28.7,30,25,1,0,47,31,16,38.9,41.7,-2.8,20,ENG
e7434f04,2,180,2.0,2,2,0,25,3,6,-3,1.5,3.7,-2.3,20,ENG
e75750a3,16,676,7.5,9,2,7,7,7,6,1,7.7,10.2,-2.5,20,ENG
e77dc3b2,32,1651,18.3,17,10,15,6,22,39,-17,21.8,29.2,-7.4,20,ENG
e7ca0439,18,1582,17.6,18,16,0,3,15,23,-8,13.8,27.3,-13.5,20,ENG
e8832875,3,25,0.3,0,0,3,6,1,1,0,0.4,0.8,-0.5,20,ENG
e8c9f4e9,25,1051,11.7,10,0,15,11,11,10,1,12.2,14.4,-2.2,20,ENG
e9254eec,15,1262,14.0,14,13,1,3,12,25,-13,15.3,22.5,-7.2,20,ENG
e97fd090,7,208,2.3,2,0,5,4,4,3,1,4.6,4.1,0.5,20,ENG
e9971f2d,6,525,5.8,6,5,0,9,6,7,-1,6.4,13.3,-6.9,20,ENG
eaeca114,29,2503,27.8,29,27,0,1,30,46,-16,32.7,44.9,-12.2,20,ENG
eb58eef0,37,2935,32.6,35,20,2,0,74,28,46,57.9,34.1,23.8,20,ENG
eb7822d7,21,1581,17.6,18,13,3,6,36,13,23,28.1,16.4,11.7,20,ENG
eba42d2b,17,655,7.3,6,1,11,16,5,11,-6,6.7,11.8,-5.1,20,ENG
ebd0a048,1,6,0.1,0,0,1,5,0,0,0,0.0,0.0,0.0,20,ENG
ecf44e09,6,117,1.3,0,0,6,6,1,6,-5,1.9,4.3,-2.4,20,ENG
ed1e53f3,23,901,10.0,9,4,14,13,34,7,27,21.8,9.3,12.5,20,ENG
ee38d9c5,31,2624,29.2,29,23,2,0,51,26,25,46.9,35.0,11.9,20,ENG
efb9215a,28,2304,25.6,25,21,3,9,14,56,-42,22.0,49.3,-27.2,20,ENG
f08490a6,14,630,7.0,6,2,8,5,4,12,-8,5.7,11.5,-5.8,20,ENG
f1e94cd6,1,3,0.0,0,0,1,2,0,0,0,0.1,0.0,0.1,20,ENG
f23f9d20,36,3240,36.0,36,36,0,0,25,68,-43,33.7,62.0,-28.3,20,ENG
f25b010f,32,2620,29.1,29,28,3,4,33,42,-9,30.0,51.8,-21.8,20,ENG
f25c8e3a,18,815,9.1,9,1,9,9,19,8,11,15.6,6.8,8.8,20,ENG
f2bf1b0f,30,1111,12.3,12,0,18,6,17,17,0,20.0,17.7,2.3,20,ENG
f2f29dda,23,797,8.9,7,2,16,14,12,10,2,11.1,11.1,0.0,20,ENG
f31def1e,8,639,7.1,7,7,1,6,11,15,-4,10.9,11.7,-0.7,20,ENG
f4290206,18,1430,15.9,15,12,3,9,39,18,21,31.8,15.7,16.1,20,ENG
f4e433d4,9,620,6.9,7,3,2,2,7,8,-1,8.4,9.2,-0.7999999999999998,20,ENG
f573a8bf,5,70,0.8,0,0,5,7,0,3,-3,0.5,2.3,-1.7,20,ENG
f586779e,34,2215,24.6,25,9,9,0,45,34,11,46.3,27.5,18.8,20,ENG
f5a00fa4,38,3108,34.5,34,30,4,0,46,36,10,47.6,35.0,12.6,20,ENG
f5deef4c,35,3092,34.4,35,33,0,0,61,32,29,57.3,34.0,23.2,20,ENG
f5e6d08d,1,56,0.6,1,0,0,1,0,0,0,1.3,0.3,1.0,20,ENG
f63d8a4b,37,2489,27.7,30,9,7,0,18,54,-36,26.2,49.2,-23.1,20,ENG
f72293fc,12,621,6.9,6,1,6,3,11,7,4,11.0,7.4,3.6,20,ENG
f76e6b4e,11,875,9.7,9,9,2,27,24,10,14,18.9,10.5,8.4,20,ENG
f7d50789,33,2957,32.9,33,32,0,5,53,39,14,40.7,45.3,-4.7,20,ENG
f833a830,10,249,2.8,2,0,8,7,4,2,2,5.0,2.5,2.5,20,ENG
f874dd44,15,1158,12.9,13,10,2,5,20,18,2,15.5,20.4,-4.9,20,ENG
f8fcd2a5,38,3383,37.6,38,35,0,0,64,40,24,59.7,45.0,14.7,20,ENG
fa031b34,36,3070,34.1,36,26,0,0,39,51,-12,44.5,41.2,3.3,20,ENG
fa38722f,1,3,0.0,0,0,1,8,0,0,0,0.0,0.0,0.0,20,ENG
fb614c44,13,1012,11.2,11,11,2,25,16,14,2,19.3,12.5,6.8,20,ENG
fc027d02,3,267,3.0,3,2,0,0,2,4,-2,5.0,2.6,2.5,20,ENG
fc15fb84,38,3338,37.1,38,31,0,0,41,48,-7,46.6,47.2,-0.6,20,ENG
fcab00a0,27,1534,17.0,18,4,9,10,20,29,-9,21.4,26.3,-4.9,20,ENG
fce2302c,15,989,11.0,12,6,3,4,18,16,2,12.4,19.0,-6.6,20,ENG
fdd85f94,35,2829,31.4,32,28,3,1,33,46,-13,37.4,44.6,-7.2,20,ENG
fe558029,1,90,1.0,1,1,0,1,0,3,-3,0.4,2.0,-1.7,20,ENG
fe8e6fa1,10,195,2.2,2,0,8,19,2,6,-4,2.4,4.5,-2.1,20,ENG
fed96827,12,912,10.1,10,10,2,11,6,19,-13,10.0,16.0,-6.0,20,ENG
ff527768,33,2674,29.7,32,19,1,2,41,44,-3,36.0,48.7,-12.8,20,ENG
ffa90327,34,2051,22.8,26,9,8,3,26,48,-22,29.8,42.3,-12.4,20,ENG
005ca692,2,31,0.3,0,0,2,4,2,1,1,0.5,1.4,-0.9,20,EL
00672021,6,483,5.4,6,2,0,0,13,6,7,9.7,6.5,3.2,20,EL
0076ab7f,10,729,8.1,8,8,2,0,15,4,11,16.1,5.8,10.3,20,EL
007faf7a,2,102,1.1,1,0,1,0,2,1,1,1.2,0.6,0.5,20,EL
00963611,1,90,1.0,1,1,0,0,2,2,0,1.6,0.5,1.1,20,EL
00b28772,7,512,5.7,6,5,1,0,7,6,1,8.5,5.2,3.4,20,EL
00ddb7f7,5,444,4.9,5,3,0,0,5,6,-1,5.1,8.1,-3.0,20,EL
00eba9c9,5,277,3.1,3,1,2,0,4,5,-1,3.6,6.9,-3.3,20,EL
0127419a,4,215,2.4,2,1,2,0,5,3,2,4.3,3.2,1.0,20,EL
01464072,1,90,1.0,1,1,0,2,4,1,3,2.2,0.6,1.6,20,EL
0176f037,5,385,4.3,4,4,1,0,3,5,-2,6.9,7.0,-0.2,20,EL
017ab4d4,2,74,0.8,1,0,1,3,2,2,0,1.7,2.8,-1.1,20,EL
0193a8bf,5,325,3.6,4,2,1,0,4,4,0,4.3,5.3,-1.1,20,EL
01ba3996,1,21,0.2,0,0,1,2,0,0,0,0.2,0.1,0.1,20,EL
02319ad7,7,503,5.6,6,2,1,1,7,5,2,9.5,5.0,4.4,20,EL
023efc8b,1,31,0.3,0,0,1,2,1,1,0,1.6,0.5,1.1,20,EL
02caf6e0,6,540,6.0,6,6,0,0,6,9,-3,6.9,8.0,-1.1,20,EL
02ce2030,6,540,6.0,6,6,0,0,7,11,-4,9.7,9.0,0.7,20,EL
02ee4c77,5,220,2.4,3,0,2,0,1,6,-5,3.0,4.3,-1.3,20,EL
03622183,5,289,3.2,3,2,2,1,10,1,9,7.9,2.2,5.7,20,EL
038aa94a,9,840,9.3,9,9,0,0,13,13,0,12.7,15.1,-2.4,20,EL
03df04ff,2,180,2.0,2,2,0,0,4,5,-1,3.0,3.3,-0.3,20,EL
042d286e,6,488,5.4,5,5,1,0,2,6,-4,7.3,8.2,-0.9,20,EL
04a35432,6,540,6.0,6,6,0,0,6,10,-4,6.2,7.2,-1.0,20,EL
04e17fd5,6,267,3.0,3,0,3,0,4,1,3,4.8,4.0,0.8,20,EL
0534149c,1,53,0.6,1,0,0,3,1,3,-2,0.5,1.4,-0.9,20,EL
053f6e16,5,398,4.4,5,3,0,1,2,4,-2,4.0,7.5,-3.5,20,EL
0562b7f1,6,533,5.9,6,5,0,0,9,7,2,9.6,7.1,2.5,20,EL
05a6c38b,5,213,2.4,2,2,3,1,4,2,2,3.9,3.1,0.8,20,EL
05a84d52,7,602,6.7,7,5,0,0,10,12,-2,11.8,9.6,2.2,20,EL
05cb19c5,6,247,2.7,2,1,4,0,5,4,1,4.0,5.8,-1.8,20,EL
062fc2e6,1,90,1.0,1,1,0,3,1,1,0,1.0,1.2,-0.2,20,EL
068830ca,6,540,6.0,6,6,0,0,8,18,-10,6.1,17.2,-11.1,20,EL
06983922,6,359,4.0,4,0,2,0,8,1,7,6.8,3.8,3.0,20,EL
06a10001,10,890,9.9,10,9,0,0,14,12,2,15.6,12.6,3.0,20,EL
06a1d642,7,214,2.4,2,0,5,2,2,1,1,1.3,1.6,-0.3,20,EL
06e5b0e4,7,555,6.2,6,6,1,1,8,6,2,6.6,7.4,-0.8,20,EL
06f33dc8,9,705,7.8,8,5,1,0,8,12,-4,9.5,13.6,-4.1,20,EL
070a3904,3,84,0.9,1,0,2,3,3,3,0,2.9,1.9,1.0,20,EL
070ec0b1,3,232,2.6,3,1,0,0,6,2,4,5.6,1.7,3.9,20,EL
07a821e4,1,5,0.1,0,0,1,0,0,0,0,0.0,0.0,0.0,20,EL
080440a4,9,810,9.0,9,9,0,0,10,16,-6,13.9,14.2,-0.3,20,EL
0827221a,1,90,1.0,1,1,0,4,0,6,-6,0.3,6.8,-6.6,20,EL
08990838,6,515,5.7,6,4,0,0,6,7,-1,6.4,6.8,-0.4,20,EL
08fe932d,2,82,0.9,2,0,0,0,3,0,3,2.2,0.9,1.3,20,EL
0a6dbbf7,2,180,2.0,2,2,0,0,1,6,-5,1.7,4.7,-3.0,20,EL
0a74011c,3,181,2.0,2,2,1,2,1,3,-2,2.1,2.9,-0.8,20,EL
0ac893aa,8,668,7.4,8,4,0,0,7,5,2,9.8,11.1,-1.3,20,EL
0adc7748,3,270,3.0,3,3,0,2,6,6,0,3.0,5.5,-2.4,20,EL
0aeeed3f,6,517,5.7,6,4,0,0,8,7,1,9.1,7.8,1.3,20,EL
0af4b238,2,46,0.5,0,0,2,3,1,0,1,0.7,0.2,0.5,20,EL
0b0cbe5b,5,249,2.8,2,2,3,0,3,2,1,3.8,2.0,1.7,20,EL
0b380363,6,166,1.8,1,1,5,0,5,8,-3,2.6,7.0,-4.4,20,EL
0b4854f9,2,180,2.0,2,2,0,7,1,1,0,2.1,2.9,-0.8,20,EL
0b4d8274,4,305,3.4,4,2,0,1,3,6,-3,2.5,3.3,-0.8,20,EL
0b4f388a,5,305,3.4,3,1,2,0,2,4,-2,6.6,3.7,2.8,20,EL
0bad4516,3,181,2.0,2,2,1,1,4,1,3,3.7,1.0,2.7,20,EL
0bd57693,1,75,0.8,1,0,0,5,2,3,-1,0.8,1.5,-0.7,20,EL
0be28faf,7,597,6.6,7,5,0,0,12,7,5,10.1,7.3,2.8,20,EL
0be95d34,5,178,2.0,3,0,2,0,1,3,-2,2.9,0.8,2.1,20,EL
0c09c984,6,400,4.4,5,4,1,1,3,6,-3,3.7,5.2,-1.5,20,EL
0c0d6ed1,8,368,4.1,3,1,5,1,7,7,0,6.7,6.5,0.2,20,EL
0cc5f4a5,5,119,1.3,0,0,5,0,0,2,-2,1.9,1.3,0.6,20,EL
0d115860,1,7,0.1,0,0,1,2,1,0,1,0.3,0.0,0.3,20,EL
0d2b0b84,2,135,1.5,2,1,0,3,0,3,-3,1.4,2.7,-1.3,20,EL
0d72fbca,3,139,1.5,1,0,2,0,1,1,0,2.3,0.9,1.4,20,EL
0dce3356,2,180,2.0,2,2,0,0,4,5,-1,3.0,3.3,-0.3,20,EL
0e0102eb,1,29,0.3,0,0,1,0,0,3,-3,0.3,0.8,-0.5,20,EL
0e21fc3c,2,180,2.0,2,2,0,4,4,1,3,3.5,0.5,3.0,20,EL
0e7ccfc4,4,360,4.0,4,4,0,1,11,2,9,8.5,4.1,4.4,20,EL
0e96a5e1,2,106,1.2,1,0,1,0,0,3,-3,1.0,2.8,-1.8,20,EL
0fb5e2ad,4,128,1.4,2,0,2,2,0,9,-9,1.2,6.5,-5.3,20,EL
0fbecd11,4,229,2.5,2,1,2,4,2,3,-1,4.0,5.0,-1.0,20,EL
0fd37a3d,8,665,7.4,8,5,0,0,7,5,2,9.8,11.1,-1.3,20,EL
1001ae82,3,139,1.5,1,1,2,2,0,1,-1,2.1,0.6,1.5,20,EL
1055fa53,1,90,1.0,1,1,0,4,1,0,1,1.9,0.3,1.7,20,EL
108fe016,6,438,4.9,5,3,1,0,8,9,-1,7.9,5.6,2.3,20,EL
10f1cd17,3,196,2.2,2,2,1,1,3,4,-1,3.4,5.0,-1.6,20,EL
110338ae,1,90,1.0,1,1,0,7,0,1,-1,1.0,1.4,-0.5,20,EL
112521d1,5,339,3.8,3,3,2,2,8,3,5,7.4,3.8,3.6,20,EL
113fb4ea,3,270,3.0,3,3,0,5,3,7,-4,4.1,4.8,-0.7,20,EL
1144d8d7,4,187,2.1,1,0,3,1,3,4,-1,2.3,2.6,-0.3,20,EL
116c35df,4,308,3.4,3,2,1,0,8,7,1,4.2,6.1,-1.8,20,EL
11c0fa9d,6,389,4.3,4,3,2,0,6,7,-1,8.0,5.7,2.3,20,EL
11e5e469,4,360,4.0,4,4,0,0,1,8,-7,2.6,7.6,-5.0,20,EL
1232e1dc,6,540,6.0,6,6,0,0,5,8,-3,8.7,4.9,3.9,20,EL
126568a4,1,14,0.2,0,0,1,0,0,0,0,0.0,0.5,-0.5,20,EL
1281be1c,1,90,1.0,1,1,0,1,0,2,-2,1.2,0.7,0.5,20,EL
12dcbdcc,8,720,8.0,8,8,0,0,17,13,4,12.7,10.6,2.1,20,EL
12e6d21a,6,480,5.3,6,4,0,0,7,7,0,8.5,7.6,0.9,20,EL
13203c45,7,413,4.6,5,2,2,2,5,3,2,5.0,4.4,0.6,20,EL
132a82f1,2,180,2.0,2,2,0,1,2,2,0,2.6,1.8,0.8,20,EL
132f161f,2,30,0.3,0,0,2,3,0,1,-1,0.1,0.9,-0.9,20,EL
1395682c,2,180,2.0,2,2,0,0,1,1,0,2.0,3.0,-1.0,20,EL
13a78e01,6,540,6.0,6,6,0,0,4,19,-15,3.1,19.1,-16.0,20,EL
13ac19de,3,112,1.2,1,0,2,0,3,0,3,2.0,0.8,1.2,20,EL
13ddc856,6,506,5.6,6,3,0,0,10,9,1,9.1,7.3,1.8,20,EL
13ea2544,4,364,4.0,4,3,0,0,3,4,-1,2.8,6.9,-4.0,20,EL
146b19d9,5,300,3.3,3,2,2,1,7,9,-2,5.8,5.1,0.7,20,EL
146f71c9,5,437,4.9,5,2,0,0,6,9,-3,4.8,10.3,-5.5,20,EL
14e8fe86,6,533,5.9,6,5,0,0,4,7,-3,8.1,9.3,-1.2,20,EL
1519a888,2,34,0.4,0,0,2,4,0,3,-3,0.9,0.5,0.4,20,EL
15937e17,10,900,10.0,10,10,0,0,20,4,16,15.4,12.0,3.4,20,EL
15b287da,10,736,8.2,8,4,2,0,12,14,-2,14.5,12.5,2.0,20,EL
15b6e8d7,4,332,3.7,4,3,0,1,4,6,-2,6.5,4.6,1.9,20,EL
15d0c248,1,90,1.0,1,1,0,5,1,2,-1,1.6,1.3,0.3,20,EL
15eb04ec,6,474,5.3,5,5,1,0,3,8,-5,7.2,8.6,-1.4,20,EL
16380240,2,151,1.7,1,1,1,0,1,3,-2,2.1,1.5,0.6,20,EL
16657b95,5,422,4.7,5,3,0,0,6,4,2,6.2,6.3,-0.1,20,EL
1668b4b1,2,6,0.1,0,0,2,3,0,0,0,0.0,0.0,0.0,20,EL
16886ee5,5,418,4.6,5,3,0,0,5,9,-4,4.4,10.0,-5.6,20,EL
169fd162,2,180,2.0,2,2,0,0,3,6,-3,2.8,4.7,-1.9,20,EL
16daec92,4,150,1.7,1,0,3,2,4,3,1,1.8,1.6,0.2,20,EL
170eb35b,6,401,4.5,4,4,2,0,4,2,2,6.2,5.1,1.2,20,EL
17145c90,6,540,6.0,6,6,0,0,7,11,-4,9.7,9.0,0.7,20,EL
17310a6c,1,50,0.6,1,0,0,0,0,1,-1,0.3,1.1,-0.8,20,EL
173eb3cd,4,297,3.3,3,2,1,0,0,2,-2,3.3,3.6,-0.4,20,EL
174651c8,7,354,3.9,4,1,3,1,5,5,0,7.6,4.4,3.1,20,EL
176674ab,1,9,0.1,0,0,1,0,0,0,0,0.0,0.4,-0.4,20,EL
17695062,3,233,2.6,3,1,0,0,6,4,2,5.4,3.7,1.7,20,EL
17780d2b,1,90,1.0,1,1,0,2,1,0,1,1.5,1.1,0.5,20,EL
178ae8f8,8,375,4.2,3,1,5,0,13,5,8,9.5,4.8,4.6,20,EL
17e3e467,1,20,0.2,0,0,1,3,1,1,0,0.7,0.7,0.0,20,EL
1858bbf7,8,720,8.0,8,8,0,0,7,5,2,10.1,11.4,-1.3,20,EL
1880614f,3,100,1.1,1,0,2,3,2,3,-1,1.7,1.2,0.6,20,EL
189cee7b,4,255,2.8,4,0,0,1,3,0,3,3.7,1.3,2.4,20,EL
1971591f,5,335,3.7,3,2,2,1,2,7,-5,4.4,5.7,-1.3,20,EL
19f8e480,1,90,1.0,1,1,0,0,0,1,-1,0.8,1.7,-0.9,20,EL
1a1033a1,7,399,4.4,4,3,3,3,6,8,-2,7.7,6.1,1.6,20,EL
1a317a1b,4,360,4.0,4,4,0,0,4,4,0,7.2,4.7,2.5,20,EL
1a672e2d,4,163,1.8,1,0,3,2,2,6,-4,3.3,4.3,-1.0,20,EL
1a6b7ea4,6,435,4.8,5,4,1,0,9,10,-1,6.7,8.5,-1.9,20,EL
1a799243,2,180,2.0,2,2,0,0,3,6,-3,2.8,4.7,-1.9,20,EL
1a9db1c5,2,92,1.0,1,1,1,2,0,5,-5,0.5,3.0,-2.6,20,EL
1adb73db,5,216,2.4,2,1,3,1,1,1,0,3.5,3.8,-0.3,20,EL
1adcf39e,6,540,6.0,6,6,0,0,14,11,3,10.1,8.0,2.1,20,EL
1ae836b1,1,90,1.0,1,1,0,1,1,0,1,1.7,0.8,0.9,20,EL
1b17ed86,6,446,5.0,5,3,1,0,10,3,7,8.2,3.1,5.1,20,EL
1b192c1f,6,540,6.0,6,6,0,0,7,8,-1,6.1,11.1,-4.9,20,EL
1b7ddc55,1,10,0.1,0,0,1,3,0,0,0,0.0,0.1,0.0,20,EL
1b7ec703,2,125,1.4,1,0,1,0,2,2,0,1.1,1.4,-0.3,20,EL
1b81794d,2,22,0.2,0,0,2,4,1,0,1,0.7,0.1,0.6,20,EL
1bd5735a,4,190,2.1,2,2,2,2,2,3,-1,4.9,2.1,2.8,20,EL
1bd5fc78,5,247,2.7,2,2,3,3,4,5,-1,2.6,5.2,-2.6,20,EL
1c0567fc,3,127,1.4,1,0,2,2,1,0,1,0.9,1.9,-1.0,20,EL
1c07b06e,4,319,3.5,4,2,0,0,3,3,0,2.5,4.8,-2.3,20,EL
1c59240b,7,488,5.4,6,1,1,4,7,3,4,5.2,7.8,-2.6,20,EL
1c90cd29,5,277,3.1,3,3,2,0,3,6,-3,5.6,4.2,1.4,20,EL
1c98558c,4,360,4.0,4,4,0,2,5,8,-3,4.0,6.6,-2.7,20,EL
1caa93a5,8,720,8.0,8,8,0,0,12,9,3,8.6,10.8,-2.2,20,EL
1cbe4984,4,303,3.4,3,2,1,0,7,3,4,5.8,4.1,1.6,20,EL
1d5cab82,2,165,1.8,2,1,0,0,3,5,-2,2.8,4.6,-1.9,20,EL
1d896c05,3,110,1.2,1,0,2,0,2,2,0,2.3,1.4,0.9,20,EL
1daec722,8,410,4.6,4,2,4,1,5,4,1,6.8,4.2,2.6,20,EL
1dbfae2d,2,121,1.3,1,0,1,2,1,0,1,1.5,2.0,-0.5,20,EL
1e064bfb,1,90,1.0,1,1,0,2,1,0,1,1.5,0.4,1.1,20,EL
1e26e376,9,840,9.3,9,9,0,2,23,2,21,21.0,5.6,15.4,20,EL
1ec7e1c5,3,270,3.0,3,3,0,3,2,4,-2,4.3,2.3,2.1,20,EL
1eecc0c6,3,206,2.3,2,2,1,0,1,4,-3,2.1,3.9,-1.8,20,EL
1f3afdcb,2,180,2.0,2,2,0,0,1,6,-5,1.7,4.7,-3.0,20,EL
1fbbfbde,7,660,7.3,7,7,0,0,11,12,-1,8.8,10.1,-1.3,20,EL
1fffae99,9,772,8.6,8,7,1,1,9,7,2,6.6,11.8,-5.3,20,EL
2054d037,5,381,4.2,4,4,1,0,3,5,-2,6.6,3.9,2.7,20,EL
2077ae86,2,210,2.3,2,2,0,0,3,1,2,2.8,3.7,-0.9,20,EL
20b9f052,8,659,7.3,7,7,1,1,11,7,4,12.2,10.4,1.9,20,EL
20df3aaf,4,198,2.2,2,1,2,2,3,5,-2,1.5,4.3,-2.8,20,EL
20e73fac,5,373,4.1,4,3,1,0,2,6,-4,5.6,3.6,1.9,20,EL
213cd822,6,540,6.0,6,6,0,0,6,10,-4,6.2,7.2,-1.0,20,EL
21519148,8,720,8.0,8,8,0,0,3,15,-12,7.3999999999999995,10.9,-3.5999999999999996,20,EL
215918bf,2,56,0.6,1,0,1,1,1,0,1,0.7,0.4,0.3,20,EL
220ace7e,6,524,5.8,6,5,0,0,7,8,-1,5.7,10.7,-5.0,20,EL
22a239c1,2,35,0.4,0,0,2,3,2,2,0,1.7,0.9,0.9,20,EL
22a94b80,4,360,4.0,4,4,0,0,3,4,-1,4.1,10.7,-6.6,20,EL
22cd43d2,1,7,0.1,0,0,1,0,0,1,-1,0.1,0.9,-0.9,20,EL
22db7a5e,5,393,4.4,5,4,0,0,7,5,2,4.6,5.7,-1.0,20,EL
230f0471,1,14,0.2,0,0,1,0,0,0,0,0.1,0.2,0.0,20,EL
23c5db70,3,178,2.0,2,1,1,0,4,3,1,4.6,2.3,2.3,20,EL
23f9e9d3,3,86,1.0,0,0,3,1,3,2,1,0.7,2.9,-2.2,20,EL
2402b0e8,5,421,4.7,5,4,0,0,7,14,-7,5.5,13.2,-7.8,20,EL
242e1043,4,276,3.1,3,3,1,1,4,7,-3,4.0,6.2,-2.1,20,EL
244a1281,5,442,4.9,5,4,0,1,6,7,-1,5.0,6.9,-1.9,20,EL
244a31b9,8,720,8.0,8,8,0,0,11,14,-3,6.8,13.1,-6.3,20,EL
244f57b9,6,377,4.2,5,1,1,0,4,6,-2,4.0,5.4,-1.4,20,EL
2475dcc6,2,180,2.0,2,2,0,0,2,3,-1,1.7,2.3,-0.7,20,EL
24b98f95,1,90,1.0,1,1,0,5,2,1,1,1.5,1.2,0.3,20,EL
2513a588,7,582,6.5,6,4,1,0,14,8,6,9.0,7.4,1.5,20,EL
25146df0,6,540,6.0,6,6,0,0,10,10,0,9.9,7.3,2.6,20,EL
25736bcf,1,90,1.0,1,1,0,2,1,1,0,0.8,3.5,-2.7,20,EL
258aff54,6,540,6.0,6,6,0,0,5,4,1,4.7,5.3,-0.5,20,EL
2628fd2b,2,210,2.3,2,2,0,6,2,2,0,4.3,1.5,2.7,20,EL
262e5a82,2,144,1.6,2,0,0,0,4,4,0,2.3,2.7,-0.4,20,EL
2648e18f,4,315,3.5,3,3,1,1,5,7,-2,7.3,5.6,1.7,20,EL
2677a1de,3,246,2.7,3,1,0,1,4,4,0,1.8,2.2,-0.4,20,EL
2696b6a9,6,247,2.7,2,0,4,2,9,2,7,6.6,1.6,5.1,20,EL
26a796c1,8,720,8.0,8,8,0,0,10,12,-2,8.5,12.4,-3.9,20,EL
26ce2263,6,513,5.7,6,3,0,0,10,4,6,7.3,6.8,0.6,20,EL
273c483b,1,90,1.0,1,1,0,4,0,2,-2,0.3,2.3,-2.1,20,EL
275f52fc,1,1,0.0,0,0,1,0,0,0,0,0.0,0.4,-0.4,20,EL
276cce2e,6,433,4.8,5,4,1,0,3,13,-10,5.4,9.4,-4.1,20,EL
27d902c8,2,180,2.0,2,2,0,0,3,6,-3,2.8,4.7,-1.9,20,EL
27f0ddef,6,540,6.0,6,6,0,0,7,6,1,5.9,8.9,-3.0,20,EL
27ff9bdb,2,115,1.3,1,1,1,4,3,3,0,2.8,2.1,0.7,20,EL
282faa70,6,243,2.7,2,1,4,1,5,5,0,4.6,3.4,1.2,20,EL
28a65a2c,2,180,2.0,2,2,0,3,1,2,-1,1.3,2.2,-0.9,20,EL
28b1f3ce,7,582,6.5,7,5,0,0,9,12,-3,10.4,7.4,3.0,20,EL
28b76e67,9,579,6.4,6,5,3,2,8,5,3,10.4,8.1,2.3,20,EL
28eea0fc,3,251,2.8,3,2,0,0,6,7,-1,3.2,5.1,-2.0,20,EL
2903a856,3,182,2.0,1,1,2,0,4,1,3,3.9,2.8,1.1,20,EL
2928dca2,11,990,11.0,11,11,0,0,19,10,9,18.0,10.6,7.3,20,EL
292a652a,6,540,6.0,6,6,0,0,14,11,3,10.1,8.0,2.1,20,EL
29733c72,11,769,8.5,8,7,3,0,23,2,21,18.8,5.9,12.9,20,EL
2a0c8ba4,10,748,8.3,10,4,0,1,13,4,9,15.4,9.3,6.1,20,EL
2a5fab54,1,4,0.0,0,0,1,1,0,0,0,0.1,0.1,0.0,20,EL
2a6cd437,1,90,1.0,1,1,0,2,0,3,-3,0.5,2.4,-1.9,20,EL
2b53f7a5,2,179,2.0,2,1,0,0,1,3,-2,0.5,2.7,-2.2,20,EL
2bab583c,5,450,5.0,5,5,0,1,7,6,1,8.5,6.2,2.3,20,EL
2baec6ce,3,270,3.0,3,3,0,2,6,2,4,5.9,2.6,3.3,20,EL
2bea06e0,1,90,1.0,1,1,0,1,0,2,-2,0.2,0.8,-0.6,20,EL
2c0f8e9e,5,241,2.7,2,2,3,1,5,1,4,5.7,1.7,4.0,20,EL
2c44a35d,1,90,1.0,1,1,0,0,1,1,0,1.4,1.2,0.1,20,EL
2cb77ec6,4,335,3.7,4,3,0,2,3,2,1,4.4,5.9,-1.5,20,EL
2cbb3202,6,419,4.7,5,2,1,0,6,7,-1,5.5,5.0,0.5,20,EL
2d49b833,4,279,3.1,3,2,1,1,3,2,1,4.4,3.6,0.8,20,EL
2d7d4acc,6,461,5.1,6,3,0,0,9,7,2,11.5,5.8,5.7,20,EL
2e5e846d,2,125,1.4,2,0,0,0,2,2,0,1.8,1.4,0.4,20,EL
2ebc1b44,5,436,4.8,5,2,0,0,6,5,1,7.3,5.2,2.1,20,EL
2ef7c612,2,41,0.5,0,0,2,0,0,2,-2,0.6,1.1,-0.5,20,EL
2f52874b,6,510,5.7,6,5,0,0,8,18,-10,5.9,16.7,-10.8,20,EL
2f7af524,5,426,4.7,5,4,0,1,3,10,-7,5.4,7.0,-1.6,20,EL
2f8e326a,6,470,5.2,5,5,1,0,2,5,-3,5.4,7.8,-2.4,20,EL
30061f53,6,540,6.0,6,6,0,0,10,13,-3,6.4,13.0,-6.6,20,EL
301b1e4c,1,15,0.2,0,0,1,1,0,0,0,0.0,0.6,-0.6,20,EL
30223b33,2,151,1.7,2,1,0,4,3,2,1,2.9,1.2,1.7,20,EL
30263816,1,90,1.0,1,1,0,5,1,1,0,0.5,0.6,-0.1,20,EL
303636d2,2,92,1.0,1,1,1,0,1,1,0,0.2,1.7,-1.5,20,EL
3046fcff,2,94,1.0,1,1,1,4,0,1,-1,1.4,1.6,-0.2,20,EL
3060f38c,8,646,7.2,7,4,1,0,6,4,2,9.1,9.4,-0.3,20,EL
30643ce2,4,219,2.4,2,0,2,1,5,1,4,4.9,1.9,3.0,20,EL
3098c0df,4,222,2.5,3,0,1,4,1,2,-1,1.2,2.5,-1.3,20,EL
30c220c3,2,135,1.5,1,1,1,2,5,2,3,2.6,1.1,1.5,20,EL
30d4a2e5,6,540,6.0,6,6,0,0,7,7,0,10.8,6.7,4.1,20,EL
30d75bfb,2,180,2.0,2,2,0,2,4,4,0,2.8,2.5,0.3,20,EL
30f5ffa9,1,7,0.1,0,0,1,4,0,0,0,0.0,0.0,0.0,20,EL
31114001,6,230,2.6,1,0,5,0,5,1,4,4.4,3.1,1.3,20,EL
314a0ea4,6,401,4.5,5,1,1,0,10,3,7,8.0,3.3,4.7,20,EL
316de854,8,636,7.1,8,3,0,0,9,9,0,7.6,9.9,-2.3,20,EL
31c01b85,7,332,3.7,3,3,4,1,8,7,1,6.1,5.3,0.8,20,EL
31c69ef1,2,180,2.0,2,2,0,0,4,5,-1,3.0,3.3,-0.3,20,EL
31e3ab68,1,90,1.0,1,1,0,4,1,1,0,0.8,3.5,-2.7,20,EL
31faf295,5,244,2.7,2,1,3,3,2,3,-1,1.9,5.2,-3.3,20,EL
328f7d51,8,320,3.6,3,2,5,1,4,4,0,3.5,5.2,-1.7,20,EL
32c016f8,7,239,2.7,3,1,4,3,2,4,-2,4.9,3.3,1.6,20,EL
32e73151,6,425,4.7,5,2,1,0,6,8,-2,6.3,10.7,-4.4,20,EL
32e7ce92,5,450,5.0,5,5,0,0,6,11,-5,8.4,8.2,0.3,20,EL
32f60ed8,4,248,2.8,4,0,0,2,2,3,-1,1.9,2.5,-0.5,20,EL
3318286e,4,354,3.9,3,3,1,4,8,7,1,6.1,5.8,0.3,20,EL
3353737a,5,450,5.0,5,5,0,4,9,4,5,7.7,6.3,1.4,20,EL
33887998,4,274,3.0,4,3,0,1,3,6,-3,3.7,2.2,1.5,20,EL
339fe0e8,4,360,4.0,4,4,0,0,5,7,-2,5.6,5.5,0.2,20,EL
33b11df6,6,491,5.5,6,1,0,2,11,7,4,8.0,5.6,2.4,20,EL
33b8d077,5,390,4.3,4,2,1,0,10,4,6,7.2,4.5,2.7,20,EL
3423f250,4,274,3.0,3,2,1,0,1,3,-2,5.0,3.4,1.6,20,EL
34269bdf,4,286,3.2,3,3,1,2,3,2,1,3.9,8.5,-4.6,20,EL
346d51d9,1,90,1.0,1,1,0,0,3,3,0,1.8,1.8,0.0,20,EL
34a88e3e,3,133,1.5,1,0,2,2,2,1,1,2.1,3.3,-1.2,20,EL
34b54da7,2,117,1.3,2,1,0,4,1,1,0,2.5,1.5,1.1,20,EL
34c3b935,6,540,6.0,6,6,0,0,14,11,3,10.1,8.0,2.1,20,EL
34caa4b3,8,636,7.1,8,5,0,0,14,9,5,14.7,7.3,7.4,20,EL
350e71a0,4,309,3.4,4,2,0,1,3,11,-8,2.4,7.4,-5.1,20,EL
35141f4c,5,296,3.3,3,3,2,1,4,7,-3,4.4,6.9,-2.6,20,EL
352ca5eb,1,90,1.0,1,1,0,5,2,2,0,0.8,2.3,-1.4,20,EL
356c9002,1,1,0.0,0,0,1,5,0,0,0,0.1,0.0,0.1,20,EL
35bd124a,2,180,2.0,2,2,0,4,4,3,1,3.0,2.7,0.3,20,EL
3626daea,8,611,6.8,7,4,1,0,10,7,3,11.0,9.3,1.7,20,EL
366f6f12,4,271,3.0,3,2,1,0,4,2,2,6.3,4.2,2.1,20,EL
36a59ba4,5,374,4.2,5,2,0,1,4,7,-3,7.1,6.0,1.1,20,EL
36a79857,6,532,5.9,6,4,0,0,4,7,-3,7.8,9.2,-1.4,20,EL
36d836c9,3,270,3.0,3,3,0,1,1,6,-5,1.4,5.1,-3.7,20,EL
36d9dabe,1,14,0.2,0,0,1,7,0,0,0,0.0,0.1,-0.1,20,EL
36f19a65,3,58,0.6,0,0,3,3,2,1,1,0.5,0.3,0.2,20,EL
3767b3b7,4,288,3.2,4,2,0,0,3,4,-1,3.6,9.5,-5.9,20,EL
378825c7,6,292,3.2,3,3,3,0,4,5,-1,7.3,4.5,2.8,20,EL
379652be,6,409,4.5,6,0,0,1,8,5,3,7.3,5.0,2.3,20,EL
379dc075,6,522,5.8,6,3,0,0,7,8,-1,6.0,9.8,-3.9,20,EL
37e103f8,2,69,0.8,1,0,1,3,1,2,-1,1.8,1.2,0.6,20,EL
37f827ec,4,285,3.2,3,3,1,1,4,6,-2,5.8,4.9,0.8,20,EL
37faa4cb,2,39,0.4,0,0,2,2,1,2,-1,1.2,1.7,-0.6,20,EL
3814b753,2,141,1.6,2,0,0,3,0,0,0,2.0,0.9,1.0,20,EL
384d58d9,6,540,6.0,6,6,0,0,6,9,-3,11.3,8.3,3.0,20,EL
389f24bf,4,118,1.3,1,0,3,1,2,1,1,2.5,3.1,-0.6,20,EL
38e78902,1,10,0.1,0,0,1,0,0,0,0,0.1,0.3,-0.2,20,EL
3904e745,8,720,8.0,8,8,0,0,10,12,-2,8.5,12.4,-3.9,20,EL
392a7aea,2,180,2.0,2,2,0,0,1,6,-5,1.7,4.7,-3.0,20,EL
3935e52e,1,79,0.9,1,0,0,4,1,0,1,1.9,1.8,0.1,20,EL
3a233281,5,103,1.1,0,0,5,0,2,1,1,1.0,2.0,-1.0,20,EL
3acadb7f,4,360,4.0,4,4,0,7,4,4,0,6.4,4.9,1.5,20,EL
3bb7f478,8,684,7.6,8,6,0,1,12,8,4,12.8,10.5,2.3,20,EL
3c16d927,6,540,6.0,6,6,0,0,14,3,11,13.1,3.7,9.4,20,EL
3c70fb81,8,413,4.6,5,3,3,2,6,7,-1,6.8,6.8,0.0,20,EL
3cb6f224,9,630,7.0,7,1,2,0,8,5,3,5.6,8.5,-2.9,20,EL
3cdfc63e,6,540,6.0,6,6,0,0,5,7,-2,8.6,9.4,-0.8,20,EL
3ce20eda,1,63,0.7,1,0,0,0,0,1,-1,0.4,1.8,-1.4,20,EL
3cefa66a,5,450,5.0,5,5,0,0,6,8,-2,6.4,11.2,-4.8,20,EL
3d022757,1,45,0.5,0,0,1,3,0,2,-2,0.3,1.8,-1.4,20,EL
3d13d9e4,2,40,0.4,0,0,2,0,0,0,0,0.3,0.8,-0.5,20,EL
3d214e5f,8,720,8.0,8,8,0,0,16,11,5,16.1,10.5,5.5,20,EL
3d2320f7,5,415,4.6,5,2,0,0,3,6,-3,6.0,6.2,-0.2,20,EL
3da8cba0,1,5,0.1,0,0,1,4,0,0,0,0.0,0.1,-0.1,20,EL
3e59d360,1,22,0.2,0,0,1,0,1,1,0,1.7,1.7,0.0,20,EL
3e975352,6,269,3.0,4,1,2,0,7,6,1,6.3,3.2,3.1,20,EL
3ed84b2c,3,98,1.1,1,0,2,2,1,1,0,0.9,2.1,-1.1,20,EL
3effaa34,9,654,7.3,9,3,0,0,9,11,-2,12.4,10.4,2.0,20,EL
3f10bd22,6,507,5.6,6,4,0,0,8,4,4,8.2,7.4,0.8,20,EL
3f2d59fe,7,627,7.0,7,5,0,0,13,6,7,16.5,7.1,9.3,20,EL
3f359b33,5,450,5.0,5,5,0,0,6,11,-5,8.4,8.2,0.3,20,EL
3fa66cb2,1,90,1.0,1,1,0,4,2,2,0,1.0,0.4,0.6,20,EL
4030c7ae,6,540,6.0,6,6,0,0,5,7,-2,8.6,9.4,-0.8,20,EL
4037db79,8,654,7.3,7,7,1,0,11,14,-3,6.8,12.5,-5.8,20,EL
403f5d20,2,180,2.0,2,2,0,2,4,3,1,1.6,2.2,-0.7,20,EL
40ca6712,3,188,2.1,2,2,1,3,0,3,-3,1.1,3.8,-2.7,20,EL
40e236a8,3,30,0.3,0,0,3,2,2,0,2,0.8,0.2,0.6,20,EL
40ef7347,4,112,1.2,1,0,3,1,0,2,-2,0.9,4.2,-3.3,20,EL
418befe0,6,540,6.0,6,6,0,0,10,10,0,9.9,7.3,2.6,20,EL
41b3069f,5,450,5.0,5,5,0,1,13,8,5,10.7,7.2,3.5,20,EL
41c12f75,5,447,5.0,5,4,0,1,5,6,-1,8.4,5.8,2.6,20,EL
41c7bfd7,2,41,0.5,1,0,1,0,0,1,-1,0.4,1.2,-0.7,20,EL
41f32541,7,570,6.3,6,6,1,1,10,6,4,9.8,8.3,1.6,20,EL
41ff002d,1,13,0.1,0,0,1,4,1,1,0,0.8,0.1,0.7,20,EL
420c18a1,6,540,6.0,6,6,0,0,6,9,-3,11.3,8.3,3.0,20,EL
4242011c,3,225,2.5,3,2,0,1,5,1,4,4.3,0.7,3.6,20,EL
424d5f72,2,180,2.0,2,2,0,1,2,3,-1,1.3,1.6,-0.3,20,EL
4253363a,1,58,0.6,1,0,0,0,1,1,0,0.3,0.6,-0.3,20,EL
42ec696a,5,450,5.0,5,5,0,0,2,9,-7,6.6,8.3,-1.7,20,EL
4383b0da,6,451,5.0,6,1,0,0,11,7,4,6.1,7.7,-1.6,20,EL
438ae11e,5,354,3.9,4,2,1,1,3,9,-6,4.3,4.9,-0.6,20,EL
4398b5cb,1,90,1.0,1,1,0,0,2,0,2,0.7,1.2,-0.5,20,EL
43f71e77,6,211,2.3,2,0,4,2,5,2,3,5.3,2.4,3.0,20,EL
441197b8,5,405,4.5,5,4,0,5,7,6,1,7.6,5.7,1.9,20,EL
4431aed2,4,265,2.9,3,2,1,0,3,5,-2,3.7,3.3,0.4,20,EL
447837d1,5,320,3.6,3,3,2,1,2,14,-12,1.3,13.4,-12.2,20,EL
44ac04e9,1,90,1.0,1,1,0,1,2,0,2,1.7,0.0,1.7,20,EL
44b49036,1,1,0.0,0,0,1,1,0,0,0,0.0,0.0,0.0,20,EL
44bfb6c5,9,775,8.6,9,8,0,1,11,6,5,12.5,7.8,4.7,20,EL
44eb9093,6,463,5.1,6,1,0,0,14,5,9,9.5,4.4,5.1,20,EL
450ad405,10,930,10.3,10,10,0,0,13,16,-3,13.2,18.4,-5.2,20,EL
4515f00d,5,197,2.2,2,0,3,1,2,6,-4,2.3,4.8,-2.4,20,EL
4574720b,3,270,3.0,3,3,0,0,4,3,1,2.9,5.0,-2.1,20,EL
45954ec7,7,609,6.8,7,6,0,3,9,10,-1,9.5,7.7,1.8,20,EL
45b9b619,3,252,2.8,3,2,0,1,3,3,0,3.1,4.0,-0.8,20,EL
45e11f7e,5,450,5.0,5,5,0,0,8,11,-3,5.3,11.8,-6.6,20,EL
467bae22,10,376,4.2,3,3,7,0,11,2,9,9.3,2.9,6.4,20,EL
468fdbad,2,161,1.8,2,1,0,0,2,3,-1,2.1,1.6,0.5,20,EL
469d3d84,2,33,0.4,0,0,2,0,0,0,0,0.9,0.1,0.8,20,EL
46e58246,3,264,2.9,3,2,0,3,5,5,0,3.3,5.2,-2.0,20,EL
46ff3923,2,180,2.0,2,2,0,5,2,3,-1,2.8,2.4,0.5,20,EL
4760b2f2,8,709,7.9,8,7,0,0,12,9,3,8.4,10.6,-2.3,20,EL
47a0b54d,6,540,6.0,6,6,0,0,8,10,-2,7.0,13.3,-6.3,20,EL
47a34c4f,6,406,4.5,4,4,2,0,5,11,-6,8.1,7.8,0.3,20,EL
47dc80f5,2,180,2.0,2,2,0,0,4,5,-1,3.0,3.3,-0.3,20,EL
48035304,5,450,5.0,5,5,0,0,5,9,-4,9.7,7.2,2.5,20,EL
481c9ece,6,540,6.0,6,6,0,0,9,12,-3,7.7,9.9,-2.2,20,EL
482e9289,2,180,2.0,2,2,0,4,2,6,-4,3.5,3.7,-0.2,20,EL
485eaf31,6,540,6.0,6,6,0,0,6,10,-4,6.2,7.2,-1.0,20,EL
489e80e3,2,110,1.2,1,1,1,0,3,2,1,2.4,2.6,-0.2,20,EL
48a2b92a,8,648,7.2,8,4,0,0,10,10,0,12.7,10.3,2.4,20,EL
48a5a5d6,7,424,4.7,5,3,2,1,12,5,7,11.8,4.7,7.1,20,EL
48b28bfd,4,243,2.7,4,1,0,0,3,3,0,3.2,3.1,0.2,20,EL
48e89655,2,86,1.0,1,0,1,0,1,0,1,1.6,0.8,0.8,20,EL
48f984b4,1,1,0.0,0,0,1,6,0,0,0,0.0,0.0,0.0,20,EL
4914ed4a,3,123,1.4,1,1,2,0,2,3,-1,1.4,1.1,0.2,20,EL
493924a7,5,316,3.5,3,3,2,2,6,3,3,5.2,3.6,1.6,20,EL
496aeede,4,317,3.5,4,1,0,0,3,9,-6,6.1,5.3,0.8,20,EL
49e9d799,10,486,5.4,6,1,4,0,8,6,2,8.9,6.1,2.8,20,EL
4a1a9578,8,401,4.5,5,0,3,0,9,10,-1,8.8,7.5,1.3,20,EL
4a1abff3,6,540,6.0,6,6,0,0,8,11,-3,10.0,6.2,3.9,20,EL
4a537185,2,69,0.8,1,0,1,2,0,2,-2,0.7,1.9,-1.2,20,EL
4a56052c,8,555,6.2,6,5,2,0,10,6,4,10.8,7.9,2.9,20,EL
4a5a45c7,5,234,2.6,2,0,3,0,6,0,6,5.8,2.2,3.6,20,EL
4a895384,3,270,3.0,3,3,0,0,3,4,-1,4.3,3.4,0.9,20,EL
4aea5077,6,540,6.0,6,6,0,0,6,9,-3,11.3,8.3,3.0,20,EL
4b1793b0,2,180,2.0,2,2,0,1,1,5,-4,1.5,2.4,-0.9,20,EL
4b2ad4b1,4,360,4.0,4,4,0,1,0,2,-2,4.4,3.5,0.9,20,EL
4b3c863f,2,180,2.0,2,2,0,0,4,5,-1,3.0,3.3,-0.3,20,EL
4b803b3c,1,90,1.0,1,1,0,0,1,4,-3,1.4,3.0,-1.6,20,EL
4be0b467,1,72,0.8,1,0,0,1,0,0,0,1.2,0.4,0.7,20,EL
4c07f0e8,7,568,6.3,6,5,1,0,10,9,1,6.2,9.9,-3.7,20,EL
4c3a6744,7,542,6.0,6,5,1,1,11,4,7,11.0,6.3,4.8,20,EL
4c45cdc2,1,37,0.4,0,0,1,1,1,1,0,0.9,0.7,0.2,20,EL
4c6facae,9,765,8.5,9,8,0,0,14,14,0,15.3,11.7,3.6,20,EL
4c78b5ed,3,237,2.6,3,2,0,0,3,5,-2,4.0,3.6,0.4,20,EL
4ca4f601,2,12,0.1,0,0,2,2,0,0,0,0.0,0.2,-0.2,20,EL
4d0eb7d2,2,121,1.3,2,0,0,0,1,4,-3,1.1,3.5,-2.3,20,EL
4d1666ff,9,810,9.0,9,9,0,2,16,4,12,15.2,8.4,6.8,20,EL
4d425e6e,6,506,5.6,6,3,0,0,8,8,0,9.8,5.0,4.8,20,EL
4d8cf390,5,147,1.6,2,0,3,0,1,3,-2,2.0,3.8,-1.8,20,EL
4d982baf,7,344,3.8,4,0,3,1,6,6,0,7.0,5.5,1.5,20,EL
4da9191b,8,651,7.2,8,5,0,1,8,9,-1,7.6,10.4,-2.8,20,EL
4e015693,4,282,3.1,3,1,1,2,6,2,4,4.5,2.8,1.7,20,EL
4e219ad2,6,460,5.1,6,0,0,0,8,4,4,7.0,6.8,0.2,20,EL
4e358a2d,7,553,6.1,6,6,1,2,10,6,4,10.7,7.1,3.5,20,EL
4e6dbac4,4,308,3.4,3,3,1,0,5,7,-2,5.5,5.2,0.3,20,EL
4f56170e,4,390,4.3,4,4,0,0,3,4,-1,3.6,7.2,-3.6,20,EL
4f5a953e,6,540,6.0,6,6,0,0,8,11,-3,10.0,6.2,3.9,20,EL
4f8ce0e1,7,630,7.0,7,7,0,1,10,11,-1,7.6,11.0,-3.4,20,EL
4fc7c059,1,90,1.0,1,1,0,3,0,4,-4,0.3,2.5,-2.3,20,EL
4fe7e935,2,151,1.7,2,1,0,4,4,1,3,2.8,1.2,1.6,20,EL
501055d8,1,45,0.5,0,0,1,0,1,2,-1,1.0,1.6,-0.6,20,EL
5042e5c2,2,40,0.4,0,0,2,0,0,1,-1,0.2,0.4,-0.1,20,EL
505d9778,1,90,1.0,1,1,0,4,0,1,-1,1.5,1.1,0.5,20,EL
507c7bdf,10,810,9.0,9,6,1,1,18,6,12,16.8,7.9,8.9,20,EL
50d85cd8,8,660,7.3,8,5,0,0,10,12,-2,7.8,11.8,-4.0,20,EL
50dc94ce,2,180,2.0,2,2,0,0,2,3,-1,1.7,2.3,-0.7,20,EL
50e73475,1,90,1.0,1,1,0,4,1,2,-1,1.0,1.6,-0.6,20,EL
50f823d3,3,45,0.5,0,0,3,3,0,0,0,0.2,0.0,0.2,20,EL
518918ad,8,720,8.0,8,8,0,0,12,9,3,8.6,10.8,-2.2,20,EL
520c318f,6,270,3.0,3,0,3,1,2,7,-5,3.4,3.6,-0.3,20,EL
52611641,6,347,3.9,3,3,3,0,12,4,8,12.4,5.3,7.1,20,EL
526541e5,6,530,5.9,6,5,0,0,3,9,-6,7.7,9.6,-1.9,20,EL
5294a83f,4,208,2.3,2,0,2,0,3,3,0,2.4,3.1,-0.8,20,EL
52e101a8,5,450,5.0,5,5,0,0,6,6,0,7.4,5.9,1.4,20,EL
53070b63,2,24,0.3,0,0,2,0,1,1,0,0.2,0.7,-0.5,20,EL
532aa911,5,292,3.2,3,0,2,3,5,4,1,3.5,4.0,-0.5,20,EL
539230cf,2,180,2.0,2,2,0,4,4,1,3,3.5,0.5,3.0,20,EL
546bb36e,4,263,2.9,3,1,1,1,4,3,1,3.2,4.0,-0.7,20,EL
54771b10,6,540,6.0,6,6,0,0,4,19,-15,3.1,19.1,-16.0,20,EL
54b4dc4e,4,350,3.9,4,3,0,0,8,5,3,6.3,5.1,1.2,20,EL
54bcdeb0,2,63,0.7,0,0,2,1,1,2,-1,1.2,1.1,0.1,20,EL
54c9ed15,7,630,7.0,7,7,0,1,11,8,3,6.8,9.9,-3.1,20,EL
54f5ce34,1,90,1.0,1,1,0,1,0,5,-5,0.3,3.5,-3.2,20,EL
5529e983,3,255,2.8,3,2,0,2,2,7,-5,3.7,4.5,-0.8,20,EL
555d5edd,3,203,2.3,2,2,1,0,5,2,3,4.2,1.9,2.3,20,EL
55a480e4,2,55,0.6,1,0,1,1,0,0,0,0.2,0.5,-0.4,20,EL
55abe554,2,151,1.7,2,1,0,0,1,4,-3,1.5,3.9,-2.4,20,EL
55ae91f0,2,42,0.5,0,0,2,2,1,1,0,0.6,0.9,-0.3,20,EL
55bd7d45,7,630,7.0,7,7,0,1,6,13,-7,4.3,12.2,-7.9,20,EL
56413b1f,3,251,2.8,3,2,0,0,6,1,5,5.6,1.5,4.0,20,EL
565bf0da,9,810,9.0,9,9,0,0,13,17,-4,15.3,14.8,0.5,20,EL
56f6f826,10,900,10.0,10,10,0,0,13,12,1,11.8,14.0,-2.2,20,EL
571d3ac1,6,441,4.9,5,4,1,0,3,10,-7,2.9,6.6,-3.7,20,EL
572498c7,8,621,6.9,7,6,1,0,8,10,-2,7.6,10.6,-3.0,20,EL
57760e66,5,346,3.8,4,2,1,0,6,4,2,5.0,5.9,-0.9,20,EL
57ae16f4,6,385,4.3,5,1,1,0,6,4,2,5.7,5.7,-0.1,20,EL
57e3f0c7,6,298,3.3,2,2,4,1,7,3,4,9.2,2.8,6.3,20,EL
580bcd18,7,316,3.5,2,1,5,1,10,6,4,7.8,5.7,2.0,20,EL
58797f45,1,1,0.0,0,0,1,0,0,0,0,0.0,0.0,0.0,20,EL
588de166,4,295,3.3,4,1,0,1,7,5,2,4.6,3.9,0.7,20,EL
58a9a4d9,5,337,3.7,4,1,1,4,11,1,10,8.9,1.6,7.3,20,EL
58afe001,6,440,4.9,5,3,1,1,6,4,2,7.4,4.0,3.4,20,EL
58dda688,5,435,4.8,5,4,0,3,7,8,-1,6.2,9.5,-3.3,20,EL
58eee997,9,640,7.1,7,4,2,2,14,4,10,14.3,5.4,8.9,20,EL
5906ab00,3,100,1.1,1,1,2,1,0,4,-4,0.3,2.6,-2.3,20,EL
593bf50d,4,360,4.0,4,4,0,0,5,7,-2,4.1,4.3,-0.2,20,EL
595ccab1,1,90,1.0,1,1,0,0,1,1,0,2.0,0.6,1.3,20,EL
5976f83e,2,180,2.0,2,2,0,0,2,3,-1,1.7,2.3,-0.7,20,EL
59a3efba,4,128,1.4,1,0,3,2,1,0,1,1.7,3.3,-1.6,20,EL
59a7d912,10,677,7.5,9,1,1,0,12,8,4,11.6,8.9,2.7,20,EL
59fd245c,2,53,0.6,0,0,2,2,2,0,2,2.1,0.4,1.7,20,EL
5a28b2d9,8,638,7.1,7,6,1,0,7,10,-3,6.4,10.6,-4.2,20,EL
5a48195c,5,435,4.8,5,4,0,1,3,7,-4,6.8,7.7,-0.9,20,EL
5a7301ae,11,607,6.7,6,4,5,0,13,8,5,11.7,7.1,4.7,20,EL
5aa53281,7,597,6.6,7,5,0,2,8,8,0,10.0,9.5,0.6,20,EL
5ad141cb,10,900,10.0,10,10,0,0,15,12,3,15.9,13.1,2.8,20,EL
5af687a1,1,1,0.0,0,0,1,0,0,0,0,0.0,0.0,0.0,20,EL
5b3d1a7a,8,568,6.3,5,4,3,0,13,11,2,9.9,8.2,1.6,20,EL
5b479568,7,622,6.9,7,6,0,0,14,7,7,15.0,8.9,6.1,20,EL
5b887c7a,3,252,2.8,3,2,0,0,7,1,6,3.4,3.3,0.1,20,EL
5bfb7572,1,65,0.7,0,0,1,5,0,6,-6,0.3,6.7,-6.4,20,EL
5c4f0f49,6,492,5.5,6,5,0,0,10,7,3,6.2,7.3,-1.1,20,EL
5c6ba09a,8,582,6.5,7,4,1,0,6,10,-4,6.0,9.4,-3.4,20,EL
5c961282,11,826,9.2,9,7,2,0,10,7,3,7.5,12.1,-4.6,20,EL
5c9ac7f0,5,343,3.8,5,1,0,0,4,6,-2,4.4,8.4,-4.1,20,EL
5caa62a7,6,328,3.6,4,2,2,0,5,9,-4,3.6,6.3,-2.7,20,EL
5d5219b1,6,453,5.0,6,2,0,0,7,5,2,7.4,6.3,1.1,20,EL
5da33b33,3,270,3.0,3,3,0,0,1,8,-7,4.0,5.0,-1.0,20,EL
5ddb8f9f,9,538,6.0,6,3,3,1,8,8,0,9.2,8.2,1.1,20,EL
5e1028e5,1,90,1.0,1,1,0,1,1,2,-1,1.2,1.5,-0.3,20,EL
5e74d6c8,8,727,8.1,8,6,0,2,14,4,10,14.3,6.8,7.5,20,EL
5e91ddf8,5,450,5.0,5,5,0,0,2,10,-8,5.6,7.3,-1.8,20,EL
5e9fa5c9,5,429,4.8,5,4,0,1,4,7,-3,6.0,7.7,-1.7,20,EL
5ea8ef20,6,339,3.8,2,2,4,2,7,5,2,8.3,2.3,6.0,20,EL
5eae500a,6,442,4.9,5,3,1,0,15,5,10,10.4,4.7,5.7,20,EL
5eb3130f,1,3,0.0,0,0,1,0,0,0,0,0.0,0.0,0.0,20,EL
5eebbfdf,8,376,4.2,4,1,4,0,8,2,6,8.1,3.7,4.4,20,EL
5f26e0c5,3,192,2.1,2,1,1,2,1,4,-3,1.5,2.8,-1.3,20,EL
5f4ce4b6,4,337,3.7,4,2,0,0,1,4,-3,4.1,5.5,-1.4,20,EL
5faa73aa,6,464,5.2,5,5,1,0,6,5,1,4.8,7.0,-2.3,20,EL
5fcb90ac,3,269,3.0,3,2,0,2,3,1,2,5.6,4.3,1.3,20,EL
6043997c,2,180,2.0,2,2,0,2,3,3,0,3.0,1.1,1.9,20,EL
60c07b31,4,390,4.3,4,4,0,0,3,4,-1,3.6,7.2,-3.6,20,EL
60db2f9b,7,354,3.9,4,1,3,1,3,2,1,4.8,6.2,-1.4,20,EL
60fd5334,3,130,1.4,1,0,2,0,1,2,-1,2.4,2.8,-0.5,20,EL
614f69aa,5,446,5.0,5,4,0,0,5,6,-1,5.0,8.7,-3.8,20,EL
62ab9184,5,450,5.0,5,5,0,4,10,4,6,7.9,5.1,2.8,20,EL
6388e356,3,244,2.7,3,2,0,0,1,4,-3,3.4,3.6,-0.2,20,EL
63b9cc6d,1,45,0.5,1,0,0,1,0,2,-2,0.4,1.4,-1.0,20,EL
63c3659d,7,630,7.0,7,7,0,1,8,11,-3,7.6,10.8,-3.2,20,EL
6438d426,2,180,2.0,2,2,0,0,2,3,-1,1.7,2.3,-0.7,20,EL
645a3363,3,245,2.7,3,1,0,0,1,2,-1,4.0,2.6,1.4,20,EL
64f69877,3,263,2.9,3,1,0,0,4,3,1,5.3,4.4,0.9,20,EL
654600fd,1,90,1.0,1,1,0,1,0,2,-2,0.3,2.3,-2.1,20,EL
6554bb97,6,288,3.2,3,2,3,0,6,4,2,4.1,4.8,-0.7,20,EL
65553d96,5,72,0.8,0,0,5,2,1,1,0,1.4,0.7,0.7,20,EL
65ad4d98,6,495,5.5,6,5,0,0,3,7,-4,7.5,7.8,-0.3,20,EL
65bbfba3,4,271,3.0,3,2,1,1,3,1,2,3.4,5.3,-1.9,20,EL
6603fed7,8,579,6.4,7,3,1,0,13,11,2,8.9,9.1,-0.2,20,EL
6622454d,1,90,1.0,1,1,0,0,0,2,-2,0.2,0.8,-0.6,20,EL
6639e500,6,233,2.6,2,1,4,2,9,1,8,4.1,2.3,1.8,20,EL
6747869d,2,110,1.2,1,0,1,0,2,3,-1,2.1,3.2,-1.1,20,EL
675b0427,6,537,6.0,6,5,0,0,7,11,-4,9.7,8.9,0.8,20,EL
67f0703d,3,270,3.0,3,3,0,0,3,3,0,5.6,2.6,3.0,20,EL
6800f515,7,630,7.0,7,7,0,0,12,8,4,10.2,8.6,1.6,20,EL
685857dc,8,548,6.1,5,4,3,0,11,7,4,8.0,7.2,0.7,20,EL
68635c10,6,540,6.0,6,6,0,0,8,7,1,9.1,7.9,1.2,20,EL
686cbe7d,6,524,5.8,6,3,0,0,10,10,0,9.8,7.3,2.5,20,EL
689c9cf4,6,463,5.1,5,4,1,0,8,6,2,7.8,6.7,1.1,20,EL
68dc0dac,6,401,4.5,5,2,1,0,4,4,0,5.2,5.0,0.2,20,EL
691bef82,2,180,2.0,2,2,0,0,2,3,-1,1.7,2.3,-0.7,20,EL
6922f806,6,190,2.1,2,1,4,0,5,5,0,4.4,3.0,1.4,20,EL
6928979a,6,424,4.7,5,4,1,0,14,5,9,10.1,4.6,5.5,20,EL
69374ff5,4,119,1.3,1,0,3,1,2,3,-1,1.3,4.1,-2.8,20,EL
6956ff08,1,18,0.2,0,0,1,1,0,0,0,0.2,0.1,0.2,20,EL
6993fcc8,5,450,5.0,5,5,0,0,5,8,-3,5.2,6.1,-0.9,20,EL
69986380,1,27,0.3,0,0,1,3,1,0,1,1.2,0.2,1.0,20,EL
69cbc8b6,3,257,2.9,2,2,1,1,5,2,3,4.9,2.5,2.4,20,EL
6b08d120,1,3,0.0,0,0,1,3,1,0,1,0.2,0.0,0.2,20,EL
6b200d45,4,360,4.0,4,4,0,1,5,6,-1,3.8,3.5,0.2,20,EL
6b6c793c,3,261,2.9,3,2,0,3,4,7,-3,4.0,5.1,-1.1,20,EL
6b6cbca4,2,111,1.2,2,1,0,0,1,1,0,1.5,1.5,0.0,20,EL
6b767188,5,288,3.2,3,2,2,1,1,7,-6,3.3,4.7,-1.4,20,EL
6b85f966,10,817,9.1,10,4,0,0,16,5,11,12.0,9.4,2.6,20,EL
6b915aa1,4,160,1.8,2,0,2,2,1,2,-1,3.3,1.8,1.5,20,EL
6bd05d38,1,90,1.0,1,1,0,5,1,0,1,1.3,1.3,0.0,20,EL
6bd5cd5d,8,711,7.9,8,7,0,1,14,10,4,12.5,7.8,4.7,20,EL
6be41a31,3,126,1.4,1,1,2,1,3,1,2,3.1,1.0,2.0,20,EL
6bfaecc4,1,90,1.0,1,1,0,4,5,1,4,2.5,0.9,1.6,20,EL
6bfb4303,5,450,5.0,5,5,0,1,6,9,-3,5.7,9.0,-3.3,20,EL
6bff8a73,6,540,6.0,6,6,0,0,2,5,-3,6.0,8.7,-2.7,20,EL
6c8ddd52,2,180,2.0,2,2,0,0,3,3,0,3.0,1.1,1.9,20,EL
6cbf8d0d,2,96,1.1,1,0,1,0,2,1,1,2.7,1.3,1.4,20,EL
6dce77a5,4,330,3.7,4,3,0,0,3,5,-2,4.8,6.1,-1.4,20,EL
6e240751,5,450,5.0,5,5,0,1,1,4,-3,5.2,5.2,0.0,20,EL
6e269dd3,5,207,2.3,2,0,3,0,2,2,0,2.9,4.5,-1.6,20,EL
6ea23758,1,79,0.9,1,0,0,0,1,1,0,0.8,0.9,-0.1,20,EL
6ec1ddf1,6,375,4.2,4,3,2,0,6,7,-1,4.1,10.1,-6.0,20,EL
6f1721f0,4,218,2.4,3,0,1,1,1,8,-7,2.2,3.9,-1.8,20,EL
6f4cf369,6,540,6.0,6,6,0,0,10,10,0,9.9,7.3,2.6,20,EL
6f8cd6d0,6,518,5.8,6,4,0,0,6,9,-3,10.5,8.1,2.4,20,EL
6fd8a334,3,137,1.5,1,1,2,1,3,1,2,1.8,1.4,0.3,20,EL
6fdac234,6,160,1.8,2,0,4,0,1,5,-4,1.7,4.2,-2.5,20,EL
6fe5c35b,10,900,10.0,10,10,0,0,15,12,3,15.9,13.1,2.8,20,EL
6ff8ef56,5,134,1.5,1,0,4,2,5,2,3,3.0,1.0,1.9,20,EL
7091324a,2,71,0.8,1,0,1,1,0,3,-3,2.2,0.8,1.4,20,EL
70c52749,6,540,6.0,6,6,0,0,3,11,-8,6.1,7.9,-1.9,20,EL
70cb75ae,4,97,1.1,1,0,3,2,2,2,0,1.4,2.7,-1.4,20,EL
70cf63ca,2,102,1.1,1,1,1,0,3,3,0,1.8,1.8,0.0,20,EL
71115017,2,119,1.3,2,0,0,4,0,0,0,0.4,1.7,-1.3,20,EL
7120a04d,4,125,1.4,1,1,3,2,4,2,2,2.7,3.3,-0.7,20,EL
712dd708,10,882,9.8,10,9,0,0,11,12,-1,11.5,14.0,-2.5,20,EL
713c144a,6,540,6.0,6,6,0,0,7,9,-2,7.8,13.6,-5.8,20,EL
715e5b0e,3,88,1.0,0,0,3,0,0,1,-1,1.1,2.6,-1.5,20,EL
715fc0fe,7,579,6.4,7,4,0,1,14,7,7,8.1,7.3,0.9,20,EL
71d5ca31,4,360,4.0,4,4,0,0,5,5,0,8.7,4.9,3.8,20,EL
723ba189,2,42,0.5,0,0,2,0,0,2,-2,1.6,0.5,1.1,20,EL
7272a72a,6,521,5.8,6,1,0,0,10,10,0,8.9,6.7,2.2,20,EL
73000a79,4,337,3.7,4,3,0,0,7,4,3,6.8,4.5,2.3,20,EL
7304f3b1,1,19,0.2,0,0,1,0,0,0,0,0.0,0.2,-0.2,20,EL
731302dc,1,10,0.1,0,0,1,0,0,0,0,0.2,0.0,0.2,20,EL
733e7ad8,2,168,1.9,2,1,0,0,1,4,-3,1.5,4.0,-2.5,20,EL
7352dca8,5,421,4.7,5,4,0,0,1,4,-3,4.8,4.5,0.3,20,EL
73683fa9,5,450,5.0,5,5,0,3,12,3,9,10.2,4.3,5.9,20,EL
740a0e28,3,270,3.0,3,3,0,5,1,2,-1,3.4,3.4,0.0,20,EL
741275f5,1,83,0.9,0,0,1,1,0,1,-1,1.4,1.5,0.0,20,EL
74223a01,6,393,4.4,4,3,2,0,3,8,-5,3.0,5.7,-2.7,20,EL
74288db0,2,25,0.3,0,0,2,1,0,0,0,0.5,0.1,0.4,20,EL
742a4995,4,203,2.3,2,2,2,1,3,2,1,3.0,2.1,1.0,20,EL
74419746,4,360,4.0,4,4,0,0,11,4,7,7.5,4.4,3.1,20,EL
746fec7d,1,18,0.2,0,0,1,1,0,0,0,0.4,0.4,-0.1,20,EL
74733221,2,180,2.0,2,2,0,3,2,1,1,3.6,1.2,2.4,20,EL
7483d9f9,1,90,1.0,1,1,0,1,2,2,0,1.4,1.7,-0.3,20,EL
74ced675,6,540,6.0,6,6,0,0,8,11,-3,10.0,6.2,3.9,20,EL
74f2e748,1,83,0.9,1,0,0,1,1,1,0,2.0,1.3,0.7,20,EL
75229233,7,630,7.0,7,7,0,0,8,11,-3,7.4,10.3,-2.8,20,EL
754bc99d,5,450,5.0,5,5,0,0,9,11,-2,5.7,9.7,-4.0,20,EL
7586ae9b,4,85,0.9,1,0,3,2,2,1,1,1.9,0.5,1.4,20,EL
75b86fb3,5,368,4.1,4,3,1,0,11,4,7,7.4,4.5,2.9,20,EL
760be9fa,4,277,3.1,3,3,1,4,4,2,2,5.6,3.1,2.5,20,EL
762179d9,11,872,9.7,10,4,1,0,11,7,4,9.4,13.4,-4.0,20,EL
76864df8,3,60,0.7,0,0,3,0,0,0,0,0.8,0.4,0.4,20,EL
768b28d0,4,142,1.6,2,0,2,2,2,3,-1,3.3,3.5,-0.1,20,EL
76c131da,2,126,1.4,1,0,1,0,4,2,2,4.6,1.6,3.0,20,EL
76ecfb22,6,434,4.8,5,2,1,0,1,10,-9,4.4,5.9,-1.5,20,EL
770ebf00,5,388,4.3,5,2,0,0,3,6,-3,3.2,5.3,-2.0,20,EL
7713c72a,1,90,1.0,1,1,0,3,4,1,3,1.9,1.7,0.2,20,EL
771d74d1,4,165,1.8,2,0,2,0,0,3,-3,1.4,2.7,-1.3,20,EL
77c9e37c,1,2,0.0,0,0,1,0,0,0,0,0.0,0.0,0.0,20,EL
77e39b04,6,303,3.4,3,2,3,1,6,7,-1,5.7,4.4,1.3,20,EL
78a3c38e,5,206,2.3,2,1,3,0,10,3,7,6.7,2.5,4.2,20,EL
79019bf4,1,9,0.1,0,0,1,1,0,0,0,0.0,0.0,0.0,20,EL
79083382,1,90,1.0,1,1,0,4,4,0,4,3.2,0.6,2.6,20,EL
79135368,5,438,4.9,5,4,0,1,5,4,1,9.0,5.2,3.7,20,EL
791af558,3,67,0.7,0,0,3,1,1,1,0,1.7,1.0,0.7,20,EL
79370f8c,6,422,4.7,4,4,2,0,3,9,-6,5.6,8.6,-3.0,20,EL
7956236f,6,540,6.0,6,6,0,2,14,7,7,14.5,6.7,7.8,20,EL
79b0d6a0,10,900,10.0,10,10,0,0,15,10,5,15.4,10.4,5.1,20,EL
79c536d7,3,270,3.0,3,3,0,3,5,4,1,4.7,5.6,-0.9,20,EL
7a20d90a,8,720,8.0,8,8,0,0,10,14,-4,12.7,10.1,2.6,20,EL
7a2cf111,7,630,7.0,7,7,0,0,13,11,2,10.1,9.8,0.3,20,EL
7a412c2d,5,364,4.0,4,4,1,1,9,5,4,6.5,4.8,1.7,20,EL
7a47e204,4,114,1.3,1,0,3,1,1,2,-1,1.0,1.2,-0.2,20,EL
7a4cea18,4,348,3.9,4,2,0,0,2,3,-1,3.0,6.3,-3.3,20,EL
7afbd2c3,1,78,0.9,1,0,0,0,0,2,-2,0.3,1.9,-1.6,20,EL
7b456af7,2,180,2.0,2,2,0,8,4,1,3,3.0,1.8,1.1,20,EL
7b4c1f6e,1,31,0.3,0,0,1,2,0,0,0,0.8,0.1,0.7,20,EL
7b4de647,5,450,5.0,5,5,0,1,7,10,-3,8.1,5.5,2.6,20,EL
7b57c56a,7,606,6.7,7,6,0,0,13,10,3,13.4,9.3,4.1,20,EL
7b5ab7f2,4,165,1.8,1,0,3,0,4,1,3,3.3,1.1,2.2,20,EL
7b8ff0ac,2,60,0.7,1,0,1,2,1,1,0,0.7,1.8,-1.1,20,EL
7b9a86e6,6,273,3.0,3,1,3,2,4,5,-1,4.3,6.1,-1.8,20,EL
7b9a9e25,6,374,4.2,4,2,2,0,5,4,1,3.5,3.7,-0.3,20,EL
7b9c2d84,4,151,1.7,2,0,2,0,2,2,0,2.6,1.8,0.8,20,EL
7ba2eaa9,8,332,3.7,3,1,5,2,7,4,3,6.2,3.0,3.2,20,EL
7ba6d84e,2,180,2.0,2,2,0,4,1,2,-1,3.2,2.2,1.0,20,EL
7baff104,1,15,0.2,0,0,1,0,0,0,0,0.5,0.8,-0.3,20,EL
7be09c86,4,230,2.6,2,1,2,0,5,3,2,6.2,2.7,3.5,20,EL
7c1a0c67,6,540,6.0,6,6,0,0,3,9,-6,7.8,9.6,-1.8,20,EL
7c2965bb,7,409,4.5,5,2,2,1,11,3,8,11.3,2.9,8.4,20,EL
7c9fa389,5,367,4.1,4,4,1,0,5,9,-4,6.3,7.7,-1.4,20,EL
7cd6badb,4,190,2.1,2,1,2,0,4,2,2,4.4,3.2,1.2,20,EL
7cd78926,8,698,7.8,8,7,0,0,11,14,-3,6.7,12.9,-6.2,20,EL
7cf431a5,3,179,2.0,2,1,1,2,2,3,-1,2.3,1.0,1.2,20,EL
7cf8150a,1,10,0.1,0,0,1,1,0,0,0,0.0,0.0,0.0,20,EL
7d036b4a,7,499,5.5,6,4,1,0,7,5,2,6.0,7.3,-1.3,20,EL
7d393a9f,6,514,5.7,5,5,1,1,4,4,0,6.6,9.5,-3.0,20,EL
7dc7187e,2,152,1.7,2,1,0,0,1,3,-2,1.8,3.1,-1.3,20,EL
7e219e84,1,4,0.0,0,0,1,2,1,0,1,0.4,0.5,-0.1,20,EL
7e56d3db,2,210,2.3,2,2,0,0,4,5,-1,3.4,3.1,0.3,20,EL
7e74e0c2,2,100,1.1,1,0,1,0,0,1,-1,0.7,1.7,-1.0,20,EL
7e763ddc,2,101,1.1,1,0,1,0,2,3,-1,2.0,2.4,-0.4,20,EL
7e871b0a,6,380,4.2,4,4,2,0,4,11,-7,3.4,11.2,-7.9,20,EL
7e964a67,5,154,1.7,1,1,4,1,1,7,-6,0.5,9.0,-8.4,20,EL
7ec7738e,2,66,0.7,0,0,2,0,0,1,-1,0.8,1.5,-0.7,20,EL
7f5a2470,6,290,3.2,4,1,2,0,3,9,-6,4.9,6.8,-1.9,20,EL
7f622eef,1,76,0.8,1,0,0,1,0,1,-1,0.7,1.5,-0.8,20,EL
7fcc71d8,4,180,2.0,2,1,2,0,3,3,0,3.6,2.4,1.2,20,EL
7fd58fe3,5,163,1.8,1,0,4,1,2,3,-1,2.9,2.6,0.2,20,EL
7ff93107,2,35,0.4,0,0,2,3,0,0,0,0.0,0.2,-0.2,20,EL
8023bcab,7,500,5.6,5,4,2,1,10,5,5,9.6,6.8,2.8,20,EL
8104e41e,1,30,0.3,0,0,1,0,0,2,-2,0.2,0.8,-0.7,20,EL
810e3c74,9,419,4.7,4,3,5,1,7,4,3,6.8,4.6,2.3,20,EL
810e40c1,1,90,1.0,1,1,0,1,1,4,-3,1.4,3.0,-1.6,20,EL
81442ecb,6,552,6.1,6,5,0,1,13,9,4,8.4,7.2,1.2,20,EL
81b906e7,3,270,3.0,3,3,0,3,8,6,2,4.3,3.6,0.7,20,EL
82220b03,4,38,0.4,0,0,4,3,0,1,-1,0.3,0.9,-0.6,20,EL
824bd41a,3,270,3.0,3,3,0,3,2,5,-3,3.6,4.2,-0.6,20,EL
8267f8d4,2,113,1.3,1,1,1,0,1,2,-1,1.6,1.5,0.1,20,EL
82b85f5a,5,206,2.3,2,0,3,0,2,5,-3,3.4,2.4,1.0,20,EL
82e3586c,5,435,4.8,5,4,0,0,10,11,-1,5.9,7.8,-1.9,20,EL
82e9b89d,3,247,2.7,3,2,0,0,4,3,1,5.7,4.1,1.6,20,EL
82efe6fa,1,90,1.0,1,1,0,0,0,2,-2,0.5,2.4,-2.0,20,EL
83300259,8,720,8.0,8,8,0,0,16,11,5,16.1,10.5,5.5,20,EL
834d0be5,3,175,1.9,2,1,1,1,5,2,3,4.0,1.6,2.5,20,EL
83534f30,8,714,7.9,8,5,0,0,11,9,2,8.5,10.7,-2.2,20,EL
839ef2b8,3,235,2.6,3,1,0,2,2,2,0,3.3,3.6,-0.3,20,EL
83b9c48f,3,84,0.9,1,0,2,0,1,2,-1,0.3,1.2,-1.0,20,EL
83ce5ef1,3,258,2.9,3,2,0,2,2,4,-2,2.4,6.3,-3.9,20,EL
83d961d1,5,285,3.2,3,2,2,1,5,5,0,2.8,7.6,-4.8,20,EL
8474cb83,6,427,4.7,4,3,2,2,8,7,1,6.1,5.9,0.2,20,EL
8494acc4,4,217,2.4,2,1,2,0,6,5,1,5.1,4.5,0.5,20,EL
852351df,1,90,1.0,1,1,0,0,0,2,-2,0.5,2.4,-2.0,20,EL
85322440,1,9,0.1,0,0,1,0,0,0,0,0.0,0.0,0.0,20,EL
853b7c48,8,720,8.0,8,8,0,0,10,14,-4,12.7,10.1,2.6,20,EL
854a2041,6,471,5.2,5,4,1,0,5,10,-5,6.0,9.2,-3.2,20,EL
854f7734,3,270,3.0,3,3,0,0,6,6,0,3.0,5.5,-2.4,20,EL
8558593d,6,474,5.3,5,5,1,0,8,15,-7,5.1,14.3,-9.2,20,EL
85733f33,1,3,0.0,0,0,1,1,0,0,0,0.0,0.2,-0.2,20,EL
8577e60a,2,126,1.4,1,1,1,1,1,2,-1,1.7,1.2,0.5,20,EL
85c25f57,6,162,1.8,1,1,5,1,2,5,-3,1.6,4.8,-3.2,20,EL
86168d75,2,90,1.0,1,0,1,3,3,4,-1,2.4,1.5,0.8,20,EL
862fa9fb,4,180,2.0,2,1,2,0,1,5,-4,2.8,1.9,0.9,20,EL
8637e09a,1,90,1.0,1,1,0,2,2,1,1,2.2,1.0,1.2,20,EL
867239d3,3,238,2.6,2,2,1,0,3,2,1,6.2,2.1,4.1,20,EL
86878265,6,473,5.3,6,2,0,0,9,11,-2,7.3,8.7,-1.3,20,EL
8696bc90,9,450,5.0,4,3,5,0,15,2,13,11.2,3.2,8.0,20,EL
86e119e0,9,789,8.8,9,8,0,0,14,12,2,12.5,10.5,2.0,20,EL
8754c7ca,4,377,4.2,4,2,0,0,2,4,-2,3.2,6.7,-3.5,20,EL
878f0921,8,716,8.0,8,6,0,0,14,16,-2,9.600000000000001,14.5,-4.8999999999999995,20,EL
87d8b5a3,6,475,5.3,5,5,1,5,10,2,8,7.5,6.9,0.6,20,EL
881cd6be,1,90,1.0,1,1,0,1,1,2,-1,1.2,1.5,-0.3,20,EL
881ef58c,4,279,3.1,4,0,0,0,5,2,3,5.3,2.9,2.4,20,EL
883f251e,7,486,5.4,6,2,1,0,5,2,3,7.1,7.2,-0.1,20,EL
884a8908,6,482,5.4,6,2,0,0,3,11,-8,5.0,6.8,-1.8,20,EL
886f9aac,3,65,0.7,0,0,3,0,5,5,0,1.9,1.4,0.4,20,EL
8870154f,1,90,1.0,1,1,0,2,0,1,-1,1.1,2.0,-0.9,20,EL
88b748d2,6,475,5.3,6,5,0,0,4,13,-9,2.8,12.4,-9.6,20,EL
88c89891,5,316,3.5,3,3,2,1,5,3,2,6.2,3.0,3.2,20,EL
8a1d7b51,6,524,5.8,6,5,0,0,7,8,-1,9.7,7.7,2.0,20,EL
8b0b02c9,3,160,1.8,2,0,1,1,1,2,-1,2.8,2.6,0.2,20,EL
8b298f56,4,357,4.0,4,3,0,0,4,4,0,5.8,2.8,3.0,20,EL
8b3ab7ad,1,66,0.7,1,0,0,1,0,1,-1,0.0,0.7,-0.7,20,EL
8b529245,2,34,0.4,0,0,2,0,0,1,-1,0.5,0.9,-0.4,20,EL
8b683d09,6,428,4.8,4,4,2,4,7,8,-1,6.7,7.5,-0.8,20,EL
8b788c01,7,489,5.4,6,2,1,0,10,3,7,11.9,4.3,7.6,20,EL
8bbf17da,5,387,4.3,4,4,1,0,1,4,-3,4.1,5.3,-1.1,20,EL
8bc373ea,3,267,3.0,2,2,1,1,3,3,0,3.1,4.9,-1.8,20,EL
8c5f1522,1,12,0.1,0,0,1,1,0,0,0,0.4,0.5,-0.1,20,EL
8c6239f2,6,540,6.0,6,6,0,0,10,13,-3,6.4,13.0,-6.6,20,EL
8ce30c57,1,46,0.5,1,0,0,0,1,1,0,0.8,0.6,0.2,20,EL
8cfc2f69,8,445,4.9,4,2,4,1,4,3,1,6.6,4.0,2.6,20,EL
8d67689d,1,45,0.5,0,0,1,1,2,1,1,1.4,1.3,0.1,20,EL
8d957256,5,450,5.0,5,5,0,4,5,4,1,9.0,5.3,3.7,20,EL
8e010ff4,6,400,4.4,5,3,1,1,5,4,1,8.8,4.9,3.9,20,EL
8e16dd48,6,490,5.4,6,2,0,0,7,9,-2,7.0,11.7,-4.7,20,EL
8e3e66a0,5,218,2.4,2,0,3,0,3,6,-3,3.4,3.7,-0.4,20,EL
8e58987d,5,241,2.7,3,2,2,1,2,5,-3,4.9,3.9,1.0,20,EL
8ed17872,5,362,4.0,5,2,0,0,8,8,0,5.2,7.1,-1.8,20,EL
8ee95cc6,2,36,0.4,0,0,2,2,0,2,-2,0.2,1.8,-1.6,20,EL
8f056768,5,353,3.9,5,1,0,0,5,6,-1,5.1,6.5,-1.3,20,EL
8f7e6783,8,699,7.8,8,6,0,0,16,11,5,15.3,10.1,5.2,20,EL
8f8c6934,4,360,4.0,4,4,0,5,6,4,2,6.0,3.6,2.4,20,EL
8fb2cd60,2,180,2.0,2,2,0,3,0,2,-2,1.6,2.2,-0.5,20,EL
8fd9996f,7,544,6.0,6,5,1,0,8,9,-1,10.0,6.0,4.0,20,EL
8ff4872e,3,93,1.0,0,0,3,4,0,5,-5,0.1,4.2,-4.1,20,EL
9001138b,6,311,3.5,4,1,2,0,4,3,1,2.8,3.0,-0.2,20,EL
9038c2a1,4,142,1.6,1,0,3,4,0,1,-1,1.8,1.7,0.1,20,EL
903b3b77,5,450,5.0,5,5,0,0,6,9,-3,7.8,6.7,1.0,20,EL
903b6e8b,3,300,3.3,3,3,0,0,3,3,0,2.5,5.2,-2.7,20,EL
908eea67,9,728,8.1,8,7,1,0,13,6,7,14.5,9.3,5.2,20,EL
90f3beec,10,821,9.1,10,7,0,0,19,7,12,15.4,10.7,4.7,20,EL
911680d8,1,90,1.0,1,1,0,3,4,1,3,2.3,2.1,0.2,20,EL
9139bb12,5,364,4.0,5,0,0,1,6,7,-1,6.0,4.4,1.5,20,EL
91538ba3,5,383,4.3,4,3,1,0,3,13,-10,2.7,12.0,-9.3,20,EL
91748070,1,7,0.1,0,0,1,3,1,0,1,0.6,0.2,0.4,20,EL
91976866,2,28,0.3,0,0,2,2,0,1,-1,0.9,1.2,-0.3,20,EL
91b43c98,4,120,1.3,1,1,3,2,0,3,-3,1.5,2.9,-1.4,20,EL
92232aad,4,329,3.7,4,3,0,0,6,7,-1,3.0,3.2,-0.2,20,EL
92ffb8f9,1,68,0.8,1,0,0,0,1,2,-1,0.9,1.5,-0.6,20,EL
934e1968,2,155,1.7,2,0,0,0,2,6,-4,1.8,3.8,-2.0,20,EL
93b891d1,6,470,5.2,5,4,1,0,5,8,-3,6.1,6.7,-0.6,20,EL
94130fc4,4,239,2.7,3,1,1,1,6,2,4,3.1,3.2,-0.1,20,EL
947e036f,3,197,2.2,2,2,1,1,2,5,-3,1.7,4.3,-2.6,20,EL
94b3ccdb,3,270,3.0,3,3,0,3,1,6,-5,1.4,5.1,-3.7,20,EL
94d260aa,2,135,1.5,1,1,1,5,1,1,0,0.6,1.7,-1.1,20,EL
951f1739,5,394,4.4,5,1,0,3,9,6,3,4.9,6.1,-1.2,20,EL
953597a1,5,333,3.7,4,3,1,0,7,5,2,5.0,3.8,1.2,20,EL
95efdac2,3,79,0.9,1,0,2,1,0,1,-1,0.5,0.3,0.2,20,EL
96094cbc,2,167,1.9,2,0,0,0,4,5,-1,2.5,2.8,-0.3,20,EL
962e54cb,10,543,6.0,5,3,5,0,8,12,-4,9.4,10.4,-1.1,20,EL
966eea58,5,343,3.8,4,2,1,0,2,3,-1,3.5,6.4,-2.9,20,EL
96cf436e,5,450,5.0,5,5,0,1,11,7,4,5.2,7.4,-2.2,20,EL
96ddfa79,5,449,5.0,5,4,0,0,7,17,-10,5.4,15.2,-9.8,20,EL
972aeb2a,2,180,2.0,2,2,0,0,2,2,0,1.5,0.8,0.7,20,EL
97572117,9,721,8.0,8,7,1,0,10,5,5,12.3,6.8,5.6,20,EL
9763a91c,6,267,3.0,3,1,3,0,7,7,0,2.9,6.9,-4.0,20,EL
9778d8dd,1,90,1.0,1,1,0,1,2,2,0,1.4,1.7,-0.3,20,EL
977ffc24,5,92,1.0,0,0,5,1,0,0,0,0.9,2.0,-1.1,20,EL
97810d55,6,540,6.0,6,6,0,0,7,8,-1,6.1,11.1,-4.9,20,EL
980522ec,6,244,2.7,2,2,4,0,6,1,5,5.2,0.9,4.4,20,EL
984b3198,3,137,1.5,2,0,1,1,2,7,-5,2.1,5.7,-3.6,20,EL
98554bfd,2,106,1.2,1,1,1,1,5,2,3,3.7,0.9,2.8,20,EL
98a84572,2,28,0.3,0,0,2,4,0,0,0,0.3,0.2,0.1,20,EL
98b94ef4,1,21,0.2,0,0,1,1,1,1,0,0.7,0.1,0.7,20,EL
9907b1c8,7,501,5.6,6,3,1,0,10,4,6,10.7,5.7,4.9,20,EL
9993817f,2,29,0.3,0,0,2,4,0,1,-1,0.4,1.0,-0.6,20,EL
9a28eba4,10,625,6.9,7,1,3,0,12,5,7,12.2,7.4,4.8,20,EL
9ab16552,8,658,7.3,7,6,1,1,11,14,-3,12.9,12.3,0.6,20,EL
9b6d9b53,5,450,5.0,5,5,0,1,9,6,3,6.3,6.1,0.2,20,EL
9bd3b683,1,10,0.1,0,0,1,5,1,0,1,0.9,0.1,0.8,20,EL
9bd73cce,2,95,1.1,1,0,1,0,1,3,-2,0.4,2.6,-2.1,20,EL
9bf914b4,5,391,4.3,5,2,0,0,5,9,-4,6.1,9.3,-3.2,20,EL
9c0a65df,5,191,2.1,1,1,4,0,3,4,-1,1.5,4.9,-3.3,20,EL
9c2b4382,5,389,4.3,5,0,0,0,1,5,-4,6.0,6.1,-0.1,20,EL
9c824717,5,399,4.4,5,2,0,1,11,2,9,7.1,6.0,1.1,20,EL
9c94165b,4,360,4.0,4,4,0,0,12,3,9,9.2,3.6,5.6,20,EL
9d21da85,9,810,9.0,9,9,0,0,14,12,2,14.0,12.8,1.2,20,EL
9d60028d,4,185,2.1,2,1,2,1,7,3,4,3.6,3.6,0.1,20,EL
9d689a5b,4,196,2.2,3,0,1,0,1,2,-1,1.2,2.9,-1.7,20,EL
9d7d5334,4,204,2.3,2,2,2,3,2,3,-1,2.3,3.9,-1.5,20,EL
9d971f13,8,565,6.3,8,3,0,0,10,10,0,6.4,8.1,-1.7,20,EL
9dab6e3b,1,90,1.0,1,1,0,6,1,2,-1,1.5,1.4,0.0,20,EL
9daeac61,2,171,1.9,2,1,0,1,3,2,1,2.2,0.9,1.3,20,EL
9dbb75ca,5,384,4.3,4,2,1,1,5,6,-1,6.9,3.5,3.4,20,EL
9ddb85e8,5,130,1.4,0,0,5,1,1,7,-6,2.9,2.8,0.2,20,EL
9e1577aa,4,202,2.2,2,1,2,2,6,1,5,3.0,0.7,2.4,20,EL
9e49c320,3,47,0.5,0,0,3,0,2,0,2,1.6,1.5,0.1,20,EL
9e525177,5,445,4.9,5,3,0,2,11,2,9,13.3,2.6,10.7,20,EL
9ef884b1,4,103,1.1,0,0,4,4,3,1,2,1.6,0.8,0.9,20,EL
9f84febe,3,264,2.9,3,2,0,0,3,2,1,3.7,7.4,-3.7,20,EL
9f9c57f0,1,2,0.0,0,0,1,3,0,0,0,0.0,0.0,0.0,20,EL
9fa26bc2,3,270,3.0,3,3,0,1,3,6,-3,2.3,7.7,-5.4,20,EL
9fb640a8,11,963,10.7,11,9,0,0,21,8,13,17.1,13.0,4.1,20,EL
9fbbcf39,8,648,7.2,7,6,1,2,13,7,6,11.0,7.7,3.3,20,EL
9fc2531b,1,26,0.3,0,0,1,0,0,0,0,0.8,0.3,0.5,20,EL
9ffdf29a,2,15,0.2,0,0,2,4,1,0,1,0.2,0.0,0.2,20,EL
a0313275,5,450,5.0,5,5,0,0,2,7,-5,4.0,5.7,-1.7,20,EL
a04e2dd2,8,720,8.0,8,8,0,0,9,11,-2,8.2,10.9,-2.7,20,EL
a08b974a,7,561,6.2,7,3,0,1,6,5,1,8.7,8.0,0.7,20,EL
a0b730dc,4,248,2.8,3,0,1,2,4,3,1,4.0,3.4,0.6,20,EL
a0e9a73d,6,496,5.5,6,1,0,0,4,10,-6,5.3,6.4,-1.1,20,EL
a0f9b535,4,315,3.5,4,1,0,0,4,6,-2,4.4,2.4,2.0,20,EL
a1232f4e,4,340,3.8,4,3,0,2,12,1,11,9.0,2.1,6.9,20,EL
a1c5b23e,1,90,1.0,1,1,0,1,2,1,1,1.5,1.6,-0.1,20,EL
a1d5bd30,6,413,4.6,4,1,2,2,6,2,4,11.3,2.5,8.9,20,EL
a2560346,6,199,2.2,2,0,4,3,3,2,1,3.7,3.3,0.4,20,EL
a2609621,4,355,3.9,4,3,0,0,4,8,-4,5.8,5.0,0.8,20,EL
a26fb8aa,8,720,8.0,8,8,0,0,16,11,5,16.1,10.5,5.5,20,EL
a274dccb,1,12,0.1,0,0,1,1,0,0,0,0.1,0.1,0.0,20,EL
a29b1131,5,393,4.4,5,3,0,0,7,8,-1,5.5,7.0,-1.5,20,EL
a2da58b1,2,94,1.0,1,1,1,1,1,3,-2,1.3,3.0,-1.7,20,EL
a372a9f2,6,458,5.1,6,3,0,0,6,9,-3,6.6,5.5,1.1,20,EL
a3b03921,8,557,6.2,7,2,1,0,10,7,3,10.8,6.6,4.3,20,EL
a40d5a0c,4,187,2.1,2,0,2,2,3,4,-1,3.1,3.3,-0.2,20,EL
a45eac1f,2,92,1.0,1,0,1,0,1,2,-1,1.7,1.6,0.1,20,EL
a47e7ecd,6,540,6.0,6,6,0,0,6,10,-4,6.2,7.2,-1.0,20,EL
a4851d9e,3,205,2.3,2,2,1,3,2,3,-1,2.2,3.4,-1.2,20,EL
a489c26e,2,152,1.7,2,1,0,4,4,8,-4,2.5,6.6,-4.0,20,EL
a4971d84,7,630,7.0,7,7,0,1,8,5,3,10.1,5.0,5.2,20,EL
a4ac4b8f,8,720,8.0,8,8,0,0,11,7,4,10.7,8.9,1.9,20,EL
a4b1028a,4,360,4.0,4,4,0,0,2,5,-3,5.8,3.8,2.0,20,EL
a4e16ab4,1,25,0.3,0,0,1,1,0,0,0,0.2,0.1,0.1,20,EL
a4e428bf,4,354,3.9,4,3,0,0,4,8,-4,2.6,8.9,-6.3,20,EL
a4f642c5,5,281,3.1,3,2,2,0,10,2,8,4.8,4.3,0.6,20,EL
a4fe8cda,6,270,3.0,3,2,3,0,6,2,4,5.4,1.3,4.1,20,EL
a51a79a2,1,11,0.1,0,0,1,1,0,0,0,0.1,0.1,0.1,20,EL
a56bd2ee,11,1020,11.3,11,11,0,0,12,8,4,10.0,14.6,-4.5,20,EL
a62c16d0,8,603,6.7,7,4,1,0,13,11,2,10.3,9.6,0.7,20,EL
a63a995f,5,380,4.2,5,3,0,0,7,4,3,7.4,4.9,2.5,20,EL
a64b4786,4,390,4.3,4,4,0,4,7,7,0,5.3,6.6,-1.3,20,EL
a685f013,4,360,4.0,4,4,0,1,9,3,6,7.9,4.6,3.3,20,EL
a6f6aad2,1,7,0.1,0,0,1,1,0,0,0,0.1,0.0,0.1,20,EL
a70b8345,5,450,5.0,5,5,0,5,8,7,1,8.6,5.3,3.3,20,EL
a73c8f95,10,877,9.7,10,9,0,0,13,12,1,14.4,13.2,1.2,20,EL
a78ff07f,7,577,6.4,7,5,0,1,13,10,3,9.5,9.2,0.3,20,EL
a81ed730,6,513,5.7,6,4,0,0,6,6,0,10.1,5.6,4.5,20,EL
a820e429,11,646,7.2,7,1,4,0,15,5,10,11.5,10.0,1.5,20,EL
a8741470,1,29,0.3,0,0,1,1,0,2,-2,0.2,0.8,-0.7,20,EL
a881d44a,1,21,0.2,0,0,1,2,0,0,0,0.5,0.8,-0.3,20,EL
a8c0acb7,8,675,7.5,7,7,1,0,12,10,2,10.3,10.3,0.1,20,EL
a8c62306,3,123,1.4,1,1,2,0,1,5,-4,1.7,3.2,-1.6,20,EL
a8f21b9f,3,206,2.3,2,1,1,0,2,1,1,2.0,3.2,-1.2,20,EL
a9142dc3,2,87,1.0,1,0,1,1,1,1,0,0.9,0.8,0.2,20,EL
aa04bee3,4,130,1.4,1,0,3,0,1,5,-4,1.1,2.9,-1.8,20,EL
aa5859cb,8,656,7.3,8,2,0,0,11,9,2,7.6,10.3,-2.7,20,EL
aa6f2f2c,1,90,1.0,1,1,0,4,4,0,4,2.5,0.3,2.3,20,EL
aa8e289e,6,535,5.9,6,5,0,0,3,9,-6,7.8,9.5,-1.7,20,EL
aacdfe88,2,100,1.1,1,0,1,3,1,3,-2,1.1,1.7,-0.6,20,EL
ab096c6f,6,540,6.0,6,6,0,0,6,8,-2,5.5,5.4,0.1,20,EL
ab6928f2,1,10,0.1,0,0,1,2,1,0,1,0.5,0.1,0.4,20,EL
abb3bb95,8,397,4.4,4,2,4,0,8,5,3,7.5,5.0,2.4,20,EL
ac290817,5,184,2.0,2,0,3,0,3,6,-3,2.8,5.9,-3.1,20,EL
ad3389d5,5,450,5.0,5,5,0,0,10,5,5,8.3,5.7,2.5,20,EL
ad4d0985,3,240,2.7,3,2,0,1,4,5,-1,4.4,3.1,1.3,20,EL
ad556f81,1,26,0.3,0,0,1,0,0,0,0,0.3,0.5,-0.2,20,EL
ad597bf7,2,145,1.6,2,1,0,0,1,3,-2,1.5,2.1,-0.6,20,EL
ad7b19ef,1,64,0.7,1,0,0,1,1,3,-2,0.3,1.1,-0.7,20,EL
ade993b9,6,430,4.8,5,3,1,0,7,8,-1,6.1,10.9,-4.7,20,EL
adfbe1f5,6,467,5.2,5,3,1,0,4,6,-2,7.5,9.1,-1.6,20,EL
aeda1f69,5,130,1.4,1,1,4,3,1,4,-3,0.7,1.4,-0.7,20,EL
aeed5c06,4,329,3.7,4,2,0,0,8,4,4,5.3,4.0,1.3,20,EL
aefd0c5b,2,180,2.0,2,2,0,1,0,3,-3,1.5,3.7,-2.2,20,EL
afbf187b,5,370,4.1,4,4,1,0,6,8,-2,5.7,10.6,-4.9,20,EL
b0616e3d,7,630,7.0,7,7,0,5,15,4,11,14.4,4.8,9.6,20,EL
b0a84aa7,1,6,0.1,0,0,1,4,0,0,0,0.1,0.1,0.0,20,EL
b0c12a65,6,456,5.1,5,2,1,0,6,7,-1,5.7,8.4,-2.6,20,EL
b0edd538,3,240,2.7,3,1,0,2,3,6,-3,3.6,4.6,-1.0,20,EL
b1062a37,6,540,6.0,6,6,0,0,7,5,2,5.8,9.1,-3.3,20,EL
b12d5243,1,90,1.0,1,1,0,0,1,2,-1,1.5,1.4,0.0,20,EL
b1313ec4,10,612,6.8,6,5,4,0,10,8,2,9.8,9.3,0.5,20,EL
b15780e3,1,90,1.0,1,1,0,5,0,2,-2,0.3,2.3,-2.1,20,EL
b1579026,8,631,7.0,7,7,1,2,8,12,-4,8.9,14.4,-5.5,20,EL
b182a240,1,45,0.5,0,0,1,0,1,0,1,0.2,0.4,-0.2,20,EL
b1cd37e6,10,889,9.9,10,8,0,0,14,17,-3,16.7,15.5,1.2,20,EL
b1f4086c,2,180,2.0,2,2,0,0,4,5,-1,3.0,3.3,-0.3,20,EL
b2d0ec1b,2,74,0.8,1,0,1,1,4,0,4,3.8,0.2,3.6,20,EL
b39a793e,4,219,2.4,2,2,2,1,2,5,-3,3.7,3.1,0.6,20,EL
b39bf63f,4,274,3.0,3,2,1,2,2,6,-4,4.2,5.4,-1.2,20,EL
b3aed40d,2,142,1.6,2,1,0,0,2,3,-1,2.4,2.7,-0.3,20,EL
b3b310f0,3,80,0.9,0,0,3,0,4,0,4,3.1,0.3,2.8,20,EL
b3b7f5a6,5,54,0.6,0,0,5,4,0,4,-4,1.0,3.5,-2.5,20,EL
b3c14bff,9,319,3.5,4,0,5,0,5,3,2,5.3,3.5,1.8,20,EL
b3dc6eca,1,73,0.8,1,0,0,0,2,2,0,1.3,1.1,0.2,20,EL
b4a014b1,8,646,7.2,7,6,1,2,14,4,10,11.3,8.0,3.3,20,EL
b500b384,5,423,4.7,5,2,0,0,10,4,6,7.4,5.3,2.1,20,EL
b561db50,9,761,8.5,9,6,0,1,11,6,5,12.8,8.0,4.9,20,EL
b583aef5,10,930,10.3,10,10,0,0,13,16,-3,13.2,18.4,-5.2,20,EL
b5920350,6,401,4.5,5,1,1,1,4,5,-1,3.6,4.6,-1.0,20,EL
b5f7d10b,5,450,5.0,5,5,0,0,12,10,2,8.7,6.8,1.9,20,EL
b6047994,1,36,0.4,0,0,1,1,0,0,0,0.1,0.2,-0.1,20,EL
b635c249,2,129,1.4,2,0,0,1,1,1,0,1.4,2.6,-1.1,20,EL
b6580563,2,104,1.2,2,1,0,0,0,1,-1,0.3,2.9,-2.6,20,EL
b675e328,2,156,1.7,2,1,0,2,3,2,1,0.8,3.0,-2.1,20,EL
b682dcf6,5,355,3.9,4,2,1,0,4,6,-2,6.5,3.5,2.9,20,EL
b684a484,5,198,2.2,2,1,3,0,2,4,-2,3.4,1.5,1.9,20,EL
b6867b96,2,78,0.9,0,0,2,4,0,3,-3,0.5,3.5,-3.0,20,EL
b686f4c0,9,430,4.8,6,1,3,0,7,6,1,6.9,7.3,-0.4,20,EL
b69261a0,4,339,3.8,4,2,0,2,3,4,-1,5.9,4.9,1.0,20,EL
b6964eb6,5,450,5.0,5,5,0,0,7,4,3,7.7,7.0,0.7,20,EL
b6cd4243,2,175,1.9,2,1,0,0,4,2,2,2.3,4.3,-2.0,20,EL
b70bde8f,1,6,0.1,0,0,1,3,0,0,0,0.0,0.0,0.0,20,EL
b7de5bad,2,165,1.8,2,1,0,3,3,5,-2,2.8,3.4,-0.6,20,EL
b853e0ad,9,664,7.4,8,5,1,2,16,3,13,17.6,4.8,12.8,20,EL
b8798a46,3,270,3.0,3,3,0,2,4,4,0,3.4,2.8,0.6,20,EL
b8814868,4,358,4.0,4,3,0,1,5,4,1,8.6,4.4,4.2,20,EL
b8e740fb,1,74,0.8,1,0,0,1,2,1,1,1.4,1.3,0.1,20,EL
b937e490,8,584,6.5,6,3,2,2,9,6,3,10.2,7.0,3.2,20,EL
b956af7d,2,180,2.0,2,2,0,0,1,5,-4,1.7,3.5,-1.8,20,EL
b96b595c,6,540,6.0,6,6,0,0,6,9,-3,6.9,8.0,-1.1,20,EL
b997c3de,7,585,6.5,7,6,0,0,7,11,-4,10.3,7.9,2.4,20,EL
ba3378a5,4,275,3.1,3,2,1,4,2,7,-5,2.6,4.0,-1.5,20,EL
ba3d3bea,5,262,2.9,3,2,2,0,1,4,-3,1.7,4.2,-2.5,20,EL
ba5004e1,4,360,4.0,4,4,0,3,6,4,2,6.0,3.6,2.4,20,EL
bab077a4,3,159,1.8,2,0,1,1,1,5,-4,2.5,2.9,-0.4,20,EL
bac46a10,2,180,2.0,2,2,0,0,2,3,-1,1.7,2.3,-0.7,20,EL
bad38a94,5,426,4.7,5,4,0,2,10,7,3,9.1,5.3,3.7,20,EL
bb08bce9,10,900,10.0,10,10,0,0,20,8,12,15.7,12.9,2.8,20,EL
bb19da7c,5,245,2.7,3,0,2,1,3,7,-4,1.7,7.6,-5.9,20,EL
bbddc31f,6,540,6.0,6,6,0,0,10,10,0,9.9,7.3,2.6,20,EL
bc6bd723,5,223,2.5,3,0,2,0,2,5,-3,3.6,4.0,-0.4,20,EL
bc6f5f06,5,429,4.8,5,4,0,7,9,3,6,10.8,3.0,7.8,20,EL
bc7dc64d,6,544,6.0,6,5,0,1,8,6,2,11.3,5.6,5.6,20,EL
bd142efb,4,284,3.2,3,3,1,1,7,4,3,4.0,4.2,-0.2,20,EL
bd3e08b6,1,90,1.0,1,1,0,5,0,4,-4,0.3,2.5,-2.3,20,EL
bd46bd6d,6,385,4.3,4,2,2,0,1,3,-2,4.6,5.7,-1.1,20,EL
bd7d2e6d,3,270,3.0,3,3,0,3,7,7,0,4.1,5.7,-1.6,20,EL
bdc74a8f,2,21,0.2,0,0,2,0,0,0,0,0.2,0.6,-0.4,20,EL
bdc8912c,9,789,8.8,9,7,0,0,15,6,9,15.3,9.4,5.9,20,EL
bdf8165d,6,491,5.5,5,5,1,0,8,11,-3,9.9,5.6,4.3,20,EL
be094834,1,32,0.4,0,0,1,1,0,0,0,0.0,0.2,-0.2,20,EL
be2706c0,3,270,3.0,3,3,0,3,3,5,-2,3.6,7.8,-4.2,20,EL
be4e7e47,6,495,5.5,6,5,0,0,7,5,2,5.0,8.6,-3.6,20,EL
be60b6f4,4,172,1.9,1,0,3,3,2,3,-1,3.2,2.0,1.2,20,EL
be765073,10,880,9.8,10,8,0,0,13,11,2,11.4,13.7,-2.3,20,EL
be927d03,8,515,5.699999999999999,6,4,2,0,16,4,12,13.399999999999999,5.3,8.0,20,EL
beb6c168,5,373,4.1,5,2,0,1,3,12,-9,2.5,9.3,-6.7,20,EL
bee0bab1,2,67,0.7,1,0,1,1,1,0,1,1.0,0.3,0.7,20,EL
bf309d24,6,448,5.0,5,4,1,0,11,6,5,11.2,4.8,6.3,20,EL
bfc5768b,4,34,0.4,0,0,4,2,1,1,0,1.1,1.1,0.0,20,EL
bfe272bd,6,452,5.0,6,3,0,1,2,10,-8,3.8,8.5,-4.7,20,EL
c01c66d9,5,439,4.9,5,4,0,1,5,7,-2,5.1,6.4,-1.2,20,EL
c0617e2b,6,311,3.5,3,1,3,0,9,1,8,10.7,2.5,8.2,20,EL
c082d484,3,137,1.5,1,1,2,1,4,4,0,2.8,2.5,0.3,20,EL
c089980e,6,519,5.8,6,5,0,0,9,9,0,9.2,7.2,2.0,20,EL
c0e27d1a,5,420,4.7,5,4,0,0,7,4,3,10.0,4.5,5.5,20,EL
c21da05c,1,90,1.0,1,1,0,0,1,2,-1,1.5,1.4,0.0,20,EL
c2304da8,4,344,3.8,4,2,0,0,5,3,2,4.4,4.0,0.4,20,EL
c24544c7,1,44,0.5,0,0,1,0,0,0,0,0.5,0.6,0.0,20,EL
c27ae377,2,23,0.3,0,0,2,2,1,1,0,0.5,1.9,-1.4,20,EL
c2a6033c,1,14,0.2,0,0,1,6,0,0,0,0.8,0.0,0.8,20,EL
c32e457e,3,225,2.5,3,2,0,0,1,8,-7,0.6,11.1,-10.4,20,EL
c3767acc,2,64,0.7,1,0,1,3,0,1,-1,0.3,1.6,-1.3,20,EL
c3e39f12,7,630,7.0,7,7,0,0,12,8,4,10.2,8.6,1.6,20,EL
c43e5e7e,6,534,5.9,6,5,0,0,13,10,3,10.0,6.9,3.2,20,EL
c44a1d58,5,418,4.6,5,3,0,0,6,8,-2,7.8,6.7,1.1,20,EL
c45a34e7,2,115,1.3,1,1,1,0,0,6,-6,0.8,3.7,-2.9,20,EL
c492c9f0,1,90,1.0,1,1,0,2,0,2,-2,0.7,1.9,-1.1,20,EL
c4987edc,1,7,0.1,0,0,1,1,0,0,0,0.0,0.5,-0.4,20,EL
c4e87b8b,9,758,8.4,9,7,0,0,14,13,1,13.0,10.1,3.0,20,EL
c50281a0,4,286,3.2,4,1,0,0,5,3,2,5.5,4.1,1.3,20,EL
c54ea7f0,6,537,6.0,6,5,0,0,7,8,-1,6.1,11.1,-4.9,20,EL
c5bdb6e3,2,168,1.9,2,1,0,3,6,2,4,4.8,1.0,3.8,20,EL
c5ea2dab,8,720,8.0,8,8,0,0,17,13,4,12.7,10.6,2.1,20,EL
c603ad6a,4,332,3.7,4,2,0,2,4,4,0,3.8,5.4,-1.5,20,EL
c631f952,7,630,7.0,7,7,0,0,17,4,13,10.8,9.0,1.8,20,EL
c63f6e46,4,373,4.1,4,3,0,0,3,4,-1,3.6,7.1,-3.5,20,EL
c699e60c,3,201,2.2,2,1,1,1,1,2,-1,2.5,2.8,-0.3,20,EL
c6ac6579,2,19,0.2,0,0,2,4,0,0,0,0.0,0.6,-0.6,20,EL
c7069d87,6,540,6.0,6,6,0,0,7,11,-4,9.7,9.0,0.7,20,EL
c71e97ba,5,424,4.7,5,4,0,0,5,5,0,6.6,5.3,1.4,20,EL
c738a5ec,6,227,2.5,2,1,4,0,2,6,-4,2.3,4.8,-2.5,20,EL
c758cdaf,7,72,0.8,0,0,7,1,1,0,1,1.0,0.6,0.4,20,EL
c7842dab,4,289,3.2,3,3,1,1,3,5,-2,4.5,4.8,-0.2,20,EL
c83623e2,8,656,7.3,8,7,0,0,7,5,2,9.4,10.0,-0.7,20,EL
c89e8aae,5,450,5.0,5,5,0,5,8,7,1,7.5,4.3,3.3,20,EL
c8a88acd,2,180,2.0,2,2,0,2,1,2,-1,1.3,2.6,-1.3,20,EL
c8c60119,4,360,4.0,4,4,0,3,7,6,1,7.2,5.1,2.1,20,EL
c8d7131c,4,279,3.1,3,3,1,0,3,2,1,3.8,8.5,-4.7,20,EL
c904f3d5,2,117,1.3,2,1,0,0,0,1,-1,0.6,2.3,-1.7,20,EL
c906ce0f,7,543,6.0,6,5,1,0,9,9,0,10.9,6.9,4.0,20,EL
c90b2e8f,2,97,1.1,1,1,1,0,1,3,-2,2.2,1.0,1.3,20,EL
c931d9f9,6,295,3.3,4,0,2,3,6,1,5,6.1,2.3,3.7,20,EL
c93a0fd3,5,351,3.9,5,1,0,1,2,13,-11,2.7,12.1,-9.4,20,EL
c952f633,6,455,5.1,5,5,1,0,6,7,-1,6.9,7.5,-0.6,20,EL
c9bdb329,2,168,1.9,2,1,0,0,2,4,-2,2.6,2.8,-0.1,20,EL
ca033449,8,720,8.0,8,8,0,0,7,5,2,10.1,11.4,-1.3,20,EL
ca45605e,2,135,1.5,2,1,0,0,2,4,-2,1.8,3.1,-1.3,20,EL
ca607d59,5,194,2.1999999999999997,1,0,4,0,4,3,1,1.9000000000000001,3.5,-1.5999999999999999,20,EL
ca8fa0c0,1,16,0.2,0,0,1,1,0,1,-1,0.1,0.8,-0.7,20,EL
cac76a72,4,360,4.0,4,4,0,0,5,6,-1,4.2,3.2,1.0,20,EL
cb641b9d,6,480,5.3,6,1,0,0,11,7,4,5.5,8.3,-2.8,20,EL
cb7786d5,2,68,0.8,1,0,1,5,0,1,-1,0.1,1.4,-1.3,20,EL
cba16a46,1,2,0.0,0,0,1,1,0,0,0,0.0,0.0,0.0,20,EL
cc1a0c57,3,270,3.0,3,3,0,2,4,6,-2,3.9,5.4,-1.5,20,EL
cc55da2a,3,201,2.2,2,1,1,0,0,4,-4,1.0,3.1,-2.1,20,EL
cc89c822,4,138,1.5,1,0,3,3,0,1,-1,0.4,0.9,-0.5,20,EL
cc9256ef,1,7,0.1,0,0,1,0,0,0,0,0.0,0.0,0.0,20,EL
ccbf1b54,6,511,5.7,6,4,0,0,4,17,-13,3.0,17.5,-14.5,20,EL
ccc66d00,6,354,3.9,5,0,1,0,1,5,-4,5.1,4.9,0.2,20,EL
ccd38335,1,45,0.5,1,0,0,1,1,1,0,1.3,1.2,0.2,20,EL
ccee698e,1,80,0.9,1,0,0,0,1,0,1,0.3,1.0,-0.8,20,EL
cd0ecf81,4,274,3.0,4,1,0,2,1,3,-2,2.4,3.3,-0.9,20,EL
cd6a1a59,1,90,1.0,1,1,0,3,3,2,1,0.4,2.0,-1.6,20,EL
cda08080,6,458,5.1,4,4,2,0,4,17,-13,2.7,14.9,-12.1,20,EL
cda49f68,5,151,1.7,1,0,4,3,4,1,3,2.8,1.4,1.4,20,EL
cda90ea8,6,512,5.7,6,4,0,0,8,16,-8,6.1,16.1,-10.0,20,EL
ce17b5eb,5,450,5.0,5,5,0,0,6,10,-4,8.3,10.3,-1.9,20,EL
ce30bfc8,4,315,3.5,4,2,0,0,11,4,7,6.2,4.2,2.1,20,EL
ce50fd99,7,618,6.9,7,5,0,0,10,8,2,7.5,9.6,-2.1,20,EL
ce5a24b9,5,373,4.1,4,3,1,0,2,6,-4,3.2,7.0,-3.8,20,EL
ce82f116,6,463,5.1,5,4,1,0,12,7,5,10.3,4.7,5.7,20,EL
cea0df32,4,59,0.7,0,0,4,0,2,1,1,1.4,1.7,-0.3,20,EL
cf15bbb1,9,785,8.7,9,8,0,0,12,11,1,9.7,13.2,-3.5,20,EL
cf182add,3,247,2.7,3,2,0,0,6,5,1,4.7,4.1,0.6,20,EL
cf1c23d8,2,180,2.0,2,2,0,4,4,1,3,3.5,0.5,3.0,20,EL
cf623c78,2,82,0.9,1,0,1,4,1,0,1,1.7,0.6,1.1,20,EL
cfb6c9e5,4,65,0.7,0,0,4,3,1,1,0,0.6,2.1,-1.5,20,EL
cfe6238d,3,182,2.0,2,2,1,3,4,3,1,1.2,3.9,-2.7,20,EL
cff7dcb0,3,70,0.8,0,0,3,0,1,0,1,1.1,0.3,0.8,20,EL
d019d5db,2,87,1.0,1,0,1,0,0,1,-1,0.7,0.9,-0.2,20,EL
d01bbb6f,4,230,2.6,3,0,1,0,5,4,1,4.4,4.2,0.2,20,EL
d0d8dd44,4,360,4.0,4,4,0,1,11,4,7,7.5,4.4,3.1,20,EL
d0f72bf1,4,360,4.0,4,4,0,5,9,4,5,8.4,3.4,5.1,20,EL
d1117c6c,6,540,6.0,6,6,0,0,10,13,-3,6.4,13.0,-6.6,20,EL
d125f22f,1,90,1.0,1,1,0,1,0,5,-5,0.3,3.5,-3.2,20,EL
d14229f3,4,181,2.0,2,1,2,1,1,1,0,3.0,1.9,1.1,20,EL
d1675302,1,7,0.1,0,0,1,1,2,2,0,0.1,0.6,-0.5,20,EL
d1992a3b,10,754,8.4,7,6,3,1,7,5,2,6.3,10.8,-4.5,20,EL
d19ecb20,1,32,0.4,0,0,1,6,3,1,2,2.3,0.1,2.1,20,EL
d1d418f8,1,6,0.1,0,0,1,0,0,1,-1,0.2,0.1,0.1,20,EL
d1f48bfc,6,362,4.0,4,3,2,0,5,7,-2,6.7,5.7,1.0,20,EL
d1fea02e,6,540,6.0,6,6,0,0,3,11,-8,6.1,7.9,-1.9,20,EL
d2161bae,5,409,4.5,5,3,0,1,3,8,-5,2.6,6.0,-3.4,20,EL
d2800f47,9,775,8.6,9,4,0,0,8,15,-7,8.9,16.2,-7.4,20,EL
d2a802b8,5,418,4.6,5,1,0,0,7,14,-7,4.4,13.2,-8.8,20,EL
d2bf42ba,1,25,0.3,0,0,1,0,0,0,0,0.4,0.2,0.2,20,EL
d4133fa1,5,439,4.9,5,4,0,0,4,6,-2,4.1,4.0,0.1,20,EL
d436eb94,2,180,2.0,2,2,0,0,1,6,-5,1.7,4.7,-3.0,20,EL
d4931a5a,2,107,1.2,1,1,1,5,2,1,1,2.1,1.0,1.1,20,EL
d494882e,2,162,1.8,2,1,0,0,1,6,-5,1.3,4.3,-3.0,20,EL
d49f80d7,4,360,4.0,4,4,0,2,8,6,2,9.2,3.7,5.5,20,EL
d4a2533d,9,697,7.7,9,2,0,1,14,8,6,11.1,8.4,2.8,20,EL
d4d0a9ad,4,314,3.5,4,2,0,1,5,5,0,5.4,2.7,2.7,20,EL
d5575935,4,159,1.8,2,0,2,1,1,3,-2,2.8,2.9,-0.1,20,EL
d557d734,10,844,9.4,10,8,0,0,14,9,5,14.4,9.6,4.8,20,EL
d5dd5f1f,6,408,4.5,4,4,2,0,6,4,2,10.6,4.6,6.0,20,EL
d61b3354,3,158,1.8,3,1,0,1,5,4,1,3.0,2.4,0.7,20,EL
d637fc22,2,210,2.3,2,2,0,0,4,5,-1,3.4,3.1,0.3,20,EL
d68cb24c,7,436,4.8,5,2,2,1,6,5,1,5.0,7.5,-2.4,20,EL
d790907f,1,1,0.0,0,0,1,1,0,0,0,0.0,0.0,0.0,20,EL
d79a8c87,3,270,3.0,3,3,0,1,8,3,5,8.4,3.2,5.1,20,EL
d807c7f6,1,90,1.0,1,1,0,2,1,1,0,1.3,2.4,-1.0,20,EL
d82c6542,5,388,4.3,4,4,1,0,4,10,-6,3.6,10.6,-7.1,20,EL
d849ef0f,4,231,2.6,2,2,2,4,1,3,-2,1.9,3.7,-1.8,20,EL
d8931174,9,817,9.1,9,8,0,2,23,4,19,20.6,6.5,14.1,20,EL
d8c679be,5,327,3.6,4,2,1,0,2,10,-8,2.2,6.8,-4.6,20,EL
d8d25850,3,153,1.7,2,1,1,2,2,6,-4,1.8,4.3,-2.6,20,EL
d93c2511,7,424,4.7,5,3,2,3,14,1,13,11.7,2.3,9.4,20,EL
d94653be,6,477,5.3,6,4,0,0,6,8,-2,8.6,7.2,1.4,20,EL
d9565625,3,260,2.9,3,2,0,0,2,1,1,4.3,2.6,1.7,20,EL
d97b252e,3,270,3.0,3,3,0,3,3,7,-4,6.3,6.2,0.1,20,EL
d97cccc9,8,685,7.6,8,5,0,0,9,6,3,9.2,9.7,-0.4,20,EL
d9a5d930,5,37,0.4,0,0,5,1,3,2,1,1.1,0.3,0.8,20,EL
d9b89391,6,293,3.3,3,2,3,0,5,7,-2,3.8,6.7,-2.9,20,EL
d9d43555,1,6,0.1,0,0,1,3,1,1,0,0.1,1.1,-1.0,20,EL
da1185fc,10,927,10.3,10,7,0,0,13,16,-3,13.2,18.3,-5.2,20,EL
da23d58d,5,159,1.8,2,0,3,1,3,1,2,1.9,1.8,0.2,20,EL
da27e268,3,202,2.2,2,2,1,0,3,1,2,3.6,1.1,2.5,20,EL
da617483,6,455,5.1,5,5,1,4,4,3,1,4.6,4.5,0.1,20,EL
da6cb94b,4,360,4.0,4,4,0,1,1,5,-4,2.6,4.3,-1.7,20,EL
da8b19e2,1,90,1.0,1,1,0,10,4,0,4,2.5,0.3,2.3,20,EL
db265666,4,146,1.6,1,1,3,1,1,6,-5,2.0,2.6,-0.6,20,EL
db2e8273,4,11,0.1,0,0,4,1,0,0,0,0.2,0.2,0.1,20,EL
db401046,5,450,5.0,5,5,0,0,7,6,1,7.2,7.1,0.1,20,EL
db74c6d3,2,180,2.0,2,2,0,0,1,1,0,2.0,3.0,-1.0,20,EL
db7849ca,2,135,1.5,1,1,1,0,0,1,-1,1.5,1.0,0.5,20,EL
dba67bc4,1,90,1.0,1,1,0,0,1,4,-3,1.4,3.0,-1.6,20,EL
dbbf4a56,1,5,0.1,0,0,1,3,0,0,0,0.0,0.1,-0.1,20,EL
dbe16ade,2,43,0.5,0,0,2,0,2,2,0,2.4,1.1,1.3,20,EL
dbf3e08b,5,431,4.8,5,4,0,0,7,4,3,4.5,7.3,-2.8,20,EL
dc415e39,6,451,5.0,5,2,1,0,5,6,-1,5.5,9.3,-3.9,20,EL
dc52c72f,6,513,5.7,6,5,0,0,6,7,-1,9.7,6.5,3.2,20,EL
dc6f5bdd,3,193,2.1,2,2,1,2,6,2,4,5.2,3.0,2.2,20,EL
dc90cfbe,4,196,2.2,2,1,2,0,0,3,-3,4.2,5.1,-0.9,20,EL
dd0daf32,5,301,3.3,3,3,2,1,3,5,-2,4.0,5.3,-1.4,20,EL
dd669209,9,501,5.6,5,4,4,0,8,6,2,10.0,5.9,4.1,20,EL
deb20131,7,521,5.8,7,4,0,0,13,9,4,13.2,6.7,6.5,20,EL
deba6b05,7,627,7.0,7,6,0,0,15,12,3,10.5,8.8,1.8,20,EL
def899bd,3,203,2.3,2,2,1,1,2,0,2,4.3,0.9,3.4,20,EL
defb905a,8,690,7.7,8,6,0,0,10,11,-1,10.1,10.9,-0.8,20,EL
dfb6490a,5,211,2.3,2,1,3,0,2,3,-1,6.3,2.6,3.7,20,EL
dff19848,2,103,1.1,1,1,1,0,1,1,0,1.5,2.4,-0.9,20,EL
e09436fb,3,166,1.8,2,1,1,1,0,5,-5,0.9,2.5,-1.6,20,EL
e0991c04,4,347,3.9,4,3,0,0,5,0,5,7.0,2.0,5.1,20,EL
e0a1c004,5,191,2.1,2,1,3,3,1,3,-2,0.5,3.5,-3.0,20,EL
e0d3e18d,6,351,3.9,4,0,2,0,1,4,-3,5.0,4.9,0.1,20,EL
e0f613ad,3,270,3.0,3,3,0,1,2,5,-3,2.5,4.1,-1.5,20,EL
e12b0b5b,8,651,7.2,8,5,0,0,12,10,2,12.4,9.4,3.0,20,EL
e12d7851,6,498,5.5,5,5,1,0,4,17,-13,3.0,17.2,-14.2,20,EL
e150254d,2,112,1.2,1,0,1,1,3,1,2,2.3,1.3,1.0,20,EL
e1ba3d5a,8,704,7.8,8,5,0,0,14,5,9,14.2,8.5,5.6,20,EL
e1deea75,1,90,1.0,1,1,0,0,2,0,2,0.8,0.2,0.7,20,EL
e248e62f,2,66,0.7,0,0,2,1,0,1,-1,0.2,0.6,-0.4,20,EL
e2781082,8,689,7.7,8,7,0,0,11,9,2,7.9,10.0,-2.1,20,EL
e27da244,5,429,4.8,5,4,0,2,7,3,4,7.1,6.4,0.6,20,EL
e27fdbca,5,306,3.4,3,2,2,3,2,6,-4,5.9,4.5,1.4,20,EL
e28205f4,4,187,2.1,2,0,2,0,1,3,-2,2.4,1.8,0.6,20,EL
e28868f3,6,377,4.2,5,4,1,1,9,4,5,6.5,3.7,2.8,20,EL
e288d4b3,2,97,1.1,1,1,1,2,2,3,-1,2.7,2.0,0.7,20,EL
e2bf2abc,4,182,2.0,2,0,2,3,1,1,0,1.0,2.1,-1.1,20,EL
e2f9bb5f,6,468,5.2,5,5,1,0,6,8,-2,4.4,5.0,-0.6,20,EL
e34e086c,3,179,2.0,2,0,1,0,5,3,2,2.7,2.3,0.4,20,EL
e38f1636,6,540,6.0,6,6,0,0,9,12,-3,7.7,9.9,-2.2,20,EL
e3a5814e,6,289,3.2,4,1,2,1,8,5,3,7.1,3.2,4.0,20,EL
e3fabb0a,7,403,4.5,4,2,3,0,6,7,-1,6.2,4.4,1.8,20,EL
e410ade0,6,440,4.9,5,1,1,0,4,8,-4,4.7,4.7,0.0,20,EL
e4538d74,3,259,2.9,3,2,0,0,3,5,-2,2.7,3.1,-0.4,20,EL
e4738e91,1,78,0.9,1,0,0,1,3,3,0,1.4,1.4,0.0,20,EL
e4b72e34,1,90,1.0,1,1,0,2,2,3,-1,0.6,1.1,-0.5,20,EL
e53b5534,10,930,10.3,10,10,0,1,12,7,5,9.4,13.8,-4.4,20,EL
e54a9890,3,254,2.8,3,2,0,1,1,5,-4,5.1,2.6,2.4,20,EL
e5f63987,5,157,1.7,2,0,3,0,1,0,1,2.0,2.5,-0.5,20,EL
e613313c,2,114,1.3,1,1,1,0,2,2,0,1.7,1.7,0.0,20,EL
e61b8aee,4,390,4.3,4,4,0,1,6,4,2,8.8,4.5,4.3,20,EL
e61d33f1,5,392,4.4,4,4,1,1,2,6,-4,4.1,5.2,-1.1,20,EL
e65a7469,6,321,3.6,5,1,1,0,1,8,-7,1.8,5.2,-3.4,20,EL
e6697917,1,63,0.7,1,0,0,1,2,1,1,1.5,1.2,0.3,20,EL
e66e4ddc,6,540,6.0,6,6,0,0,8,11,-3,10.0,6.2,3.9,20,EL
e6aaca37,3,138,1.5,1,0,2,0,4,2,2,2.9,1.1,1.8,20,EL
e6c43eec,6,466,5.2,5,5,1,1,8,10,-2,7.7,5.2,2.5,20,EL
e6dda1c7,7,575,6.4,6,6,1,1,6,4,2,5.0,7.8,-2.8,20,EL
e726e11e,5,216,2.4,2,1,3,1,4,1,3,3.7,0.7,3.0,20,EL
e73659d3,7,599,6.7,7,4,0,1,10,7,3,9.6,8.1,1.5,20,EL
e73c9bb2,8,720,8.0,8,8,0,0,10,14,-4,12.7,10.1,2.6,20,EL
e76cb9cc,5,322,3.6,4,3,1,3,2,8,-6,3.0,5.0,-2.0,20,EL
e7aa9d7c,3,37,0.4,0,0,3,2,0,0,0,1.4,0.1,1.3,20,EL
e7fcf289,1,67,0.7,1,0,0,1,1,0,1,1.7,0.0,1.7,20,EL
e8029b54,8,240,2.7,2,2,6,3,2,2,0,2.5,2.7,-0.2,20,EL
e81f0356,2,180,2.0,2,2,0,0,3,6,-3,2.8,4.7,-1.9,20,EL
e82adcab,2,144,1.6,2,0,0,3,2,2,0,2.6,2.3,0.3,20,EL
e92cd3f7,4,263,2.9,3,2,1,1,2,5,-3,2.0,4.7,-2.7,20,EL
e9457fb9,5,280,3.1,3,1,2,1,5,7,-2,2.6,8.3,-5.6,20,EL
e961d3ac,2,180,2.0,2,2,0,3,2,2,0,2.8,3.6,-0.8,20,EL
e97150c0,3,270,3.0,3,3,0,2,2,4,-2,3.6,3.2,0.5,20,EL
e98d18ca,2,35,0.4,0,0,2,0,1,1,0,0.8,0.1,0.7,20,EL
e9c0c1b2,1,90,1.0,1,1,0,0,2,1,1,1.5,1.6,-0.1,20,EL
ea610f00,6,391,4.3,4,4,2,1,11,5,6,10.2,5.6,4.6,20,EL
ea7a8366,3,270,3.0,3,3,0,0,1,3,-2,2.2,3.8,-1.6,20,EL
eab957a3,2,180,2.0,2,2,0,0,1,5,-4,1.7,3.5,-1.8,20,EL
eac044ad,6,332,3.7,3,3,3,0,10,3,7,9.1,2.4,6.7,20,EL
ead14875,10,838,9.3,10,7,0,0,19,5,14,13.9,10.2,3.7,20,EL
ead960f2,2,180,2.0,2,2,0,1,0,6,-6,0.5,5.9,-5.5,20,EL
eada676e,6,540,6.0,6,6,0,0,6,10,-4,6.2,7.2,-1.0,20,EL
eaf645bf,1,16,0.2,0,0,1,1,0,3,-3,0.0,1.3,-1.3,20,EL
eb1451a5,2,98,1.1,1,1,1,2,1,4,-3,0.5,2.0,-1.4,20,EL
eb2b33aa,5,450,5.0,5,5,0,1,6,7,-1,9.4,6.3,3.0,20,EL
eb3f56e5,4,281,3.1,4,3,0,1,8,3,5,4.2,2.9,1.3,20,EL
eb6e14be,1,15,0.2,0,0,1,0,0,1,-1,0.0,0.1,0.0,20,EL
eb7822d7,5,411,4.6,4,4,1,4,7,1,6,8.5,3.8,4.7,20,EL
ebca82e8,6,540,6.0,6,6,0,0,8,10,-2,7.0,13.3,-6.3,20,EL
ebca86ca,1,10,0.1,0,0,1,1,0,0,0,0.5,0.1,0.4,20,EL
ec30b9c8,6,540,6.0,6,6,0,0,8,10,-2,7.0,13.3,-6.3,20,EL
ec48abb1,4,138,1.5,1,0,3,4,3,1,2,2.2,1.5,0.7,20,EL
ec531cdc,1,75,0.8,1,0,0,1,0,4,-4,0.2,2.3,-2.1,20,EL
ecb68eea,2,172,1.9,2,1,0,0,1,3,-2,2.0,2.0,0.0,20,EL
ecc10d95,7,518,5.699999999999999,6,1,1,1,7,5,2,5.7,8.9,-3.3,20,EL
ed16a617,8,650,7.2,7,4,1,0,7,4,3,9.2,9.5,-0.3,20,EL
ed5886d2,5,450,5.0,5,5,0,1,5,7,-2,4.9,5.9,-1.0,20,EL
eda40760,8,590,6.6,7,5,1,1,11,6,5,10.6,9.5,1.1,20,EL
edd81e2a,1,10,0.1,0,0,1,2,0,0,0,0.0,0.2,-0.2,20,EL
ee0da7af,2,180,2.0,2,2,0,0,2,5,-3,2.7,3.4,-0.7,20,EL
ee3519f5,5,450,5.0,5,5,0,0,12,10,2,8.2,6.6,1.7,20,EL
ee37317d,1,73,0.8,1,0,0,2,0,1,-1,0.0,0.0,0.0,20,EL
ee47f156,3,270,3.0,3,3,0,0,1,6,-5,1.4,5.1,-3.7,20,EL
eee84d49,1,1,0.0,0,0,1,5,0,1,-1,0.0,0.1,-0.1,20,EL
eef95b11,5,414,4.6,4,4,1,0,6,6,0,6.4,9.5,-3.1,20,EL
ef3909cd,4,360,4.0,4,4,0,3,5,5,0,5.8,6.2,-0.4,20,EL
ef88f778,9,790,8.8,9,7,0,0,12,12,0,9.7,12.8,-3.1,20,EL
ef8f266e,3,97,1.1,1,0,2,1,1,1,0,1.0,0.9,0.1,20,EL
efc13588,10,885,9.8,10,9,0,0,15,9,6,15.9,12.1,3.8,20,EL
efc33b33,5,450,5.0,5,5,0,1,3,12,-9,2.6,10.3,-7.8,20,EL
f034613c,4,121,1.3,0,0,4,1,4,0,4,2.8,1.5,1.4,20,EL
f03f284b,3,210,2.3,2,2,1,1,5,4,1,3.9,2.8,1.1,20,EL
f0661424,1,90,1.0,1,1,0,0,0,2,-2,0.2,0.8,-0.6,20,EL
f0e3b343,7,474,5.3,6,2,1,1,8,10,-2,5.9,9.1,-3.2,20,EL
f11a5b76,6,539,6.0,6,5,0,0,7,8,-1,6.1,11.1,-5.0,20,EL
f11fe861,5,373,4.1,5,4,0,1,5,3,2,8.2,4.9,3.4,20,EL
f15b778f,10,930,10.3,10,10,0,0,12,7,5,9.4,13.8,-4.4,20,EL
f15f8b2b,7,511,5.7,5,2,2,0,8,8,0,6.7,8.8,-2.2,20,EL
f1b55719,1,17,0.2,0,0,1,2,0,2,-2,0.6,1.5,-1.0,20,EL
f1e8372d,1,6,0.1,0,0,1,4,0,0,0,0.0,0.0,0.0,20,EL
f209b81e,5,335,3.7,4,2,1,0,1,2,-1,5.2,4.5,0.7,20,EL
f294b8cc,4,182,2.0,2,1,2,0,4,8,-4,2.9,6.8,-3.9,20,EL
f2eaebe9,2,107,1.2,1,1,1,4,0,8,-8,0.3,8.0,-7.7,20,EL
f30a4ab1,4,243,2.7,2,1,2,1,2,5,-3,2.4,4.7,-2.3,20,EL
f315ca93,4,383,4.3,4,3,0,0,2,4,-2,3.2,6.7,-3.5,20,EL
f323d995,8,675,7.5,8,7,0,0,12,8,4,10.4,9.3,1.1,20,EL
f352799f,2,180,2.0,2,2,0,0,4,5,-1,3.6,2.8,0.8,20,EL
f3722c97,2,52,0.6,0,0,2,2,0,1,-1,0.7,0.2,0.5,20,EL
f3a97d02,10,900,10.0,10,10,0,0,13,12,1,11.8,14.0,-2.2,20,EL
f4021366,6,495,5.5,5,5,1,0,8,14,-6,6.0,14.0,-8.0,20,EL
f42e9f3f,6,540,6.0,6,6,0,0,7,8,-1,6.1,11.1,-4.9,20,EL
f4b1e26f,4,308,3.4,4,2,0,1,2,10,-8,3.1,7.1,-4.0,20,EL
f4d8ce5a,5,150,1.7,1,1,4,2,0,3,-3,0.6,2.3,-1.7,20,EL
f512a009,6,428,4.8,4,4,2,1,7,8,-1,5.6,7.0,-1.4,20,EL
f521b80a,4,360,4.0,4,4,0,0,4,8,-4,7.3,5.9,1.4,20,EL
f533776b,5,139,1.5,1,1,4,2,2,3,-1,1.4,4.4,-3.1,20,EL
f5a00fa4,11,877,9.7,10,7,1,0,19,9,10,17.1,9.9,7.3,20,EL
f5ae006d,9,463,5.1,4,2,5,0,7,9,-2,7.7,8.5,-0.8,20,EL
f5deef4c,4,320,3.6,3,3,1,3,3,3,0,6.5,3.8,2.7,20,EL
f5eedf74,6,453,5.0,6,2,0,0,9,9,0,5.8,8.6,-2.8,20,EL
f620b04f,1,66,0.7,1,0,0,0,0,1,-1,0.0,0.7,-0.7,20,EL
f63a8347,3,270,3.0,3,3,0,3,2,5,-3,2.5,4.1,-1.5,20,EL
f6798fc3,10,900,10.0,10,10,0,2,19,6,13,19.1,9.3,9.8,20,EL
f68b64fc,10,900,10.0,10,10,0,0,20,8,12,15.7,12.9,2.8,20,EL
f7036e1c,5,352,3.9,5,0,0,0,9,4,5,5.8,3.2,2.6,20,EL
f7223718,1,11,0.1,0,0,1,4,0,0,0,0.0,0.1,-0.1,20,EL
f74f680d,4,42,0.5,0,0,4,0,0,3,-3,0.7,3.0,-2.3,20,EL
f7815d38,7,327,3.6,4,1,3,0,1,3,-2,2.2,6.4,-4.2,20,EL
f7b10c66,6,540,6.0,6,6,0,0,8,7,1,9.1,7.9,1.2,20,EL
f7c398ec,1,27,0.3,0,0,1,0,0,2,-2,0.9,0.6,0.3,20,EL
f7e87032,6,539,6.0,6,5,0,0,7,7,0,10.8,6.7,4.1,20,EL
f874dd44,3,263,2.9,3,2,0,1,7,3,4,8.3,2.8,5.5,20,EL
f93c876b,7,502,5.6,6,4,1,1,5,11,-6,6.5,13.2,-6.6,20,EL
f9acca3a,2,113,1.3,1,1,1,1,3,1,2,1.5,1.2,0.2,20,EL
f9c927de,6,472,5.2,5,5,1,0,7,5,2,8.2,6.4,1.8,20,EL
f9ebe13d,1,15,0.2,0,0,1,7,0,3,-3,0.0,1.0,-1.0,20,EL
fa73ccc7,5,370,4.1,5,1,0,1,6,6,0,7.3,6.2,1.2,20,EL
fa937f7a,7,432,4.8,4,4,3,1,10,3,7,7.5,5.6,1.9,20,EL
fae880d5,6,540,6.0,6,6,0,0,8,10,-2,7.0,13.3,-6.3,20,EL
fb054320,8,669,7.4,8,4,0,0,11,13,-2,6.6,12.1,-5.5,20,EL
fb938d24,7,623,6.9,7,6,0,0,10,12,-2,9.2,8.4,0.9,20,EL
fbafd1b0,3,270,3.0,3,3,0,2,4,4,0,2.9,6.0,-3.1,20,EL
fbffc4b1,5,381,4.2,4,4,1,0,5,6,-1,6.6,3.9,2.7,20,EL
fc1cf07a,7,615,6.8,7,6,0,0,10,8,2,7.5,9.6,-2.1,20,EL
fc3f41aa,5,40,0.4,0,0,5,3,0,0,0,0.3,0.4,-0.1,20,EL
fc4ab056,6,448,5.0,4,4,2,0,6,14,-8,8.3,9.7,-1.4,20,EL
fc4cf6a7,4,202,2.2,2,1,2,2,3,3,0,3.7,2.7,1.0,20,EL
fc4f85b1,6,539,6.0,6,5,0,0,15,5,10,10.8,4.9,6.0,20,EL
fce2302c,4,360,4.0,4,4,0,0,9,5,4,9.7,4.4,5.3,20,EL
fd7768be,1,90,1.0,1,1,0,3,1,0,1,1.4,1.0,0.5,20,EL
fd834d1d,1,90,1.0,1,1,0,2,4,2,2,2.6,0.8,1.8,20,EL
fe6c830a,4,109,1.2,1,0,3,1,1,2,-1,0.8,2.1,-1.3,20,EL
fe85a764,4,125,1.4,2,0,2,0,2,0,2,2.9,0.9,2.0,20,EL
fe888e39,4,285,3.2,3,3,1,0,4,5,-1,5.7,4.8,0.8,20,EL
fecd43a3,3,270,3.0,3,3,0,1,2,5,-3,2.9,3.9,-1.0,20,EL
fed7cb61,5,450,5.0,5,5,0,0,10,5,5,8.3,5.7,2.5,20,EL
ff497879,1,90,1.0,1,1,0,4,0,2,-2,0.2,0.8,-0.7,20,EL
ffad706e,3,267,3.0,3,2,0,0,2,2,0,3.7,1.9,1.8,20,EL
003a5c72,9,359,4.0,3,2,6,14,6,4,2,4.1,4.7,-0.6,20,SPA
0076ab7f,24,1216,13.5,9,9,15,10,21,12,9,16.2,16.4,-0.2,20,SPA
00b28772,35,2895,32.2,33,28,2,0,39,31,8,37.9,34.6,3.3,20,SPA
011d8c56,13,1170,13.0,13,13,0,22,18,16,2,14.6,13.5,1.1,20,SPA
01a49bd2,17,1197,13.3,13,12,4,11,12,30,-18,12.3,25.9,-13.6,20,SPA
01eb744d,33,2061,22.9,22,9,11,1,31,20,11,33.2,21.0,12.2,20,SPA
02319ad7,34,2747,30.5,33,18,1,2,34,23,11,35.0,28.4,6.5,20,SPA
02c15616,29,1368,15.2,16,5,13,8,23,18,5,21.4,16.2,5.2,20,SPA
02ef8778,14,1075,11.9,11,9,3,0,7,12,-5,13.8,14.6,-0.8,20,SPA
036bba5f,27,1927,21.4,20,16,7,3,17,25,-8,19.7,30.1,-10.5,20,SPA
04965583,29,2165,24.1,26,12,3,1,25,33,-8,25.8,35.3,-9.6,20,SPA
04a65a8f,2,72,0.8,0,0,2,1,0,0,0,0.6,0.2,0.4,20,SPA
04ac8285,24,2096,23.3,24,23,0,7,27,30,-3,26.4,34.0,-7.6,20,SPA
04e17fd5,36,2181,24.200000000000003,22,15,14,1,27,36,-9,27.599999999999998,33.6,-6.1,20,SPA
05a4465d,30,1967,21.9,22,16,8,5,25,33,-8,24.8,30.1,-5.3,20,SPA
062fc2e6,6,435,4.8,6,3,0,6,6,6,0,7.8,7.2,0.6,20,SPA
06983922,20,870,9.7,9,2,11,6,6,21,-15,8.5,12.3,-3.8,20,SPA
070a3904,36,2658,29.5,29,21,7,1,22,48,-26,31.4,40.3,-8.9,20,SPA
07129f3c,1,1,0.0,0,0,1,11,0,0,0,0.1,0.0,0.0,20,SPA
073b1b37,23,1805,20.1,20,14,3,3,24,33,-9,22.7,29.7,-7.1,20,SPA
08511d65,35,3013,33.5,35,31,0,0,61,21,40,60.9,28.3,32.5,20,SPA
09332647,7,263,2.9,1,0,6,2,4,3,1,5.0,3.7,1.2,20,SPA
0959c2a2,33,1907,21.2,21,10,12,2,42,12,30,39.6,19.2,20.4,20,SPA
09a9e921,19,688,7.6,7,1,12,15,10,7,3,11.0,7.9,3.1,20,SPA
09e81276,2,83,0.9,1,0,1,9,1,2,-1,1.5,1.5,0.0,20,SPA
0a0cc13c,22,672,7.5,6,0,16,12,7,10,-3,9.0,16.0,-7.0,20,SPA
0ac94a23,24,926,10.3,9,1,15,4,11,20,-9,12.1,19.0,-6.9,20,SPA
0ae4e09a,36,2267,25.2,26,11,10,1,27,32,-5,33.0,38.4,-5.5,20,SPA
0b33f6ad,31,2725,30.3,30,28,1,3,24,33,-9,29.4,44.6,-15.2,20,SPA
0b90bb97,34,1944,21.6,21,10,13,1,20,27,-7,24.3,24.9,-0.6,20,SPA
0ba976e4,24,1027,11.4,11,1,13,9,27,14,13,22.3,11.3,11.0,20,SPA
0bc4e720,11,418,4.6,3,0,8,10,10,5,5,7.5,6.3,1.2,20,SPA
0c2ac3cb,32,2297,25.6,27,13,5,0,29,32,-3,29.400000000000002,28.599999999999998,0.7,20,SPA
0cc474e7,25,1361,15.1,14,7,11,12,19,14,5,15.1,17.1,-1.9,20,SPA
0d690336,10,250,2.8,2,0,8,21,3,3,0,3.3,3.4,-0.1,20,SPA
0e50f929,23,1161,12.9,12,3,11,10,15,23,-8,17.1,20.1,-3.0,20,SPA
0e7ccfc4,3,269,3.0,3,2,0,2,0,5,-5,2.9,2.9,0.0,20,SPA
0f0aa5b4,23,1874,20.8,22,17,1,6,16,30,-14,18.6,23.4,-4.8,20,SPA
0ff67313,1,9,0.1,0,0,1,3,1,0,1,0.9,0.0,0.9,20,SPA
10f1cd17,7,473,5.3,5,4,2,2,2,8,-6,4.4,7.7,-3.4,20,SPA
112521d1,20,1087,12.1,11,8,9,13,11,19,-8,14.7,15.2,-0.5,20,SPA
114b510e,2,93,1.0,1,0,1,1,3,1,2,2.6,1.9,0.7,20,SPA
11b9265b,18,1471,16.3,17,13,1,1,27,20,7,26.7,19.5,7.2,20,SPA
129af0db,34,2098,23.3,25,11,9,0,30,14,16,40.5,17.7,22.7,20,SPA
12c50af5,26,1630,18.1,20,7,6,3,18,21,-3,20.9,20.6,0.3,20,SPA
12eda7be,3,30,0.3,0,0,3,6,0,0,0,1.1,0.2,0.9,20,SPA
132ac341,29,2610,29.0,29,29,0,4,36,36,0,39.4,35.3,4.1,20,SPA
167c1bb0,8,377,4.2,4,3,4,9,2,6,-4,4.3,6.1,-1.8,20,SPA
16aa3654,35,2312,25.7,23,14,12,1,28,49,-21,26.6,47.0,-20.4,20,SPA
16e9d0ea,31,2265,25.2,25,19,6,3,35,41,-6,36.4,34.6,1.8,20,SPA
174651c8,22,943,10.5,10,5,12,11,11,11,0,11.7,14.5,-2.9,20,SPA
1840e36d,34,3060,34.0,34,34,0,2,60,20,40,61.1,28.8,32.3,20,SPA
189cee7b,9,448,5.0,4,1,5,6,5,4,1,8.7,5.4,3.3,20,SPA
18abe173,32,2502,27.8,27,25,5,5,24,34,-10,28.5,31.9,-3.4,20,SPA
18f0a9f0,3,19,0.2,0,0,3,3,0,2,-2,0.0,0.7,-0.7,20,SPA
19709006,30,1914,21.3,22,7,8,0,20,34,-14,22.4,27.1,-4.7,20,SPA
19b776e9,13,170,1.9,1,0,12,12,4,2,2,3.2,1.8,1.3,20,SPA
19cdceb0,3,83,0.9,1,0,2,7,1,1,0,0.6,1.8,-1.2,20,SPA
1a317a1b,16,1255,13.899999999999999,15,10,1,5,10,12,-2,8.6,18.7,-10.0,20,SPA
1b17ed86,11,473,5.3,5,1,6,5,3,11,-8,6.2,6.4,-0.2,20,SPA
1b40049a,19,573,6.4,5,0,14,17,6,9,-3,7.6,10.6,-3.0,20,SPA
1bacc518,29,2115,23.5,24,14,5,1,52,26,26,41.2,25.3,16.0,20,SPA
1bda5842,35,2393,26.6,25,13,10,1,46,34,12,35.5,29.9,5.6,20,SPA
1d1691ad,4,343,3.8,4,3,0,5,9,4,5,7.1,3.6,3.5,20,SPA
1d5f96d9,2,78,0.9,1,0,1,3,0,1,-1,0.7,0.6,0.1,20,SPA
1d8c99b0,1,9,0.1,0,0,1,0,0,1,-1,0.0,0.3,-0.3,20,SPA
1daec722,37,3237,36.0,37,24,0,0,41,33,8,40.0,38.2,1.8,20,SPA
1f079188,26,1909,21.2,21,18,5,7,36,28,8,33.9,24.8,9.1,20,SPA
1fb1c435,27,1880,20.9,23,9,4,0,27,23,4,26.1,31.5,-5.4,20,SPA
1fc3c3d7,5,87,1.0,1,0,4,9,1,2,-1,1.2,1.6,-0.4,20,SPA
1fe0492d,31,2663,29.6,30,28,1,1,32,37,-5,34.6,38.9,-4.3,20,SPA
1fe67e86,9,563,6.3,6,5,3,11,5,9,-4,5.7,8.7,-2.9,20,SPA
200e89e1,17,442,4.9,3,1,14,9,7,6,1,6.3,6.6,-0.2,20,SPA
206b11c5,2,37,0.4,0,0,2,2,0,2,-2,0.4,1.3,-0.9,20,SPA
21512407,25,1979,22.0,23,19,2,8,30,15,15,35.4,17.1,18.4,20,SPA
228b0d9d,15,981,10.9,11,8,4,14,11,14,-3,12.0,12.0,0.0,20,SPA
2327c29e,20,654,7.3,5,1,15,11,8,9,-1,11.0,12.9,-1.9,20,SPA
237a3851,6,218,2.4,2,1,4,1,2,4,-2,2.0,3.1,-1.1,20,SPA
240d3a0b,36,3029,33.7,33,32,3,0,39,35,4,38.5,44.3,-5.8,20,SPA
24279b8b,19,1583,17.6,18,17,1,7,22,24,-2,26.1,21.3,4.8,20,SPA
24f59bb2,17,1014,11.3,11,8,6,11,29,11,18,19.8,10.9,9.0,20,SPA
253a06b9,20,1591,17.7,18,14,2,0,24,22,2,28.3,21.7,6.6,20,SPA
2784f898,15,1022,11.4,10,9,5,23,17,9,8,19.3,9.0,10.3,20,SPA
27a013f7,34,2888,32.1,32,27,2,1,32,42,-10,32.9,38.6,-5.6,20,SPA
27d0a506,13,739,8.2,7,6,6,10,5,17,-12,7.9,17.3,-9.4,20,SPA
283c7121,35,2316,25.7,24,19,11,3,29,34,-5,29.6,33.8,-4.3,20,SPA
293211e1,14,208,2.3,0,0,14,3,3,2,1,3.6,3.1,0.4,20,SPA
2946f9a1,6,439,4.9,4,4,2,8,5,2,3,5.8,4.8,1.0,20,SPA
29b61deb,30,1088,12.1,7,5,23,8,13,31,-18,12.0,24.0,-12.0,20,SPA
2a0c8ba4,34,2254,25.0,27,10,7,0,30,15,15,33.9,20.6,13.3,20,SPA
2a8c9f98,3,51,0.6,0,0,3,8,2,2,0,0.7,1.1,-0.5,20,SPA
2bef2bca,6,238,2.6,2,2,4,9,11,0,11,6.6,2.6,4.0,20,SPA
2e3406ae,23,1768,19.6,18,16,5,4,21,34,-13,21.5,36.1,-14.6,20,SPA
2e5e846d,5,204,2.3,3,0,2,5,4,1,3,3.4,2.6,0.8,20,SPA
2f965a72,4,360,4.0,4,4,0,31,10,5,5,6.8,4.5,2.3,20,SPA
3024e383,28,2360,26.2,27,24,1,4,26,37,-11,28.5,35.5,-7.1,20,SPA
307fcd26,4,360,4.0,4,4,0,34,11,8,3,9.5,6.4,3.0,20,SPA
31a1288d,8,181,2.0,2,0,6,5,5,0,5,3.6,1.8,1.7,20,SPA
32974271,35,2655,29.5,31,18,4,0,26,29,-3,29.7,42.2,-12.5,20,SPA
32c0491f,2,75,0.8,1,0,1,0,0,2,-2,1.3,2.0,-0.7,20,SPA
3353737a,31,2509,27.9,29,26,2,4,39,22,17,39.6,27.0,12.6,20,SPA
335fa267,30,2339,26.0,27,21,3,2,56,27,29,40.3,26.8,13.5,20,SPA
33a61a52,23,1848,20.5,20,19,3,9,34,31,3,28.5,33.4,-4.9,20,SPA
34e393f2,14,936,10.4,11,6,3,3,10,14,-4,11.6,12.9,-1.3,20,SPA
355c883a,31,2099,23.3,23,16,8,5,20,38,-18,22.7,36.4,-13.8,20,SPA
3594a357,2,29,0.3,0,0,2,8,1,1,0,0.6,0.2,0.4,20,SPA
360d70f8,35,2188,24.3,24,12,11,1,19,35,-16,22.8,38.1,-15.3,20,SPA
3624ce4c,36,2884,32.0,33,27,3,1,43,43,0,37.9,37.7,0.2,20,SPA
3672b352,1,10,0.1,0,0,1,7,0,0,0,0.1,0.1,0.0,20,SPA
36c5f77b,20,561,6.2,5,1,15,14,3,10,-7,6.1,7.0,-0.9,20,SPA
374ee424,25,2250,25.0,25,25,0,13,38,32,6,34.2,29.5,4.7,20,SPA
379652be,24,1115,12.4,12,2,12,10,8,18,-10,10.1,17.1,-7.0,20,SPA
37e103f8,12,378,4.2,4,0,8,5,3,8,-5,4.7,6.4,-1.7,20,SPA
37f04799,2,180,2.0,2,2,0,9,2,2,0,1.6,2.6,-1.0,20,SPA
37f1cf47,35,2872,31.9,32,26,3,0,35,32,3,37.8,38.5,-0.7,20,SPA
38126309,29,1690,18.8,22,5,7,9,20,32,-12,23.6,32.2,-8.6,20,SPA
38ce1150,3,59,0.7,0,0,3,2,1,0,1,0.7,0.7,0.0,20,SPA
3902e91b,25,1236,13.7,14,2,11,4,11,17,-6,15.5,24.8,-9.3,20,SPA
3a9c4b7b,30,2332,25.9,26,23,4,2,32,33,-1,33.3,30.5,2.8,20,SPA
3aa4a3be,36,2031,22.6,21,9,15,1,31,40,-9,33.7,32.3,1.4,20,SPA
3c05c659,18,877,9.7,9,4,9,1,10,12,-2,10.5,12.0,-1.4,20,SPA
3c16d927,22,1535,17.0,16,13,6,1,20,31,-11,16.4,27.4,-11.1,20,SPA
3c7bc9bd,26,2194,24.4,25,22,1,4,18,29,-11,23.2,25.7,-2.5,20,SPA
3cefcaef,25,1809,20.1,19,18,6,6,35,11,24,34.0,16.9,17.1,20,SPA
3d688b46,28,1499,16.7,18,6,10,3,18,22,-4,18.2,17.0,1.2,20,SPA
3da1b6ed,1,2,0.0,0,0,1,8,0,0,0,0.0,0.1,-0.1,20,SPA
3e016e5a,8,406,4.5,5,0,3,5,3,7,-4,3.8,5.8,-2.0,20,SPA
3e42f707,32,2793,31.0,31,31,1,2,38,48,-10,42.3,41.2,1.0,20,SPA
3e4f735d,1,6,0.1,0,0,1,5,0,0,0,0.0,0.2,-0.2,20,SPA
3ecc11d8,32,2810,31.2,32,31,0,4,36,27,9,35.4,38.4,-3.0,20,SPA
3ee0dd59,9,524,5.8,6,5,3,4,9,8,1,6.7,5.2,1.6,20,SPA
3eed9821,13,949,10.5,10,10,3,12,24,12,12,16.8,8.2,8.6,20,SPA
3f10bd22,38,3369,37.4,37,35,1,0,53,32,21,52.8,34.7,18.1,20,SPA
3f79a1c8,23,1674,18.6,18,14,5,2,20,31,-11,21.0,28.6,-7.6,20,SPA
3fc45c73,33,2970,33.0,33,33,0,2,38,32,6,38.5,41.5,-3.0,20,SPA
40449bbd,15,1119,12.4,11,11,4,8,11,16,-5,12.5,19.4,-6.9,20,SPA
407feb71,6,65,0.7,0,0,6,10,0,1,-1,0.4,1.3,-0.9,20,SPA
4112ace5,1,73,0.8,1,0,0,2,0,1,-1,0.4,0.6,-0.3,20,SPA
41521385,2,13,0.1,0,0,2,5,1,0,1,0.4,0.5,-0.1,20,SPA
418f8f61,29,2178,24.2,27,13,2,4,17,21,-4,21.3,32.6,-11.2,20,SPA
41b3069f,15,1043,11.6,12,9,3,13,8,21,-13,12.5,15.2,-2.7,20,SPA
41c12f75,24,1870,20.8,21,18,3,1,20,20,0,21.8,24.1,-2.3,20,SPA
41f32541,34,2659,29.5,30,27,4,0,41,28,13,42.2,26.4,15.8,20,SPA
4207e578,13,209,2.3,1,0,12,11,2,3,-1,3.4,2.8,0.6,20,SPA
42276181,29,1581,17.6,17,5,12,1,21,28,-7,20.4,26.6,-6.2,20,SPA
4242011c,26,2259,25.1,26,24,0,3,21,38,-17,24.8,35.1,-10.3,20,SPA
43f71e77,34,1886,21.0,23,5,11,2,20,19,1,19.6,21.5,-1.9,20,SPA
44150beb,1,77,0.9,1,0,0,9,1,1,0,0.8,1.0,-0.2,20,SPA
4442fbcd,30,1569,17.4,20,5,10,2,18,28,-10,20.5,29.3,-8.9,20,SPA
45af8a54,9,336,3.7,3,0,6,2,9,3,6,7.2,3.4,3.8,20,SPA
45d96179,6,495,5.5,5,5,1,8,4,7,-3,0.0,0.0,0.0,20,SPA
45e17712,17,1119,12.4,12,10,5,1,15,12,3,12.8,12.1,0.7,20,SPA
45e304c8,2,22,0.2,0,0,2,6,1,1,0,0.3,0.1,0.2,20,SPA
4601e194,27,2187,24.3,25,21,2,2,53,23,30,41.8,23.3,18.5,20,SPA
46166b49,6,109,1.2,0,0,6,1,2,2,0,1.4,2.5,-1.1,20,SPA
466824fb,29,2320,25.8,27,18,2,1,34,31,3,38.3,31.1,7.3,20,SPA
467bae22,31,1098,12.2,11,3,20,4,19,14,5,17.7,14.0,3.7,20,SPA
46a8347f,5,362,4.0,4,2,1,2,2,3,-1,3.1,3.2,-0.2,20,SPA
46bd3a5b,12,929,10.3,11,7,1,9,8,17,-9,9.7,13.4,-3.7,20,SPA
46e07328,26,1128,12.5,10,3,16,8,9,15,-6,12.0,14.9,-2.9000000000000004,20,SPA
4737cebe,24,1167,13.0,13,4,11,8,16,15,1,16.6,12.9,3.7,20,SPA
474ecac8,28,2374,26.4,27,25,1,5,36,34,2,35.6,43.1,-7.5,20,SPA
476ca810,4,195,2.2,2,2,2,1,2,4,-2,2.1,2.8,-0.7,20,SPA
487d9b09,12,641,7.1,7,5,5,20,8,11,-3,10.0,8.9,1.2,20,SPA
48b3dd60,21,1182,13.1,14,4,7,6,32,11,21,21.9,14.2,7.7,20,SPA
48e89655,3,56,0.6,0,0,3,1,1,3,-2,0.4,1.6,-1.2,20,SPA
4958bfb2,31,2738,30.4,31,29,0,2,59,18,41,57.4,25.7,31.6,20,SPA
49d028db,10,681,7.6,9,2,1,15,9,9,0,10.2,9.4,0.8,20,SPA
49ea92be,24,1442,16.0,21,4,3,1,22,14,8,17.5,20.1,-2.6,20,SPA
4a478107,38,2519,28.0,29,11,9,0,32,38,-6,31.9,49.6,-17.7,20,SPA
4a633cfe,8,536,6.0,6,5,2,8,5,11,-6,6.0,9.8,-3.7,20,SPA
4a895384,17,1446,16.1,16,15,1,13,20,14,6,16.8,18.3,-1.5,20,SPA
4accb7e0,31,2245,24.9,27,17,4,2,26,33,-7,29.3,31.7,-2.5,20,SPA
4bd414c1,36,3237,36.0,36,35,0,1,61,44,17,60.9,42.7,18.1,20,SPA
4c2e9442,33,2143,23.8,25,11,8,1,29,30,-1,23.8,31.6,-7.7,20,SPA
4c5b14d2,34,2060,22.9,25,5,9,1,32,33,-1,33.1,28.6,4.5,20,SPA
4cee5954,35,3144,34.9,35,34,0,1,34,42,-8,34.3,40.3,-6.0,20,SPA
4d1666ff,29,2309,25.7,25,24,4,8,39,22,17,34.8,24.2,10.6,20,SPA
4d224fe8,35,3088,34.3,35,32,0,1,67,22,45,61.1,28.5,32.6,20,SPA
4d8cd038,17,430,4.8,4,1,13,10,9,5,4,11.0,5.3,5.7,20,SPA
4dbd0916,22,925,10.3,10,1,12,8,9,8,1,14.5,6.1,8.3,20,SPA
4df0dff8,6,531,5.9,5,5,1,27,7,12,-5,7.1,7.3,-0.2,20,SPA
4e219ad2,17,785,8.7,8,1,9,0,16,10,6,13.6,10.0,3.6,20,SPA
4f28a6ff,28,2424,26.9,28,24,0,6,61,28,33,49.4,27.1,22.4,20,SPA
5083a734,30,2368,26.3,28,18,2,2,37,28,9,30.2,27.3,2.9,20,SPA
518f2234,1,15,0.2,0,0,1,8,1,0,1,0.1,0.0,0.1,20,SPA
51a3c4c8,25,2102,23.4,23,23,2,6,31,20,11,36.8,20.8,16.0,20,SPA
51e3954c,16,1277,14.2,15,11,1,13,16,21,-5,17.0,20.5,-3.5,20,SPA
529f49ab,35,2549,28.3,29,21,6,0,39,18,21,40.7,23.0,17.6,20,SPA
532e1e4f,34,2971,33.0,33,33,1,0,54,45,9,58.1,41.5,16.7,20,SPA
53ddba36,9,184,2.0,1,0,8,5,5,3,2,2.8,3.2,-0.4,20,SPA
54073b28,25,1570,17.4,18,10,7,7,9,23,-14,17.4,18.1,-0.7,20,SPA
545e2f01,6,338,3.8,3,3,3,7,5,10,-5,5.8,7.2,-1.4,20,SPA
55126f3b,32,2698,30.0,30,26,2,0,45,20,25,47.3,25.5,21.7,20,SPA
5512b1a9,11,990,11.0,11,11,0,27,5,18,-13,10.2,14.6,-4.4,20,SPA
555f3a0b,17,1217,13.5,15,10,2,14,17,9,8,22.3,11.0,11.3,20,SPA
57be54ec,19,531,5.9,5,0,14,2,5,10,-5,7.4,8.6,-1.1,20,SPA
58640e66,4,231,2.6,3,2,1,19,0,3,-3,2.3,1.6,0.6,20,SPA
58a3a572,2,126,1.4,1,0,1,3,3,3,0,1.8,1.7,0.1,20,SPA
58a9a4d9,28,1596,17.7,21,3,7,5,26,16,10,23.1,15.4,7.7,20,SPA
58afe001,35,3069,34.1,34,30,1,0,36,33,3,37.4,36.6,0.7,20,SPA
59b7d823,14,623,6.9,6,4,8,17,8,13,-5,6.2,12.9,-6.7,20,SPA
5a626448,37,2319,25.8,26,8,11,1,42,32,10,41.9,32.6,9.2,20,SPA
5ab0ea87,33,2483,27.6,29,16,4,3,68,29,39,49.3,27.2,22.1,20,SPA
5c4dc0ff,5,45,0.5,0,0,5,6,1,2,-1,1.5,0.6,0.9,20,SPA
5c7845f6,33,2640,29.3,29,26,4,4,45,39,6,36.5,36.4,0.1,20,SPA
5c96b017,30,2188,24.3,25,11,5,0,31,38,-7,35.6,34.5,1.1,20,SPA
5ca20b7a,30,2545,28.3,29,21,1,3,43,35,8,35.3,30.6,4.7,20,SPA
5ce0b5ba,3,216,2.4,3,2,0,1,2,3,-1,3.4,3.9,-0.4,20,SPA
5ceba7fc,18,993,11.0,11,2,7,1,19,15,4,23.6,16.2,7.4,20,SPA
5d5219b1,14,531,5.9,2,0,12,1,6,6,0,9.7,4.9,4.8,20,SPA
5dcf3e90,34,2991,33.2,34,33,0,1,38,29,9,34.6,43.6,-9.0,20,SPA
5eebbfdf,19,586,6.5,3,0,16,2,12,4,8,10.3,4.8,5.5,20,SPA
6025fab1,31,1996,22.2,22,10,9,1,45,14,31,39.3,19.0,20.2,20,SPA
603116a7,15,1296,14.4,15,12,0,9,28,13,15,28.1,12.3,15.8,20,SPA
60359288,8,497,5.5,6,4,2,7,4,7,-3,5.5,7.2,-1.7,20,SPA
605873e1,14,706,7.8,7,3,7,3,8,12,-4,7.2,8.9,-1.7,20,SPA
605eb473,36,3240,36.0,36,36,0,2,38,60,-22,39.7,60.6,-20.9,20,SPA
61220da2,37,3156,35.1,35,30,2,0,45,46,-1,44.3,57.4,-13.1,20,SPA
61b62b33,22,1218,13.5,15,3,7,5,12,17,-5,14.3,14.2,0.0,20,SPA
61bb7498,3,270,3.0,3,3,0,34,7,7,0,5.9,5.9,0.0,20,SPA
61bd33d0,29,1960,21.8,23,13,6,7,24,31,-7,24.7,33.5,-8.7,20,SPA
6265208f,36,2782,30.9,31,21,5,1,31,47,-16,36.1,45.6,-9.5,20,SPA
636eae97,23,1354,15.0,18,2,5,12,14,15,-1,16.6,19.1,-2.4,20,SPA
63f04c6c,21,1349,15.0,15,7,6,2,17,21,-4,18.4,23.4,-5.0,20,SPA
6435143e,1,4,0.0,0,0,1,0,0,0,0,0.0,0.0,0.0,20,SPA
64e8ed6d,34,2140,23.8,24,7,10,4,33,32,1,31.8,33.1,-1.3,20,SPA
65154df0,1,13,0.1,0,0,1,10,1,0,1,0.5,0.2,0.4,20,SPA
65d62814,1,25,0.3,0,0,1,37,0,0,0,0.7,0.1,0.6,20,SPA
6636496a,2,88,1.0,1,0,1,4,2,2,0,1.6,1.9,-0.3,20,SPA
6763373d,7,232,2.6,2,0,5,6,1,2,-1,1.2,2.4,-1.3,20,SPA
67669ce7,3,270,3.0,3,3,0,34,3,3,0,3.7,3.4,0.3,20,SPA
67cdbc0e,33,1671,18.6,16,8,17,3,48,18,30,37.4,18.3,19.1,20,SPA
6922f806,27,1811,20.1,20,10,7,1,19,34,-15,21.7,28.8,-7.0,20,SPA
697295b1,23,1777,19.7,21,16,2,11,21,21,0,22.9,24.3,-1.4,20,SPA
69cbc8b6,35,3060,34.0,35,33,0,0,38,37,1,36.2,37.400000000000006,-1.2000000000000002,20,SPA
6a99e0b1,38,2939,32.7,34,11,4,0,35,30,5,34.8,39.6,-4.9,20,SPA
6bb2c084,36,2583,28.7,28,21,8,1,46,37,9,45.4,32.8,12.7,20,SPA
6c811eb7,21,907,10.1,9,4,12,9,15,13,2,12.600000000000001,12.700000000000001,-0.10000000000000009,20,SPA
6ce1f46f,35,2652,29.5,31,22,4,2,45,17,28,48.8,24.7,24.1,20,SPA
6d8f8441,17,989,11.0,11,6,6,20,9,16,-7,12.7,18.8,-6.1,20,SPA
6dce77a5,8,242,2.7,3,0,5,7,4,4,0,5.0,3.5,1.5,20,SPA
6f51e382,36,3240,36.0,36,36,0,1,79,36,43,60.7,37.3,23.5,20,SPA
6f5f82c0,14,714,7.9,8,4,6,11,9,12,-3,9.5,11.8,-2.3,20,SPA
70d74ece,37,3141,34.9,36,21,1,1,63,22,41,60.5,30.6,29.9,20,SPA
70d8e84c,26,1997,22.2,21,19,5,8,17,31,-14,24.1,27.6,-3.4,20,SPA
70f8e0bd,37,3039,33.8,36,26,1,0,39,62,-23,36.1,58.4,-22.4,20,SPA
7111d552,29,1364,15.2,12,5,17,5,27,15,12,26.4,15.3,11.2,20,SPA
715bf047,8,419,4.7,5,2,3,10,7,3,4,8.8,2.5,6.3,20,SPA
719384c1,15,973,10.8,11,8,4,1,18,12,6,12.7,13.6,-0.9,20,SPA
71b47ab9,22,1487,16.5,17,7,5,0,19,23,-4,15.2,26.2,-10.9,20,SPA
72a99e38,27,787,8.7,5,1,22,6,13,18,-5,12.4,14.8,-2.5,20,SPA
72b07a9c,35,2943,32.7,33,32,2,2,26,40,-14,31.1,49.2,-18.2,20,SPA
7329018e,30,2253,25.0,25,17,5,3,23,42,-19,25.5,36.9,-11.4,20,SPA
73683fa9,36,3232,35.9,36,35,0,0,25,58,-33,35.7,50.1,-14.4,20,SPA
7460ca0d,35,3024,33.6,35,29,0,1,40,49,-9,38.0,50.3,-12.2,20,SPA
74dc806c,5,159,1.8,2,0,3,5,2,3,-1,0.7,2.1,-1.5,20,SPA
75645f0e,35,1922,21.4,21,8,14,1,27,30,-3,27.6,30.6,-3.0,20,SPA
75751c99,27,2429,27.0,27,26,0,1,25,33,-8,29.7,28.2,1.6,20,SPA
75bd85ea,35,2568,28.5,31,17,4,0,29,43,-14,32.7,44.5,-11.8,20,SPA
79135368,10,403,4.5,5,2,5,10,4,6,-2,2.8,5.6,-2.8,20,SPA
79300479,31,2527,28.1,29,22,2,3,42,35,7,38.7,33.0,5.7,20,SPA
7958dc65,11,372,4.1,5,0,6,10,3,5,-2,3.6,5.4,-1.8,20,SPA
7a538238,10,718,8.0,8,7,2,0,11,12,-1,9.0,10.3,-1.3,20,SPA
7b456af7,33,2925,32.5,33,32,0,0,44,31,13,44.4,31.0,13.4,20,SPA
7b5ab7f2,14,623,6.9,4,2,10,9,10,6,4,9.2,5.8,3.4,20,SPA
7c2965bb,5,134,1.5,2,0,3,17,4,4,0,2.3,2.1,0.1,20,SPA
7c363088,1,11,0.1,0,0,1,8,0,0,0,0.1,0.1,0.0,20,SPA
7c388b20,36,2505,27.8,28,15,8,1,27,28,-1,30.5,37.5,-7.1,20,SPA
7c4243d4,29,2012,22.4,22,9,7,4,23,31,-8,26.2,23.5,2.7,20,SPA
7dcf86f6,37,3262,36.2,37,30,0,0,35,48,-13,37.0,43.7,-6.7,20,SPA
7f203b54,4,309,3.4,3,3,1,9,2,4,-2,4.1,4.2,-0.1,20,SPA
7f4c7c9f,32,2432,27.0,27,24,5,2,40,38,2,36.3,46.2,-9.9,20,SPA
808d48f3,19,1389,15.4,15,10,4,14,20,17,3,19.6,22.3,-2.8,20,SPA
808df563,1,90,1.0,1,1,0,4,2,1,1,1.7,0.4,1.3,20,SPA
81069528,25,1871,20.8,21,14,4,6,19,25,-6,21.4,21.2,0.2,20,SPA
81a606fc,3,244,2.7,3,2,0,8,2,3,-1,2.1,3.5,-1.4,20,SPA
81d5c497,5,83,0.9,1,0,4,10,1,1,0,0.5,1.8,-1.3,20,SPA
81f0781e,35,2744,30.5,33,20,2,0,55,38,17,53.8,36.7,17.1,20,SPA
82e9b89d,19,1044,11.600000000000001,11,7,8,3,12,13,-1,13.2,12.899999999999999,0.3,20,SPA
833fb62e,24,1306,14.5,15,5,9,2,10,16,-6,15.1,20.7,-5.6,20,SPA
84399660,8,264,2.9,2,0,6,5,3,5,-2,4.0,5.3,-1.3,20,SPA
8455ad90,17,454,5.0,3,0,14,12,9,9,0,5.1,7.0,-1.8,20,SPA
84bba8b6,14,330,3.7,1,0,13,8,2,7,-5,4.8,6.7,-2.0,20,SPA
84f55b4a,1,4,0.0,0,0,1,0,0,0,0,0.1,0.4,-0.3,20,SPA
84fb6aff,19,1573,17.5,17,15,2,13,29,22,7,29.0,21.5,7.5,20,SPA
850c0a0d,24,2007,22.3,22,20,2,1,23,39,-16,24.3,33.4,-9.1,20,SPA
85dace26,1,6,0.1,0,0,1,11,0,0,0,0.2,0.0,0.2,20,SPA
868ce848,18,1447,16.1,16,13,2,14,17,19,-2,18.7,24.8,-6.0,20,SPA
8696bc90,21,1250,13.9,14,5,7,8,20,10,10,19.8,9.6,10.2,20,SPA
873619c6,2,25,0.3,0,0,2,3,0,1,-1,0.0,0.2,-0.2,20,SPA
873ce3a2,16,599,6.7,6,2,10,15,5,8,-3,6.7,8.4,-1.7,20,SPA
874d7a32,13,786,8.7,11,4,2,4,4,16,-12,6.8,14.5,-7.6,20,SPA
88050721,26,1787,19.9,24,6,2,6,23,19,4,20.7,24.1,-3.4,20,SPA
8875b8c9,2,180,2.0,2,2,0,18,5,4,1,3.0,1.6,1.4,20,SPA
88a359d4,26,1443,16.0,17,0,9,4,18,21,-3,22.9,20.1,2.8,20,SPA
88d91621,18,1147,12.7,14,8,4,9,14,20,-6,13.7,18.5,-4.8,20,SPA
88f130ed,2,77,0.9,1,0,1,7,3,0,3,1.7,2.1,-0.4,20,SPA
89151b16,17,1431,15.9,16,13,1,8,23,30,-7,21.9,24.4,-2.6,20,SPA
89cbc961,7,453,5.0,5,5,2,19,9,7,2,6.3,5.9,0.5,20,SPA
89f951b5,31,1589,17.7,16,6,15,5,31,15,16,31.0,19.4,11.6,20,SPA
8aafd64f,27,1745,19.4,21,4,6,0,22,7,15,30.6,14.9,15.7,20,SPA
8b625720,6,238,2.6,2,1,4,14,3,5,-2,3.1,5.2,-2.1,20,SPA
8c3c640c,37,3051,33.9,36,22,1,1,50,45,5,43.8,38.5,5.3,20,SPA
8cfc2f69,32,1407,15.6,9,6,23,4,23,23,0,20.5,21.3,-0.8,20,SPA
8d47bb39,26,2205,24.5,25,19,1,9,37,28,9,30.6,28.1,2.5,20,SPA
8db394aa,23,1903,21.1,22,18,1,2,21,30,-9,24.6,28.7,-4.0,20,SPA
8dc6dbb3,2,21,0.2,0,0,2,7,0,0,0,0.2,0.5,-0.3,20,SPA
8e010ff4,16,376,4.2,3,1,13,12,5,4,1,3.7,5.8,-2.1,20,SPA
8e049cbd,20,1191,13.2,13,10,7,13,13,19,-6,16.3,14.5,1.9,20,SPA
8e088e04,8,470,5.2,6,2,2,4,8,8,0,6.3,6.9,-0.5,20,SPA
8e48dc61,14,939,10.4,11,6,3,11,17,16,1,15.5,14.4,1.1,20,SPA
8e92be30,37,1507,16.7,14,1,23,1,25,21,4,24.5,21.8,2.6,20,SPA
8ef81d2d,5,311,3.5,3,3,2,3,2,8,-6,3.4,7.2,-3.9,20,SPA
8f29e08b,2,180,2.0,2,2,0,17,5,3,2,3.4,3.0,0.4,20,SPA
8f3565b3,35,2765,30.7,33,15,2,0,38,53,-15,35.0,51.1,-16.2,20,SPA
8f5e92a6,19,1019,11.3,12,1,7,9,21,2,19,22.9,7.4,15.5,20,SPA
8f898ba8,24,1213,13.5,13,8,11,2,11,18,-7,15.4,13.8,1.6,20,SPA
8f8c6934,38,3420,38.0,38,38,0,0,43,37,6,41.6,41.4,0.2,20,SPA
8fae77ea,35,3150,35.0,35,35,0,3,29,39,-10,33.1,50.1,-17.0,20,SPA
8fc259d7,6,150,1.7,1,0,5,17,0,4,-4,1.4,3.1,-1.7,20,SPA
9038c2a1,20,1175,13.1,14,1,6,9,17,15,2,13.9,12.9,1.1,20,SPA
904cd50d,1,73,0.8,1,0,0,3,2,3,-1,1.2,2.2,-1.0,20,SPA
9109185e,5,425,4.7,4,4,1,33,3,9,-6,6.9,5.2,1.7,20,SPA
9260926b,10,770,8.6,9,5,1,5,6,10,-4,8.3,8.2,0.1,20,SPA
92d38e6c,24,1918,21.3,23,18,1,3,17,27,-10,23.0,22.9,0.1,20,SPA
93090f69,36,3087,34.3,34,32,2,1,46,40,6,37.8,38.9,-1.1,20,SPA
933e8c8a,26,2227,24.7,26,22,0,8,24,20,4,24.8,32.2,-7.4,20,SPA
949c3655,1,4,0.0,0,0,1,2,0,0,0,0.0,0.1,-0.1,20,SPA
963829d0,29,1547,17.2,17,9,12,7,30,20,10,27.7,22.8,4.9,20,SPA
967f34d3,33,2960,32.9,33,32,0,0,31,43,-12,33.1,40.3,-7.2,20,SPA
97572117,34,2422,26.9,31,13,3,0,28,28,0,26.8,30.3,-3.5,20,SPA
97852360,27,2358,26.2,27,26,0,2,26,37,-11,27.8,39.4,-11.6,20,SPA
9939e168,27,1496,16.6,15,10,12,5,20,22,-2,16.7,21.1,-4.4,20,SPA
9970da54,3,270,3.0,3,3,0,16,4,3,1,4.8,2.5,2.3,20,SPA
999908af,16,1283,14.3,15,9,1,0,14,24,-10,13.5,24.1,-10.6,20,SPA
99bebd12,5,96,1.1,1,0,4,8,0,2,-2,0.4,2.9,-2.5,20,SPA
9a64e67e,31,2394,26.6,25,24,6,5,37,30,7,33.2,28.6,4.6,20,SPA
9ab48bde,30,1604,17.8,15,14,15,7,21,31,-10,20.9,26.8,-5.8,20,SPA
9d2a3d5f,17,695,7.7,6,2,11,17,7,7,0,12.1,8.7,3.4,20,SPA
9d66fbe3,33,2347,26.1,30,13,3,3,34,33,1,30.1,29.9,0.2,20,SPA
9dfdbdeb,1,4,0.0,0,0,1,0,0,1,-1,0.0,0.1,-0.1,20,SPA
9e098912,1,4,0.0,0,0,1,10,0,0,0,0.0,0.1,-0.1,20,SPA
9e1035f8,34,2251,25.0,26,11,8,3,27,30,-3,28.9,38.8,-9.9,20,SPA
9f0ea33f,34,3060,34.0,34,34,0,4,52,41,11,54.1,39.9,14.2,20,SPA
9f323c71,13,541,6.0,6,2,7,4,4,6,-2,4.7,8.0,-3.3,20,SPA
9f8e9423,32,2822,31.4,32,31,0,4,62,21,41,56.2,29.4,26.8,20,SPA
a01c3d54,36,3240,36.0,36,36,0,2,43,51,-8,44.2,59.9,-15.7,20,SPA
a0255c67,9,253,2.8,3,0,6,10,5,3,2,4.5,4.7,-0.2,20,SPA
a03c82b2,14,951,10.6,12,9,2,8,9,17,-8,10.2,14.0,-3.7,20,SPA
a08b974a,33,2745,30.5,31,18,2,0,45,24,21,43.5,28.5,15.0,20,SPA
a0b4bb3e,23,1181,13.1,15,1,8,7,15,8,7,17.7,12.8,5.0,20,SPA
a190d597,23,1350,15.0,14,6,9,0,22,9,13,20.7,14.7,5.9,20,SPA
a2609621,18,1332,14.8,15,12,3,8,10,23,-13,17.6,19.5,-1.8,20,SPA
a300ac7e,34,2496,27.7,29,18,5,1,25,45,-20,30.9,42.3,-11.4,20,SPA
a35134ae,12,814,9.0,9,8,3,9,4,17,-13,7.1,15.1,-7.9,20,SPA
a39bb753,16,1077,12.0,14,3,2,3,27,5,22,25.5,8.6,16.9,20,SPA
a4971d84,34,3060,34.0,34,34,0,0,37,34,3,35.5,37.7,-2.1,20,SPA
a4995f48,19,1655,18.4,18,17,1,16,19,27,-8,19.9,25.1,-5.2,20,SPA
a55d8df5,25,1220,13.6,13,5,12,9,10,13,-3,16.5,14.9,1.6,20,SPA
a58bb1e1,16,1089,12.1,12,5,4,10,21,9,12,18.2,13.5,4.7,20,SPA
a5cdedc7,1,2,0.0,0,0,1,12,0,0,0,0.0,0.1,-0.1,20,SPA
a6154613,28,1998,22.2,22,14,6,0,54,18,36,36.5,23.9,12.6,20,SPA
a685f013,4,300,3.3,3,3,1,4,2,7,-5,2.7,3.9,-1.2,20,SPA
a6951bf8,26,1905,21.2,21,13,5,2,29,27,2,26.6,30.0,-3.5,20,SPA
a6de370d,36,3163,35.1,36,32,0,0,43,57,-14,46.8,51.6,-4.7,20,SPA
a7a9d95a,13,924,10.3,11,3,2,1,14,13,1,14.8,11.0,3.8,20,SPA
a83d8b0c,30,889,9.9,7,1,23,7,20,12,8,16.7,10.7,6.0,20,SPA
a8542814,21,1123,12.5,12,6,9,12,16,7,9,21.2,8.6,12.5,20,SPA
a8f21b9f,10,476,5.3,5,2,5,6,14,10,4,9.6,6.5,3.1,20,SPA
a8fbae1d,26,2090,23.2,23,21,3,8,25,31,-6,26.5,27.9,-1.4,20,SPA
a9dc785c,2,180,2.0,2,2,0,29,7,2,5,5.6,1.0,4.6,20,SPA
aa0ac32d,8,485,5.4,5,3,3,18,6,13,-7,7.5,11.7,-4.3,20,SPA
aad53e64,8,313,3.5,4,0,4,2,6,4,2,4.6,3.0,1.5,20,SPA
aae17c81,1,26,0.3,0,0,1,9,1,1,0,1.3,0.8,0.5,20,SPA
ab99e4a0,3,152,1.7,1,1,2,6,1,3,-2,1.4,3.1,-1.6,20,SPA
abb3bb95,35,2059,22.9,24,11,11,3,36,18,18,34.6,20.1,14.5,20,SPA
ac295d9e,35,3150,35.0,35,35,0,3,33,51,-18,36.0,47.0,-11.0,20,SPA
ac3fb1be,17,1437,16.0,17,15,0,2,24,19,5,23.7,23.3,0.4,20,SPA
ad178594,9,711,7.9,8,7,1,13,9,11,-2,8.7,10.0,-1.3,20,SPA
ad1ffcfd,34,2648,29.4,33,18,1,0,48,39,9,49.4,34.1,15.3,20,SPA
ad4d0985,25,1688,18.8,20,12,5,7,13,31,-18,18.0,26.0,-8.0,20,SPA
adfc9123,35,3092,34.4,35,31,0,0,71,36,35,57.1,36.4,20.8,20,SPA
aec0fb6f,20,815,9.1,11,1,9,13,1,11,-10,6.7,7.5,-0.8,20,SPA
aed746df,16,864,9.6,10,4,6,0,5,18,-13,6.5,14.5,-8.0,20,SPA
af245161,1,90,1.0,1,1,0,22,2,7,-5,0.7,2.0,-1.3,20,SPA
b037bd4f,11,394,4.4,3,1,8,7,4,3,1,5.9,5.2,0.8,20,SPA
b05e2dbd,24,1988,22.1,23,21,1,1,25,33,-8,22.9,32.5,-9.7,20,SPA
b0616e3d,11,773,8.6,8,6,3,20,13,11,2,12.0,8.8,3.2,20,SPA
b0fce72c,20,1269,14.1,13,10,7,5,12,16,-4,13.0,20.7,-7.7,20,SPA
b14d0c5d,14,1175,13.1,14,11,0,10,14,25,-11,14.9,19.5,-4.6,20,SPA
b19db005,5,357,4.0,3,2,2,0,8,2,6,5.4,3.8,1.6,20,SPA
b233e8e4,18,1529,17.0,17,16,1,0,17,16,1,15.3,19.0,-3.7,20,SPA
b2d03887,17,1293,14.4,15,6,2,2,11,20,-9,15.3,20.1,-4.8,20,SPA
b2d0ec1b,22,1222,13.6,13,3,9,6,18,15,3,18.1,10.3,7.8,20,SPA
b333b014,1,22,0.2,0,0,1,6,0,0,0,0.1,0.2,-0.1,20,SPA
b35db3f6,13,790,8.8,9,3,4,3,9,11,-2,10.8,6.3,4.6,20,SPA
b39a793e,16,574,6.4,5,1,11,0,5,9,-4,6.3,9.5,-3.2,20,SPA
b418dbd4,35,2869,31.9,33,22,2,0,32,25,7,33.3,38.4,-5.1,20,SPA
b4a014b1,35,3134,34.8,35,34,0,2,49,31,18,48.2,32.8,15.4,20,SPA
b579e83d,10,572,6.4,6,1,4,0,7,6,1,7.4,5.8,1.6,20,SPA
b5bdf144,2,180,2.0,2,2,0,9,2,0,2,2.9,0.8,2.2,20,SPA
b5dd3469,26,1993,22.1,22,17,4,2,33,33,0,29.3,36.7,-7.4,20,SPA
b6e50615,33,2850,31.7,32,29,1,0,36,29,7,35.7,39.6,-3.9,20,SPA
b742cc0d,30,2524,28.0,29,25,1,6,32,48,-16,36.3,43.6,-7.3,20,SPA
b7c99b9b,31,2654,29.5,31,27,0,2,27,44,-17,32.6,44.6,-12.0,20,SPA
b7ca5c51,33,2801,31.1,31,28,2,2,39,45,-6,34.5,45.9,-11.5,20,SPA
b7de5bad,18,1270,14.1,14,12,4,6,8,25,-17,11.5,20.7,-9.2,20,SPA
b7f2edff,12,852,9.5,9,7,3,7,3,18,-15,6.4,17.6,-11.2,20,SPA
b857bd29,32,2775,30.8,32,28,0,0,33,50,-17,36.6,53.2,-16.6,20,SPA
b86a64b2,20,1659,18.4,19,16,1,8,16,22,-6,17.7,23.0,-5.3,20,SPA
b8a642fc,37,2048,22.8,20,10,17,0,36,35,1,39.7,29.1,10.6,20,SPA
b8c1de25,19,1506,16.7,17,12,2,3,19,21,-2,20.8,20.8,0.0,20,SPA
b92b456a,19,705,7.8,9,0,10,10,11,16,-5,8.3,12.5,-4.2,20,SPA
ba3ca78f,9,790,8.8,8,8,1,5,4,19,-15,6.7,16.0,-9.3,20,SPA
ba5004e1,30,2592,28.8,30,24,0,2,37,26,11,33.6,30.0,3.6,20,SPA
ba5a9545,25,1017,11.3,9,1,16,8,5,14,-9,6.9,16.6,-9.6,20,SPA
bad38a94,30,2492,27.7,28,24,2,5,19,41,-22,28.2,39.0,-10.8,20,SPA
bb4a42be,4,82,0.9,0,0,4,7,1,3,-2,1.3,1.3,0.0,20,SPA
bb4b1242,30,1865,20.7,21,7,9,1,18,28,-10,21.3,28.3,-6.9,20,SPA
bba30585,29,2327,25.9,27,22,2,2,37,32,5,33.0,26.4,6.5,20,SPA
bc61cc65,22,1082,12.0,11,8,11,6,13,23,-10,13.6,15.2,-1.5,20,SPA
bc6f5f06,13,717,8.0,8,6,5,8,12,9,3,10.7,8.4,2.2,20,SPA
bd3b9a9f,9,473,5.3,4,4,5,24,5,14,-9,2.8,7.9,-5.1,20,SPA
bdb624a3,17,741,8.2,9,0,8,4,11,6,5,9.0,10.3,-1.3,20,SPA
be170419,20,1572,17.5,16,16,4,17,12,22,-10,12.6,25.3,-12.7,20,SPA
bece776f,32,2638,29.3,31,19,1,0,33,49,-16,38.2,42.3,-4.1,20,SPA
bf12926c,15,348,3.9,2,0,13,14,10,8,2,5.8,5.0,0.8,20,SPA
bfb15d99,2,180,2.0,2,2,0,14,4,2,2,3.9,3.0,0.9,20,SPA
bfca375c,7,371,4.1,5,3,2,13,4,7,-3,4.2,6.4,-2.1,20,SPA
bfd381b3,36,2903,32.3,35,21,1,1,37,55,-18,34.1,52.6,-18.5,20,SPA
c00097d2,4,191,2.1,2,2,2,7,3,4,-1,2.7,2.9,-0.3,20,SPA
c010b898,5,450,5.0,5,5,0,4,4,12,-8,4.3,10.4,-6.1,20,SPA
c05dfb74,31,2382,26.5,26,13,5,0,30,29,1,30.0,33.1,-3.1,20,SPA
c14bc029,35,3072,34.1,35,31,0,1,45,25,20,50.7,30.1,20.7,20,SPA
c2111b45,11,629,7.0,7,6,4,4,10,6,4,6.8,8.4,-1.6,20,SPA
c2846353,4,219,2.4,3,1,1,15,2,4,-2,3.3,3.7,-0.4,20,SPA
c33ee247,10,240,2.7,2,0,8,8,6,4,2,5.5,3.2,2.3,20,SPA
c4b8bcf4,30,1301,14.5,13,3,17,5,16,24,-8,15.4,19.6,-4.2,20,SPA
c67cd65c,29,2610,29.0,29,29,0,1,36,38,-2,34.9,45.6,-10.7,20,SPA
c693cf7c,7,226,2.5,2,1,5,9,3,6,-3,3.8,2.5,1.3,20,SPA
c7429db3,14,537,6.0,5,0,9,5,7,9,-2,7.3,7.2,0.1,20,SPA
c77a8043,36,2563,28.5,27,19,9,0,43,31,12,33.5,34.7,-1.2,20,SPA
c78b352d,4,259,2.9,3,2,1,21,5,6,-1,3.6,5.8,-2.2,20,SPA
c90977db,29,2390,26.6,28,19,1,0,28,46,-18,28.4,38.6,-10.2,20,SPA
c93231dc,11,189,2.1,1,0,10,1,4,8,-4,2.1,6.2,-4.1,20,SPA
c966fce1,15,490,5.4,4,2,11,15,7,8,-1,7.0,8.3,-1.3,20,SPA
c9cb972b,15,1324,14.7,14,14,1,23,19,23,-4,17.0,22.1,-5.1,20,SPA
c9e39d91,31,1477,16.4,15,4,16,5,18,25,-7,15.4,20.1,-4.7,20,SPA
ca6edaa0,1,8,0.1,0,0,1,9,0,0,0,0.1,0.1,0.0,20,SPA
cac2537b,30,2114,23.5,23,16,7,2,35,34,1,31.1,36.9,-5.8,20,SPA
cb574619,27,1965,21.8,22,19,5,4,14,25,-11,18.1,23.5,-5.3,20,SPA
cbbfa2e7,14,743,8.3,10,1,4,0,13,8,5,8.1,9.4,-1.4,20,SPA
cbdf7d5c,1,8,0.1,0,0,1,1,0,0,0,0.5,0.1,0.5,20,SPA
cca05da8,1,13,0.1,0,0,1,1,0,1,-1,0.9,0.4,0.4,20,SPA
ccaa5728,21,878,9.8,9,2,12,8,9,14,-5,7.5,14.3,-6.8,20,SPA
cce181df,27,1807,20.1,21,15,6,5,21,30,-9,20.3,28.0,-7.7,20,SPA
cda0b317,33,2887,32.1,33,32,0,4,41,48,-7,43.9,47.5,-3.6,20,SPA
cde52ef5,4,280,3.1,3,3,1,10,3,5,-2,3.1,3.5,-0.4,20,SPA
ce8039aa,6,182,2.0,2,0,4,3,1,0,1,1.8,0.6,1.2,20,SPA
ce82f116,21,1024,11.4,10,5,11,10,6,17,-11,13.0,13.6,-0.7,20,SPA
ced26057,3,15,0.2,0,0,3,11,1,0,1,1.5,0.6,0.9,20,SPA
d04b94db,32,2097,23.3,24,18,8,3,49,25,24,41.3,23.8,17.6,20,SPA
d080ed5e,36,3139,34.9,35,30,1,0,52,43,9,46.3,39.1,7.2,20,SPA
d166c007,1,5,0.1,0,0,1,8,0,1,-1,0.0,0.1,-0.1,20,SPA
d1b060e2,20,279,3.1,0,0,20,10,1,7,-6,4.9,6.6,-1.7,20,SPA
d2110326,21,1444,16.0,15,14,6,10,20,23,-3,20.0,24.6,-4.6,20,SPA
d2aea9ac,2,6,0.1,0,0,2,17,0,0,0,0.4,0.0,0.4,20,SPA
d2be40f2,7,457,5.1,6,3,1,4,5,12,-7,4.0,7.5,-3.6,20,SPA
d2ed99b4,1,2,0.0,0,0,1,4,1,0,1,0.9,0.0,0.9,20,SPA
d38fdf53,36,2979,33.1,32,30,4,1,41,48,-7,43.4,43.9,-0.5,20,SPA
d4cb83cc,29,2390,26.6,27,23,2,4,43,32,11,35.2,28.0,7.2,20,SPA
d4ef9ac5,20,1589,17.7,18,15,2,9,14,23,-9,20.6,30.1,-9.5,20,SPA
d66b9872,31,1896,21.1,23,5,8,6,21,28,-7,23.7,26.5,-2.8,20,SPA
d70a3661,1,6,0.1,0,0,1,5,0,0,0,0.1,0.1,0.1,20,SPA
d70ce98e,33,2880,32.0,32,31,1,0,72,30,42,58.2,32.0,26.2,20,SPA
d717630e,5,194,2.2,2,1,3,4,3,5,-2,1.9,3.8,-1.9,20,SPA
d733aa38,36,2717,30.2,31,20,5,2,35,40,-5,41.0,39.5,1.5,20,SPA
d83bbc54,35,2733,30.4,30,27,5,2,38,41,-3,36.1,45.2,-9.1,20,SPA
d87e2cae,37,2011,22.3,24,5,13,0,32,28,4,27.4,25.1,2.3,20,SPA
d9764034,1,90,1.0,1,1,0,0,1,0,1,0.5,1.1,-0.6,20,SPA
d9bda115,5,157,1.7,2,0,3,14,2,3,-1,1.3,1.7,-0.4,20,SPA
da27e268,35,3008,33.4,35,24,0,0,22,52,-30,29.9,45.9,-16.0,20,SPA
db750822,28,1227,13.6,11,2,17,5,16,10,6,17.3,11.0,6.3,20,SPA
db8f0eba,18,1371,15.2,17,6,1,0,11,18,-7,14.8,18.6,-3.8,20,SPA
dbe519cf,15,1029,11.4,11,9,4,12,10,13,-3,10.1,15.0,-4.9,20,SPA
de39485a,15,631,7.0,6,0,9,1,12,6,6,10.1,8.5,1.6,20,SPA
de7d40d6,3,258,2.9,3,2,0,4,2,7,-5,3.1,4.5,-1.3,20,SPA
dee86451,13,892,9.9,11,7,2,4,17,24,-7,15.4,16.5,-1.1,20,SPA
df69b544,35,2549,28.3,31,15,4,1,61,29,32,45.0,27.1,17.9,20,SPA
df8b52a5,33,2839,31.5,32,29,1,1,39,49,-10,40.1,46.0,-5.8,20,SPA
e08647d6,34,2201,24.5,21,15,13,2,39,25,14,31.2,26.6,4.7,20,SPA
e1c805cf,1,15,0.2,0,0,1,8,1,1,0,0.4,0.2,0.2,20,SPA
e1cbb531,17,1383,15.4,17,9,0,1,11,23,-12,16.7,19.7,-2.9,20,SPA
e1deea75,11,847,9.4,10,7,1,1,10,9,1,14.0,7.8,6.2,20,SPA
e288d4b3,12,752,8.4,9,3,3,3,4,8,-4,6.1,9.7,-3.6,20,SPA
e29d1111,23,1893,21.0,21,18,2,6,19,21,-2,23.6,27.8,-4.2,20,SPA
e2e9c250,35,2450,27.2,29,14,6,0,45,39,6,47.8,32.2,15.6,20,SPA
e3fabb0a,33,1719,19.1,21,4,12,5,14,27,-13,19.5,25.0,-5.5,20,SPA
e4086af3,2,108,1.2,2,1,0,0,0,1,-1,2.2,1.6,0.6,20,SPA
e49ce451,26,1973,21.9,24,17,2,6,23,28,-5,21.3,28.9,-7.6,20,SPA
e54bd0a2,20,1344,14.9,17,7,3,2,11,13,-2,14.7,15.9,-1.3,20,SPA
e61bdd69,12,356,4.0,3,1,9,2,8,2,6,6.5,2.9,3.6,20,SPA
e6bc67d7,21,1266,14.1,14,7,7,3,15,22,-7,16.3,17.7,-1.3,20,SPA
e7ab4179,15,1076,12.0,12,9,3,11,9,12,-3,14.0,17.1,-3.0999999999999996,20,SPA
e82d2807,12,364,4.0,4,1,8,7,5,6,-1,4.0,7.6,-3.6,20,SPA
e897d8ba,27,1767,19.6,20,6,7,5,17,27,-10,21.7,24.8,-3.1,20,SPA
e9ada8cf,1,90,1.0,1,1,0,3,0,6,-6,0.2,2.9,-2.7,20,SPA
ea610f00,5,173,1.9,2,1,3,12,0,1,-1,1.2,1.5,-0.3,20,SPA
ea83bfa6,35,3150,35.0,35,35,0,1,49,42,7,41.2,39.1,2.0,20,SPA
ea9b2ef9,28,2293,25.5,26,22,2,1,40,30,10,32.5,27.8,4.8,20,SPA
eac044ad,2,26,0.3,0,0,2,2,0,0,0,0.7,0.2,0.5,20,SPA
eb3dd471,28,1634,18.2,19,4,9,4,16,22,-6,19.2,24.2,-5.1,20,SPA
ec7c84c2,1,52,0.6,1,0,0,3,0,2,-2,0.1,0.4,-0.3,20,SPA
ecc77652,5,33,0.4,0,0,5,6,2,1,1,1.7,2.2,-0.5,20,SPA
ecd8c01e,28,1875,20.8,22,5,6,2,23,31,-8,22.4,31.1,-8.7,20,SPA
ed5c5fa3,28,1830,20.3,22,11,6,6,19,22,-3,20.8,22.4,-1.7,20,SPA
ed6ea4d9,36,2129,23.7,20,7,16,1,36,30,6,30.6,27.2,3.4,20,SPA
ed9f7cfe,32,2396,26.6,28,21,4,3,37,21,16,35.8,22.0,13.8,20,SPA
ee8508c0,38,3395,37.7,38,37,0,0,51,27,24,56.1,32.4,23.8,20,SPA
ee923664,17,1325,14.7,16,8,1,11,20,20,0,20.4,18.9,1.5,20,SPA
ef322658,28,2046,22.7,25,11,3,3,31,28,3,34.2,31.0,3.2,20,SPA
efecd633,25,1751,19.5,20,14,5,7,14,20,-6,18.1,30.5,-12.4,20,SPA
f03f284b,32,2455,27.3,29,19,3,0,18,40,-22,27.4,36.5,-9.1,20,SPA
f090a37a,11,510,5.7,5,2,6,4,14,5,9,12.0,5.6,6.4,20,SPA
f0da930c,21,1755,19.5,19,19,2,3,29,13,16,30.5,17.3,13.1,20,SPA
f11fe861,8,636,7.1,7,7,1,10,4,9,-5,5.5,11.2,-5.699999999999999,20,SPA
f1bed920,27,1937,21.6,22,15,5,7,20,25,-5,23.5,22.599999999999998,0.8999999999999999,20,SPA
f20fce1b,3,75,0.8,0,0,3,6,1,2,-1,0.9,1.6,-0.6,20,SPA
f2308b33,33,2785,30.9,32,28,1,2,22,45,-23,31.3,36.2,-4.9,20,SPA
f2c6ac01,36,3182,35.4,36,33,0,0,40,59,-19,38.4,58.2,-19.9,20,SPA
f3112790,33,2684,29.8,31,22,2,1,20,41,-21,27.5,32.4,-4.9,20,SPA
f3b1d9a2,7,66,0.7,0,0,7,11,0,2,-2,1.4,2.3,-0.9,20,SPA
f520049f,8,673,7.5,8,6,0,10,7,14,-7,5.5,11.7,-6.2,20,SPA
f631c17f,31,1429,15.9,14,6,17,2,13,22,-9,16.0,26.9,-10.8,20,SPA
f6798fc3,6,495,5.5,5,5,1,27,10,3,7,8.8,4.3,4.5,20,SPA
f681a8ef,18,876,9.7,11,1,7,3,14,14,0,11.7,10.0,1.6,20,SPA
f6ac68c1,22,1980,22.0,22,22,0,3,28,15,13,28.6,18.4,10.2,20,SPA
f76fdcd2,3,166,1.8,2,1,1,4,1,3,-2,2.3,3.9,-1.5,20,SPA
f7dc2ae5,22,1510,16.8,17,13,5,0,27,21,6,22.3,17.4,4.9,20,SPA
f814eccb,4,115,1.3,2,0,2,3,1,3,-2,1.6,1.3,0.3,20,SPA
f8eca1b6,35,2344,26.0,23,17,12,1,27,31,-4,27.3,39.0,-11.6,20,SPA
f9acf8bf,19,1360,15.1,16,12,3,8,13,29,-16,16.3,27.8,-11.5,20,SPA
f9b42381,1,90,1.0,1,1,0,13,2,2,0,0.8,0.9,-0.1,20,SPA
fa937f7a,33,2475,27.5,28,16,5,2,34,29,5,37.1,28.2,8.9,20,SPA
fb5d47b3,25,1962,21.8,22,20,3,12,36,28,8,37.4,28.1,9.3,20,SPA
fbd6378b,29,2576,28.6,29,27,0,6,35,35,0,39.9,39.7,0.2,20,SPA
fd47b4f2,25,2121,23.6,24,19,1,5,18,32,-14,22.9,33.4,-10.6,20,SPA
fd51b456,18,848,9.4,8,6,10,4,23,10,13,19.7,9.5,10.2,20,SPA
fd771f95,35,2341,26.0,25,18,10,3,24,35,-11,31.6,31.5,0.20000000000000018,20,SPA
fd9c4805,21,891,9.9,8,2,13,7,13,14,-1,10.6,11.6,-1.0,20,SPA
fdd60087,14,1076,12.0,11,9,3,18,19,9,10,18.0,12.4,5.6,20,SPA
fed17f5a,28,2066,23.0,24,12,4,1,26,31,-5,23.5,32.6,-9.1,20,SPA
ff8f26ef,3,130,1.4,2,0,1,14,0,4,-4,1.0,2.3,-1.3,20,SPA
ffacd3d5,5,325,3.6,4,2,1,10,5,0,5,6.5,3.0,3.5,20,SPA
ffad706e,17,1384,15.4,16,12,1,14,17,22,-5,18.8,21.3,-2.4,20,SPA
00672021,6,494,5.5,6,3,0,0,5,11,-6,6.7,11.8,-5.1,20,CL
0127419a,5,143,1.6,1,0,4,1,2,2,0,2.8,5.8,-2.9,20,CL
016ff750,4,104,1.2,0,0,4,1,3,3,0,2.2,3.3,-1.1,20,CL
01b8a2b2,7,630,7.0,7,7,0,1,12,6,6,11.1,8.6,2.5,20,CL
01eb744d,8,444,4.9,5,0,3,0,7,5,2,7.4,6.2,1.1,20,CL
028e70b9,1,5,0.1,0,0,1,4,0,0,0,0.1,0.6,-0.5,20,CL
02c15616,4,210,2.3,1,1,3,4,4,3,1,2.2,4.1,-1.9,20,CL
02ef8778,4,122,1.4,1,1,3,1,3,4,-1,2.8,2.4,0.4,20,CL
032f894e,5,124,1.4,1,0,4,0,0,7,-7,2.5,2.7,-0.2,20,CL
0331786b,1,4,0.0,0,0,1,2,0,0,0,0.2,0.2,0.0,20,CL
03998238,1,1,0.0,0,0,1,1,0,0,0,0.0,0.0,0.0,20,CL
03df04ff,6,540,6.0,6,6,0,0,10,11,-1,8.1,9.4,-1.3,20,CL
042e8a49,9,549,6.1,7,2,2,1,23,3,20,20.3,4.6,15.7,20,CL
048a1cbc,8,550,6.1,6,6,2,0,7,8,-1,11.1,10.3,0.8,20,CL
04989945,1,1,0.0,0,0,1,1,0,0,0,0.0,0.0,0.0,20,CL
04ac8285,6,540,6.0,6,6,0,1,11,11,0,11.1,12.7,-1.6,20,CL
05439de2,8,675,7.5,8,7,0,0,26,6,20,22.6,7.6,15.0,20,CL
05d548d8,8,720,8.0,8,8,0,0,10,11,-1,14.4,13.1,1.4,20,CL
0638becf,1,1,0.0,0,0,1,5,0,0,0,0.0,0.0,0.0,20,CL
070ec0b1,6,539,6.0,6,5,0,0,5,9,-4,6.7,6.8,-0.1,20,CL
07a821e4,1,90,1.0,1,1,0,0,6,2,4,4.3,0.7,3.5,20,CL
08511d65,5,445,4.9,5,4,0,0,12,6,6,13.9,8.7,5.2,20,CL
089550f5,3,259,2.9,3,2,0,0,3,3,0,3.3,2.8,0.5,20,CL
0959c2a2,6,348,3.9,4,2,2,1,10,2,8,10.7,6.4,4.3,20,CL
0a6dbbf7,5,450,5.0,5,5,0,1,4,12,-8,5.7,9.8,-4.1,20,CL
0ab1f153,6,497,5.5,6,3,0,1,11,5,6,8.3,7.6,0.7,20,CL
0ac94a23,6,263,2.9,3,0,3,0,3,2,1,3.4,5.5,-2.1,20,CL
0b5a292a,7,527,5.9,7,5,0,0,10,6,4,11.6,7.7,4.0,20,CL
0ba976e4,5,115,1.3,1,0,4,3,1,3,-2,1.5,3.3,-1.8,20,CL
0bc4e720,2,74,0.8,0,0,2,3,4,0,4,1.4,1.2,0.2,20,CL
0c3f7197,4,110,1.2,1,0,3,1,0,4,-4,0.6,2.5,-1.9,20,CL
0cb29e91,5,302,3.4,3,2,2,1,2,11,-9,2.7,12.0,-9.3,20,CL
0d10333c,5,440,4.9,5,4,0,0,9,9,0,6.2,8.4,-2.2,20,CL
0d267745,8,557,6.2,6,5,2,1,13,4,9,15.9,4.5,11.3,20,CL
0d82903c,6,540,6.0,6,6,0,1,11,6,5,10.8,7.9,2.9,20,CL
0da6a13e,6,258,2.9,2,0,4,0,2,6,-4,3.4,8.5,-5.1,20,CL
0dce3356,5,450,5.0,5,5,0,1,8,9,-1,7.2,6.2,1.0,20,CL
0e21fc3c,3,152,1.7,2,0,1,1,2,2,0,2.4,2.6,-0.2,20,CL
0e6bc38c,6,130,1.4,1,0,5,1,4,0,4,4.2,0.7,3.6,20,CL
0ef89a37,11,519,5.8,5,3,6,0,25,5,20,17.4,4.9,12.5,20,CL
10072610,2,125,1.4,1,1,1,6,4,2,2,4.1,0.9,3.1,20,CL
101da2b5,8,653,7.3,7,6,1,0,16,6,10,19.1,6.4,12.7,20,CL
10549b49,6,462,5.1,6,2,0,0,6,7,-1,5.4,6.6,-1.2,20,CL
108fe016,3,28,0.3,0,0,3,3,2,1,1,1.0,0.5,0.5,20,CL
10b9fa99,3,181,2.0,2,1,1,1,1,2,-1,4.6,2.3,2.3,20,CL
10efd0e1,6,474,5.3,6,2,0,0,1,11,-10,3.9,13.5,-9.6,20,CL
10fe831e,5,370,4.1,4,4,1,1,3,8,-5,2.7,10.7,-8.0,20,CL
119b9a8e,3,212,2.4,3,2,0,0,3,4,-1,5.2,2.1,3.0,20,CL
121101a4,5,450,5.0,5,5,0,0,9,9,0,7.2,12.7,-5.5,20,CL
1265a93a,6,382,4.2,4,3,2,1,7,11,-4,9.2,10.3,-1.1,20,CL
129af0db,8,487,5.4,5,4,3,0,9,4,5,10.9,3.6,7.3,20,CL
133faa84,6,540,6.0,6,6,0,0,1,14,-13,4.2,16.4,-12.2,20,CL
13b44b02,6,505,5.6,6,4,0,0,8,11,-3,6.7,13.8,-7.1,20,CL
13ea2544,5,415,4.6,5,2,0,1,5,11,-6,4.5,9.9,-5.4,20,CL
1467af0d,9,589,6.5,6,5,3,0,14,4,10,15.2,8.7,6.5,20,CL
14b8fcdf,2,180,2.0,2,2,0,5,4,1,3,3.3,4.6,-1.3,20,CL
15f3ec41,5,263,2.9,2,1,3,0,6,5,1,6.7,3.8,2.8,20,CL
169fd162,6,540,6.0,6,6,0,0,16,13,3,13.7,11.9,1.8,20,CL
16b9d5cf,3,270,3.0,3,3,0,2,3,3,0,3.9,4.0,-0.1,20,CL
16ceb862,3,88,1.0,1,0,2,3,0,4,-4,2.0,2.8,-0.8,20,CL
179d2851,6,540,6.0,6,6,0,0,4,10,-6,9.4,12.2,-2.8,20,CL
1840e36d,7,585,6.5,7,6,0,1,11,11,0,14.3,12.2,2.1,20,CL
18b896d6,2,180,2.0,2,2,0,1,2,4,-2,3.8,3.7,0.1,20,CL
1931bde9,5,354,3.9,4,2,1,1,0,14,-14,1.8,11.9,-10.1,20,CL
197640fd,6,394,4.4,4,3,2,3,6,10,-4,8.8,9.9,-1.1,20,CL
199cd404,3,119,1.3,1,0,2,1,3,8,-5,1.5,4.8,-3.3,20,CL
19cda00b,9,744,8.3,9,3,0,0,16,3,13,17.4,10.2,7.1,20,CL
19e4dca5,1,90,1.0,1,1,0,3,0,2,-2,0.1,3.2,-3.1,20,CL
1a2935f6,3,232,2.6,3,2,0,3,5,2,3,5.2,2.4,2.8,20,CL
1a799243,6,540,6.0,6,6,0,0,16,13,3,13.7,11.9,1.8,20,CL
1a992676,5,70,0.8,0,0,5,3,4,1,3,3.2,1.2,2.0,20,CL
1adcf39e,6,535,5.9,6,5,0,0,6,12,-6,7.3,12.4,-5.2,20,CL
1bacc518,9,748,8.3,8,8,1,0,14,13,1,13.3,16.4,-3.2,20,CL
1bf33a9a,4,266,3.0,3,2,1,1,9,6,3,10.3,4.2,6.1,20,CL
1c07b06e,6,481,5.3,6,3,0,0,7,11,-4,7.6,10.6,-3.1,20,CL
1c78737d,4,166,1.8,2,0,2,2,1,5,-4,1.3,4.2,-2.9,20,CL
1c96ad85,2,159,1.8,2,1,0,2,2,4,-2,4.5,1.8,2.7,20,CL
1cb49278,4,360,4.0,4,4,0,3,3,10,-7,7.0,10.3,-3.3,20,CL
1d1691ad,2,110,1.2,1,1,1,5,5,1,4,1.9,1.2,0.7,20,CL
1d5cab82,5,403,4.5,4,3,1,1,9,10,-1,8.1,9.3,-1.2,20,CL
1dbfae2d,4,88,1.0,1,0,3,1,0,0,0,0.3,1.9,-1.6,20,CL
1e8dbb59,1,22,0.2,0,0,1,4,0,1,-1,0.1,0.8,-0.8,20,CL
1f3afdcb,2,180,2.0,2,2,0,3,1,4,-3,2.8,3.1,-0.2,20,CL
1f44ac21,8,553,6.1,6,3,2,0,14,13,1,12.9,10.2,2.5999999999999996,20,CL
1fb1c435,6,526,5.8,6,3,0,0,11,9,2,11.0,11.5,-0.5,20,CL
20030c06,4,279,3.1,3,3,1,1,4,4,0,5.1,4.1,1.1,20,CL
21512407,6,540,6.0,6,5,0,2,6,6,0,8.5,5.3,3.3,20,CL
21a66f6a,5,450,5.0,5,5,0,0,17,11,6,12.0,5.3,6.8,20,CL
228f73ae,1,6,0.1,0,0,1,2,0,0,0,0.0,0.1,-0.1,20,CL
230a2fac,8,720,8.0,8,8,0,0,13,8,5,14.9,11.0,3.9,20,CL
24228180,6,463,5.1,5,2,1,0,8,9,-1,5.7,13.0,-7.4,20,CL
2475dcc6,6,540,6.0,6,6,0,0,12,6,6,7.5,13.8,-6.3,20,CL
24b98f95,3,244,2.7,3,1,0,2,2,6,-4,2.7,6.9,-4.2,20,CL
24f59bb2,4,271,3.0,3,3,1,2,6,3,3,5.5,4.1,1.4,20,CL
262e5a82,3,270,3.0,3,3,0,0,6,5,1,4.5,4.7,-0.2,20,CL
2784f898,3,270,3.0,3,3,0,5,4,6,-2,2.6,4.8,-2.2,20,CL
27d902c8,4,302,3.4,4,3,0,0,9,9,0,7.6,7.0,0.6,20,CL
27f0fcda,5,190,2.1,1,1,4,0,3,10,-7,1.3,8.5,-7.3,20,CL
28d596a0,6,540,6.0,6,6,0,2,11,9,2,15.4,6.5,8.9,20,CL
292a652a,6,540,6.0,6,6,0,0,8,13,-5,8.3,13.1,-4.8,20,CL
2946f9a1,1,45,0.5,1,0,0,2,0,2,-2,1.2,0.9,0.3,20,CL
2973d8ff,4,88,1.0,0,0,4,3,2,2,0,3.4,2.4,1.0,20,CL
29c02c9f,1,90,1.0,1,1,0,5,1,0,1,1.9,1.8,0.0,20,CL
29fbdc88,4,101,1.1,1,0,3,1,2,4,-2,1.2,4.9,-3.7,20,CL
2a1beb34,9,764,8.5,9,8,0,0,15,16,-1,16.7,17.2,-0.5,20,CL
2a6cd437,1,45,0.5,1,0,0,0,1,1,0,1.3,1.9,-0.5,20,CL
2acd49b9,6,419,4.7,4,4,2,0,14,10,4,10.6,5.6,5.0,20,CL
2b09d998,3,82,0.9,0,0,3,0,2,0,2,1.3,0.8,0.5,20,CL
2b3efa4a,6,540,6.0,6,6,0,0,4,10,-6,9.4,12.2,-2.8,20,CL
2b471f99,4,329,3.7,4,3,0,0,1,12,-11,2.3,11.3,-9.0,20,CL
2b622f01,6,399,4.4,5,2,1,2,5,14,-9,4.9,9.0,-4.1,20,CL
2ba38347,5,450,5.0,5,5,0,0,9,9,0,7.2,12.7,-5.5,20,CL
2bed3eab,2,180,2.0,2,2,0,4,5,4,1,6.1,1.4,4.7,20,CL
2c0f8e9e,1,65,0.7,1,0,0,1,1,1,0,0.9,0.9,0.0,20,CL
2c44a35d,6,454,5.0,6,2,0,0,3,9,-6,6.5,8.5,-2.0,20,CL
2ccd89a3,3,259,2.9,3,2,0,3,3,9,-6,2.7,6.6,-3.9,20,CL
2d970560,8,655,7.3,7,6,1,0,15,14,1,15.3,14.5,0.9,20,CL
2db2fd7b,9,579,6.4,8,3,1,2,27,7,20,21.0,7.5,13.5,20,CL
2e4f5f03,8,649,7.2,7,6,1,0,11,10,1,12.8,7.5,5.3,20,CL
2ef7c612,4,127,1.4,1,0,3,0,1,2,-1,1.2,1.5,-0.3,20,CL
2f557579,5,349,3.9,4,2,1,1,4,6,-2,6.2,5.4,0.8,20,CL
2f7acede,5,440,4.9,5,4,0,1,8,12,-4,7.3,6.7,0.6,20,CL
2f90f6b8,8,417,4.6,4,2,4,0,9,6,3,9.2,4.0,5.2,20,CL
2f965a72,2,135,1.5,1,1,1,6,5,1,4,2.3,1.6,0.8,20,CL
2fabebc0,4,360,4.0,4,4,0,2,3,7,-4,3.0,6.6,-3.7,20,CL
30941e96,5,450,5.0,5,5,0,3,7,5,2,6.1000000000000005,6.8,-0.7,20,CL
30c220c3,3,270,3.0,3,3,0,1,2,5,-3,2.3,4.0,-1.7,20,CL
30f5ffa9,6,540,6.0,6,6,0,0,10,9,1,10.0,10.3,-0.3,20,CL
31a62dc7,6,540,6.0,6,6,0,0,4,14,-10,8.8,10.1,-1.3,20,CL
31c69ef1,6,540,6.0,6,6,0,0,10,11,-1,8.1,9.4,-1.3,20,CL
3318193b,2,38,0.4,0,0,2,2,0,1,-1,1.1,0.6,0.5,20,CL
335fa267,6,411,4.6,4,3,2,0,9,7,2,7.2,9.9,-2.8,20,CL
33b8d077,6,520,5.8,6,5,0,0,9,9,0,9.7,10.2,-0.5,20,CL
346d51d9,4,340,3.8,4,2,0,2,6,8,-2,8.2,8.3,-0.1,20,CL
34c3b935,6,540,6.0,6,6,0,0,8,13,-5,8.3,13.1,-4.8,20,CL
356c9002,5,388,4.3,5,3,0,1,8,5,3,7.7,7.4,0.3,20,CL
360e3062,4,265,2.9,3,2,1,0,4,12,-8,2.8,8.6,-5.8,20,CL
3640af28,6,540,6.0,6,6,0,0,8,14,-6,7.9,12.1,-4.3,20,CL
365836c9,4,360,4.0,4,4,0,2,4,16,-12,4.9,12.5,-7.6,20,CL
36a3ff67,4,360,4.0,4,4,0,0,5,4,1,8.7,7.0,1.8,20,CL
38ac43d3,5,262,2.9,4,0,1,0,5,2,3,4.3,3.7,0.6,20,CL
38c7feef,5,281,3.1,3,0,2,3,6,1,5,5.9,1.8,4.1,20,CL
392a7aea,6,540,6.0,6,6,0,0,4,12,-8,7.4,10.4,-3.0,20,CL
39769cff,6,533,5.9,6,5,0,0,16,13,3,13.3,11.8,1.4,20,CL
3a233281,3,115,1.3,2,0,1,0,2,4,-2,1.2,2.3,-1.1,20,CL
3a24769f,3,161,1.8,2,1,1,1,1,6,-5,2.9,5.1,-2.2,20,CL
3b333ac3,9,590,6.6,7,5,2,0,14,12,2,12.0,13.8,-1.8,20,CL
3b387cc7,1,19,0.2,0,0,1,2,1,0,1,0.8,0.5,0.3,20,CL
3b8674e6,7,421,4.7,4,3,3,0,7,5,2,8.2,5.6,2.6,20,CL
3bb7b8b4,8,675,7.5,8,7,0,0,17,7,10,21.0,6.9,14.1,20,CL
3c6089ab,10,711,7.9,7,6,3,1,28,5,23,25.6,7.5,18.1,20,CL
3ca7254a,3,99,1.1,0,0,3,1,0,2,-2,2.1,1.9,0.2,20,CL
3cefcaef,5,409,4.5,4,4,1,2,8,8,0,6.6,8.6,-2.0,20,CL
3d68d631,5,209,2.3,2,1,3,1,2,2,0,3.0,3.2,-0.3,20,CL
3eb22ec9,7,435,4.8,5,3,2,2,7,4,3,10.0,3.3,6.8,20,CL
3eed9821,3,270,3.0,3,3,0,1,6,3,3,5.5,4.1,1.5,20,CL
3ef0af0d,6,463,5.1,5,4,1,0,6,8,-2,5.4,8.4,-3.0,20,CL
407feb71,1,18,0.2,0,0,1,1,1,0,1,0.1,0.2,-0.1,20,CL
41e7ef1c,4,203,2.3,2,2,2,4,6,2,4,6.1,1.7,4.4,20,CL
42276181,7,319,3.5,4,1,3,0,6,4,2,5.5,6.1,-0.5,20,CL
42eaa028,4,239,2.7,3,1,1,1,2,6,-4,5.4,4.1,1.3,20,CL
42fd9c7f,10,654,7.3,6,4,4,0,18,5,13,19.6,10.3,9.4,20,CL
433dc9a2,10,873,9.7,10,8,0,0,23,4,19,23.4,10.8,12.5,20,CL
436a9dd0,6,324,3.6,4,0,2,1,7,2,5,8.2,3.6,4.7,20,CL
43a166b4,6,190,2.1,1,0,5,1,4,3,1,4.6,2.1,2.5,20,CL
43b78598,7,473,5.3,7,0,0,4,11,2,9,11.7,5.5,6.2,20,CL
44781702,3,270,3.0,3,3,0,2,7,3,4,6.6,4.3,2.2,20,CL
44865466,3,144,1.6,1,1,2,3,0,7,-7,0.3,6.7,-6.3,20,CL
448a3608,6,540,6.0,6,6,0,0,7,9,-2,6.1,9.5,-3.3,20,CL
44ac04e9,3,236,2.6,3,1,0,2,4,5,-1,4.1,5.6,-1.6,20,CL
44eb9093,3,184,2.0,2,1,1,1,2,3,-1,3.2,2.7,0.5,20,CL
45a03961,8,639,7.1,7,7,1,1,28,5,23,23.0,5.2,17.7,20,CL
45af8a54,1,30,0.3,0,0,1,0,0,1,-1,0.2,0.6,-0.5,20,CL
45db685d,7,611,6.8,7,6,0,0,11,11,0,16.3,9.1,7.2,20,CL
4601e194,5,354,3.9,5,3,0,0,7,10,-3,5.7,10.0,-4.3,20,CL
46a8347f,2,120,1.3,1,1,1,0,4,1,3,1.8,1.5,0.3,20,CL
47327321,1,9,0.1,0,0,1,1,1,0,1,1.5,0.1,1.4,20,CL
47af88b8,9,780,8.7,9,8,0,0,12,14,-2,11.0,15.7,-4.6,20,CL
47dc80f5,4,360,4.0,4,4,0,2,7,7,0,6.3,6.5,-0.2,20,CL
47fd5136,5,450,5.0,5,5,0,0,7,6,1,6.0,7.1,-1.0,20,CL
48b3dd60,4,298,3.3,3,2,1,1,5,2,3,5.9,6.1,-0.2,20,CL
48d5bd33,9,262,2.9,1,1,8,0,5,9,-4,7.1,8.4,-1.3,20,CL
49296448,11,903,10.0,10,9,1,0,36,8,28,30.8,9.8,20.9,20,CL
4958bfb2,7,622,6.9,7,6,0,1,13,11,2,15.4,12.7,2.7,20,CL
49fe9070,8,579,6.4,7,5,1,0,11,7,4,12.4,6.4,6.0,20,CL
4adc7b42,6,470,5.2,6,1,0,0,4,8,-4,7.6,11.2,-3.6,20,CL
4b3c863f,5,375,4.2,5,4,0,1,8,6,2,5.6,6.2,-0.6,20,CL
4b6960d2,6,523,5.8,6,4,0,0,1,13,-12,4.1,15.8,-11.7,20,CL
4b803b3c,6,540,6.0,6,6,0,0,16,13,3,13.7,11.9,1.8,20,CL
4bd00a50,2,100,1.1,1,1,1,3,2,1,1,0.8,1.8,-1.1,20,CL
4c2e9442,6,419,4.7,5,3,1,0,9,10,-1,10.2,9.0,1.2,20,CL
4c370d81,8,627,7.0,7,4,1,0,12,9,3,12.2,6.9,5.3,20,CL
4c5e78da,4,167,1.9,2,0,2,0,0,2,-2,2.8,4.5,-1.7,20,CL
4c82730b,2,105,1.2,1,1,1,1,0,2,-2,1.2,4.3,-3.0,20,CL
4d034881,3,196,2.2,2,1,1,2,6,1,5,7.4,2.0,5.4,20,CL
4d0eb7d2,3,237,2.6,3,1,0,3,3,8,-5,2.4,6.2,-3.9,20,CL
4d17df3e,5,324,3.6,3,3,2,1,3,7,-4,3.9,7.2,-3.3,20,CL
4d224fe8,8,689,7.7,8,7,0,0,14,12,2,14.4,13.2,1.2,20,CL
4d8cd038,5,121,1.3,1,0,4,3,2,2,0,1.6,1.8,-0.3,20,CL
4dbd0916,7,231,2.6,2,0,5,2,3,2,1,4.8,1.3,3.5,20,CL
4dbdf7f7,3,176,2.0,3,0,0,0,0,5,-5,0.9,4.7,-3.7,20,CL
4dedd469,5,441,4.9,5,4,0,0,3,16,-13,3.7,14.5,-10.8,20,CL
4e034598,1,90,1.0,1,1,0,5,0,2,-2,0.1,3.2,-3.1,20,CL
4e204552,2,21,0.2,0,0,2,1,0,1,-1,0.2,1.4,-1.2,20,CL
4f1e6a0b,4,180,2.0,2,0,2,0,7,4,3,2.5,5.8,-3.3,20,CL
4f28a6ff,9,721,8.0,8,8,1,0,14,13,1,12.7,17.2,-4.4,20,CL
4f56170e,6,462,5.1,5,5,1,0,7,13,-6,7.5,11.4,-3.9,20,CL
4fa7cb9b,1,21,0.2,0,0,1,0,1,0,1,0.8,0.6,0.2,20,CL
5042e5c2,4,37,0.4,0,0,4,2,0,0,0,0.2,0.4,-0.1,20,CL
5064d4c1,1,69,0.8,1,0,0,0,1,2,-1,0.8,1.1,-0.3,20,CL
50871bcc,7,475,5.3,6,0,1,1,6,6,0,9.5,7.3,2.2,20,CL
50c1ff86,6,495,5.5,6,5,0,0,3,17,-14,3.9,18.5,-14.5,20,CL
50dc94ce,5,447,5.0,5,4,0,0,9,6,3,5.9,11.8,-6.0,20,CL
5148dcc5,5,240,2.7,3,0,2,0,4,3,1,2.6,6.5,-3.9,20,CL
51a3c4c8,8,661,7.3,7,7,1,1,10,5,5,11.9,7.2,4.7,20,CL
51cf8561,2,115,1.3,1,1,1,2,4,0,4,4.1,1.0,3.0,20,CL
51dbeea9,5,376,4.2,4,4,1,1,8,2,6,9.6,3.6,6.0,20,CL
51ffa295,5,174,1.9,1,0,4,0,1,6,-5,0.5,7.3,-6.8,20,CL
5271c8f1,6,438,4.9,5,4,1,2,14,4,10,16.4,3.8,12.6,20,CL
527f063d,3,132,1.5,1,1,2,3,3,0,3,2.8,1.4,1.4,20,CL
529f49ab,8,735,8.2,8,7,0,1,11,7,4,13.8,8.2,5.6,20,CL
52ec54d0,7,630,7.0,7,7,0,1,12,6,6,11.1,8.6,2.5,20,CL
53070b63,2,38,0.4,0,0,2,3,0,2,-2,0.5,1.1,-0.6,20,CL
53cad200,7,612,6.8,7,6,0,0,11,11,0,16.3,9.0,7.3,20,CL
54b4dc4e,5,372,4.1,5,1,0,0,4,3,1,4.0,4.1,0.0,20,CL
54f2d108,2,61,0.7,0,0,2,3,0,4,-4,0.1,2.8,-2.7,20,CL
54f5ce34,3,270,3.0,3,3,0,1,1,2,-1,4.6,3.4,1.2,20,CL
55126f3b,9,796,8.8,9,5,0,0,12,9,3,14.6,8.8,5.8,20,CL
552e00b9,4,67,0.7,0,0,4,2,1,1,0,0.6,1.0,-0.4,20,CL
55537f53,1,10,0.1,0,0,1,2,0,1,-1,0.1,1.5,-1.4,20,CL
555d5edd,4,238,2.6,2,1,2,0,2,3,-1,2.5,3.1,-0.6,20,CL
555f3a0b,5,353,3.9,3,3,2,2,4,3,1,6.8,2.0,4.7,20,CL
55abe554,4,359,4.0,4,3,0,0,3,8,-5,4.5,7.3,-2.8,20,CL
56413b1f,5,413,4.6,5,3,0,0,5,6,-1,6.0,4.4,1.6,20,CL
574fff8c,4,360,4.0,4,4,0,1,3,10,-7,4.3,10.9,-6.6,20,CL
580d52dd,6,532,5.9,6,5,0,0,4,11,-7,6.0,12.9,-6.9,20,CL
5853ac44,2,75,0.8,1,0,1,2,4,0,4,3.2,0.2,3.0,20,CL
58f077c0,6,540,6.0,6,6,0,0,10,13,-3,7.5,16.3,-8.8,20,CL
5944af8f,4,185,2.1,1,1,3,2,3,10,-7,1.7,8.5,-6.7,20,CL
5976f83e,5,405,4.5,4,4,1,1,8,1,7,6.1,8.1,-2.0,20,CL
5ab0ea87,7,504,5.6,7,2,0,1,8,9,-1,9.5,9.6,-0.1,20,CL
5af687a1,1,10,0.1,0,0,1,0,0,0,0,0.1,0.0,0.1,20,CL
5c07e176,3,238,2.6,2,2,1,1,7,4,3,6.1,4.9,1.2,20,CL
5c2b4f07,5,449,5.0,5,4,0,0,11,13,-2,9.2,6.1,3.1,20,CL
5c2da10f,4,209,2.3,2,2,2,2,3,6,-3,3.2,5.2,-2.0,20,CL
5cb1d026,5,439,4.9,5,4,0,0,4,9,-5,5.9,9.8,-3.9,20,CL
5cdddffa,6,339,3.8,4,2,2,1,13,6,7,9.6,3.5,6.2,20,CL
5ceba7fc,4,283,3.1,4,0,0,0,4,5,-1,4.1,7.4,-3.3,20,CL
5d4f7d61,5,240,2.7,2,1,3,1,7,1,6,5.8,1.9,4.0,20,CL
5dfc6ad5,7,610,6.8,7,6,0,0,8,10,-2,11.4,10.2,1.2,20,CL
5e1028e5,5,393,4.4,5,0,0,0,6,6,0,5.4,6.2,-0.9,20,CL
5e861944,6,103,1.1,0,0,6,2,1,3,-2,1.6,3.0,-1.3,20,CL
5e8936be,6,540,6.0,6,6,0,0,3,20,-17,4.0,19.8,-15.8,20,CL
5eae500a,5,403,4.5,5,3,0,0,8,6,2,7.3,7.6,-0.2,20,CL
5ed9b537,2,112,1.2,2,1,0,0,2,2,0,1.8,2.2,-0.4,20,CL
5eecec3d,1,50,0.6,0,0,1,4,3,0,3,2.3,0.5,1.8,20,CL
5f0241b2,3,192,2.1,2,2,1,8,10,0,10,9.3,1.3,8.0,20,CL
6025fab1,6,391,4.3,4,2,2,0,10,9,1,8.5,9.1,-0.6,20,CL
603116a7,4,266,3.0,3,2,1,2,8,2,6,8.8,4.3,4.5,20,CL
60e86875,5,362,4.0,4,2,1,0,6,4,2,4.8,4.9,-0.1,20,CL
6250083a,2,31,0.3,0,0,2,2,0,0,0,0.7,0.2,0.5,20,CL
62db2015,6,487,5.4,6,3,0,0,3,17,-14,3.9,17.9,-14.0,20,CL
63b9cc6d,4,76,0.8,0,0,4,1,2,1,1,2.2,2.4,-0.1,20,CL
63d17038,4,360,4.0,4,4,0,4,14,5,9,9.5,5.2,4.3,20,CL
6421ec64,1,4,0.0,0,0,1,2,0,1,-1,0.0,0.3,-0.3,20,CL
6434f10d,8,620,6.9,8,2,0,0,16,7,9,18.3,6.0,12.4,20,CL
6438d426,4,333,3.7,4,3,0,0,0,8,-8,2.8,10.4,-7.6,20,CL
64f69877,6,459,5.1,5,5,1,0,5,8,-3,5.1,5.9,-0.8,20,CL
652d4c37,10,346,3.8,3,2,7,0,22,3,19,12.6,3.2,9.4,20,CL
65adf2db,2,72,0.8,1,0,1,4,1,3,-2,1.8,2.8,-1.0,20,CL
66116290,3,209,2.3,2,2,1,0,0,3,-3,1.1,6.4,-5.2,20,CL
6613c819,6,540,6.0,6,6,0,0,4,10,-6,9.4,12.2,-2.8,20,CL
6622454d,6,495,5.5,6,2,0,0,12,5,7,7.1,11.4,-4.3,20,CL
6747869d,1,2,0.0,0,0,1,2,0,0,0,0.0,0.0,0.0,20,CL
67ac5bb8,6,540,6.0,6,6,0,0,4,14,-10,8.8,10.1,-1.3,20,CL
67b3d74b,1,90,1.0,1,1,0,2,2,2,0,0.9,3.2,-2.4,20,CL
67cdbc0e,7,422,4.7,4,3,3,1,7,10,-3,7.7,9.0,-1.3,20,CL
68252d6d,7,514,5.7,6,3,1,0,11,15,-4,10.9,14.2,-3.4,20,CL
691bef82,5,427,4.7,5,4,0,0,10,4,6,5.7,9.2,-3.5,20,CL
691f64f5,5,344,3.8,3,3,2,0,1,7,-6,2.6,9.1,-6.4,20,CL
6928979a,4,290,3.2,3,3,1,0,6,5,1,4.9,5.5,-0.6,20,CL
69374ff5,6,346,3.8,3,2,3,0,2,9,-7,3.4,4.8,-1.4,20,CL
69384e5d,7,585,6.5,6,6,1,0,15,5,10,15.3,7.5,7.8,20,CL
6a479195,1,10,0.1,0,0,1,2,1,1,0,0.7,0.6,0.1,20,CL
6aa3e78b,3,196,2.2,2,2,1,1,2,6,-4,1.5,3.8,-2.3,20,CL
6b6cbca4,6,540,6.0,6,6,0,0,4,12,-8,7.4,10.4,-3.0,20,CL
6b994195,5,435,4.8,5,4,0,0,9,8,1,7.2,10.9,-3.8,20,CL
6c7762c3,3,198,2.2,2,2,1,0,5,3,2,4.3,3.5,0.8,20,CL
6c811eb7,1,90,1.0,1,1,0,1,2,1,1,1.5,1.7,-0.2,20,CL
6ca88b2a,1,90,1.0,1,1,0,2,1,4,-3,0.4,3.6,-3.3,20,CL
6ce1f46f,6,540,6.0,6,6,0,1,12,9,3,14.2,9.5,4.7,20,CL
6ceef869,6,518,5.8,6,5,0,0,4,11,-7,6.0,12.5,-6.5,20,CL
6e4df551,9,708,7.9,9,3,0,0,15,13,2,16.2,13.9,2.3,20,CL
6eee05f1,6,509,5.7,6,5,0,2,10,13,-3,10.4,12.5,-2.2,20,CL
6f51e382,8,720,8.0,8,8,0,1,13,13,0,12.9,16.1,-3.3,20,CL
6fbde63a,3,79,0.9,1,0,2,2,1,0,1,0.7,0.6,0.1,20,CL
6fd8a334,3,94,1.0,1,1,2,3,0,3,-3,2.2,1.8,0.5,20,CL
6fe90922,10,423,4.7,5,0,5,0,20,4,16,16.7,4.7,12.0,20,CL
70a9cba5,2,47,0.5,0,0,2,2,0,1,-1,0.8,0.5,0.2,20,CL
70bc68ef,1,24,0.3,0,0,1,0,1,2,-1,1.4,0.6,0.8,20,CL
70cf63ca,3,124,1.4,2,1,1,0,3,4,-1,2.4,2.8,-0.4,20,CL
70d74ece,8,644,7.2,7,7,1,0,14,11,3,15.5,12.9,2.6,20,CL
7111d552,5,194,2.2,2,0,3,1,4,2,2,2.5,3.2,-0.7,20,CL
7120a04d,3,155,1.7,2,1,1,0,3,2,1,2.5,2.5,0.0,20,CL
715bf047,2,81,0.9,1,0,1,0,0,2,-2,0.4,1.2,-0.8,20,CL
71ec39ef,7,603,6.7,7,6,0,0,9,8,1,8.1,8.6,-0.5,20,CL
720611fe,2,93,1.0,1,1,1,3,1,2,-1,0.9,1.5,-0.6,20,CL
7272a72a,5,450,5.0,5,5,0,0,7,12,-5,7.3,11.9,-4.7,20,CL
72c812f3,7,566,6.3,7,5,0,2,8,4,4,10.8,6.7,4.1,20,CL
73000a79,2,101,1.1,1,1,1,0,0,3,-3,2.3,1.3,1.0,20,CL
733e7ad8,5,395,4.4,5,2,0,1,2,9,-7,5.5,8.6,-3.1,20,CL
73d6a176,1,3,0.0,0,0,1,0,0,0,0,0.0,0.2,-0.2,20,CL
73fc8cc3,2,10,0.1,0,0,2,3,0,0,0,0.2,0.9,-0.7,20,CL
74419746,6,540,6.0,6,6,0,0,10,9,1,10.0,10.3,-0.3,20,CL
7460ca0d,8,720,8.0,8,8,0,0,13,15,-2,14.7,15.7,-1.0,20,CL
746b64a7,6,540,6.0,6,6,0,0,3,20,-17,4.0,19.8,-15.8,20,CL
746fec7d,4,80,0.9,0,0,4,1,1,2,-1,1.0,1.2,-0.2,20,CL
7483d9f9,2,180,2.0,2,2,0,4,8,5,3,7.0,1.6,5.3,20,CL
76d5857d,3,138,1.5,2,0,1,3,1,2,-1,1.8,1.6,0.2,20,CL
77d7c96f,5,145,1.6,1,1,4,4,4,3,1,2.0,6.0,-4.0,20,CL
77e84962,10,819,9.1,9,5,1,1,38,8,30,31.1,9.6,21.5,20,CL
78841da9,7,569,6.3,7,3,0,1,12,7,5,13.5,9.1,4.4,20,CL
79c0821a,8,610,6.8,7,4,1,0,10,15,-5,14.0,12.0,2.0,20,CL
7a11550b,7,512,5.7,5,4,2,1,12,10,2,12.0,5.8,6.2,20,CL
7a2e46a8,5,450,5.0,5,5,0,0,9,4,5,9.5,4.4,5.1,20,CL
7a4cea18,3,105,1.2,1,0,2,1,2,4,-2,1.7,2.5,-0.8,20,CL
7b075c75,1,88,1.0,1,0,0,3,1,3,-2,1.2,1.9,-0.7,20,CL
7bcc0708,5,252,2.8,2,1,3,1,1,7,-6,2.0,8.1,-6.0,20,CL
7c104bb7,1,68,0.8,1,0,0,7,2,1,1,1.2,0.6,0.7,20,CL
7c3ed041,1,8,0.1,0,0,1,0,0,0,0,0.0,0.3,-0.3,20,CL
7c56da38,9,510,5.7,7,1,2,1,9,6,3,10.2,6.8,3.5,20,CL
7edfbb8a,4,360,4.0,4,4,0,2,7,6,1,10.6,3.1,7.5,20,CL
7f3b388c,7,483,5.4,6,5,1,0,10,9,1,8.7,7.2,1.5,20,CL
7f97771d,7,343,3.8,4,1,3,3,17,2,15,13.9,1.0,12.9,20,CL
7fa4e703,2,43,0.5,0,0,2,0,2,1,1,1.0,1.1,-0.1,20,CL
7fcc71d8,6,457,5.1,5,3,1,0,7,13,-6,7.4,11.1,-3.7,20,CL
7ff93107,3,54,0.6,0,0,3,2,3,1,2,2.8,1.4,1.5,20,CL
80490d7f,6,540,6.0,6,6,0,0,5,20,-15,6.9,18.2,-11.3,20,CL
807e869a,1,90,1.0,1,1,0,1,0,2,-2,1.0,0.7,0.2,20,CL
808d48f3,3,246,2.7,3,2,0,4,2,6,-4,4.9,5.5,-0.7,20,CL
808df563,2,91,1.0,1,1,1,1,2,1,1,1.5,1.7,-0.2,20,CL
8104e41e,5,435,4.8,5,3,0,0,3,9,-6,6.3,9.2,-2.9,20,CL
810e40c1,1,7,0.1,0,0,1,1,0,0,0,0.4,0.0,0.4,20,CL
819b3158,9,810,9.0,9,9,0,0,21,9,12,25.1,7.9,17.2,20,CL
82518f62,4,294,3.3,4,2,0,0,3,5,-2,3.5,7.2,-3.7,20,CL
8263d615,1,1,0.0,0,0,1,0,0,0,0,0.1,0.0,0.0,20,CL
82a8d4cc,4,171,1.9,2,1,2,1,0,7,-7,1.3,8.6,-7.2,20,CL
82b1198a,2,180,2.0,2,2,0,6,2,4,-2,2.9,2.8,0.1,20,CL
82dbf623,6,92,1.0,0,0,6,1,2,0,2,1.8,0.6,1.1,20,CL
82efe6fa,1,20,0.2,0,0,1,1,2,0,2,1.2,0.1,1.1,20,CL
834d0be5,5,214,2.4,2,0,3,1,0,3,-3,3.3,1.5,1.7,20,CL
8387afe6,4,239,2.7,2,2,2,2,1,6,-5,1.7,7.5,-5.8,20,CL
8455ad90,5,127,1.4,1,0,4,1,1,3,-2,1.9,3.2,-1.3,20,CL
85613cf0,5,215,2.4,2,0,3,2,4,1,3,7.4,3.9,3.5,20,CL
85686f86,2,19,0.2,0,0,2,3,2,1,1,1.0,0.7,0.3,20,CL
85f8571a,6,519,5.8,6,5,0,0,7,9,-2,5.8,9.3,-3.4,20,CL
8652a85c,4,138,1.5,1,0,3,0,0,4,-4,0.8,2.3,-1.5,20,CL
86dd16a8,5,450,5.0,5,5,0,0,3,9,-6,5.4,10.7,-5.3,20,CL
86dd77d1,6,443,4.9,5,4,1,3,13,6,7,14.6,5.7,8.8,20,CL
86e7deaf,9,810,9.0,9,9,0,1,18,6,12,20.7,11.5,9.1,20,CL
874d7a32,2,149,1.7,2,1,0,0,1,3,-2,2.2,2.2,0.0,20,CL
8754c7ca,5,450,5.0,5,5,0,1,7,11,-4,7.0,10.9,-3.9,20,CL
8778c910,11,990,11.0,11,11,0,0,43,8,35,35.5,10.2,25.3,20,CL
8794e251,5,367,4.1,4,2,1,2,7,3,4,7.0,6.1,0.9,20,CL
88062e83,3,156,1.7,2,1,1,0,0,6,-6,2.4,4.2,-1.8,20,CL
881cd6be,2,180,2.0,2,2,0,1,3,4,-1,1.8,2.9,-1.1,20,CL
886f9aac,5,138,1.5,1,0,4,0,3,4,-1,2.9,3.9,-1.0,20,CL
88e357ef,10,761,8.5,9,3,1,1,30,8,22,25.1,9.1,16.0,20,CL
88f130ed,1,90,1.0,1,1,0,4,2,1,1,1.5,1.7,-0.2,20,CL
892d5bb1,7,572,6.4,6,5,1,2,18,6,12,21.1,5.8,15.3,20,CL
89565ac5,1,1,0.0,0,0,1,2,0,0,0,0.0,0.1,-0.1,20,CL
89ac64a6,6,523,5.8,6,5,0,2,8,7,1,12.5,9.1,3.3,20,CL
89b2c8a9,8,583,6.5,7,3,1,0,13,7,6,10.8,8.6,2.2,20,CL
89d10e53,4,360,4.0,4,4,0,0,11,12,-1,7.7,5.9,1.7,20,CL
89f951b5,7,345,3.8,4,1,3,2,7,4,3,5.7,7.6,-1.9,20,CL
8a08491a,8,510,5.7,5,3,3,0,12,3,9,9.4,8.3,1.1,20,CL
8a6ab963,2,180,2.0,2,2,0,1,4,2,2,3.2,2.8,0.3,20,CL
8aafd64f,6,425,4.7,4,1,2,0,8,5,3,10.0,5.8,4.2,20,CL
8ac501f5,1,7,0.1,0,0,1,1,0,0,0,0.0,0.3,-0.3,20,CL
8b3ab7ad,6,377,4.2,4,2,2,0,7,3,4,5.2,9.6,-4.4,20,CL
8b529245,5,322,3.6,3,1,2,0,8,6,2,5.3,5.5,-0.2,20,CL
8b8a56ce,1,90,1.0,1,1,0,2,2,0,2,3.0,0.3,2.7,20,CL
8b9ebd03,7,528,5.9,6,3,1,0,10,9,1,14.2,6.9,7.4,20,CL
8bbe2df5,3,270,3.0,3,3,0,3,2,8,-6,5.4,4.4,0.9,20,CL
8c5f1522,2,67,0.7,1,0,1,1,0,0,0,0.5,0.4,0.1,20,CL
8c90fd7a,5,450,5.0,5,5,0,1,3,12,-9,8.4,7.4,1.0,20,CL
8ce063f9,4,233,2.6,3,0,1,1,2,5,-3,1.4,4.2,-2.8,20,CL
8ce30c57,5,286,3.2,3,3,2,0,2,6,-4,4.0,4.4,-0.5,20,CL
8d78e732,10,886,9.8,10,9,0,1,39,7,32,31.9,9.1,22.8,20,CL
8da74c05,2,9,0.1,0,0,2,0,0,0,0,0.1,0.5,-0.4,20,CL
8e034340,3,129,1.4,1,0,2,0,1,1,0,2.1,3.2,-1.1,20,CL
8e7f49d3,6,540,6.0,6,6,0,0,7,9,-2,6.1,9.5,-3.3,20,CL
8ea2c099,1,90,1.0,1,1,0,4,1,3,-2,0.9,1.3,-0.4,20,CL
8f21b7bd,2,15,0.2,0,0,2,1,0,1,-1,0.0,0.3,-0.3,20,CL
8f5bfaac,1,7,0.1,0,0,1,2,0,1,-1,0.0,0.9,-0.9,20,CL
8f5e92a6,5,330,3.7,4,2,1,1,11,3,8,8.8,4.4,4.4,20,CL
8f62b6ee,4,360,4.0,4,4,0,0,4,13,-9,5.1,6.0,-1.0,20,CL
8f696594,8,590,6.6,8,3,0,0,10,10,0,8.5,13.0,-4.5,20,CL
8ff2354e,7,516,5.7,6,4,1,1,9,3,6,7.9,6.4,1.5,20,CL
903b6e8b,6,540,6.0,6,6,0,0,8,14,-6,7.9,12.1,-4.3,20,CL
90f87966,4,360,4.0,4,4,0,1,3,10,-7,6.0,5.8,0.2,20,CL
9139bb12,5,368,4.1,4,1,1,0,4,10,-6,4.8,10.3,-5.5,20,CL
91e58f66,1,65,0.7,1,0,0,0,0,2,-2,0.1,2.2,-2.1,20,CL
921f6058,7,571,6.3,6,6,1,1,15,9,6,13.6,11.1,2.4,20,CL
92432bc6,7,271,3.0,2,1,5,3,6,4,2,6.6,4.5,2.0,20,CL
92e7e919,6,365,4.1,4,2,2,0,13,9,4,10.3,3.7,6.6,20,CL
934e1968,5,389,4.3,5,1,0,1,12,9,3,8.8,9.6,-0.8,20,CL
935e6b8f,6,511,5.7,6,2,0,1,8,8,0,10.8,5.9,4.9,20,CL
9413b19f,6,540,6.0,6,6,0,2,11,4,7,12.0,8.2,3.8,20,CL
94b2001f,6,471,5.2,5,5,1,1,7,4,3,6.0,8.8,-2.8,20,CL
952e0df2,2,20,0.2,0,0,2,2,0,1,-1,0.1,1.7,-1.6,20,CL
9591723b,1,9,0.1,0,0,1,0,0,2,-2,0.0,1.5,-1.5,20,CL
96094cbc,6,402,4.5,4,1,2,0,7,5,2,5.1,6.4,-1.3,20,CL
9674002f,8,450,5.0,6,3,2,0,5,13,-8,7.7,8.9,-1.2,20,CL
9744ff80,9,406,4.5,5,1,4,2,12,3,9,10.8,3.2,7.7,20,CL
9778d8dd,1,2,0.0,0,0,1,3,0,0,0,0.0,0.1,-0.1,20,CL
980522ec,5,298,3.3,2,2,3,1,8,8,0,5.3,5.5,-0.2,20,CL
984a5a64,1,90,1.0,1,1,0,1,1,3,-2,1.0,2.9,-1.9,20,CL
98d2c2c4,8,668,7.4,8,6,0,1,16,15,1,13.5,16.7,-3.2,20,CL
997fff07,2,135,1.5,1,1,1,5,3,2,1,1.7,2.9,-1.2,20,CL
9a1f2e1c,1,72,0.8,1,0,0,6,1,2,-1,0.4,2.3,-1.9,20,CL
9a2e0ccc,9,522,5.8,5,3,4,1,11,8,3,12.4,7.8,4.6,20,CL
9ae9eaea,7,507,5.6,6,4,1,0,8,6,2,7.4,12.6,-5.3,20,CL
9d12e142,8,720,8.0,8,8,0,0,10,11,-1,14.4,13.1,1.4,20,CL
9d40ca9c,6,540,6.0,6,6,0,0,4,10,-6,9.4,12.2,-2.8,20,CL
9d60028d,5,337,3.7,4,2,1,1,6,6,0,5.9,7.3,-1.4,20,CL
9d689a5b,6,423,4.7,5,1,1,0,6,12,-6,6.1,9.6,-3.5,20,CL
9e1035f8,6,478,5.3,5,2,1,2,10,13,-3,12.2,10.1,2.0,20,CL
9e1577aa,4,219,2.4,3,0,1,1,5,4,1,4.9,5.1,-0.2,20,CL
9efa1d25,4,74,0.8,1,0,3,4,1,2,-1,2.4,1.2,1.2,20,CL
9f8e9423,8,720,8.0,8,8,0,0,16,12,4,16.6,13.7,2.8,20,CL
9f936061,1,9,0.1,0,0,1,1,0,0,0,0.1,0.0,0.1,20,CL
a022e78c,6,540,6.0,6,6,0,0,3,20,-17,4.0,19.8,-15.8,20,CL
a0b4bb3e,4,270,3.0,3,0,1,3,7,4,3,7.4,6.8,0.7,20,CL
a167537f,7,490,5.4,5,4,2,0,8,8,0,10.5,10.2,0.3,20,CL
a179d516,2,180,2.0,2,2,0,6,1,7,-6,2.1,6.2,-4.1,20,CL
a190d597,7,456,5.1,6,2,1,0,6,6,0,7.3,5.1,2.2,20,CL
a29b1131,1,90,1.0,1,1,0,0,0,1,-1,1.1,2.1,-1.0,20,CL
a2abe631,6,540,6.0,6,6,0,0,1,14,-13,4.2,16.4,-12.2,20,CL
a39bb753,6,454,5.0,6,1,0,0,9,6,3,11.1,7.1,4.0,20,CL
a3b0ed18,5,450,5.0,5,5,0,0,4,9,-5,6.0,9.9,-4.0,20,CL
a45eac1f,5,208,2.3,2,0,3,0,3,5,-2,2.7,3.6,-0.9,20,CL
a4effc55,5,286,3.2,3,3,2,3,5,4,1,5.0,5.5,-0.5,20,CL
a5296e55,7,519,5.8,6,3,1,1,12,8,4,9.5,9.2,0.2,20,CL
a58bb1e1,3,116,1.3,1,0,2,1,1,6,-5,1.8,4.0,-2.2,20,CL
a5db0bec,8,711,7.9,8,4,0,1,13,11,2,9.9,16.4,-6.5,20,CL
a6154613,7,567,6.3,6,4,1,0,13,12,1,9.3,15.4,-6.1,20,CL
a634b9d2,1,90,1.0,1,1,0,3,1,2,-1,0.3,2.7,-2.3,20,CL
a65ce836,2,178,2.0,2,1,0,0,2,3,-1,1.8,2.6,-0.8,20,CL
a6951bf8,6,429,4.8,5,3,1,0,7,7,0,6.9,9.9,-3.0,20,CL
a69e4806,7,412,4.6,5,1,2,0,4,3,1,8.1,5.7,2.4,20,CL
a7a9d95a,2,113,1.3,1,0,1,1,2,0,2,4.8,0.5,4.3,20,CL
a8542814,6,265,2.9,3,1,3,1,3,2,1,3.4,1.6,1.8,20,CL
a8741470,1,90,1.0,1,1,0,1,0,0,0,1.7,0.6,1.1,20,CL
a8f21b9f,1,84,0.9,1,0,0,3,1,1,0,1.3,1.7,-0.4,20,CL
a99138af,1,4,0.0,0,0,1,6,0,0,0,0.5,0.0,0.5,20,CL
a9aa0d1d,4,360,4.0,4,4,0,0,2,8,-6,4.1,8.6,-4.6,20,CL
a9dc785c,1,90,1.0,1,1,0,8,2,1,1,1.5,1.7,-0.2,20,CL
aad56ca3,1,8,0.1,0,0,1,0,0,1,-1,0.0,0.1,-0.1,20,CL
aad9c3f3,3,84,0.9,1,0,2,2,2,2,0,1.9,3.1,-1.2,20,CL
ab77f2d9,5,312,3.5,4,1,1,0,1,12,-11,1.4,10.3,-8.9,20,CL
abe66106,5,232,2.6,2,2,3,0,5,6,-1,5.0,2.1,2.9,20,CL
ac3fb1be,5,364,4.0,4,4,1,0,7,7,0,8.4,8.4,-0.1,20,CL
ac4003af,2,180,2.0,2,2,0,7,5,5,0,3.2,5.0,-1.8,20,CL
ac73ec79,10,698,7.8,7,6,3,0,13,9,4,14.9,11.0,3.9,20,CL
ac7e640b,3,254,2.8,3,2,0,0,9,6,3,4.9,7.0,-2.1,20,CL
ac861941,5,311,3.5,4,2,1,3,6,8,-2,4.1,5.3,-1.2,20,CL
aca5a6f7,3,62,0.7,0,0,3,0,2,3,-1,0.9,3.9,-2.9,20,CL
ad3389d5,6,540,6.0,6,6,0,0,5,9,-4,6.7,6.8,0.0,20,CL
ad6df2d5,8,656,7.3,8,5,0,0,14,5,9,10.2,10.6,-0.4,20,CL
adfc9123,7,629,7.0,7,6,0,0,10,12,-2,10.5,14.5,-4.0,20,CL
ae44e8e2,8,666,7.4,8,5,0,2,11,16,-5,8.6,19.7,-11.100000000000001,20,CL
ae4e2852,2,180,2.0,2,2,0,2,3,0,3,1.2,2.9,-1.7,20,CL
ae59b359,6,526,5.8,6,5,0,0,4,14,-10,8.3,10.1,-1.8,20,CL
aeed5c06,2,180,2.0,2,2,0,4,2,2,0,2.9,1.8,1.1,20,CL
aef6e670,10,900,10.0,10,10,0,0,20,6,14,21.8,12.0,9.8,20,CL
b05e2dbd,6,540,6.0,6,6,0,1,12,11,1,12.1,12.2,0.0,20,CL
b088363d,1,22,0.2,0,0,1,3,0,0,0,0.0,0.6,-0.6,20,CL
b0b902c8,6,415,4.6,4,3,2,0,6,8,-2,4.3,8.3,-4.0,20,CL
b182a240,5,423,4.7,5,3,0,0,12,4,8,6.1,12.0,-5.9,20,CL
b19db005,4,136,1.5,2,0,2,1,1,0,1,3.8,1.8,2.0,20,CL
b1f4086c,6,540,6.0,6,6,0,0,10,11,-1,8.1,9.4,-1.3,20,CL
b217ef29,1,90,1.0,1,1,0,2,0,2,-2,0.7,1.8,-1.0,20,CL
b2336681,3,266,3.0,3,2,0,1,1,5,-4,4.3,4.9,-0.5,20,CL
b2bd0f6c,6,282,3.1,3,2,3,0,3,8,-5,5.5,5.1,0.3,20,CL
b34c63a5,2,34,0.4,0,0,2,3,0,2,-2,0.2,0.6,-0.4,20,CL
b35db3f6,6,316,3.5,3,2,3,0,5,7,-2,4.6,6.5,-1.9,20,CL
b3e4a674,3,255,2.8,3,1,0,3,2,10,-8,4.0,8.1,-4.1,20,CL
b400bde0,9,601,6.7,6,5,3,0,18,7,11,20.3,6.6,13.7,20,CL
b5f7d10b,5,282,3.1,3,2,2,0,6,5,1,5.5,5.0,0.5,20,CL
b66315ae,8,589,6.5,7,5,1,1,14,8,6,16.1,5.8,10.4,20,CL
b698cfc6,2,89,1.0,1,0,1,1,1,3,-2,2.7,3.3,-0.6,20,CL
b70bde8f,3,191,2.1,2,1,1,0,2,3,-1,2.6,3.0,-0.5,20,CL
b74277a0,3,225,2.5,3,2,0,1,5,5,0,2.8,6.5,-3.7,20,CL
b7481dc0,1,1,0.0,0,0,1,1,0,0,0,0.0,0.0,0.0,20,CL
b7ca5c51,6,539,6.0,6,5,0,0,9,7,2,10.0,11.3,-1.2,20,CL
b825a650,4,288,3.2,3,2,1,0,5,5,0,4.3,5.2,-0.9,20,CL
b9fbae28,4,360,4.0,4,4,0,1,7,8,-1,7.2,6.9,0.3,20,CL
ba23a904,3,252,2.8,3,2,0,3,9,9,0,6.6,3.5,3.1,20,CL
bac46a10,6,537,6.0,6,5,0,0,12,6,6,7.5,13.6,-6.1,20,CL
bb6c6331,2,59,0.7,1,0,1,3,1,5,-4,0.2,2.7,-2.5,20,CL
bc647827,4,112,1.2,1,0,3,0,1,5,-4,3.1,3.0,0.1,20,CL
bcb2ccd8,10,873,9.7,10,9,0,0,14,12,2,15.6,12.8,2.8,20,CL
bd142efb,5,450,5.0,5,5,0,1,5,7,-2,4.5,5.9,-1.4,20,CL
bd20f4eb,2,27,0.3,0,0,2,1,0,1,-1,0.1,0.3,-0.3,20,CL
bd6351cd,8,570,6.3,6,6,2,1,11,7,4,15.4,4.4,11.0,20,CL
beb391dd,8,548,6.1,6,3,2,1,6,9,-3,6.8,10.9,-4.1,20,CL
bee0bab1,5,411,4.6,5,3,0,0,5,4,1,5.5,4.7,0.8,20,CL
beec76cc,6,534,5.9,6,5,0,0,4,9,-5,9.4,11.9,-2.6,20,CL
c01f247a,1,26,0.3,0,0,1,2,0,0,0,0.2,0.2,0.0,20,CL
c06d1086,5,214,2.4,2,1,3,1,1,9,-8,3.5,7.2,-3.7,20,CL
c0c7ff58,8,708,7.9,8,7,0,0,13,8,5,14.6,11.0,3.6,20,CL
c0cddebe,5,340,3.8,4,3,1,3,7,3,4,4.3,4.8,-0.5,20,CL
c14bc029,9,840,9.3,9,9,0,0,13,9,4,15.3,9.1,6.1,20,CL
c1b7847c,10,713,7.9,9,4,1,0,11,10,1,14.1,9.5,4.6,20,CL
c20bdcd7,2,180,2.0,2,2,0,1,1,4,-3,3.1,3.0,0.1,20,CL
c24544c7,3,263,2.9,3,2,0,0,3,4,-1,3.9,3.8,0.0,20,CL
c2604e3c,3,208,2.3,3,1,0,1,3,5,-2,2.7,5.0,-2.4,20,CL
c27ae377,3,102,1.1,1,0,2,0,3,1,2,1.5,0.9,0.6,20,CL
c3ee18ef,3,155,1.7,2,1,1,4,6,1,5,6.8,0.6,6.2,20,CL
c43e5e7e,6,525,5.8,6,4,0,0,8,13,-5,8.3,13.1,-4.8,20,CL
c459a650,6,540,6.0,6,6,0,0,5,20,-15,6.9,18.2,-11.3,20,CL
c47541e0,5,231,2.6,2,1,3,5,3,5,-2,3.8,2.6,1.2,20,CL
c50281a0,4,271,3.0,3,3,1,0,1,5,-4,4.3,2.6,1.7,20,CL
c50e5bba,6,505,5.6,6,5,0,0,7,7,0,6.1,8.0,-2.0,20,CL
c56dc39e,7,630,7.0,7,7,0,0,10,15,-5,12.1,16.1,-4.0,20,CL
c56ee8f7,5,450,5.0,5,5,0,1,5,16,-11,5.1,15.1,-10.1,20,CL
c63f6e46,6,278,3.1,3,1,3,0,5,9,-4,4.9,6.9,-2.0,20,CL
c691bfe2,8,631,7.0,7,6,1,0,13,11,2,13.7,8.1,5.6,20,CL
c6e5d20f,8,462,5.1,4,4,4,1,11,6,5,8.1,9.9,-1.8,20,CL
c707411f,6,540,6.0,6,6,0,1,9,5,4,11.3,6.8,4.5,20,CL
c7526c18,5,386,4.3,5,3,0,0,0,10,-10,2.6,11.4,-8.8,20,CL
c78b352d,1,21,0.2,0,0,1,4,0,0,0,0.1,0.1,0.0,20,CL
c8e65157,6,540,6.0,6,6,0,0,3,20,-17,4.0,19.8,-15.8,20,CL
c904f3d5,6,540,6.0,6,6,0,0,8,14,-6,7.9,12.1,-4.3,20,CL
c9cb972b,2,180,2.0,2,2,0,6,2,4,-2,3.6,3.0,0.6,20,CL
ca45605e,6,241,2.7,3,0,3,0,5,5,0,4.9,5.0,-0.2,20,CL
ca5828af,3,34,0.4,0,0,3,1,1,3,-2,1.0,1.3,-0.3,20,CL
ca8033cb,10,809,9.0,9,8,1,0,14,12,2,17.0,11.7,5.3,20,CL
cbbfa2e7,4,202,2.2,2,1,2,0,2,3,-1,2.1,4.7,-2.6,20,CL
cc700722,6,445,4.9,5,4,1,1,8,3,5,8.4,6.7,1.7,20,CL
cc86b9a3,8,520,5.8,6,3,2,1,20,3,17,19.4,5.9,13.5,20,CL
cc96d422,3,22,0.2,0,0,3,2,0,1,-1,0.1,0.9,-0.8,20,CL
cce181df,5,405,4.5,5,4,0,0,9,9,0,8.1,9.3,-1.2,20,CL
cd1acf9d,7,583,6.5,6,6,1,0,10,10,0,13.0,7.0,5.9,20,CL
ce30bfc8,4,220,2.4,2,2,2,0,5,2,3,5.2,3.0,2.3,20,CL
ce4246f5,7,612,6.8,7,6,0,1,12,12,0,15.4,8.9,6.4,20,CL
ce9e8024,2,165,1.8,1,1,1,4,2,5,-3,2.5,3.2,-0.7,20,CL
cea4ee8f,7,516,5.7,7,1,0,0,16,12,4,11.5,7.3,4.2,20,CL
ceb30355,2,173,1.9,2,1,0,4,1,2,-1,2.5,4.2,-1.7,20,CL
cf007308,5,106,1.2,1,0,4,3,2,0,2,4.3,0.8,3.5,20,CL
cf182add,6,540,6.0,6,6,0,0,8,13,-5,8.3,13.1,-4.8,20,CL
cf2a6ace,4,13,0.1,0,0,4,2,0,0,0,0.3,0.5,-0.3,20,CL
d04b94db,7,630,7.0,7,7,0,0,10,12,-2,10.5,14.5,-4.0,20,CL
d072a976,6,361,4.0,4,3,2,0,1,10,-9,3.2,11.1,-7.9,20,CL
d0b6129f,6,540,6.0,6,6,0,0,5,20,-15,6.9,18.2,-11.3,20,CL
d0d8dd44,6,540,6.0,6,6,0,0,10,9,1,10.0,10.3,-0.3,20,CL
d125f22f,4,173,1.9,2,0,2,1,1,5,-4,3.2,4.8,-1.6,20,CL
d2110326,5,309,3.4,4,2,1,1,4,6,-2,4.6,6.4,-1.8,20,CL
d2416c2e,8,576,6.4,6,6,2,1,8,9,-1,10.5,10.8,-0.3,20,CL
d248cd8f,8,659,7.3,8,6,0,1,13,10,3,12.9,8.7,4.2,20,CL
d3de9af0,5,323,3.6,3,2,2,0,4,8,-4,5.7,7.7,-2.0,20,CL
d4232ba9,5,450,5.0,5,5,0,0,3,9,-6,8.4,10.8,-2.3,20,CL
d436eb94,6,540,6.0,6,6,0,0,4,12,-8,7.4,10.4,-3.0,20,CL
d4e93bab,4,138,1.5,1,0,3,0,2,0,2,1.5,1.9,-0.3,20,CL
d504b3e1,8,328,3.6,3,1,5,1,5,4,1,5.0,5.5,-0.5,20,CL
d5c04323,6,540,6.0,6,6,0,0,4,11,-7,6.0,13.1,-7.0,20,CL
d5f2f82b,11,969,10.8,11,10,0,0,24,6,18,25.6,12.0,13.6,20,CL
d6a889ea,2,148,1.6,1,1,1,0,3,2,1,2.4,3.2,-0.8,20,CL
d6e53a3a,6,540,6.0,6,6,0,0,10,5,5,8.8,6.3,2.5,20,CL
d70ce98e,8,662,7.4,7,7,1,0,13,13,0,12.5,14.5,-2.0,20,CL
d72f8d9e,3,270,3.0,3,3,0,0,2,5,-3,3.9,4.7,-0.7,20,CL
d7553721,5,330,3.7,4,1,1,1,5,6,-1,5.0,5.9,-0.9,20,CL
d75f3980,3,270,3.0,3,3,0,0,3,10,-7,2.7,9.9,-7.2,20,CL
d781d855,8,713,7.9,8,7,0,3,28,4,24,26.4,7.5,19.0,20,CL
d7c09951,5,450,5.0,5,5,0,0,4,9,-5,6.0,9.9,-4.0,20,CL
d83bbc54,8,720,8.0,8,8,0,0,13,15,-2,14.7,15.7,-1.0,20,CL
d8feae4a,4,360,4.0,4,4,0,0,0,8,-8,2.9,10.9,-8.0,20,CL
d9a5d930,4,179,2.0,2,0,2,1,2,4,-2,1.9,3.6,-1.7,20,CL
da7b447d,5,450,5.0,5,5,0,2,15,5,10,11.3,6.1,5.2,20,CL
da974c7b,7,630,7.0,7,7,0,0,12,7,5,14.2,9.4,4.8,20,CL
dad4b285,5,426,4.7,5,3,0,0,10,4,6,5.7,9.1,-3.4,20,CL
dae8623e,6,512,5.7,6,5,0,0,5,19,-14,6.3,17.4,-11.1,20,CL
db3cb6ee,6,540,6.0,6,6,0,0,10,13,-3,7.5,16.3,-8.8,20,CL
db4ed67b,2,30,0.3,0,0,2,6,0,1,-1,0.2,1.6,-1.4,20,CL
db750822,4,119,1.3,1,0,3,2,2,1,1,2.5,0.5,2.0,20,CL
dba67bc4,6,504,5.6,6,4,0,0,16,13,3,13.6,10.7,2.9,20,CL
dbd3a428,6,437,4.9,6,1,0,0,2,17,-15,4.2,14.9,-10.7,20,CL
dbf053da,8,644,7.2,7,3,1,0,9,9,0,12.7,11.3,1.4,20,CL
dc008610,3,162,1.8,2,1,1,1,0,5,-5,1.5,4.9,-3.4,20,CL
dc29b608,1,27,0.3,0,0,1,9,2,0,2,2.4,0.2,2.2,20,CL
dc3fa3b5,7,489,5.5,6,4,1,1,10,9,1,10.8,7.9,2.9,20,CL
dc62b55d,2,81,0.9,0,0,2,4,2,1,1,3.0,1.4,1.6,20,CL
dda3969e,2,42,0.5,0,0,2,1,0,0,0,0.9,0.2,0.7,20,CL
de39485a,1,90,1.0,1,1,0,2,1,2,-1,1.1,0.9,0.2,20,CL
dea698d9,8,711,7.9,8,7,0,0,13,6,7,11.3,10.8,0.4,20,CL
df69b544,9,653,7.3,7,2,2,0,12,10,2,11.0,13.4,-2.4,20,CL
dff153a4,6,370,4.1,4,1,2,2,14,1,13,13.1,3.2,9.8,20,CL
e0314d87,4,217,2.4,4,0,0,2,2,6,-4,4.3,5.5,-1.2,20,CL
e06683ca,8,750,8.3,8,8,0,0,15,12,3,16.2,8.8,7.4,20,CL
e07c2923,6,457,5.1,6,2,0,0,4,7,-3,7.4,8.9,-1.5,20,CL
e0900238,1,10,0.1,0,0,1,1,0,0,0,0.6,0.1,0.5,20,CL
e0921a4f,8,311,3.5,3,1,5,0,7,3,4,5.8,3.4,2.4,20,CL
e0bc6fdc,3,199,2.2,2,2,1,2,3,6,-3,3.8,4.0,-0.2,20,CL
e162b013,5,450,5.0,5,5,0,0,12,4,8,11.6,6.6,5.0,20,CL
e1cbb531,1,45,0.5,0,0,1,0,0,0,0,1.0,0.0,1.0,20,CL
e204ec12,4,303,3.4,4,1,0,1,1,7,-6,2.7,9.8,-7.2,20,CL
e26f559f,6,539,6.0,6,5,0,0,1,14,-13,4.1,16.4,-12.3,20,CL
e2716bd0,4,127,1.4,1,0,3,3,1,1,0,4.3,0.6,3.7,20,CL
e280527c,9,805,8.9,9,7,0,1,13,10,3,14.2,11.8,2.4,20,CL
e288d4b3,1,12,0.1,0,0,1,0,0,1,-1,0.6,0.4,0.2,20,CL
e2dde94c,4,209,2.3,3,1,1,1,2,5,-3,1.4,5.1,-3.6,20,CL
e33c06cf,6,334,3.7,2,2,4,0,17,2,15,10.5,4.1,6.4,20,CL
e342ad68,8,730,8.1,8,6,0,0,15,12,3,16.1,8.8,7.3,20,CL
e34fc66d,6,392,4.4,4,3,2,4,7,4,3,4.8,8.9,-4.1,20,CL
e3cceee6,1,90,1.0,1,1,0,6,2,0,2,0.9,2.2,-1.3,20,CL
e3d0b0c4,10,725,8.1,8,8,2,0,9,11,-2,10.1,13.8,-3.7,20,CL
e40d028b,1,90,1.0,1,1,0,7,2,0,2,0.9,2.2,-1.3,20,CL
e42d61c7,8,707,7.9,8,5,0,0,10,11,-1,14.4,12.8,1.6,20,CL
e46012d4,7,571,6.3,7,4,0,1,14,8,6,16.4,7.0,9.4,20,CL
e599253a,9,690,7.7,7,4,2,0,16,11,5,16.2,12.3,3.9,20,CL
e5bf73f3,1,3,0.0,0,0,1,4,0,0,0,0.1,0.0,0.1,20,CL
e613313c,2,109,1.2,1,1,1,4,2,1,1,1.7,3.8,-2.1,20,CL
e6bc67d7,3,198,2.2,2,1,1,1,2,9,-7,5.1,4.3,0.8,20,CL
e6eadfb8,5,393,4.4,4,4,1,0,7,5,2,6.3,4.9,1.3,20,CL
e7986081,10,625,6.9,6,6,4,0,10,9,1,9.4,10.7,-1.3,20,CL
e81f0356,4,360,4.0,4,4,0,2,8,8,0,6.7,10.2,-3.5,20,CL
e8ed3abc,3,137,1.5,1,0,2,1,1,2,-1,1.9,3.0,-1.1,20,CL
e9971f2d,1,90,1.0,1,1,0,2,0,3,-3,0.3,0.9,-0.6,20,CL
e9c0c1b2,6,540,6.0,6,6,0,0,12,6,6,7.5,13.8,-6.3,20,CL
eb2fe5b6,6,220,2.4,2,0,4,3,3,6,-3,4.5,5.5,-1.1,20,CL
eb58eef0,8,552,6.1,5,3,3,0,12,11,1,13.7,6.8,6.8,20,CL
ebc56869,1,44,0.5,1,0,0,0,1,0,1,0.6,0.7,-0.1,20,CL
ecada4fc,9,798,8.9,9,8,0,1,15,6,9,16.9,11.0,5.9,20,CL
ed1e53f3,5,253,2.8,3,1,2,2,11,3,8,9.9,2.6,7.4,20,CL
ed2b33cb,2,73,0.8,1,0,1,3,2,1,1,0.9,1.4,-0.5,20,CL
ed87a229,5,356,4.0,5,2,0,0,3,6,-3,4.2,7.8,-3.5,20,CL
ed9f7cfe,9,759,8.4,9,6,0,0,11,8,3,12.9,8.5,4.4,20,CL
ee3519f5,6,539,6.0,6,5,0,0,6,13,-7,7.3,13.1,-5.8,20,CL
ee8508c0,9,840,9.3,9,9,0,0,13,9,4,15.3,9.1,6.1,20,CL
ee926a02,6,517,5.7,6,5,0,0,10,12,-2,7.4,15.6,-8.2,20,CL
ee93c1a9,6,263,2.9,3,0,3,1,4,1,3,4.3,3.0,1.2,20,CL
ee950928,6,471,5.2,6,1,0,0,8,8,0,6.6,10.3,-3.7,20,CL
eed332df,3,188,2.1,2,1,1,1,0,5,-5,1.0,6.6,-5.6,20,CL
ef619b0b,6,202,2.2,2,0,4,0,3,2,1,4.2,2.6,1.6,20,CL
ef9c1c95,5,403,4.5,5,2,0,0,3,8,-5,7.5,6.4,1.1,20,CL
f0021247,4,353,3.9,4,2,0,0,4,6,-2,5.0,8.6,-3.6,20,CL
f00de885,10,900,10.0,10,10,0,0,14,14,0,12.7,18.4,-5.7,20,CL
f0661424,6,538,6.0,6,5,0,0,12,6,6,7.4,13.8,-6.4,20,CL
f0da930c,5,299,3.3,4,3,1,2,6,4,2,6.8,3.3,3.5,20,CL
f0f7f62f,7,630,7.0,7,7,0,0,12,13,-1,14.5,13.9,0.6,20,CL
f0fc9d0e,5,341,3.8,4,2,1,1,2,8,-6,4.0,8.4,-4.4,20,CL
f25c8e3a,4,250,2.8,3,1,1,1,8,2,6,7.3,2.6,4.7,20,CL
f2d063ec,5,412,4.6,5,3,0,1,3,14,-11,4.4,13.8,-9.3,20,CL
f315ca93,6,540,6.0,6,6,0,0,8,14,-6,7.9,12.1,-4.3,20,CL
f3600c02,3,120,1.3,1,1,2,3,1,3,-2,0.8,2.7,-1.9,20,CL
f4290206,5,397,4.4,5,3,0,0,4,8,-4,7.6,5.8,1.8,20,CL
f520049f,2,91,1.0,1,1,1,2,1,4,-3,2.5,1.8,0.8,20,CL
f586779e,8,566,6.3,7,3,1,0,10,11,-1,14.0,8.0,6.0,20,CL
f5ba8903,1,7,0.1,0,0,1,0,0,0,0,0.1,0.0,0.1,20,CL
f5c8b425,6,371,4.1,4,1,2,0,2,7,-5,5.1,7.0,-1.9,20,CL
f5dfc256,1,19,0.2,0,0,1,5,1,0,1,0.2,0.4,-0.2,20,CL
f6ac68c1,4,390,4.3,4,4,0,1,7,6,1,5.6,5.8,-0.2,20,CL
f7036e1c,6,520,5.8,6,4,0,0,9,9,0,9.7,10.2,-0.5,20,CL
f76e6b4e,3,300,3.3,3,3,0,5,6,8,-2,6.7,4.4,2.3,20,CL
f7d50789,6,540,6.0,6,6,0,1,9,18,-9,8.3,10.1,-1.8,20,CL
f81ef10d,3,270,3.0,3,3,0,3,4,6,-2,3.8,8.3,-4.5,20,CL
f833a830,7,516,5.699999999999999,6,4,1,1,16,14,2,13.7,11.6,2.1,20,CL
f9acca3a,4,350,3.9,4,3,0,1,5,5,0,4.0,4.2,-0.2,20,CL
f9e0c603,1,90,1.0,1,1,0,5,0,4,-4,1.8,3.0,-1.2,20,CL
fa18c72e,6,277,3.1,3,0,3,0,2,7,-5,3.2,5.0,-1.8,20,CL
fa274d97,3,225,2.5,3,2,0,2,3,6,-3,4.8,4.7,0.1,20,CL
fc46aab1,1,10,0.1,0,0,1,0,0,1,-1,0.1,1.5,-1.4,20,CL
fc4f85b1,5,450,5.0,5,5,0,1,9,8,1,8.6,9.3,-0.7,20,CL
fc62f087,3,111,1.2,1,1,2,7,8,0,8,6.0,0.4,5.7,20,CL
fcb38f57,6,521,5.8,6,5,0,0,3,14,-11,8.5,9.6,-1.1,20,CL
fd51b456,4,102,1.1,1,0,3,1,1,3,-2,2.3,2.0,0.3,20,CL
fdd60087,2,180,2.0,2,2,0,5,3,2,1,5.0,2.4,2.6,20,CL
fdf3cb77,6,540,6.0,6,6,0,0,4,10,-6,9.4,12.2,-2.8,20,CL
fe2db476,6,362,4.0,4,3,2,1,4,6,-2,4.5,6.8,-2.3,20,CL
fe641c1a,3,244,2.7,3,2,0,1,2,1,1,4.4,2.5,1.9,20,CL
fed17f5a,5,392,4.4,4,3,1,0,7,11,-4,8.6,9.1,-0.5,20,CL
fed7cb61,5,432,4.8,5,3,0,0,3,7,-4,5.9,4.6,1.3,20,CL
ff0ab48c,9,755,8.4,9,5,0,0,10,11,-1,10.7,12.4,-1.7,20,CL
ff579c7e,5,415,4.6,5,3,0,0,8,9,-1,6.4,10.0,-3.7,20,CL
0000acda,18,980,10.9,10,6,8,12,16,12,4,13.3,13.6,-0.3,20,ITA
008a6e6d,31,2354,26.2,26,24,5,3,35,41,-6,30.7,43.1,-12.3,20,ITA
00b0bb87,16,1153,12.8,14,10,2,2,26,17,9,14.6,22.5,-7.9,20,ITA
016ff750,6,323,3.6,3,0,3,14,5,5,0,6.7,3.6,3.2,20,ITA
01b8a2b2,29,2591,28.8,29,28,0,7,57,33,24,51.4,35.9,15.5,20,ITA
01efac19,24,1563,17.4,16,15,8,13,28,40,-12,28.2,38.4,-10.2,20,ITA
023937a9,19,1318,14.6,15,12,4,4,14,30,-16,18.3,24.1,-5.8,20,ITA
02b2937c,24,1869,20.8,22,13,2,0,22,40,-18,23.4,39.3,-16.0,20,ITA
02caf6e0,32,2548,28.3,29,19,3,4,52,33,19,48.7,38.1,10.7,20,ITA
0375723e,33,2073,23.0,26,5,7,0,30,41,-11,28.4,38.5,-10.1,20,ITA
03f946ed,36,3032,33.7,33,30,3,0,24,62,-38,36.8,60.4,-23.5,20,ITA
0489bb30,17,680,7.6,7,0,10,6,8,8,0,9.3,12.4,-3.1,20,ITA
04989945,4,165,1.8,2,1,2,10,3,5,-2,3.7,2.6,1.1,20,ITA
04df29a5,1,9,0.1,0,0,1,5,1,0,1,0.1,0.1,0.1,20,ITA
05e19d6a,35,2904,32.3,33,25,2,2,57,37,20,55.2,38.1,17.2,20,ITA
060606ec,15,781,8.7,10,1,5,1,9,15,-6,7.0,15.7,-8.7,20,ITA
0728bebe,33,2673,29.7,31,18,2,1,36,37,-1,40.0,36.8,3.1,20,ITA
07767f42,22,1397,15.5,15,12,7,11,22,26,-4,17.3,28.1,-10.9,20,ITA
07abb358,23,1743,19.3,19,13,4,2,18,38,-20,23.7,35.800000000000004,-12.2,20,ITA
0821331c,27,2207,24.5,26,21,1,2,36,40,-4,36.8,32.7,4.0,20,ITA
085e71a7,31,2790,31.0,31,31,0,2,36,43,-7,41.3,39.3,2.0,20,ITA
089550f5,8,639,7.1,7,6,1,15,15,5,10,11.7,6.8,4.9,20,ITA
08990838,11,328,3.6,1,1,10,23,6,8,-2,6.0,6.3,-0.3,20,ITA
08aa9cd1,32,2236,24.8,23,11,9,3,34,49,-15,30.5,37.0,-6.6,20,ITA
08f5afaa,36,3201,35.6,36,35,0,0,59,42,17,59.1,39.9,19.2,20,ITA
091795f2,2,122,1.4,1,1,1,35,0,5,-5,1.7,2.7,-0.9,20,ITA
09538fdb,36,2569,28.5,28,16,8,1,27,39,-12,31.1,39.8,-8.7,20,ITA
0a3065c8,13,1006,11.2,12,9,1,0,18,19,-1,18.1,15.1,3.0,20,ITA
0a447501,24,1387,15.4,16,5,8,7,20,34,-14,18.5,24.1,-5.6,20,ITA
0a483542,26,1643,18.3,17,14,9,10,28,30,-2,27.0,31.5,-4.5,20,ITA
0ab1f153,33,2654,29.5,28,26,5,3,60,26,34,58.2,31.6,26.7,20,ITA
0b5a292a,24,1966,21.8,22,18,2,9,39,35,4,36.5,27.3,9.2,20,ITA
0c35d28d,2,3,0.0,0,0,2,5,0,0,0,0.8,0.0,0.8,20,ITA
0ccac09c,36,3168,35.2,36,34,0,1,31,68,-37,39.9,68.4,-28.5,20,ITA
0cd0e21b,13,396,4.4,1,0,12,13,9,4,5,8.0,5.9,2.1,20,ITA
0d077b88,17,925,10.3,10,7,7,12,19,23,-4,15.9,16.6,-0.7,20,ITA
0d422df7,35,3150,35.0,35,35,0,3,43,43,0,45.7,50.0,-4.2,20,ITA
0d82903c,29,2385,26.5,27,24,2,3,48,31,17,52.0,32.8,19.3,20,ITA
0db169ae,35,3014,33.5,34,28,1,0,32,61,-29,38.8,64.5,-25.7,20,ITA
0dfce079,3,270,3.0,3,3,0,32,4,8,-4,4.8,3.8,1.0,20,ITA
0e21fc3c,19,931,10.3,9,5,10,18,25,8,17,19.9,10.6,9.4,20,ITA
0f47717b,2,180,2.0,2,2,0,36,2,4,-2,0.8,4.0,-3.2,20,ITA
103b7264,2,78,0.9,0,0,2,0,1,1,0,0.8,0.9,-0.1,20,ITA
1079c685,19,664,7.4,6,2,13,11,8,24,-16,8.3,15.0,-6.7,20,ITA
10dc46f0,36,3240,36.0,36,36,0,2,43,64,-21,42.0,57.7,-15.7,20,ITA
10e7f486,15,1015,11.3,12,3,3,7,21,14,7,13.8,15.9,-2.0,20,ITA
1253a12e,3,204,2.3,2,2,1,2,2,4,-2,3.0,3.7,-0.7,20,ITA
1295552e,24,1273,14.1,13,8,11,14,34,27,7,22.9,24.4,-1.5,20,ITA
130a7a3f,22,1209,13.4,16,4,6,6,23,13,10,20.7,13.8,6.9,20,ITA
13f89eaa,8,389,4.3,4,0,4,28,3,9,-6,5.5,7.5,-2.1,20,ITA
144607cc,36,3073,34.2,34,29,2,0,39,53,-14,45.4,60.2,-14.9,20,ITA
149c5f5d,23,1029,11.4,9,6,14,14,15,20,-5,13.799999999999999,20.3,-6.5,20,ITA
14b8fcdf,10,690,7.7,7,7,3,27,11,15,-4,15.3,9.5,5.8,20,ITA
157d29b6,18,824,9.2,7,3,11,1,15,19,-4,15.8,18.9,-3.1,20,ITA
15d0c248,26,2024,22.5,24,17,2,5,48,23,25,42.6,31.8,10.9,20,ITA
162efffd,34,2822,31.4,33,26,1,0,32,43,-11,35.3,44.9,-9.6,20,ITA
16569fef,25,2152,23.9,24,21,1,0,20,44,-24,26.6,40.4,-13.8,20,ITA
16657b95,26,1616,18.0,18,13,8,0,43,31,12,38.7,24.6,14.0,20,ITA
16b9d5cf,22,1799,20.0,20,18,2,8,33,24,9,34.0,22.4,11.6,20,ITA
16bb656a,15,693,7.7,7,4,8,9,11,7,4,13.3,9.2,4.2,20,ITA
173061c0,32,2604,28.9,31,22,1,3,48,41,7,37.3,46.2,-8.9,20,ITA
1770bd68,32,2453,27.3,30,15,2,1,22,33,-11,29.7,36.4,-6.7,20,ITA
17f3620a,18,1183,13.1,14,7,4,3,9,16,-7,18.2,13.3,4.9,20,ITA
18736214,1,90,1.0,1,1,0,37,1,1,0,1.3,0.6,0.7,20,ITA
1880614f,18,873,9.7,10,2,8,11,20,18,2,22.0,13.3,8.7,20,ITA
18f9dbd0,20,686,7.6,6,2,14,12,10,18,-8,9.4,12.2,-2.8,20,ITA
197640fd,27,1769,19.7,19,16,8,7,47,24,23,37.8,22.2,15.6,20,ITA
19e4eab9,29,2213,24.6,24,21,5,6,23,34,-11,25.0,38.6,-13.6,20,ITA
1ab6fad3,4,63,0.7,0,0,4,7,1,2,-1,1.6,1.2,0.4,20,ITA
1b82f8df,21,1387,15.4,15,11,6,2,21,34,-13,16.8,25.7,-8.9,20,ITA
1cac99dc,12,337,3.7,3,0,9,7,6,6,0,6.4,9.4,-3.0,20,ITA
1cadaf34,1,17,0.2,0,0,1,9,0,1,-1,0.4,0.1,0.4,20,ITA
1d00a56c,2,52,0.6,1,0,1,8,2,0,2,0.8,1.2,-0.3,20,ITA
1d0bb7e4,7,280,3.1,3,1,4,6,7,3,4,5.4,3.3,2.1,20,ITA
1e12c53b,24,1270,14.1,13,9,11,6,11,32,-21,15.1,28.0,-12.9,20,ITA
1ea5f91c,30,2095,23.3,25,11,5,5,35,40,-5,32.3,33.4,-1.1,20,ITA
1eeeff8a,14,768,8.5,8,3,6,10,15,21,-6,15.1,20.4,-5.4,20,ITA
1f9328da,26,2071,23.0,25,13,1,0,36,34,2,28.6,36.7,-8.2,20,ITA
1fca9171,20,1082,12.0,13,4,7,5,11,27,-16,15.3,23.6,-8.3,20,ITA
20730eae,31,1404,15.6,12,5,19,7,30,21,9,26.8,21.3,5.5,20,ITA
20b3a502,16,699,7.8,7,1,9,4,8,11,-3,8.0,10.6,-2.7,20,ITA
20b9f052,32,2880,32.0,32,32,0,2,69,45,24,64.2,39.6,24.6,20,ITA
2146785a,25,1622,18.0,16,10,9,9,30,20,10,28.2,18.1,10.1,20,ITA
217875a4,14,1165,12.9,13,10,1,22,10,19,-9,12.5,21.6,-9.1,20,ITA
22051fbe,20,1760,19.6,20,18,0,1,28,45,-17,29.6,42.2,-12.6,20,ITA
228f73ae,9,176,2.0,1,0,8,19,3,1,2,3.7,2.3,1.3,20,ITA
230a2fac,33,2970,33.0,33,33,0,4,50,44,6,52.9,40.8,12.1,20,ITA
2334478a,16,1252,13.9,15,9,1,2,18,24,-6,20.5,21.4,-1.0,20,ITA
244f57b9,24,1177,13.1,14,4,10,12,21,15,6,21.0,16.3,4.7,20,ITA
246d153b,32,2079,23.1,20,12,12,5,35,39,-4,30.2,34.7,-4.5,20,ITA
263b855a,1,1,0.0,0,0,1,16,0,0,0,0.0,0.1,-0.1,20,ITA
26db8853,20,1139,12.7,12,6,8,17,15,15,0,14.6,17.7,-3.2,20,ITA
282b3a4d,13,313,3.5,2,0,11,15,3,5,-2,4.2,5.4,-1.2,20,ITA
28a15394,1,90,1.0,1,1,0,37,1,1,0,1.9,0.9,1.0,20,ITA
2990c466,16,1026,11.4,10,8,6,22,20,15,5,17.1,16.6,0.5,20,ITA
2a1beb34,35,2721,30.2,29,27,6,1,82,41,41,69.1,34.6,34.5,20,ITA
2b15a82a,4,80,0.9,0,0,4,10,1,1,0,1.2,1.0,0.2,20,ITA
2c0f8e9e,22,923,10.3,10,4,12,4,31,9,22,23.7,11.3,12.4,20,ITA
2c3a6c21,33,2440,27.1,28,19,5,1,36,64,-28,39.1,62.3,-23.2,20,ITA
2c851997,26,1392,15.5,19,3,7,9,19,30,-11,19.4,21.9,-2.5,20,ITA
2cfae697,19,1082,12.0,13,6,6,12,19,23,-4,19.1,19.8,-0.7,20,ITA
2d970560,34,2617,29.1,31,17,3,3,78,36,42,64.5,30.7,33.8,20,ITA
2e3596d1,3,97,1.1,1,0,2,10,0,2,-2,1.2,2.3,-1.1,20,ITA
2ead2809,25,1784,19.8,20,13,5,1,30,47,-17,30.1,46.7,-16.6,20,ITA
2f3452eb,20,1481,16.5,17,11,3,14,24,17,7,21.3,15.7,5.6,20,ITA
2f557579,37,2810,31.2,34,18,3,1,49,44,5,50.1,39.3,10.9,20,ITA
2f7407fa,1,3,0.0,0,0,1,10,1,0,1,0.8,0.1,0.7,20,ITA
30223b33,5,450,5.0,5,5,0,21,5,5,0,7.3,8.6,-1.3,20,ITA
30f5ffa9,32,2627,29.2,30,27,2,2,61,30,31,52.4,30.9,21.5,20,ITA
31b252fc,1,3,0.0,0,0,1,14,0,0,0,0.0,0.0,0.0,20,ITA
32a33c68,1,9,0.1,0,0,1,1,0,0,0,0.4,0.6,-0.2,20,ITA
331c0a43,34,2798,31.1,31,27,3,3,23,61,-38,35.1,57.8,-22.6,20,ITA
33914f14,13,972,10.8,11,6,2,19,10,28,-18,15.3,22.3,-7.0,20,ITA
339c6ed4,5,225,2.5,2,1,3,26,6,5,1,6.0,4.2,1.9,20,ITA
339fe0e8,38,3420,38.0,38,38,0,0,79,42,37,68.0,51.1,16.9,20,ITA
33b8d077,32,2701,30.0,30,26,2,1,63,29,34,50.0,33.5,16.5,20,ITA
33ecf462,32,1774,19.7,22,2,10,5,30,24,6,28.2,24.7,3.6,20,ITA
343c0d52,37,2924,32.5,34,18,3,0,44,41,3,37.3,45.6,-8.3,20,ITA
343f753a,34,3060,34.0,34,34,0,0,53,53,0,43.0,57.4,-14.3,20,ITA
3535098b,15,884,9.8,10,3,5,17,17,18,-1,14.3,16.6,-2.3,20,ITA
356c9002,32,1993,22.1,24,9,8,4,51,26,25,41.0,25.4,15.6,20,ITA
35dd6d80,26,2053,22.8,24,20,2,1,28,43,-15,29.3,38.3,-9.0,20,ITA
360b2bb1,8,344,3.8,3,2,5,15,3,14,-11,4.5,8.9,-4.4,20,ITA
3626daea,24,1548,17.2,18,12,6,10,26,22,4,29.1,23.4,5.7,20,ITA
38ac43d3,12,681,7.6,9,2,3,2,10,5,5,11.0,8.4,2.7,20,ITA
39ee6cb6,28,1909,21.2,20,16,8,9,27,45,-18,29.1,49.1,-20.0,20,ITA
3b333ac3,32,2356,26.2,25,22,7,4,71,34,37,62.5,29.3,33.2,20,ITA
3b61c9ec,24,1908,21.2,22,15,2,3,34,37,-3,25.4,30.0,-4.5,20,ITA
3b8674e6,30,2196,24.4,25,17,5,4,47,27,20,49.7,27.8,21.9,20,ITA
3bb7af3b,17,1115,12.4,13,6,4,7,24,28,-4,20.8,26.099999999999998,-5.3,20,ITA
3bb7f478,35,2854,31.7,31,27,4,3,60,43,17,63.1,41.6,21.5,20,ITA
3c05c659,1,90,1.0,1,1,0,17,0,1,-1,0.8,1.4,-0.6,20,ITA
3cd3b384,17,1135,12.6,12,10,5,21,22,19,3,20.7,19.4,1.3,20,ITA
3ead85f9,35,3091,34.3,35,34,0,0,54,43,11,55.2,39.6,15.6,20,ITA
3ed84b2c,11,188,2.1,0,0,11,21,3,5,-2,5.8,3.4,2.3,20,ITA
3ef0a2d7,2,8,0.1,0,0,2,29,1,0,1,0.0,0.0,0.0,20,ITA
3effaa34,1,60,0.7,1,0,0,1,1,0,1,0.6,0.6,0.0,20,ITA
4195b8b6,11,917,10.2,10,9,1,1,9,25,-16,11.4,23.2,-11.7,20,ITA
422ec08a,25,1422,15.8,17,4,8,2,16,33,-17,21.5,35.7,-14.2,20,ITA
42b1a58a,16,963,10.700000000000001,11,8,5,19,16,22,-6,18.1,21.6,-3.5,20,ITA
43a1bea5,2,90,1.0,1,0,1,14,1,2,-1,1.6,1.8,-0.2,20,ITA
440c84ed,14,621,6.9,7,1,7,9,8,13,-5,9.0,8.3,0.7,20,ITA
4431aed2,37,3170,35.2,36,29,1,0,76,38,38,63.2,46.7,16.5,20,ITA
44510fde,20,658,7.3,7,0,13,13,5,11,-6,10.3,11.1,-0.9,20,ITA
44ac04e9,20,1282,14.2,14,10,6,3,30,13,17,23.1,15.9,7.2,20,ITA
44eb9093,22,1402,15.6,15,11,7,8,37,9,28,29.3,14.5,14.8,20,ITA
455a2b79,13,430,4.8,4,0,9,16,3,6,-3,5.3,5.5,-0.2,20,ITA
4571fa88,2,135,1.5,1,1,1,14,4,4,0,1.1,3.1,-1.9,20,ITA
45af5134,10,257,2.9,3,0,7,3,1,7,-6,3.3,6.6,-3.2,20,ITA
45b9b619,30,2002,22.2,22,11,8,1,47,26,21,40.6,30.4,10.2,20,ITA
4611e028,37,2950,32.8,32,31,5,0,46,45,1,48.4,41.3,7.1,20,ITA
46f5c54d,28,2169,24.1,23,22,5,7,18,41,-23,28.8,46.8,-18.0,20,ITA
46fa7204,13,730,8.1,8,4,5,18,9,14,-5,10.6,13.7,-3.1,20,ITA
47a500ae,26,2261,25.1,25,24,1,2,30,57,-27,29.6,61.3,-31.8,20,ITA
482145e9,18,555,6.2,6,0,12,4,5,14,-9,6.4,13.4,-7.1,20,ITA
48d5bd33,34,1535,17.1,12,4,22,2,44,19,25,38.2,17.7,20.4,20,ITA
4a56052c,33,2629,29.2,30,23,3,3,53,36,17,56.1,36.6,19.5,20,ITA
4a5a45c7,27,2097,23.3,26,12,1,0,48,30,18,43.2,31.3,11.9,20,ITA
4a6914ff,10,900,10.0,10,10,0,28,5,29,-24,7.9,17.4,-9.5,20,ITA
4b029b31,13,784,8.7,8,7,5,21,9,22,-13,10.5,13.9,-3.4,20,ITA
4b3e1a38,36,3228,35.9,36,35,0,1,43,49,-6,47.3,50.6,-3.4,20,ITA
4c3a6744,22,1514,16.8,19,7,3,9,36,21,15,30.7,20.1,10.7,20,ITA
4c62d0c8,21,1890,21.0,21,21,0,0,30,38,-8,28.2,30.8,-2.6,20,ITA
4c78b5ed,25,1808,20.1,23,11,2,2,42,18,24,35.9,23.1,12.9,20,ITA
4cdcbc14,11,553,6.1,6,1,5,24,7,13,-6,5.9,9.4,-3.5,20,ITA
4cde5509,18,1362,15.1,16,11,2,0,34,17,17,28.4,19.9,8.6,20,ITA
4ce8f4a3,3,44,0.5,0,0,3,0,0,2,-2,0.3,1.4,-1.1,20,ITA
4e1d5e59,2,12,0.1,0,0,2,18,0,0,0,0.3,0.1,0.1,20,ITA
4e219ad2,16,1359,15.1,15,12,1,4,13,21,-8,21.4,18.6,2.7,20,ITA
4e358a2d,16,1213,13.5,14,10,2,14,29,20,9,24.7,17.5,7.2,20,ITA
4e6dbac4,37,3029,33.7,35,25,2,0,71,39,32,60.4,45.7,14.7,20,ITA
4f2908e5,23,1513,16.8,17,13,6,14,31,37,-6,23.5,28.8,-5.3,20,ITA
4fa7cb9b,23,802,8.9,7,1,16,2,28,9,19,19.2,8.7,10.5,20,ITA
5128bde4,38,3239,36.0,37,28,1,0,43,48,-5,47.2,48.4,-1.2,20,ITA
528492ea,26,1730,19.3,20,9,6,6,38,26,12,28.5,28.0,0.40000000000000036,20,ITA
5294a83f,36,3113,34.6,36,26,0,0,75,37,38,62.3,44.3,18.0,20,ITA
52ec54d0,35,3082,34.2,35,32,0,0,73,38,35,64.4,38.7,25.7,20,ITA
5313ed43,32,2249,25.0,24,14,8,6,25,30,-5,27.5,29.1,-1.7,20,ITA
536cebe5,26,1395,15.5,15,3,11,8,32,21,11,29.3,20.1,9.2,20,ITA
539230cf,7,526,5.8,5,4,2,30,18,2,16,12.6,3.9,8.8,20,ITA
53a0e358,31,2493,27.7,29,17,2,1,53,46,7,39.6,46.6,-7.0,20,ITA
53de807a,29,2306,25.6,28,18,1,0,55,25,30,44.4,30.6,13.8,20,ITA
54e53b7e,30,1256,13.9,12,2,18,7,19,27,-8,18.8,24.6,-5.8,20,ITA
5592007b,31,1684,18.7,20,9,11,4,19,43,-24,21.8,34.7,-12.9,20,ITA
563a68ad,23,1784,19.8,22,9,1,2,24,30,-6,31.6,25.7,5.9,20,ITA
56400c01,30,2442,27.1,28,22,2,5,41,42,-1,29.0,41.0,-12.0,20,ITA
56b2957b,22,1031,11.4,12,1,10,9,15,16,-1,11.399999999999999,16.7,-5.3,20,ITA
570bb4b9,31,1570,17.4,20,5,11,4,28,27,1,21.4,26.8,-5.4,20,ITA
5710a281,14,685,7.6,8,4,6,15,11,12,-1,10.1,11.4,-1.3,20,ITA
58027adc,14,1051,11.7,11,9,3,10,13,21,-8,15.5,16.1,-0.6,20,ITA
582a251c,5,423,4.7,4,4,1,32,9,9,0,6.8,11.5,-4.7,20,ITA
5832ebfe,26,2240,24.9,25,23,1,7,33,45,-12,38.4,35.9,2.5,20,ITA
585a73a8,33,2671,29.7,31,27,2,0,39,44,-5,35.8,52.6,-16.8,20,ITA
58d97e77,8,89,1.0,0,0,8,7,1,1,0,2.3,1.6,0.7,20,ITA
58e933d2,18,1216,13.5,13,9,5,2,20,26,-6,17.9,21.7,-3.8,20,ITA
599d91d0,2,4,0.0,0,0,2,17,0,0,0,0.0,0.5,-0.5,20,ITA
59be3a74,6,62,0.7,0,0,6,24,3,2,1,2.4,1.4,0.9,20,ITA
5a2cb25d,34,2919,32.4,33,22,1,0,40,46,-6,41.9,44.2,-2.2,20,ITA
5aa53281,32,2740,30.4,31,27,1,1,59,39,20,56.8,39.0,17.8,20,ITA
5aaef9ef,26,1932,21.5,22,16,4,1,29,28,1,24.6,33.7,-9.1,20,ITA
5bd72174,36,2931,32.6,33,25,3,1,60,54,6,44.8,53.5,-8.7,20,ITA
5c397195,11,384,4.3,4,0,7,5,11,6,5,7.1,5.6,1.6,20,ITA
5cec2c74,33,2201,24.5,23,20,10,4,32,52,-20,30.7,41.3,-10.5,20,ITA
5df4ef30,11,759,8.4,8,6,3,7,7,16,-9,13.0,11.0,2.0,20,ITA
5e834dce,2,120,1.3,1,1,1,4,1,3,-2,1.5,2.0,-0.5,20,ITA
5e861944,26,1002,11.200000000000001,11,1,15,8,19,13,6,17.4,12.4,5.1,20,ITA
5eae500a,36,2979,33.1,33,25,3,0,67,31,36,58.5,35.6,22.8,20,ITA
5efc5389,20,1338,14.9,14,9,6,15,15,19,-4,14.5,26.2,-11.7,20,ITA
5fa57166,1,9,0.1,0,0,1,6,0,0,0,0.0,0.1,-0.1,20,ITA
5fd5ed86,27,2270,25.2,27,21,0,9,35,42,-7,31.3,37.0,-5.8,20,ITA
6010ba04,1,9,0.1,0,0,1,19,0,0,0,0.2,0.1,0.0,20,ITA
601ef102,33,2415,26.8,28,15,5,0,26,33,-7,31.5,37.5,-6.0,20,ITA
61b3978f,28,2402,26.7,27,23,1,2,31,48,-17,32.7,43.3,-10.6,20,ITA
61f2f56a,7,143,1.6,0,0,7,8,3,3,0,2.5,2.5,0.0,20,ITA
6213fd82,25,1928,21.4,22,15,3,4,15,46,-31,23.5,37.2,-13.7,20,ITA
62437b4f,12,341,3.8,2,0,10,6,5,7,-2,4.5,7.2,-2.7,20,ITA
63071a3f,36,3053,33.9,34,32,2,1,48,50,-2,41.6,56.9,-15.4,20,ITA
649b01d8,36,3240,36.0,36,36,0,2,46,60,-14,46.0,50.6,-4.5,20,ITA
64cd167d,24,1971,21.9,22,19,2,12,29,38,-9,32.3,30.5,1.8,20,ITA
6523afa4,1,90,1.0,1,1,0,14,0,1,-1,1.2,1.3,-0.1,20,ITA
652811aa,26,2064,22.9,24,19,2,3,32,59,-27,32.5,56.9,-24.4,20,ITA
66a9470c,2,24,0.3,0,0,2,3,0,0,0,0.6,0.1,0.5,20,ITA
67f649be,17,1530,17.0,17,17,0,4,17,35,-18,20.5,29.2,-8.7,20,ITA
6817095b,11,216,2.4,0,0,11,22,0,6,-6,1.9,5.0,-3.1,20,ITA
68252d6d,26,1663,18.5,21,7,5,1,51,24,27,43.3,19.5,23.8,20,ITA
6928979a,27,2013,22.4,23,17,4,1,45,21,24,40.9,24.1,16.7,20,ITA
6a189491,18,1095,12.2,11,4,7,14,13,22,-9,13.5,20.9,-7.5,20,ITA
6aafdc27,23,1755,19.5,20,17,3,13,13,42,-29,18.7,34.5,-15.8,20,ITA
6c1f7328,17,766,8.5,8,1,9,0,11,13,-2,11.3,10.1,1.3,20,ITA
6ca663b4,15,307,3.4,1,0,14,13,8,6,2,8.3,6.1,2.2,20,ITA
6cc97b6a,16,641,7.1,6,1,10,7,10,13,-3,8.0,11.6,-3.6,20,ITA
6e058f06,11,264,2.9,2,0,9,27,4,6,-2,4.6,3.2,1.4,20,ITA
6e4df551,36,2842,31.6,34,14,2,1,83,38,45,67.2,34.9,32.2,20,ITA
6eee05f1,34,2783,30.9,32,24,2,3,77,38,39,66.1,31.6,34.5,20,ITA
6f5ead86,32,2419,26.9,27,19,5,0,38,40,-2,31.1,45.8,-14.7,20,ITA
718b8afd,22,1380,15.3,15,8,7,15,12,27,-15,14.8,31.7,-17.0,20,ITA
71dc23da,25,1717,19.1,20,14,5,10,19,40,-21,23.3,33.2,-10.0,20,ITA
72be9309,4,360,4.0,4,4,0,34,3,4,-1,5.4,6.9,-1.5,20,ITA
73ddc40c,6,405,4.5,4,4,2,9,5,6,-1,5.3,5.6,-0.2,20,ITA
74419746,35,3150,35.0,35,35,0,3,74,32,42,64.3,36.0,28.3,20,ITA
756959aa,14,698,7.8,8,4,6,4,13,18,-5,9.7,13.2,-3.4,20,ITA
75b86fb3,25,1921,21.3,21,16,4,11,51,23,28,41.9,22.8,19.1,20,ITA
75e60d75,27,1819,20.2,20,13,7,3,18,36,-18,22.6,29.7,-7.2,20,ITA
7737dee2,7,153,1.7,1,0,6,16,4,3,1,2.7,2.8,-0.1,20,ITA
780e3631,35,2489,27.7,27,21,8,0,38,38,0,39.4,39.6,-0.2,20,ITA
78841da9,33,2172,24.1,25,12,8,5,37,35,2,39.8,30.1,9.7,20,ITA
79083382,4,139,1.5,1,0,3,20,4,4,0,3.5,3.2,0.3,20,ITA
79443529,30,1499,16.7,13,8,17,6,22,30,-8,24.0,24.2,-0.2,20,ITA
7aa84ac5,10,284,3.2,3,0,7,15,1,10,-9,2.8,7.6,-4.8,20,ITA
7b075c75,8,637,7.1,7,6,1,4,13,14,-1,10.5,9.0,1.5,20,ITA
7b4b9221,1,20,0.2,0,0,1,19,0,1,-1,0.1,1.2,-1.1,20,ITA
7b4de647,2,129,1.4,1,1,1,17,2,3,-1,2.2,3.7,-1.5,20,ITA
7b536033,21,706,7.8,7,2,14,14,12,11,1,10.5,13.0,-2.5,20,ITA
7b5f516f,1,11,0.1,0,0,1,37,0,1,-1,0.4,0.1,0.4,20,ITA
7ba1f1ef,1,17,0.2,0,0,1,15,0,1,-1,0.4,0.1,0.4,20,ITA
7d3cbc67,15,509,5.7,3,0,12,20,4,12,-8,10.8,11.2,-0.3,20,ITA
7d50454d,16,1246,13.8,15,12,1,4,20,17,3,13.4,19.3,-5.8,20,ITA
7e81a17d,14,222,2.5,1,0,13,18,4,4,0,3.9,4.4,-0.4,20,ITA
7eb97a8e,33,2269,25.2,26,15,7,1,34,42,-8,38.6,33.8,4.8,20,ITA
7ec7738e,10,348,3.9,4,0,6,2,3,9,-6,3.6,5.5,-1.9,20,ITA
7ed4921e,30,2576,28.6,29,27,1,6,29,43,-14,31.1,41.8,-10.8,20,ITA
7f24b3eb,3,48,0.5,0,0,3,18,0,1,-1,0.6,0.6,0.0,20,ITA
7f267d66,11,718,8.0,8,5,3,15,10,21,-11,9.4,20.9,-11.5,20,ITA
7f66ea09,29,2610,29.0,29,29,0,2,27,59,-32,29.8,57.6,-27.9,20,ITA
7f78ad23,5,386,4.3,5,3,0,10,2,3,-1,4.5,3.9,0.7,20,ITA
7fd58fe3,20,1573,17.5,20,10,0,1,42,17,25,33.9,22.5,11.4,20,ITA
7fe90ccd,9,452,5.0,3,3,6,4,11,7,4,7.5,8.1,-0.7,20,ITA
7ff93107,7,199,2.2,2,1,5,25,8,1,7,4.8,1.9,3.0,20,ITA
801831fe,2,27,0.3,0,0,2,14,0,0,0,0.1,0.0,0.1,20,ITA
80c718dd,8,155,1.7,1,0,7,30,2,2,0,1.6,4.1,-2.5,20,ITA
81255c03,36,3151,35.0,35,29,1,0,51,49,2,39.9,54.3,-14.4,20,ITA
817c6964,15,537,6.0,4,1,11,17,7,7,0,7.9,6.4,1.6,20,ITA
822a7761,5,186,2.1,2,0,3,12,1,4,-3,1.6,4.4,-2.8,20,ITA
82328faf,1,90,1.0,1,1,0,35,3,1,2,1.7,1.2,0.6,20,ITA
825b8997,13,855,9.5,8,7,5,19,15,18,-3,10.8,16.6,-5.9,20,ITA
82b1198a,17,1469,16.3,17,16,0,18,26,17,9,27.2,17.5,9.7,20,ITA
82dbf623,17,501,5.6,3,1,14,6,10,8,2,12.5,8.2,4.2,20,ITA
82efe6fa,9,614,6.8,7,4,2,5,15,8,7,14.5,9.1,5.4,20,ITA
84594618,18,1477,16.4,16,15,2,5,25,23,2,21.8,24.9,-3.0,20,ITA
84b6acaa,26,2244,24.9,26,24,0,4,22,49,-27,26.9,47.5,-20.6,20,ITA
852351df,16,1056,11.7,12,6,4,3,32,15,17,26.4,13.5,12.9,20,ITA
854ee61a,17,980,10.9,9,4,8,4,24,20,4,18.2,17.7,0.5,20,ITA
85613cf0,26,1747,19.4,19,8,7,3,29,23,6,31.3,21.5,9.8,20,ITA
85e51909,2,28,0.3,0,0,2,14,0,2,-2,0.3,1.2,-0.9,20,ITA
8650af85,23,1897,21.1,21,20,2,5,39,33,6,30.0,35.2,-5.1,20,ITA
8697c095,13,398,4.4,4,0,9,13,3,12,-9,5.3,6.9,-1.6,20,ITA
8794e251,28,1912,21.2,21,13,7,6,45,22,23,39.5,21.8,17.7,20,ITA
881ef58c,11,514,5.7,5,1,6,15,8,4,4,10.3,5.8,4.5,20,ITA
88c89891,15,619,6.9,7,2,8,10,12,12,0,11.9,9.5,2.5,20,ITA
8913a9f9,1,5,0.1,0,0,1,2,0,0,0,0.0,0.0,0.0,20,ITA
89976232,31,2686,29.8,30,27,1,1,38,51,-13,36.9,47.7,-10.7,20,ITA
89b2c8a9,31,1689,18.8,18,8,13,2,35,30,5,30.0,24.2,5.9,20,ITA
8a08491a,32,1866,20.7,20,7,12,2,41,25,16,39.3,25.4,13.9,20,ITA
8abd0c03,13,593,6.6,6,0,7,5,10,9,1,7.6,9.0,-1.4,20,ITA
8b303bcb,6,225,2.5,2,0,4,9,1,3,-2,2.3,4.5,-2.2,20,ITA
8b609c34,4,132,1.5,1,0,3,15,2,3,-1,1.6,3.2,-1.6,20,ITA
8b66d9cc,14,573,6.4,5,1,9,12,8,13,-5,8.9,11.3,-2.4,20,ITA
8b8a56ce,20,1532,17.0,18,14,2,8,50,18,32,39.5,21.1,18.4,20,ITA
8b95acda,31,2772,30.8,30,30,1,5,37,53,-16,37.9,43.5,-5.6,20,ITA
8bc8829a,3,68,0.8,0,0,3,21,3,3,0,3.4,1.7,1.7,20,ITA
8c63fae5,3,232,2.6,2,2,1,17,2,4,-2,3.5,3.2,0.3,20,ITA
8c65eb5f,26,1649,18.3,19,10,7,2,14,27,-13,19.6,26.8,-7.3,20,ITA
8c725b43,33,2830,31.4,33,30,0,1,46,41,5,44.6,42.9,1.7,20,ITA
8cabdc1e,31,2790,31.0,31,31,0,2,58,55,3,45.0,50.2,-5.2,20,ITA
8cb494c9,1,1,0.0,0,0,1,11,0,0,0,0.0,0.0,0.0,20,ITA
8cc29864,9,702,7.8,9,6,0,4,9,16,-7,11.1,14.0,-2.9,20,ITA
8cea6319,15,997,11.1,11,7,4,20,10,28,-18,13.4,22.5,-9.1,20,ITA
8d8178ac,35,2517,28.0,28,17,7,2,44,47,-3,41.9,39.1,2.8,20,ITA
8da74c05,7,211,2.3,2,2,5,10,10,3,7,6.8,3.1,3.7,20,ITA
8efa621b,36,3132,34.8,36,34,0,0,51,75,-24,51.0,75.0,-24.0,20,ITA
8f866fe8,33,2035,22.6,24,10,9,4,32,37,-5,31.5,33.0,-1.5,20,ITA
8fef5412,23,1725,19.2,21,15,2,11,30,29,1,31.6,27.1,4.5,20,ITA
8ff07990,19,1404,15.6,16,10,3,0,14,31,-17,18.2,26.6,-8.4,20,ITA
9085dd7c,21,1343,14.9,14,12,7,5,20,26,-6,17.0,22.9,-5.8,20,ITA
909bce7f,31,2138,23.8,24,14,7,4,32,48,-16,34.0,49.8,-15.7,20,ITA
91899ca8,18,1466,16.3,17,15,1,4,14,20,-6,23.1,19.6,3.5,20,ITA
91976866,2,82,0.9,0,0,2,16,2,1,1,0.9,0.7,0.2,20,ITA
919dd4b1,1,2,0.0,0,0,1,1,0,0,0,0.1,0.0,0.1,20,ITA
91c9de34,4,47,0.5,0,0,4,3,0,0,0,0.7,0.7,0.0,20,ITA
921f6058,30,2480,27.6,28,24,2,5,68,34,34,61.6,31.5,30.2,20,ITA
92b4758e,21,1546,17.2,16,15,5,8,14,30,-16,17.8,26.9,-9.1,20,ITA
92d83c27,25,1051,11.7,12,2,13,11,16,30,-14,13.4,21.2,-7.8,20,ITA
933d3b51,17,851,9.5,9,5,8,18,10,22,-12,9.9,20.2,-10.2,20,ITA
934e264d,2,70,0.8,1,0,1,5,1,2,-1,0.5,1.2,-0.6,20,ITA
93b891d1,30,1406,15.6,18,2,12,6,35,14,21,27.6,18.8,8.9,20,ITA
93cf32a8,31,2692,29.9,30,29,1,2,36,53,-17,35.9,47.0,-11.1,20,ITA
9413b19f,22,1951,21.7,21,21,1,14,35,33,2,34.4,27.2,7.2,20,ITA
94816803,18,514,5.7,4,0,14,20,9,16,-7,8.8,9.5,-0.7,20,ITA
94b2001f,22,1440,16.0,16,10,6,9,33,27,6,24.8,22.5,2.3,20,ITA
952a03fe,21,1500,16.7,17,13,4,15,15,17,-2,19.1,20.0,-0.9,20,ITA
9591723b,1,1,0.0,0,0,1,11,0,0,0,0.0,0.0,0.0,20,ITA
9592289a,24,1640,18.2,16,12,8,4,24,25,-1,21.3,25.8,-4.5,20,ITA
95adf1e1,4,279,3.1,4,3,0,23,4,4,0,7.0,2.9,4.1,20,ITA
95facda1,35,2898,32.2,32,26,3,0,40,46,-6,36.1,50.1,-14.0,20,ITA
96640846,1,90,1.0,1,1,0,34,2,3,-1,0.9,2.1,-1.2,20,ITA
96960855,24,1458,16.2,18,8,6,6,18,32,-14,19.1,25.9,-6.9,20,ITA
96e0490d,33,2685,29.8,30,27,3,0,42,45,-3,37.1,50.9,-13.8,20,ITA
970b8574,16,548,6.1,5,2,11,23,8,11,-3,8.899999999999999,9.4,-0.5,20,ITA
980522ec,17,703,7.8,8,2,9,0,14,5,9,17.1,7.0,10.1,20,ITA
983ff2c7,16,858,9.5,10,5,6,22,12,12,0,12.4,13.0,-0.6,20,ITA
9866afec,6,115,1.3,1,0,5,10,0,3,-3,0.9,3.0,-2.1,20,ITA
98d2c2c4,31,2337,26.0,28,18,3,7,65,31,34,54.5,30.2,24.3,20,ITA
9907b1c8,26,1503,16.7,16,6,10,0,31,19,12,31.8,21.1,10.7,20,ITA
997fff07,9,529,5.9,5,4,4,29,4,8,-4,8.2,6.8,1.4,20,ITA
9b30df1e,7,344,3.8,3,3,4,18,2,10,-8,3.4,6.8,-3.4,20,ITA
9b6f7fd5,24,1103,12.3,12,2,12,9,15,14,1,19.1,14.0,5.1,20,ITA
9d4c45d6,29,2469,27.4,29,18,0,0,35,40,-5,42.5,36.0,6.5,20,ITA
9dc96f10,3,27,0.3,0,0,3,3,1,1,0,0.3,0.2,0.1,20,ITA
9e1577aa,26,1576,17.5,18,8,8,10,31,14,17,29.4,17.8,11.6,20,ITA
9e90fb5d,25,1579,17.5,20,3,5,11,18,32,-14,20.1,33.8,-13.7,20,ITA
9f5a610b,2,180,2.0,2,2,0,28,2,5,-3,4.2,4.4,-0.2,20,ITA
a111cf41,38,3420,38.0,38,38,0,0,37,51,-14,41.6,53.4,-11.8,20,ITA
a1216563,8,431,4.8,4,2,4,10,4,8,-4,6.7,4.8,1.9,20,ITA
a36084cd,3,21,0.2,0,0,3,10,1,1,0,0.6,0.6,0.0,20,ITA
a3d94a58,30,2577,28.6,30,26,0,1,33,54,-21,36.4,48.8,-12.3,20,ITA
a40819d9,25,1950,21.7,25,16,0,3,22,22,0,26.9,29.3,-2.4,20,ITA
a40d5a0c,21,875,9.7,10,1,11,7,16,15,1,15.2,14.9,0.4,20,ITA
a4e85758,26,1948,21.7,21,15,5,11,20,34,-14,28.4,36.4,-8.0,20,ITA
a4fe8cda,19,838,9.3,9,0,10,1,18,4,14,16.7,12.3,4.3,20,ITA
a5296e55,37,2924,32.5,32,25,5,1,48,43,5,52.9,38.3,14.6,20,ITA
a64cbd35,26,1688,18.8,20,9,6,8,28,30,-2,23.1,30.2,-7.0,20,ITA
a65ce836,8,284,3.2,2,0,6,12,9,9,0,7.8,6.3,1.5,20,ITA
a69cc629,4,76,0.8,0,0,4,9,1,1,0,1.5,0.8,0.7,20,ITA
a69e4806,26,1025,11.4,10,1,16,9,17,11,6,19.3,10.2,9.1,20,ITA
a8a874f1,33,2586,28.7,31,17,2,4,54,43,11,43.4,46.9,-3.4,20,ITA
a8f21b9f,14,566,6.3,5,1,9,3,17,11,6,15.1,9.8,5.3,20,ITA
a96e5dc0,29,2186,24.3,25,19,4,3,36,33,3,31.0,38.6,-7.7,20,ITA
aae9d04a,36,3228,35.9,36,35,0,0,43,44,-1,47.6,49.8,-2.2,20,ITA
ab1ca213,34,2811,31.2,32,25,2,0,36,38,-2,40.2,43.2,-3.0,20,ITA
ab4449d6,37,3330,37.0,37,37,0,0,51,64,-13,55.6,54.2,1.4,20,ITA
ac1f056e,3,96,1.1,1,0,2,3,0,2,-2,0.7,2.3,-1.6,20,ITA
ac4003af,6,525,5.8,5,4,1,31,17,5,12,13.0,3.7,9.3,20,ITA
ac4a4508,32,2110,23.4,24,11,8,3,16,53,-37,24.1,39.2,-15.1,20,ITA
ac7e640b,14,959,10.7,11,8,3,5,28,14,14,21.1,12.0,9.0,20,ITA
ad6df2d5,30,2277,25.3,28,18,2,4,53,27,26,47.0,31.6,15.4,20,ITA
aded8e6f,1,59,0.7,1,0,0,3,3,1,2,1.5,0.6,0.9,20,ITA
ae4e2852,9,471,5.2,6,4,3,10,10,3,7,7.4,6.4,1.0,20,ITA
ae64d449,22,1598,17.8,19,10,3,8,31,30,1,21.8,27.2,-5.4,20,ITA
ae7058f9,8,569,6.3,7,5,1,28,11,13,-2,8.3,10.9,-2.6,20,ITA
ae82fa48,9,395,4.4,3,1,6,15,6,9,-3,7.2,5.8,1.4000000000000001,20,ITA
b0243215,14,1007,11.2,11,8,3,15,12,22,-10,15.8,21.1,-5.3,20,ITA
b0f7e36c,34,2637,29.3,31,16,3,1,42,33,9,43.7,34.8,8.9,20,ITA
b1236c63,28,1251,13.9,15,5,13,10,16,17,-1,14.7,18.7,-4.0,20,ITA
b1deecf8,20,1718,19.1,19,19,1,10,25,34,-9,22.7,31.8,-9.1,20,ITA
b233e8e4,10,666,7.4,7,6,3,8,5,14,-9,7.1,10.5,-3.4,20,ITA
b3af9be1,29,2528,28.1,29,25,0,0,36,45,-9,43.6,38.1,5.5,20,ITA
b3fd7075,28,1919,21.3,22,9,6,5,29,33,-4,34.1,29.1,5.1,20,ITA
b59e02da,13,964,10.7,11,8,2,2,15,17,-2,15.0,21.8,-6.8,20,ITA
b5bf1770,17,1176,13.1,15,8,2,11,8,24,-16,11.0,20.2,-9.1,20,ITA
b5cae4e6,17,642,7.2,6,1,11,21,5,11,-6,9.1,13.8,-4.8,20,ITA
b6964eb6,30,2566,28.5,29,28,1,1,54,38,16,52.0,36.4,15.6,20,ITA
b6b2b820,30,2317,25.7,28,14,2,1,42,41,1,27.6,39.5,-11.9,20,ITA
b70bde8f,12,723,8.0,9,2,3,3,14,5,9,14.3,7.1,7.2,20,ITA
b7a5bc86,8,421,4.7,5,1,3,3,3,9,-6,3.2,9.2,-6.0,20,ITA
b86fe156,3,130,1.4,1,0,2,6,0,3,-3,1.0,4.8,-3.9,20,ITA
b871bf55,7,481,5.3,6,4,1,12,6,6,0,4.8,7.6,-2.8,20,ITA
b96b595c,36,3162,35.1,36,32,0,1,74,38,36,62.9,46.9,16.0,20,ITA
ba1e04b3,25,1674,18.6,18,16,7,3,33,35,-2,25.5,31.4,-5.9,20,ITA
ba3d3bea,21,592,6.6,3,0,18,12,18,7,11,12.7,13.7,-1.0,20,ITA
bbafc0c4,27,1768,19.6,21,11,6,2,26,32,-6,24.1,29.8,-5.8,20,ITA
bdc74a8f,9,299,3.3,2,2,7,8,10,5,5,7.6,4.8,2.8,20,ITA
bdd0692f,20,590,6.6,4,1,16,18,8,9,-1,5.9,11.7,-5.8,20,ITA
be927d03,18,1185,13.2,13,7,5,0,30,17,13,25.7,15.9,9.8,20,ITA
bee704fc,37,3258,36.2,36,36,1,0,50,44,6,51.3,45.2,6.2,20,ITA
bf13975c,27,1664,18.5,19,6,8,1,27,42,-15,25.5,43.7,-18.3,20,ITA
bf168004,2,180,2.0,2,2,0,17,4,4,0,2.5,5.1,-2.6,20,ITA
bf309d24,22,1518,16.9,19,11,3,6,35,20,15,33.3,21.1,12.1,20,ITA
bf356094,5,82,0.9,0,0,5,14,2,2,0,1.8,0.7,1.1,20,ITA
bf39bdec,25,1844,20.5,22,11,3,0,21,46,-25,26.6,42.7,-16.2,20,ITA
bf4d31d3,1,12,0.1,0,0,1,4,0,0,0,0.5,0.2,0.3,20,ITA
bf57eaab,19,744,8.3,7,0,12,13,15,10,5,12.1,10.0,2.0,20,ITA
c01c66d9,16,765,8.5,6,5,10,21,15,12,3,14.7,13.4,1.3,20,ITA
c0c7ff58,33,2684,29.8,30,22,3,4,48,38,10,49.8,35.0,14.8,20,ITA
c0cddebe,35,2237,24.9,23,16,12,3,47,26,21,42.4,30.4,12.0,20,ITA
c235e803,9,680,7.6,6,5,3,28,16,8,8,14.4,9.6,4.8,20,ITA
c316607a,9,707,7.9,8,6,1,5,17,16,1,10.0,14.7,-4.7,20,ITA
c375dfa5,12,553,6.1,6,3,6,6,8,17,-9,9.5,14.5,-5.0,20,ITA
c3a8bcd8,32,2427,27.0,29,19,3,4,34,46,-12,36.8,42.3,-5.5,20,ITA
c414df9d,27,1527,17.0,18,5,9,4,15,28,-13,19.4,32.8,-13.5,20,ITA
c4efe2b4,4,154,1.7,2,0,2,12,0,1,-1,1.7,2.1,-0.4,20,ITA
c50cee19,26,760,8.4,7,0,19,8,11,14,-3,10.6,13.4,-2.7,20,ITA
c53083ad,16,1122,12.5,13,8,3,1,11,37,-26,11.6,24.5,-12.9,20,ITA
c56dc39e,33,2608,29.0,29,27,4,2,67,39,28,62.3,30.6,31.7,20,ITA
c59f90b0,1,3,0.0,0,0,1,14,1,0,1,0.8,0.0,0.8,20,ITA
c5adc293,9,376,4.2,3,2,6,15,8,5,3,7.9,5.4,2.5,20,ITA
c693347d,26,1494,16.6,17,11,9,3,32,19,13,24.8,30.5,-5.8,20,ITA
c6e8cf1f,30,1861,20.7,20,14,10,3,20,39,-19,22.3,33.6,-11.3,20,ITA
c707411f,26,2176,24.2,25,22,1,6,39,32,7,37.7,26.6,11.0,20,ITA
c710f7d5,22,1400,15.6,15,9,7,14,10,30,-20,16.2,25.6,-9.3,20,ITA
c7259b83,26,2050,22.8,24,18,2,1,20,31,-11,23.7,34.3,-10.6,20,ITA
c730da00,6,257,2.9,2,1,4,21,7,2,5,5.9,4.1,1.8,20,ITA
c75b6a02,12,534,5.9,8,0,4,12,6,9,-3,7.0,8.8,-1.8,20,ITA
c840baa2,5,37,0.4,0,0,5,7,0,2,-2,1.1,1.8,-0.7,20,ITA
ca241ad3,6,167,1.9,2,0,4,11,3,3,0,2.0,5.4,-3.4,20,ITA
ca8fa0c0,1,2,0.0,0,0,1,9,0,0,0,0.1,0.0,0.1,20,ITA
caec77da,1,12,0.1,0,0,1,12,0,0,0,0.0,0.0,0.0,20,ITA
caffaf5a,14,1187,13.2,13,13,1,2,22,21,1,19.6,22.5,-2.9,20,ITA
cbec1196,21,1125,12.5,11,7,10,14,11,30,-19,13.5,29.1,-15.6,20,ITA
cc700722,23,1280,14.2,16,8,7,5,20,20,0,20.3,17.9,2.4,20,ITA
cce9f582,10,260,2.9000000000000004,2,1,8,16,5,9,-4,4.4,8.1,-3.7,20,ITA
cd0fa27b,35,2704,30.0,34,19,1,0,50,41,9,49.4,36.4,13.1,20,ITA
cdf65d12,23,1818,20.2,21,18,2,8,39,33,6,28.3,31.6,-3.3,20,ITA
ce30bfc8,24,1797,20.0,21,11,3,4,48,23,25,38.5,22.2,16.3,20,ITA
ce5b170a,5,231,2.6,2,2,3,26,5,7,-2,3.2,4.8,-1.6,20,ITA
cedb3e36,34,1897,21.1,21,10,13,3,20,31,-11,20.6,36.4,-15.9,20,ITA
cf007308,26,1134,12.6,12,4,14,11,25,16,9,18.3,13.3,5.0,20,ITA
cf1c23d8,3,270,3.0,3,3,0,33,7,6,1,5.1,4.7,0.4,20,ITA
cfbf9881,20,1507,16.7,16,13,4,14,22,31,-9,24.3,25.7,-1.5,20,ITA
d023d70f,28,2019,22.4,22,14,6,4,31,44,-13,29.7,37.2,-7.6,20,ITA
d0d8dd44,34,2830,31.4,32,30,2,3,61,32,29,55.3,36.1,19.3,20,ITA
d0dbca9f,12,1005,11.2,11,10,1,7,11,13,-2,14.9,8.6,6.3,20,ITA
d183e9d6,28,2259,25.1,26,22,2,9,26,44,-18,29.1,33.6,-4.4,20,ITA
d1b49282,24,1865,20.7,21,17,3,8,30,35,-5,26.4,28.0,-1.6,20,ITA
d2fd20d6,1,1,0.0,0,0,1,5,0,0,0,0.1,0.0,0.1,20,ITA
d37b0350,2,45,0.5,1,0,1,0,0,0,0,0.4,0.4,0.0,20,ITA
d3b888e3,11,469,5.2,4,3,7,13,10,10,0,5.2,10.1,-4.9,20,ITA
d3d758d8,17,1107,12.3,13,5,4,2,19,22,-3,15.6,16.1,-0.4,20,ITA
d3de9af0,28,2026,22.5,25,12,3,0,59,29,30,46.0,23.1,22.9,20,ITA
d4535821,15,942,10.5,10,7,5,9,26,12,14,17.5,14.0,3.4,20,ITA
d4890c25,1,6,0.1,0,0,1,13,1,0,1,0.0,0.0,0.0,20,ITA
d4931a5a,15,571,6.3,6,3,9,16,17,10,7,12.7,8.9,3.8,20,ITA
d4c9725f,33,2817,31.3,32,29,1,1,58,38,20,55.7,37.0,18.7,20,ITA
d5575935,3,33,0.4,0,0,3,13,1,0,1,0.5,0.7,-0.2,20,ITA
d6a889ea,4,256,2.8,3,2,1,9,7,2,5,5.6,3.9,1.7,20,ITA
d6e53a3a,29,2450,27.2,26,25,3,6,54,31,23,49.9,33.9,15.9,20,ITA
d705ba44,36,3008,33.4,34,30,2,0,38,60,-22,39.5,52.8,-13.2,20,ITA
d711d04f,34,1685,18.7,18,5,16,2,29,35,-6,29.4,28.0,1.4,20,ITA
d7918b13,4,196,2.2,2,1,2,13,1,3,-2,1.5,3.7,-2.1,20,ITA
d7d32194,13,335,3.8,3,0,10,19,4,8,-4,7.8,5.3,2.5999999999999996,20,ITA
d80b1835,1,90,1.0,1,1,0,1,1,3,-2,1.2,1.7,-0.6,20,ITA
d85c238b,34,2114,23.5,26,7,8,2,22,32,-10,29.7,35.4,-5.7,20,ITA
d89b0ebb,3,26,0.3,0,0,3,14,0,2,-2,0.1,1.1,-1.0,20,ITA
d8dfae8a,3,16,0.2,0,0,3,5,0,1,-1,0.3,0.2,0.1,20,ITA
d9624b51,15,835,9.3,8,6,7,23,6,15,-9,12.3,12.9,-0.5,20,ITA
d97f2e8d,29,1854,20.6,21,15,8,1,22,28,-6,23.4,28.3,-5.0,20,ITA
d995ed27,29,1338,14.9,13,4,16,7,29,14,15,25.4,14.6,10.9,20,ITA
da13074e,13,798,8.9,9,2,4,3,11,25,-14,8.7,19.4,-10.7,20,ITA
da5a981b,16,853,9.5,9,5,7,7,5,17,-12,10.5,14.8,-4.3,20,ITA
da974c7b,25,2105,23.4,24,22,1,2,41,34,7,41.8,30.4,11.4,20,ITA
db092d3b,31,2485,27.6,28,22,3,4,50,33,17,48.5,31.6,17.0,20,ITA
dc1c2fce,29,1823,20.3,21,8,8,7,28,36,-8,24.6,30.3,-5.8,20,ITA
dc3a9a0d,19,828,9.2,9,3,10,15,12,12,0,11.3,14.1,-2.8,20,ITA
dc3fa3b5,15,902,10.0,10,3,5,3,13,14,-1,14.5,11.6,2.9,20,ITA
dc61b402,1,12,0.1,0,0,1,13,0,0,0,0.1,0.0,0.1,20,ITA
dd06d56c,6,454,5.0,5,5,1,31,8,11,-3,4.8,9.3,-4.4,20,ITA
dd0daf32,22,1530,17.0,16,6,6,2,32,24,8,31.5,21.7,9.8,20,ITA
dd29f81d,12,629,7.0,6,3,6,11,10,20,-10,7.9,17.0,-9.1,20,ITA
de045b15,34,2898,32.2,33,28,1,3,24,62,-38,33.7,58.1,-24.4,20,ITA
dea698d9,33,2917,32.4,33,31,0,0,66,36,30,60.1,38.1,22.0,20,ITA
deb748c9,31,2548,28.3,28,25,3,3,29,55,-26,34.3,51.6,-17.4,20,ITA
df301450,24,942,10.5,9,4,15,10,5,21,-16,10.9,16.9,-6.0,20,ITA
df3cda47,36,2930,32.6,33,23,3,0,51,51,0,42.0,53.9,-11.9,20,ITA
df525574,19,1063,11.8,11,6,8,13,15,18,-3,13.4,17.2,-3.8,20,ITA
df85d472,24,770,8.6,5,3,19,2,13,12,1,16.9,13.2,3.7,20,ITA
dfd56738,1,25,0.3,0,0,1,18,0,0,0,0.1,0.0,0.0,20,ITA
e01ca8f4,5,181,2.0,1,0,4,20,6,6,0,6.1,3.8,2.3,20,ITA
e0314d87,22,1867,20.7,22,17,0,14,39,36,3,31.0,27.5,3.4000000000000004,20,ITA
e0921a4f,33,2155,23.9,25,7,8,2,51,22,29,45.1,24.8,20.4,20,ITA
e14ec482,37,2681,29.8,32,15,5,1,40,51,-11,46.1,41.0,5.1,20,ITA
e1b0a70d,7,624,6.9,7,6,0,31,14,5,9,12.2,9.6,2.6,20,ITA
e1cbb531,14,752,8.4,9,3,5,5,18,9,9,15.5,7.7,7.8,20,ITA
e23f56c1,30,2014,22.4,24,12,6,2,32,43,-11,32.5,45.7,-13.2,20,ITA
e26bd2f4,28,2003,22.3,24,17,4,5,23,53,-30,30.2,49.6,-19.4,20,ITA
e288d4b3,14,997,11.1,12,5,2,5,21,15,6,20.0,14.9,5.2,20,ITA
e33f36d5,26,2225,24.7,26,22,0,10,29,31,-2,29.5,31.0,-1.5,20,ITA
e358587b,1,90,1.0,1,1,0,14,3,2,1,1.6,1.6,-0.1,20,ITA
e3756e72,1,18,0.2,0,0,1,15,0,1,-1,0.4,0.1,0.4,20,ITA
e3cceee6,6,418,4.6,5,4,1,19,13,4,9,8.9,5.7,3.2,20,ITA
e40d028b,9,810,9.0,9,9,0,29,19,10,9,19.1,8.8,10.3,20,ITA
e468c053,31,2270,25.2,27,13,4,1,34,33,1,32.2,38.1,-5.9,20,ITA
e58cbfd5,2,105,1.2,1,0,1,11,0,3,-3,0.8,2.1,-1.2,20,ITA
e599253a,35,2417,26.9,30,16,5,2,66,35,31,56.2,28.3,27.9,20,ITA
e5bf73f3,25,1544,17.1,15,10,10,12,26,27,-1,27.0,24.4,2.6999999999999997,20,ITA
e63e122d,1,76,0.8,1,0,0,0,1,1,0,1.5,0.1,1.4,20,ITA
e726e11e,12,420,4.7,4,0,8,2,14,1,13,12.6,4.1,8.5,20,ITA
e74f0e59,29,2243,24.9,28,19,1,5,28,47,-19,26.9,39.0,-12.1,20,ITA
e7ee38c3,17,1524,16.9,17,16,0,6,31,24,7,20.6,26.9,-6.3,20,ITA
e83f8ebb,1,15,0.2,0,0,1,2,0,0,0,0.2,0.0,0.2,20,ITA
e85fb9b8,4,202,2.2,3,1,1,4,4,1,3,3.6,2.1,1.6,20,ITA
e8c930bb,22,1585,17.6,20,10,2,15,19,26,-7,21.3,23.4,-2.1,20,ITA
e947ee4a,23,1458,16.2,17,6,6,12,18,26,-8,19.7,29.5,-9.8,20,ITA
e94d79e3,27,2356,26.2,27,25,0,5,35,26,9,36.4,31.1,5.3,20,ITA
ea06dd97,16,1278,14.2,16,6,0,2,16,23,-7,14.1,24.0,-9.8,20,ITA
ea164f99,16,920,10.2,12,3,4,8,18,12,6,12.3,16.6,-4.3,20,ITA
eb2fe5b6,34,1260,14.0,10,1,24,1,40,17,23,36.5,14.0,22.4,20,ITA
eccbe56a,29,1633,18.1,19,3,10,4,37,24,13,27.3,30.9,-3.6,20,ITA
ed5886d2,29,1700,18.9,17,13,12,8,28,24,4,29.5,26.2,3.4,20,ITA
ed65da8c,1,15,0.2,0,0,1,3,0,0,0,0.1,0.9,-0.8,20,ITA
eda40760,32,2732,30.4,30,30,2,5,64,37,27,61.7,35.9,25.8,20,ITA
ee251371,13,684,7.6,6,3,7,3,20,9,11,16.0,9.0,7.0,20,ITA
ee4f2f3b,28,2275,25.3,26,15,2,6,28,43,-15,36.5,33.3,3.2,20,ITA
ee833569,26,2340,26.0,26,26,0,0,20,44,-24,32.0,47.3,-15.3,20,ITA
ee93c1a9,29,1571,17.5,19,5,10,6,27,24,3,33.5,22.6,10.9,20,ITA
ef5b337e,16,878,9.8,10,2,6,13,14,8,6,15.5,10.3,5.2,20,ITA
ef619b0b,24,1051,11.7,11,1,13,8,27,12,15,22.8,11.5,11.3,20,ITA
ef94dc2f,22,1293,14.4,17,3,5,9,17,22,-5,20.3,18.6,1.7,20,ITA
f058ed1f,5,450,5.0,5,5,0,27,7,4,3,5.3,6.8,-1.4,20,ITA
f0f7f62f,33,2884,32.0,33,32,0,5,81,42,39,70.1,37.5,32.6,20,ITA
f1cfc209,32,2702,30.0,31,25,1,2,41,43,-2,37.7,44.1,-6.4,20,ITA
f1f1f238,32,2733,30.4,31,28,1,4,37,41,-4,42.0,43.3,-1.3,20,ITA
f239e6dd,1,1,0.0,0,0,1,3,0,2,-2,0.0,0.6,-0.6,20,ITA
f26e3c59,20,768,8.5,5,3,15,17,6,16,-10,9.1,17.099999999999998,-7.9,20,ITA
f32df091,1,1,0.0,0,0,1,8,0,0,0,0.0,0.0,0.0,20,ITA
f45f9427,31,2484,27.6,29,20,2,4,37,35,2,37.9,34.5,3.4,20,ITA
f4ec4fd0,14,599,6.7,6,1,8,4,5,13,-8,7.6,9.2,-1.6,20,ITA
f503ea63,32,2385,26.5,27,21,5,1,37,40,-3,34.9,33.2,1.7,20,ITA
f554e29b,16,1440,16.0,16,16,0,3,13,21,-8,16.3,22.8,-6.5,20,ITA
f5ba8903,3,30,0.3,0,0,3,14,0,0,0,0.6,0.2,0.4,20,ITA
f61c7c4e,21,1409,15.7,19,1,2,0,19,12,7,20.7,17.5,3.2,20,ITA
f6a06749,1,19,0.2,0,0,1,37,0,0,0,0.5,0.2,0.3,20,ITA
f6f6b6e8,3,197,2.2,2,2,1,14,1,9,-8,2.4,4.5,-2.2,20,ITA
f7036e1c,35,2452,27.2,29,9,6,0,55,28,27,47.8,28.2,19.6,20,ITA
f7223718,21,1670,18.6,19,12,2,11,39,20,19,34.7,24.4,10.2,20,ITA
f7e2af2c,7,368,4.1,5,2,2,6,5,7,-2,3.4,4.5,-1.2,20,ITA
f8d41a8c,1,1,0.0,0,0,1,11,0,0,0,0.0,0.0,0.0,20,ITA
f8f0744b,1,7,0.1,0,0,1,12,0,1,-1,0.0,0.0,0.0,20,ITA
f91e81c9,33,2789,31.0,32,24,1,0,27,32,-5,33.7,38.3,-4.7,20,ITA
f93ed0df,34,2997,33.3,34,33,0,2,43,76,-33,48.0,74.1,-26.1,20,ITA
faa1b07d,5,303,3.4,3,1,2,19,5,4,1,3.0,4.3,-1.3,20,ITA
fb2c533b,25,1750,19.4,19,11,6,13,12,42,-30,17.3,33.4,-16.1,20,ITA
fb77bfef,17,1438,15.899999999999999,16,14,1,12,15,41,-26,16.3,28.5,-12.200000000000001,20,ITA
fba81826,18,930,10.3,9,5,9,12,9,9,0,10.6,13.3,-2.7,20,ITA
fc4f85b1,23,1628,18.1,18,12,5,13,30,15,15,27.3,21.1,6.3,20,ITA
fe012aca,34,2513,27.9,28,14,6,1,47,44,3,37.4,41.7,-4.3,20,ITA
fe0b8f0e,10,230,2.6,2,1,8,9,4,6,-2,1.8,4.8,-3.0,20,ITA
fe471a89,6,531,5.9,5,5,1,20,4,16,-12,6.5,14.0,-7.5,20,ITA
fe479e17,2,41,0.5,0,0,2,13,1,0,1,0.1,0.4,-0.3,20,ITA
fe6a7685,21,1838,20.4,21,20,0,2,17,35,-18,22.1,36.2,-14.1,20,ITA
fed5f993,30,2638,29.3,30,26,0,3,39,48,-9,41.7,45.7,-4.0,20,ITA
ff4296df,3,127,1.4,1,0,2,10,1,1,0,0.6,1.1,-0.4,20,ITA
ff764de3,24,1085,12.1,9,3,15,12,16,26,-10,15.7,27.4,-11.7,20,ITA
ff800ed8,35,2648,29.4,30,20,5,2,37,37,0,39.0,36.8,2.2,20,ITA
005c0807,26,2246,25.0,25,21,1,0,26,41,-15,28.4,36.9,-8.5,20,FRA
007faf7a,2,72,0.8,1,0,1,2,0,0,0,1.0,0.4,0.6,20,FRA
0118c54c,8,691,7.7,8,6,0,1,16,8,8,12.0,7.5,4.5,20,FRA
032f894e,19,1483,16.5,16,14,3,1,19,15,4,24.4,19.2,5.2,20,FRA
0557ff4f,16,1122,12.5,12,11,4,7,17,15,2,15.5,20.7,-5.2,20,FRA
05816e19,18,1202,13.4,14,6,4,4,15,20,-5,13.6,16.6,-3.0,20,FRA
0630eb63,21,880,9.8,8,2,13,4,16,7,9,11.6,10.6,1.0,20,FRA
0670ee51,1,9,0.1,0,0,1,0,0,1,-1,0.0,0.2,-0.2,20,FRA
06df8256,16,1411,15.7,16,14,0,12,23,23,0,26.7,25.0,1.7,20,FRA
07f73a4f,1,9,0.1,0,0,1,2,1,0,1,0.4,0.1,0.2,20,FRA
08082af0,11,929,10.3,10,9,1,13,16,15,1,13.6,13.2,0.4,20,FRA
095e4199,1,6,0.1,0,0,1,1,0,0,0,0.3,0.5,-0.2,20,FRA
0984c5d5,1,53,0.6,1,0,0,2,1,0,1,1.3,0.2,1.1,20,FRA
0a63446f,17,1378,15.3,15,14,2,6,11,23,-12,15.1,19.3,-4.3,20,FRA
0a89e877,13,890,9.9,10,8,3,3,11,19,-8,14.0,16.2,-2.1,20,FRA
0aa874f4,22,1781,19.8,21,16,1,3,15,13,2,21.5,20.8,0.7,20,FRA
0b0cbe5b,26,2042,22.7,23,16,3,0,26,34,-8,25.5,33.3,-7.8,20,FRA
0b4d8274,14,865,9.6,9,4,5,3,15,20,-5,13.3,12.8,0.4,20,FRA
0bb6e193,2,95,1.1,2,0,0,4,0,4,-4,1.3,2.5,-1.1,20,FRA
0be95d34,21,1242,13.8,14,6,7,6,24,9,15,20.7,12.8,7.8,20,FRA
0c291a1a,1,60,0.7,1,0,0,9,0,1,-1,0.9,0.3,0.6,20,FRA
0cbc8baa,14,1178,13.1,13,13,1,6,18,18,0,17.2,17.9,-0.7,20,FRA
0d2158d5,8,201,2.2,1,0,7,3,4,3,1,2.6,3.0,-0.4,20,FRA
0d3585b5,17,603,6.7,6,2,11,6,8,9,-1,7.3,10.7,-3.4,20,FRA
0e6bc38c,9,451,5.0,5,1,4,7,11,1,10,11.4,2.5,8.9,20,FRA
0eb03d5b,9,573,6.4,5,4,4,9,11,9,2,7.8,7.7,0.2,20,FRA
0f26fd24,15,609,6.8,6,0,9,4,5,5,0,8.5,6.2,2.3,20,FRA
0f52f925,3,270,3.0,3,3,0,0,3,3,0,3.5,2.9,0.6,20,FRA
0f8418aa,23,1598,17.8,18,14,5,1,22,20,2,20.8,21.4,-0.6,20,FRA
0f86995c,2,141,1.6,1,1,1,2,5,1,4,2.3,1.7,0.6,20,FRA
0f87f8c2,1,60,0.7,1,0,0,4,0,1,-1,0.7,1.1,-0.4,20,FRA
0f9b8301,24,1392,15.5,16,9,8,2,22,21,1,20.4,23.2,-2.8,20,FRA
1001ae82,24,1597,17.7,20,8,4,2,16,26,-10,17.3,23.8,-6.5,20,FRA
10f0fdd3,24,1497,16.6,16,7,8,0,14,19,-5,19.9,19.3,0.7,20,FRA
11ced928,15,910,10.1,9,6,6,5,11,24,-13,12.4,18.2,-5.7,20,FRA
11ff3d56,19,1561,17.3,18,15,1,1,19,26,-7,17.4,31.9,-14.5,20,FRA
1232e1dc,19,1278,14.2,14,13,5,4,21,15,6,23.3,16.3,6.9,20,FRA
132a82f1,14,1215,13.5,13,13,1,2,16,24,-8,17.0,20.7,-3.8,20,FRA
132bb875,2,180,2.0,2,2,0,22,0,5,-5,1.3,3.5,-2.2,20,FRA
1467af0d,20,1482,16.5,15,11,5,1,52,15,37,46.1,15.0,31.1,20,FRA
14e8e9d7,14,1260,14.0,14,14,0,6,13,34,-21,15.1,25.8,-10.7,20,FRA
16324e1d,22,1737,19.3,20,17,2,0,15,31,-16,18.2,28.8,-10.7,20,FRA
166a981d,10,649,7.2,8,4,2,6,12,11,1,9.4,11.3,-1.9,20,FRA
16aa7d4c,12,823,9.1,9,8,3,9,7,13,-6,8.8,13.7,-4.9,20,FRA
18ebca4b,26,2065,22.9,23,17,3,0,31,29,2,23.6,37.0,-13.4,20,FRA
19a12bed,23,1709,19.0,18,16,5,3,17,14,3,20.3,19.4,0.9,20,FRA
19cda00b,26,2000,22.2,23,15,3,1,63,20,43,62.5,20.2,42.4,20,FRA
19f8e480,6,468,5.2,6,3,0,5,3,7,-4,3.2,5.7,-2.5,20,FRA
1a4b9094,27,2164,24.0,25,17,2,0,35,24,11,30.1,27.2,2.9,20,FRA
1a6f2a66,17,1032,11.5,12,5,5,3,11,12,-1,12.4,13.299999999999999,-0.9,20,FRA
1a992676,11,686,7.6,7,4,4,6,20,10,10,18.3,7.7,10.6,20,FRA
1ad8cb67,26,2339,26.0,26,25,0,0,26,40,-14,27.4,36.4,-9.0,20,FRA
1b6862e8,14,528,5.9,4,1,10,9,2,7,-5,4.4,7.0,-2.6,20,FRA
1bab7b66,17,1352,15.0,14,12,3,1,13,23,-10,15.7,20.4,-4.7,20,FRA
1bfb6fef,16,1366,15.2,16,14,0,0,9,27,-18,17.0,21.9,-4.9,20,FRA
1d2d5cc8,27,2370,26.3,27,26,0,0,37,27,10,32.5,29.8,2.7,20,FRA
1ddbc7ca,1,45,0.5,0,0,1,1,3,0,3,0.9,0.1,0.9,20,FRA
1ec7e1c5,25,2244,24.9,25,24,0,1,36,21,15,32.7,25.3,7.4,20,FRA
20094685,23,1110,12.3,13,4,10,5,17,18,-1,12.6,16.6,-4.0,20,FRA
2054d037,26,2126,23.6,24,15,2,1,30,23,7,30.0,26.4,3.6,20,FRA
20e73fac,25,1903,21.1,21,16,4,0,29,20,9,27.1,21.4,5.7,20,FRA
2145368f,20,1373,15.3,15,9,5,4,10,27,-17,12.6,23.1,-10.5,20,FRA
21f8d950,24,1541,17.1,17,8,7,4,18,29,-11,17.5,24.3,-6.8,20,FRA
22721b88,26,2164,24.0,24,23,2,1,36,22,14,32.5,24.5,8.0,20,FRA
22bfb57e,19,988,11.0,12,5,7,7,10,23,-13,12.2,18.4,-6.1,20,FRA
2306bfde,6,188,2.1,1,0,5,0,4,5,-1,3.3,3.5,-0.2,20,FRA
23bf644d,5,121,1.3,1,0,4,3,0,2,-2,1.6,2.6,-1.0,20,FRA
23c63b7f,26,1239,13.8,12,4,14,1,19,19,0,18.7,23.9,-5.2,20,FRA
242b350c,1,23,0.3,0,0,1,0,0,0,0,0.2,0.0,0.2,20,FRA
2434f24a,28,2520,28.0,28,28,0,0,40,34,6,30.4,36.9,-6.6,20,FRA
243f4a0b,25,2211,24.6,25,23,0,0,35,28,7,26.4,31.1,-4.6,20,FRA
244bc2c8,24,1812,20.1,21,12,3,0,20,17,3,21.8,18.5,3.4,20,FRA
247accfd,22,1868,20.8,22,20,0,1,21,35,-14,20.6,26.4,-5.8,20,FRA
24eb7ed6,17,587,6.5,5,1,12,4,11,12,-1,8.3,10.3,-2.0,20,FRA
254c927d,1,11,0.1,0,0,1,1,0,0,0,0.0,0.4,-0.4,20,FRA
26777636,21,1020,11.3,11,3,10,1,17,11,6,11.3,11.9,-0.6,20,FRA
2677a1de,16,1149,12.8,13,6,3,0,12,21,-9,12.8,16.3,-3.5,20,FRA
26975a92,26,2340,26.0,26,26,0,1,27,32,-5,27.8,26.9,0.9,20,FRA
26e4447b,23,1465,16.3,18,6,5,0,20,22,-2,15.0,24.5,-9.5,20,FRA
275e2c51,27,2340,26.0,27,25,0,1,27,31,-4,25.9,27.9,-1.9,20,FRA
279ddf6a,24,2147,23.9,24,23,0,0,22,19,3,26.0,23.1,2.9,20,FRA
288e1e13,11,957,10.6,11,10,0,3,9,13,-4,12.0,14.5,-2.5,20,FRA
28a65a2c,5,450,5.0,5,5,0,21,4,4,0,3.5,7.3,-3.8,20,FRA
28dabd43,25,2203,24.5,25,24,0,0,25,38,-13,27.3,34.4,-7.1,20,FRA
2945f4b7,18,548,6.1,4,1,14,8,6,10,-4,8.3,9.0,-0.7,20,FRA
29c02c9f,10,668,7.4,7,6,3,5,17,4,13,19.6,5.5,14.1,20,FRA
29d8ad3f,25,2173,24.1,25,23,0,1,37,30,7,25.5,32.8,-7.3,20,FRA
29ef0f49,22,777,8.6,6,2,16,3,5,25,-20,12.4,17.4,-5.0,20,FRA
2a657da0,13,924,10.3,12,4,1,0,9,7,2,10.9,9.9,1.0,20,FRA
2acf0cd7,17,838,9.3,8,7,9,7,11,8,3,9.3,10.3,-1.1,20,FRA
2b1bed19,23,1816,20.2,20,18,3,1,20,22,-2,21.1,32.7,-11.6,20,FRA
2b3d9aad,4,25,0.3,0,0,4,5,1,1,0,1.4,0.9,0.5,20,FRA
2b9fdeea,2,22,0.2,0,0,2,0,0,2,-2,0.4,1.9,-1.5,20,FRA
2c92d3c0,3,115,1.3,2,0,1,1,0,1,-1,0.5,2.2,-1.7,20,FRA
2e52206e,2,167,1.9,2,1,0,0,1,3,-2,3.1,2.5,0.6,20,FRA
2ee1b96b,2,136,1.5,1,1,1,24,1,4,-3,2.1,2.0,0.1,20,FRA
2f965a72,3,270,3.0,3,3,0,1,8,2,6,8.6,1.9,6.7,20,FRA
2fa2a875,28,2520,28.0,28,28,0,0,44,44,0,48.9,42.7,6.1,20,FRA
3010aefb,1,14,0.2,1,0,0,0,0,0,0,0.0,0.0,0.0,20,FRA
30144daa,24,1391,15.5,16,6,8,0,15,19,-4,15.6,22.6,-7.0,20,FRA
3071a619,7,584,6.5,7,3,0,0,12,8,4,9.0,7.1,1.9,20,FRA
31a62dc7,23,2070,23.0,23,23,0,3,30,22,8,34.3,25.1,9.2,20,FRA
3225654e,1,25,0.3,0,0,1,0,2,0,2,2.1,0.3,1.8,20,FRA
32c2d95f,28,2520,28.0,28,28,0,0,26,21,5,30.6,28.5,2.1,20,FRA
32f3d97e,27,1468,16.3,16,5,11,0,19,14,5,20.0,17.6,2.4,20,FRA
33508c78,18,930,10.3,12,2,6,5,22,21,1,19.5,17.7,1.8,20,FRA
33887998,24,2160,24.0,24,24,0,1,33,19,14,32.2,23.4,8.8,20,FRA
3423f250,22,1690,18.8,20,13,2,0,25,16,9,26.4,17.4,8.9,20,FRA
34bb6fbd,21,1878,20.9,21,20,0,2,23,38,-15,21.6,28.3,-6.7,20,FRA
3681cfff,15,1103,12.3,13,8,2,0,19,15,4,18.4,19.1,-0.7,20,FRA
3708e9fa,25,2061,22.9,24,15,1,0,35,34,1,39.4,35.1,4.3,20,FRA
375622c5,16,1150,12.8,13,7,3,0,13,17,-4,16.4,17.7,-1.3,20,FRA
380a15e2,3,196,2.2,3,2,0,21,0,3,-3,3.9,3.2,0.7,20,FRA
38568467,3,270,3.0,3,3,0,9,3,4,-1,3.5,3.5,0.0,20,FRA
38d9ce53,1,12,0.1,0,0,1,0,0,0,0,0.2,0.0,0.1,20,FRA
3a74f92b,4,305,3.4,4,3,0,0,0,4,-4,3.4,3.2,0.2,20,FRA
3b5cd50d,12,349,3.9,4,0,8,10,5,4,1,4.5,4.0,0.4,20,FRA
3befc2b6,25,2177,24.2,25,23,0,0,24,24,0,27.2,26.1,1.0,20,FRA
3c6bbbab,28,2520,28.0,28,28,0,0,27,35,-8,27.1,38.1,-11.0,20,FRA
3dd738a1,19,1072,11.9,11,9,8,5,20,16,4,22.5,16.3,6.2,20,FRA
3deb2342,1,9,0.1,0,0,1,1,0,0,0,0.1,0.1,0.0,20,FRA
3e092724,20,1772,19.7,20,18,0,0,30,25,5,26.5,29.2,-2.7,20,FRA
3eaf8817,21,1047,11.6,12,3,9,1,17,21,-4,19.1,16.5,2.6,20,FRA
3ef0fa48,21,1674,18.6,20,11,1,0,31,33,-2,32.9,29.9,3.0,20,FRA
3ef68782,5,140,1.6,1,0,4,0,4,2,2,2.4,2.1,0.3,20,FRA
3f1a7191,7,580,6.4,6,5,1,10,5,7,-2,7.1,8.1,-1.0,20,FRA
3f5b4635,24,1941,21.6,23,20,1,2,25,26,-1,26.7,25.4,1.2,20,FRA
4085f08e,22,1916,21.3,21,20,1,6,27,42,-15,23.6,33.1,-9.5,20,FRA
414e1f69,9,99,1.1,0,0,9,15,3,3,0,2.4,1.6,0.7,20,FRA
41e7ef1c,14,858,9.5,9,7,5,4,24,7,17,23.2,8.7,14.5,20,FRA
42dcf26d,20,1628,18.1,19,17,1,2,30,17,13,22.0,19.4,2.6,20,FRA
42eaa028,28,2057,22.9,26,5,2,0,28,17,11,30.6,21.7,9.0,20,FRA
42fd9c7f,20,1513,16.8,17,12,3,0,54,16,38,52.1,15.4,36.7,20,FRA
4315f30d,19,1454,16.2,16,13,3,4,25,18,7,19.0,26.0,-6.9,20,FRA
433dc9a2,18,1388,15.4,16,12,2,2,42,15,27,45.1,13.2,31.9,20,FRA
436a9dd0,8,547,6.1,6,4,2,4,17,7,10,15.8,4.9,10.9,20,FRA
43b78598,20,1267,14.1,14,7,6,1,47,16,31,42.8,13.3,29.4,20,FRA
43e7a164,25,2064,22.9,23,22,2,1,29,24,5,30.5,27.2,3.3,20,FRA
44f8c299,17,1335,14.8,15,10,2,0,16,18,-2,18.5,17.1,1.4,20,FRA
450e277f,11,812,9.0,8,8,3,15,8,16,-8,9.7,8.3,1.3,20,FRA
45c1c326,20,1506,16.7,18,8,2,0,17,18,-1,17.8,21.4,-3.6,20,FRA
462475ed,26,2058,22.9,24,12,2,1,31,21,10,28.6,25.4,3.2,20,FRA
46750e9c,11,395,4.4,3,0,8,9,10,7,3,6.8,6.5,0.3,20,FRA
468fdbad,6,360,4.0,4,3,2,2,2,4,-2,5.1,2.5,2.6,20,FRA
46907171,7,371,4.1,4,1,3,0,6,3,3,6.2,2.8,3.4,20,FRA
469d3d84,15,623,6.9,6,2,9,1,7,14,-7,8.3,10.9,-2.5,20,FRA
46a7b605,1,25,0.3,0,0,1,1,0,0,0,0.2,0.1,0.1,20,FRA
46d50339,12,855,9.5,10,8,2,10,9,15,-6,7.2,12.5,-5.2,20,FRA
46faabfa,21,951,10.6,9,3,12,5,11,10,1,9.6,14.1,-4.5,20,FRA
4749367a,6,373,4.1,4,2,2,8,1,4,-3,3.5,4.4,-0.8,20,FRA
475583ff,21,1530,17.0,17,12,4,6,20,28,-8,17.6,27.8,-10.2,20,FRA
4788cb6b,1,8,0.1,0,0,1,2,0,0,0,0.1,0.1,0.0,20,FRA
47af88b8,25,2131,23.7,24,22,1,1,37,22,15,30.8,23.0,7.8,20,FRA
47c609d5,7,453,5.0,6,1,1,0,5,3,2,5.4,5.4,-0.1,20,FRA
48b28bfd,11,630,7.0,8,2,3,3,8,10,-2,9.6,8.0,1.6,20,FRA
49070d66,4,360,4.0,4,4,0,8,4,4,0,3.8,6.1,-2.3,20,FRA
4914ed4a,4,231,2.6,3,2,1,5,2,6,-4,2.7,4.8,-2.1,20,FRA
4a537185,1,1,0.0,0,0,1,0,0,0,0,0.0,0.0,0.0,20,FRA
4b96c347,20,1579,17.5,19,12,1,2,12,17,-5,15.9,17.3,-1.4,20,FRA
4be0b467,12,666,7.4,8,1,4,4,5,8,-3,7.3,7.6,-0.3,20,FRA
4bf69118,14,983,10.9,13,8,1,9,16,11,5,12.1,15.6,-3.6,20,FRA
4c4ffacc,20,1587,17.6,18,15,2,8,15,23,-8,17.3,23.1,-5.8,20,FRA
4c700f46,14,924,10.3,10,8,4,7,14,9,5,11.4,14.0,-2.7,20,FRA
4c93a97f,1,45,0.5,1,0,0,1,2,2,0,0.5,0.6,-0.1,20,FRA
4e0afc5d,24,2016,22.4,22,21,2,1,26,24,2,24.5,26.9,-2.3,20,FRA
4e7bfc23,11,401,4.5,4,2,7,13,2,4,-2,4.6,4.5,0.1,20,FRA
4e7d66f8,12,764,8.5,9,2,3,8,7,16,-9,7.6,11.3,-3.6,20,FRA
4e7db402,27,2430,27.0,27,27,0,0,27,29,-2,27.5,27.8,-0.3,20,FRA
4f255115,18,1175,13.0,13,8,5,8,21,14,7,12.4,18.5,-6.1,20,FRA
5046b7d4,20,907,10.1,10,1,10,1,14,9,5,12.4,9.0,3.4,20,FRA
5065d67d,15,1268,14.1,13,12,2,3,16,15,1,12.5,26.0,-13.5,20,FRA
509a4ccb,21,858,9.5,9,2,12,4,17,14,3,17.2,15.0,2.2,20,FRA
5148dcc5,23,1198,13.3,13,6,10,3,16,12,4,17.0,13.3,3.7,20,FRA
51c30111,3,78,0.9,1,0,2,4,0,2,-2,0.6,1.2,-0.6,20,FRA
51c83a90,2,123,1.4,1,1,1,26,3,3,0,0.9,2.5,-1.6,20,FRA
51dbeea9,7,480,5.3,5,4,2,3,20,7,13,18.7,6.1,12.5,20,FRA
527f063d,14,605,6.7,7,3,7,2,15,9,6,19.7,6.6,13.0,20,FRA
5314e067,17,1400,15.6,17,11,0,8,13,23,-10,16.7,21.9,-5.2,20,FRA
53283127,1,1,0.0,0,0,1,5,0,0,0,0.0,0.1,-0.1,20,FRA
53e585f2,2,25,0.3,0,0,2,2,0,0,0,0.7,0.4,0.3,20,FRA
54131505,15,982,10.9,11,5,4,10,14,14,0,13.1,16.9,-3.9,20,FRA
542cc80f,19,1224,13.6,14,9,5,6,15,21,-6,14.0,25.7,-11.7,20,FRA
57a46f3f,2,25,0.3,0,0,2,4,0,1,-1,0.2,0.9,-0.7,20,FRA
5853ac44,6,452,5.0,4,3,2,8,18,6,12,14.6,3.5,11.1,20,FRA
586ef3a3,1,90,1.0,1,1,0,27,0,3,-3,0.3,2.8,-2.5,20,FRA
58ad9383,27,2430,27.0,27,27,0,0,26,18,8,30.3,25.7,4.6,20,FRA
58ae47b2,22,1930,21.4,22,15,0,0,34,19,15,29.1,21.6,7.5,20,FRA
59bf127b,20,1719,19.1,20,17,0,0,36,30,6,36.5,29.2,7.3,20,FRA
5b1bf5e3,24,2001,22.2,23,13,1,0,23,35,-12,21.4,28.4,-7.0,20,FRA
5b5724d2,18,1272,14.1,14,11,4,8,13,24,-11,16.2,22.2,-6.0,20,FRA
5c2da10f,20,963,10.7,11,1,9,5,16,7,9,17.6,11.4,6.2,20,FRA
5c9ac7f0,6,292,3.2,3,1,3,0,5,3,2,3.1,3.4,-0.3,20,FRA
5ceba7fc,8,538,6.0,5,2,3,0,8,5,3,8.0,5.7,2.3,20,FRA
5d42d487,13,349,3.9,3,0,10,4,4,4,0,3.6,4.3,-0.6,20,FRA
5d93ccee,1,90,1.0,1,1,0,10,1,0,1,1.7,1.3,0.3,20,FRA
5d9577aa,1,18,0.2,0,0,1,14,0,1,-1,0.2,0.4,-0.2,20,FRA
5e080f73,21,1450,16.1,15,10,6,2,22,22,0,19.6,25.4,-5.8,20,FRA
5e22e2a4,28,2505,27.8,28,27,0,0,28,33,-5,29.2,28.4,0.8,20,FRA
5f0241b2,2,180,2.0,2,2,0,21,6,4,2,7.6,2.6,5.0,20,FRA
5f26e0c5,11,990,11.0,11,11,0,5,11,18,-7,9.8,16.0,-6.2,20,FRA
5f3eaaf5,26,2177,24.2,25,19,1,0,25,26,-1,27.2,27.3,-0.1,20,FRA
6043997c,4,116,1.3,0,0,4,11,2,2,0,1.5,2.1,-0.6,20,FRA
60f58477,1,6,0.1,0,0,1,4,0,0,0,0.2,0.1,0.1,20,FRA
61590953,17,1273,14.1,14,12,3,4,24,18,6,19.1,21.5,-2.4,20,FRA
6191093d,24,1845,20.5,22,7,2,0,18,27,-9,21.2,24.5,-3.2,20,FRA
625c144a,25,2250,25.0,25,25,0,0,35,27,8,31.1,28.7,2.4,20,FRA
6421dd73,26,1751,19.5,20,7,6,0,16,36,-20,22.2,30.4,-8.2,20,FRA
6481421d,26,1718,19.1,22,3,4,0,15,13,2,20.4,18.5,1.9,20,FRA
65391fa7,7,415,4.6,3,3,4,10,4,8,-4,4.6,4.0,0.6,20,FRA
6578600f,1,9,0.1,0,0,1,2,0,1,-1,0.0,0.5,-0.5,20,FRA
6605d143,26,2196,24.4,26,22,0,0,22,29,-7,22.9,33.2,-10.3,20,FRA
6690ef25,16,1376,15.3,16,14,0,0,17,16,1,20.9,17.1,3.7,20,FRA
67ac5bb8,24,2087,23.2,23,22,1,1,30,21,9,34.4,25.1,9.2,20,FRA
67b7357e,10,666,7.4,9,5,1,9,2,13,-11,6.7,12.8,-6.1,20,FRA
68a87d66,3,145,1.6,2,1,1,0,4,3,1,3.6,2.6,1.1,20,FRA
69384e5d,15,1318,14.6,15,11,0,0,40,11,29,38.9,11.2,27.8,20,FRA
698b37b8,5,163,1.8,2,0,3,8,0,4,-4,1.2,2.3,-1.1,20,FRA
698f11e3,1,90,1.0,1,1,0,7,0,3,-3,0.3,1.0,-0.7,20,FRA
6a26e528,2,4,0.0,0,0,2,3,0,0,0,0.0,0.2,-0.2,20,FRA
6a827d8e,13,1003,11.1,12,8,1,0,15,16,-1,11.8,18.1,-6.3,20,FRA
6b200d45,21,1714,19.0,20,18,1,3,18,29,-11,22.2,25.9,-3.7,20,FRA
6b2c894b,16,1333,14.8,15,14,1,6,15,12,3,16.0,18.9,-3.0,20,FRA
6b4436ba,1,59,0.7,1,0,0,6,2,0,2,0.6,0.9,-0.3,20,FRA
6bca20fe,5,192,2.1,2,1,3,5,0,2,-2,2.6,2.8,-0.3,20,FRA
6bde367b,19,1524,16.9,18,9,1,0,24,22,2,20.2,22.6,-2.4,20,FRA
6be41a31,8,226,2.5,2,0,6,9,6,4,2,5.6,2.7,2.9,20,FRA
6c8ddd52,5,172,1.9,1,1,4,5,5,4,1,3.6,4.1,-0.5,20,FRA
6dfd8f05,20,1670,18.6,19,18,1,5,20,28,-8,18.2,32.2,-13.9,20,FRA
6e5b5a45,23,1869,20.8,21,16,2,1,24,29,-5,21.7,30.7,-9.0,20,FRA
6e7f1353,27,2173,24.1,26,12,1,0,34,20,14,30.9,25.1,5.9,20,FRA
6fbde63a,3,173,1.9,2,0,1,0,3,3,0,2.0,1.2,0.8,20,FRA
706a60e1,18,675,7.5,7,2,11,4,12,10,2,11.9,11.5,0.4,20,FRA
7091324a,2,16,0.2,0,0,2,6,1,1,0,1.1,0.1,1.0,20,FRA
71ec39ef,24,1763,19.6,19,16,5,2,30,21,9,26.0,18.5,7.4,20,FRA
72a0fb65,28,2520,28.0,28,28,0,0,27,37,-10,30.5,38.4,-8.0,20,FRA
72c812f3,20,1653,18.4,19,16,1,1,47,15,32,49.4,16.0,33.4,20,FRA
741418c3,22,1629,18.1,19,12,3,0,25,25,0,21.4,30.0,-8.6,20,FRA
74733221,4,360,4.0,4,4,0,21,6,5,1,5.0,6.8,-1.9,20,FRA
75a63397,26,1826,20.3,23,3,3,2,21,23,-2,17.3,26.8,-9.6,20,FRA
767212e6,22,1980,22.0,22,22,0,1,29,30,-1,24.0,37.7,-13.8,20,FRA
76806215,2,150,1.7,1,1,1,26,4,2,2,3.7,2.0,1.7,20,FRA
770d7eb8,25,2043,22.7,22,22,3,1,31,22,9,28.9,24.9,4.0,20,FRA
775185ae,17,530,5.9,5,0,12,3,6,4,2,6.1,5.3,0.8,20,FRA
779847d6,21,1890,21.0,21,21,0,0,19,20,-1,22.4,21.4,1.0,20,FRA
77d7c96f,18,1072,11.9,9,8,9,5,15,14,1,15.8,11.8,4.0,20,FRA
7800bdb8,2,180,2.0,2,2,0,26,4,2,2,3.7,2.2,1.5,20,FRA
7909ffa4,20,1251,13.9,13,8,7,5,19,17,2,17.5,15.2,2.3,20,FRA
796b1c41,7,106,1.2,0,0,7,19,1,1,0,2.1,2.1,0.0,20,FRA
79b2399c,24,1747,19.4,20,15,4,0,17,29,-12,20.0,19.8,0.2,20,FRA
7b075c75,6,415,4.6,4,4,2,7,7,5,2,7.8,4.5,3.3,20,FRA
7b9a9e25,18,908,10.1,9,4,9,3,9,15,-6,11.3,15.5,-4.1,20,FRA
7b9c2d84,25,2107,23.4,24,18,1,1,32,21,11,31.6,26.2,5.3,20,FRA
7c2965bb,1,80,0.9,1,0,0,0,0,3,-3,0.5,0.8,-0.2,20,FRA
7c6d6c96,3,270,3.0,3,3,0,0,3,4,-1,2.1,4.5,-2.4,20,FRA
7cab69b5,13,1056,11.7,13,9,0,2,20,15,5,23.1,14.4,8.8,20,FRA
7cdda3bf,28,2237,24.9,27,13,1,0,32,26,6,31.3,29.1,2.2,20,FRA
7cf431a5,20,1079,12.0,12,5,8,6,12,7,5,14.6,12.3,2.4,20,FRA
7d937aa1,13,829,9.2,10,3,3,11,7,11,-4,7.6,11.9,-4.4,20,FRA
7d9397f8,14,590,6.6,7,2,7,6,9,7,2,7.6,10.1,-2.4,20,FRA
7d9b37bf,1,7,0.1,0,0,1,1,0,0,0,0.1,0.8,-0.7,20,FRA
7dfbba27,23,1222,13.6,14,1,9,1,14,10,4,14.1,19.0,-4.9,20,FRA
7e82a78f,25,1684,18.7,19,10,6,0,28,25,3,25.0,25.6,-0.7,20,FRA
7ebfac0f,4,54,0.6,0,0,4,1,1,0,1,1.5,0.8,0.7,20,FRA
7f622eef,4,120,1.3,1,1,3,5,2,2,0,2.1,1.8,0.3,20,FRA
7fecbcdb,7,554,6.2,6,6,1,7,9,3,6,6.0,5.5,0.5,20,FRA
7ffaf233,13,262,2.9,1,0,12,5,3,2,1,2.9,3.6,-0.7,20,FRA
80556f08,15,991,11.0,11,6,4,6,14,14,0,13.0,16.2,-3.2,20,FRA
808df563,5,200,2.2,2,2,3,2,3,2,1,2.4,3.5,-1.1,20,FRA
80d1adb3,8,148,1.6,0,0,8,4,1,0,1,1.7,3.4,-1.7,20,FRA
80e4c841,22,1971,21.9,22,21,0,1,25,36,-11,23.4,27.0,-3.6,20,FRA
814ac171,2,20,0.2,0,0,2,5,0,0,0,0.0,0.1,-0.1,20,FRA
81d3318f,11,648,7.2,7,4,4,5,9,8,1,7.2,9.0,-1.8,20,FRA
822d51d7,20,1618,18.0,19,14,1,0,25,20,5,24.5,21.1,3.4000000000000004,20,FRA
82518f62,3,270,3.0,3,3,0,1,4,1,3,6.1,1.8,4.3,20,FRA
82671804,3,190,2.1,2,2,1,0,0,2,-2,2.3,1.7,0.5,20,FRA
8332db56,16,1254,13.9,14,12,2,7,11,22,-11,14.0,18.7,-4.7,20,FRA
834b5c4c,27,2430,27.0,27,27,0,0,32,32,0,34.2,32.2,2.0,20,FRA
8413ceb1,1,55,0.6,0,0,1,5,1,0,1,0.7,0.4,0.3,20,FRA
84549a07,3,133,1.5,1,0,2,5,2,2,0,1.8,1.5,0.3,20,FRA
84d94b91,19,1364,15.2,15,7,4,7,11,25,-14,12.0,22.8,-10.8,20,FRA
8577e60a,12,901,10.0,10,9,2,4,13,20,-7,11.0,14.9,-3.9,20,FRA
85e2d218,12,384,4.3,4,1,8,9,3,3,0,5.9,3.6,2.2,20,FRA
8608f269,1,72,0.8,0,0,1,6,0,4,-4,0.2,2.7,-2.5,20,FRA
861227d2,24,2115,23.5,24,23,0,1,21,28,-7,22.1,31.8,-9.6,20,FRA
86574238,13,875,9.7,11,9,2,6,3,19,-16,8.0,12.8,-4.8,20,FRA
86e7deaf,21,1571,17.5,20,13,1,0,45,11,34,45.3,13.2,32.0,20,FRA
8746d5d0,20,1434,15.9,15,12,5,5,21,25,-4,19.6,24.3,-4.6,20,FRA
87e9c7cd,2,4,0.0,0,0,2,4,0,1,-1,0.1,0.2,-0.2,20,FRA
8802c1d5,10,518,5.8,6,0,4,6,8,10,-2,6.5,8.6,-2.2,20,FRA
8846a40f,25,1542,17.1,17,9,8,0,17,24,-7,19.1,18.2,0.8,20,FRA
885b7aa7,27,2386,26.5,27,24,0,0,25,35,-10,28.8,37.1,-8.3,20,FRA
8a2248b4,26,2340,26.0,26,26,0,0,37,36,1,32.1,41.7,-9.7,20,FRA
8b28686a,1,45,0.5,1,0,0,1,0,0,0,0.1,0.4,-0.3,20,FRA
8b298f56,11,839,9.3,10,6,1,2,9,9,0,8.9,13.5,-4.6,20,FRA
8bbe2df5,18,1419,15.8,16,14,2,4,22,15,7,25.6,18.4,7.2,20,FRA
8c90fd7a,27,2287,25.4,25,21,2,0,33,23,10,37.2,26.7,10.5,20,FRA
8c955557,3,158,1.8,1,1,2,0,0,2,-2,1.6,1.4,0.1,20,FRA
8d043f1d,3,201,2.2,2,1,1,1,8,2,6,3.7,2.7,1.0,20,FRA
8da74c05,8,519,5.8,6,4,2,5,8,11,-3,8.2,9.1,-0.9,20,FRA
8eec784d,3,85,0.9,1,0,2,0,1,1,0,1.1,0.6,0.6,20,FRA
8f325097,7,556,6.2,6,5,1,5,10,3,7,7.6,5.3,2.2,20,FRA
8f4d116f,28,2458,27.3,28,24,0,0,34,33,1,34.4,33.7,0.7,20,FRA
8f534f8e,1,58,0.6,1,0,0,3,0,1,-1,0.4,0.7,-0.3,20,FRA
8f696594,13,1018,11.3,12,7,1,1,19,8,11,13.3,10.7,2.6,20,FRA
8fa8f8d2,11,901,10.0,9,9,2,15,8,17,-9,11.1,14.4,-3.2,20,FRA
9001138b,11,413,4.6,4,1,7,6,8,6,2,8.3,4.9,3.4,20,FRA
909222de,14,527,5.9,4,3,10,5,6,10,-4,6.6,8.1,-1.5,20,FRA
90eb507d,27,2430,27.0,27,27,0,1,26,18,8,30.3,25.7,4.6,20,FRA
90f87966,25,2205,24.5,25,24,0,3,30,24,6,35.2,28.8,6.4,20,FRA
90fcf472,23,1160,12.9,14,4,9,0,8,27,-19,13.4,19.8,-6.4,20,FRA
91e58f66,3,48,0.5,0,0,3,4,2,0,2,0.7,0.3,0.4,20,FRA
91f2da4c,16,683,7.6,6,2,10,1,8,9,-1,10.0,9.6,0.5,20,FRA
92232aad,21,1769,19.7,20,18,1,4,22,34,-12,24.2,28.1,-4.0,20,FRA
923f4dda,23,1921,21.3,23,17,0,0,25,34,-9,21.5,25.9,-4.4,20,FRA
92b56413,15,892,9.9,12,1,3,2,9,6,3,12.4,7.8,4.6,20,FRA
92cd4bef,21,1715,19.1,21,12,0,2,16,40,-24,21.9,29.8,-7.9,20,FRA
934a0957,1,45,0.5,1,0,0,0,1,3,-2,0.8,1.0,-0.2,20,FRA
93c942fb,3,22,0.2,0,0,3,5,0,1,-1,0.1,0.5,-0.4,20,FRA
942b4f90,26,2164,24.0,25,15,1,0,40,36,4,44.5,36.7,7.8,20,FRA
94f8d10c,23,1886,21.0,20,20,3,3,29,22,7,26.5,22.2,4.3,20,FRA
95981861,5,87,1.0,1,0,4,7,1,2,-1,1.0,1.9,-0.9,20,FRA
972aeb2a,12,992,11.0,11,11,1,1,10,15,-5,12.4,14.0,-1.6,20,FRA
9744ff80,21,1164,12.9,13,5,8,4,32,8,24,31.1,9.2,21.9,20,FRA
97bfa797,10,266,3.0,2,0,8,6,5,5,0,6.0,3.3,2.6,20,FRA
97fb4608,8,455,5.1,4,3,4,9,4,6,-2,5.8,3.8,1.9,20,FRA
9980269a,21,1616,18.0,18,15,3,1,16,14,2,20.3,16.2,4.1,20,FRA
9a1f2e1c,13,700,7.8,9,4,4,7,10,8,2,11.1,7.7,3.4,20,FRA
9a506145,8,327,3.6,4,2,4,11,5,6,-1,3.2,5.7,-2.5,20,FRA
9ae9eaea,11,829,9.2,11,8,0,1,13,7,6,14.2,6.1,8.1,20,FRA
9b398aea,17,1282,14.2,16,10,1,0,18,17,1,16.8,13.8,3.1,20,FRA
9b6556d2,14,520,5.8,5,1,9,3,9,11,-2,7.5,8.5,-1.0,20,FRA
9bb0b9f1,3,185,2.1,2,2,1,3,4,7,-3,3.3,5.8,-2.4,20,FRA
9c2b1f11,1,12,0.1,1,0,0,0,0,0,0,0.1,0.1,0.1,20,FRA
9cebd6ce,2,50,0.6,0,0,2,1,1,1,0,0.9,1.3,-0.3,20,FRA
9daeac61,6,540,6.0,6,6,0,2,5,2,3,4.8,5.6000000000000005,-0.7,20,FRA
9e64fc85,8,656,7.3,8,7,0,0,3,15,-12,7.1,8.7,-1.5,20,FRA
a0434482,17,1133,12.6,14,8,3,3,14,21,-7,12.9,17.1,-4.2,20,FRA
a046fc35,1,30,0.3,0,0,1,1,0,0,0,0.1,0.1,0.1,20,FRA
a0791826,19,821,9.1,8,1,11,3,10,12,-2,8.9,13.5,-4.6,20,FRA
a0b65401,22,1165,12.9,12,10,10,1,15,22,-7,14.4,18.1,-3.8,20,FRA
a0f9b535,17,885,9.8,9,5,8,5,14,9,5,13.7,11.9,1.8,20,FRA
a2d873dd,24,1633,18.1,19,9,5,2,24,26,-2,21.1,26.8,-5.7,20,FRA
a440d8ca,9,682,7.6,8,6,1,16,10,13,-3,7.8,11.4,-3.6,20,FRA
a46472d0,18,1473,16.4,17,15,1,4,13,23,-10,17.9,21.7,-3.8,20,FRA
a4b1028a,27,2411,26.8,27,25,0,0,37,22,15,34.7,27.4,7.3,20,FRA
a4c3f7af,25,1817,20.2,20,15,5,1,20,25,-5,20.8,25.4,-4.5,20,FRA
a5db0bec,25,1956,21.7,23,14,2,1,30,23,7,28.6,22.3,6.3,20,FRA
a634b9d2,5,450,5.0,5,5,0,18,5,5,0,5.9,6.3,-0.4,20,FRA
a8567629,1,90,1.0,1,1,0,2,4,4,0,3.2,1.3,1.9,20,FRA
a8797cf1,21,992,11.0,10,6,11,3,16,29,-13,11.6,20.2,-8.6,20,FRA
a99138af,11,200,2.2,1,0,10,11,4,2,2,3.5,1.5,2.0,20,FRA
aa1a8c7e,3,84,0.9,1,0,2,1,1,2,-1,1.1,1.3,-0.2,20,FRA
aad56ca3,1,1,0.0,0,0,1,2,0,0,0,0.0,0.0,0.0,20,FRA
ab096c6f,15,1305,14.5,14,14,1,3,15,21,-6,13.6,21.7,-8.1,20,FRA
ac89503b,3,270,3.0,3,3,0,5,4,7,-3,4.0,5.2,-1.2,20,FRA
ad7b19ef,15,858,9.5,12,4,3,1,8,16,-8,10.8,13.5,-2.7,20,FRA
ad82197c,27,2430,27.0,27,27,0,0,25,21,4,29.0,27.1,1.8,20,FRA
ae59b359,20,1213,13.5,15,7,5,6,12,19,-7,16.1,17.0,-0.9,20,FRA
ae7d0ecd,27,2384,26.5,27,26,0,0,26,31,-5,24.9,36.1,-11.2,20,FRA
aef6e670,16,1225,13.6,14,13,2,5,42,12,30,39.5,12.8,26.7,20,FRA
af0c835b,18,523,5.8,3,2,15,10,3,9,-6,6.0,7.6,-1.6,20,FRA
b0547a87,24,1995,22.2,23,15,1,0,31,29,2,25.2,29.3,-4.1,20,FRA
b056e3da,2,180,2.0,2,2,0,23,4,2,2,2.5,2.0,0.5,20,FRA
b2336681,8,661,7.3,8,5,0,13,9,7,2,8.3,8.2,0.1,20,FRA
b2791a55,1,90,1.0,1,1,0,12,2,2,0,1.1,1.5,-0.4,20,FRA
b2bd0f6c,26,1937,21.5,22,13,4,1,27,20,7,30.3,24.1,6.2,20,FRA
b34c63a5,6,143,1.6,1,0,5,6,3,3,0,1.4,1.0,0.4,20,FRA
b49729cb,27,2397,26.6,27,26,0,0,31,34,-3,29.9,43.0,-13.2,20,FRA
b4c816a9,4,68,0.8,0,0,4,8,1,2,-1,1.0,1.0,0.1,20,FRA
b5bb8188,1,79,0.9,1,0,0,0,1,2,-1,1.2,1.6,-0.4,20,FRA
b6047994,3,132,1.5,1,1,2,1,1,2,-1,1.7,1.0,0.8,20,FRA
b666421b,23,2052,22.8,23,22,0,2,21,22,-1,23.8,23.1,0.7,20,FRA
b66d1d8a,24,2056,22.8,23,18,1,1,23,34,-11,25.0,33.1,-8.1,20,FRA
b684a484,14,440,4.9,4,0,10,5,5,3,2,4.1,4.3,-0.2,20,FRA
b748968d,6,540,6.0,6,6,0,6,3,9,-6,3.5,10.4,-6.9,20,FRA
b871bf55,7,630,7.0,7,7,0,0,7,9,-2,6.4,8.7,-2.4,20,FRA
b8d22478,20,1357,15.1,15,8,5,2,22,18,4,14.6,22.6,-8.0,20,FRA
b92edde2,2,4,0.0,0,0,2,13,0,0,0,0.1,0.1,0.1,20,FRA
b94b8be1,1,64,0.7,1,0,0,3,2,0,2,1.3,0.3,1.0,20,FRA
b98cea65,2,180,2.0,2,2,0,25,1,1,0,1.5,1.5,0.0,20,FRA
b99bec05,28,2520,28.0,28,28,0,0,22,58,-36,31.7,45.6,-13.9,20,FRA
bb67bff1,6,123,1.4,1,0,5,11,0,1,-1,1.3,1.5,-0.2,20,FRA
bc0bfc64,21,735,8.2,6,4,15,5,12,9,3,10.2,9.3,0.9,20,FRA
bc270726,28,2520,28.0,28,28,0,0,31,50,-19,27.4,39.3,-11.9,20,FRA
bc50c437,4,49,0.5,0,0,4,1,0,1,-1,0.8,0.2,0.5,20,FRA
bc7b4580,10,834,9.3,10,9,0,0,9,6,3,9.1,9.5,-0.4,20,FRA
bcc81786,20,1633,18.1,17,17,3,0,20,43,-23,22.3,31.3,-9.0,20,FRA
bced0375,25,2175,24.2,25,23,0,0,15,52,-37,27.0,40.8,-13.7,20,FRA
bcf1b2e9,23,2035,22.6,22,22,1,2,22,49,-27,27.0,39.0,-11.9,20,FRA
bdedd861,28,1563,17.4,17,5,11,0,14,21,-7,16.8,18.2,-1.4,20,FRA
be13e5a8,1,90,1.0,1,1,0,5,0,1,-1,1.3,0.8,0.5,20,FRA
beae3a73,24,2027,22.5,23,18,1,0,20,38,-18,23.6,35.0,-11.4,20,FRA
beb391dd,22,1330,14.8,14,9,8,2,17,16,1,19.0,14.0,5.0,20,FRA
bef0a7ac,26,2101,23.3,25,10,1,0,33,24,9,30.2,27.0,3.2,20,FRA
bef22bc4,10,465,5.2,6,1,4,5,2,5,-3,4.7,5.3,-0.6,20,FRA
c05d65d1,2,14,0.2,0,0,2,5,0,0,0,0.2,0.8,-0.6,20,FRA
c1b16364,13,468,5.2,4,1,9,9,3,9,-6,4.5,6.3,-1.8,20,FRA
c20bdcd7,16,1110,12.3,12,11,4,6,13,12,1,15.0,12.8,2.2,20,FRA
c26a3918,22,1980,22.0,22,22,0,2,19,29,-10,23.2,22.7,0.6,20,FRA
c3e4ecbb,10,842,9.4,8,8,2,10,11,23,-12,6.3,18.2,-11.9,20,FRA
c46fa34c,12,536,6.0,6,2,6,5,7,6,1,5.7,7.2,-1.5,20,FRA
c47541e0,23,1253,13.9,14,4,9,4,28,11,17,22.3,13.3,8.9,20,FRA
c4bbea9f,28,2510,27.9,28,27,0,0,35,33,2,35.1,34.4,0.7,20,FRA
c58270f8,13,163,1.8,0,0,13,14,2,1,1,2.6,3.3,-0.7,20,FRA
c5a500ca,21,1635,18.2,19,11,2,0,19,40,-21,22.0,31.3,-9.4,20,FRA
c6056d58,23,2070,23.0,23,23,0,5,36,36,0,40.5,36.3,4.2,20,FRA
c69ef855,24,1841,20.5,21,14,3,4,24,33,-9,20.7,26.4,-5.7,20,FRA
c6e5d20f,22,1812,20.1,21,15,1,0,33,20,13,25.8,19.9,5.9,20,FRA
c7526c18,5,386,4.3,4,4,1,0,9,2,7,7.0,3.8,3.2,20,FRA
c76b7567,25,2072,23.0,24,13,1,0,28,25,3,28.8,25.7,3.1,20,FRA
c795c408,2,107,1.2,1,1,1,1,0,4,-4,0.9,1.6,-0.6,20,FRA
c801616a,24,1871,20.8,21,15,3,2,21,29,-8,22.0,20.9,1.1,20,FRA
c8090cb3,23,1632,18.1,20,8,3,2,17,26,-9,18.3,24.9,-6.6,20,FRA
ca122e29,2,13,0.1,0,0,2,8,0,0,0,0.9,0.0,0.8,20,FRA
cac76a72,22,1980,22.0,22,22,0,0,25,40,-15,26.6,30.7,-4.1,20,FRA
cc41f558,13,1102,12.2,12,11,1,5,14,15,-1,11.1,18.7,-7.6,20,FRA
cc77354e,24,2139,23.8,24,22,0,0,39,24,15,33.2,26.2,7.0,20,FRA
cc83b74d,23,1888,21.0,22,14,1,0,32,27,5,26.1,32.7,-6.6,20,FRA
ccb1c3af,6,148,1.6,1,1,5,4,0,2,-2,2.6,1.3,1.3,20,FRA
ccee698e,4,151,1.7,2,0,2,0,2,1,1,1.3,2.2,-0.9,20,FRA
ce492295,19,1488,16.5,16,13,3,5,19,18,1,14.7,20.6,-5.9,20,FRA
cecbce23,19,1619,18.0,19,17,0,2,19,20,-1,19.3,24.1,-4.8,20,FRA
cfd8dde3,6,261,2.9,3,1,3,12,1,4,-3,3.4,4.3,-0.9,20,FRA
d07e3b41,20,1190,13.2,15,1,5,2,14,26,-12,10.1,19.7,-9.6,20,FRA
d14229f3,23,1210,13.4,13,4,10,1,21,12,9,21.5,14.0,7.6,20,FRA
d21e361a,8,306,3.4,4,0,4,1,6,1,5,4.7,1.7,3.1,20,FRA
d2448564,24,1492,16.6,17,2,7,2,19,23,-4,19.3,25.4,-6.1,20,FRA
d26cd32d,4,314,3.5,3,2,1,11,5,8,-3,5.4,9.7,-4.3,20,FRA
d33c706e,26,2280,25.3,26,20,0,0,35,31,4,33.1,30.9,2.3,20,FRA
d3ce9f1f,11,827,9.2,9,9,2,13,14,10,4,12.5,13.3,-0.8,20,FRA
d4133fa1,23,1942,21.6,21,20,2,2,19,37,-18,22.0,32.1,-10.1,20,FRA
d4d35152,8,236,2.6,2,1,6,8,2,4,-2,2.8,3.0,-0.2,20,FRA
d504b3e1,15,862,9.6,12,2,3,2,15,10,5,12.7,8.5,4.3,20,FRA
d512db65,2,100,1.1,1,1,1,0,2,1,1,1.8,0.9,0.9,20,FRA
d520120b,23,1997,22.2,22,21,1,0,24,29,-5,25.8,31.9,-6.1,20,FRA
d5f2f82b,19,1476,16.4,15,15,4,0,46,14,32,50.6,13.3,37.3,20,FRA
d63e2912,21,1620,18.0,19,15,2,1,22,19,3,24.7,21.5,3.2,20,FRA
d6f88a1d,22,1221,13.6,13,9,9,1,21,15,6,23.5,19.6,3.9,20,FRA
d7bf3d19,26,1695,18.8,18,12,8,2,18,25,-7,20.8,24.2,-3.4,20,FRA
d83f8f69,4,317,3.5,3,3,1,24,4,6,-2,3.0,6.5,-3.5,20,FRA
d8992b84,20,1029,11.4,11,8,9,3,11,13,-2,11.5,16.1,-4.5,20,FRA
d8b97bb3,1,10,0.1,0,0,1,0,0,0,0,0.1,0.1,0.0,20,FRA
d9764034,20,1753,19.5,20,18,0,5,32,31,1,33.8,29.8,4.0,20,FRA
d9a66c60,5,106,1.2,1,0,4,12,1,2,-1,2.3,1.3,1.0,20,FRA
dab1b8dc,1,90,1.0,1,1,0,5,1,2,-1,2.7,3.6,-0.9,20,FRA
db7849ca,12,849,9.4,9,6,3,2,14,15,-1,12.0,10.9,1.1,20,FRA
db87a2c4,1,90,1.0,1,1,0,3,2,0,2,1.6,0.4,1.2,20,FRA
dcfb17f4,4,46,0.5,0,0,4,3,0,0,0,0.6,0.7,-0.1,20,FRA
de488e56,20,1738,19.3,20,16,0,0,20,21,-1,20.2,23.0,-2.8,20,FRA
debc2f28,15,544,6.0,5,0,10,6,7,16,-9,6.5,11.0,-4.4,20,FRA
dff153a4,17,814,9.0,8,6,9,9,25,10,15,24.5,7.9,16.6,20,FRA
e067808c,20,899,10.0,9,2,11,4,13,16,-3,12.0,19.1,-7.1,20,FRA
e0f3a1f6,22,1838,20.4,22,19,0,3,27,31,-4,23.5,35.2,-11.8,20,FRA
e110ea4b,1,9,0.1,0,0,1,5,0,0,0,0.0,0.3,-0.3,20,FRA
e162b013,16,1242,13.8,14,11,2,5,37,12,25,35.2,12.6,22.7,20,FRA
e1df6989,24,2009,22.3,22,17,2,2,24,27,-3,23.9,25.7,-1.8,20,FRA
e2f9bb5f,16,1077,12.0,9,7,7,3,14,16,-2,13.7,16.1,-2.5,20,FRA
e34fc66d,18,1531,17.0,17,17,1,10,29,17,12,22.6,18.5,4.1,20,FRA
e3756e72,1,62,0.7,1,0,0,5,1,3,-2,0.8,1.6,-0.8,20,FRA
e3d0b0c4,17,1503,16.7,17,15,0,10,18,15,3,22.9,14.3,8.6,20,FRA
e3e05edf,21,1821,20.2,21,17,0,6,25,21,4,21.9,22.8,-0.9,20,FRA
e4b72e34,19,1476,16.4,17,13,2,3,17,27,-10,19.1,22.1,-3.0,20,FRA
e4bb1f08,3,32,0.4,0,0,3,10,1,0,1,0.4,0.2,0.2,20,FRA
e50623a0,20,1646,18.3,19,18,1,3,18,24,-6,16.3,26.2,-10.0,20,FRA
e54a9890,23,1803,20.0,23,13,0,3,26,14,12,23.4,19.9,3.4,20,FRA
e562a02e,2,68,0.8,1,0,1,0,1,2,-1,1.1,1.8,-0.7,20,FRA
e5cd9da6,4,160,1.8,2,0,2,3,1,3,-2,0.9,2.8,-2.0,20,FRA
e61bdd69,14,1057,11.7,12,10,2,6,17,11,6,18.4,16.6,1.9,20,FRA
e6777e6b,23,2053,22.8,23,22,0,3,26,26,0,28.0,26.8,1.1,20,FRA
e68f2cb4,15,1101,12.2,12,8,3,1,13,27,-14,13.8,17.4,-3.6,20,FRA
e6eadfb8,11,818,9.1,10,6,1,2,18,10,8,9.9,10.2,-0.3,20,FRA
e768de1f,26,2266,25.2,26,21,0,1,26,30,-4,25.1,33.6,-8.5,20,FRA
e7986081,27,2188,24.3,24,20,3,1,38,23,15,34.7,23.6,11.1,20,FRA
e8a65bc8,1,5,0.1,0,0,1,2,0,0,0,0.2,0.6,-0.4,20,FRA
e8edfdc9,17,799,8.9,7,5,10,2,9,13,-4,10.1,16.0,-6.0,20,FRA
e90af77c,5,130,1.4,1,0,4,4,1,4,-3,1.7,2.8,-1.1,20,FRA
e90dc1d5,4,160,1.8,2,0,2,4,2,4,-2,2.1,4.3,-2.2,20,FRA
e97150c0,21,1806,20.1,20,19,1,1,23,18,5,25.2,23.3,1.8,20,FRA
e9743d8a,3,151,1.7,2,0,1,4,3,2,1,4.3,2.4,1.9,20,FRA
ea02beaf,26,1959,21.7,21,11,5,0,20,14,6,25.7,20.7,5.0,20,FRA
ea0aa7e0,18,811,9.0,8,5,10,7,8,15,-7,13.6,13.0,0.6,20,FRA
ea0ff634,25,1350,15.0,14,6,11,3,26,22,4,18.1,20.2,-2.1,20,FRA
ea42c03f,10,858,9.5,9,8,1,5,5,20,-15,11.4,18.6,-7.2,20,FRA
ea540835,4,91,1.0,0,0,4,3,0,1,-1,1.3,1.2,0.1,20,FRA
ecada4fc,21,1890,21.0,21,21,0,1,59,18,41,56.4,18.2,38.2,20,FRA
ed45c4a5,26,2060,22.9,23,17,3,1,33,23,10,30.0,24.2,5.8,20,FRA
ed90babd,16,1123,12.5,14,4,2,0,20,15,5,16.3,18.6,-2.3,20,FRA
edd1466a,20,1528,17.0,18,14,2,5,18,20,-2,20.1,21.3,-1.2,20,FRA
edd81e2a,9,810,9.0,9,9,0,0,10,7,3,7.9,13.1,-5.2,20,FRA
ef2e5e1a,25,1416,15.7,15,13,10,0,21,17,4,22.6,19.1,3.5,20,FRA
ef7cd87a,27,2221,24.7,24,22,3,0,23,24,-1,26.9,24.5,2.4,20,FRA
ef9c1c95,26,2054,22.8,23,19,3,0,30,21,9,31.9,24.0,7.9,20,FRA
f00de885,26,2340,26.0,26,26,0,0,38,25,13,35.1,25.1,10.0,20,FRA
f10983ae,17,1389,15.4,16,14,1,4,11,26,-15,16.2,21.8,-5.5,20,FRA
f18d7ab2,10,766,8.5,8,6,2,3,8,14,-6,8.8,14.0,-5.1,20,FRA
f3600c02,17,709,7.9,8,2,9,3,9,8,1,12.7,11.1,1.6,20,FRA
f3642ba8,9,88,1.0,0,0,9,4,3,3,0,1.8,2.2,-0.5,20,FRA
f36c432f,9,473,5.3,5,0,4,0,6,6,0,7.0,5.1,1.9,20,FRA
f449640d,21,1679,18.7,18,18,3,4,29,38,-9,34.5,31.1,3.5,20,FRA
f4bc42b1,23,1508,16.8,15,10,8,1,17,17,0,16.1,19.1,-3.0,20,FRA
f5044e54,26,2252,25.0,25,23,1,0,38,34,4,32.4,39.8,-7.3,20,FRA
f54d2149,7,592,6.6,7,5,0,5,8,5,3,6.6,6.5,0.1,20,FRA
f5b6fb78,23,1896,21.1,21,19,2,0,27,28,-1,21.5,28.6,-7.2,20,FRA
f5c8b425,18,848,9.4,9,4,9,0,14,8,6,14.5,10.4,4.1,20,FRA
f5efb153,25,2183,24.3,25,24,0,2,36,28,8,25.8,30.6,-4.8,20,FRA
f6496133,20,1146,12.7,13,2,7,8,10,24,-14,13.1,19.5,-6.4,20,FRA
f7691f63,22,1489,16.5,16,11,6,2,24,23,1,24.4,23.5,0.9,20,FRA
f7b1d4e0,5,231,2.6,2,1,3,0,5,2,3,4.7,1.7,3.0,20,FRA
f81ef10d,8,568,6.3,7,4,1,12,10,5,5,8.8,6.5,2.4,20,FRA
f83c8d6c,22,1525,16.9,18,12,4,0,22,18,4,18.8,19.9,-1.1,20,FRA
f84a807c,2,62,0.7,1,0,1,0,0,2,-2,0.6,0.7,-0.1,20,FRA
f86ca403,13,632,7.1,8,3,5,11,13,6,7,8.2,7.7,0.5,20,FRA
f98b15f0,27,1994,22.2,23,13,4,1,21,32,-11,24.5,31.9,-7.5,20,FRA
f9921b7f,6,121,1.3,1,0,5,10,1,5,-4,0.7,3.5,-2.8,20,FRA
f99fe221,18,1441,16.0,16,13,2,1,21,21,0,19.7,23.3,-3.6,20,FRA
f9d5908e,9,490,5.4,6,1,3,5,11,9,2,7.2,8.6,-1.4,20,FRA
fa060e71,1,45,0.5,0,0,1,4,1,1,0,0.2,0.7,-0.5,20,FRA
fa18c72e,21,828,9.2,7,3,14,5,11,14,-3,14.1,13.1,1.0,20,FRA
fb14aa28,24,1676,18.6,20,9,4,0,21,29,-8,21.2,25.4,-4.2,20,FRA
fbbb9269,12,913,10.1,10,7,2,0,17,16,1,12.7,15.4,-2.6,20,FRA
fbf76716,15,930,10.4,10,6,5,2,17,11,6,13.6,10.200000000000001,3.4,20,FRA
fc62f087,16,1201,13.3,14,10,2,5,27,9,18,30.3,9.1,21.2,20,FRA
fcb27134,19,1503,16.7,17,15,2,3,18,21,-3,20.6,20.3,0.3,20,FRA
fcb38f57,28,2520,28.0,28,28,0,0,35,27,8,40.3,31.4,8.8,20,FRA
fcbcbd94,12,614,6.8,6,5,6,3,5,13,-8,5.4,12.8,-7.4,20,FRA
fd2bc67d,21,1890,21.0,21,21,0,0,31,26,5,27.5,31.5,-4.0,20,FRA
feb5d3ab,19,1605,17.8,18,16,1,5,16,16,0,19.8,18.9,0.9,20,FRA
ff0ab48c,16,1346,15.0,15,14,1,0,24,12,12,19.4,14.3,5.1,20,FRA
ff20acfe,1,15,0.2,0,0,1,4,0,0,0,0.2,0.2,0.0,20,FRA
ff3a6a60,1,37,0.4,0,0,1,2,1,1,0,0.4,0.5,-0.1,20,FRA
ffec9769,18,1285,14.3,14,10,4,1,28,19,9,28.0,21.1,6.9,20,FRA
00242715,32,2866,31.8,32,31,0,0,37,45,-8,48.2,44.2,4.0,21,GER
00242b75,29,2303,25.6,27,13,2,4,28,37,-9,38.9,39.5,-0.5,21,GER
00844823,18,1222,13.6,12,12,6,16,12,29,-17,13.8,23.3,-9.4,21,GER
00963611,21,1463,16.3,19,8,2,4,24,22,2,19.2,23.7,-4.5,21,GER
009a4f60,24,1069,11.9,10,4,14,9,17,18,-1,15.2,14.3,0.9,21,GER
016ff750,22,1240,13.8,13,5,9,1,25,24,1,23.7,17.8,5.9,21,GER
01834aa0,24,2083,23.1,23,23,1,1,21,40,-19,27.2,37.0,-9.8,21,GER
02760e49,7,371,4.1,5,0,2,8,3,9,-6,4.2,7.8,-3.6,21,GER
028e70b9,3,92,1.0,1,0,2,2,1,3,-2,0.6,1.3,-0.8,21,GER
042e8a49,29,1752,19.5,23,3,6,2,49,24,25,41.5,23.2,18.3,21,GER
048a1cbc,27,2218,24.6,25,19,2,1,58,34,24,50.4,29.6,20.8,21,GER
05439de2,32,2675,29.7,30,27,2,0,82,43,39,62.7,37.5,25.2,21,GER
054849d2,18,1560,17.3,18,14,0,1,21,24,-3,20.2,27.4,-7.2,21,GER
056d2d95,31,2572,28.6,30,22,1,1,40,38,2,38.9,36.0,2.8,21,GER
05ba9d7c,31,1506,16.7,17,2,14,1,25,32,-7,25.2,25.0,0.2,21,GER
05d548d8,33,2813,31.3,32,27,1,0,67,45,22,62.2,38.4,23.8,21,GER
05f99a4a,29,1373,15.3,16,1,13,2,17,29,-12,22.5,27.6,-5.1,21,GER
061e8e23,24,1111,12.3,13,1,11,4,27,16,11,18.9,16.8,2.1,21,GER
0630eb63,12,611,6.8,5,2,7,1,8,6,2,9.4,7.3,2.1,21,GER
070ec0b1,18,1170,13.0,14,8,4,2,20,17,3,13.3,13.8,-0.5,21,GER
080440a4,29,2527,28.1,29,27,0,0,54,42,12,50.3,35.7,14.6,21,GER
08593525,31,2563,28.5,31,18,0,1,45,47,-2,43.1,41.8,1.3,21,GER
088ca1bd,31,2393,26.6,27,17,4,0,38,40,-2,35.2,39.9,-4.7,21,GER
096a77c4,7,98,1.1,1,0,6,17,2,1,1,2.1,0.8,1.3,21,GER
0a1cb833,34,3060,34.0,34,34,0,0,36,57,-21,32.9,53.2,-20.3,21,GER
0a3d6d2b,14,1033,11.5,12,8,2,9,16,14,2,14.3,12.5,1.8,21,GER
0a89e877,13,540,6.0,5,3,8,7,9,7,2,11.2,6.1,5.0,21,GER
0b4f388a,31,1440,16.0,16,7,15,0,29,28,1,29.0,23.4,5.6,21,GER
0b7dae21,11,899,10.0,11,9,0,6,10,19,-9,8.3,16.5,-8.2,21,GER
0c61c77c,29,1855,20.6,21,3,8,0,29,35,-6,26.5,30.2,-3.7,21,GER
0cddeaa7,18,421,4.7,2,0,16,13,13,5,8,8.8,7.5,1.4,21,GER
0d55d942,26,2340,26.0,26,26,0,8,34,39,-5,32.3,36.5,-4.2,21,GER
0d8a37c2,4,344,3.8,3,3,1,30,9,6,3,6.2,5.2,1.0,21,GER
0da32a38,13,343,3.8,2,0,11,12,3,9,-6,1.8,7.6,-5.8,21,GER
0e0102eb,1,1,0.0,0,0,1,6,0,0,0,0.1,0.0,0.1,21,GER
0e6bc38c,22,820,9.1,8,4,14,7,20,9,11,18.3,9.3,9.0,21,GER
0fbecd11,24,1528,17.0,16,13,8,8,25,23,2,31.200000000000003,21.200000000000003,10.0,21,GER
1025db8e,32,2835,31.5,32,31,0,1,35,48,-13,34.2,52.4,-18.3,21,GER
106bca06,19,942,10.5,10,3,9,10,10,33,-23,11.4,22.9,-11.5,21,GER
11bc43f4,1,18,0.2,0,0,1,1,0,0,0,0.0,0.1,0.0,21,GER
11d8aff0,1,90,1.0,1,1,0,28,1,2,-1,2.6,1.1,1.5,21,GER
11fd2b75,24,1762,19.6,21,15,3,3,12,47,-35,16.5,40.2,-23.7,21,GER
1238a3f9,23,813,9.0,7,3,16,4,6,18,-12,10.0,13.8,-3.8,21,GER
13203c45,20,1229,13.7,14,7,6,6,24,17,7,20.9,18.8,2.0,21,GER
14a7af33,23,1468,16.3,17,9,6,3,13,31,-18,14.0,26.3,-12.3,21,GER
15413fa5,28,1371,15.2,15,7,13,6,13,27,-14,15.3,25.4,-10.0,21,GER
15b287da,32,2356,26.2,28,6,4,1,51,42,9,43.6,36.5,7.1,21,GER
15f24fe7,33,2136,23.7,23,10,10,1,37,36,1,31.0,36.1,-5.1,21,GER
15fd5593,3,222,2.5,3,0,0,0,4,3,1,2.9,3.2,-0.3,21,GER
169fd162,18,460,5.1,3,1,15,9,9,5,4,8.6,6.4,2.2,21,GER
16b4260e,7,102,1.1,0,0,7,6,0,4,-4,1.6,2.6,-1.0,21,GER
16daec92,23,822,9.1,7,2,16,2,12,14,-2,14.7,15.8,-1.2,21,GER
17376543,34,3060,34.0,34,34,0,0,36,54,-18,37.3,57.3,-20.0,21,GER
17780d2b,29,1846,20.5,21,13,8,5,19,32,-13,19.6,32.2,-12.5,21,GER
17f3620a,32,1630,18.1,18,3,14,0,20,27,-7,20.8,23.3,-2.5,21,GER
18a9efe4,13,359,4.0,3,0,10,2,7,6,1,8.3,6.3,2.0,21,GER
19a967ab,4,71,0.8,0,0,4,3,3,2,1,2.4,2.1,0.3,21,GER
1a1033a1,21,469,5.2,3,0,18,10,7,8,-1,9.0,8.2,0.8,21,GER
1a4b9094,8,452,5.0,5,4,3,17,13,9,4,8.8,7.2,1.6,21,GER
1a5d7cb9,21,1160,12.9,15,3,6,11,14,18,-4,12.6,17.4,-4.8,21,GER
1a83027b,16,456,5.1,4,0,12,14,6,6,0,7.9,8.3,-0.4,21,GER
1ae836b1,30,1833,20.4,20,8,10,3,20,36,-16,21.8,32.5,-10.7,21,GER
1b6d8083,4,51,0.6,0,0,4,3,0,3,-3,0.3,1.7,-1.3,21,GER
1bc432b7,22,1305,14.5,15,3,7,3,13,33,-20,12.7,28.4,-15.7,21,GER
1be390b3,5,58,0.6,0,0,5,1,1,1,0,0.7,1.4,-0.7,21,GER
1c08a3c8,5,60,0.7,0,0,5,7,1,1,0,1.0,1.3,-0.3,21,GER
1cbe4984,23,1737,19.3,19,15,4,2,30,19,11,26.7,23.2,3.5,21,GER
1d8e9add,24,1841,20.5,20,18,4,3,27,37,-10,32.6,35.4,-2.8,21,GER
1df0c0b9,24,1377,15.3,14,9,10,10,17,30,-13,18.4,29.6,-11.1,21,GER
1e43fad8,22,1876,20.8,22,20,0,2,18,50,-32,18.2,41.0,-22.7,21,GER
1f2d714c,11,272,3.0,1,0,10,16,9,0,9,7.0,2.4,4.6,21,GER
1f44ac21,28,2407,26.7,27,23,1,0,64,33,31,54.5,33.0,21.5,21,GER
1fc4f3d1,1,1,0.0,0,0,1,9,0,0,0,0.0,0.0,0.0,21,GER
1fda91b3,9,277,3.1,2,1,7,22,3,9,-6,5.3,6.5,-1.2,21,GER
20030c06,29,2363,26.3,25,25,4,4,46,24,22,51.5,24.0,27.5,21,GER
217c93a1,7,200,2.2,2,0,5,18,3,1,2,3.1,1.6,1.5,21,GER
220ace7e,22,1177,13.1,13,1,9,6,15,23,-8,12.5,23.1,-10.6,21,GER
228f73ae,26,1391,15.5,16,1,10,0,33,25,8,26.9,19.8,7.1,21,GER
22919e97,18,479,5.3,3,1,15,6,13,6,7,11.1,10.4,0.7,21,GER
229cd98a,23,1090,12.1,13,1,10,1,8,18,-10,9.6,19.5,-9.8,21,GER
234204f4,2,69,0.8,1,0,1,10,0,0,0,0.6,0.8,-0.2,21,GER
2374aaca,15,934,10.4,10,6,5,0,16,13,3,17.7,16.2,1.5,21,GER
2590ddf7,2,18,0.2,0,0,2,5,0,0,0,0.9,0.0,0.9,21,GER
25ab9c9c,27,1954,21.7,22,14,5,7,35,31,4,31.6,32.8,-1.3,21,GER
25f50295,22,1356,15.1,15,13,7,12,10,25,-15,10.8,27.8,-17.0,21,GER
2696b6a9,13,386,4.3,4,1,9,6,5,8,-3,4.0,6.1,-2.0,21,GER
271b8617,30,1963,21.8,24,9,6,0,30,28,2,28.0,27.1,0.9,21,GER
2723ce5d,2,34,0.4,0,0,2,2,1,1,0,0.3,0.7,-0.3,21,GER
27270af4,5,69,0.8,0,0,5,5,0,2,-2,1.3,1.4,-0.1,21,GER
277c49ed,30,2590,28.8,29,27,1,2,49,32,17,41.0,36.1,4.9,21,GER
27d2618c,8,720,8.0,8,8,0,18,7,13,-6,9.6,11.0,-1.4,21,GER
2903a856,24,1817,20.2,21,11,3,1,35,33,2,30.8,24.7,6.2,21,GER
2a29eb9b,19,884,9.8,11,1,8,9,15,17,-2,11.7,16.2,-4.6,21,GER
2a6cd437,10,575,6.4,7,2,3,11,14,5,9,9.2,8.8,0.4,21,GER
2b09d998,27,1850,20.6,21,13,6,1,35,19,16,37.0,18.7,18.2,21,GER
2b114be3,32,1805,20.1,18,3,14,0,58,30,28,45.0,24.9,20.1,21,GER
2b5527c4,1,1,0.0,0,0,1,14,0,0,0,0.0,0.0,0.0,21,GER
2b7c56b4,25,1198,13.3,12,1,13,7,20,24,-4,22.1,21.3,0.8,21,GER
2b83fa49,29,1768,19.6,20,12,9,4,22,42,-20,24.1,36.3,-12.2,21,GER
2c0558b8,26,881,9.8,7,0,19,8,26,14,12,18.5,12.2,6.3,21,GER
2c44a35d,9,474,5.3,6,2,3,3,6,9,-3,4.8,6.8,-2.0,21,GER
2d61d13a,14,1243,13.8,14,12,0,1,11,38,-27,14.5,31.0,-16.5,21,GER
2db2fd7b,29,2368,26.3,29,18,0,3,75,33,42,59.1,29.5,29.6,21,GER
2e7ff968,16,1395,15.5,16,15,0,15,37,16,21,31.1,17.4,13.7,21,GER
2f3e911a,5,262,2.9,3,2,2,2,0,3,-3,2.8,2.9,-0.1,21,GER
2f7fec15,2,16,0.2,0,0,2,3,1,0,1,0.6,0.4,0.2,21,GER
2ff76adc,20,1674,18.6,19,16,1,8,23,27,-4,26.2,26.7,-0.5,21,GER
302527b2,34,2993,33.3,34,32,0,0,50,51,-1,44.3,51.3,-7.0,21,GER
30941e96,26,2161,24.0,24,18,2,2,43,20,23,46.2,19.6,26.5,21,GER
30c220c3,5,226,2.5,2,1,3,14,7,3,4,3.9,1.5,2.4,21,GER
3189f61a,9,548,6.1,6,4,3,2,2,19,-17,3.9,14.0,-10.0,21,GER
32e7ce92,4,292,3.2,3,3,1,26,2,1,1,4.6,2.8,1.8,21,GER
33144cc5,3,220,2.4,3,0,0,5,0,9,-9,0.7,5.8,-5.1,21,GER
33340bd6,1,5,0.1,0,0,1,16,0,0,0,0.0,0.0,0.0,21,GER
33b554b7,29,1800,20.0,21,7,8,2,21,43,-22,23.0,35.3,-12.3,21,GER
34a0f5ff,12,529,5.9,5,0,7,3,9,7,2,5.3,7.9,-2.6,21,GER
34b54da7,8,269,3.0,3,2,5,23,7,6,1,6.6,4.1,2.4,21,GER
34e12499,16,1285,14.3,15,11,1,5,22,20,2,20.8,19.9,0.8,21,GER
34e4343c,8,221,2.5,1,0,7,5,0,6,-6,2.8,5.5,-2.7,21,GER
35d64857,19,1459,16.2,16,14,3,11,36,29,7,26.2,23.8,2.5,21,GER
36a3ff67,32,2279,25.3,27,7,5,1,58,29,29,51.3,27.2,24.2,21,GER
36a59ba4,33,2622,29.1,30,18,3,0,55,46,9,47.1,37.7,9.4,21,GER
378825c7,25,1811,20.1,20,13,5,1,40,36,4,28.0,25.4,2.6,21,GER
37998008,4,360,4.0,4,4,0,16,3,7,-4,6.9,5.5,1.3,21,GER
37f606f0,9,658,7.3,9,3,0,0,10,12,-2,11.0,13.0,-1.9,21,GER
384d58d9,25,1419,15.8,15,7,10,1,37,26,11,24.9,21.8,3.2,21,GER
38ac43d3,9,395,4.4,4,0,5,0,4,4,0,5.6,5.2,0.4,21,GER
3935e52e,17,1426,15.8,16,14,1,0,12,38,-26,11.4,27.2,-15.8,21,GER
3a233281,30,2141,23.8,25,15,5,0,42,27,15,33.0,29.4,3.6,21,GER
3bb625ac,14,841,9.3,9,4,5,3,10,17,-7,15.5,15.3,0.2,21,GER
3c4b7820,14,458,5.1,5,1,9,7,4,7,-3,4.3,7.7,-3.4,21,GER
3c6089ab,32,2674,29.7,31,20,1,0,90,37,53,65.4,34.5,30.9,21,GER
3cd9e95a,34,3009,33.4,34,33,0,0,33,59,-26,40.3,52.2,-12.0,21,GER
3eb0f2df,27,1903,21.1,24,9,3,3,24,36,-12,26.3,30.9,-4.6,21,GER
3eeb80e0,13,377,4.2,1,0,12,1,6,6,0,6.8,7.8,-1.0,21,GER
3effaa34,32,2760,30.7,32,20,0,0,64,46,18,53.8,37.3,16.6,21,GER
3f2d59fe,13,1037,11.5,11,11,2,1,8,28,-20,8.6,22.1,-13.5,21,GER
3f65898c,34,3032,33.7,34,33,0,0,35,56,-21,32.2,51.2,-19.0,21,GER
3f7cd8f1,1,27,0.3,0,0,1,5,1,1,0,0.3,0.4,-0.1,21,GER
4114f306,3,53,0.6,1,0,2,3,1,2,-1,0.4,2.5,-2.1,21,GER
41bff4fa,12,821,9.1,9,7,3,11,8,12,-4,10.9,13.0,-2.1,21,GER
420c18a1,31,2712,30.1,31,30,0,0,55,50,5,48.8,40.6,8.2,21,GER
437f2b00,31,2369,26.3,28,13,3,0,42,46,-4,40.2,41.4,-1.2,21,GER
441197b8,23,2044,22.7,23,22,0,4,51,35,16,36.5,31.4,5.1,21,GER
442b56fa,34,2858,31.8,33,21,1,0,60,43,17,47.4,42.8,4.5,21,GER
4468ec10,10,442,4.9,5,2,5,2,5,12,-7,7.6,6.7,0.9,21,GER
4567a0b4,14,715,7.9,8,0,6,1,8,10,-2,10.5,11.4,-0.9,21,GER
45a03961,24,1943,21.6,22,19,2,6,61,27,34,45.9,25.6,20.4,21,GER
463503e2,5,219,2.4,2,0,3,12,1,5,-4,3.5,4.6,-1.1,21,GER
47064058,31,2790,31.0,31,31,0,0,48,51,-3,46.9,49.4,-2.5,21,GER
48035304,29,2536,28.2,29,27,0,2,52,46,6,46.8,35.8,11.0,21,GER
49296448,27,2194,24.4,25,20,2,0,73,27,46,58.8,25.8,33.0,21,GER
493924a7,22,1642,18.2,19,14,3,5,35,20,15,23.7,21.4,2.3,21,GER
496aeede,28,2033,22.6,23,16,5,3,39,37,2,34.9,31.5,3.4,21,GER
4aea5077,33,2768,30.8,31,24,2,0,57,49,8,48.3,40.8,7.5,21,GER
4b6dd263,1,5,0.1,0,0,1,1,0,1,-1,0.2,0.6,-0.5,21,GER
4c3a6744,19,813,9.0,8,0,11,7,17,12,5,16.1,11.0,5.1,21,GER
4c6facae,28,2175,24.2,25,18,3,4,51,40,11,38.2,33.8,4.4,21,GER
4ccd8957,8,108,1.2,1,0,7,7,2,5,-3,1.8,2.1,-0.4,21,GER
4d8cd038,18,894,9.9,8,4,10,1,26,15,11,15.9,12.8,3.2,21,GER
4e204552,2,89,1.0,1,0,1,7,1,2,-1,1.3,1.3,0.0,21,GER
4e3a947f,10,270,3.0,2,1,8,13,5,7,-2,4.9,6.3,-1.4,21,GER
4f16405e,19,877,9.7,10,1,9,1,11,11,0,10.1,15.3,-5.3,21,GER
4fa7cb9b,11,320,3.6,3,0,8,5,7,5,2,4.4,4.6,-0.2,21,GER
5042e5c2,9,588,6.5,7,2,2,0,7,15,-8,6.2,10.7,-4.5,21,GER
50871bcc,16,654,7.3,8,1,8,3,17,8,9,15.8,7.6,8.2,21,GER
50e6dc35,15,997,11.1,12,4,3,1,11,20,-9,17.8,18.8,-1.0,21,GER
526ea7cc,30,2682,29.8,30,28,0,0,22,47,-25,29.5,48.7,-19.1,21,GER
53070b63,1,65,0.7,1,0,0,1,0,2,-2,0.7,0.3,0.4,21,GER
53e07d0b,18,733,8.1,8,0,10,3,8,7,1,11.5,8.1,3.4,21,GER
53eeaf6a,32,744,8.3,5,0,27,1,6,9,-3,7.4,15.5,-8.1,21,GER
541127d5,12,605,6.7,6,3,6,2,3,18,-15,5.7,12.4,-6.6,21,GER
543ddcaf,20,1640,18.2,18,16,2,2,17,44,-27,15.1,33.7,-18.7,21,GER
54b4dc4e,29,1744,19.4,20,10,9,3,22,19,3,25.3,20.6,4.7,21,GER
54e4866f,31,2313,25.7,27,8,4,1,44,40,4,36.0,39.2,-3.2,21,GER
555d5edd,29,1890,21.0,20,14,9,0,39,24,15,27.6,23.7,3.9,21,GER
5569bf9a,21,1604,17.8,18,12,3,7,13,23,-10,16.2,30.7,-14.5,21,GER
56413b1f,21,1669,18.5,20,13,1,2,20,24,-4,24.9,23.3,1.6,21,GER
565bf0da,14,1222,13.6,14,12,0,0,25,17,8,24.9,15.8,9.1,21,GER
5722eced,1,18,0.2,0,0,1,0,1,0,1,0.1,0.1,0.0,21,GER
5723931e,6,46,0.5,0,0,6,3,3,0,3,1.0,0.1,0.9,21,GER
5762be5c,19,1037,11.5,10,9,9,10,14,18,-4,14.5,17.9,-3.3,21,GER
57d88cf9,29,1697,18.9,19,5,10,2,43,29,14,37.8,20.9,16.8,21,GER
582a5247,15,887,9.9,9,8,6,12,4,19,-15,9.3,17.4,-8.1,21,GER
58450270,3,238,2.6,3,0,0,0,5,6,-1,3.5,5.4,-1.9,21,GER
5853ac44,6,118,1.3,0,0,6,3,2,1,1,1.4,1.5,-0.2,21,GER
58a2e9f6,22,905,10.1,10,2,12,7,11,14,-3,11.0,14.0,-3.0,21,GER
58ce23e5,13,419,4.7,3,1,10,4,3,10,-7,4.5,9.9,-5.4,21,GER
5939baa2,24,1956,21.7,22,19,2,6,12,56,-44,17.0,44.5,-27.5,21,GER
59a48c59,3,34,0.4,0,0,3,8,0,2,-2,0.1,0.6,-0.5,21,GER
59e4b92e,27,1818,20.2,23,11,4,5,22,26,-4,20.6,32.8,-12.1,21,GER
5c4bf6ba,31,2790,31.0,31,31,0,0,33,46,-13,45.3,45.0,0.3,21,GER
5c899683,7,362,4.0,3,2,4,14,9,3,6,8.4,4.5,4.0,21,GER
5d4f7d61,29,1866,20.7,20,12,9,0,34,21,13,31.4,25.8,5.6,21,GER
5d8e331f,31,2729,30.3,30,29,1,0,49,43,6,41.9,45.8,-3.9,21,GER
5db45ee5,3,10,0.1,0,0,3,8,0,1,-1,0.0,0.1,-0.1,21,GER
5ddb8f9f,22,1318,14.6,16,7,6,7,21,23,-2,19.799999999999997,18.5,1.3,21,GER
5dfc6ad5,15,1130,12.6,13,11,2,0,24,18,6,23.9,15.1,8.7,21,GER
5e22e2a4,30,2209,24.5,28,13,2,0,37,36,1,32.3,32.3,0.0,21,GER
5e66fa06,31,2711,30.1,30,29,1,1,50,52,-2,45.8,45.2,0.7,21,GER
5ea8ef20,24,1818,20.2,19,16,5,0,27,29,-2,28.7,25.8,2.8,21,GER
5ed9b537,14,695,7.7,8,4,6,10,15,9,6,11.9,8.0,3.9,21,GER
5fd5e542,13,829,9.2,10,2,3,14,22,17,5,15.5,10.8,4.6,21,GER
603cb947,28,2379,26.4,26,17,2,0,43,41,2,39.9,41.0,-1.1,21,GER
610aa1e9,6,381,4.2,4,4,2,11,5,9,-4,7.1,7.8,-0.7,21,GER
614eca9b,22,1681,18.7,20,6,2,11,15,30,-15,16.4,31.6,-15.2,21,GER
6190474d,26,823,9.1,7,0,19,7,14,14,0,11.3,16.5,-5.2,21,GER
626fab5f,21,1540,17.1,19,11,2,4,20,22,-2,18.2,27.4,-9.2,21,GER
62ab9184,29,1936,21.5,21,16,8,5,39,24,15,29.2,28.4,0.8,21,GER
62c7067a,12,378,4.2,2,0,10,9,3,6,-3,4.9,5.4,-0.5,21,GER
62f94e47,1,25,0.3,0,0,1,11,1,1,0,1.1,0.8,0.3,21,GER
635f2732,31,2065,22.9,23,8,8,3,28,39,-11,37.1,36.7,0.3,21,GER
63b9cc6d,13,914,10.2,11,2,2,2,7,7,0,11.2,14.2,-3.0,21,GER
652d4c37,16,781,8.7,7,1,9,1,28,16,12,21.5,12.2,9.3,21,GER
66385c46,17,758,8.4,7,2,10,12,8,13,-5,11.0,13.0,-2.0,21,GER
677da306,29,2610,29.0,29,29,0,0,28,42,-14,28.7,46.5,-17.8,21,GER
68635c10,3,99,1.1,1,1,2,6,2,4,-2,1.6,2.2,-0.6,21,GER
68829001,26,1729,19.2,23,2,3,3,29,31,-2,26.6,29.5,-2.9,21,GER
69374ff5,17,1072,11.9,12,8,5,1,26,12,14,15.7,11.5,4.2,21,GER
699fb8db,21,1369,15.2,14,12,7,12,16,26,-10,17.4,24.1,-6.7,21,GER
6aa3e78b,23,1574,17.5,17,13,6,1,25,27,-2,25.6,25.3,0.2,21,GER
6b21b7b5,14,257,2.9,1,0,13,13,6,7,-1,6.1,5.2,0.9,21,GER
6b8887c2,6,56,0.6,0,0,6,8,1,3,-2,0.7,2.0,-1.3,21,GER
6bd5cd5d,34,3042,33.8,34,33,0,0,50,42,8,46.9,40.8,6.1,21,GER
6c6a3300,24,1462,16.2,14,6,10,1,19,28,-9,16.4,27.8,-11.4,21,GER
6ca598d5,2,40,0.4,0,0,2,0,0,0,0,0.1,0.4,-0.3,21,GER
6cafd68d,12,700,7.8,6,6,6,4,15,14,1,13.1,13.3,-0.2,21,GER
6ce43701,14,422,4.7,2,1,12,4,10,5,5,10.7,4.2,6.5,21,GER
6e44569a,7,125,1.4,1,0,6,16,1,1,0,2.3,2.1,0.2,21,GER
6ec6fde0,16,1184,13.2,14,10,2,2,21,22,-1,20.0,22.7,-2.7,21,GER
6ecbddf6,30,1612,17.9,18,5,12,1,19,27,-8,19.1,24.8,-5.7,21,GER
6f8cd6d0,29,1731,19.2,20,3,9,0,43,29,14,35.8,24.3,11.5,21,GER
6fd8a334,18,1136,12.6,11,9,7,15,22,16,6,19.5,14.2,5.3,21,GER
70678132,7,85,0.9,1,0,6,7,3,2,1,2.3,2.4,0.0,21,GER
70dcf94d,14,486,5.4,5,0,9,4,8,7,1,6.3,10.5,-4.2,21,GER
71ec39ef,26,2090,23.2,25,17,1,5,25,36,-11,26.9,30.2,-3.3,21,GER
7242b495,13,430,4.8,4,3,9,12,4,6,-2,6.2,6.9,-0.7,21,GER
73000a79,22,1570,17.4,19,12,3,5,29,18,11,23.2,18.7,4.5,21,GER
74c7c2db,28,1476,16.4,18,3,10,2,24,31,-7,23.5,27.3,-3.8,21,GER
74f2e748,10,436,4.8,4,2,6,4,7,8,-1,7.9,6.4,1.5,21,GER
75422cbf,1,2,0.0,0,0,1,4,0,0,0,0.1,0.0,0.1,21,GER
763b8b37,19,270,3.0,1,0,18,12,9,3,6,7.0,4.1,2.9,21,GER
76b2817e,21,1133,12.6,15,2,6,10,11,22,-11,15.9,17.0,-1.1,21,GER
76fa965f,25,1509,16.8,17,3,8,3,25,24,1,22.3,23.9,-1.5,21,GER
78b9e99c,2,11,0.1,0,0,2,6,0,0,0,0.2,0.1,0.1,21,GER
791abba1,14,1071,11.9,11,11,3,1,12,24,-12,12.5,24.1,-11.7,21,GER
7961f7aa,12,216,2.4,1,0,11,6,3,6,-3,2.9,5.6,-2.7,21,GER
79c90e45,20,1588,17.6,17,15,3,0,30,24,6,27.6,27.3,0.2,21,GER
79ca3e23,32,2537,28.2,32,13,0,0,31,40,-9,32.2,41.5,-9.2,21,GER
7aac47fe,2,128,1.4,2,1,0,0,5,3,2,3.4,3.0,0.3,21,GER
7c473e12,19,1545,17.2,17,14,2,0,25,26,-1,20.4,25.9,-5.4,21,GER
7c56da38,28,1892,21.0,19,10,9,0,40,17,23,41.6,14.5,27.1,21,GER
7ca196eb,6,147,1.6,1,0,5,7,3,5,-2,2.5,5.2,-2.7,21,GER
7cd6badb,30,1961,21.8,23,10,7,0,41,35,6,35.5,29.7,5.8,21,GER
7d841904,6,62,0.7,0,0,6,6,0,4,-4,0.7,1.9,-1.3,21,GER
7dca49f6,13,647,7.2,8,0,5,3,7,11,-4,5.9,10.2,-4.3,21,GER
7ed08d5c,1,90,1.0,1,1,0,2,1,1,0,0.8,1.3,-0.5,21,GER
7f609bfc,26,2119,23.5,25,19,1,0,37,35,2,35.0,33.8,1.2,21,GER
7f97771d,19,466,5.2,4,2,15,6,12,6,6,8.9,7.5,1.4,21,GER
7fa4e703,32,1976,22.0,23,9,9,0,44,31,13,42.2,26.6,15.6,21,GER
7fe12375,31,2768,30.8,31,30,0,0,48,42,6,42.3,40.0,2.3,21,GER
809940aa,27,1233,13.7,11,2,16,7,12,21,-9,17.0,21.7,-4.7,21,GER
80c9e555,2,34,0.4,0,0,2,9,0,0,0,0.9,0.2,0.7,21,GER
80f36c88,27,1858,20.6,23,14,4,2,27,40,-13,30.1,33.199999999999996,-3.1,21,GER
815c314f,32,2727,30.3,32,25,0,0,48,49,-1,46.1,45.4,0.7,21,GER
81868f73,1,6,0.1,0,0,1,2,0,0,0,0.1,0.1,0.1,21,GER
834d0be5,25,1245,13.8,12,3,13,4,21,15,6,17.6,15.3,2.4,21,GER
8494acc4,27,1578,17.5,17,11,10,7,32,30,2,27.1,29.8,-2.7,21,GER
857a5abe,16,1266,14.1,16,9,0,4,18,17,1,21.2,17.5,3.6,21,GER
8593f88c,34,3060,34.0,34,34,0,0,52,52,0,45.5,52.4,-6.9,21,GER
867501bf,25,1246,13.8,13,3,12,4,8,35,-27,11.1,26.3,-15.2,21,GER
86e119e0,30,2585,28.7,30,23,0,0,53,30,23,43.0,32.9,10.1,21,GER
8758ddf4,1,90,1.0,1,1,0,7,3,1,2,2.0,0.5,1.5,21,GER
8778c910,33,2970,33.0,33,33,0,1,97,42,55,73.0,38.9,34.1,21,GER
88d4144a,27,1797,20.0,22,12,5,4,19,38,-19,23.2,30.4,-7.1,21,GER
88e357ef,27,1644,18.3,20,4,7,0,63,20,43,47.3,21.0,26.3,21,GER
89ac64a6,28,2350,26.1,26,23,2,0,60,37,23,53.4,30.9,22.5,21,GER
8b6e0db2,24,1358,15.1,13,12,11,10,17,28,-11,18.7,26.9,-8.2,21,GER
8d78e732,29,2458,27.3,28,22,1,0,85,37,48,66.0,32.9,33.1,21,GER
8e235926,24,835,9.3,9,1,15,7,10,17,-7,9.1,16.6,-7.5,21,GER
8eb55dbb,18,1106,12.3,15,2,3,1,24,13,11,17.6,13.0,4.6,21,GER
8f056768,32,2626,29.2,30,15,2,0,51,33,18,41.9,36.1,5.8,21,GER
8ff2354e,24,1651,18.3,19,14,5,3,35,19,16,38.8,19.0,19.8,21,GER
901c0f97,28,2517,28.0,28,27,0,1,20,43,-23,27.5,50.0,-22.5,21,GER
90339309,32,2880,32.0,32,32,0,0,38,53,-15,48.7,48.7,0.0,21,GER
92432bc6,31,1905,21.2,21,9,10,1,37,21,16,43.8,17.3,26.5,21,GER
924f9191,24,1816,20.2,21,8,3,0,30,27,3,26.7,23.9,2.8,21,GER
92948149,11,990,11.0,11,11,0,8,10,15,-5,11.8,15.0,-3.2,21,GER
9321b8ed,2,135,1.5,1,1,1,25,2,3,-1,0.8,3.3,-2.5,21,GER
93a50d2c,12,987,11.0,11,10,1,12,18,15,3,16.5,16.7,-0.2,21,GER
94c18565,8,447,5.0,6,1,2,0,6,9,-3,8.4,7.5,1.0,21,GER
962e54cb,15,749,8.3,9,3,6,1,8,21,-13,7.8,20.0,-12.2,21,GER
9642c929,4,360,4.0,4,4,0,1,7,10,-3,5.0,8.2,-3.2,21,GER
99f7e9aa,23,1276,14.2,14,6,9,10,27,25,2,23.9,23.0,1.0,21,GER
9a2e0ccc,29,1539,17.1,20,0,9,1,29,20,9,31.2,15.3,15.9,21,GER
9ab16552,29,2288,25.4,26,19,3,4,51,38,13,46.9,33.4,13.5,21,GER
9af1f9ff,4,188,2.1,2,2,2,17,4,4,0,3.5,3.3,0.1,21,GER
9b1b7d78,6,520,5.8,6,5,0,7,4,13,-9,4.8,12.7,-8.0,21,GER
9ceb7642,11,513,5.7,6,1,5,4,4,7,-3,7.0,7.4,-0.5,21,GER
9d12e142,19,1665,18.5,18,18,1,9,38,30,8,35.1,24.2,10.9,21,GER
9f381d8b,21,1537,17.1,17,8,4,0,22,26,-4,23.5,22.9,0.6,21,GER
9f979eb2,16,1300,14.4,14,12,2,12,13,24,-11,16.6,22.3,-5.7,21,GER
9fec8860,23,1957,21.7,21,17,2,1,21,34,-13,20.4,34.6,-14.2,21,GER
a0415710,23,1726,19.2,18,12,5,1,20,36,-16,22.8,27.7,-4.9,21,GER
a0606ae8,1,51,0.6,0,0,1,33,1,1,0,0.3,1.3,-1.1,21,GER
a167537f,31,1495,16.6,17,7,14,3,36,26,10,32.7,21.1,11.6,21,GER
a2a85828,26,977,10.9,9,1,17,6,20,15,5,19.5,13.6,6.0,21,GER
a3ddb1b9,20,1494,16.6,18,12,2,0,14,46,-32,17.1,39.4,-22.3,21,GER
a42760bc,10,112,1.2,0,0,10,7,3,4,-1,1.6,1.4,0.2,21,GER
a4effc55,9,276,3.1,3,1,6,1,6,5,1,5.8,5.5,0.3,21,GER
a4f94a0d,22,1033,11.5,13,2,9,2,15,12,3,15.5,12.8,2.7,21,GER
a53b661f,32,2200,24.4,23,13,9,2,43,40,3,40.7,36.0,4.7,21,GER
a572e291,24,2109,23.4,24,22,0,1,44,35,9,38.7,35.9,2.8,21,GER
a5ae8f8e,23,1723,19.1,19,16,4,3,25,20,5,20.4,27.5,-7.1,21,GER
a5ce09f2,27,1555,17.3,17,1,10,1,18,25,-7,14.2,24.3,-10.0,21,GER
a5ec3ede,21,1370,15.2,14,13,7,12,15,26,-11,18.9,25.1,-6.2,21,GER
a65ce836,28,2133,23.7,23,19,5,3,53,32,21,44.8,31.0,13.9,21,GER
a6c58494,6,252,2.8,3,0,3,6,3,12,-9,4.9,7.0,-2.1,21,GER
a70b8345,11,945,10.5,10,10,1,9,6,24,-18,6.8,22.0,-15.2,21,GER
a73c8f95,31,2652,29.5,29,29,2,0,44,35,9,38.9,36.0,2.8,21,GER
a7813ac4,21,1430,15.9,16,10,5,8,20,34,-14,25.6,29.4,-3.7,21,GER
a8d4428b,32,2506,27.8,30,12,2,0,25,43,-18,26.5,41.0,-14.4,21,GER
a8db7ebb,24,890,9.9,8,2,16,10,12,17,-5,11.9,14.7,-2.7,21,GER
a9142dc3,6,409,4.5,5,2,1,1,6,5,1,5.3,6.1,-0.8,21,GER
a92ab7be,3,270,3.0,3,3,0,0,7,6,1,4.3,6.9,-2.6,21,GER
aad48be9,33,2793,31.0,31,29,2,1,36,50,-14,38.2,43.2,-5.0,21,GER
ab3f1bdf,1,24,0.3,0,0,1,1,0,1,-1,0.1,1.6,-1.5,21,GER
ab5b7dc1,26,977,10.9,8,2,18,6,11,13,-2,14.0,15.3,-1.3,21,GER
ab700320,18,1064,11.8,13,5,5,5,8,16,-8,14.0,18.099999999999998,-4.1,21,GER
ac73ec79,28,1677,18.6,21,9,7,2,37,14,23,33.5,12.3,21.2,21,GER
ad00b1a8,12,416,4.6,4,2,8,14,3,9,-6,5.5,7.3,-1.9,21,GER
ad3389d5,29,2565,28.5,29,28,0,0,48,29,19,38.6,30.3,8.3,21,GER
ae44e8e2,32,2194,24.4,26,8,6,0,46,20,26,46.2,19.3,26.9,21,GER
aeaf1bc1,2,37,0.4,0,0,2,4,0,1,-1,0.2,1.3,-1.0,21,GER
aeda1f69,6,137,1.5,1,1,5,4,1,1,0,1.0,1.7,-0.7,21,GER
aeed5c06,32,2388,26.5,28,18,4,0,45,30,15,34.5,29.5,4.9,21,GER
af0d79a9,26,2042,22.7,25,16,1,2,38,33,5,33.5,31.6,2.0,21,GER
afb0c500,1,90,1.0,1,1,0,26,2,2,0,2.9,1.3,1.6,21,GER
b0a0698b,28,2259,25.1,26,21,2,0,27,39,-12,31.9,34.5,-2.6,21,GER
b1a21aca,3,79,0.9,0,0,3,0,1,1,0,0.5,2.1,-1.6,21,GER
b1cd37e6,30,2534,28.2,29,26,1,0,60,42,18,46.6,36.8,9.8,21,GER
b3325a30,25,1953,21.7,24,18,1,0,13,56,-43,17.9,43.4,-25.5,21,GER
b3b7f5a6,15,432,4.8,3,1,12,17,10,12,-2,9.4,10.5,-1.2,21,GER
b4b08774,1,2,0.0,0,0,1,4,0,0,0,0.0,0.0,0.0,21,GER
b4cf5806,16,1126,12.5,14,4,2,1,14,23,-9,19.2,18.4,0.8,21,GER
b500b384,18,820,9.1,8,0,10,10,15,8,7,13.8,11.4,2.3,21,GER
b69261a0,22,1254,13.9,15,4,7,12,22,23,-1,24.4,20.4,4.0,21,GER
b6a6e0a7,20,585,6.5,6,0,14,13,12,10,2,14.2,9.5,4.7,21,GER
b77f44a4,34,3060,34.0,34,34,0,0,50,43,7,46.9,42.8,4.1,21,GER
b797f558,14,651,7.2,5,0,9,14,6,16,-10,4.7,13.2,-8.4,21,GER
b825a650,27,1932,21.5,24,8,3,3,38,15,23,42.1,14.2,27.9,21,GER
b93b7882,17,506,5.6,5,1,12,7,5,10,-5,6.5,8.3,-1.8,21,GER
bb08bce9,17,1299,14.4,14,13,3,12,17,19,-2,18.7,17.9,0.8,21,GER
bbd86530,27,2248,25.0,27,17,0,1,41,31,10,32.9,30.5,2.4,21,GER
bc249af8,15,296,3.3,2,0,13,7,4,5,-1,3.2,7.2,-4.1,21,GER
bc6bd723,29,1803,20.0,19,7,10,1,39,28,11,29.6,25.6,4.1,21,GER
bcb2ccd8,33,2970,33.0,33,33,0,0,59,30,29,61.8,28.3,33.5,21,GER
bd142efb,27,2219,24.7,24,22,3,7,37,29,8,37.0,29.6,7.4,21,GER
be42a291,32,1378,15.3,14,5,18,2,27,30,-3,21.1,23.1,-2.1,21,GER
be625686,1,17,0.2,0,0,1,2,0,0,0,0.1,0.2,-0.1,21,GER
beb882a8,33,2942,32.7,33,31,0,0,34,52,-18,30.5,49.7,-19.2,21,GER
beda9675,7,108,1.2,0,0,7,4,0,3,-3,0.4,2.0,-1.6,21,GER
bee0bab1,22,798,8.9,7,0,15,5,8,7,1,12.8,9.2,3.6,21,GER
bf075f6b,28,1661,18.5,22,1,6,0,29,29,0,23.7,28.1,-4.4,21,GER
bfd522a6,1,8,0.1,0,0,1,10,1,0,1,0.5,0.0,0.5,21,GER
c0d3bd23,16,1108,12.3,13,9,3,10,10,25,-15,10.7,20.6,-9.9,21,GER
c1242d4e,34,3060,34.0,34,34,0,0,26,52,-26,32.9,56.8,-23.9,21,GER
c149016b,33,2955,32.8,33,31,0,0,56,53,3,50.2,49.8,0.4,21,GER
c18d22f5,23,1692,18.8,22,10,1,11,28,30,-2,24.7,26.1,-1.4,21,GER
c1b7847c,3,84,0.9,1,0,2,1,1,4,-3,2.5,1.9,0.6,21,GER
c2009df3,19,1290,14.3,15,7,4,1,16,28,-12,20.2,23.7,-3.6,21,GER
c2211709,32,2785,30.9,32,26,0,1,30,56,-26,36.5,50.1,-13.6,21,GER
c3ee18ef,23,1597,17.7,18,12,5,8,59,16,43,43.3,19.4,23.9,21,GER
c3fd9887,4,156,1.7,1,0,3,4,2,3,-1,1.8,4.7,-2.9,21,GER
c41f7379,3,270,3.0,3,3,0,30,4,3,1,5.0,3.7,1.3,21,GER
c4e87b8b,34,2941,32.7,33,24,1,0,58,35,23,47.8,40.4,7.4,21,GER
c50281a0,14,936,10.4,12,5,2,3,22,8,14,14.9,11.5,3.4,21,GER
c51e68be,5,38,0.4,0,0,5,5,2,0,2,0.7,0.4,0.2,21,GER
c5224618,5,305,3.4,3,2,2,27,4,8,-4,4.4,6.3,-1.9,21,GER
c562c5b4,25,2162,24.0,24,23,1,8,20,33,-13,25.7,38.9,-13.3,21,GER
c59b67ed,1,15,0.2,0,0,1,2,0,0,0,0.1,0.2,-0.1,21,GER
c5fd13e9,26,1940,21.6,24,13,2,1,19,37,-18,18.4,33.9,-15.5,21,GER
c64c01fc,9,241,2.7,2,1,7,3,3,3,0,2.4,3.8,-1.3,21,GER
c6608135,14,216,2.4,0,0,14,8,6,3,3,4.1,2.7,1.4,21,GER
c89e8aae,2,180,2.0,2,2,0,30,3,4,-1,1.7,3.2,-1.5,21,GER
c8c60119,17,704,7.8,8,3,9,5,17,12,5,14.7,11.6,3.2,21,GER
ca618d23,33,2089,23.2,22,7,11,0,34,35,-1,32.4,33.1,-0.7,21,GER
ca8033cb,23,1446,16.1,15,10,8,2,28,14,14,30.6,13.6,17.0,21,GER
cb6d81b3,15,701,7.8,8,5,7,16,12,15,-3,8.7,14.8,-6.1,21,GER
cbac6ec9,31,2790,31.0,31,31,0,0,45,46,-1,41.2,45.6,-4.3,21,GER
cc86b9a3,24,1705,18.9,18,12,6,0,61,24,37,46.3,22.4,24.0,21,GER
cc971106,2,60,0.7,1,0,1,10,2,2,0,2.0,1.9,0.2,21,GER
cd59b9df,33,2970,33.0,33,33,0,0,54,54,0,49.7,50.0,-0.2,21,GER
cd82452e,29,2037,22.6,24,9,5,1,28,34,-6,25.8,39.4,-13.7,21,GER
ce17b5eb,33,2970,33.0,33,33,0,1,66,52,14,56.4,46.4,10.0,21,GER
cf623c78,21,1480,16.4,19,4,2,2,30,23,7,24.3,20.3,4.0,21,GER
d01bbb6f,34,2768,30.8,33,14,1,0,23,46,-23,29.5,51.2,-21.6,21,GER
d1273f09,33,2665,29.6,31,22,2,0,29,46,-17,30.2,50.2,-20.0,21,GER
d1661819,27,1922,21.4,20,18,7,6,16,60,-44,19.5,47.4,-27.9,21,GER
d1db4b83,4,296,3.3,4,2,0,5,0,8,-8,1.1,5.3,-4.2,21,GER
d20f088b,3,239,2.7,2,2,1,18,1,12,-11,3.6,6.2,-2.6,21,GER
d2416c2e,27,1354,15.0,14,7,13,3,28,15,13,27.6,14.3,13.3,21,GER
d248cd8f,29,2330,25.9,27,23,2,1,42,26,16,49.5,21.3,28.2,21,GER
d25fee56,26,1270,14.1,12,9,14,7,11,30,-19,13.4,24.7,-11.3,21,GER
d28339cb,1,90,1.0,1,1,0,33,2,1,1,1.7,2.2,-0.5,21,GER
d2c580ce,12,498,5.5,4,1,8,8,6,10,-4,6.5,10.9,-4.4,21,GER
d3096421,23,970,10.8,10,1,13,5,21,20,1,19.7,17.6,2.1,21,GER
d3585b17,2,4,0.0,0,0,2,1,0,1,-1,0.0,0.3,-0.3,21,GER
d4a2533d,29,1814,20.2,22,4,7,2,35,22,13,27.0,24.2,2.8,21,GER
d4d0a9ad,10,476,5.3,7,3,3,5,1,15,-14,1.4,9.5,-8.1,21,GER
d571df78,2,33,0.4,0,0,2,1,0,1,-1,0.5,0.4,0.1,21,GER
d6862409,28,1737,19.3,21,4,7,3,19,30,-11,20.9,31.8,-10.9,21,GER
d686dbc0,16,639,7.1,7,3,9,12,4,13,-9,8.7,12.1,-3.4,21,GER
d699d8ef,1,16,0.2,0,0,1,0,0,1,-1,0.0,0.9,-0.9,21,GER
d781d855,23,1763,19.6,22,16,1,4,55,32,23,47.3,23.0,24.3,21,GER
d847944b,23,687,7.6,5,1,18,6,6,17,-11,9.4,15.6,-6.1,21,GER
d9e196bf,14,997,11.1,12,8,2,8,19,19,0,17.9,17.2,0.8,21,GER
da27e268,6,177,2.0,2,0,4,20,4,5,-1,3.7,5.0,-1.2,21,GER
daa78200,18,1000,11.1,11,2,7,0,10,14,-4,13.6,18.2,-4.6,21,GER
db401046,32,2880,32.0,32,32,0,0,58,33,25,47.3,38.9,8.4,21,GER
db4ed67b,21,1258,14.0,15,5,6,11,33,13,20,24.5,16.7,7.9,21,GER
dbf053da,26,2062,22.9,24,14,2,1,45,28,17,44.0,26.3,17.7,21,GER
dc38e3bc,7,100,1.1,0,0,7,3,4,1,3,1.9,2.2,-0.2,21,GER
dc62b55d,27,2149,23.9,25,17,2,0,32,40,-8,30.1,33.7,-3.7,21,GER
dc62fbee,27,1514,16.8,19,4,8,4,22,29,-7,18.9,26.8,-7.9,21,GER
dc90cfbe,12,817,9.1,9,7,3,1,14,16,-2,17.2,16.3,0.9,21,GER
dd669209,21,1566,17.4,19,5,2,0,30,14,16,24.9,17.9,7.0,21,GER
de4cac2d,25,1919,21.3,24,9,1,0,40,33,7,36.0,33.0,2.9,21,GER
dee3013b,3,270,3.0,3,3,0,31,6,10,-4,4.6,7.1,-2.5,21,GER
deee6467,7,140,1.6,0,0,7,11,4,2,2,1.8,1.4,0.3,21,GER
df8e7b62,8,313,3.5,3,0,5,6,6,7,-1,5.3,5.2,0.1,21,GER
dfb6490a,27,876,9.7,9,2,18,6,15,13,2,17.6,12.4,5.2,21,GER
e0b113a7,29,2526,28.1,29,26,0,0,43,32,11,42.0,33.4,8.6,21,GER
e0d515ef,1,1,0.0,0,0,1,0,0,0,0,0.0,0.0,0.0,21,GER
e12b0b5b,27,1625,18.1,19,7,8,0,35,27,8,30.9,27.5,3.4,21,GER
e162b013,21,1472,16.4,17,10,4,7,34,22,12,29.3,20.8,8.5,21,GER
e21042ae,34,2709,30.1,32,14,2,0,25,44,-19,29.6,47.1,-17.5,21,GER
e26fcca3,13,762,8.5,8,3,5,7,7,9,-2,9.1,12.3,-3.2,21,GER
e27da244,32,2774,30.8,31,30,1,0,56,34,22,45.5,37.8,7.7,21,GER
e27de4fa,21,1111,12.3,12,5,9,11,13,17,-4,14.9,18.3,-3.4,21,GER
e280527c,27,2026,22.5,24,16,3,2,34,24,10,38.7,21.1,17.7,21,GER
e33c06cf,20,1505,16.7,16,15,4,7,55,19,36,37.9,16.8,21.1,21,GER
e3f6253d,4,26,0.3,0,0,4,11,1,2,-1,0.4,2.5,-2.2,21,GER
e5478b87,21,1359,15.1,16,3,5,1,22,17,5,19.1,19.4,-0.3,21,GER
e5649a78,19,538,6.0,4,1,15,9,6,8,-2,9.2,8.1,1.2,21,GER
e5f63987,11,215,2.4,1,0,10,15,1,4,-3,2.1,2.4,-0.3,21,GER
e6c43eec,20,747,8.3,7,6,13,5,15,6,9,10.6,11.6,-1.0,21,GER
e79269bd,11,309,3.4,2,1,9,3,4,9,-5,7.2,4.5,2.7,21,GER
e7d22eae,5,267,3.0,3,0,2,1,4,4,0,4.7,3.7,1.0,21,GER
e7d59f4f,28,2101,23.3,25,11,3,1,20,60,-40,19.9,45.3,-25.4,21,GER
e7fcf289,29,2224,24.7,25,16,4,0,41,30,11,35.7,29.9,5.9,21,GER
e82adcab,9,572,6.4,7,4,2,12,7,5,2,6.6,6.4,0.2,21,GER
e87ad81a,6,525,5.8,6,5,0,16,8,4,4,9.0,6.4,2.6,21,GER
e92cd3f7,29,1443,16.0,13,10,16,4,28,14,14,31.4,14.1,17.3,21,GER
ea003d07,20,857,9.6,10,1,10,1,18,11,7,16.1,9.8,6.2,21,GER
eac044ad,22,999,11.1,11,2,11,7,17,12,5,17.9,16.8,1.2,21,GER
eba42d2b,10,351,3.9,3,3,7,6,3,10,-7,6.3,8.0,-1.7,21,GER
ed79b7d3,30,1498,16.6,19,0,11,2,32,26,6,22.5,25.4,-2.9,21,GER
f0a37d36,31,2655,29.5,30,23,1,0,24,40,-16,28.2,46.2,-18.0,21,GER
f26834c7,31,1843,20.5,19,7,12,0,19,36,-17,26.8,30.7,-3.9,21,GER
f2dd9a21,28,2084,23.2,23,11,5,3,24,41,-17,24.4,38.8,-14.4,21,GER
f35430a4,15,1221,13.6,14,12,1,3,12,33,-21,10.9,31.5,-20.6,21,GER
f3722c97,1,58,0.6,1,0,0,7,1,1,0,0.4,0.4,0.0,21,GER
f503ef6e,1,4,0.0,0,0,1,2,0,1,-1,0.0,0.8,-0.8,21,GER
f521b80a,34,3060,34.0,34,34,0,0,64,56,8,54.9,45.7,9.2,21,GER
f5ae006d,4,51,0.6,0,0,4,7,1,3,-2,1.5,2.1,-0.6,21,GER
f69fba57,24,762,8.5,7,0,17,8,9,20,-11,7.0,12.2,-5.2,21,GER
f6bdc830,24,1654,18.4,18,16,6,7,33,23,10,26.6,26.5,0.1,21,GER
f761c901,1,34,0.4,0,0,1,21,1,1,0,0.5,0.4,0.1,21,GER
f7aa75bd,16,1071,11.9,12,6,4,7,17,13,4,13.7,15.3,-1.6,21,GER
f820504e,3,152,1.7,2,1,1,22,1,0,1,1.0,0.7,0.4,21,GER
f86ad3f5,32,2785,30.9,31,29,1,0,34,53,-19,30.1,47.2,-17.1,21,GER
f86cabbd,14,969,10.8,11,9,3,8,15,15,0,11.5,14.1,-2.6,21,GER
f93e6e94,32,1301,14.5,12,3,20,1,18,25,-7,19.0,23.8,-4.8,21,GER
f9446dcd,22,1629,18.1,19,10,3,1,31,26,5,28.0,22.2,5.8,21,GER
f956479d,24,754,8.4,5,0,19,7,13,9,4,11.7,14.4,-2.7,21,GER
f95d2f9d,2,39,0.4,0,0,2,1,0,0,0,0.5,0.6,-0.1,21,GER
f972644c,29,1416,15.7,16,3,13,1,15,27,-12,17.4,29.6,-12.2,21,GER
f99fe221,3,95,1.1,1,0,2,19,0,1,-1,0.4,1.2,-0.8,21,GER
f9acca3a,22,1457,16.2,15,13,7,11,23,21,2,22.4,20.1,2.2,21,GER
f9e7c4ac,17,544,6.0,4,1,13,2,7,8,-1,10.0,10.3,-0.3,21,GER
fa274d97,13,610,6.8,6,5,7,14,13,11,2,10.1,10.2,-0.2,21,GER
fa661778,31,2551,28.3,29,18,2,0,29,50,-21,31.4,45.9,-14.4,21,GER
fbbc8e15,5,36,0.4,0,0,5,7,2,3,-1,1.0,1.4,-0.4,21,GER
fc0f3ef3,1,6,0.1,0,0,1,0,0,0,0,0.0,0.0,0.0,21,GER
fc62fdf4,18,757,8.4,7,3,11,5,11,16,-5,11.6,14.6,-3.0,21,GER
fd53759d,24,1029,11.4,9,2,15,4,11,21,-10,13.7,19.5,-5.9,21,GER
fdd60087,1,90,1.0,1,1,0,0,1,1,0,1.5,0.8,0.7,21,GER
fe2db476,11,455,5.1,5,3,6,17,11,3,8,10.5,6.0,4.4,21,GER
fe46e261,6,500,5.6,6,4,0,2,5,10,-5,5.6,10.0,-4.4,21,GER
fe641c1a,20,1286,14.3,14,7,6,6,32,19,13,24.0,19.6,4.4,21,GER
fe888e39,19,810,9.0,10,1,9,9,9,18,-9,9.700000000000001,19.3,-9.6,21,GER
ff182fdc,14,596,6.6,7,1,7,12,4,14,-10,7.7,12.3,-4.6,21,GER
ff5ea0bf,19,1452,16.1,15,14,4,9,5,40,-35,10.9,30.2,-19.3,21,GER
ff98492b,23,1164,12.9,12,0,11,1,13,17,-4,16.7,20.3,-3.6,21,GER
ffbbc83b,26,1879,20.9,22,15,4,0,33,30,3,32.5,30.1,2.3,21,GER
00f0482f,2,11,0.1,0,0,2,3,0,0,0,0.0,0.1,-0.1,21,ENG
01226327,29,2598,28.9,29,28,0,0,36,51,-15,30.9,39.0,-8.1,21,ENG
012c975a,9,661,7.3,7,6,2,16,14,6,8,13.0,8.3,4.7,21,ENG
02b29014,29,2443,27.1,29,20,0,1,35,36,-1,33.3,36.4,-3.1,21,ENG
0313a347,36,3196,35.5,35,35,1,0,51,46,5,46.6,50.4,-3.8,21,ENG
03622183,1,10,0.1,0,0,1,1,0,1,-1,0.0,0.1,0.0,21,ENG
03edb878,4,284,3.2,3,2,1,0,2,2,0,3.0,4.6,-1.6,21,ENG
0420d84f,25,1613,17.9,18,12,7,3,23,19,4,21.8,21.1,0.7,21,ENG
0442183b,13,1145,12.7,13,11,0,9,16,22,-6,12.4,17.5,-5.1,21,ENG
07802f7f,29,2173,24.1,26,13,3,0,33,40,-7,27.4,30.5,-3.0,21,ENG
08452314,21,528,5.9,6,0,15,6,4,9,-5,8.8,8.1,0.8,21,ENG
099e666f,4,79,0.9,1,0,3,7,0,1,-1,0.5,2.1,-1.5,21,ENG
0b33f6ad,12,844,9.4,8,7,4,11,10,19,-9,11.0,14.2,-3.1,21,ENG
0d4ceb32,28,1371,15.2,15,5,13,5,18,24,-6,18.2,21.4,-3.2,21,ENG
0df2b165,28,2032,22.6,23,18,5,6,14,40,-26,19.6,36.6,-17.0,21,ENG
0f7533cd,33,2372,26.4,28,14,5,2,20,32,-12,26.3,35.1,-8.8,21,ENG
101da2b5,21,1188,13.2,12,10,9,11,29,10,19,20.6,10.0,10.5,21,ENG
10b9fa99,25,2089,23.2,23,19,2,4,12,41,-29,20.1,39.1,-19.0,21,ENG
111c3236,8,266,3.0,2,1,6,7,3,6,-3,3.0,5.0,-2.0,21,ENG
119b9a8e,16,1344,14.9,14,14,2,12,30,10,20,26.7,10.8,16.0,21,ENG
11ff3d56,22,1020,11.3,10,8,12,6,10,22,-12,11.7,18.5,-6.8,21,ENG
1265a93a,32,2373,26.4,25,25,7,3,38,29,9,43.0,21.7,21.4,21,ENG
132a82f1,28,2262,25.1,27,22,1,1,43,30,13,35.1,28.2,6.9,21,ENG
1544f145,22,626,7.0,6,0,16,8,9,10,-1,10.0,10.1,-0.1,21,ENG
1566e437,5,118,1.3,1,0,4,6,1,3,-2,0.4,2.8,-2.4,21,ENG
1598599e,23,1459,16.2,15,9,8,14,26,25,1,24.4,21.4,3.0,21,ENG
15ea812b,36,3240,36.0,36,36,0,0,31,50,-19,37.4,52.8,-15.4,21,ENG
15f3ec41,23,1059,11.8,10,2,13,10,22,5,17,21.4,6.3,15.1,21,ENG
16ceb862,17,748,8.3,8,1,9,18,9,5,4,14.0,6.0,8.0,21,ENG
17370b95,3,206,2.3,2,2,1,9,0,3,-3,1.2,3.8,-2.7,21,ENG
17695062,20,1440,16.0,18,7,2,3,31,10,21,25.0,14.8,10.1,21,ENG
178ae8f8,19,1112,12.4,12,5,7,0,24,15,9,23.2,17.4,5.8,21,ENG
17acc2ed,2,180,2.0,2,2,0,28,0,5,-5,1.2,3.2,-2.1,21,ENG
17d4507a,30,2700,30.0,30,30,0,0,13,54,-41,23.5,51.0,-27.5,21,ENG
1880614f,9,281,3.1,1,0,8,17,4,5,-1,4.9,6.7,-1.8,21,ENG
18b896d6,19,1710,19.0,19,19,0,13,23,10,13,30.4,12.2,18.1,21,ENG
18b999f4,5,119,1.3,1,0,4,8,2,3,-1,1.3,2.2,-0.9,21,ENG
18e96f64,30,2584,28.7,28,27,2,3,31,53,-22,31.1,52.4,-21.3,21,ENG
1900032e,30,2574,28.6,29,28,1,1,42,46,-4,33.3,35.4,-2.1,21,ENG
1961b2aa,28,1570,17.4,17,7,11,6,24,22,2,23.3,23.4,-0.1,21,ENG
197640fd,27,2345,26.1,27,25,0,0,51,37,14,37.0,29.7,7.3,21,ENG
19f4d211,1,1,0.0,0,0,1,6,0,0,0,0.0,0.0,0.0,21,ENG
1a4ef233,12,722,8.0,8,6,4,14,13,14,-1,9.9,9.1,0.7,21,ENG
1a7fcf39,36,2461,27.3,29,19,7,2,47,35,12,45.0,41.3,3.7,21,ENG
1aa84968,31,2576,28.6,31,21,0,0,14,51,-37,23.7,44.9,-21.2,21,ENG
1ae30132,4,274,3.0,3,3,1,23,3,8,-5,2.3,3.8,-1.5,21,ENG
1b84dbe1,30,2681,29.8,30,29,0,0,39,42,-3,36.4,37.8,-1.3,21,ENG
1bf33a9a,27,1738,19.3,18,12,9,2,25,21,4,31.9,17.9,13.9,21,ENG
1c7012b8,32,2879,32.0,32,31,0,0,52,37,15,47.4,37.3,10.1,21,ENG
1cb49278,17,1371,15.2,15,13,2,6,21,15,6,23.5,10.8,12.7,21,ENG
1d042188,28,2102,23.4,25,21,3,8,17,51,-34,20.9,43.2,-22.3,21,ENG
1ecb65be,22,1631,18.1,20,8,2,4,23,28,-5,16.4,27.099999999999998,-10.7,21,ENG
1ef37668,20,1266,14.1,13,10,7,12,15,19,-4,15.2,20.8,-5.7,21,ENG
1f9a3a04,1,90,1.0,1,1,0,9,0,1,-1,0.9,0.5,0.4,21,ENG
1fb1c435,26,1288,14.3,14,4,12,0,29,21,8,22.5,23.4,-0.8,21,ENG
1fdfd6da,3,270,3.0,3,3,0,30,2,6,-4,2.9,2.3,0.6,21,ENG
21166ff4,23,1819,20.2,19,19,4,2,42,30,12,33.4,25.9,7.5,21,ENG
21945a9e,1,1,0.0,0,0,1,3,0,0,0,0.0,0.0,0.0,21,ENG
21a66f6a,35,3082,34.2,35,30,0,0,65,39,26,50.6,43.6,7.0,21,ENG
2389cdc2,28,2372,26.4,28,22,0,1,42,35,7,35.9,35.1,0.8,21,ENG
246d153b,31,2664,29.6,31,24,0,4,22,36,-14,30.4,42.0,-11.6,21,ENG
254147d4,27,1240,13.8,15,4,12,7,12,27,-15,14.9,18.5,-3.7,21,ENG
25b82f9a,1,9,0.1,0,0,1,10,0,0,0,0.1,0.1,0.0,21,ENG
2628fd2b,35,3131,34.8,35,34,0,2,52,37,15,46.2,40.3,5.9,21,ENG
2691c772,22,1331,14.8,15,5,7,3,11,19,-8,15.5,18.1,-2.6,21,ENG
26f6dca8,17,566,6.3,5,1,12,15,13,5,8,9.2,7.9,1.3,21,ENG
27c01749,17,791,8.8,9,1,8,11,11,17,-6,16.0,7.3,8.7,21,ENG
282679b4,35,2393,26.6,28,15,7,1,41,44,-3,38.2,41.5,-3.3,21,ENG
282f75f3,33,2931,32.6,33,31,0,0,34,38,-4,46.6,29.3,17.3,21,ENG
289601e6,28,2162,24.0,24,21,4,3,16,27,-11,27.7,33.1,-5.4,21,ENG
28b40c9c,7,630,7.0,7,7,0,31,3,13,-10,6.2,10.9,-4.7,21,ENG
28d596a0,7,585,6.5,6,6,1,28,9,8,1,11.0,7.5,3.5,21,ENG
2928dca2,37,3303,36.7,37,36,0,0,35,51,-16,34.4,48.5,-14.2,21,ENG
29733c72,9,509,5.7,6,1,3,17,12,6,6,8.9,4.2,4.7,21,ENG
2973d8ff,18,728,8.1,7,2,11,17,10,15,-5,8.8,11.2,-2.4,21,ENG
2acd49b9,25,1585,17.6,15,14,10,10,22,22,0,19.8,22.4,-2.6,21,ENG
2b16cb1a,25,1560,17.3,19,5,6,0,27,26,1,21.8,25.6,-3.8,21,ENG
2b471f99,28,1703,18.9,19,8,9,2,14,27,-13,21.0,26.7,-5.7,21,ENG
2b622f01,30,1411,15.7,14,7,16,7,29,18,11,23.5,18.4,5.2,21,ENG
2b91cf8e,22,1891,21.0,21,18,1,8,19,35,-16,18.9,33.1,-14.2,21,ENG
2baec6ce,9,404,4.5,4,3,5,21,7,8,-1,5.5,5.0,0.6,21,ENG
2bd83368,3,88,1.0,1,0,2,8,0,0,0,0.7,0.9,-0.3,21,ENG
2bed3eab,6,383,4.3,3,3,3,16,8,12,-4,4.0,6.7,-2.6,21,ENG
2ce2508a,31,2359,26.2,27,18,4,1,25,47,-22,22.5,42.6,-20.1,21,ENG
2d61d13a,9,801,8.9,9,7,0,1,10,9,1,14.5,10.1,4.4,21,ENG
2e4f5f03,38,3383,37.6,38,35,0,0,65,42,23,65.5,42.9,22.6,21,ENG
2f7acede,15,861,9.6,9,4,6,15,22,16,6,17.7,11.4,6.3,21,ENG
2f90f6b8,26,1070,11.9,11,6,15,4,15,10,5,19.4,14.9,4.4,21,ENG
2f965a72,36,3240,36.0,36,36,0,2,27,48,-21,39.4,49.4,-10.0,21,ENG
2fba6108,2,155,1.7,2,1,0,0,3,2,1,2.2,1.6,0.6,21,ENG
30040f5d,13,111,1.2,0,0,13,16,0,1,-1,1.2,2.8,-1.6,21,ENG
30e81a88,27,1128,12.5,12,2,15,7,7,16,-9,12.2,16.9,-4.7,21,ENG
312626c1,2,180,2.0,2,2,0,0,0,3,-3,2.0,2.4,-0.4,21,ENG
31c69ef1,32,2843,31.6,32,30,0,4,68,21,47,57.8,22.9,34.9,21,ENG
321a71a7,2,123,1.4,1,1,1,3,0,1,-1,1.3,1.4,-0.1,21,ENG
3233eefd,10,526,5.8,6,3,4,21,4,12,-8,4.4,11.0,-6.6,21,ENG
32f60ed8,11,414,4.6,4,1,7,9,4,6,-2,4.6,5.1,-0.6,21,ENG
3312f911,27,1428,15.9,15,5,12,0,20,26,-6,17.8,23.6,-5.7,21,ENG
3353737a,27,2244,24.9,26,20,1,4,51,31,20,36.3,31.6,4.7,21,ENG
33887998,31,2745,30.5,31,30,0,3,46,25,21,49.4,22.2,27.2,21,ENG
3423f250,30,2360,26.2,26,19,4,0,44,34,10,37.9,40.1,-2.3,21,ENG
3515d404,38,3420,38.0,38,38,0,0,47,68,-21,41.2,53.1,-11.8,21,ENG
35e413f1,36,3191,35.5,36,31,0,1,39,44,-5,45.9,33.1,12.8,21,ENG
3626f7d9,14,1198,13.3,13,12,1,20,21,19,2,15.9,19.0,-3.1,21,ENG
36c2ca73,30,2700,30.0,30,30,0,7,37,57,-20,31.7,41.2,-9.5,21,ENG
3727dd3c,30,2617,29.1,29,28,1,3,41,46,-5,36.4,44.4,-7.9,21,ENG
383e68b1,1,10,0.1,0,0,1,4,0,0,0,1.4,0.0,1.4,21,ENG
38c7feef,13,253,2.8,2,0,11,12,5,6,-1,3.3,3.1,0.2,21,ENG
38ceb24a,35,2607,29.0,30,13,5,1,34,30,4,40.3,23.3,16.9,21,ENG
3925dbd6,27,1402,15.6,13,12,14,3,12,24,-12,19.6,20.5,-0.9,21,ENG
3935e52e,1,90,1.0,1,1,0,3,2,1,1,1.1,2.0,-0.9,21,ENG
394854c4,32,2787,31.0,32,30,0,3,14,51,-37,25.1,53.5,-28.4,21,ENG
3a24769f,26,1573,17.5,18,6,8,5,27,24,3,22.8,24.9,-2.1,21,ENG
3a949a25,13,1170,13.0,13,13,0,11,20,19,1,19.7,21.4,-1.7,21,ENG
3add8ed8,2,85,0.9,1,0,1,2,1,1,0,0.9,0.7,0.1,21,ENG
3ae14ed1,21,1166,13.0,12,2,9,2,24,14,10,16.9,17.2,-0.3,21,ENG
3b029691,19,520,5.8,5,0,14,15,7,8,-1,6.8,8.7,-1.9,21,ENG
3bb7b8b4,36,3240,36.0,36,36,0,0,76,28,48,64.1,27.2,36.9,21,ENG
3c066877,2,32,0.4,0,0,2,8,0,2,-2,0.2,1.7,-1.5,21,ENG
3d50bcdb,2,15,0.2,0,0,2,1,0,0,0,0.1,0.0,0.1,21,ENG
3e1550ee,1,90,1.0,1,1,0,3,4,3,1,1.5,2.2,-0.8,21,ENG
3e9e06cb,22,1925,21.4,22,21,0,4,37,23,14,34.2,24.1,10.2,21,ENG
3ea50f67,25,1945,21.6,22,15,3,1,36,25,11,29.0,25.0,4.0,21,ENG
3eb22ec9,26,2065,22.9,24,17,2,10,52,18,34,43.7,15.2,28.5,21,ENG
3ec9195b,35,2932,32.6,32,31,3,3,29,63,-34,30.7,58.8,-28.1,21,ENG
3f2d59fe,3,47,0.5,0,0,3,6,0,1,-1,0.1,0.9,-0.8,21,ENG
3fe6bd8c,15,1255,13.9,14,12,1,5,20,20,0,19.8,23.5,-3.7,21,ENG
4047c976,11,315,3.5,2,0,9,6,1,9,-8,3.6,5.4,-1.7,21,ENG
4115ce4e,36,3100,34.4,36,32,0,1,41,59,-18,36.2,45.8,-9.6,21,ENG
420d7c7d,38,3399,37.8,38,37,0,0,62,54,8,54.9,57.4,-2.4,21,ENG
42130443,1,90,1.0,1,1,0,34,3,1,2,2.7,0.8,1.8,21,ENG
43309491,1,3,0.0,0,0,1,7,0,0,0,0.1,0.1,-0.1,21,ENG
43439614,32,2220,24.7,26,15,6,5,12,43,-31,20.8,40.5,-19.7,21,ENG
43458538,11,148,1.6,0,0,11,5,1,2,-1,1.8,2.5,-0.6,21,ENG
43a166b4,9,186,2.1,2,0,7,17,2,0,2,3.2,1.0,2.2,21,ENG
4468ec10,1,19,0.2,0,0,1,0,1,0,1,0.3,0.0,0.3,21,ENG
44781702,20,1346,15.0,14,14,6,9,21,16,5,18.3,18.8,-0.6,21,ENG
44bfb6c5,36,2675,29.7,31,21,5,1,26,42,-16,25.3,39.4,-14.1,21,ENG
450ab6fc,19,1625,18.1,19,16,0,0,12,32,-20,18.3,28.8,-10.5,21,ENG
4535e4bb,14,1260,14.0,14,14,0,13,17,21,-4,22.299999999999997,13.399999999999999,8.9,21,ENG
45963054,34,2840,31.6,31,24,3,0,61,44,17,46.5,39.3,7.2,21,ENG
45db685d,28,2010,22.3,23,15,5,10,34,17,17,37.6,15.3,22.3,21,ENG
466fb2c5,38,3420,38.0,38,38,0,0,20,63,-43,32.6,62.2,-29.6,21,ENG
46ee5234,10,809,9.0,9,8,1,7,10,22,-12,6.3,18.0,-11.7,21,ENG
47369df8,33,2813,31.3,32,29,1,1,25,42,-17,33.6,45.9,-12.3,21,ENG
47a34c4f,23,1544,17.2,17,13,6,13,27,20,7,23.0,22.0,1.0,21,ENG
4806ec67,31,2742,30.5,31,30,0,2,38,39,-1,35.7,38.5,-2.8,21,ENG
4879f8cb,4,360,4.0,4,4,0,31,2,14,-12,4.6,6.9,-2.3,21,ENG
48a5a5d6,14,589,6.5,7,2,7,9,13,3,10,12.6,5.7,6.9,21,ENG
495945ef,38,3410,37.9,38,37,0,0,33,55,-22,39.3,54.6,-15.3,21,ENG
49fe9070,35,2602,28.9,29,18,6,3,52,29,23,47.5,23.9,23.6,21,ENG
4ab53cdb,31,1265,14.1,12,4,19,3,9,25,-16,12.0,23.6,-11.6,21,ENG
4b40d9ca,32,2880,32.0,32,32,0,0,31,37,-6,32.8,44.6,-11.8,21,ENG
4b511457,21,1763,19.6,20,15,1,0,27,25,2,20.6,20.1,0.5,21,ENG
4bcf39f6,33,2512,27.9,29,17,4,1,32,34,-2,40.4,24.7,15.8,21,ENG
4c370d81,36,2838,31.5,33,16,3,0,57,39,18,57.5,36.8,20.7,21,ENG
4d034881,12,559,6.2,7,2,5,7,11,4,7,10.9,4.5,6.4,21,ENG
4d0eb7d2,3,103,1.1,1,0,2,13,1,2,-1,0.6,1.4,-0.8,21,ENG
4dc4f138,25,2234,24.8,25,24,0,2,23,36,-13,26.8,39.4,-12.6,21,ENG
4e9a0555,33,2741,30.5,32,22,1,0,27,43,-16,31.7,44.8,-13.0,21,ENG
4f565d77,29,2428,27.0,28,25,1,0,46,34,12,39.3,40.4,-1.1,21,ENG
4f974391,36,3170,35.2,36,34,0,0,60,41,19,52.2,42.5,9.7,21,ENG
4fa62ae4,2,4,0.0,0,0,2,7,0,0,0,0.1,0.8,-0.7,21,ENG
4fb9c88f,24,1179,13.1,13,4,11,12,24,14,10,21.6,15.2,6.4,21,ENG
507c7bdf,37,3099,34.4,35,23,2,0,68,36,32,55.6,35.0,20.6,21,ENG
50dc94ce,19,524,5.8,4,3,15,15,19,12,7,13.2,8.0,5.2,21,ENG
50e6dc35,7,221,2.5,2,0,5,11,2,4,-2,1.0,5.4,-4.4,21,ENG
515ebe8d,17,1456,16.2,15,15,2,13,29,11,18,27.6,15.5,12.0,21,ENG
51cf8561,20,1478,16.4,15,14,5,8,41,14,27,30.8,12.5,18.3,21,ENG
52105203,15,1350,15.0,15,15,0,15,13,24,-11,15.4,21.1,-5.7,21,ENG
5271c8f1,13,953,10.6,11,7,2,19,22,10,12,18.2,8.5,9.7,21,ENG
527f063d,26,1375,15.3,13,8,13,0,28,18,10,25.3,16.2,9.1,21,ENG
529f49ab,24,1534,17.0,18,10,6,0,22,18,4,19.5,16.3,3.2,21,ENG
531a4aa8,3,103,1.1,1,1,2,6,1,4,-3,1.0,2.8,-1.9,21,ENG
5348aada,2,113,1.3,1,0,1,9,4,0,4,2.7,1.4,1.3,21,ENG
53af52f3,38,3420,38.0,38,38,0,0,68,50,18,55.8,46.0,9.8,21,ENG
53cad200,26,2188,24.3,24,20,2,12,39,20,19,40.5,18.2,22.2,21,ENG
5540c9dc,1,90,1.0,1,1,0,1,0,0,0,0.8,1.1,-0.3,21,ENG
55b4f1d6,14,355,3.9,0,0,14,18,4,5,-1,6.3,8.2,-1.9,21,ENG
56f7a928,38,3357,37.3,37,35,1,0,68,50,18,54.2,45.4,8.8,21,ENG
57df7a11,12,1006,11.2,12,7,0,0,22,15,7,16.4,13.5,2.9,21,ENG
57e3f0c7,29,1616,18.0,16,8,13,6,26,21,5,21.6,23.9,-2.3,21,ENG
58bc7d18,3,270,3.0,3,3,0,31,5,2,3,4.3,3.9,0.4,21,ENG
58eee997,31,1822,20.2,21,7,10,4,39,23,16,32.1,23.8,8.3,21,ENG
59e6e5bf,33,2871,31.9,32,26,1,0,41,39,2,40.7,41.8,-1.1,21,ENG
5a04fd92,30,1391,15.5,14,2,16,2,27,19,8,24.6,21.4,3.2,21,ENG
5a4280b1,8,637,7.1,7,7,1,21,4,13,-9,5.8,6.6,-0.8,21,ENG
5a7301ae,33,2503,27.8,28,25,5,1,26,33,-7,28.2,36.2,-8.0,21,ENG
5c2b4f07,19,1605,17.8,19,15,0,6,35,22,13,22.4,23.8,-1.4,21,ENG
5cbd1eb0,19,1710,19.0,19,19,0,11,22,32,-10,17.7,28.5,-10.8,21,ENG
5cdddffa,33,2091,23.2,28,6,5,3,38,24,14,27.1,31.9,-4.8,21,ENG
5e105217,3,172,1.9,2,0,1,5,1,5,-4,1.9,2.5,-0.6,21,ENG
5e74d6c8,4,188,2.1,2,2,2,16,4,3,1,2.5,1.9,0.7,21,ENG
5ed97752,1,12,0.1,0,0,1,6,0,1,-1,0.0,1.4,-1.4,21,ENG
5eecec3d,22,1933,21.5,22,21,0,12,53,12,41,42.2,13.5,28.6,21,ENG
5f09991f,22,1777,19.7,20,19,2,11,19,36,-17,17.1,30.9,-13.8,21,ENG
5f1a2f31,4,263,2.9,3,2,1,23,3,10,-7,2.2,4.8,-2.6,21,ENG
615ef733,14,839,9.3,8,8,6,24,9,9,0,14.7,11.9,2.7,21,ENG
62d7ef38,2,180,2.0,2,2,0,13,4,1,3,2.2,1.7,0.5,21,ENG
6385ebfb,3,270,3.0,3,3,0,24,5,3,2,6.2,2.0,4.3,21,ENG
6421ec64,14,556,6.2,5,1,9,13,5,7,-2,8.4,7.9,0.4,21,ENG
6434f10d,34,2748,30.5,31,28,3,4,64,27,37,56.1,24.9,31.2,21,ENG
64b08de7,16,821,9.1,10,2,6,8,9,15,-6,6.8,10.6,-3.8,21,ENG
653ee42d,7,261,2.9,3,1,4,19,1,4,-3,1.5,2.7,-1.2,21,ENG
6612cd8c,11,374,4.2,4,1,7,13,2,12,-10,4.0,7.3,-3.3,21,ENG
6613c819,38,3419,38.0,38,37,0,0,62,47,15,55.4,48.7,6.7,21,ENG
6622454d,23,1172,13.0,15,1,8,5,16,7,9,18.4,9.4,9.0,21,ENG
6722d4f0,1,15,0.2,0,0,1,0,0,1,-1,0.1,0.8,-0.7,21,ENG
67ac5bb8,23,1996,22.2,22,21,1,10,28,24,4,26.8,23.6,3.2,21,ENG
67ca8566,38,3409,37.9,38,36,0,0,62,53,9,55.0,56.7,-1.8,21,ENG
6956ff08,6,187,2.1,2,0,4,17,4,6,-2,2.2,3.5,-1.2,21,ENG
6a713852,27,2430,27.0,27,27,0,0,26,27,-1,34.0,24.2,9.8,21,ENG
6adbc307,18,1537,17.1,17,15,1,20,18,39,-21,17.9,28.6,-10.7,21,ENG
6b47c5db,26,2176,24.2,25,21,1,1,48,31,17,34.6,27.2,7.4,21,ENG
6b625ac2,35,3150,35.0,35,35,0,2,57,52,5,51.4,53.9,-2.6,21,ENG
6bb2c084,36,2587,28.7,29,22,7,2,19,40,-21,29.0,41.4,-12.5,21,ENG
6bd603db,1,12,0.1,0,0,1,0,0,1,-1,0.2,0.3,-0.1,21,ENG
6c17e046,27,1340,14.9,14,3,13,10,20,19,1,20.4,22.8,-2.4,21,ENG
6c203af0,36,3111,34.6,35,30,1,0,35,42,-7,45.1,31.1,14.0,21,ENG
6ca5ec4b,30,1542,17.1,17,5,13,5,24,21,3,22.3,23.9,-1.6,21,ENG
6d5701f2,24,1937,21.5,23,20,1,6,33,22,11,27.9,25.6,2.2,21,ENG
6d646ff7,1,38,0.4,0,0,1,8,2,0,2,0.7,0.1,0.6,21,ENG
6e7f1353,9,294,3.3,3,0,6,2,2,4,-2,3.1,5.4,-2.4,21,ENG
6f7d826d,33,2781,30.9,32,21,1,4,43,41,2,39.9,42.6,-2.7,21,ENG
715bf047,23,1764,19.6,21,7,2,1,29,27,2,25.6,26.4,-0.8,21,ENG
71ef519e,18,1350,15.0,15,11,3,12,24,22,2,21.2,25.4,-4.1,21,ENG
728e9b2e,1,48,0.5,0,0,1,16,0,0,0,0.8,0.4,0.5,21,ENG
7399c7a8,11,877,9.7,9,8,2,7,7,11,-4,10.0,14.6,-4.6,21,ENG
74b2cd7e,28,2492,27.7,28,27,0,1,42,34,8,40.1,34.6,5.5,21,ENG
74e12f1e,16,1350,15.0,15,12,1,5,17,24,-7,17.1,20.6,-3.5,21,ENG
758dd7f0,13,825,9.2,10,6,3,16,13,15,-2,12.0,12.3,-0.3,21,ENG
75a72a99,15,959,10.7,10,7,5,6,15,19,-4,12.8,15.7,-2.9,21,ENG
76dd1480,36,2253,25.0,24,12,12,2,29,29,0,25.8,31.2,-5.4,21,ENG
77bb1522,19,1487,16.5,17,12,2,11,14,42,-28,10.9,34.0,-23.1,21,ENG
77cf6852,16,1288,14.3,14,9,2,17,20,27,-7,16.8,22.9,-6.1,21,ENG
77d7c96f,22,1481,16.5,18,12,4,2,10,27,-17,17.5,22.2,-4.7,21,ENG
77e84962,24,1854,20.6,20,13,4,1,34,18,16,38.5,22.2,16.4,21,ENG
78b8ac63,23,1324,14.7,12,10,11,1,8,27,-19,15.4,26.2,-10.8,21,ENG
7914b9fe,20,1800,20.0,20,20,0,7,23,39,-16,16.4,33.6,-17.3,21,ENG
79300479,14,866,9.6,9,4,5,2,19,12,7,14.6,11.7,2.9,21,ENG
7956236f,38,3420,38.0,38,38,0,0,55,46,9,52.5,51.1,1.4,21,ENG
79b0d6a0,37,3329,37.0,37,36,0,1,36,51,-15,35.6,48.7,-13.1,21,ENG
79bc4c45,24,1604,17.8,17,10,7,10,6,29,-23,15.0,29.2,-14.2,21,ENG
79c0821a,27,1815,20.2,21,10,6,3,26,26,0,32.4,17.4,15.0,21,ENG
79c84d1c,38,2562,28.5,30,6,8,0,43,33,10,39.7,35.1,4.6,21,ENG
7a11550b,7,590,6.6,6,5,1,0,15,14,1,14.0,7.5,6.5,21,ENG
7a1f2c08,33,1820,20.2,19,10,14,3,21,39,-18,16.5,35.0,-18.4,21,ENG
7a2e46a8,33,2970,33.0,33,33,0,0,58,32,26,58.3,36.7,21.6,21,ENG
7af88b33,8,550,6.1,7,4,1,25,5,10,-5,6.5,10.1,-3.6,21,ENG
7ba2eaa9,31,2550,28.3,30,19,1,0,29,38,-9,28.2,36.3,-8.0,21,ENG
7ba6d84e,26,2295,25.5,26,25,0,7,46,32,14,38.1,27.8,10.3,21,ENG
7bb5f40e,33,1828,20.3,20,9,13,1,18,42,-24,20.8,37.0,-16.2,21,ENG
7c104bb7,34,2747,30.5,31,19,3,0,23,33,-10,34.7,39.0,-4.4,21,ENG
7c39363f,2,3,0.0,1,0,1,10,0,0,0,0.1,0.0,0.1,21,ENG
7d2d3329,10,316,3.5,4,1,6,21,3,2,1,5.3,4.2,1.1,21,ENG
7edfbb8a,1,45,0.5,0,0,1,4,0,2,-2,0.9,1.7,-0.9,21,ENG
7f3b388c,30,2567,28.5,28,27,2,0,53,29,24,51.3,33.5,17.9,21,ENG
7fcc71d8,24,1661,18.5,22,3,2,0,16,24,-8,16.9,20.0,-3.1,21,ENG
803ae100,31,2247,25.0,26,19,5,1,19,35,-16,25.8,33.8,-8.0,21,ENG
80c31c97,3,18,0.2,0,0,3,10,1,0,1,0.9,0.7,0.2,21,ENG
810e3c74,16,1421,15.8,16,11,0,0,30,19,11,25.6,21.8,3.9,21,ENG
819aa8e7,25,1331,14.8,15,6,10,4,29,21,8,23.5,17.8,5.7,21,ENG
819b3158,28,2029,22.5,23,16,5,6,55,16,39,43.1,16.0,27.1,21,ENG
81d8091f,3,148,1.6,2,0,1,7,4,5,-1,2.5,3.1,-0.6,21,ENG
82927de4,33,2572,28.6,31,16,2,3,43,33,10,42.5,35.5,7.0,21,ENG
8397a50c,36,3194,35.5,36,35,0,0,50,42,8,48.7,47.0,1.6,21,ENG
839c14e1,10,746,8.3,8,7,2,15,16,11,5,13.2,9.0,4.2,21,ENG
83d074ff,21,1115,12.4,13,5,8,9,9,14,-5,14.7,11.1,3.6,21,ENG
849c826a,15,375,4.2,1,0,14,10,8,7,1,4.9,6.1,-1.2,21,ENG
8574c61f,2,33,0.4,0,0,2,23,1,0,1,0.8,1.5,-0.8,21,ENG
85f8571a,13,767,8.5,8,6,5,7,4,19,-15,5.9,15.2,-9.3,21,ENG
862a1c15,34,2429,27.0,28,12,6,2,30,48,-18,29.1,40.8,-11.7,21,ENG
86695068,15,718,8.0,10,0,5,10,12,11,1,11.3,8.8,2.5,21,ENG
867239d3,26,1897,21.1,21,17,5,3,36,26,10,30.8,25.7,5.1,21,ENG
86dd77d1,24,1946,21.6,22,20,2,9,48,20,28,32.9,20.6,12.4,21,ENG
86e7deaf,23,1935,21.5,23,20,0,2,33,20,13,37.5,16.2,21.3,21,ENG
87935cf3,4,276,3.1,3,3,1,8,4,8,-4,2.9,5.9,-3.1,21,ENG
87f7500e,21,1127,12.5,14,1,7,10,7,26,-19,8.8,18.8,-10.0,21,ENG
88acf83f,1,5,0.1,0,0,1,1,0,0,0,0.0,0.8,-0.8,21,ENG
892d5bb1,27,1949,21.7,23,13,4,10,48,22,26,35.1,21.0,14.0,21,ENG
8a7ff278,26,2256,25.1,25,25,1,7,25,43,-18,20.9,40.7,-19.7,21,ENG
8aec0537,34,2484,27.6,27,24,7,4,27,28,-1,36.1,24.3,11.8,21,ENG
8b04d6c1,38,3420,38.0,38,38,0,0,68,45,23,53.1,49.1,4.0,21,ENG
8b529245,9,308,3.4,3,2,6,16,5,2,3,4.8,5.1,-0.3,21,ENG
8b788c01,22,1480,16.4,17,5,5,1,34,19,15,27.1,18.8,8.3,21,ENG
8b9ebd03,25,1406,15.6,16,6,9,8,22,17,5,22.3,17.1,5.2,21,ENG
8d03ca5a,13,461,5.1,3,1,10,18,7,11,-4,7.8,10.1,-2.3,21,ENG
8d228291,5,138,1.5,0,0,5,3,2,5,-3,0.7,5.1,-4.4,21,ENG
8d3c902d,36,3121,34.7,35,33,1,1,39,56,-17,32.8,53.4,-20.5,21,ENG
8d62d31a,12,733,8.1,8,8,4,9,12,12,0,9.3,13.9,-4.7,21,ENG
8df7a2fb,30,2693,29.9,30,29,0,0,29,41,-12,32.4,47.6,-15.2,21,ENG
8f62b6ee,38,3420,38.0,38,38,0,0,68,45,23,53.1,49.1,4.0,21,ENG
8fa8f8d2,1,16,0.2,0,0,1,21,0,0,0,0.2,0.4,-0.3,21,ENG
90f91999,37,3330,37.0,37,37,0,0,53,46,7,50.3,50.6,-0.4,21,ENG
9228b07c,25,1423,15.8,17,8,8,10,18,23,-5,17.1,23.2,-6.2,21,ENG
92e7e919,37,3114,34.6,36,23,1,0,61,36,25,46.4,43.6,2.9,21,ENG
9319781b,14,523,5.8,5,1,9,19,10,10,0,8.9,8.2,0.7,21,ENG
9328b835,35,3150,35.0,35,35,0,0,57,44,13,49.2,46.7,2.5,21,ENG
935e6b8f,21,1704,18.9,20,16,1,2,34,23,11,30.4,19.4,10.9,21,ENG
93feac6e,38,3050,33.9,37,24,1,0,51,50,1,50.4,50.7,-0.3,21,ENG
966e28d0,4,255,2.8,3,2,1,1,1,6,-5,2.6,3.7,-1.1,21,ENG
9674002f,36,2890,32.1,32,26,4,1,48,32,16,55.3,25.7,29.7,21,ENG
96bb8cc2,19,1052,11.7,12,4,7,2,8,6,2,8.5,15.8,-7.3,21,ENG
97333cf5,33,2764,30.7,32,21,1,1,39,56,-17,32.8,44.2,-11.4,21,ENG
979b811d,36,2472,27.5,27,15,9,0,19,43,-24,28.4,39.4,-11.0,21,ENG
984a5a64,30,2645,29.4,30,26,0,1,41,41,0,31.5,38.0,-6.5,21,ENG
989d5705,22,1422,15.8,17,10,5,14,20,24,-4,17.9,21.5,-3.6,21,ENG
99813635,30,1596,17.7,16,8,14,1,20,18,2,23.2,14.0,9.1,21,ENG
9a104dee,5,48,0.5,0,0,5,6,1,3,-2,1.6,2.2,-0.5,21,ENG
9a28eba4,37,2649,29.4,28,25,9,0,31,41,-10,30.8,39.6,-8.8,21,ENG
9a71e978,12,577,6.4,5,4,7,22,3,11,-8,4.9,10.2,-5.4,21,ENG
9a9c05db,34,3060,34.0,34,34,0,2,30,47,-17,35.9,50.2,-14.3,21,ENG
9ae9eaea,13,623,6.9,7,5,6,4,8,9,-1,6.5,7.7,-1.2,21,ENG
9b398aea,21,1404,15.6,16,10,5,8,16,23,-7,15.1,18.5,-3.5,21,ENG
9c94165b,32,2654,29.5,30,27,2,2,51,33,18,41.3,32.7,8.6,21,ENG
9dbb75ca,31,1923,21.4,22,7,9,5,33,21,12,31.8,24.4,7.4,21,ENG
9dc96f10,3,166,1.8,2,0,1,8,3,3,0,2.2,1.7,0.5,21,ENG
9deaf2c8,15,277,3.1,1,1,14,18,5,1,4,5.1,2.2,2.9,21,ENG
9e1035f8,24,1306,14.5,15,5,9,13,29,13,16,23.2,12.4,10.9,21,ENG
9e525177,34,3060,34.0,34,34,0,3,67,36,31,54.9,37.2,17.7,21,ENG
9e5708be,37,3330,37.0,37,37,0,0,32,74,-42,33.5,66.4,-32.9,21,ENG
9f1893b9,2,3,0.0,0,0,2,2,0,0,0,0.0,0.2,-0.1,21,ENG
9f4647e9,11,531,5.8999999999999995,6,3,5,10,8,14,-6,7.1,7.9,-0.8999999999999999,21,ENG
9f472354,11,210,2.3,1,0,10,7,2,6,-4,1.9,5.6,-3.7,21,ENG
9f7c837d,31,2685,29.8,29,29,2,2,31,35,-4,31.8,39.4,-7.6,21,ENG
9fbbcf39,27,2407,26.7,27,26,0,7,26,40,-14,25.5,38.5,-12.9,21,ENG
a1232f4e,12,916,10.2,10,9,2,14,16,17,-1,15.1,13.8,1.3,21,ENG
a179d516,1,90,1.0,1,1,0,6,3,3,0,2.0,0.6,1.4,21,ENG
a1d5bd30,37,2920,32.4,33,22,4,1,57,39,18,47.8,34.4,13.3,21,ENG
a29b1131,21,1208,13.4,13,2,8,5,21,15,6,12.7,20.0,-7.3,21,ENG
a2b105e0,22,1412,15.7,15,14,7,9,20,26,-6,19.2,24.3,-5.1,21,ENG
a3b03921,21,1216,13.5,13,8,8,11,20,18,2,17.7,21.4,-3.6999999999999997,21,ENG
a4ac4b8f,21,1879,20.9,21,20,0,5,19,29,-10,18.7,26.1,-7.4,21,ENG
a4fe8cda,2,25,0.3,0,0,2,1,0,0,0,0.4,0.0,0.4,21,ENG
a53649b7,17,423,4.7,4,0,13,11,4,6,-2,5.2,3.9,1.3,21,ENG
a58bb1e1,20,920,10.2,10,0,10,10,21,12,9,15.9,9.4,6.5,21,ENG
a67a09fb,9,702,7.8,8,7,1,20,13,9,4,12.5,10.8,1.8,21,ENG
a712ca2b,18,1381,15.3,15,15,3,17,24,22,2,21.2,22.6,-1.4,21,ENG
a7588cdc,1,11,0.1,0,0,1,0,0,0,0,0.2,0.1,0.1,21,ENG
a8748947,10,759,8.4,9,7,1,5,6,15,-9,8.9,13.6,-4.7,21,ENG
a9142dc3,1,80,0.9,1,0,0,2,1,2,-1,1.2,1.5,-0.3,21,ENG
aa54ec6f,10,900,10.0,10,10,0,7,19,8,11,16.4,12.7,3.7,21,ENG
aa6f2f2c,1,22,0.2,0,0,1,2,0,0,0,0.9,0.9,0.0,21,ENG
aa849a12,36,2847,31.6,34,22,2,0,54,45,9,48.0,46.7,1.2,21,ENG
ab070c55,30,1816,20.2,21,11,9,4,23,34,-11,20.4,31.5,-11.1,21,ENG
ab13a5aa,37,3330,37.0,37,37,0,1,38,64,-26,32.2,56.9,-24.7,21,ENG
ab4b3e35,12,455,5.1,3,1,9,21,4,7,-3,3.7,7.8,-4.1,21,ENG
ab651565,29,1738,19.3,17,13,12,1,24,39,-15,24.5,29.5,-5.0,21,ENG
ab7d7882,1,13,0.1,0,0,1,1,0,3,-3,0.0,2.1,-2.1,21,ENG
abe66106,23,717,8.0,5,0,18,5,16,17,-1,14.2,13.4,0.8,21,ENG
ac05f970,26,1974,21.9,24,12,2,0,37,25,12,38.5,23.2,15.3,21,ENG
ac861941,28,2520,28.0,28,28,0,9,45,34,11,36.8,35.8,1.0,21,ENG
ad1f61f3,15,896,10.0,10,4,5,20,10,17,-7,11.3,11.2,0.1,21,ENG
ae0a7ddf,6,436,4.8,5,3,1,3,1,6,-5,3.0,7.7,-4.7,21,ENG
ae4fc6a4,34,2559,28.4,29,19,5,2,30,51,-21,25.3,43.8,-18.5,21,ENG
ae5019e6,16,1110,12.3,12,9,4,7,9,20,-11,10.8,20.2,-9.4,21,ENG
aed3a70f,37,3328,37.0,37,36,0,0,55,46,9,51.9,50.1,1.9,21,ENG
af341b88,4,229,2.5,3,2,1,23,1,8,-7,1.3,3.7,-2.4,21,ENG
af69e7f0,16,669,7.4,7,5,9,18,6,17,-11,6.4,11.8,-5.4,21,ENG
b04ee927,33,2577,28.6,30,21,3,0,32,54,-22,30.1,51.9,-21.7,21,ENG
b0b4fd3e,26,2185,24.3,24,22,2,0,40,28,12,36.3,33.4,2.9,21,ENG
b217ef29,10,691,7.7,9,6,1,0,19,5,14,15.7,6.8,8.9,21,ENG
b28bbd58,34,2258,25.1,25,16,9,4,25,37,-12,21.8,36.0,-14.2,21,ENG
b2bc3b1f,30,2612,29.0,29,27,1,0,37,52,-15,29.0,45.1,-16.1,21,ENG
b2d31e83,27,2061,22.9,23,20,4,10,20,28,-8,26.3,22.4,3.8,21,ENG
b2ee9d2c,1,1,0.0,0,0,1,0,0,0,0,0.0,0.0,0.0,21,ENG
b2f9c73e,2,20,0.2,0,0,2,5,0,0,0,0.0,0.8,-0.7,21,ENG
b400bde0,31,2536,28.2,28,25,3,5,58,23,35,53.9,23.2,30.7,21,ENG
b561db50,10,823,9.1,10,8,0,0,9,10,-1,8.4,11.1,-2.7,21,ENG
b581987a,18,392,4.4,4,0,14,17,6,8,-2,4.7,9.0,-4.4,21,ENG
b63e789d,31,2575,28.6,29,26,2,2,16,47,-31,23.7,46.9,-23.3,21,ENG
b66315ae,29,2063,22.9,22,18,7,1,54,17,37,42.9,15.0,27.9,21,ENG
b827d5b3,31,1746,19.4,17,9,14,7,36,22,14,30.5,24.1,6.4,21,ENG
b853e0ad,30,2390,26.6,27,18,3,5,49,25,24,42.2,26.1,16.1,21,ENG
b937e490,2,173,1.9,1,1,1,1,1,7,-6,1.0,4.2,-3.2,21,ENG
b98570d1,18,1242,13.8,15,8,3,12,14,33,-19,10.9,24.7,-13.8,21,ENG
b9fbae28,30,2146,23.8,24,19,6,2,35,24,11,35.5,20.9,14.6,21,ENG
ba115a40,16,937,10.4,10,7,6,0,11,12,-1,10.7,15.2,-4.5,21,ENG
bb5fbd2b,21,1672,18.6,19,15,2,0,23,25,-2,27.9,18.3,9.6,21,ENG
bba30585,15,1204,13.4,14,11,1,3,17,12,5,15.6,20.9,-5.4,21,ENG
bc0bfc64,15,810,9.0,9,3,6,2,7,9,-2,10.5,9.4,1.1,21,ENG
bc7dc64d,32,2553,28.4,30,20,2,4,38,31,7,37.2,30.3,6.9,21,ENG
bd6351cd,28,2299,25.5,27,23,1,6,51,18,33,50.7,17.0,33.7,21,ENG
bd8a7d05,3,62,0.7,0,0,3,2,0,2,-2,0.1,0.9,-0.8,21,ENG
bf3aeb61,6,264,2.9,2,1,4,17,1,7,-6,2.4,5.6,-3.2,21,ENG
bf8fad51,7,630,7.0,7,7,0,10,13,6,7,12.3,8.8,3.5,21,ENG
bfae110f,3,18,0.2,0,0,3,4,1,1,0,1.3,0.3,0.9,21,ENG
c0027d2d,5,377,4.2,4,3,1,13,1,8,-7,1.5,7.3,-5.8,21,ENG
c0398aca,16,427,4.7,3,0,13,10,11,6,5,7.0,5.2,1.7,21,ENG
c0617e2b,25,1615,17.9,17,11,8,10,23,17,6,24.5,18.5,6.0,21,ENG
c067631c,14,569,6.3,6,3,8,15,7,9,-2,8.2,8.0,0.2,21,ENG
c0e27d1a,20,1396,15.5,17,13,3,2,26,18,8,22.7,16.2,6.6,21,ENG
c17bfb65,31,1983,22.0,23,10,8,6,27,36,-9,25.3,33.3,-8.0,21,ENG
c2731c10,30,2531,28.1,28,25,2,2,18,48,-30,24.6,48.5,-24.0,21,ENG
c2dfedeb,11,546,6.1,5,3,6,5,2,11,-9,3.3,9.8,-6.5,21,ENG
c2f9d19f,1,16,0.2,0,0,1,26,0,2,-2,0.1,0.8,-0.7,21,ENG
c3e39f12,8,720,8.0,8,8,0,30,10,11,-1,9.5,11.8,-2.3,21,ENG
c40b6180,29,2594,28.8,29,28,0,2,32,35,-3,37.7,29.2,8.5,21,ENG
c47541e0,36,2317,25.7,29,6,7,0,32,31,1,33.8,33.2,0.6,21,ENG
c596fcb0,26,2084,23.2,23,19,3,1,31,37,-6,26.2,33.6,-7.4,21,ENG
c5b7c315,35,2991,33.2,33,32,2,2,42,43,-1,42.3,42.9,-0.6,21,ENG
c5bdb6e3,2,71,0.8,0,0,2,4,0,0,0,1.2,0.8,0.4,21,ENG
c684d3c9,13,1004,11.2,12,8,1,10,5,17,-12,7.8,21.8,-14.0,21,ENG
c691bfe2,35,2810,31.2,31,25,4,0,54,28,26,56.6,32.7,23.9,21,ENG
c7170b46,3,39,0.4,0,0,3,6,0,0,0,0.6,0.6,0.0,21,ENG
c73ada83,2,180,2.0,2,2,0,15,0,4,-4,1.8,3.1,-1.3,21,ENG
c81d773d,33,2953,32.8,33,32,0,1,24,41,-17,35.8,46.2,-10.4,21,ENG
c8aa95da,18,1246,13.8,13,11,5,0,13,21,-8,13.8,18.5,-4.7,21,ENG
c908a1bc,1,1,0.0,0,0,1,5,0,0,0,0.0,0.0,0.0,21,ENG
c92e1a31,25,1459,16.2,16,10,9,13,30,23,7,24.9,18.5,6.4,21,ENG
c931d9f9,15,910,10.1,11,4,4,12,22,7,15,19.1,9.0,10.1,21,ENG
c951a6df,24,1942,21.6,22,19,2,3,22,33,-11,20.9,33.1,-12.2,21,ENG
ca22ccb0,1,9,0.1,0,0,1,0,0,0,0,0.0,0.1,-0.1,21,ENG
ca2bc3df,1,9,0.1,0,0,1,9,0,0,0,0.1,0.0,0.1,21,ENG
caa1a7f0,4,61,0.7,0,0,4,10,0,2,-2,0.5,0.6,-0.1,21,ENG
cc2d7ad5,29,2426,27.0,28,25,1,1,19,42,-23,28.3,39.6,-11.3,21,ENG
cc700722,24,2051,22.8,23,21,1,2,27,30,-3,29.5,30.1,-0.6,21,ENG
cc70a1d5,1,90,1.0,1,1,0,30,3,2,1,1.9,1.4,0.5,21,ENG
cd1acf9d,36,3031,33.7,34,30,2,0,60,40,20,61.2,37.5,23.8,21,ENG
cde3309f,25,2250,25.0,25,25,0,6,26,43,-17,23.8,36.9,-13.1,21,ENG
ce4246f5,24,2029,22.5,22,22,2,11,41,25,16,36.9,20.7,16.2,21,ENG
ce5143da,24,1545,17.2,17,7,7,2,18,18,0,25.0,15.4,9.7,21,ENG
cea4ee8f,15,620,6.9,7,1,8,8,11,9,2,11.0,8.8,2.1,21,ENG
cee31595,18,1466,16.3,17,11,1,1,20,26,-6,14.2,21.6,-7.4,21,ENG
d0042ab9,28,2287,25.4,26,22,2,3,26,32,-6,26.6,33.5,-6.9,21,ENG
d01231f0,9,171,1.9,0,0,9,17,7,2,5,4.9,2.0,2.9,21,ENG
d04b94db,34,2983,33.1,34,29,0,2,31,45,-14,31.8,44.1,-12.4,21,ENG
d0b6129f,15,1120,12.4,13,11,2,0,6,23,-17,12.0,19.7,-7.8,21,ENG
d0f72bf1,18,1310,14.6,14,14,4,19,11,11,0,13.3,14.9,-1.6,21,ENG
d2424d1b,27,2286,25.4,27,22,0,7,37,23,14,43.5,19.5,24.0,21,ENG
d484c261,1,66,0.7,1,0,0,7,1,2,-1,0.5,1.3,-0.8,21,ENG
d557d734,17,1240,13.8,13,11,4,11,26,15,11,20.5,16.1,4.4,21,ENG
d56543a0,18,928,10.3,9,2,9,2,7,17,-10,10.7,13.0,-2.2,21,ENG
d5dd5f1f,29,2332,25.9,26,19,3,3,34,26,8,33.2,29.3,3.9,21,ENG
d6192210,33,2780,30.9,31,30,2,4,31,71,-40,26.1,58.7,-32.6,21,ENG
d7492450,1,2,0.0,0,0,1,24,0,0,0,0.0,0.0,0.0,21,ENG
d7553721,18,945,10.5,11,0,7,2,22,10,12,18.7,14.1,4.6,21,ENG
d79a8c87,30,2558,28.4,28,27,2,5,37,26,11,37.2,33.8,3.4,21,ENG
d87e2cae,17,1110,12.3,12,2,5,2,12,13,-1,12.2,13.8,-1.7,21,ENG
d8931174,34,3047,33.9,34,33,0,0,66,36,30,54.6,35.8,18.8,21,ENG
d93c2511,32,2129,23.7,24,20,8,4,49,25,24,37.4,26.6,10.8,21,ENG
d9cfca3d,11,296,3.3,2,0,9,8,1,10,-9,3.7,7.4,-3.7,21,ENG
da052c14,33,2096,23.3,23,12,10,3,21,42,-21,16.5,36.8,-20.3,21,ENG
da7b447d,18,1486,16.5,17,16,1,10,38,22,16,28.5,21.5,7.0,21,ENG
da8b19e2,2,91,1.0,1,1,1,36,0,1,-1,0.9,0.8,0.1,21,ENG
dad4b285,28,2281,25.3,25,22,3,5,22,27,-5,34.1,21.7,12.5,21,ENG
dbe56a33,35,2397,26.6,28,16,7,2,16,37,-21,22.2,38.6,-16.4,21,ENG
dc31b84c,1,90,1.0,1,1,0,13,0,9,-9,0.5,4.7,-4.2,21,ENG
dc64b8b3,25,2185,24.3,25,23,0,1,38,40,-2,37.8,36.6,1.2,21,ENG
dc6f5bdd,10,753,8.4,8,7,2,8,16,10,6,11.0,10.4,0.6,21,ENG
dd323728,6,249,2.8,3,0,3,25,5,1,4,4.6,4.1,0.6,21,ENG
dd897ee7,1,40,0.4,0,0,1,5,1,4,-3,0.5,2.1,-1.5,21,ENG
dda3969e,16,1189,13.2,14,8,2,2,16,17,-1,18.6,18.7,0.0,21,ENG
de112b84,26,1626,18.1,17,13,9,7,27,33,-6,24.9,31.2,-6.3,21,ENG
de31038e,1,4,0.0,0,0,1,8,0,0,0,0.0,0.2,-0.2,21,ENG
de5b5570,13,749,8.3,9,5,4,25,10,6,4,10.8,10.1,0.6,21,ENG
debe38a0,31,2629,29.2,30,28,1,0,16,47,-31,25.0,44.8,-19.8,21,ENG
df10e27c,5,261,2.9,3,2,2,12,5,2,3,3.7,2.8,1.0,21,ENG
e06683ca,5,370,4.1,5,4,0,0,12,11,1,10.0,5.2,4.8,21,ENG
e0bc6fdc,2,90,1.0,0,0,2,19,3,0,3,2.1,0.5,1.6,21,ENG
e28868f3,7,495,5.5,7,2,0,0,3,4,-1,5.7,5.9,-0.2,21,ENG
e342ad68,37,3078,34.2,34,27,3,0,59,41,18,60.5,38.2,22.3,21,ENG
e34fc66d,31,2730,30.3,30,29,1,0,22,35,-13,33.4,39.9,-6.5,21,ENG
e3a5814e,26,1720,19.1,19,14,7,8,22,23,-1,25.5,28.0,-2.4,21,ENG
e46012d4,25,1997,22.2,23,17,2,4,45,17,28,40.4,18.8,21.5,21,ENG
e49ce451,16,1317,14.6,15,12,1,0,17,20,-3,19.0,23.8,-4.9,21,ENG
e4e0deaa,1,1,0.0,0,0,1,0,0,0,0,0.0,0.0,0.0,21,ENG
e514ab62,38,3404,37.8,38,37,0,0,55,44,11,52.4,50.3,2.2,21,ENG
e58a03c6,18,514,5.7,4,1,14,9,5,9,-4,8.1,10.2,-2.1,21,ENG
e5a76dfe,13,1125,12.5,12,12,1,25,27,12,15,22.0,13.6,8.3,21,ENG
e608ed4c,1,90,1.0,1,1,0,37,3,2,1,2.4,1.5,0.9,21,ENG
e61b8aee,31,2522,28.0,29,23,2,2,44,26,18,42.7,29.6,13.1,21,ENG
e73c9bb2,9,690,7.7,8,5,1,22,15,11,4,14.7,8.2,6.4,21,ENG
e75750a3,28,1560,17.3,20,5,8,10,23,42,-19,18.6,32.7,-14.1,21,ENG
e7aa9d7c,32,1369,15.2,11,7,21,6,18,29,-11,16.6,22.3,-5.7,21,ENG
e7ca0439,8,553,6.1,6,5,2,4,6,12,-6,4.5,7.5,-3.0,21,ENG
e7ee38c3,7,630,7.0,7,7,0,21,9,9,0,9.1,11.2,-2.1,21,ENG
e8c9f4e9,16,735,8.2,7,4,9,9,6,15,-9,8.3,14.4,-6.1,21,ENG
e97fd090,31,1969,21.9,22,9,9,2,17,22,-5,25.8,28.2,-2.4,21,ENG
e9971f2d,6,487,5.4,6,4,0,8,7,8,-1,9.2,9.1,0.1,21,ENG
ea6bc03a,17,1132,12.6,13,12,4,2,20,21,-1,20.3,18.9,1.4,21,ENG
eaeca114,10,797,8.9,9,8,1,7,16,13,3,15.6,9.4,6.2,21,ENG
eb58eef0,38,2941,32.7,34,24,4,0,58,39,19,57.9,38.6,19.3,21,ENG
eb7822d7,20,1106,12.3,12,11,8,17,23,18,5,19.1,14.5,4.6,21,ENG
ed1e53f3,28,1616,18.0,17,10,11,10,46,16,30,32.1,16.0,16.1,21,ENG
ee38d9c5,31,2099,23.3,24,11,7,0,40,28,12,34.3,29.8,4.6,21,ENG
efb9215a,24,1837,20.4,20,19,4,12,24,37,-13,21.7,28.3,-6.6,21,ENG
f13d02a6,22,1156,12.8,13,5,9,10,21,23,-2,16.4,19.6,-3.3,21,ENG
f1e94cd6,18,745,8.3,7,0,11,10,9,11,-2,10.6,10.1,0.4,21,ENG
f230bc30,12,647,7.2,7,3,5,7,8,10,-2,6.1,6.9,-0.8,21,ENG
f25b010f,24,2079,23.1,24,20,0,3,31,38,-7,26.9,37.7,-10.8,21,ENG
f25c8e3a,10,520,5.8,7,2,3,8,17,8,9,11.4,5.9,5.5,21,ENG
f2bf1b0f,36,2667,29.6,30,16,6,0,39,51,-12,32.1,37.4,-5.3,21,ENG
f315ca93,2,7,0.1,0,0,2,20,0,0,0,0.0,0.0,0.0,21,ENG
f4290206,13,960,10.7,11,9,2,9,15,13,2,15.5,9.8,5.7,21,ENG
f4d296e4,27,2075,23.1,22,18,5,10,38,32,6,29.5,33.5,-4.0,21,ENG
f4e433d4,11,886,9.8,11,6,0,0,12,15,-3,13.7,10.0,3.7,21,ENG
f522d7ec,20,1235,13.7,15,6,5,9,10,33,-23,7.9,26.5,-18.6,21,ENG
f586779e,22,1040,11.6,12,7,10,8,23,12,11,20.0,8.2,11.8,21,ENG
f5a00fa4,33,2528,28.1,28,18,5,1,25,40,-15,26.8,39.7,-12.9,21,ENG
f5b281e7,2,81,0.9,1,0,1,24,0,1,-1,0.5,2.4,-2.0,21,ENG
f5deef4c,29,2585,28.7,29,28,0,5,61,30,31,47.8,30.3,17.5,21,ENG
f631c17f,25,1269,14.1,14,1,11,8,6,21,-15,9.9,22.1,-12.1,21,ENG
f72293fc,22,1363,15.1,16,4,6,4,15,24,-9,17.0,20.4,-3.5,21,ENG
f76e6b4e,3,270,3.0,3,3,0,27,6,9,-3,7.1,4.6,2.4,21,ENG
f7750aa0,3,270,3.0,3,3,0,18,3,10,-7,2.6,4.7,-2.1,21,ENG
f7d50789,25,2240,24.9,25,24,0,10,44,25,19,33.9,29.4,4.5,21,ENG
f833a830,19,1004,11.2,11,4,8,16,23,18,5,15.8,14.1,1.7000000000000002,21,ENG
f874dd44,25,2089,23.2,24,20,1,9,26,24,2,28.5,28.0,0.6,21,ENG
f8e588df,4,40,0.4,0,0,4,5,0,1,-1,0.4,0.3,0.2,21,ENG
f8fcd2a5,28,2473,27.5,28,25,0,0,46,31,15,39.0,29.8,9.2,21,ENG
fa031b34,34,2861,31.8,33,21,1,0,40,38,2,39.9,40.6,-0.7,21,ENG
fb2dec57,19,561,6.2,2,0,17,8,4,12,-8,4.8,14.2,-9.4,21,ENG
fb614c44,23,2070,23.0,23,23,0,0,39,25,14,33.9,25.8,8.1,21,ENG
fc027d02,14,969,10.8,12,7,2,17,23,18,5,17.2,14.8,2.4,21,ENG
fc15fb84,36,3069,34.1,34,30,2,0,32,50,-18,35.4,48.4,-13.0,21,ENG
fcab00a0,4,225,2.5,3,0,1,11,4,2,2,3.6,2.1,1.4,21,ENG
fce2302c,27,2299,25.5,26,23,1,0,35,27,8,33.8,28.2,5.5,21,ENG
fdd85f94,7,213,2.4,2,0,5,14,2,2,0,2.7,2.9,-0.2,21,ENG
fdf3cb77,34,3054,33.9,34,33,0,1,57,43,14,48.8,44.7,4.0,21,ENG
fed7cb61,27,1520,16.9,18,8,9,4,31,15,16,28.7,12.5,16.2,21,ENG
ff527768,21,712,7.9,8,2,13,11,11,15,-4,7.7,14.2,-6.5,21,ENG
ffa90327,28,1613,17.9,17,6,11,6,23,22,1,26.4,23.7,2.7,21,ENG
ffec9769,1,20,0.2,0,0,1,0,0,1,-1,0.3,0.3,0.0,21,ENG
0027c6cc,8,720,8.0,8,8,0,0,6,10,-4,8.9,8.7,0.2,21,EL
005ca692,4,284,3.2,3,3,1,0,3,5,-2,4.2,5.9,-1.8,21,EL
00672021,4,314,3.5,4,1,0,0,3,4,-1,4.3,5.2,-0.9,21,EL
00ddb7f7,4,300,3.3,4,1,0,0,3,8,-5,4.2,7.7,-3.5,21,EL
00eba9c9,3,210,2.3,3,0,0,0,1,7,-6,2.2,5.4,-3.3,21,EL
00f0482f,1,15,0.2,0,0,1,3,0,0,0,0.0,0.0,0.0,21,EL
011d8c56,1,90,1.0,1,1,0,4,1,0,1,4.5,0.2,4.3,21,EL
0127419a,6,358,4.0,5,0,1,4,10,3,7,7.5,3.9,3.6,21,EL
0193a8bf,8,548,6.1,7,0,1,2,8,8,0,6.4,7.7,-1.3,21,EL
01ccefab,6,429,4.8,5,2,1,0,5,4,1,8.9,5.3,3.6,21,EL
02a496ff,5,395,4.4,5,3,0,0,6,12,-6,4.0,8.7,-4.6,21,EL
02ce2030,6,476,5.3,6,4,0,0,4,7,-3,8.2,8.6,-0.4,21,EL
02d2c436,8,637,7.1,7,7,1,0,5,10,-5,7.6,8.5,-0.8,21,EL
02fbc447,1,90,1.0,1,1,0,5,3,1,2,3.8,0.5,3.3,21,EL
032f894e,4,287,3.2,3,2,1,1,11,5,6,4.8,5.2,-0.4,21,EL
0362c29e,5,366,4.1,4,4,1,0,5,9,-4,8.4,6.4,2.0,21,EL
03df04ff,4,360,4.0,4,4,0,3,14,5,9,9.0,4.7,4.3,21,EL
03f946ed,6,296,3.3,3,0,3,0,5,2,3,7.6,3.1,4.6,21,EL
042d286e,6,278,3.1,3,0,3,0,2,4,-2,4.7,3.9,0.8,21,EL
04df29a5,3,104,1.2,1,0,2,2,1,1,0,0.6,1.3,-0.6,21,EL
0557ff4f,1,66,0.7,1,0,0,2,2,3,-1,1.0,2.0,-1.1,21,EL
0562b7f1,4,277,3.1,3,1,1,1,4,12,-8,3.6,6.7,-3.1,21,EL
0578b238,5,450,5.0,5,5,0,1,6,13,-7,4.4,10.1,-5.7,21,EL
05bffdb1,4,360,4.0,4,4,0,2,9,7,2,6.0,9.5,-3.5,21,EL
05e19d6a,8,509,5.7,6,4,2,2,7,8,-1,6.3,7.3,-1.0,21,EL
0658de43,3,82,0.9,0,0,3,2,0,2,-2,0.9,1.7,-0.7,21,EL
0670ee51,2,91,1.0,1,1,1,0,0,2,-2,1.0,2.0,-1.1,21,EL
06a10001,6,523,5.8,6,5,0,0,11,12,-1,8.2,10.4,-2.1,21,EL
06eae126,4,296,3.3,4,0,0,0,4,4,0,3.6,5.7,-2.1,21,EL
070ec0b1,1,80,0.9,1,0,0,3,4,1,3,1.0,0.4,0.6,21,EL
07a821e4,2,76,0.8,1,0,1,0,1,1,0,1.9,0.4,1.5,21,EL
08593525,6,337,3.7,3,1,3,1,13,3,10,10.7,3.9,6.8,21,EL
08f5afaa,8,720,8.0,8,8,0,0,12,12,0,10.0,9.6,0.4,21,EL
0990f2fb,6,540,6.0,6,6,0,0,8,7,1,5.9,8.4,-2.6,21,EL
09a9e921,9,490,5.4,7,0,2,4,11,5,6,7.9,3.5,4.4,21,EL
0a3d6d2b,2,180,2.0,2,2,0,0,3,5,-2,6.3,2.7,3.6,21,EL
0a6dbbf7,2,180,2.0,2,2,0,0,1,2,-1,1.8,1.4,0.4,21,EL
0a8d6b91,2,109,1.2,1,1,1,4,0,1,-1,1.1,1.1,-0.1,21,EL
0ac893aa,6,539,6.0,6,5,0,0,4,10,-6,4.9,9.1,-4.2,21,EL
0acf0e1c,1,6,0.1,0,0,1,5,0,1,-1,0.0,0.4,-0.4,21,EL
0aeeed3f,9,725,8.1,9,3,0,0,12,11,1,11.0,11.8,-0.8,21,EL
0b0f256d,1,62,0.7,1,0,0,0,1,3,-2,1.5,1.9,-0.3,21,EL
0b5a292a,6,397,4.4,4,2,2,2,4,3,1,6.1,5.7,0.4,21,EL
0be28faf,5,343,3.8,5,0,0,1,5,11,-6,3.2,6.2,-2.9,21,EL
0bf123b6,1,90,1.0,1,1,0,3,0,2,-2,0.2,1.2,-1.0,21,EL
0bf3c11c,4,105,1.2,1,0,3,2,3,4,-1,1.4,1.8,-0.4,21,EL
0c3057a9,6,442,4.9,5,1,1,0,6,10,-4,6.3,8.2,-1.9,21,EL
0c5c94d0,5,127,1.4,1,0,4,1,3,2,1,1.1,1.9,-0.8,21,EL
0c81fbf1,1,1,0.0,0,0,1,0,0,0,0,0.0,0.0,0.0,21,EL
0cb29e91,8,428,4.8,4,2,4,0,3,3,0,4.4,7.3,-2.8,21,EL
0cd0e21b,5,237,2.6,3,1,2,0,6,8,-2,4.6,6.7,-2.2,21,EL
0d10333c,7,399,4.4,4,3,3,1,13,6,7,9.9,5.1,4.8,21,EL
0d267745,6,468,5.2,6,5,0,1,15,6,9,9.5,5.5,3.9,21,EL
0d4fd3a0,4,317,3.5,4,1,0,2,6,7,-1,2.9,7.1,-4.2,21,EL
0d72fbca,9,170,1.9,0,0,9,1,4,2,2,3.9,2.6,1.4,21,EL
0d901d79,1,14,0.2,0,0,1,1,1,1,0,0.3,0.1,0.3,21,EL
0db169ae,8,539,6.0,5,4,3,2,13,7,6,7.6,6.5,1.2,21,EL
0e5753c7,2,180,2.0,2,2,0,0,5,2,3,3.2,1.3,1.8,21,EL
0e96a5e1,1,33,0.4,0,0,1,1,2,1,1,1.7,1.0,0.7,21,EL
0eb8ee41,10,602,6.7,7,2,3,2,8,10,-2,6.0,9.4,-3.3,21,EL
0eeafda5,1,90,1.0,1,1,0,5,1,3,-2,0.4,2.5,-2.1,21,EL
0f888175,6,372,4.1,4,3,2,0,10,7,3,6.7,9.4,-2.7,21,EL
0fbb73c2,5,292,3.2,3,2,2,1,6,9,-3,5.3,7.6,-2.3,21,EL
1013b476,2,180,2.0,2,2,0,1,1,5,-4,2.2,4.0,-1.7,21,EL
10161491,1,90,1.0,1,1,0,4,3,2,1,1.3,1.5,-0.1,21,EL
108fe016,4,141,1.6,1,1,3,0,3,2,1,2.5,2.4,0.0,21,EL
112c495e,4,295,3.3,3,2,1,0,5,3,2,3.7,4.2,-0.6,21,EL
116c35df,8,674,7.5,8,6,0,0,13,14,-1,10.1,7.7,2.4,21,EL
11a1a615,3,225,2.5,2,2,1,3,3,4,-1,1.6,4.4,-2.8,21,EL
11b4f41a,4,155,1.7,2,0,2,1,3,7,-4,2.8,4.6,-1.8,21,EL
11b9265b,4,46,0.5,0,0,4,2,0,0,0,0.3,0.3,0.1,21,EL
11c0fa9d,3,260,2.9,3,2,0,1,2,3,-1,2.0,3.9,-1.9,21,EL
11c7fa75,2,180,2.0,2,2,0,8,0,5,-5,1.1,6.5,-5.4,21,EL
11f5df14,4,360,4.0,4,4,0,1,4,8,-4,4.2,6.8,-2.6,21,EL
121101a4,6,179,2.0,2,0,4,5,3,1,2,3.3,3.2,0.2,21,EL
123dd5e2,9,337,3.7,2,1,7,0,9,5,4,9.1,5.1,3.9,21,EL
1295b5e3,5,450,5.0,5,5,0,0,10,11,-1,7.0,10.0,-3.0,21,EL
12aa7661,2,135,1.5,1,1,1,2,2,2,0,1.2,3.0,-1.9,21,EL
12c35abe,5,280,3.1,3,1,2,0,7,3,4,3.8,2.9,0.8,21,EL
12dcbdcc,6,502,5.6,6,4,0,0,12,10,2,8.9,9.9,-1.1,21,EL
12e6d21a,8,671,7.5,8,4,0,0,8,11,-3,8.8,12.6,-3.8,21,EL
130a7a3f,10,724,8.0,9,5,1,0,15,9,6,11.0,8.2,2.8,21,EL
132a82f1,6,469,5.2,4,3,2,0,13,3,10,11.5,4.4,7.1,21,EL
1338e42b,4,293,3.3,3,2,1,4,10,5,5,6.9,4.9,2.0,21,EL
1395682c,3,193,2.1,3,2,0,0,3,2,1,3.1,2.7,0.3,21,EL
13b44b02,4,240,2.7,2,2,2,7,2,0,2,2.9,5.1,-2.2,21,EL
13c8e5f6,4,279,3.1,4,1,0,0,2,8,-6,1.8,10.3,-8.4,21,EL
13ea2544,4,360,4.0,4,4,0,0,7,7,0,3.7,5.2,-1.6,21,EL
14229604,1,10,0.1,0,0,1,0,1,0,1,0.1,0.2,0.0,21,EL
14349aeb,4,244,2.7,4,0,0,0,4,4,0,2.6,6.9,-4.3,21,EL
14866457,1,29,0.3,0,0,1,0,1,0,1,1.2,0.1,1.1,21,EL
148e136f,2,180,2.0,2,2,0,0,2,4,-2,2.0,2.7,-0.7,21,EL
14a4dd0d,1,17,0.2,0,0,1,3,0,0,0,0.0,0.6,-0.6,21,EL
15975a3c,2,169,1.9,2,1,0,0,2,4,-2,2.0,2.7,-0.7,21,EL
1598599e,4,178,2.0,1,1,3,4,3,1,2,4.4,1.6,2.8,21,EL
15b949ab,3,270,3.0,3,3,0,0,5,6,-1,3.9,4.9,-1.1,21,EL
15eb04ec,6,480,5.3,6,2,0,0,2,8,-6,6.0,8.9,-2.9,21,EL
15fd5593,6,540,6.0,6,6,0,0,11,5,6,15.4,5.0,10.4,21,EL
165a2e40,4,80,0.9,0,0,4,2,6,0,6,2.8,1.2,1.5,21,EL
16657b95,13,1042,11.6,13,10,0,0,26,14,12,23.9,16.6,7.3,21,EL
166a981d,2,46,0.5,1,0,1,4,0,0,0,0.2,0.4,-0.2,21,EL
1695c659,4,226,2.5,3,0,1,0,0,4,-4,2.1,4.6,-2.5,21,EL
16aa3654,5,372,4.1,5,2,0,0,10,4,6,8.3,2.3,6.0,21,EL
16b9d5cf,8,675,7.5,8,7,0,0,8,7,1,13.0,9.7,3.3,21,EL
16c149b8,5,401,4.5,4,3,1,1,3,11,-8,7.1,7.1,-0.1,21,EL
16daec92,7,434,4.8,6,3,1,0,14,2,12,10.6,3.3,7.3,21,EL
172bab0a,4,269,3.0,3,1,1,0,3,6,-3,4.6,5.7,-1.1,21,EL
17695062,11,679,7.5,8,1,3,0,13,7,6,12.2,5.5,6.7,21,EL
179d2851,12,1054,11.7,12,11,0,0,16,16,0,12.6,16.4,-3.8,21,EL
17e3e467,3,162,1.8,2,0,1,1,2,3,-1,2.0,3.1,-1.2,21,EL
1880614f,8,499,5.5,6,2,2,0,8,6,2,8.1,5.5,2.6,21,EL
1971591f,3,225,2.5,2,2,1,0,7,2,5,5.2,2.5,2.7,21,EL
197640fd,2,111,1.2,1,0,1,0,3,1,2,2.8,0.7,2.1,21,EL
19a12bed,4,338,3.8,4,2,0,0,6,12,-6,4.3,6.5,-2.2,21,EL
19c36442,6,454,5.0,5,2,1,0,5,3,2,6.6,3.4,3.2,21,EL
19e74ea6,4,61,0.7,0,0,4,1,0,0,0,0.6,1.9,-1.3,21,EL
1a4ef233,2,150,1.7,2,1,0,0,0,1,-1,0.8,1.5,-0.7,21,EL
1a6b7ea4,6,450,5.0,6,4,0,0,10,7,3,7.3,4.1,3.3,21,EL
1a799243,2,180,2.0,2,2,0,0,1,4,-3,2.9,3.2,-0.4,21,EL
1a9db1c5,1,5,0.1,0,0,1,4,0,0,0,0.3,0.0,0.3,21,EL
1adcf39e,4,360,4.0,4,4,0,0,4,5,-1,4.9,6.3,-1.4,21,EL
1b033987,6,342,3.8,4,1,2,0,6,4,2,5.0,3.9,1.1,21,EL
1b192c1f,8,665,7.4,8,6,0,0,8,10,-2,8.7,9.7,-1.0,21,EL
1b7af391,2,74,0.8,1,0,1,2,0,4,-4,0.5,2.9,-2.4,21,EL
1b81794d,9,262,2.9,2,0,7,1,5,5,0,5.6,5.3,0.4,21,EL
1bd5735a,3,31,0.3,0,0,3,1,1,0,1,0.9,0.8,0.1,21,EL
1bda5842,8,433,4.8,5,0,3,0,1,3,-2,9.8,3.8,6.0,21,EL
1bfdb73a,5,254,2.8,3,2,2,3,5,2,3,4.9,2.5,2.4,21,EL
1c07b06e,4,232,2.6,3,2,1,0,5,7,-2,2.0,3.2,-1.2,21,EL
1cfd188f,1,90,1.0,1,1,0,3,1,2,-1,0.4,1.6,-1.2,21,EL
1d25929b,2,121,1.3,1,0,1,0,0,2,-2,1.4,2.5,-1.1,21,EL
1d42db4a,9,705,7.8,8,6,1,0,12,13,-1,13.0,14.9,-1.9,21,EL
1d54e8f8,4,289,3.2,4,0,0,0,3,2,1,2.9,4.4,-1.5,21,EL
1d5cab82,2,180,2.0,2,2,0,0,1,4,-3,2.9,3.2,-0.4,21,EL
1d8e9add,6,495,5.5,6,5,0,1,11,6,5,13.3,5.7,7.6,21,EL
1dbfae2d,2,61,0.7,0,0,2,2,0,2,-2,0.6,2.1,-1.5,21,EL
1e1378e1,2,91,1.0,1,0,1,0,0,2,-2,0.7,2.3,-1.6,21,EL
1e8dbb59,7,381,4.2,4,4,3,1,5,3,2,3.6,7.7,-4.1,21,EL
1f0072a6,1,90,1.0,1,1,0,4,4,0,4,2.9,1.3,1.7,21,EL
1f079188,8,501,5.6,6,5,2,3,15,5,10,12.6,3.0,9.7,21,EL
1f3afdcb,2,180,2.0,2,2,0,0,1,2,-1,1.8,1.4,0.4,21,EL
1f6298f2,1,45,0.5,0,0,1,2,0,1,-1,0.7,0.7,0.1,21,EL
1fda91b3,4,278,3.1,3,3,1,3,7,0,7,7.1,0.9,6.1,21,EL
2003bf6f,2,2,0.0,0,0,2,10,0,0,0,0.0,0.0,0.0,21,EL
200e89e1,6,115,1.3,0,0,6,1,1,1,0,2.2,1.7,0.6,21,EL
202b3b68,3,140,1.6,2,0,1,1,2,4,-2,2.9,2.8,0.1,21,EL
20730eae,7,319,3.5,2,1,5,0,6,7,-1,6.0,4.9,1.1,21,EL
20b9f052,12,1017,11.3,12,11,0,1,26,7,19,20.5,11.9,8.6,21,EL
210bade3,6,155,1.7,2,0,4,0,0,3,-3,1.8,2.0,-0.2,21,EL
21166ff4,3,196,2.2,3,2,0,0,0,2,-2,1.0,1.8,-0.8,21,EL
21453b2e,1,45,0.5,1,0,0,1,0,0,0,0.3,0.0,0.2,21,EL
2146785a,3,205,2.3,3,0,0,5,4,2,2,5.4,1.9,3.5,21,EL
216891d5,3,64,0.7,1,0,2,3,0,1,-1,0.1,0.5,-0.4,21,EL
21945a9e,2,19,0.2,0,0,2,4,1,0,1,0.7,0.0,0.7,21,EL
21a66f6a,5,314,3.5,3,1,2,3,5,3,2,7.4,2.1,5.3,21,EL
2209c211,5,326,3.6,3,3,2,1,5,8,-3,5.8,6.7,-0.9,21,EL
228b0d9d,2,103,1.1,1,1,1,6,1,0,1,1.8,0.7,1.1,21,EL
22919e97,4,103,1.1,0,0,4,1,4,4,0,4.5,2.9,1.6,21,EL
22f2ce4b,6,327,3.6,5,0,1,0,7,6,1,4.9,5.2,-0.3,21,EL
230a2fac,8,660,7.3,7,7,1,0,8,7,1,13.9,8.6,5.3,21,EL
230f0471,4,277,3.1,3,1,1,4,6,4,2,4.6,2.2,2.3,21,EL
23559bd9,3,184,2.0,2,2,1,1,4,4,0,2.6,4.9,-2.3,21,EL
235a646b,4,200,2.2,2,2,2,1,3,6,-3,1.6,5.1,-3.4,21,EL
23a10591,1,22,0.2,0,0,1,2,2,1,1,0.2,0.9,-0.6,21,EL
23f9e9d3,6,169,1.9,1,1,5,2,4,7,-3,2.4,5.8,-3.3,21,EL
24228180,10,740,8.2,8,3,2,0,12,6,6,10.5,9.5,0.9,21,EL
2429a3ec,4,360,4.0,4,4,0,0,6,8,-2,4.5,5.8,-1.3,21,EL
242e1043,5,450,5.0,5,5,0,1,4,8,-4,7.0,7.8,-0.8,21,EL
244a31b9,5,450,5.0,5,5,0,0,6,16,-10,4.5,14.8,-10.4,21,EL
2475dcc6,6,540,6.0,6,6,0,0,11,5,6,15.4,5.0,10.4,21,EL
24b98f95,1,9,0.1,0,0,1,3,0,0,0,0.0,0.5,-0.4,21,EL
24fc70d3,6,403,4.5,6,1,0,1,6,6,0,6.2,6.7,-0.6,21,EL
25126342,6,540,6.0,6,6,0,0,5,12,-7,6.3,10.6,-4.3,21,EL
254b831b,3,184,2.0,2,1,1,2,1,6,-5,1.0,3.1,-2.1,21,EL
258a6f4d,5,233,2.6,2,1,3,0,3,7,-4,5.2,4.4,0.8,21,EL
25b74470,5,344,3.8,4,3,1,1,8,1,7,7.2,2.6,4.6,21,EL
25e6f8cb,1,90,1.0,1,1,0,3,0,1,-1,1.4,0.7,0.7,21,EL
2628fd2b,10,900,10.0,10,10,0,2,19,10,9,16.8,7.8,9.0,21,EL
262e5a82,3,120,1.3,2,0,1,5,3,1,2,1.8,1.1,0.8,21,EL
264b6d64,1,8,0.1,0,0,1,6,0,0,0,0.1,0.0,0.1,21,EL
26a796c1,5,352,3.9,4,2,1,0,4,9,-5,2.1,8.1,-6.0,21,EL
26b7d548,2,135,1.5,1,1,1,1,0,4,-4,0.7,2.1,-1.4,21,EL
26ce2263,5,390,4.3,4,2,1,0,7,15,-8,4.5,9.3,-4.8,21,EL
2707b562,5,146,1.6,2,0,3,1,4,7,-3,2.6,3.0,-0.4,21,EL
275f52fc,1,10,0.1,0,0,1,1,0,0,0,0.0,0.5,-0.5,21,EL
27b35319,1,5,0.1,0,0,1,1,0,0,0,0.0,0.1,-0.1,21,EL
27d902c8,2,180,2.0,2,2,0,0,1,4,-3,2.9,3.2,-0.4,21,EL
27e3271e,6,532,5.9,6,4,0,0,5,11,-6,6.4,11.0,-4.6,21,EL
27f0ddef,4,360,4.0,4,4,0,4,13,9,4,9.8,5.4,4.5,21,EL
27f0fcda,3,25,0.3,0,0,3,2,0,0,0,0.0,0.3,-0.3,21,EL
27ff9bdb,6,223,2.5,2,1,4,0,4,10,-6,3.1,4.7,-1.5,21,EL
282faa70,5,270,3.0,3,2,2,3,4,8,-4,4.3,5.8,-1.6,21,EL
28eaa0f3,6,229,2.5,2,1,4,1,2,8,-6,3.3,6.6,-3.3,21,EL
28eea0fc,5,293,3.3,3,3,2,0,7,3,4,5.8,4.1,1.7,21,EL
292a652a,3,270,3.0,3,3,0,1,4,2,2,4.0,4.0,0.1,21,EL
2969ccd2,6,301,3.3,3,1,3,0,1,4,-3,2.7,3.9,-1.2,21,EL
29733c72,5,36,0.4,0,0,5,1,2,0,2,0.6,0.2,0.4,21,EL
29e48848,5,208,2.3,1,1,4,0,0,5,-5,1.9,4.0,-2.2,21,EL
29fbdc88,10,724,8.0,8,3,2,1,12,7,5,9.5,11.5,-2.0,21,EL
2a70dcc9,4,88,1.0,1,0,3,0,3,0,3,1.5,1.1,0.4,21,EL
2a74db8a,4,69,0.8,0,0,4,0,3,2,1,1.2,2.6,-1.4,21,EL
2a8c9f98,2,30,0.3,0,0,2,6,0,0,0,0.8,0.3,0.5,21,EL
2acd49b9,8,490,5.4,5,2,3,2,13,6,7,12.5,4.3,8.1,21,EL
2b1c4abd,4,163,1.8,2,0,2,2,3,3,0,1.1,2.7,-1.6,21,EL
2b3efa4a,11,885,9.8,10,9,1,0,12,13,-1,9.6,14.5,-4.9,21,EL
2b53f7a5,6,394,4.4,4,2,2,0,6,13,-7,4.3,14.7,-10.4,21,EL
2b622f01,10,591,6.6,7,0,3,0,17,5,12,15.0,5.7,9.4,21,EL
2b79c1a3,1,1,0.0,0,0,1,1,0,0,0,0.0,0.0,0.0,21,EL
2ba38347,5,246,2.7,2,1,3,7,3,2,1,2.1,3.1,-1.0,21,EL
2bab583c,7,516,5.7,5,5,2,2,11,13,-2,9.4,10.6,-1.2,21,EL
2baec6ce,3,140,1.6,1,1,2,6,2,0,2,1.5,1.2,0.3,21,EL
2bf50b37,2,66,0.7,0,0,2,0,0,1,-1,1.3,1.0,0.3,21,EL
2ccd89a3,1,83,0.9,1,0,0,0,0,1,-1,0.9,0.9,0.0,21,EL
2cd081e3,5,256,2.8,3,0,2,0,3,6,-3,3.5,4.5,-1.0,21,EL
2ce71308,3,200,2.2,2,1,1,0,5,4,1,3.0,4.4,-1.5,21,EL
2d26a704,4,142,1.6,1,0,3,4,0,5,-5,0.3,2.6,-2.4,21,EL
2d45ce0a,5,180,2.0,2,0,3,0,2,5,-3,3.4,4.9,-1.5,21,EL
2d49b833,6,441,4.9,5,4,1,0,3,8,-5,3.2,8.3,-5.0,21,EL
2e594b84,4,292,3.2,4,1,0,0,6,7,-1,5.7,6.9,-1.2,21,EL
2e77d607,5,450,5.0,5,5,0,1,3,11,-8,8.0,7.1,0.9,21,EL
2ef7c612,1,90,1.0,1,1,0,0,1,1,0,0.8,0.4,0.3,21,EL
2f3452eb,2,148,1.6,2,1,0,1,1,1,0,1.8,2.1,-0.3,21,EL
2f557579,8,472,5.2,5,4,3,0,6,5,1,10.7,6.4,4.3,21,EL
2f7acede,8,664,7.4,8,6,0,2,19,4,15,17.2,6.2,11.0,21,EL
301c287b,5,274,3.0,2,2,3,0,5,1,4,3.2,2.5,0.8,21,EL
30223b33,2,153,1.7,1,1,1,11,4,7,-3,5.3,5.3,0.0,21,EL
3060f38c,1,45,0.5,0,0,1,1,1,1,0,0.4,0.8,-0.3,21,EL
30643ce2,1,21,0.2,0,0,1,0,0,0,0,0.3,0.0,0.2,21,EL
3092b473,1,18,0.2,0,0,1,4,0,0,0,0.8,0.0,0.8,21,EL
3098c0df,2,25,0.3,0,0,2,4,0,0,0,0.4,0.6,-0.2,21,EL
30d4a2e5,4,352,3.9,4,3,0,0,2,5,-3,2.2,5.1,-2.8,21,EL
30d75bfb,1,14,0.2,0,0,1,5,0,1,-1,0.1,0.4,-0.3,21,EL
30fab1ee,7,327,3.6,3,3,4,0,7,3,4,3.7,4.6,-0.9,21,EL
313d5ee5,6,384,4.3,4,2,2,0,8,12,-4,7.3,10.8,-3.5,21,EL
315e74cf,8,535,5.9,7,3,1,0,10,7,3,12.8,6.7,6.1,21,EL
316de854,10,754,8.4,8,5,2,0,19,14,5,15.1,10.2,4.9,21,EL
31822f8c,5,68,0.8,0,0,5,0,3,1,2,1.6,0.2,1.5,21,EL
319322cd,6,485,5.4,6,4,0,0,5,11,-6,4.6,9.3,-4.7,21,EL
31a62dc7,4,331,3.7,4,3,0,1,6,5,1,5.3,4.2,1.1,21,EL
321a71a7,2,180,2.0,2,2,0,0,5,9,-4,3.3,6.3,-3.0,21,EL
321f83a2,6,470,5.2,5,3,1,0,8,7,1,5.5,7.6,-2.1,21,EL
327c20e6,5,406,4.5,5,3,0,1,5,10,-5,5.5,6.2,-0.7,21,EL
328f7d51,9,566,6.3,6,4,3,0,16,9,7,12.9,5.7,7.2,21,EL
32f7976d,5,450,5.0,5,5,0,1,5,15,-10,3.6,10.6,-6.9,21,EL
3318193b,5,358,4.0,5,0,0,0,4,6,-2,4.1,6.1,-2.0,21,EL
3353737a,4,255,2.8,3,2,1,3,3,2,1,5.1,2.8,2.3,21,EL
346d51d9,7,427,4.7,4,2,3,0,11,9,2,7.2,6.2,1.0,21,EL
34caa4b3,6,71,0.8,0,0,6,0,4,0,4,3.7,0.1,3.6,21,EL
35044395,4,272,3.0,3,3,1,1,2,7,-5,1.3,6.2,-4.8,21,EL
35141f4c,5,431,4.8,5,4,0,0,3,4,-1,6.9,5.7,1.2,21,EL
352ca5eb,4,254,2.8,3,1,1,0,3,5,-2,3.6,3.4,0.3,21,EL
35389469,2,180,2.0,2,2,0,0,0,3,-3,1.9,3.1,-1.2,21,EL
3564fbc8,3,107,1.2,2,0,1,3,0,4,-4,0.5,1.5,-1.0,21,EL
359a9fb4,2,101,1.1,1,1,1,0,0,1,-1,0.6,0.6,0.0,21,EL
35c54115,6,540,6.0,6,6,0,0,9,11,-2,6.1,8.5,-2.4,21,EL
3624ce4c,6,346,3.8,3,3,3,0,3,6,-3,3.4,7.1,-3.7,21,EL
3626daea,11,563,6.3,8,1,3,0,18,2,16,12.1,4.0,8.1,21,EL
370ae604,2,41,0.5,0,0,2,3,1,1,0,1.1,2.1,-1.0,21,EL
37268799,4,117,1.3,1,0,3,1,3,3,0,2.3,2.9,-0.6,21,EL
374ee424,7,630,7.0,7,7,0,1,4,8,-4,11.6,8.3,3.3,21,EL
3768a876,4,47,0.5,0,0,4,2,0,0,0,0.2,0.8,-0.7,21,EL
376d4a41,1,10,0.1,0,0,1,0,1,0,1,0.2,0.0,0.2,21,EL
37736209,4,275,3.1,3,3,1,1,2,7,-5,2.8,8.0,-5.2,21,EL
37d0048f,5,350,3.9,4,0,1,0,10,4,6,6.1,6.5,-0.4,21,EL
37d39918,3,270,3.0,3,3,0,1,4,3,1,4.9,4.3,0.5,21,EL
37f606f0,4,189,2.1,2,0,2,0,7,0,7,4.5,1.6,2.9,21,EL
3814b753,4,263,2.9,3,2,1,0,1,4,-3,1.7,4.8,-3.1,21,EL
383e8f03,2,77,0.9,1,0,1,0,1,2,-1,1.2,2.3,-1.1,21,EL
387750b7,2,180,2.0,2,2,0,4,2,6,-4,2.9,4.4,-1.5,21,EL
390eb94b,6,454,5.0,6,1,0,0,4,9,-5,5.7,8.5,-2.8,21,EL
3925ee80,1,20,0.2,0,0,1,2,0,0,0,0.2,0.1,0.1,21,EL
3935e52e,4,360,4.0,4,4,0,0,13,3,10,10.0,3.3,6.7,21,EL
393a257c,2,153,1.7,2,1,0,1,0,3,-3,0.3,4.4,-4.2,21,EL
39769cff,2,179,2.0,2,1,0,0,1,4,-3,2.9,3.2,-0.4,21,EL
398dc4f4,5,407,4.5,5,3,0,0,5,9,-4,3.5,7.1,-3.6,21,EL
3a17d72b,2,3,0.0,0,0,2,3,0,0,0,0.0,0.0,0.0,21,EL
3a233281,8,508,5.6,6,2,2,0,17,11,6,12.1,7.6,4.5,21,EL
3a4e124d,6,268,3.0,3,1,3,0,3,8,-5,2.4,5.8,-3.4,21,EL
3a770838,10,810,9.0,10,4,0,0,16,13,3,15.9,14.4,1.5,21,EL
3a7e7259,3,270,3.0,3,3,0,0,3,4,-1,2.0,2.8,-0.9,21,EL
3add8ed8,1,11,0.1,0,0,1,1,0,0,0,0.1,0.0,0.1,21,EL
3b0108d6,1,90,1.0,1,1,0,9,2,0,2,1.6,0.6,1.0,21,EL
3b5cd50d,6,297,3.3,4,1,2,0,2,4,-2,5.8,5.3,0.6,21,EL
3bb7f478,10,565,6.3,6,1,4,3,12,10,2,13.1,11.6,1.5,21,EL
3c70fb81,5,398,4.4,5,4,0,1,7,8,-1,6.8,7.4,-0.5,21,EL
3c93b9f0,4,360,4.0,4,4,0,2,3,4,-1,2.9,5.0,-2.1,21,EL
3ca7254a,12,729,8.1,9,1,3,1,14,9,5,17.0,11.7,5.3,21,EL
3ce20eda,5,405,4.5,4,4,1,0,8,6,2,7.3,6.3,0.9,21,EL
3d214e5f,6,540,6.0,6,6,0,0,7,5,2,8.2,10.7,-2.5,21,EL
3d62c18b,3,262,2.9,3,2,0,1,1,4,-3,1.8,4.3,-2.5,21,EL
3d6691dd,1,71,0.8,1,0,0,3,1,1,0,1.4,0.4,1.0,21,EL
3d688b46,10,321,3.6,3,2,7,1,3,4,-1,3.8,5.3,-1.5,21,EL
3dab8efd,4,81,0.9,1,0,3,1,0,2,-2,0.5,2.2,-1.7,21,EL
3e6b69c2,6,533,5.9,6,5,0,0,7,12,-5,4.4,11.0,-6.6,21,EL
3e8c66c3,2,180,2.0,2,2,0,4,2,6,-4,1.9,3.6,-1.7,21,EL
3ea50f67,8,487,5.4,5,4,3,0,7,4,3,7.2,4.6,2.6,21,EL
3ead85f9,6,519,5.8,5,4,1,1,13,8,5,10.1,6.9,3.2,21,EL
3ec9f005,1,8,0.1,0,0,1,1,0,0,0,0.0,0.0,0.0,21,EL
3ee0dd59,7,477,5.3,5,5,2,1,4,3,1,9.8,4.3,5.4,21,EL
3f2587ee,1,9,0.1,0,0,1,4,0,0,0,0.5,0.0,0.5,21,EL
3f2d59fe,5,400,4.4,5,3,0,1,18,4,14,11.7,2.8,8.9,21,EL
3ff205d5,5,58,0.6,0,0,5,1,0,1,-1,0.2,1.6,-1.4,21,EL
4037db79,6,470,5.2,6,0,0,0,5,17,-12,3.5,17.0,-13.4,21,EL
403f5d20,8,622,6.9,7,6,1,0,14,12,2,10.2,7.6,2.6,21,EL
4044e8d8,6,344,3.8,4,0,2,0,7,6,1,5.5,5.2,0.3,21,EL
407feb71,8,393,4.4,4,1,4,1,6,6,0,5.6,4.6,1.0,21,EL
41034650,5,450,5.0,5,5,0,0,9,5,4,12.1,4.0,8.1,21,EL
41723204,6,219,2.4,1,1,5,0,5,2,3,4.3,2.6,1.8,21,EL
41f0b196,4,360,4.0,4,4,0,0,4,5,-1,4.9,6.3,-1.4,21,EL
4210aebe,2,17,0.2,0,0,2,4,0,2,-2,0.4,1.0,-0.6,21,EL
42eaa028,8,434,4.8,5,2,3,0,13,9,4,8.7,6.1,2.7,21,EL
42ec696a,6,540,6.0,6,6,0,0,3,8,-5,6.5,9.0,-2.5,21,EL
437f2b00,8,420,4.7,5,1,3,0,10,6,4,10.4,5.0,5.4,21,EL
4383b0da,5,280,3.1,4,0,1,0,3,9,-6,2.1,11.7,-9.6,21,EL
4398b5cb,6,495,5.5,6,5,0,0,5,13,-8,6.6,11.3,-4.7,21,EL
43c004a8,4,214,2.4,2,2,2,2,0,7,-7,1.5,4.3,-2.8,21,EL
43f71e77,11,618,6.9,6,3,5,1,7,5,2,8.2,7.2,1.0,21,EL
4468ec10,2,118,1.3,1,1,1,0,3,5,-2,3.1,3.1,0.0,21,EL
44781702,10,900,10.0,10,9,0,0,25,8,17,22.7,7.9,14.8,21,EL
44b49036,3,193,2.1,2,2,1,1,2,4,-2,4.8,2.4,2.4,21,EL
45191c29,1,15,0.2,0,0,1,2,1,0,1,0.1,0.1,0.0,21,EL
452c3055,7,271,3.0,3,0,4,0,2,2,0,3.1,3.1,0.0,21,EL
4567a0b4,4,198,2.2,2,1,2,2,3,5,-2,3.9,4.8,-0.9,21,EL
45963054,4,251,2.8,3,1,1,2,4,4,0,4.2,3.6,0.6,21,EL
45e17712,9,617,6.9,6,6,3,0,8,6,2,9.2,7.9,1.2,21,EL
45f5aa2f,1,60,0.7,1,0,0,0,1,1,0,0.5,1.1,-0.5,21,EL
46152b69,4,63,0.7,0,0,4,2,1,0,1,0.4,1.4,-1.0,21,EL
469be117,4,293,3.3,3,2,1,2,4,8,-4,1.0,7.8,-6.8,21,EL
46e58246,5,364,4.0,4,3,1,0,5,9,-4,5.7,8.0,-2.3,21,EL
46fcf2fb,5,132,1.5,0,0,5,1,1,3,-2,1.0,3.2,-2.2,21,EL
47064058,7,630,7.0,7,7,0,0,16,6,10,17.0,6.4,10.6,21,EL
4737cebe,7,400,4.4,5,1,2,1,4,6,-2,7.4,5.5,1.9,21,EL
474439fb,4,212,2.4,2,1,2,1,4,3,1,2.9,2.8,0.1,21,EL
4760b2f2,2,94,1.0,1,1,1,3,1,4,-3,1.2,2.3,-1.1,21,EL
47681787,1,6,0.1,0,0,1,1,0,0,0,0.0,0.1,-0.1,21,EL
47a0b54d,6,396,4.4,5,3,1,0,4,10,-6,5.0,8.9,-3.9,21,EL
47a34c4f,12,420,4.7,5,2,7,1,14,5,9,10.4,3.8,6.6,21,EL
47c1458c,7,540,6.0,5,5,2,3,8,12,-4,10.3,10.4,-0.1,21,EL
47c7a40c,5,450,5.0,5,5,0,1,6,13,-7,4.4,10.1,-5.7,21,EL
47dc80f5,6,389,4.3,5,1,1,0,11,9,2,7.5,6.4,1.1,21,EL
481c9ece,6,510,5.7,6,4,0,0,11,9,2,7.6,6.7,0.9,21,EL
48a2b92a,5,450,5.0,5,5,0,1,6,3,3,6.8,9.4,-2.6,21,EL
48a5a5d6,6,108,1.2,0,0,6,2,2,1,1,3.5,1.1,2.4,21,EL
48c81dd3,1,24,0.3,0,0,1,2,0,2,-2,0.0,1.8,-1.8,21,EL
492e9836,1,4,0.0,0,0,1,3,0,0,0,0.0,0.0,0.0,21,EL
49aa1724,5,266,3.0,2,2,3,1,5,10,-5,2.9,7.0,-4.2,21,EL
49e9d799,3,219,2.4,3,2,0,0,4,6,-2,2.6,4.2,-1.5,21,EL
4a1abff3,5,436,4.8,5,3,0,0,4,8,-4,2.3,8.1,-5.8,21,EL
4a56052c,8,440,4.9,6,2,2,1,12,2,10,7.6,5.5,2.1,21,EL
4a5a45c7,12,672,7.5,6,4,6,1,18,12,6,16.3,13.4,2.9,21,EL
4a97f4c2,6,208,2.3,2,0,4,2,2,2,0,2.7,2.5,0.1,21,EL
4a99131a,1,90,1.0,1,1,0,5,1,3,-2,1.2,3.3,-2.2,21,EL
4adc7b42,12,628,7.0,5,4,7,0,12,11,1,9.4,10.6,-1.2,21,EL
4b3c863f,1,1,0.0,0,0,1,5,0,0,0,0.0,0.0,0.0,21,EL
4b3e1a38,2,180,2.0,2,2,0,3,2,3,-1,3.3,1.7,1.6,21,EL
4b3f2936,2,84,0.9,1,0,1,4,0,3,-3,0.8,2.8,-1.9,21,EL
4b48d876,4,140,1.6,2,0,2,2,0,1,-1,0.9,2.1,-1.2,21,EL
4b803b3c,1,45,0.5,0,0,1,1,0,1,-1,0.2,0.8,-0.6,21,EL
4bce9c16,10,619,6.9,7,0,3,2,14,9,5,9.2,8.5,0.8,21,EL
4bd414c1,11,1020,11.3,11,11,0,2,23,7,16,18.1,9.4,8.7,21,EL
4c07f0e8,6,327,3.6,4,2,2,0,5,12,-7,3.6,10.8,-7.2,21,EL
4c0a6a48,2,25,0.3,0,0,2,3,0,0,0,0.4,0.1,0.4,21,EL
4c184730,6,145,1.6,0,0,6,0,5,3,2,5.8,2.0,3.7,21,EL
4c1b67d6,5,373,4.1,4,3,1,0,7,6,1,4.2,6.0,-1.8,21,EL
4c45cdc2,3,116,1.3,0,0,3,1,1,3,-2,0.8,2.6,-1.7,21,EL
4c5039bd,1,90,1.0,1,1,0,5,0,0,0,0.9,1.3,-0.4,21,EL
4c5e78da,8,226,2.5,2,0,6,2,6,6,0,3.5,5.5,-2.0,21,EL
4c6711e2,2,180,2.0,2,2,0,3,0,7,-7,0.8,4.3,-3.6,21,EL
4c700f46,6,406,4.5,5,4,1,1,7,5,2,8.4,6.2,2.2,21,EL
4c82730b,6,467,5.2,6,1,0,0,11,5,6,6.4,6.8,-0.4,21,EL
4cb950ea,6,402,4.5,5,2,1,0,5,11,-6,3.8,8.5,-4.7,21,EL
4cd69919,1,89,1.0,1,0,0,0,0,5,-5,0.3,3.9,-3.6,21,EL
4cde5509,5,241,2.7,3,0,2,1,3,3,0,3.6,3.1,0.4,21,EL
4d6a842d,10,900,10.0,10,10,0,0,16,17,-1,16.7,17.2,-0.5,21,EL
4d77b365,7,437,4.9,5,2,2,0,15,7,8,12.9,6.5,6.4,21,EL
4d90ce8c,1,9,0.1,0,0,1,4,0,0,0,0.5,0.0,0.5,21,EL
4da9191b,10,880,9.8,10,8,0,0,21,15,6,16.0,10.4,5.6,21,EL
4dedd469,4,310,3.4,4,1,0,0,6,5,1,5.0,4.0,1.0,21,EL
4e204552,1,13,0.1,0,0,1,2,1,0,1,0.5,0.1,0.4,21,EL
4e2da7f7,3,196,2.2,2,1,1,5,3,4,-1,3.0,4.1,-1.1,21,EL
4e358a2d,5,386,4.3,4,4,1,0,9,4,5,8.3,4.9,3.3,21,EL
4e3f5992,3,92,1.0,1,0,2,1,0,2,-2,0.2,0.7,-0.5,21,EL
4f1e6a0b,6,450,5.0,6,0,0,0,8,4,4,11.2,4.7,6.5,21,EL
4f5a953e,1,60,0.7,1,0,0,2,0,1,-1,0.1,0.6,-0.5,21,EL
4fac8f81,2,138,1.5,2,0,0,0,4,2,2,2.8,2.2,0.6,21,EL
501055d8,2,61,0.7,0,0,2,0,0,2,-2,0.7,1.4,-0.7,21,EL
507c7bdf,9,743,8.3,9,3,0,0,17,6,11,15.5,11.1,4.4,21,EL
5083a734,10,813,9.0,9,7,1,1,9,10,-1,9.2,11.2,-1.9,21,EL
50c1ff86,5,268,3.0,3,1,2,2,4,4,0,3.9,5.7,-1.8,21,EL
50ccf47d,3,194,2.2,3,0,0,0,2,6,-4,3.3,4.6,-1.3,21,EL
50cddd19,6,243,2.7,3,0,3,0,2,9,-7,2.8,5.0,-2.2,21,EL
50dc94ce,3,141,1.6,1,1,2,3,4,3,1,3.6,4.6,-1.1,21,EL
5136940a,1,58,0.6,1,0,0,0,1,0,1,0.6,0.1,0.5,21,EL
518918ad,4,182,2.0,1,0,3,1,3,5,-2,3.5,2.9,0.5,21,EL
518f2234,9,287,3.2,4,0,5,4,7,3,4,5.8,2.1,3.7,21,EL
51b41c5c,5,405,4.5,5,4,0,0,6,12,-6,5.5,6.2,-0.7,21,EL
520b18e0,1,1,0.0,0,0,1,1,0,0,0,0.0,0.0,0.0,21,EL
526541e5,5,436,4.8,5,4,0,0,1,5,-4,5.1,5.8,-0.7,21,EL
527f063d,5,367,4.1,4,2,1,0,11,5,6,9.5,7.3,2.2,21,EL
529f49ab,8,540,6.0,6,3,2,2,10,3,7,10.0,4.2,5.8,21,EL
52d7f819,7,554,6.2,6,6,1,0,10,10,0,8.7,11.9,-3.2,21,EL
532e1e4f,9,795,8.8,9,8,0,3,14,5,9,13.3,8.3,5.1,21,EL
536cebe5,5,262,2.9,3,0,2,1,6,2,4,4.4,3.3,1.2,21,EL
53af52f3,6,540,6.0,6,6,0,1,12,6,6,10.6,6.5,4.1,21,EL
53ccc8ad,8,648,7.2,8,6,0,0,8,9,-1,8.5,10.2,-1.7,21,EL
53d93280,3,270,3.0,3,3,0,0,4,5,-1,6.5,5.0,1.5,21,EL
540c9a17,6,421,4.7,5,2,1,0,9,10,-1,7.2,11.1,-3.9,21,EL
540ec57b,9,351,3.9,2,1,7,5,9,2,7,6.1,2.6,3.5,21,EL
54b4dc4e,5,445,4.9,5,4,0,2,14,10,4,10.0,6.8,3.3,21,EL
54bb5c3f,6,540,6.0,6,6,0,0,5,12,-7,6.3,10.6,-4.3,21,EL
54f5ce34,2,180,2.0,2,2,0,0,1,2,-1,1.8,1.4,0.4,21,EL
5521f419,1,45,0.5,0,0,1,1,1,3,-2,0.9,1.3,-0.4,21,EL
555031bc,3,30,0.3,0,0,3,1,0,0,0,0.2,0.7,-0.5,21,EL
555d5edd,8,490,5.4,6,2,2,0,20,12,8,13.1,6.1,7.0,21,EL
55a480e4,5,199,2.2,2,2,3,0,3,6,-3,1.6,5.3,-3.6,21,EL
55a88fd9,6,350,3.9,4,1,2,0,3,9,-6,3.3,7.2,-3.9,21,EL
55abe554,2,180,2.0,2,2,0,0,1,2,-1,1.8,1.4,0.4,21,EL
55b93ae0,1,90,1.0,1,1,0,5,0,3,-3,0.6,1.8,-1.2,21,EL
55bd7d45,5,450,5.0,5,5,0,0,6,16,-10,3.8,15.3,-11.5,21,EL
55c95c3e,6,466,5.2,5,4,1,0,5,10,-5,4.8,14.0,-9.2,21,EL
561b8eb8,7,588,6.5,7,4,0,0,8,10,-2,8.7,9.7,-1.0,21,EL
5631b735,5,444,4.9,5,4,0,0,5,11,-6,5.4,7.6,-2.2,21,EL
56413b1f,1,90,1.0,1,1,0,1,0,2,-2,1.1,1.9,-0.9,21,EL
56901a62,3,270,3.0,3,3,0,3,4,10,-6,2.7,7.5,-4.7,21,EL
56ad2519,5,375,4.2,4,4,1,1,5,6,-1,4.2,7.1,-2.9,21,EL
56dd5e10,6,364,4.0,3,3,3,0,4,9,-5,4.4,7.3,-2.9,21,EL
56f6f826,10,900,10.0,10,10,0,0,23,15,8,17.8,11.5,6.4,21,EL
56f7a928,7,537,6.0,6,3,1,0,12,4,8,10.4,4.9,5.5,21,EL
5700824a,6,451,5.0,6,3,0,0,4,6,-2,8.0,7.7,0.3,21,EL
57a0ea13,3,62,0.7,0,0,3,2,0,4,-4,0.4,1.7,-1.2,21,EL
57a46f3f,4,81,0.9,0,0,4,4,1,2,-1,1.2,1.4,-0.2,21,EL
57df4cea,6,535,5.9,6,5,0,0,8,5,3,10.7,7.6,3.1,21,EL
57e3f0c7,13,902,10.0,10,6,3,1,27,9,18,21.3,7.9,13.4,21,EL
58027adc,5,185,2.1,2,0,3,0,4,4,0,2.5,5.4,-2.9,21,EL
580bcd18,3,270,3.0,3,3,0,3,3,3,0,4.2,4.0,0.1,21,EL
5845bdfa,2,26,0.3,0,0,2,3,1,1,0,1.0,0.3,0.7,21,EL
58df8bfe,4,64,0.7,0,0,4,1,1,4,-3,0.5,1.4,-0.9,21,EL
58eee997,9,706,7.8,8,3,1,0,11,5,6,11.5,10.0,1.4,21,EL
58f077c0,11,1020,11.3,11,11,0,0,16,8,8,14.5,15.4,-0.9,21,EL
595ccab1,5,450,5.0,5,5,0,0,4,10,-6,2.3,9.6,-7.3,21,EL
596cc50e,7,550,6.1,6,6,1,3,11,10,1,8.4,11.4,-3.0,21,EL
59bf127b,7,463,5.1,5,4,2,1,7,2,5,10.6,6.7,3.9,21,EL
59fd245c,2,33,0.4,0,0,2,2,1,0,1,0.8,0.7,0.1,21,EL
5a48195c,1,12,0.1,0,0,1,1,0,0,0,0.7,0.3,0.4,21,EL
5a51caa1,1,6,0.1,0,0,1,3,0,1,-1,0.0,0.1,-0.1,21,EL
5a626448,11,273,3.0,1,0,10,1,9,3,6,7.3,2.3,5.0,21,EL
5a80aea3,6,358,4.0,6,0,0,0,6,9,-3,4.9,8.2,-3.2,21,EL
5a9dab86,2,71,0.8,1,0,1,0,1,3,-2,0.2,1.1,-0.9,21,EL
5aa53281,7,585,6.5,6,6,1,0,16,6,10,14.5,8.8,5.7,21,EL
5acc4a10,8,721,8.0,8,5,0,0,14,4,10,12.2,7.1,5.2,21,EL
5ad141cb,5,450,5.0,5,5,0,0,8,11,-3,5.2,9.9,-4.6,21,EL
5ad50391,10,880,9.8,10,9,0,0,14,6,8,13.9,11.8,2.1,21,EL
5b3d1a7a,7,567,6.3,7,3,0,0,11,11,0,10.2,10.7,-0.5,21,EL
5b479568,4,190,2.1,2,0,2,0,1,2,-1,1.9,6.2,-4.3,21,EL
5b5c2228,5,338,3.8,4,3,1,0,9,4,5,6.7,6.0,0.7,21,EL
5bc43860,2,119,1.3,2,0,0,0,1,2,-1,2.2,1.9,0.3,21,EL
5c0466ba,1,2,0.0,0,0,1,0,0,0,0,0.0,0.0,0.0,21,EL
5c2b4f07,4,251,2.8,3,1,1,2,3,6,-3,3.9,3.5,0.4,21,EL
5c4f0f49,2,179,2.0,2,1,0,0,1,7,-6,1.2,6.7,-5.5,21,EL
5c6337cd,1,89,1.0,1,0,0,3,0,5,-5,0.3,3.9,-3.6,21,EL
5c7845f6,4,360,4.0,4,4,0,2,3,7,-4,7.2,5.5,1.7,21,EL
5ca20b7a,4,273,3.0,4,1,0,0,0,5,-5,4.8,4.9,0.0,21,EL
5caa62a7,4,244,2.7,3,0,1,0,4,5,-1,1.8,3.8,-2.1,21,EL
5cdddffa,7,313,3.5,3,0,4,2,8,3,5,8.8,1.8,7.0,21,EL
5ce0b5ba,1,72,0.8,1,0,0,0,0,3,-3,0.6,2.3,-1.7,21,EL
5ce91d9b,6,368,4.1,5,0,1,0,3,7,-4,3.3,6.8,-3.5,21,EL
5cec2c74,4,360,4.0,4,4,0,0,4,5,-1,6.0,5.2,0.8,21,EL
5d4f7d61,5,337,3.7,5,2,0,0,9,8,1,10.0,4.8,5.3,21,EL
5d51b074,10,508,5.6,6,0,4,0,7,11,-4,7.4,10.0,-2.6,21,EL
5da33b33,2,135,1.5,1,1,1,0,1,3,-2,1.8,1.2,0.6,21,EL
5db295be,8,481,5.3,5,0,3,0,6,6,0,7.7,5.7,2.0,21,EL
5db45ee5,2,134,1.5,2,0,0,3,4,0,4,3.1,0.6,2.5,21,EL
5e1028e5,2,25,0.3,0,0,2,6,1,0,1,0.6,0.6,0.1,21,EL
5e74d6c8,4,116,1.3,0,0,4,5,2,4,-2,1.1,3.6,-2.5,21,EL
5e861944,8,489,5.4,7,1,1,0,7,7,0,9.3,6.9,2.4,21,EL
5e8936be,8,720,8.0,8,8,0,0,12,7,5,8.3,10.9,-2.7,21,EL
5eaf85b5,2,174,1.9,2,1,0,0,3,4,-1,1.9,2.9,-1.0,21,EL
5eb77bef,5,360,4.0,4,2,1,0,7,10,-3,5.0,8.6,-3.6,21,EL
5eebbfdf,9,670,7.4,9,3,0,1,8,6,2,7.0,7.6,-0.6,21,EL
5f011e05,9,691,7.7,9,5,0,0,13,12,1,12.9,12.7,0.2,21,EL
5f06ae82,4,336,3.7,4,1,0,2,6,6,0,4.3,8.7,-4.4,21,EL
5f3d00d1,7,316,3.5,4,1,3,1,7,5,2,4.3,4.2,0.2,21,EL
60097ff6,3,126,1.4,0,0,3,5,5,4,1,3.8,2.2,1.6,21,EL
601299e9,4,145,1.6,1,1,3,1,0,1,-1,2.4,1.8,0.6,21,EL
603cb947,4,140,1.6,0,0,4,0,3,2,1,3.5,1.9,1.7,21,EL
605fe3e6,1,6,0.1,0,0,1,1,0,0,0,0.1,0.0,0.1,21,EL
60a6fe9c,6,539,6.0,6,5,0,0,4,8,-4,4.9,7.7,-2.8,21,EL
60c07b31,3,261,2.9,3,2,0,0,6,4,2,2.8,3.4,-0.6,21,EL
60db2f9b,6,422,4.7,5,0,1,0,3,5,-2,3.5,5.0,-1.5,21,EL
611f4f60,1,81,0.9,1,0,0,3,1,1,0,1.2,0.9,0.4,21,EL
614c1695,5,207,2.3,3,0,2,0,3,1,2,2.6,3.3,-0.7,21,EL
614f69aa,5,450,5.0,5,5,0,1,7,5,2,6.8,6.1,0.7,21,EL
61590953,4,287,3.2,4,2,0,1,5,9,-4,3.8,5.5,-1.7,21,EL
615c4d8f,6,275,3.1,4,0,2,4,4,2,2,5.3,5.8,-0.5,21,EL
61db425b,1,90,1.0,1,1,0,0,1,2,-1,0.6,2.5,-1.9,21,EL
6200dc3c,3,130,1.4,2,0,1,0,0,1,-1,1.7,1.0,0.7,21,EL
625c144a,13,1200,13.3,13,13,0,0,26,9,17,23.0,10.9,12.1,21,EL
62d0dcc5,5,250,2.8,2,1,3,1,5,13,-8,2.9,8.3,-5.4,21,EL
62f94e47,3,79,0.9,0,0,3,2,2,0,2,2.0,0.4,1.6,21,EL
63458a96,1,90,1.0,1,1,0,1,0,1,-1,0.2,1.6,-1.3,21,EL
639ea276,2,2,0.0,0,0,2,4,0,0,0,0.0,0.0,0.0,21,EL
63f04c6c,12,911,10.1,10,5,2,2,18,6,12,15.5,9.1,6.4,21,EL
647cf7f1,6,354,3.9,5,0,1,0,4,8,-4,2.6,8.0,-5.4,21,EL
64e8ed6d,13,661,7.3,7,3,6,1,18,7,11,14.3,6.9,7.3,21,EL
653010fb,3,24,0.3,0,0,3,3,0,0,0,0.2,0.1,0.0,21,EL
6554bb97,5,295,3.3,3,2,2,0,4,11,-7,2.3,7.1,-4.8,21,EL
655d956b,3,108,1.2,1,0,2,3,1,1,0,0.8,1.5,-0.7,21,EL
6583a8a9,2,155,1.7,2,0,0,4,2,0,2,2.0,0.8,1.2,21,EL
65ad4d98,6,528,5.9,6,5,0,0,3,8,-5,5.8,8.7,-2.9,21,EL
6603fed7,7,426,4.7,5,1,2,0,13,6,7,7.7,7.5,0.2,21,EL
660e71be,1,8,0.1,0,0,1,4,0,1,-1,0.0,0.1,-0.1,21,EL
66a7effe,12,398,4.4,4,0,8,0,7,9,-2,4.6,8.9,-4.3,21,EL
675b0427,2,180,2.0,2,2,0,0,2,4,-2,2.0,2.7,-0.7,21,EL
67669ce7,1,90,1.0,1,1,0,11,0,0,0,1.3,0.9,0.4,21,EL
6796e284,4,158,1.8,2,0,2,2,3,2,1,3.3,1.0,2.3,21,EL
67ac5bb8,6,540,6.0,6,6,0,5,10,7,3,10.0,5.6,4.4,21,EL
67f0703d,2,98,1.1,1,1,1,0,1,1,0,0.5,0.9,-0.4,21,EL
6800f515,6,540,6.0,6,6,0,0,10,19,-9,6.1,11.1,-5.0,21,EL
68dc0dac,5,373,4.1,4,3,1,0,7,11,-4,3.9,8.0,-4.0,21,EL
691bef82,3,244,2.7,3,2,0,0,6,2,4,7.2,3.2,4.0,21,EL
692cd6de,5,405,4.5,5,4,0,1,10,11,-1,6.6,9.2,-2.5,21,EL
69374ff5,5,332,3.7,4,3,1,1,12,5,7,8.0,3.5,4.5,21,EL
6959bef9,3,30,0.3,0,0,3,1,0,1,-1,0.8,0.7,0.1,21,EL
697dc00a,11,431,4.8,3,2,8,0,7,1,6,6.7,4.4,2.3,21,EL
6a2b9aee,2,56,0.6,0,0,2,0,0,1,-1,1.1,0.9,0.1,21,EL
6a73afe7,1,1,0.0,0,0,1,5,0,2,-2,0.0,1.6,-1.6,21,EL
6a827d8e,4,154,1.7,2,0,2,0,4,4,0,3.2,2.2,1.0,21,EL
6a829019,4,329,3.7,4,2,0,0,5,6,-1,4.4,8.2,-3.8,21,EL
6aa3e78b,5,247,2.7,3,1,2,2,5,2,3,4.9,3.5,1.4,21,EL
6b074beb,6,132,1.5,1,0,5,0,3,5,-2,4.0,2.2,1.8,21,EL
6b3e4b53,1,17,0.2,0,0,1,2,1,0,1,0.2,0.0,0.2,21,EL
6b47c5db,4,297,3.3,4,2,0,0,2,2,0,1.9,2.0,-0.1,21,EL
6b4e77fe,1,2,0.0,0,0,1,5,0,0,0,0.0,0.0,0.0,21,EL
6b6c793c,3,258,2.9,3,2,0,2,3,4,-1,3.7,3.3,0.4,21,EL
6b6cbca4,1,90,1.0,1,1,0,3,2,0,2,0.4,0.3,0.1,21,EL
6b88c810,4,72,0.8,1,0,3,0,1,1,0,1.4,0.5,0.9,21,EL
6b8cd7dd,5,450,5.0,5,5,0,1,4,10,-6,5.9,9.0,-3.1,21,EL
6b915aa1,2,161,1.8,2,1,0,2,1,3,-2,0.7,1.0,-0.3,21,EL
6b994195,10,921,10.2,10,9,0,0,16,8,8,14.0,13.5,0.5,21,EL
6c249ea7,4,308,3.4,4,2,0,0,6,5,1,3.2,4.0,-0.8,21,EL
6c330f30,3,225,2.5,2,2,1,7,2,4,-2,2.8,3.5,-0.8,21,EL
6c7762c3,12,901,10.0,10,6,2,0,21,7,14,18.2,6.7,11.5,21,EL
6ca0b04a,2,166,1.8,2,1,0,6,3,4,-1,1.0,4.7,-3.7,21,EL
6cafd68d,4,255,2.8,2,2,2,0,6,1,5,6.1,1.4,4.8,21,EL
6cbf8d0d,4,189,2.1,2,0,2,4,2,5,-3,2.8,5.0,-2.2,21,EL
6ce46a59,2,104,1.2,1,1,1,0,2,7,-5,2.4,4.8,-2.4,21,EL
6d86d9cd,5,390,4.3,4,3,1,0,4,8,-4,2.2,7.6,-5.5,21,EL
6e36226f,1,10,0.1,0,0,1,4,0,0,0,0.1,0.1,0.0,21,EL
6e5497ca,5,343,3.8,4,3,1,0,6,12,-6,5.6,7.7,-2.1,21,EL
6ea23758,5,353,3.9,4,3,1,1,10,10,0,6.8,6.8,-0.1,21,EL
6ec6fde0,4,330,3.7,4,3,0,1,13,2,11,8.0,4.3,3.7,21,EL
6f5f82c0,6,300,3.3,3,1,3,0,4,3,1,6.1,3.2,3.0,21,EL
6fa81fa5,1,4,0.0,0,0,1,0,0,0,0,0.0,1.0,-0.9,21,EL
6fa87bf4,3,99,1.1,1,0,2,3,3,0,3,1.4,1.5,-0.1,21,EL
6fd8a334,8,612,6.8,7,6,1,0,20,12,8,16.0,8.6,7.4,21,EL
6fe2aba3,3,270,3.0,3,3,0,1,2,9,-7,5.3,5.8,-0.6,21,EL
6fe5c35b,6,540,6.0,6,6,0,0,11,12,-1,9.0,10.4,-1.3,21,EL
701a15f5,1,9,0.1,0,0,1,0,0,0,0,0.1,0.0,0.1,21,EL
705f5269,5,450,5.0,5,5,0,1,7,12,-5,6.9,8.4,-1.5,21,EL
706a60e1,4,161,1.8,2,1,2,1,3,7,-4,2.9,3.9,-1.1,21,EL
70cb75ae,7,498,5.5,6,3,1,1,6,12,-6,6.2,9.2,-3.0,21,EL
70cf63ca,8,508,5.6,4,3,4,0,17,10,7,11.4,7.9,3.5,21,EL
7120a04d,4,208,2.3,2,0,2,0,3,4,-1,3.4,3.9,-0.5,21,EL
712dd708,10,849,9.4,10,8,0,0,22,15,7,17.2,11.0,6.2,21,EL
713c144a,6,531,5.9,6,5,0,0,4,8,-4,9.0,9.4,-0.5,21,EL
715e5b0e,4,190,2.1,1,0,3,0,4,2,2,2.3,2.6,-0.3,21,EL
719384c1,8,553,6.1,6,3,2,0,7,8,-1,6.0,8.0,-2.0,21,EL
7220ffd7,3,194,2.2,2,1,1,0,3,2,1,2.9,3.0,-0.1,21,EL
7272a72a,3,231,2.6,3,0,0,1,2,3,-1,3.2,3.8,-0.6,21,EL
73000a79,4,252,2.8,3,2,1,4,6,6,0,6.9,4.6,2.4,21,EL
7314bba4,4,360,4.0,4,4,0,1,7,11,-4,4.1,6.8,-2.7,21,EL
731bf16a,4,360,4.0,4,4,0,2,4,9,-5,3.8,8.3,-4.5,21,EL
734b6a70,6,329,3.7,3,3,3,0,5,8,-3,4.2,5.6,-1.4,21,EL
736157b7,5,447,5.0,5,3,0,0,4,8,-4,4.7,7.5,-2.7,21,EL
73affbb6,2,55,0.6,0,0,2,2,0,0,0,0.2,0.7,-0.5,21,EL
73ddc40c,2,101,1.1,1,1,1,3,1,0,1,0.7,1.5,-0.8,21,EL
740a0e28,5,405,4.5,5,4,0,1,3,12,-9,6.2,7.0,-0.8,21,EL
741418c3,6,362,4.0,4,2,2,0,6,10,-4,5.0,6.0,-1.0,21,EL
742a4995,6,432,4.8,5,2,1,0,1,13,-12,7.0,8.3,-1.2,21,EL
742ea558,1,9,0.1,0,0,1,3,0,1,-1,0.1,0.5,-0.4,21,EL
74510b8f,3,263,2.9,3,0,0,1,5,6,-1,3.1,4.9,-1.8,21,EL
7460ca0d,12,941,10.5,10,7,2,0,17,4,13,14.6,8.6,6.0,21,EL
746b64a7,7,630,7.0,7,7,0,0,11,6,5,6.9,8.7,-1.8,21,EL
7483d9f9,1,90,1.0,1,1,0,0,1,2,-1,1.9,1.2,0.7,21,EL
74f2e748,7,556,6.199999999999999,7,5,0,1,11,19,-8,8.6,11.1,-2.5,21,EL
7566531d,8,592,6.6,7,5,1,0,5,7,-2,6.7,7.1,-0.5,21,EL
75a72a99,2,75,0.8,1,0,1,0,0,1,-1,0.6,0.4,0.2,21,EL
75dd7eeb,2,71,0.8,0,0,2,6,0,3,-3,0.0,1.2,-1.2,21,EL
76847418,3,124,1.4,1,0,2,1,3,6,-3,4.7,4.1,0.6,21,EL
76d5857d,2,159,1.8,2,1,0,0,2,4,-2,1.8,2.7,-0.9,21,EL
76d679c7,4,283,3.1,3,3,1,4,2,1,1,7.7,2.0,5.7,21,EL
76fa5f80,1,13,0.1,0,0,1,3,0,0,0,0.0,0.0,0.0,21,EL
770d7eb8,4,255,2.8,3,1,1,0,4,7,-3,2.1,3.4,-1.3,21,EL
77bf714c,8,406,4.5,5,2,3,0,7,4,3,8.9,4.7,4.2,21,EL
781cff03,5,145,1.6,1,0,4,0,1,6,-5,1.9,3.0,-1.2,21,EL
786f179e,6,322,3.6,3,2,3,0,1,4,-3,1.7,4.0,-2.3,21,EL
78a3c38e,6,491,5.5,6,4,0,0,7,4,3,7.1,9.5,-2.3,21,EL
78e68b4d,8,623,6.9,7,4,1,1,15,9,6,11.5,8.5,3.0,21,EL
78f21137,6,495,5.5,6,5,0,0,6,5,1,3.5,6.3,-2.8,21,EL
79083382,6,419,4.7,4,3,2,0,9,5,4,8.9,4.8,4.1,21,EL
79135368,5,450,5.0,5,5,0,0,6,9,-3,4.7,7.4,-2.6,21,EL
79194648,2,17,0.2,0,0,2,2,0,0,0,0.6,0.1,0.5,21,EL
792c7b94,4,355,3.9,4,3,0,1,7,10,-3,6.2,6.9,-0.8,21,EL
79300479,6,420,4.7,5,0,1,0,6,6,0,6.5,3.9,2.6,21,EL
79370f8c,6,162,1.8,1,1,5,0,2,3,-1,2.0,3.3,-1.3,21,EL
7952d0c2,6,372,4.1,5,0,1,0,6,2,4,4.7,6.9,-2.3,21,EL
79c536d7,6,540,6.0,6,6,0,0,7,14,-7,7.8,12.1,-4.4,21,EL
79c90e45,2,134,1.5,1,0,1,0,2,4,-2,4.6,1.9,2.6,21,EL
7a2cf111,5,429,4.8,5,4,0,2,10,8,2,7.5,7.6,0.0,21,EL
7a4cea18,3,157,1.7,3,0,0,0,3,5,-2,1.3,1.9,-0.5,21,EL
7b075c75,2,103,1.1,1,1,1,3,2,2,0,2.3,1.0,1.3,21,EL
7b41edb2,3,260,2.9,3,2,0,1,3,1,2,4.0,3.8,0.2,21,EL
7b57c56a,6,537,6.0,6,5,0,0,7,5,2,8.2,10.6,-2.4,21,EL
7ba6d84e,5,480,5.3,5,5,0,3,13,6,7,10.5,8.1,2.4,21,EL
7bc34048,5,375,4.2,5,3,0,0,6,2,4,6.7,4.9,1.7,21,EL
7be09c86,3,165,1.8,1,1,2,1,3,7,-4,1.4,5.0,-3.7,21,EL
7bf8ad6c,6,211,2.3,1,0,5,0,4,8,-4,2.9,5.7,-2.8,21,EL
7c1a0c67,2,113,1.3,2,0,0,0,0,0,0,1.9,0.6,1.2,21,EL
7c2965bb,4,227,2.5,3,1,1,2,3,8,-5,3.5,3.6,-0.1,21,EL
7c4cb72d,6,538,6.0,6,4,0,0,4,13,-9,5.0,11.4,-6.3,21,EL
7c7fdb0f,5,450,5.0,5,5,0,1,10,11,-1,7.0,10.0,-3.0,21,EL
7c85e03f,5,325,3.6,4,2,1,0,4,7,-3,2.3,5.3,-3.0,21,EL
7c9fa389,5,393,4.4,4,4,1,0,3,8,-5,3.8,5.7,-1.8,21,EL
7cb9de24,6,540,6.0,6,6,0,0,7,19,-12,5.0,18.6,-13.7,21,EL
7cd78926,3,270,3.0,3,3,0,1,5,9,-4,3.0,7.8,-4.9,21,EL
7d2d3329,8,439,4.9,5,3,3,0,9,6,3,8.9,6.1,2.8,21,EL
7d9397f8,3,204,2.3,2,2,1,3,1,1,0,2.7,2.1,0.6,21,EL
7dc7187e,2,32,0.4,0,0,2,4,0,1,-1,0.9,1.3,-0.4,21,EL
7e1c86f1,4,204,2.3,2,2,2,2,1,5,-4,1.4,3.9,-2.5,21,EL
7e40455a,6,540,6.0,6,6,0,0,7,15,-8,7.5,10.2,-2.7,21,EL
7e56d3db,6,510,5.7,6,4,0,0,6,7,-1,4.9,7.7,-2.8,21,EL
7ebfac0f,4,200,2.2,3,0,1,1,2,3,-1,1.0,3.1,-2.2,21,EL
7ec1955f,4,240,2.7,3,1,1,2,4,7,-3,1.3,4.0,-2.7,21,EL
7ecc9dee,4,262,2.9,2,1,2,2,1,7,-6,3.4,5.6,-2.3,21,EL
7edfbb8a,4,360,4.0,4,4,0,0,4,5,-1,6.0,5.2,0.8,21,EL
7ef972c3,2,180,2.0,2,2,0,3,4,6,-2,2.3,4.3,-2.0,21,EL
7f40333d,5,450,5.0,5,5,0,1,8,3,5,11.0,4.4,6.6,21,EL
7f609bfc,3,216,2.4,3,1,0,1,7,0,7,4.7,2.4,2.3,21,EL
7f63620c,2,82,0.9,1,0,1,3,0,0,0,0.3,1.1,-0.8,21,EL
7f73bdf4,5,403,4.5,5,3,0,1,2,12,-10,5.3,6.8,-1.5,21,EL
801831fe,2,80,0.9,1,0,1,4,1,0,1,0.5,0.9,-0.4,21,EL
8023bcab,3,80,0.9,0,0,3,1,0,2,-2,1.5,2.1,-0.6,21,EL
808d48f3,8,399,4.4,5,0,3,6,7,4,3,6.2,3.0,3.2,21,EL
808df563,4,95,1.1,1,0,3,1,1,1,0,1.7,1.1,0.6,21,EL
80c31c97,5,193,2.1,2,1,3,1,4,1,3,3.8,2.0,1.7,21,EL
80f36c88,7,513,5.7,7,3,0,0,9,5,4,13.3,4.7,8.6,21,EL
816bdfdd,6,536,6.0,6,5,0,0,6,11,-5,6.0,15.5,-9.4,21,EL
817c6964,10,667,7.4,9,4,1,0,13,9,4,9.9,8.2,1.6,21,EL
819aa8e7,4,85,0.9,0,0,4,2,3,1,2,2.8,0.7,2.0,21,EL
81d5c497,5,168,1.9,1,1,4,7,3,0,3,3.0,0.9,2.1,21,EL
81f0781e,12,879,9.8,9,5,3,0,15,4,11,13.6,8.6,5.0,21,EL
821770dd,6,377,4.2,4,1,2,0,6,9,-3,5.6,8.7,-3.1,21,EL
82220b03,7,411,4.6,5,1,2,0,4,6,-2,6.1,4.7,1.4,21,EL
826e8b63,8,675,7.5,8,7,0,0,13,14,-1,10.1,7.7,2.4,21,EL
829ae874,6,455,5.1,6,4,0,0,6,10,-4,4.7,7.8,-3.0,21,EL
82a8d4cc,4,151,1.7,1,0,3,3,2,1,1,0.7,2.6,-1.9,21,EL
82b1198a,3,270,3.0,3,3,0,3,3,2,1,3.2,6.0,-2.8,21,EL
82e9b1bb,7,550,6.1,6,6,1,0,13,12,1,9.2,5.5,3.8,21,EL
82efe6fa,9,574,6.4,8,4,1,2,13,11,2,11.2,11.7,-0.5,21,EL
83300259,6,540,6.0,6,6,0,0,7,5,2,8.2,10.7,-2.5,21,EL
834d0be5,5,214,2.4,3,0,2,1,7,4,3,2.8,2.0,0.8,21,EL
83534f30,6,381,4.2,4,2,2,0,2,8,-6,6.9,6.7,0.2,21,EL
839c14e1,9,613,6.8,7,5,2,5,18,6,12,15.3,6.3,9.1,21,EL
84a42351,5,386,4.3,5,1,0,0,4,9,-5,4.0,9.9,-5.8,21,EL
84e5adcd,6,523,5.8,6,5,0,0,3,7,-4,5.5,9.2,-3.7,21,EL
852184c3,7,354,3.9,3,1,4,1,3,6,-3,3.2,6.2,-3.0,21,EL
852351df,13,962,10.7,9,7,4,0,22,15,7,20.6,16.0,4.6,21,EL
8530dd74,6,521,5.8,6,3,0,0,5,11,-6,5.6,10.8,-5.2,21,EL
85686f86,2,30,0.3,0,0,2,0,0,1,-1,0.1,1.2,-1.0,21,EL
857c7688,1,81,0.9,1,0,0,2,0,1,-1,0.8,0.7,0.1,21,EL
85c76f0a,1,14,0.2,0,0,1,4,1,1,0,0.0,0.7,-0.6,21,EL
85f7d1be,4,261,2.9,3,2,1,6,4,3,1,3.1,3.7,-0.6,21,EL
8614496d,6,540,6.0,6,6,0,0,5,12,-7,6.3,10.6,-4.3,21,EL
864c362f,1,90,1.0,1,1,0,10,1,0,1,1.0,0.0,1.0,21,EL
86695068,6,356,4.0,4,2,2,0,8,2,6,6.6,2.9,3.7,21,EL
867239d3,6,429,4.8,5,1,1,0,11,5,6,8.3,7.8,0.5,21,EL
86878265,4,327,3.6,4,3,0,2,8,5,3,7.0,4.8,2.2,21,EL
86b3d4cc,3,270,3.0,3,3,0,2,4,4,0,4.1,4.9,-0.8,21,EL
86b575a7,5,384,4.3,4,2,1,0,9,11,-2,5.8,4.3,1.5,21,EL
871961e8,5,332,3.7,4,0,1,1,5,13,-8,3.2,11.0,-7.8,21,EL
878f0921,2,120,1.3,2,0,0,0,0,2,-2,0.5,1.2,-0.8,21,EL
881fb89d,3,154,1.7,1,0,2,3,2,6,-4,2.7,4.1,-1.5,21,EL
886f9aac,4,205,2.3,3,0,1,0,2,2,0,2.3,2.9,-0.6,21,EL
88968486,4,360,4.0,4,4,0,0,2,5,-3,2.3,5.2,-2.9,21,EL
88a9ea33,5,402,4.5,5,2,0,0,6,11,-5,6.2,6.8,-0.6,21,EL
88c89891,1,22,0.2,0,0,1,6,1,0,1,0.6,0.1,0.5,21,EL
8960cf3d,3,176,2.0,3,0,0,3,1,3,-2,1.9,3.3,-1.3,21,EL
89b2c8a9,7,396,4.4,4,2,3,0,5,3,2,9.0,5.9,3.1,21,EL
89c63f8c,5,450,5.0,5,5,0,0,4,10,-6,2.3,9.6,-7.3,21,EL
89cbc961,6,406,4.5,4,4,2,7,10,1,9,7.7,2.0,5.6,21,EL
8a2248b4,5,450,5.0,5,5,0,1,8,15,-7,6.4,8.5,-2.2,21,EL
8a6e0e81,6,509,5.7,6,4,0,0,4,8,-4,8.8,8.6,0.2,21,EL
8a7a5ad7,3,270,3.0,3,3,0,0,1,8,-7,1.6,5.2,-3.7,21,EL
8b04d6c1,7,303,3.4,2,1,5,0,9,4,5,7.7,3.4,4.3,21,EL
8b0b02c9,2,64,0.7,1,0,1,3,2,3,-1,1.5,1.2,0.3,21,EL
8b3ab7ad,6,518,5.8,6,5,0,0,11,4,7,15.3,4.3,11.0,21,EL
8b3d765f,1,90,1.0,1,1,0,1,2,3,-1,1.5,2.2,-0.7,21,EL
8b529245,9,545,6.1,5,3,4,0,14,4,10,14.1,3.9,10.2,21,EL
8b788c01,3,158,1.8,2,1,1,0,1,0,1,2.1,1.7,0.4,21,EL
8b8a56ce,7,550,6.1,7,6,0,2,8,8,0,7.1,5.7,1.4,21,EL
8b929ec2,11,1020,11.3,11,11,0,0,14,7,7,12.5,14.0,-1.6,21,EL
8b92fc98,1,76,0.8,1,0,0,5,1,4,-3,1.5,2.5,-1.0,21,EL
8b9b8e43,5,437,4.9,5,4,0,0,5,11,-6,6.7,9.0,-2.4,21,EL
8b9ebd03,9,312,3.5,3,0,6,1,7,2,5,5.8,2.0,3.9,21,EL
8bbe2df5,7,514,5.7,6,4,1,1,12,11,1,11.8,7.8,4.0,21,EL
8c3c640c,7,549,6.1,7,0,0,0,3,6,-3,11.9,6.7,5.2,21,EL
8c90fd7a,3,184,2.0,2,1,1,0,0,3,-3,1.8,2.4,-0.6,21,EL
8c955557,3,41,0.5,0,0,3,2,0,1,-1,0.1,1.0,-0.9,21,EL
8ca0559d,6,227,2.5,3,0,3,1,0,4,-4,1.5,3.4,-1.9,21,EL
8ca850b8,6,438,4.9,5,3,1,0,3,6,-3,5.3,7.6,-2.3,21,EL
8cc9ef90,1,90,1.0,1,1,0,5,1,1,0,0.9,1.2,-0.2,21,EL
8cd7091d,5,357,4.0,4,3,1,0,9,5,4,6.8,5.6,1.1,21,EL
8ce30c57,2,180,2.0,2,2,0,0,1,2,-1,1.8,1.4,0.4,21,EL
8d47bb39,10,742,8.2,9,5,1,0,9,6,3,8.6,7.5,1.1,21,EL
8d711616,3,102,1.1,1,0,2,3,0,2,-2,1.0,3.5,-2.6,21,EL
8d7fe72a,4,301,3.3,4,1,0,1,4,9,-5,2.8,8.7,-6.0,21,EL
8d965034,7,368,4.1,5,0,2,0,2,7,-5,3.3,6.1,-2.8,21,EL
8dfed6e9,5,153,1.7,1,0,4,1,2,2,0,1.5,1.9,-0.4,21,EL
8e16dd48,1,19,0.2,0,0,1,0,0,0,0,0.2,0.2,0.0,21,EL
8e371868,4,277,3.1,3,2,1,2,3,8,-5,3.8,5.6,-1.8,21,EL
8e48dc61,5,345,3.8,4,2,1,3,1,3,-2,9.1,3.2,5.9,21,EL
8e697a8f,5,192,2.1,1,1,4,1,3,6,-3,2.4,3.4,-1.0,21,EL
8e92be30,8,465,5.2,7,0,1,0,2,5,-3,10.4,6.4,4.0,21,EL
8ec4c2f7,5,445,4.9,5,4,0,0,7,6,1,4.8,7.3,-2.4,21,EL
8ee7161d,4,360,4.0,4,4,0,1,3,2,1,4.1,5.4,-1.3,21,EL
8eec784d,6,278,3.1,3,1,3,2,6,6,0,4.1,5.7,-1.6,21,EL
8f1d4155,3,270,3.0,3,3,0,2,1,8,-7,2.6,5.6,-3.0,21,EL
8f21b7bd,10,723,8.0,8,6,2,1,8,9,-1,7.1,8.4,-1.2,21,EL
8f5bfaac,8,214,2.4,1,0,7,1,4,3,1,2.3,4.9,-2.5,21,EL
8f62b6ee,4,390,4.3,4,4,0,3,6,5,1,6.4,5.2,1.2,21,EL
8f68aa41,6,540,6.0,6,6,0,0,3,7,-4,5.5,9.8,-4.2,21,EL
8f7e6783,6,495,5.5,6,4,0,0,7,4,3,7.1,9.5,-2.4,21,EL
8fa8f8d2,4,360,4.0,4,4,0,2,14,3,11,9.9,3.2,6.7,21,EL
8fef5412,2,113,1.3,1,1,1,3,1,0,1,0.9,1.5,-0.6,21,EL
8ff4872e,5,295,3.3,4,2,1,1,2,11,-9,1.4,12.3,-11.0,21,EL
903b6e8b,4,360,4.0,4,4,0,0,7,7,0,3.7,5.2,-1.6,21,EL
906baf89,4,203,2.3,2,0,2,1,3,4,-1,3.0,4.0,-1.0,21,EL
908eea67,4,304,3.4,3,2,1,0,5,5,0,4.0,5.4,-1.4,21,EL
90d7dda6,7,534,5.9,6,5,1,0,9,4,5,6.2,7.2,-1.0,21,EL
90f87966,6,495,5.5,6,5,0,1,13,9,4,8.5,6.3,2.2,21,EL
913329c8,1,26,0.3,0,0,1,4,1,0,1,0.3,0.0,0.3,21,EL
9139bb12,4,239,2.7,3,0,1,0,1,4,-3,2.4,4.8,-2.5,21,EL
91f2da4c,4,146,1.6,2,0,2,1,2,2,0,1.7,1.0,0.7,21,EL
91f8302e,6,364,4.0,6,1,0,1,5,5,0,5.5,4.7,0.8,21,EL
92560306,4,227,2.5,3,1,1,0,1,8,-7,2.6,5.4,-2.8,21,EL
926314b9,3,206,2.3,2,1,1,0,6,6,0,3.9,5.2,-1.4,21,EL
92b17b2a,5,365,4.1,4,2,1,0,7,6,1,4.5,6.9,-2.4,21,EL
92e7e919,7,326,3.6,3,0,4,2,9,1,8,7.0,3.6,3.4,21,EL
92ffb8f9,8,394,4.4,4,2,4,0,5,8,-3,5.7,7.4,-1.7,21,EL
93090f69,9,684,7.6,8,7,1,1,10,7,3,7.9,9.2,-1.3,21,EL
9321b8ed,3,270,3.0,3,3,0,5,7,6,1,8.0,4.6,3.4,21,EL
93a50d2c,4,281,3.1,3,2,1,1,9,4,5,8.7,3.3,5.4,21,EL
93b95f72,6,540,6.0,6,6,0,0,6,14,-8,7.1,11.6,-4.5,21,EL
93db8be8,1,90,1.0,1,1,0,5,3,4,-1,2.5,2.6,-0.1,21,EL
9413b19f,5,450,5.0,5,5,0,3,6,5,1,11.8,3.8,8.0,21,EL
94d260aa,2,180,2.0,2,2,0,4,3,8,-5,1.9,4.9,-3.0,21,EL
94f8e060,1,20,0.2,0,0,1,5,0,0,0,0.0,0.2,-0.2,21,EL
950ff24d,1,90,1.0,1,1,0,5,0,1,-1,0.9,0.7,0.2,21,EL
951f1739,8,337,3.7,3,1,5,0,6,9,-3,6.2,6.3,0.0,21,EL
957e00ad,5,164,1.8,1,0,4,3,5,7,-2,2.5,5.1,-2.6,21,EL
95a24690,8,411,4.6,5,1,3,0,7,10,-3,6.9,6.3,0.7,21,EL
95a4435e,5,49,0.5,0,0,5,1,1,1,0,0.3,0.7,-0.4,21,EL
95efdac2,4,320,3.6,4,1,0,0,7,8,-1,5.2,3.5,1.7,21,EL
96094cbc,8,381,4.2,6,0,2,0,14,4,10,8.8,3.9,4.9,21,EL
963829d0,14,997,11.1,12,4,2,0,24,7,17,19.6,9.3,10.3,21,EL
965a81e2,3,141,1.6,1,1,2,3,1,5,-4,2.1,4.2,-2.1,21,EL
973a70bc,6,388,4.3,5,1,1,0,8,6,2,5.8,8.0,-2.2,21,EL
975eda74,3,175,1.9,2,1,1,3,2,5,-3,3.4,4.9,-1.4,21,EL
9778d8dd,2,135,1.5,2,1,0,0,1,3,-2,2.6,2.4,0.2,21,EL
977ffc24,2,135,1.5,1,1,1,4,1,4,-3,2.3,2.7,-0.4,21,EL
979d0640,1,28,0.3,0,0,1,1,0,1,-1,0.2,0.3,-0.1,21,EL
97b87472,5,450,5.0,5,5,0,1,5,8,-3,5.1,7.7,-2.6,21,EL
97e2aa67,6,265,2.9,3,0,3,0,7,5,2,5.8,4.9,1.0,21,EL
981e1bee,4,276,3.1,3,2,1,0,3,6,-3,3.6,6.7,-3.0,21,EL
99127249,6,414,4.6,6,0,0,0,5,3,2,10.0,3.1,7.0,21,EL
9a34c46d,2,180,2.0,2,2,0,1,1,5,-4,2.5,4.0,-1.5,21,EL
9a64e67e,7,617,6.9,7,6,0,0,4,8,-4,14.3,7.9,6.5,21,EL
9b92e48d,1,1,0.0,0,0,1,0,0,0,0,0.0,0.0,0.0,21,EL
9bf914b4,6,508,5.6,6,4,0,0,4,7,-3,8.9,8.6,0.3,21,EL
9c2e7413,1,5,0.1,0,0,1,2,0,0,0,0.0,0.0,0.0,21,EL
9c94165b,6,407,4.5,5,3,1,2,10,4,6,7.8,5.4,2.4,21,EL
9cfa4d3f,1,13,0.1,0,0,1,2,0,0,0,0.3,0.7,-0.4,21,EL
9d115f7a,6,402,4.5,4,1,2,0,7,6,1,8.1,4.3,3.8,21,EL
9d21da85,4,319,3.5,4,3,0,0,5,6,-1,4.0,6.5,-2.5,21,EL
9d40ca9c,8,720,8.0,8,8,0,1,13,5,8,9.6,7.0,2.6,21,EL
9d66fbe3,8,410,4.6,5,0,3,0,5,5,0,5.1,6.5,-1.4,21,EL
9d689a5b,4,215,2.4,2,0,2,0,4,3,1,2.5,2.1,0.4,21,EL
9d739099,4,99,1.1,0,0,4,4,0,1,-1,1.6,1.0,0.6,21,EL
9d7d5334,2,43,0.5,0,0,2,0,1,3,-2,0.1,2.4,-2.2,21,EL
9dbb75ca,8,401,4.5,5,0,3,4,12,2,10,9.0,4.3,4.7,21,EL
9dc96f10,4,94,1.0,0,0,4,5,3,1,2,1.1,1.2,0.0,21,EL
9e49c320,5,195,2.2,2,0,3,0,0,3,-3,1.6,4.1,-2.4,21,EL
9e525177,9,723,8.0,9,4,0,0,17,3,14,15.2,8.5,6.8,21,EL
9ef884b1,2,31,0.3,0,0,2,2,0,1,-1,0.2,1.0,-0.8,21,EL
9efa1d25,6,465,5.2,6,2,0,0,9,9,0,6.7,5.0,1.7,21,EL
9f0ea33f,1,90,1.0,1,1,0,13,2,0,2,0.7,0.2,0.5,21,EL
9f333379,5,255,2.8,3,1,2,1,7,5,2,3.5,5.0,-1.5,21,EL
9f6325f9,8,641,7.1,7,6,1,0,11,4,7,6.7,8.8,-2.0,21,EL
9f84febe,10,715,7.9,8,6,2,3,15,11,4,17.2,10.7,6.5,21,EL
9fc2531b,3,36,0.4,0,0,3,0,2,2,0,0.9,0.4,0.6,21,EL
9ff78253,3,232,2.6,3,2,0,3,6,5,1,5.1,4.1,1.0,21,EL
a0284e8e,4,315,3.5,3,3,1,2,3,10,-7,0.9,9.0,-8.0,21,EL
a07cac95,5,382,4.2,4,2,1,1,0,5,-5,3.5,7.6,-4.0,21,EL
a0b730dc,4,264,2.9,3,2,1,2,1,8,-7,3.5,5.1,-1.6,21,EL
a11c995d,4,33,0.4,0,0,4,6,1,0,1,0.5,0.9,-0.4,21,EL
a1232f4e,5,475,5.3,5,4,0,1,8,5,3,8.0,8.3,-0.3,21,EL
a1d5bd30,7,434,4.8,5,1,2,1,10,4,6,8.3,4.7,3.6,21,EL
a26fb8aa,6,540,6.0,6,6,0,0,7,5,2,8.2,10.7,-2.5,21,EL
a2768a3a,1,13,0.1,0,0,1,5,0,2,-2,0.0,0.2,-0.2,21,EL
a2950e2d,6,257,2.9,3,0,3,0,5,5,0,4.4,5.9,-1.5,21,EL
a29b1131,8,276,3.1,2,0,6,1,7,3,4,7.8,1.9,5.8,21,EL
a29e5244,5,140,1.6,1,0,4,1,1,5,-4,0.4,2.4,-1.9,21,EL
a2b0d521,2,152,1.7,2,0,0,0,1,2,-1,1.2,1.4,-0.2,21,EL
a2f2d806,6,385,4.3,4,0,2,1,4,6,-2,4.5,5.9,-1.4,21,EL
a31f54ca,5,402,4.5,5,3,0,3,4,3,1,4.7,2.8,1.9,21,EL
a36524bf,3,62,0.7,0,0,3,6,1,0,1,0.8,0.5,0.3,21,EL
a372a9f2,5,439,4.9,5,4,0,0,4,10,-6,2.3,9.6,-7.3,21,EL
a39b9ef6,8,677,7.5,8,2,0,0,11,6,5,7.9,10.1,-2.1,21,EL
a3b03921,5,343,3.8,4,2,1,1,13,2,11,9.3,1.8,7.5,21,EL
a40819d9,6,495,5.5,6,5,0,3,13,4,9,10.6,5.8,4.8,21,EL
a45eac1f,7,290,3.2,3,0,4,1,6,6,0,2.8,3.8,-1.1,21,EL
a469d983,1,90,1.0,1,1,0,5,1,0,1,0.7,0.9,-0.2,21,EL
a4851d9e,3,178,2.0,2,1,1,3,1,3,-2,1.9,2.9,-0.9,21,EL
a5142492,1,14,0.2,0,0,1,4,1,1,0,0.1,0.3,-0.3,21,EL
a5296e55,6,342,3.8,4,1,2,1,5,2,3,7.0,5.1,1.9,21,EL
a53649b7,8,459,5.1,6,1,2,5,15,4,11,11.4,4.5,6.9,21,EL
a53b661f,6,351,3.9,4,2,2,1,13,3,10,12.2,3.1,9.0,21,EL
a583c8c0,6,459,5.1,6,1,0,0,3,7,-4,5.1,8.8,-3.7,21,EL
a58bb1e1,10,560,6.2,7,0,3,0,17,7,10,15.3,5.4,9.9,21,EL
a5e96539,1,8,0.1,0,0,1,3,0,0,0,0.0,0.1,-0.1,21,EL
a62c16d0,6,417,4.6,5,1,1,0,11,6,5,7.2,8.3,-1.1,21,EL
a634b9d2,3,197,2.2,2,1,1,3,6,3,3,3.7,3.6,0.1,21,EL
a63a995f,8,703,7.8,8,7,0,0,12,11,1,11.5,13.0,-1.6,21,EL
a63c8107,1,90,1.0,1,1,0,5,0,5,-5,0.5,2.3,-1.8,21,EL
a65c844b,5,244,2.7,3,1,2,2,7,5,2,5.9,2.6,3.3,21,EL
a67a09fb,5,305,3.4,4,2,1,3,10,3,7,8.8,4.0,4.8,21,EL
a6951bf8,7,438,4.9,4,2,3,1,6,5,1,6.0,4.8,1.2,21,EL
a69e4806,6,275,3.1,2,0,4,0,3,1,2,5.5,4.1,1.4,21,EL
a7220785,3,113,1.3,1,1,2,2,3,3,0,1.5,2.2,-0.6,21,EL
a72c139d,1,90,1.0,1,1,0,5,1,3,-2,0.5,3.8,-3.3,21,EL
a73c8f95,5,360,4.0,3,3,2,2,14,6,8,10.5,5.0,5.5,21,EL
a74ea18d,4,90,1.0,1,0,3,1,2,3,-1,1.3,2.7,-1.4,21,EL
a793f5a8,2,26,0.3,0,0,2,2,0,0,0,0.1,0.5,-0.3,21,EL
a7a9d95a,10,517,5.7,6,0,4,2,13,3,10,11.3,5.1,6.1,21,EL
a7dbd292,2,128,1.4,2,0,0,2,3,4,-1,2.7,2.9,-0.2,21,EL
a81ed730,4,134,1.5,1,0,3,0,0,0,0,0.2,1.4,-1.3,21,EL
a8327abd,4,132,1.5,1,1,3,0,2,6,-4,2.4,3.6,-1.2,21,EL
a8797cf1,5,101,1.1,1,0,4,1,3,0,3,2.1,0.7,1.3,21,EL
a8b8af8d,3,58,0.6,1,0,2,2,0,2,-2,0.3,0.4,-0.1,21,EL
a8c0acb7,5,408,4.5,5,3,0,0,9,13,-4,4.5,7.6,-3.1,21,EL
a8c62306,2,77,0.9,1,0,1,2,1,4,-3,1.0,1.7,-0.7,21,EL
a8ee54ad,12,896,10.0,11,6,1,0,13,8,5,12.9,12.0,0.9,21,EL
a8f21b9f,9,564,6.3,6,4,3,3,12,7,5,11.9,6.6,5.2,21,EL
a8f41212,4,282,3.1,4,0,0,0,1,3,-2,0.7,4.5,-3.8,21,EL
a9a3b55d,3,270,3.0,3,3,0,3,9,4,5,5.8,5.1,0.7,21,EL
a9be27f2,2,180,2.0,2,2,0,0,2,4,-2,2.0,2.7,-0.7,21,EL
aa04bee3,5,347,3.9,4,2,1,0,6,5,1,5.1,5.8,-0.7,21,EL
aa34ed38,1,86,1.0,1,0,0,3,3,2,1,1.3,1.4,-0.1,21,EL
aa436c56,2,74,0.8,1,0,1,4,1,2,-1,0.9,3.2,-2.3,21,EL
aa54ec6f,5,450,5.0,5,5,0,5,13,5,8,8.6,3.7,5.0,21,EL
aa5859cb,1,15,0.2,0,0,1,0,0,0,0,0.1,0.1,0.0,21,EL
aa8e289e,5,446,5.0,5,4,0,0,2,5,-3,5.1,5.8,-0.8,21,EL
aad56ca3,5,396,4.4,5,2,0,0,8,15,-7,5.7,7.6,-1.9,21,EL
aad9c3f3,7,302,3.4,3,0,4,2,6,1,5,4.7,4.3,0.4,21,EL
ab6928f2,3,194,2.2,3,0,0,0,0,3,-3,2.4,4.0,-1.6,21,EL
abe66106,6,322,3.6,4,0,2,0,6,0,6,5.5,3.0,2.5,21,EL
ac290817,4,258,2.9,4,0,0,0,3,7,-4,5.1,4.6,0.5,21,EL
ac861941,6,500,5.6,5,5,1,2,14,7,7,12.9,4.6,8.2,21,EL
acf7e795,10,900,10.0,10,10,0,1,14,13,1,10.8,14.8,-4.0,21,EL
ad1ffcfd,5,299,3.3,3,2,2,0,9,2,7,7.2,0.9,6.3,21,EL
ad3389d5,5,450,5.0,5,5,0,0,17,8,9,9.5,5.2,4.3,21,EL
ade993b9,6,520,5.8,6,5,0,0,4,8,-4,9.0,9.2,-0.2,21,EL
ade9a05f,2,115,1.3,1,1,1,1,1,4,-3,1.7,3.4,-1.7,21,EL
aded8e6f,5,354,3.9,3,2,2,1,9,4,5,6.1,6.3,-0.2,21,EL
adfc4cc1,4,139,1.5,2,0,2,4,1,3,-2,1.4,2.5,-1.1,21,EL
ae3e6d85,10,568,6.300000000000001,7,0,3,2,4,13,-9,4.199999999999999,10.0,-5.9,21,EL
ae59b359,8,401,4.5,4,3,4,0,10,8,2,7.1,6.0,1.2,21,EL
aeed5c06,8,476,5.3,4,3,4,0,16,8,8,10.3,7.2,3.1,21,EL
af50141d,5,371,4.1,5,1,0,0,5,4,1,4.4,6.1,-1.6,21,EL
af7e69d1,5,450,5.0,5,5,0,0,4,10,-6,2.3,9.6,-7.3,21,EL
af859ca4,4,258,2.9,4,0,0,0,2,5,-3,2.1,3.7,-1.7,21,EL
afa0d4e0,1,81,0.9,1,0,0,0,2,1,1,1.7,1.5,0.2,21,EL
afaafed3,2,13,0.1,0,0,2,1,0,1,-1,0.2,0.5,-0.3,21,EL
afbf187b,2,164,1.8,2,1,0,0,0,4,-4,0.6,3.8,-3.2,21,EL
afff46e6,6,540,6.0,6,6,0,0,3,7,-4,5.5,9.8,-4.2,21,EL
b004076a,6,489,5.4,6,4,0,0,4,11,-7,5.5,9.3,-3.8,21,EL
b0151137,2,158,1.8,1,0,1,0,4,5,-1,1.8,3.4,-1.5,21,EL
b036b4e2,2,38,0.4,0,0,2,2,0,0,0,0.4,1.0,-0.6,21,EL
b056e3da,2,180,2.0,2,2,0,8,4,0,4,3.4,1.6,1.9,21,EL
b1313ec4,10,632,7.0,7,3,3,0,14,10,4,11.8,7.7,4.1,21,EL
b1cbc666,8,553,6.1,6,3,2,0,15,11,4,12.0,7.6,4.4,21,EL
b1dae700,1,26,0.3,0,0,1,3,0,0,0,0.1,0.1,0.0,21,EL
b1f4086c,6,465,5.2,5,3,1,0,14,8,6,8.7,6.6,2.0,21,EL
b20f5a66,3,240,2.7,3,2,0,0,4,5,-1,3.9,3.5,0.4,21,EL
b229aa13,1,90,1.0,1,1,0,0,2,5,-3,1.4,3.0,-1.6,21,EL
b2336681,4,268,3.0,3,2,1,4,3,6,-3,5.1,4.5,0.5,21,EL
b2561711,3,94,1.0,1,0,2,3,3,3,0,2.3,2.0,0.3,21,EL
b28c32d3,6,391,4.3,5,1,1,0,4,4,0,4.9,2.7,2.1,21,EL
b2bd0f6c,8,574,6.4,7,3,1,0,11,9,2,10.3,5.6,4.6,21,EL
b37c0a9f,2,90,1.0,1,0,1,4,0,2,-2,1.0,2.1,-1.2,21,EL
b387af71,4,279,3.1,3,2,1,1,5,9,-4,4.2,6.3,-2.0,21,EL
b39b2cba,2,84,0.9,1,0,1,2,1,3,-2,1.7,2.4,-0.8,21,EL
b39bf63f,1,90,1.0,1,1,0,0,2,3,-1,1.5,2.2,-0.7,21,EL
b3a712de,2,180,2.0,2,2,0,0,2,4,-2,2.0,2.7,-0.7,21,EL
b3aed40d,5,383,4.3,4,4,1,2,5,9,-4,5.2,8.0,-2.9,21,EL
b3de00a7,1,90,1.0,1,1,0,0,0,1,-1,0.5,0.6,0.0,21,EL
b44c39da,5,244,2.7,2,0,3,1,5,4,1,3.2,3.6,-0.3,21,EL
b4705807,8,375,4.2,3,3,5,0,7,11,-4,6.5,10.4,-3.9,21,EL
b49bc5e0,3,64,0.7,1,0,2,3,0,2,-2,0.0,1.0,-1.0,21,EL
b4a98bb4,1,90,1.0,1,1,0,4,1,3,-2,2.2,1.9,0.3,21,EL
b50a9c75,4,138,1.5,1,0,3,2,0,1,-1,0.3,2.3,-2.0,21,EL
b57b998c,1,45,0.5,1,0,0,5,0,0,0,0.1,0.8,-0.7,21,EL
b5f7d10b,4,351,3.9,4,3,0,0,4,5,-1,4.9,5.9,-1.0,21,EL
b62878a5,3,49,0.5,0,0,3,3,0,1,-1,0.6,0.7,-0.1,21,EL
b682dcf6,4,271,3.0,3,3,1,0,6,5,1,2.5,4.4,-1.9,21,EL
b684a484,8,244,2.7,2,1,6,2,7,5,2,6.0,5.0,1.0,21,EL
b6964eb6,5,249,2.8,3,1,2,1,4,7,-3,6.4,6.6,-0.2,21,EL
b6b6bfc4,2,91,1.0,1,1,1,4,0,1,-1,1.4,0.7,0.7,21,EL
b7139e01,6,540,6.0,6,6,0,0,6,11,-5,6.4,11.0,-4.6,21,EL
b7669d1e,1,14,0.2,0,0,1,0,0,0,0,0.0,0.6,-0.6,21,EL
b77706dd,3,41,0.5,0,0,3,1,0,2,-2,0.4,1.5,-1.1,21,EL
b79858d5,6,361,4.0,5,0,1,0,6,4,2,6.9,7.3,-0.4,21,EL
b7c19c48,2,180,2.0,2,2,0,2,2,5,-3,1.8,4.2,-2.4,21,EL
b827d5b3,5,364,4.0,5,2,0,3,7,5,2,6.4,5.6,0.8,21,EL
b82df7cb,5,113,1.3,0,0,5,1,1,3,-2,1.7,5.6,-3.9,21,EL
b8441408,6,540,6.0,6,6,0,0,3,8,-5,6.5,9.0,-2.5,21,EL
b853e0ad,8,525,5.8,6,4,2,1,14,6,8,11.4,9.5,1.9,21,EL
b85bf253,8,631,7.0,8,2,0,0,12,12,0,13.0,11.4,1.6,21,EL
b8814868,4,355,3.9,4,3,0,0,2,5,-3,2.2,5.2,-3.0,21,EL
b8a642fc,11,766,8.5,10,2,1,2,19,7,12,16.3,6.0,10.3,21,EL
b8c1de25,12,785,8.7,11,3,1,0,9,6,3,7.9,8.2,-0.3,21,EL
b8e740fb,5,449,5.0,5,4,0,0,9,4,5,13.6,4.5,9.1,21,EL
ba23a904,8,720,8.0,8,8,0,0,21,13,8,15.1,9.8,5.3,21,EL
bac46a10,6,540,6.0,6,6,0,0,11,5,6,15.4,5.0,10.4,21,EL
bafcf742,5,450,5.0,5,5,0,1,10,9,1,7.5,10.9,-3.5,21,EL
bb79b58f,4,261,2.9,4,0,0,0,3,4,-1,1.9,7.0,-5.0,21,EL
bb833a0a,1,1,0.0,0,0,1,4,0,0,0,0.0,0.0,0.0,21,EL
bc08556f,6,270,3.0,3,1,3,0,2,5,-3,2.9,5.2,-2.3,21,EL
bc7dc64d,9,699,7.8,8,2,1,3,15,7,8,11.4,6.5,4.9,21,EL
bcdc8055,6,442,4.9,5,4,1,0,8,17,-9,5.9,10.1,-4.1,21,EL
bced0375,7,556,6.2,6,4,1,0,13,12,1,10.0,7.1,2.9,21,EL
bd142efb,7,550,6.1,6,6,1,1,16,13,3,12.2,9.1,3.1,21,EL
bd3fb505,5,177,2.0,2,0,3,1,2,3,-1,1.8,4.0,-2.1,21,EL
bd7d2e6d,4,253,2.8,2,2,2,2,6,4,2,4.1,4.3,-0.1,21,EL
bdc74a8f,13,790,8.8,8,5,5,0,19,9,10,17.1,10.2,6.9,21,EL
bdc8912c,6,535,5.9,6,5,0,0,11,12,-1,8.7,10.4,-1.7,21,EL
be765073,7,498,5.5,6,5,1,0,12,7,5,9.5,6.7,2.9,21,EL
be9938ed,2,93,1.0,0,0,2,2,1,2,-1,1.5,1.4,0.0,21,EL
bee0bab1,5,297,3.3,4,2,1,0,14,4,10,10.4,2.0,8.4,21,EL
beec76cc,11,842,9.4,10,6,1,0,14,12,2,9.8,13.7,-3.9,21,EL
bf128850,3,145,1.6,1,1,2,2,1,1,0,0.8,2.5,-1.7,21,EL
bf309d24,10,841,9.3,10,7,0,0,20,13,7,16.2,13.3,2.8,21,EL
bf34eebd,5,247,2.7,3,0,2,0,4,5,-1,3.9,1.8,2.2,21,EL
bfde3de5,5,321,3.6,5,0,0,1,3,5,-2,1.5,5.9,-4.3,21,EL
c001a28e,1,90,1.0,1,1,0,5,0,4,-4,0.1,2.0,-1.9,21,EL
c00e6676,5,75,0.8,1,0,4,0,0,3,-3,0.8,2.1,-1.3,21,EL
c0617e2b,12,586,6.5,6,1,6,0,15,10,5,9.4,5.4,4.0,21,EL
c08fc464,5,368,4.1,4,2,1,0,6,8,-2,4.6,6.9,-2.3,21,EL
c0c7ff58,8,460,5.1,5,4,3,0,5,6,-1,8.4,6.0,2.5,21,EL
c0e27d1a,7,585,6.5,7,6,0,1,13,7,6,11.2,6.3,4.9,21,EL
c20bdcd7,6,226,2.5,2,1,4,2,4,1,3,2.3,2.4,-0.1,21,EL
c2111b45,10,652,7.2,8,6,2,0,7,8,-1,8.1,8.1,-0.1,21,EL
c2123906,6,305,3.4,3,0,3,0,3,4,-1,3.1,6.2,-3.1,21,EL
c2304da8,3,212,2.4,2,2,1,0,4,10,-6,2.7,5.7,-3.0,21,EL
c235e803,2,180,2.0,2,2,0,6,5,3,2,2.3,1.7,0.6,21,EL
c24544c7,2,180,2.0,2,2,0,0,1,2,-1,1.8,1.4,0.4,21,EL
c2a6033c,5,175,1.9,1,0,4,0,1,3,-2,3.5,3.7,-0.2,21,EL
c2bd8585,8,404,4.5,5,1,3,2,8,2,6,7.4,5.4,1.9,21,EL
c2e41cfb,2,180,2.0,2,2,0,4,3,7,-4,2.1,2.2,-0.1,21,EL
c328ab28,3,135,1.5,2,0,1,3,1,2,-1,1.8,3.4,-1.6,21,EL
c339426b,5,211,2.3,3,0,2,1,3,5,-2,4.6,1.9,2.7,21,EL
c34824b1,2,135,1.5,1,1,1,0,1,5,-4,1.6,3.3,-1.8,21,EL
c3853da6,7,320,3.6,3,2,4,1,4,9,-5,4.9,6.0,-1.1,21,EL
c3e4ecbb,8,585,6.5,7,5,1,2,11,11,0,10.3,12.4,-2.1,21,EL
c41f7379,1,90,1.0,1,1,0,7,4,1,3,2.2,1.2,1.0,21,EL
c43e5e7e,4,314,3.5,4,0,0,0,3,4,-1,4.2,4.9,-0.6,21,EL
c455a2b2,3,270,3.0,3,3,0,0,5,6,-1,4.9,6.8,-1.9,21,EL
c45a34e7,2,83,0.9,1,0,1,1,4,2,2,2.6,1.4,1.2,21,EL
c4a306a1,4,360,4.0,4,4,0,0,3,3,0,4.1,5.5,-1.4,21,EL
c50281a0,4,183,2.0,2,0,2,0,9,2,7,4.1,1.4,2.6,21,EL
c54ea7f0,7,620,6.9,7,6,0,0,8,13,-5,8.8,10.6,-1.7,21,EL
c585302b,1,90,1.0,1,1,0,3,0,0,0,0.5,0.7,-0.2,21,EL
c5a500ca,6,460,5.1,5,3,1,0,8,11,-3,5.4,8.3,-2.9,21,EL
c5adc293,5,220,2.4,2,1,3,2,4,2,2,7.8,3.1,4.7,21,EL
c5bdb6e3,4,243,2.7,3,2,1,5,9,1,8,7.4,2.4,5.0,21,EL
c5cbbcff,5,393,4.4,5,1,0,0,6,3,3,10.9,3.9,6.9,21,EL
c5ea2dab,6,423,4.7,5,4,1,0,11,9,2,8.0,9.3,-1.3,21,EL
c603091a,5,364,4.0,4,4,1,1,6,6,0,4.2,7.0,-2.8,21,EL
c63f6e46,4,328,3.6,4,1,0,0,6,5,1,3.5,4.9,-1.4,21,EL
c64c01fc,2,15,0.2,0,0,2,0,0,1,-1,0.4,0.7,-0.3,21,EL
c650629d,6,458,5.1,6,0,0,0,3,6,-3,5.1,8.1,-3.0,21,EL
c68b1b13,6,523,5.8,6,5,0,0,6,13,-7,6.6,10.7,-4.1,21,EL
c6cf860f,1,45,0.5,0,0,1,2,0,1,-1,0.2,1.0,-0.8,21,EL
c6dda86e,5,259,2.9,2,1,3,0,6,7,-1,2.4,5.5,-3.1,21,EL
c7069d87,2,149,1.7,2,1,0,0,2,4,-2,1.8,2.7,-0.9,21,EL
c70b221c,5,426,4.7,5,3,0,5,8,6,2,9.1,6.8,2.3,21,EL
c71e97ba,4,337,3.7,4,3,0,0,2,5,-3,2.2,5.0,-2.8,21,EL
c77a8043,11,716,8.0,7,6,4,0,6,8,-2,8.1,10.7,-2.6,21,EL
c7842dab,1,6,0.1,0,0,1,1,0,0,0,0.0,0.1,-0.1,21,EL
c7b13c29,5,450,5.0,5,5,0,1,8,7,1,5.0,7.1,-2.2,21,EL
c7e955d0,1,14,0.2,0,0,1,5,0,0,0,0.0,0.5,-0.5,21,EL
c7fbd3f1,1,89,1.0,1,0,0,3,0,5,-5,0.3,3.9,-3.6,21,EL
c8160af7,1,61,0.7,0,0,1,5,1,1,0,0.3,0.8,-0.5,21,EL
c83623e2,5,450,5.0,5,5,0,0,4,5,-1,4.4,6.8,-2.4,21,EL
c83c2c9c,2,180,2.0,2,2,0,2,2,6,-4,2.0,4.2,-2.2,21,EL
c8694401,6,529,5.9,6,5,0,0,6,12,-6,5.7,16.1,-10.5,21,EL
c86c0fab,4,192,2.1,2,0,2,0,3,4,-1,2.0,4.3,-2.2,21,EL
c8a4aafd,5,353,3.9,4,3,1,1,6,13,-7,3.2,9.1,-5.9,21,EL
c8ad0857,8,720,8.0,8,8,0,0,8,14,-6,8.8,11.6,-2.7,21,EL
c8d7131c,3,270,3.0,3,3,0,0,4,5,-1,6.5,5.0,1.5,21,EL
c8e65157,8,710,7.9,8,7,0,0,12,7,5,8.3,10.9,-2.6,21,EL
c904f3d5,1,90,1.0,1,1,0,0,1,2,-1,1.2,0.8,0.3,21,EL
c9081f9a,4,165,1.8,1,0,3,0,0,2,-2,0.8,2.8,-2.0,21,EL
c92e1a31,7,413,4.6,5,1,2,0,9,3,6,7.7,4.2,3.4,21,EL
c931d9f9,7,438,4.9,5,3,2,1,9,0,9,7.9,4.0,3.9,21,EL
c952f633,6,336,3.7,3,2,3,2,6,4,2,5.2,5.0,0.2,21,EL
c967f6b8,5,450,5.0,5,5,0,0,4,10,-6,4.8,13.5,-8.7,21,EL
ca033449,6,540,6.0,6,6,0,0,4,10,-6,4.9,9.1,-4.2,21,EL
ca45605e,2,179,2.0,2,1,0,0,1,4,-3,2.9,3.2,-0.4,21,EL
ca607d59,1,30,0.3,0,0,1,0,0,1,-1,0.4,0.5,-0.1,21,EL
caaf2ed1,6,495,5.5,6,5,0,0,10,12,-2,7.5,12.0,-4.5,21,EL
cb4f24c6,6,531,5.9,6,5,0,4,19,4,15,16.9,2.9,14.0,21,EL
cb641b9d,5,372,4.1,4,3,1,0,3,8,-5,6.3,7.4,-1.0,21,EL
cc83b74d,3,234,2.6,3,0,0,0,3,6,-3,3.0,3.4,-0.3,21,EL
ccc66d00,4,267,3.0,4,0,0,0,1,3,-2,3.0,3.9,-0.9,21,EL
ccce7025,8,662,7.4,7,6,1,0,15,10,5,12.7,8.1,4.6,21,EL
cd0fa27b,6,354,3.9,4,2,2,1,5,7,-2,5.5,4.5,1.1,21,EL
cd4959d1,6,540,6.0,6,6,0,0,6,12,-6,6.0,16.2,-10.2,21,EL
cd6a1a59,7,339,3.8,4,2,3,1,7,10,-3,6.0,8.1,-2.1,21,EL
cd7dade5,1,90,1.0,1,1,0,1,1,2,-1,1.6,1.0,0.6,21,EL
cdc20132,4,360,4.0,4,4,0,0,5,9,-4,4.8,7.0,-2.2,21,EL
ce50fd99,8,591,6.6,7,4,1,0,12,9,3,11.2,6.9,4.3,21,EL
ce940592,5,282,3.1,3,3,2,3,4,2,2,5.4,2.5,2.9,21,EL
ce9e8024,4,254,2.8,2,2,2,2,7,7,0,6.4,4.2,2.2,21,EL
cea4ee8f,8,451,5.0,6,0,2,2,13,5,8,9.5,4.1,5.4,21,EL
cee45ad0,5,450,5.0,5,5,0,0,3,7,-4,4.6,7.5,-2.9,21,EL
cf007308,6,326,3.6,4,1,2,1,4,5,-1,6.5,4.4,2.1,21,EL
cf043a33,1,61,0.7,0,0,1,3,3,2,1,3.6,1.3,2.3,21,EL
cf15bbb1,8,703,7.8,8,6,0,1,18,15,3,13.9,10.2,3.7,21,EL
cf182add,1,90,1.0,1,1,0,0,0,3,-3,0.9,2.4,-1.5,21,EL
cf8ef0a1,1,45,0.5,1,0,0,1,1,1,0,0.3,1.4,-1.1,21,EL
cfb6c9e5,4,348,3.9,4,3,0,0,4,8,-4,4.0,6.3,-2.3,21,EL
cfcf183b,2,100,1.1,1,1,1,4,1,1,0,0.7,1.5,-0.8,21,EL
cfe852d8,6,540,6.0,6,6,0,0,9,11,-2,6.1,8.5,-2.4,21,EL
d019d5db,2,53,0.6,0,0,2,3,0,1,-1,1.1,1.3,-0.2,21,EL
d035138b,5,329,3.7,4,1,1,1,5,11,-6,5.2,6.7,-1.5,21,EL
d080ed5e,8,693,7.7,8,6,0,0,5,8,-3,15.9,8.4,7.4,21,EL
d125f22f,2,75,0.8,1,0,1,0,1,1,0,0.3,0.5,-0.2,21,EL
d1274b84,1,90,1.0,1,1,0,5,0,5,-5,0.3,3.9,-3.6,21,EL
d1562e2e,4,360,4.0,4,4,0,1,3,6,-3,4.3,8.9,-4.6,21,EL
d1bf91e0,3,186,2.1,2,1,1,1,3,3,0,3.7,2.3,1.4,21,EL
d2795011,1,11,0.1,0,0,1,1,1,0,1,0.2,0.0,0.2,21,EL
d280923b,3,270,3.0,3,3,0,1,4,5,-1,3.2,8.4,-5.2,21,EL
d2ddff2d,3,26,0.3,1,0,2,3,0,0,0,0.0,0.1,0.0,21,EL
d3272fba,5,311,3.5,3,1,2,0,7,8,-1,4.1,6.0,-1.9,21,EL
d38fdf53,4,226,2.5,2,2,2,5,6,1,5,4.6,3.1,1.5,21,EL
d3aaad90,4,125,1.4,1,0,3,0,4,0,4,3.5,0.6,2.9,21,EL
d3ce0e89,2,180,2.0,2,2,0,6,2,1,1,2.6,1.3,1.4,21,EL
d4133fa1,4,349,3.9,4,3,0,0,6,7,-1,3.5,5.2,-1.7,21,EL
d4232ba9,8,576,6.4,7,4,1,0,10,10,0,9.2,10.0,-0.8,21,EL
d436eb94,2,180,2.0,2,2,0,0,1,2,-1,1.8,1.4,0.4,21,EL
d494882e,2,8,0.1,0,0,2,0,0,0,0,0.1,0.1,0.0,21,EL
d4aa40b8,8,544,6.0,7,0,1,0,11,6,5,7.0,8.6,-1.6,21,EL
d4c9725f,7,551,6.1,6,5,1,2,10,9,1,6.8,7.6,-0.9,21,EL
d4cb83cc,7,617,6.9,7,6,0,1,4,8,-4,14.3,7.9,6.5,21,EL
d4e7c451,6,209,2.3,2,0,4,2,1,3,-2,2.8,1.7,1.1,21,EL
d4f034db,4,347,3.9,4,3,0,0,4,5,-1,4.9,6.0,-1.1,21,EL
d4fa7d01,6,540,6.0,6,6,0,0,8,16,-8,7.3,9.3,-2.0,21,EL
d504b3e1,4,239,2.7,2,2,2,0,4,7,-3,3.9,5.1,-1.2,21,EL
d5127c3f,4,272,3.0,3,0,1,0,7,3,4,4.0,2.5,1.5,21,EL
d51d1d9d,3,117,1.3,1,1,2,0,3,2,1,1.6,2.2,-0.5,21,EL
d557d734,7,613,6.8,7,6,0,3,22,5,17,19.5,4.7,14.8,21,EL
d571df78,6,377,4.2,3,2,3,0,7,9,-2,6.7,8.6,-1.9,21,EL
d5854b7a,4,92,1.0,1,0,3,1,1,3,-2,0.3,1.2,-1.0,21,EL
d5aac0e9,1,45,0.5,0,0,1,5,0,1,-1,0.2,0.5,-0.2,21,EL
d5dd5f1f,8,471,5.2,5,2,3,2,10,6,4,9.5,4.5,5.0,21,EL
d665d581,5,373,4.1,4,4,1,0,3,9,-6,4.0,6.5,-2.5,21,EL
d72f8d9e,2,174,1.9,2,1,0,1,4,4,0,3.5,2.4,1.1,21,EL
d7354a36,2,107,1.2,2,0,0,4,0,1,-1,0.4,1.7,-1.3,21,EL
d73a07e2,1,16,0.2,0,0,1,0,0,1,-1,0.1,0.7,-0.6,21,EL
d7553721,6,342,3.8,4,1,2,0,8,5,3,10.9,3.0,7.9,21,EL
d78e8c43,4,147,1.6,1,0,3,2,2,7,-5,1.5,4.5,-3.0,21,EL
d79a8c87,5,405,4.5,4,4,1,6,9,3,6,8.1,2.8,5.3,21,EL
d7a70e5e,4,216,2.4,2,2,2,0,2,6,-4,2.8,5.2,-2.4,21,EL
d7f99582,3,101,1.1,1,0,2,0,2,2,0,0.7,3.1,-2.4,21,EL
d820a7c8,5,222,2.5,2,0,3,0,1,5,-4,2.4,4.1,-1.7,21,EL
d84b7d06,1,3,0.0,0,0,1,3,0,0,0,0.0,0.1,-0.1,21,EL
d87d58e7,2,18,0.2,0,0,2,6,0,1,-1,0.4,0.2,0.2,21,EL
d87e2cae,6,203,2.3,1,1,5,0,4,2,2,5.1,1.2,3.8,21,EL
d8931174,6,540,6.0,6,6,0,2,16,6,10,13.5,9.0,4.5,21,EL
d8d25850,3,97,1.1,0,0,3,2,2,2,0,1.4,1.5,-0.1,21,EL
d8ff3b2c,5,418,4.6,5,3,0,1,3,11,-8,3.6,13.8,-10.2,21,EL
d92b0327,6,304,3.4,3,1,3,0,4,8,-4,3.7,6.7,-2.9,21,EL
d93c2511,6,538,6.0,6,4,0,1,13,4,9,11.2,5.5,5.7,21,EL
d94653be,2,66,0.7,1,0,1,0,1,1,0,0.5,1.6,-1.0,21,EL
d9565625,10,760,8.4,8,8,2,0,14,10,4,11.4,9.1,2.3,21,EL
d97cccc9,4,207,2.3,2,2,2,0,7,3,4,5.4,3.6,1.8,21,EL
d9847696,3,186,2.1,2,2,1,2,2,1,1,3.4,2.1,1.3,21,EL
d9a5d930,4,62,0.7,0,0,4,0,1,1,0,0.9,1.6,-0.7,21,EL
d9ac09e2,4,119,1.3,2,0,2,1,2,3,-1,1.3,2.3,-1.0,21,EL
d9d43555,2,16,0.2,0,0,2,1,1,0,1,0.6,0.3,0.3,21,EL
d9e196bf,4,339,3.8,4,3,0,2,7,5,2,9.0,3.4,5.7,21,EL
da3bf1b3,5,405,4.5,5,4,0,1,8,6,2,3.7,5.8,-2.0,21,EL
da7b447d,7,660,7.3,7,7,0,2,14,7,7,15.2,5.2,10.0,21,EL
da974c7b,7,630,7.0,7,7,0,0,9,5,4,14.0,8.4,5.6,21,EL
db092d3b,6,292,3.2,3,1,3,1,6,2,4,6.0,2.1,3.8,21,EL
db123b51,6,414,4.6,5,1,1,0,5,13,-8,3.7,8.7,-4.9,21,EL
db1aced4,2,127,1.4,1,1,1,4,4,6,-2,2.9,5.1,-2.2,21,EL
db2e8273,3,32,0.4,0,0,3,3,0,1,-1,0.2,0.8,-0.5,21,EL
db50aeaa,2,180,2.0,2,2,0,3,2,8,-6,2.4,5.0,-2.7,21,EL
db74c6d3,5,437,4.9,4,4,1,1,2,10,-8,3.5,8.6,-5.1,21,EL
dba1f190,4,247,2.7,3,0,1,0,4,6,-2,3.8,5.7,-1.9,21,EL
dba67bc4,2,163,1.8,2,1,0,0,1,4,-3,2.7,3.2,-0.5,21,EL
dbad5a31,6,540,6.0,6,6,0,0,4,13,-9,5.0,11.4,-6.3,21,EL
dbf3e08b,5,113,1.3,0,0,5,2,0,4,-4,0.6,1.6,-1.0,21,EL
dc234f98,7,630,7.0,7,7,0,1,13,12,1,14.3,10.7,3.6,21,EL
dc29b608,8,720,8.0,8,8,0,0,16,14,2,11.9,8.7,3.3,21,EL
dc3fa3b5,6,318,3.5,3,1,3,0,4,2,2,7.0,3.3,3.7,21,EL
dc415e39,3,136,1.5,1,1,2,1,0,4,-4,0.4,3.1,-2.7,21,EL
dc52c72f,4,329,3.7,4,1,0,0,1,5,-4,1.4,4.4,-3.0,21,EL
dc6f5bdd,6,301,3.3,3,3,3,3,9,4,5,5.8,2.4,3.4,21,EL
dc90cfbe,2,145,1.6,2,0,0,0,1,1,0,1.3,0.5,0.8,21,EL
dd0daf32,11,598,6.6,7,3,4,0,18,10,8,14.5,9.6,5.0,21,EL
dd788526,6,540,6.0,6,6,0,0,4,13,-9,5.0,11.4,-6.3,21,EL
ddd5348b,2,31,0.3,0,0,2,5,0,0,0,0.5,0.4,0.1,21,EL
dde7068b,3,32,0.4,0,0,3,0,0,1,-1,1.2,0.3,0.9,21,EL
deb20131,4,360,4.0,4,4,0,0,5,2,3,4.7,7.9,-3.3,21,EL
deba6b05,7,410,4.6,4,2,3,0,9,7,2,7.2,7.5,-0.3,21,EL
debc6b55,5,113,1.3,0,0,5,3,3,2,1,2.5,0.8,1.7,21,EL
df41e06e,6,459,5.1,5,2,1,0,5,8,-3,6.0,9.5,-3.5,21,EL
dff19848,3,147,1.6,2,1,1,0,0,1,-1,1.8,3.2,-1.4,21,EL
e02f182f,4,117,1.3,1,0,3,2,3,5,-2,1.6,3.1,-1.5,21,EL
e03c2d97,9,658,7.3,8,5,1,1,12,9,3,8.4,9.2,-0.9,21,EL
e07c2923,10,643,7.1,7,0,3,1,8,9,-1,6.6,9.9,-3.3,21,EL
e09436fb,3,210,2.3,2,2,1,0,1,5,-4,0.6,5.5,-4.9,21,EL
e0d3e18d,5,178,2.0,2,0,3,0,0,3,-3,1.9,3.0,-1.1,21,EL
e111bf12,4,360,4.0,4,4,0,0,9,9,0,5.5,6.7,-1.2,21,EL
e1604571,3,253,2.8,3,2,0,1,3,7,-4,3.6,6.7,-3.1,21,EL
e16932d8,2,29,0.3,0,0,2,4,1,0,1,1.0,0.1,1.0,21,EL
e1ba3d5a,6,227,2.5,2,0,4,0,3,7,-4,4.2,5.1,-0.9,21,EL
e1bbb68d,3,199,2.2,3,0,0,3,2,3,-1,1.8,2.5,-0.7,21,EL
e1cbb531,5,268,3.0,4,0,1,3,3,4,-1,6.3,3.7,2.5,21,EL
e23f56c1,2,52,0.6,0,0,2,0,1,0,1,0.3,0.4,-0.1,21,EL
e2716bd0,5,426,4.7,5,4,0,0,2,6,-4,10.9,6.2,4.7,21,EL
e2781082,4,248,2.8,4,0,0,1,2,9,-7,2.5,3.8,-1.4,21,EL
e28205f4,5,271,3.0,3,0,2,0,1,4,-3,0.8,4.6,-3.8,21,EL
e28245d9,4,347,3.9,4,1,0,0,4,9,-5,4.1,7.0,-2.9,21,EL
e2a302a8,8,645,7.2,7,5,1,0,6,8,-2,8.8,7.6,1.2,21,EL
e373f1ec,5,365,4.1,4,3,1,1,9,8,1,6.0,10.4,-4.4,21,EL
e38f1636,3,225,2.5,2,2,1,2,6,3,3,4.0,4.2,-0.2,21,EL
e3a5814e,5,422,4.7,5,4,0,1,16,4,12,11.1,3.3,7.8,21,EL
e3e3f401,6,279,3.1,3,0,3,0,3,4,-1,2.8,4.8,-2.0,21,EL
e45ee4bc,7,607,6.7,7,4,0,0,12,10,2,13.7,9.1,4.6,21,EL
e4ac16cf,6,389,4.3,5,3,1,0,5,14,-9,5.6,10.0,-4.3,21,EL
e53830f2,1,1,0.0,0,0,1,0,0,0,0,0.0,0.0,0.0,21,EL
e5a35ae9,8,348,3.9,5,0,3,0,9,5,4,8.0,4.0,4.0,21,EL
e5a76dfe,4,360,4.0,4,4,0,5,6,1,5,5.8,3.9,1.9,21,EL
e613313c,4,105,1.2,0,0,4,1,5,1,4,3.6,0.7,2.8,21,EL
e61b8aee,10,843,9.4,10,7,0,1,21,9,12,18.0,7.3,10.8,21,EL
e6631d18,5,300,3.3,3,2,2,1,4,12,-8,4.8,9.2,-4.4,21,EL
e66c698a,3,224,2.5,3,1,0,0,1,4,-3,0.6,4.1,-3.6,21,EL
e66e4ddc,2,174,1.9,2,1,0,1,0,2,-2,0.4,2.1,-1.7,21,EL
e6fa388d,5,327,3.6,4,1,1,1,5,7,-2,4.5,5.8,-1.2,21,EL
e705903c,1,6,0.1,0,0,1,4,0,0,0,0.3,0.2,0.1,21,EL
e7199efb,7,170,1.9,0,0,7,1,5,4,1,3.9,4.4,-0.5,21,EL
e73c9bb2,7,451,5.0,4,4,3,2,9,4,5,8.5,6.8,1.7,21,EL
e75dc411,5,279,3.1,3,2,2,0,5,9,-4,3.4,7.2,-3.8,21,EL
e791ed65,1,2,0.0,0,0,1,2,0,0,0,0.0,0.0,0.0,21,EL
e7e257d2,5,109,1.2,1,0,4,0,0,5,-5,0.9,3.7,-2.8,21,EL
e7f3e8a7,5,318,3.5,3,0,2,0,0,3,-3,4.2,4.3,-0.2,21,EL
e7fcf289,7,437,4.9,5,3,2,0,14,10,4,9.5,7.5,2.0,21,EL
e82900ef,3,71,0.8,0,0,3,1,3,2,1,2.9,1.1,1.8,21,EL
e82adcab,2,163,1.8,2,1,0,2,7,3,4,2.6,2.0,0.7,21,EL
e872ca65,8,432,4.8,4,2,4,4,9,2,7,7.7,5.2,2.6,21,EL
e8796ba6,6,540,6.0,6,6,0,0,3,8,-5,6.5,9.0,-2.5,21,EL
e8918589,4,360,4.0,4,4,0,4,7,8,-1,6.1,5.1,1.0,21,EL
e8acf576,3,207,2.3,2,2,1,0,5,3,2,3.7,5.0,-1.3,21,EL
e8ed3abc,5,132,1.5,1,0,4,5,0,5,-5,0.9,2.8,-1.9,21,EL
e8ef59da,2,22,0.2,0,0,2,0,0,1,-1,0.1,0.2,-0.1,21,EL
e9895d1c,8,284,3.2,3,0,5,2,4,8,-4,2.2,7.5,-5.2,21,EL
e9971f2d,3,270,3.0,3,3,0,4,9,3,6,8.8,1.1,7.8,21,EL
e9b0ccaf,2,17,0.2,0,0,2,2,1,0,1,0.8,0.1,0.7,21,EL
ea6a7ab4,2,13,0.1,0,0,2,6,0,0,0,0.1,0.1,0.0,21,EL
ea770abf,4,130,1.4,1,1,3,2,0,2,-2,1.0,2.0,-0.9,21,EL
ea83bfa6,11,990,11.0,11,11,0,1,12,11,1,11.4,12.9,-1.6,21,EL
ea9b2ef9,10,746,8.3,8,5,2,1,6,7,-1,7.6,10.5,-2.9,21,EL
eab5c31f,5,92,1.0,0,0,5,0,0,2,-2,0.6,1.4,-0.8,21,EL
eab85789,6,481,5.3,6,4,0,0,3,14,-11,7.7,8.2,-0.5,21,EL
eac044ad,7,466,5.2,6,3,1,0,13,7,6,12.4,6.0,6.4,21,EL
eb2b33aa,4,360,4.0,4,4,0,0,2,5,-3,2.3,5.2,-2.9,21,EL
eb49bd3f,5,450,5.0,5,5,0,2,9,9,0,8.3,9.2,-0.9,21,EL
eb5bc3eb,7,526,5.8,6,3,1,0,3,8,-5,4.8,6.5,-1.7,21,EL
eb6e14be,2,180,2.0,2,2,0,0,1,4,-3,2.9,3.2,-0.4,21,EL
eb7822d7,7,354,3.9,3,3,4,2,8,2,6,6.7,3.8,2.9,21,EL
eb8b2a35,6,315,3.5,3,1,3,0,1,2,-1,3.4,4.1,-0.8,21,EL
ebca82e8,4,286,3.2,3,3,1,1,6,7,-1,5.5,5.9,-0.4,21,EL
ebdc9c7e,6,458,5.1,5,4,1,0,8,8,0,7.5,10.6,-3.2,21,EL
ec30b9c8,6,464,5.2,5,5,1,0,6,13,-7,6.1,11.4,-5.3,21,EL
ecb68eea,2,98,1.1,1,0,1,0,1,2,-1,1.0,0.8,0.2,21,EL
ecc10d95,4,89,1.0,0,0,4,0,1,2,-1,3.0,1.0,2.0,21,EL
ed16a617,5,303,3.4,4,0,1,0,4,3,1,3.7,4.1,-0.4,21,EL
ed1cc44a,6,451,5.0,5,5,1,2,10,11,-1,8.0,8.7,-0.7,21,EL
ed45a7d7,6,433,4.8,4,4,2,0,5,9,-4,5.1,9.3,-4.2,21,EL
ed6ea4d9,10,574,6.4,6,3,4,0,7,6,1,7.7,7.6,0.1,21,EL
ee251371,4,195,2.2,2,1,2,3,1,2,-1,2.1,2.7,-0.6,21,EL
ee3519f5,1,90,1.0,1,1,0,0,2,0,2,1.5,0.6,1.0,21,EL
ee38d9c5,6,344,3.8,4,1,2,0,10,3,7,9.4,4.9,4.5,21,EL
ee926a02,12,1040,11.6,12,7,0,0,15,7,8,13.2,13.9,-0.7,21,EL
ee950928,12,971,10.8,11,5,1,0,13,7,6,13.0,13.3,-0.3,21,EL
eeba07f8,8,355,3.9,3,0,5,0,4,3,1,3.7,3.4,0.3,21,EL
eed332df,3,35,0.4,0,0,3,4,1,1,0,0.3,0.7,-0.4,21,EL
eef95b11,4,161,1.8,1,1,3,2,1,5,-4,2.6,4.4,-1.8,21,EL
ef233486,4,96,1.1,1,0,3,6,3,0,3,2.2,0.7,1.5,21,EL
ef32d66d,1,15,0.2,0,0,1,2,0,0,0,0.0,0.0,0.0,21,EL
ef3909cd,6,540,6.0,6,6,0,2,12,12,0,9.0,11.2,-2.2,21,EL
ef4d73aa,6,488,5.4,6,4,0,0,7,19,-12,6.0,11.9,-6.0,21,EL
ef88f778,10,715,7.9,8,4,2,0,19,15,4,14.5,10.5,4.1,21,EL
ef9c1c95,5,287,3.2,3,1,2,2,4,5,-1,5.7,2.2,3.5,21,EL
efc13588,4,251,2.8,4,2,0,0,7,4,3,6.0,3.6,2.4,21,EL
efc33b33,4,248,2.8,2,2,2,2,3,7,-4,2.6,8.9,-6.3,21,EL
f038585f,2,180,2.0,2,2,0,4,2,2,0,2.6,2.7,-0.1,21,EL
f0661424,5,433,4.8,5,4,0,0,9,4,5,12.2,3.2,9.0,21,EL
f0677ed7,10,887,9.9,10,9,0,0,16,16,0,16.3,17.1,-0.8,21,EL
f07a0fe5,6,518,5.8,6,4,0,0,9,7,2,10.4,9.3,1.2,21,EL
f0e4c69e,1,90,1.0,1,1,0,5,1,2,-1,3.2,0.7,2.5,21,EL
f0f5a383,1,4,0.0,0,0,1,0,0,0,0,0.0,1.0,-0.9,21,EL
f0f68cb9,1,90,1.0,1,1,0,0,0,5,-5,0.3,3.9,-3.6,21,EL
f18d7ab2,4,238,2.6,2,2,2,2,2,4,-2,3.1,3.1,0.0,21,EL
f201798c,2,88,1.0,1,0,1,0,0,2,-2,0.4,1.9,-1.5,21,EL
f209b81e,5,273,3.0,3,2,2,0,2,6,-4,3.3,6.7,-3.4,21,EL
f230bc30,6,401,4.5,4,3,2,0,6,9,-3,6.5,9.5,-3.0,21,EL
f26e3c59,6,515,5.7,6,4,0,0,10,17,-7,6.0,10.3,-4.2,21,EL
f2cfb59a,1,9,0.1,0,0,1,2,0,1,-1,0.1,0.5,-0.4,21,EL
f301f363,5,258,2.9,3,0,2,1,5,9,-4,3.9,6.3,-2.4,21,EL
f323d995,2,180,2.0,2,2,0,1,4,6,-2,2.1,4.3,-2.2,21,EL
f329ec76,1,63,0.7,0,0,1,1,0,1,-1,0.9,0.7,0.1,21,EL
f352799f,3,270,3.0,3,3,0,3,0,3,-3,2.5,4.5,-2.0,21,EL
f3600c02,6,465,5.2,6,3,0,1,11,7,4,9.1,6.1,3.0,21,EL
f38cc3b3,1,13,0.1,0,0,1,2,0,0,0,0.0,0.3,-0.3,21,EL
f3a97d02,9,810,9.0,9,9,0,1,21,15,6,16.2,10.9,5.3,21,EL
f3b2463e,5,230,2.6,2,0,3,0,3,9,-6,3.0,6.2,-3.2,21,EL
f40dd3c7,3,225,2.5,3,2,0,1,0,2,-2,3.5,4.7,-1.2,21,EL
f42e9f3f,6,540,6.0,6,6,0,2,8,7,1,8.0,7.2,0.8,21,EL
f4b52308,5,350,3.9,4,3,1,3,9,7,2,5.4,4.0,1.5,21,EL
f4ceb85b,3,51,0.6,1,0,2,3,0,1,-1,1.3,0.2,1.1,21,EL
f4d8ce5a,5,161,1.8,2,0,3,0,1,2,-1,1.1,5.7,-4.6,21,EL
f5044e54,2,142,1.6,2,0,0,2,2,6,-4,1.5,2.3,-0.8,21,EL
f533776b,3,218,2.4,2,2,1,1,3,10,-7,2.8,4.9,-2.1,21,EL
f5ae006d,5,344,3.8,4,3,1,1,11,1,10,8.3,2.3,6.0,21,EL
f5c8b425,8,618,6.9,8,2,0,0,12,10,2,11.7,7.2,4.5,21,EL
f5deef4c,6,570,6.3,6,6,0,3,12,3,9,9.9,6.1,3.9,21,EL
f620b04f,1,8,0.1,0,0,1,5,0,0,0,0.0,0.0,0.0,21,EL
f63cda26,2,34,0.4,0,0,2,5,2,0,2,0.9,0.2,0.7,21,EL
f69d4d79,3,149,1.7,2,1,1,2,3,4,-1,1.5,4.0,-2.5,21,EL
f716e4e4,4,219,2.4,2,1,2,1,2,6,-4,3.7,4.8,-1.1,21,EL
f754c59e,8,630,7.0,8,1,0,0,12,12,0,13.1,11.3,1.8,21,EL
f7b10c66,8,720,8.0,8,8,0,0,15,10,5,13.5,10.0,3.5,21,EL
f7c491f1,7,308,3.4,3,2,4,5,3,4,-1,3.6,4.8,-1.2,21,EL
f7d50789,3,270,3.0,3,3,0,5,11,2,9,8.6,2.9,5.7,21,EL
f7dc2ae5,3,270,3.0,3,3,0,1,2,0,2,7.5,1.9,5.5,21,EL
f7e87032,4,315,3.5,4,3,0,0,2,5,-3,2.0,5.0,-3.0,21,EL
f80d03ca,5,143,1.6,2,0,3,0,2,2,0,2.2,1.9,0.2,21,EL
f820504e,4,331,3.7,4,3,0,3,10,4,6,9.1,2.8,6.2,21,EL
f8342731,10,872,9.7,10,9,0,0,14,15,-1,14.1,16.4,-2.2,21,EL
f874dd44,7,546,6.1,6,3,1,5,9,6,3,9.6,4.8,4.8,21,EL
f8fcd2a5,5,441,4.9,5,4,0,0,8,5,3,6.9,4.7,2.3,21,EL
f934cffd,3,254,2.8,3,2,0,0,2,6,-4,1.0,6.1,-5.1,21,EL
f94e06da,8,720,8.0,8,8,0,0,6,10,-4,8.9,8.7,0.2,21,EL
f9a72ca4,5,151,1.7,1,1,4,1,3,3,0,1.8,1.3,0.5,21,EL
f9acca3a,6,540,6.0,6,6,0,2,21,8,13,13.8,5.5,8.3,21,EL
f9c927de,9,576,6.4,6,3,3,0,10,11,-1,9.2,11.3,-2.1,21,EL
f9d5908e,4,131,1.5,1,0,3,1,1,5,-4,1.0,2.7,-1.6,21,EL
f9dfb7ae,2,180,2.0,2,2,0,4,1,5,-4,2.3,5.8,-3.5,21,EL
fa18c72e,6,238,2.6,2,0,4,0,5,4,1,4.3,4.7,-0.3,21,EL
fa265f6d,4,164,1.8,1,1,3,0,5,7,-2,3.6,6.3,-2.7,21,EL
fa73ccc7,2,92,1.0,1,0,1,0,1,2,-1,1.1,2.0,-1.0,21,EL
fae880d5,5,431,4.8,5,3,0,0,5,10,-5,5.2,9.9,-4.7,21,EL
fb37a645,1,90,1.0,1,1,0,3,2,2,0,2.9,1.1,1.9,21,EL
fb4558af,3,202,2.2,2,2,1,2,0,1,-1,1.3,1.2,0.2,21,EL
fb5d47b3,4,172,1.9,1,1,3,8,0,1,-1,0.8,2.2,-1.4,21,EL
fb614c44,6,459,5.1,5,5,1,0,11,5,6,9.6,5.5,4.1,21,EL
fc027d02,7,540,6.0,5,5,2,0,9,7,2,8.5,6.3,2.2,21,EL
fc056d1e,2,41,0.5,0,0,2,0,1,0,1,1.1,0.3,0.8,21,EL
fc1cf07a,4,360,4.0,4,4,0,1,2,11,-9,6.7,6.3,0.4,21,EL
fc46aab1,12,899,10.0,12,3,0,0,11,6,5,12.8,11.0,1.8,21,EL
fc4cf6a7,5,370,4.1,4,3,1,0,6,13,-7,5.0,7.4,-2.3,21,EL
fcb38f57,8,720,8.0,8,8,0,0,16,12,4,13.4,9.8,3.6,21,EL
fcb8b607,5,193,2.1,3,0,2,1,1,6,-5,2.5,4.0,-1.5,21,EL
fce2302c,9,428,4.8,4,3,5,1,8,4,4,7.7,3.0,4.7,21,EL
fd2bc67d,2,180,2.0,2,2,0,0,3,6,-3,2.3,2.7,-0.3,21,EL
fd4ee68b,3,256,2.8,3,1,0,0,2,9,-7,2.4,5.4,-3.0,21,EL
fd834d1d,2,180,2.0,2,2,0,6,3,3,0,3.0,3.0,-0.1,21,EL
fdbde523,11,797,8.9,9,6,2,1,15,7,8,9.0,11.5,-2.5,21,EL
fe192f45,3,266,3.0,3,2,0,0,1,5,-4,2.1,8.3,-6.2,21,EL
fe6c830a,6,534,5.9,6,4,0,0,4,10,-6,4.9,9.0,-4.2,21,EL
fe7d8182,2,180,2.0,2,2,0,1,1,4,-3,2.3,2.4,-0.2,21,EL
fefce889,5,450,5.0,5,5,0,0,10,3,7,12.2,4.3,7.9,21,EL
ff182fdc,4,201,2.2,2,0,2,0,6,1,5,5.6,2.5,3.1,21,EL
ff20acfe,1,70,0.8,1,0,0,3,2,2,0,0.9,1.2,-0.3,21,EL
ff226994,4,360,4.0,4,4,0,0,2,8,-6,3.2,7.2,-3.9,21,EL
ff497879,3,103,1.1,1,1,2,1,1,4,-3,0.5,4.0,-3.5,21,EL
ff764de3,5,326,3.6,4,1,1,0,4,5,-1,4.4,5.5,-1.1,21,EL
ff98492b,6,374,4.2,4,2,2,0,15,1,14,10.2,3.3,6.9,21,EL
ffbbc83b,7,395,4.4,4,1,3,0,7,4,3,9.7,4.1,5.5,21,EL
ffe5ecdb,5,159,1.8,2,0,3,1,3,3,0,4.3,3.4,0.9,21,EL
004d185e,30,2019,22.4,23,10,7,4,17,29,-12,14.7,35.2,-20.6,21,SPA
0076ab7f,30,1041,11.6,10,7,20,7,10,13,-3,13.8,14.2,-0.4,21,SPA
00b28772,35,2728,30.3,34,16,1,0,21,31,-10,24.7,32.8,-8.1,21,SPA
01e5f06e,29,792,8.8,4,1,25,9,3,14,-11,11.0,12.6,-1.6,21,SPA
01eb744d,38,2393,26.6,29,3,9,0,39,14,25,37.5,23.0,14.5,21,SPA
02319ad7,33,2037,22.6,23,8,10,2,14,24,-10,20.3,21.0,-0.7,21,SPA
02c15616,37,2956,32.8,33,26,4,0,59,24,35,44.2,32.7,11.5,21,SPA
036bba5f,30,2165,24.1,25,15,5,1,24,39,-15,27.6,30.9,-3.3,21,SPA
037dbd30,28,1106,12.3,10,6,18,10,9,18,-9,9.5,18.1,-8.6,21,SPA
039ae103,10,900,10.0,10,10,0,28,8,12,-4,9.2,10.3,-1.1,21,SPA
03dc5b1f,16,284,3.2,0,0,16,17,2,9,-7,4.7,9.2,-4.5,21,SPA
04965583,12,595,6.6,5,4,7,19,9,1,8,9.5,5.4,4.1,21,SPA
04981123,28,860,9.6,8,2,20,10,9,12,-3,7.4,13.9,-6.5,21,SPA
04ac8285,10,900,10.0,10,10,0,5,15,11,4,10.5,13.9,-3.4,21,SPA
04e17fd5,38,2311,25.7,23,7,15,0,39,24,15,38.5,25.7,12.8,21,SPA
056269d7,27,1901,21.1,23,15,4,5,49,20,29,38.9,22.5,16.4,21,SPA
05a4465d,25,1124,12.5,10,7,15,5,11,17,-6,12.8,15.5,-2.7,21,SPA
062fc2e6,19,1134,12.6,12,7,7,19,14,17,-3,16.0,18.2,-2.2,21,SPA
08511d65,15,1275,14.2,15,13,0,1,25,13,12,25.8,14.7,11.2,21,SPA
08990838,11,611,6.8,9,2,2,6,6,6,0,4.8,4.4,0.4,21,SPA
0959c2a2,24,1330,14.8,15,6,9,0,28,14,14,26.1,14.1,12.0,21,SPA
09a9e921,23,786,8.7,9,0,14,9,18,8,10,14.9,9.8,5.1,21,SPA
0a0cc13c,28,748,8.3,6,0,22,7,14,9,5,12.8,10.1,2.7,21,SPA
0a447501,16,932,10.4,10,1,6,3,15,20,-5,14.1,15.6,-1.5,21,SPA
0a8bcb23,12,523,5.8,5,2,7,25,5,7,-2,4.4,9.2,-4.9,21,SPA
0ac94a23,21,1101,12.2,13,0,8,3,19,21,-2,15.6,17.2,-1.6,21,SPA
0ae4e09a,33,2198,24.4,26,8,7,3,33,39,-6,26.3,32.8,-6.5,21,SPA
0b2c8585,36,2862,31.8,33,17,3,1,30,39,-9,24.5,47.9,-23.4,21,SPA
0b90bb97,34,2412,26.8,29,15,5,1,44,42,2,38.3,38.9,-0.6,21,SPA
0ba976e4,7,431,4.8,6,0,1,0,10,5,5,7.9,5.4,2.5,21,SPA
0bbab654,2,153,1.7,1,0,1,13,1,4,-3,1.5,3.8,-2.3,21,SPA
0bc4e720,30,950,10.6,9,1,21,8,18,15,3,14.7,15.5,-0.8,21,SPA
0c3f7197,11,500,5.6,6,0,5,6,6,8,-2,6.5,4.7,1.8,21,SPA
0c717ae6,1,90,1.0,1,1,0,4,0,2,-2,0.8,3.4,-2.5,21,SPA
0cc474e7,2,101,1.1,1,1,1,9,1,6,-5,1.6,3.3,-1.7,21,SPA
0d298637,1,45,0.5,0,0,1,1,0,0,0,0.8,1.4,-0.6,21,SPA
0d9b2d31,37,2415,26.8,28,6,9,0,66,26,40,56.8,26.4,30.4,21,SPA
0dce3356,3,65,0.7,0,0,3,9,0,2,-2,0.3,1.5,-1.2,21,SPA
0e4fef6e,25,1548,17.2,17,11,8,0,22,21,1,18.4,18.0,0.4,21,SPA
0e5ddc7c,34,1666,18.5,17,2,17,4,22,27,-5,16.5,26.4,-9.9,21,SPA
0ef89a37,12,654,7.3,8,1,4,1,14,7,7,14.4,9.6,4.9,21,SPA
0f7dbaf6,1,90,1.0,1,1,0,36,0,2,-2,0.5,1.0,-0.5,21,SPA
10072610,20,1800,20.0,20,20,0,5,25,25,0,27.4,24.6,2.8,21,SPA
11b9265b,5,193,2.1,2,0,3,6,6,3,3,3.4,4.0,-0.6,21,SPA
12c50af5,35,2852,31.7,34,22,1,1,50,51,-1,41.6,44.4,-2.8,21,SPA
12eda7be,12,838,9.3,9,7,3,5,7,17,-10,10.4,9.4,1.0,21,SPA
132ac341,24,2026,22.5,24,22,0,1,19,22,-3,20.0,22.5,-2.4,21,SPA
15781606,16,426,4.7,2,0,14,19,3,10,-7,6.3,8.1,-1.9,21,SPA
16aa3654,31,1104,12.2,10,2,21,7,11,13,-2,15.200000000000001,11.0,4.2,21,SPA
16e9d0ea,23,1786,19.8,20,17,3,13,27,32,-5,25.4,28.8,-3.4,21,SPA
174651c8,30,1395,15.5,15,7,15,5,10,14,-4,13.0,13.2,-0.2,21,SPA
18017beb,11,407,4.5,3,1,8,5,3,9,-6,3.3,4.4,-1.1,21,SPA
1827a42d,14,652,7.2,7,3,7,18,8,16,-8,9.9,10.8,-0.9,21,SPA
1840e36d,38,3420,38.0,38,38,0,0,67,28,39,61.5,37.6,23.9,21,SPA
18abe173,25,1289,14.3,14,11,11,10,26,22,4,20.1,19.1,1.0,21,SPA
19709006,20,511,5.7,4,0,16,14,10,7,3,8.1,4.7,3.4,21,SPA
19b776e9,21,1162,12.9,11,7,10,16,12,17,-5,13.0,20.9,-7.800000000000001,21,SPA
19c36442,16,1253,13.9,14,6,2,1,16,22,-6,14.2,19.6,-5.3,21,SPA
1a317a1b,8,504,5.6,5,4,3,7,1,8,-7,3.8,10.8,-7.0,21,SPA
1b40049a,21,453,5.0,2,0,19,16,5,9,-4,8.5,6.4,2.0,21,SPA
1bacc518,37,3154,35.0,35,29,2,0,78,35,43,67.8,37.7,30.1,21,SPA
1bda5842,37,2184,24.3,24,7,13,1,35,26,9,33.0,28.0,5.0,21,SPA
1c2c55fc,33,2944,32.7,33,32,0,3,30,48,-18,24.9,55.9,-31.0,21,SPA
1c772b46,2,34,0.4,0,0,2,3,0,0,0,0.2,0.2,0.0,21,SPA
1d1691ad,13,829,9.2,9,5,4,13,12,8,4,13.5,11.0,2.5,21,SPA
1daec722,37,3244,36.0,37,31,0,0,25,38,-13,32.6,37.3,-4.7,21,SPA
1e465e70,8,135,1.5,0,0,8,4,3,0,3,1.8,0.5,1.3,21,SPA
1f079188,19,1116,12.4,12,9,7,7,20,15,5,20.0,11.5,8.5,21,SPA
1fe0492d,31,2545,28.3,29,22,2,1,28,43,-15,33.2,34.8,-1.5,21,SPA
1fe67e86,23,1689,18.8,17,13,6,14,18,23,-5,19.2,19.2,0.0,21,SPA
200e89e1,31,1307,14.5,13,2,18,5,20,16,4,17.4,15.3,2.1,21,SPA
21512407,28,2475,27.5,28,26,0,0,47,13,34,38.2,27.3,10.9,21,SPA
217011a0,1,9,0.1,0,0,1,7,0,0,0,0.0,0.1,-0.1,21,SPA
228b0d9d,16,1210,13.4,14,12,2,11,19,13,6,21.6,15.0,6.6,21,SPA
237a3851,24,1159,12.9,12,5,12,11,7,20,-13,13.7,18.7,-5.1,21,SPA
23c5db70,1,18,0.2,0,0,1,8,2,1,1,1.2,0.9,0.3,21,SPA
23fffc06,4,72,0.8,0,0,4,4,0,1,-1,0.6,2.1,-1.5,21,SPA
240d3a0b,27,1920,21.3,21,15,6,8,23,25,-2,23.6,21.8,1.8,21,SPA
24279b8b,3,187,2.1,3,2,0,12,3,5,-2,2.6,3.6,-0.9,21,SPA
244f57b9,22,871,9.7,9,1,13,4,8,11,-3,10.6,14.2,-3.6,21,SPA
24f59bb2,7,289,3.2,3,2,4,28,7,2,5,5.5,4.2,1.3,21,SPA
253a06b9,8,202,2.2,2,0,6,2,3,1,2,3.1,2.5,0.6,21,SPA
2784f898,14,1133,12.6,13,12,1,13,26,7,19,18.7,12.0,6.7,21,SPA
27a013f7,33,2426,27.0,26,21,7,3,35,39,-4,34.5,36.7,-2.2,21,SPA
283c7121,31,2455,27.3,27,19,4,0,24,33,-9,36.1,31.7,4.4,21,SPA
2946f9a1,24,2000,22.2,22,21,2,9,40,14,26,35.4,21.7,13.7,21,SPA
29ad0dd4,1,2,0.0,0,0,1,1,0,0,0,0.0,0.0,0.0,21,SPA
29b61deb,22,1186,13.2,12,6,10,3,13,23,-10,14.9,14.6,0.3,21,SPA
2a0c8ba4,35,2406,26.7,28,8,7,0,37,22,15,35.9,25.1,10.7,21,SPA
2a8c9f98,17,505,5.6,4,1,13,19,8,6,2,8.0,5.8,2.3,21,SPA
2b6dc4d7,2,30,0.3,0,0,2,10,3,1,2,0.3,0.2,0.2,21,SPA
2bef2bca,24,1510,16.8,16,12,8,5,34,16,18,34.0,16.5,17.5,21,SPA
2ceb58ab,30,1277,14.2,11,5,19,3,10,28,-18,11.0,24.8,-13.8,21,SPA
2e5e846d,27,874,9.7,11,2,16,9,9,12,-3,10.8,12.7,-1.8,21,SPA
2f3e911a,19,1540,17.1,17,15,2,2,29,27,2,20.7,26.9,-6.2,21,SPA
3024e383,14,901,10.0,11,5,3,5,5,18,-13,12.6,9.6,3.0,21,SPA
307fcd26,16,1440,16.0,16,16,0,19,13,21,-8,14.5,18.7,-4.2,21,SPA
31f5b89b,10,378,4.2,4,1,6,21,6,3,3,7.3,4.3,3.0,21,SPA
32974271,29,1795,19.9,19,12,10,4,21,22,-1,21.7,24.4,-2.7,21,SPA
32c0491f,3,67,0.7,0,0,3,5,0,0,0,0.8,1.1,-0.3,21,SPA
335039a2,32,1981,22.0,22,9,10,5,20,29,-9,18.0,34.8,-16.8,21,SPA
335fa267,15,946,10.5,9,7,6,1,20,13,7,15.8,9.8,6.0,21,SPA
3376a776,11,653,7.3,6,4,5,24,10,4,6,7.2,7.1,0.1,21,SPA
33a61a52,35,2781,30.9,30,30,5,2,39,47,-8,35.4,39.3,-3.9,21,SPA
34269bdf,32,2701,30.0,32,23,0,1,40,41,-1,41.9,34.1,7.8,21,SPA
34caa4b3,3,27,0.3,0,0,3,10,2,0,2,1.1,0.4,0.7,21,SPA
34e393f2,35,2864,31.8,34,25,1,0,37,45,-8,38.7,39.4,-0.7,21,SPA
3521abfe,4,360,4.0,4,4,0,0,9,6,3,4.4,9.0,-4.6,21,SPA
355c883a,26,1558,17.3,16,11,10,12,19,31,-12,16.7,26.0,-9.3,21,SPA
35a6e5c7,6,118,1.3,1,0,5,10,0,3,-3,0.8,1.0,-0.2,21,SPA
3624ce4c,17,828,9.2,7,6,10,7,14,20,-6,9.7,16.7,-7.0,21,SPA
3672b352,13,460,5.1,6,0,7,20,6,6,0,6.2,7.4,-1.2,21,SPA
374ee424,38,3420,38.0,38,38,0,0,59,38,21,60.7,39.2,21.5,21,SPA
379dc075,32,2133,23.7,24,11,8,3,19,36,-17,23.9,33.8,-9.9,21,SPA
37e103f8,2,55,0.6,0,0,2,3,1,0,1,1.0,0.3,0.7,21,SPA
37f04799,12,910,10.1,9,8,3,15,4,14,-10,7.1000000000000005,13.899999999999999,-6.8,21,SPA
37f1cf47,28,2131,23.7,25,15,3,2,33,27,6,26.6,25.2,1.4,21,SPA
38699c72,29,1523,16.9,18,3,11,3,19,31,-12,17.5,25.7,-8.1,21,SPA
38ce1150,37,2186,24.3,22,8,15,0,34,38,-4,26.2,34.5,-8.2,21,SPA
3902e91b,29,1853,20.6,21,8,8,1,27,33,-6,22.9,26.3,-3.5,21,SPA
3a58d075,2,15,0.2,0,0,2,15,0,1,-1,0.2,0.5,-0.2,21,SPA
3a9c4b7b,34,2348,26.1,25,21,9,2,25,31,-6,26.4,33.6,-7.2,21,SPA
3aa4a3be,26,991,11.0,9,0,17,11,6,14,-8,9.0,14.3,-5.3,21,SPA
3aa74860,1,1,0.0,0,0,1,3,0,0,0,0.0,0.1,-0.1,21,SPA
3ae7e4ea,9,495,5.5,5,1,4,6,4,9,-5,2.9,11.4,-8.5,21,SPA
3afeb49f,2,14,0.2,0,0,2,2,0,1,-1,0.3,0.9,-0.6,21,SPA
3c16d927,30,2190,24.3,24,21,6,0,17,38,-21,27.0,34.0,-7.0,21,SPA
3ca6106c,16,486,5.4,3,0,13,0,9,4,5,6.0,7.3,-1.3,21,SPA
3cefcaef,26,2208,24.5,24,23,2,4,47,16,31,42.4,21.0,21.4,21,SPA
3d688b46,25,1321,14.7,16,5,9,10,12,30,-18,12.5,22.4,-9.9,21,SPA
3d7e48ce,22,827,9.2,6,0,16,12,10,13,-3,9.4,13.7,-4.2,21,SPA
3da1b6ed,3,23,0.3,0,0,3,6,0,1,-1,0.1,0.3,-0.2,21,SPA
3e42f707,35,3150,35.0,35,35,0,1,35,41,-6,34.3,42.9,-8.6,21,SPA
3e8bb8ce,1,8,0.1,0,0,1,8,0,0,0,0.1,0.0,0.1,21,SPA
3ecc11d8,23,1948,21.6,22,21,1,3,29,26,3,26.0,24.3,1.7,21,SPA
3ed84b2c,3,36,0.4,0,0,3,6,0,0,0,0.9,0.5,0.4,21,SPA
3ee0dd59,31,1882,20.9,17,15,14,3,32,26,6,32.5,25.7,6.9,21,SPA
3eed9821,13,645,7.2,6,5,7,14,21,4,17,14.8,4.4,10.4,21,SPA
3f10bd22,34,2827,31.4,34,25,0,1,42,31,11,43.0,29.7,13.3,21,SPA
3fc45c73,28,2519,28.0,28,27,0,3,33,34,-1,31.9,27.0,4.9,21,SPA
40449bbd,14,1111,12.3,12,7,2,22,10,16,-6,13.0,18.0,-5.0,21,SPA
405f267a,28,1933,21.5,25,5,3,1,17,31,-14,15.4,31.4,-16.0,21,SPA
4112ace5,28,1701,18.9,19,9,9,9,25,18,7,18.9,20.1,-1.2,21,SPA
418f8f61,22,946,10.5,10,1,12,14,11,21,-10,10.0,15.6,-5.6,21,SPA
41c12f75,31,2614,29.0,30,24,1,1,20,25,-5,26.8,27.8,-1.0,21,SPA
41f32541,31,2546,28.3,28,25,3,4,42,27,15,42.4,25.7,16.7,21,SPA
41fb0f4e,8,341,3.8,5,0,3,8,5,8,-3,3.9,4.3,-0.5,21,SPA
42276181,27,1077,12.0,10,2,17,3,17,17,0,14.1,14.2,-0.1,21,SPA
42a028c5,1,35,0.4,0,0,1,1,0,1,-1,0.0,1.0,-0.9,21,SPA
43f71e77,33,1615,17.9,17,6,16,5,25,36,-11,22.2,27.4,-5.1,21,SPA
44150beb,1,32,0.4,0,0,1,7,1,0,1,1.4,0.1,1.2,21,SPA
4442fbcd,13,810,9.0,11,4,2,3,11,10,1,9.6,15.1,-5.5,21,SPA
452c3055,15,393,4.4,3,0,12,14,6,15,-9,5.7,9.2,-3.4,21,SPA
45af8a54,35,1869,20.8,21,1,14,1,37,17,20,30.6,23.7,6.8,21,SPA
45d96179,25,1988,22.1,21,16,4,7,30,25,5,0.0,0.0,0.0,21,SPA
45e17712,32,2663,29.6,32,23,0,1,37,50,-13,32.9,40.4,-7.6,21,SPA
45e304c8,1,21,0.2,0,0,1,18,0,1,-1,0.6,0.3,0.2,21,SPA
4601e194,35,3025,33.6,34,28,1,1,79,34,45,66.4,35.4,31.1,21,SPA
466824fb,32,2084,23.2,24,11,8,2,20,34,-14,22.4,32.2,-9.8,21,SPA
467bae22,15,164,1.8,1,0,14,22,4,5,-1,2.5,2.7,-0.1,21,SPA
46a8347f,9,519,5.8,6,3,3,18,13,6,7,7.6,6.1,1.6,21,SPA
46bd3a5b,15,1136,12.6,13,8,2,7,12,10,2,18.2,10.5,7.7,21,SPA
4737cebe,27,1014,11.3,12,0,15,5,24,10,14,24.2,7.6,16.5,21,SPA
474ecac8,22,1623,18.0,19,15,3,7,22,28,-6,20.8,21.8,-0.9,21,SPA
47d493c3,12,600,6.7,6,2,6,12,5,9,-4,4.6,10.7,-6.1,21,SPA
487d9b09,27,2235,24.8,26,22,1,5,26,35,-9,19.9,39.9,-20.0,21,SPA
48e89655,9,361,4.0,3,0,6,1,3,5,-2,4.9,3.3,1.6,21,SPA
4958bfb2,13,950,10.6,11,7,2,0,19,6,13,16.5,9.2,7.3,21,SPA
49ea92be,10,311,3.5,4,0,6,12,3,8,-5,3.3,4.6,-1.3,21,SPA
4a478107,38,2439,27.1,30,6,8,0,36,42,-6,31.0,37.6,-6.6,21,SPA
4a633cfe,17,1242,13.8,13,9,4,19,17,22,-5,17.6,20.8,-3.3,21,SPA
4a895384,11,883,9.8,9,9,2,25,6,11,-5,7.0,11.0,-4.0,21,SPA
4aa253fd,4,237,2.6,3,0,1,1,3,4,-1,2.6,3.4,-0.8,21,SPA
4ac7608e,19,1280,14.2,15,12,4,9,11,20,-9,12.2,19.6,-7.4,21,SPA
4accb7e0,16,909,10.1,9,4,7,5,11,12,-1,10.8,12.6,-1.8,21,SPA
4b3c863f,3,181,2.0,2,2,1,14,1,3,-2,0.8,1.7,-0.9,21,SPA
4b5e7e90,20,1587,17.6,17,13,3,9,17,25,-8,21.1,23.8,-2.7,21,SPA
4bd414c1,35,3115,34.6,35,31,0,2,51,42,9,51.1,38.8,12.3,21,SPA
4c0a6a48,17,831,9.2,8,4,9,9,15,10,5,16.6,8.7,7.9,21,SPA
4c2e9442,31,2689,29.9,31,20,0,1,41,37,4,32.6,41.3,-8.7,21,SPA
4c5b14d2,27,1291,14.3,16,1,11,9,24,18,6,16.8,19.4,-2.6,21,SPA
4cee5954,32,2875,31.9,32,29,0,3,33,44,-11,41.4,39.8,1.5,21,SPA
4d1666ff,34,2975,33.1,33,32,1,1,48,28,20,47.0,30.6,16.4,21,SPA
4d224fe8,34,2901,32.2,32,29,2,0,59,20,39,54.6,27.8,26.8,21,SPA
4d8cd038,4,149,1.7,2,0,2,8,2,2,0,4.4,1.4,3.0,21,SPA
4dbd0916,27,1366,15.2,19,1,8,2,28,11,17,20.1,13.1,6.9,21,SPA
4e219ad2,34,2210,24.6,28,1,6,0,38,20,18,36.4,21.9,14.5,21,SPA
4f28a6ff,33,2475,27.5,29,23,4,2,61,29,32,54.0,29.6,24.3,21,SPA
5083a734,32,2310,25.7,25,18,7,0,34,36,-2,29.1,33.5,-4.4,21,SPA
518f2234,6,137,1.5,2,0,4,32,0,2,-2,1.3,0.9,0.4,21,SPA
51a3c4c8,31,2057,22.9,23,20,8,6,36,18,18,29.3,25.0,4.3,21,SPA
51e3954c,17,1232,13.7,14,9,3,11,12,19,-7,15.3,15.3,-0.1,21,SPA
52611641,19,518,5.8,3,1,16,13,9,4,5,7.5,7.1,0.4,21,SPA
529f49ab,3,200,2.2,2,2,1,0,3,1,2,3.2,2.1,1.1,21,SPA
532e1e4f,33,2970,33.0,33,33,0,3,51,34,17,45.4,35.1,10.3,21,SPA
5343eb4e,26,1122,12.5,13,3,13,4,10,18,-8,15.9,15.2,0.7,21,SPA
53520a67,35,2615,29.1,33,16,2,1,32,38,-6,26.4,35.3,-8.9,21,SPA
54073b28,17,734,8.2,8,3,9,13,7,14,-7,11.7,10.6,1.1,21,SPA
540ec57b,24,797,8.9,6,1,18,5,14,8,6,13.2,11.0,2.2,21,SPA
5496cc91,27,1549,17.2,16,5,11,5,19,33,-14,18.0,29.0,-11.0,21,SPA
55126f3b,37,3021,33.6,34,27,3,0,59,22,37,47.1,32.7,14.4,21,SPA
555f3a0b,31,2578,28.6,30,24,1,4,42,17,25,36.5,27.7,8.7,21,SPA
56cafd0a,2,135,1.5,1,1,1,9,1,3,-2,1.3,3.8,-2.5,21,SPA
57be54ec,35,1589,17.7,16,3,19,1,17,15,2,19.0,15.2,3.7,21,SPA
58a9a4d9,33,1400,15.6,15,3,18,5,19,15,4,21.9,14.8,7.0,21,SPA
58afe001,34,2983,33.1,33,26,1,2,26,35,-9,30.7,35.4,-4.7,21,SPA
5976f83e,30,1909,21.2,23,9,7,5,43,18,25,42.2,24.5,17.8,21,SPA
59b7d823,18,644,7.2,5,3,13,17,6,6,0,8.7,7.6,1.1,21,SPA
5a36f180,23,857,9.5,7,1,16,12,8,22,-14,11.6,15.6,-3.9,21,SPA
5a626448,35,2563,28.5,29,14,6,0,46,34,12,38.7,32.2,6.6,21,SPA
5ab0ea87,36,2517,28.0,32,13,4,0,64,30,34,53.0,31.0,21.9,21,SPA
5acc4a10,16,1185,13.2,15,4,1,2,22,14,8,17.9,16.7,1.3,21,SPA
5b28b2f6,33,1926,21.4,24,7,9,3,17,28,-11,15.7,37.0,-21.2,21,SPA
5c4dc0ff,16,513,5.7,5,1,11,10,6,4,2,7.2,8.7,-1.5,21,SPA
5c7845f6,24,1959,21.8,21,19,3,3,27,26,1,31.8,25.5,6.3,21,SPA
5c96b017,37,2718,30.2,33,9,4,0,29,38,-9,28.5,37.0,-8.5,21,SPA
5ca20b7a,12,639,7.1,6,4,6,7,6,8,-2,9.8,5.5,4.2,21,SPA
5ce0b5ba,6,337,3.7,6,0,0,6,8,2,6,6.5,1.5,5.0,21,SPA
5cec2487,5,239,2.7,2,1,3,22,1,4,-3,1.9,5.4,-3.5,21,SPA
5db04597,25,1964,21.8,25,11,0,2,25,33,-8,21.4,27.1,-5.8,21,SPA
5dcf3e90,37,3330,37.0,37,37,0,1,46,40,6,42.6,36.7,5.9,21,SPA
5dd16ace,1,90,1.0,1,1,0,0,0,2,-2,0.7,0.8,-0.1,21,SPA
5e95c000,2,50,0.6,1,0,1,10,0,2,-2,0.1,1.0,-0.9,21,SPA
5eebbfdf,28,1471,16.3,18,4,10,2,19,21,-2,15.6,25.1,-9.5,21,SPA
6025fab1,35,2733,30.4,32,18,3,1,50,23,27,46.3,30.7,15.7,21,SPA
603116a7,16,1050,11.7,12,6,4,17,16,10,6,19.5,13.0,6.5,21,SPA
60359288,16,921,10.2,11,6,5,7,5,18,-13,10.0,17.1,-7.0,21,SPA
608bcb88,1,2,0.0,0,0,1,3,1,0,1,0.2,0.0,0.2,21,SPA
608f2092,17,1204,13.4,14,11,3,0,11,22,-11,9.8,20.5,-10.6,21,SPA
61220da2,9,748,8.3,8,8,1,0,8,13,-5,10.0,11.4,-1.5,21,SPA
61bb7498,4,300,3.3,3,3,1,34,1,3,-2,4.1,1.2,2.9,21,SPA
61bd33d0,28,1819,20.2,22,8,6,10,15,25,-10,24.5,24.4,0.1,21,SPA
625c144a,2,180,2.0,2,2,0,32,3,6,-3,2.1,2.9,-0.8,21,SPA
6265208f,37,3026,33.6,34,20,3,0,32,50,-18,38.6,42.8,-4.2,21,SPA
636eae97,21,969,10.8,10,0,11,15,13,11,2,12.5,12.4,0.1,21,SPA
63b0ca6b,35,2198,24.4,29,4,6,0,21,41,-20,20.9,37.2,-16.3,21,SPA
63d17038,8,720,8.0,8,8,0,11,7,9,-2,8.4,8.4,-0.1,21,SPA
63f04c6c,29,2093,23.3,24,12,5,5,36,29,7,33.6,25.2,8.3,21,SPA
64a76620,1,22,0.2,0,0,1,10,0,2,-2,0.1,1.0,-0.9,21,SPA
64e8ed6d,2,23,0.3,0,0,2,1,1,0,1,1.5,0.1,1.3,21,SPA
6583a8a9,3,253,2.8,3,2,0,18,2,2,0,2.0,4.6,-2.6,21,SPA
67669ce7,5,450,5.0,5,5,0,31,5,8,-3,4.2,7.2,-3.0,21,SPA
683788fd,4,26,0.3,0,0,4,4,0,2,-2,0.4,1.2,-0.8,21,SPA
685857dc,23,779,8.7,7,2,16,8,7,12,-5,10.8,11.5,-0.7,21,SPA
68796d61,25,1128,12.5,14,3,11,9,9,14,-5,12.3,16.1,-3.8,21,SPA
689c9cf4,19,1220,13.6,14,5,5,3,12,16,-4,14.6,17.4,-2.7,21,SPA
6922f806,25,1544,17.2,20,3,5,2,14,18,-4,16.9,17.0,-0.2,21,SPA
697295b1,21,1529,17.0,19,15,2,5,13,22,-9,20.9,20.2,0.7,21,SPA
69c5633e,1,45,0.5,0,0,1,9,1,2,-1,0.9,1.1,-0.2,21,SPA
6a99e0b1,38,2387,26.5,27,9,11,0,37,31,6,30.7,27.0,3.7,21,SPA
6c4776b1,32,2880,32.0,32,32,0,3,28,45,-17,28.4,45.9,-17.5,21,SPA
6c7762c3,16,1168,13.0,13,9,3,7,21,21,0,20.7,17.3,3.4,21,SPA
6c811eb7,24,1414,15.7,15,6,9,14,11,21,-10,17.0,17.3,-0.09999999999999987,21,SPA
6ce1f46f,28,2117,23.5,24,17,4,3,41,21,20,36.0,24.5,11.6,21,SPA
6d8f8441,17,835,9.3,11,1,6,20,11,13,-2,8.1,15.6,-7.5,21,SPA
6e36226f,1,67,0.7,1,0,0,2,0,2,-2,0.0,3.1,-3.1,21,SPA
6e4df551,18,914,10.2,11,1,7,1,16,6,10,14.8,6.0,8.8,21,SPA
6eaed4eb,34,3015,33.5,34,33,0,0,34,53,-19,38.7,45.4,-6.7,21,SPA
6f4c734d,22,1451,16.1,18,3,4,2,18,16,2,14.4,22.6,-8.2,21,SPA
6f51e382,31,2790,31.0,31,31,0,0,74,32,42,64.5,31.1,33.4,21,SPA
6f5f82c0,32,2382,26.5,28,16,4,4,46,23,23,46.2,26.5,19.7,21,SPA
70d74ece,34,2894,32.2,33,24,1,0,63,24,39,54.7,28.7,26.0,21,SPA
7111d552,35,1969,21.9,22,7,13,2,35,17,18,35.8,23.4,12.4,21,SPA
719384c1,22,1362,15.1,17,4,5,3,21,21,0,16.6,18.0,-1.4,21,SPA
71b47ab9,23,1466,16.3,18,5,5,0,13,17,-4,12.4,18.3,-5.9,21,SPA
72a84002,34,2637,29.3,29,23,5,2,28,44,-16,27.3,43.0,-15.7,21,SPA
72a99e38,29,1283,14.3,12,2,17,5,23,22,1,19.2,20.1,-0.9,21,SPA
72b07a9c,5,177,2.0,1,1,4,3,3,4,-1,3.0,2.9,0.1,21,SPA
7329018e,33,2324,25.8,28,12,5,1,20,31,-11,29.6,29.5,0.1,21,SPA
7460ca0d,36,3112,34.6,36,28,0,0,56,43,13,51.7,39.6,12.0,21,SPA
74aa6ab7,1,90,1.0,1,1,0,11,0,3,-3,0.7,2.3,-1.6,21,SPA
74d9a90b,4,47,0.5,0,0,4,12,0,1,-1,0.6,0.8,-0.2,21,SPA
75645f0e,28,1411,15.7,15,3,13,7,24,11,13,23.8,15.5,8.3,21,SPA
76d679c7,16,622,6.9,7,2,9,19,11,11,0,9.1,9.0,0.1,21,SPA
77e39b04,28,706,7.8,3,1,25,10,22,7,15,14.9,12.0,2.9,21,SPA
788be7f9,1,73,0.8,1,0,0,15,2,1,1,0.6,0.8,-0.2,21,SPA
78c40e94,12,369,4.1,4,0,8,11,4,9,-5,2.9,7.1,-4.2,21,SPA
79300479,7,234,2.6,3,0,4,6,4,2,2,4.9,2.1,2.8,21,SPA
7a538238,19,1191,13.2,12,11,7,3,19,28,-9,15.4,21.2,-5.7,21,SPA
7b456af7,5,450,5.0,5,5,0,21,7,5,2,7.7,4.6,3.1,21,SPA
7b5ab7f2,29,2278,25.3,26,16,3,1,22,29,-7,35.0,29.5,5.5,21,SPA
7c388b20,36,2517,28.0,30,11,6,0,24,43,-19,28.4,37.3,-8.9,21,SPA
7c4243d4,25,1761,19.6,21,6,4,6,14,24,-10,18.9,25.7,-6.9,21,SPA
7dcf86f6,33,2864,31.8,33,25,0,1,47,44,3,42.4,40.0,2.4,21,SPA
7e98cff1,6,316,3.5,3,2,3,4,9,3,6,4.4,4.2,0.2,21,SPA
7f203b54,10,557,6.2,7,5,3,23,4,10,-6,4.9,6.3,-1.4,21,SPA
7f4c7c9f,26,1732,19.2,19,11,7,6,30,34,-4,25.2,27.2,-2.0,21,SPA
80153344,2,96,1.1,1,1,1,10,1,3,-2,1.1,2.4,-1.4,21,SPA
808d48f3,14,351,3.9,3,0,11,22,5,6,-1,6.0,5.3,0.7,21,SPA
81442ecb,30,2330,25.9,26,22,4,1,37,28,9,41.1,23.8,17.3,21,SPA
81d5c497,17,593,6.6,8,0,9,19,11,10,1,11.5,8.3,3.3,21,SPA
81f0781e,33,2673,29.7,30,19,3,0,53,34,19,45.9,34.2,11.7,21,SPA
82803509,15,291,3.2,3,0,12,20,2,4,-2,3.9,3.4,0.5,21,SPA
82e9b89d,22,806,9.0,8,1,14,15,7,9,-2,8.4,12.4,-4.1,21,SPA
833fb62e,20,1285,14.3,16,3,4,3,15,14,1,13.6,13.7,0.0,21,SPA
84399660,16,604,6.7,5,0,11,14,11,14,-3,10.5,7.5,2.9,21,SPA
8455ad90,24,1262,14.0,15,1,9,11,16,17,-1,13.6,19.7,-6.1,21,SPA
850c0a0d,34,2807,31.2,30,30,4,0,23,46,-23,37.8,36.9,0.9,21,SPA
85bed4ee,15,537,6.0,5,0,10,12,11,12,-1,8.9,8.8,0.0,21,SPA
868ce848,2,110,1.2,1,1,1,3,0,2,-2,1.3,0.6,0.6,21,SPA
8696bc90,24,845,9.4,9,1,15,10,12,2,10,13.8,7.1,6.6,21,SPA
877f31c2,5,141,1.6,1,0,4,11,0,6,-6,0.9,3.6,-2.7,21,SPA
88050721,26,1424,15.8,15,4,11,9,17,18,-1,17.6,14.3,3.3,21,SPA
88a359d4,17,481,5.3,5,0,12,11,6,5,1,6.1,7.0,-0.9,21,SPA
88d91621,27,1568,17.4,17,12,10,11,10,28,-18,14.0,24.6,-10.6,21,SPA
8970907e,37,2527,28.1,29,9,8,1,28,34,-6,30.5,28.8,1.7,21,SPA
89cbc961,10,727,8.1,8,7,2,26,14,10,4,12.9,9.8,3.1,21,SPA
89d1e9fa,1,16,0.2,0,0,1,3,0,0,0,0.0,0.1,-0.1,21,SPA
89f951b5,37,2233,24.8,25,7,12,0,38,21,17,36.2,23.6,12.6,21,SPA
8a6daac3,5,145,1.6,0,0,5,6,1,2,-1,0.7,2.2,-1.5,21,SPA
8aafd64f,31,1572,17.5,14,3,17,0,33,14,19,27.3,16.3,11.0,21,SPA
8abefbcf,2,49,0.5,1,0,1,14,2,0,2,0.1,0.2,0.0,21,SPA
8b625720,12,850,9.4,8,7,4,19,7,14,-7,7.8,12.9,-5.1,21,SPA
8c2c48a9,9,251,2.8,2,1,7,9,3,4,-1,3.9,3.4,0.5,21,SPA
8c3c640c,33,2408,26.8,30,6,3,0,45,24,21,45.3,27.2,18.2,21,SPA
8c5f1522,17,668,7.4,7,0,10,9,7,13,-6,7.9,12.0,-4.1,21,SPA
8cfc2f69,33,1374,15.3,12,5,21,4,12,22,-10,14.2,15.2,-1.0,21,SPA
8d47bb39,22,1797,20.0,21,16,1,4,23,26,-3,19.9,25.1,-5.2,21,SPA
8d6a9c93,3,259,2.9,3,1,0,12,2,6,-4,4.2,4.3,-0.1,21,SPA
8db394aa,31,2375,26.4,28,21,3,4,21,34,-13,30.0,31.7,-1.7,21,SPA
8e010ff4,16,418,4.6,3,1,13,19,5,6,-1,6.0,6.5,-0.5,21,SPA
8e088e04,15,728,8.1,8,5,7,19,6,11,-5,8.8,11.8,-3.0,21,SPA
8e48dc61,31,2081,23.1,25,13,6,7,33,27,6,34.6,28.9,5.7,21,SPA
8e92be30,34,2340,26.0,30,5,4,4,39,22,17,41.6,24.6,17.1,21,SPA
8f29e08b,3,270,3.0,3,3,0,25,3,3,0,3.0,4.5,-1.5,21,SPA
8f3565b3,30,1625,18.1,18,7,12,1,21,30,-9,20.5,26.2,-5.7,21,SPA
8f5e92a6,22,983,10.9,10,1,12,7,22,4,18,20.2,9.0,11.2,21,SPA
8f898ba8,21,1002,11.1,11,4,10,1,14,18,-4,8.7,17.3,-8.6,21,SPA
8f8c6934,28,2520,28.0,28,28,0,10,20,31,-11,25.2,30.0,-4.8,21,SPA
8fae77ea,25,2250,25.0,25,25,0,9,24,40,-16,26.3,35.2,-9.0,21,SPA
9038c2a1,17,441,4.9,4,1,13,16,7,7,0,5.6,9.8,-4.3,21,SPA
90f83973,11,451,5.0,4,2,7,23,6,10,-4,4.3,8.1,-3.8,21,SPA
92d38e6c,36,3071,34.1,34,31,2,1,30,49,-19,36.0,43.4,-7.4,21,SPA
93090f69,29,2363,26.3,27,23,2,1,31,48,-17,28.8,37.4,-8.7,21,SPA
933e8c8a,2,103,1.1,2,1,0,0,1,2,-1,0.8,1.1,-0.3,21,SPA
94084f83,2,180,2.0,2,2,0,2,3,3,0,2.3,2.7,-0.3,21,SPA
954c26c9,1,45,0.5,0,0,1,0,0,0,0,0.8,1.4,-0.6,21,SPA
958d67bb,4,30,0.3,0,0,4,13,0,1,-1,0.4,0.6,-0.1,21,SPA
963829d0,35,2527,28.1,30,12,5,1,47,31,16,40.7,30.9,9.8,21,SPA
967f34d3,19,1637,18.2,19,17,0,1,28,27,1,27.0,20.4,6.6,21,SPA
968a1c2f,5,100,1.1,1,0,4,13,2,1,1,2.9,1.3,1.6,21,SPA
974322dc,10,605,6.7,7,5,3,7,4,8,-4,6.8,5.6,1.2,21,SPA
97572117,31,2323,25.8,28,15,3,3,17,27,-10,20.7,26.6,-5.9,21,SPA
97852360,38,3349,37.2,37,37,1,0,36,57,-21,42.1,49.7,-7.7,21,SPA
978cd030,33,2885,32.1,32,29,1,3,30,45,-15,32.4,40.8,-8.4,21,SPA
9939e168,36,2660,29.6,28,18,8,0,28,39,-11,30.0,38.8,-8.9,21,SPA
9970da54,1,71,0.8,1,0,0,37,0,0,0,0.5,0.2,0.3,21,SPA
99bebd12,10,208,2.3,1,0,9,23,2,5,-3,2.0,4.5,-2.4,21,SPA
9a64e67e,33,2747,30.5,30,26,3,3,47,31,16,48.3,32.3,16.0,21,SPA
9d2a3d5f,13,424,4.7,4,0,9,11,4,5,-1,4.2,4.6,-0.5,21,SPA
9d66fbe3,29,1438,16.0,16,1,13,1,21,25,-4,17.4,24.5,-7.2,21,SPA
9f0ea33f,36,3240,36.0,36,36,0,2,58,40,18,54.3,39.6,14.7,21,SPA
9f323c71,25,1520,16.9,17,10,8,6,21,22,-1,19.8,17.7,2.1,21,SPA
9f351459,23,1398,15.5,18,5,5,7,12,18,-6,16.3,18.4,-2.1,21,SPA
9f8e9423,31,2715,30.2,31,29,0,2,50,23,27,51.0,29.0,22.0,21,SPA
9f9e1b9c,3,60,0.7,0,0,3,16,1,2,-1,0.9,1.4,-0.4,21,SPA
a01c3d54,29,2610,29.0,29,29,0,7,38,44,-6,33.6,36.2,-2.6,21,SPA
a039d52e,2,16,0.2,0,0,2,5,0,0,0,0.5,0.0,0.4,21,SPA
a08b974a,34,2631,29.2,30,12,4,0,37,25,12,44.7,24.4,20.3,21,SPA
a0b4bb3e,25,908,10.1,8,1,17,9,16,10,6,15.7,13.9,1.8,21,SPA
a10361d2,11,437,4.9,5,0,6,9,2,10,-8,4.3,7.5,-3.2,21,SPA
a1216563,23,1139,12.7,12,5,11,6,13,22,-9,10.1,22.1,-12.0,21,SPA
a190d597,7,208,2.3,2,0,5,0,5,0,5,5.6,2.6,3.0,21,SPA
a300ac7e,28,1759,19.5,19,5,9,4,19,28,-9,22.1,23.9,-1.8,21,SPA
a39bb753,14,532,5.9,7,0,7,1,12,4,8,6.5,6.1,0.4,21,SPA
a4971d84,34,2941,32.7,34,30,0,0,28,35,-7,32.3,33.4,-1.1,21,SPA
a4995f48,33,2958,32.9,32,32,1,4,31,40,-9,33.1,39.6,-6.6,21,SPA
a4b00319,37,3065,34.1,34,29,3,0,32,47,-15,34.0,44.1,-10.1,21,SPA
a4fe8cda,7,108,1.2,0,0,7,5,1,1,0,1.4,2.1,-0.7,21,SPA
a55d8df5,28,1593,17.7,21,2,7,8,17,25,-8,21.1,19.9,1.3,21,SPA
a56da3ba,26,1962,21.8,23,15,3,10,16,29,-13,19.3,28.5,-9.1,21,SPA
a60823a4,22,1067,11.9,10,5,12,11,8,14,-6,12.0,11.6,0.5,21,SPA
a6154613,32,2508,27.9,30,13,2,0,46,21,25,34.3,26.5,7.9,21,SPA
a62b4888,29,2064,22.9,23,16,6,7,23,27,-4,21.7,29.8,-8.1,21,SPA
a6951bf8,22,736,8.2,7,0,15,2,10,12,-2,10.5,9.1,1.4,21,SPA
a6de370d,31,2498,27.8,28,20,3,0,38,30,8,38.0,31.0,7.0,21,SPA
a75b4071,3,115,1.3,1,0,2,12,1,3,-2,0.9,3.5,-2.7,21,SPA
a7a9d95a,27,1544,17.2,19,1,8,2,25,22,3,23.5,19.1,4.5,21,SPA
a7f00c8c,5,179,2.0,2,0,3,13,3,5,-2,2.0,3.6,-1.6,21,SPA
a83d8b0c,20,918,10.2,10,3,10,6,4,18,-14,9.6,17.9,-8.3,21,SPA
a8542814,16,682,7.6,8,2,8,8,21,4,17,13.1,6.8,6.4,21,SPA
a8fbae1d,31,2641,29.3,29,28,2,3,23,38,-15,34.0,34.9,-0.9,21,SPA
a98f3cbf,22,543,6.0,4,0,18,16,6,13,-7,7.5,7.9,-0.4,21,SPA
a9dc785c,7,630,7.0,7,7,0,28,11,6,5,9.1,9.8,-0.7,21,SPA
aa0ac32d,29,2060,22.9,23,16,6,7,29,36,-7,24.4,33.9,-9.5,21,SPA
aa677a35,25,1946,21.6,21,14,4,0,21,29,-8,21.2,24.3,-3.1,21,SPA
aa7da569,1,61,0.7,1,0,0,3,1,1,0,1.0,1.1,-0.1,21,SPA
aad53e64,33,1433,15.9,17,1,16,5,15,15,0,14.9,17.6,-2.7,21,SPA
ab99e4a0,2,66,0.7,1,0,1,7,1,1,0,0.9,1.1,-0.2,21,SPA
abb3bb95,34,1268,14.1,14,1,20,4,18,13,5,19.5,11.5,8.0,21,SPA
ac295d9e,35,3120,34.7,35,34,0,1,28,49,-21,41.1,44.5,-3.3,21,SPA
ac7e7b1c,12,542,6.0,5,1,7,2,6,9,-3,6.6,8.5,-1.9,21,SPA
ac8b2421,11,743,8.3,8,7,3,7,4,12,-8,6.0,11.9,-5.9,21,SPA
ad178594,2,168,1.9,2,1,0,17,1,6,-5,2.2,6.1,-3.9,21,SPA
ad1ffcfd,13,928,10.3,10,8,3,0,15,5,10,15.2,7.7,7.4,21,SPA
ad6df2d5,19,627,7.0,6,1,13,17,10,6,4,13.7,6.8,6.9,21,SPA
adfc9123,18,1481,16.5,18,13,0,1,34,22,12,30.9,16.5,14.5,21,SPA
ae86d473,23,1177,13.1,11,6,12,0,16,21,-5,18.8,20.5,-1.7,21,SPA
aed746df,33,2090,23.2,26,3,7,2,20,29,-9,22.4,28.0,-5.6,21,SPA
afafac57,3,52,0.6,0,0,3,24,0,1,-1,0.6,0.5,0.0,21,SPA
afdc14d7,2,57,0.6,0,0,2,3,2,2,0,1.3,0.8,0.5,21,SPA
b05e2dbd,33,2846,31.6,32,29,1,1,47,47,0,37.1,43.9,-6.8,21,SPA
b0616e3d,9,565,6.3,7,2,2,13,6,3,3,5.7,5.1,0.6,21,SPA
b0fce72c,30,1722,19.1,20,11,10,7,27,24,3,24.2,18.4,5.7,21,SPA
b14d0c5d,11,697,7.7,7,7,4,21,8,14,-6,10.4,10.8,-0.4,21,SPA
b14f755d,33,2645,29.4,30,22,3,0,25,43,-18,21.7,43.8,-22.0,21,SPA
b19db005,30,1774,19.7,19,5,11,3,41,19,22,34.5,20.6,13.9,21,SPA
b1e5bbec,1,90,1.0,1,1,0,0,0,2,-2,0.8,3.4,-2.5,21,SPA
b233e8e4,31,2699,30.0,31,27,0,1,39,45,-6,40.6,36.6,3.9,21,SPA
b2d0ec1b,36,2597,28.9,35,4,1,1,45,38,7,40.9,36.4,4.5,21,SPA
b39a793e,13,300,3.3,2,0,11,2,3,5,-2,3.2,4.9,-1.7,21,SPA
b3b62f94,24,1825,20.3,22,18,2,6,17,31,-14,18.0,29.3,-11.4,21,SPA
b3dc6eca,27,2157,24.0,24,22,3,7,33,31,2,30.5,28.1,2.3,21,SPA
b3f97139,1,15,0.2,0,0,1,0,0,0,0,0.8,0.1,0.8,21,SPA
b418dbd4,34,1743,19.4,21,8,13,0,21,28,-7,23.7,20.0,3.7,21,SPA
b4a014b1,33,2788,31.0,32,28,1,1,42,26,16,45.8,27.0,18.9,21,SPA
b51b1b9c,32,1530,17.0,17,1,15,5,22,25,-3,16.3,22.6,-6.3,21,SPA
b5dd3469,21,1121,12.5,13,8,8,4,18,22,-4,14.7,15.4,-0.7,21,SPA
b6e50615,23,1682,18.7,21,15,2,3,26,19,7,22.3,18.0,4.2,21,SPA
b742cc0d,19,1694,18.8,19,18,0,6,23,27,-4,21.7,25.6,-3.9,21,SPA
b7c04927,22,1297,14.4,15,9,7,13,11,26,-15,14.3,20.1,-5.8,21,SPA
b7c99b9b,32,2631,29.2,30,25,2,5,32,46,-14,35.5,39.9,-4.4,21,SPA
b7ca5c51,31,2716,30.2,31,30,0,0,43,44,-1,35.0,42.8,-7.8,21,SPA
b7d7f3bf,30,1363,15.1,16,3,14,8,14,12,2,14.6,15.6,-1.0,21,SPA
b7f2edff,14,362,4.0,4,1,10,22,6,11,-5,5.800000000000001,9.0,-3.2,21,SPA
b86a64b2,25,2073,23.0,24,20,1,4,23,36,-13,24.8,31.2,-6.4,21,SPA
b8a642fc,28,1365,15.2,13,3,15,1,21,19,2,24.4,17.6,6.9,21,SPA
b8c1de25,25,1480,16.4,18,8,7,2,22,28,-6,19.5,24.5,-5.0,21,SPA
b92b456a,3,53,0.6,0,0,3,0,1,2,-1,0.7,2.5,-1.8,21,SPA
ba3ca78f,13,1170,13.0,13,13,0,22,10,21,-11,13.8,17.6,-3.8,21,SPA
ba5004e1,31,2434,27.0,28,19,3,3,25,31,-6,24.4,27.2,-2.8,21,SPA
ba5a9545,27,1204,13.4,10,5,17,4,15,19,-4,14.2,19.5,-5.2,21,SPA
ba71d071,13,909,10.1,8,7,5,20,12,25,-13,10.7,17.5,-6.8,21,SPA
bb4b1242,27,1404,15.6,13,4,14,5,12,11,1,22.6,13.8,8.8,21,SPA
bb6c6331,6,195,2.2,2,0,4,10,1,2,-1,1.5,2.3,-0.8,21,SPA
bba30585,1,90,1.0,1,1,0,1,1,1,0,0.3,0.8,-0.5,21,SPA
bbc19252,35,2338,26.0,25,12,10,1,30,37,-7,26.1,33.5,-7.5,21,SPA
bbf5c11b,38,2877,32.0,32,24,6,0,31,45,-14,34.0,41.4,-7.4,21,SPA
bc61cc65,22,1347,15.0,16,7,6,5,11,16,-5,15.3,18.2,-2.9,21,SPA
bc6f5f06,9,719,8.0,9,5,0,24,11,6,5,11.1,8.4,2.7,21,SPA
bdb624a3,24,1035,11.5,11,1,13,14,12,6,6,11.3,9.0,2.3,21,SPA
bdc14559,20,789,8.8,9,0,11,11,9,13,-4,8.2,17.9,-9.7,21,SPA
be170419,25,2109,23.4,23,22,2,12,28,23,5,24.4,21.4,2.9,21,SPA
be3a0121,5,304,3.4,3,2,2,12,3,7,-4,2.8,6.7,-3.8,21,SPA
bece776f,33,2622,29.1,33,17,0,0,39,37,2,38.6,32.5,6.1,21,SPA
bf12926c,21,862,9.6,8,1,13,10,12,5,7,12.1,10.7,1.3,21,SPA
bfb15d99,1,90,1.0,1,1,0,18,2,6,-4,0.3,2.3,-2.0,21,SPA
c00097d2,19,1425,15.8,16,11,3,13,21,25,-4,15.6,25.2,-9.5,21,SPA
c05dfb74,28,1943,21.6,23,5,5,1,28,26,2,23.9,21.0,2.9,21,SPA
c14bc029,33,2033,22.6,22,12,11,1,39,15,24,31.1,24.6,6.5,21,SPA
c2111b45,21,1348,15.0,15,10,6,4,16,23,-7,16.3,23.7,-7.4,21,SPA
c261b5dd,1,62,0.7,1,0,0,10,0,4,-4,0.0,1.7,-1.7,21,SPA
c2cfbfc9,11,168,1.9,2,0,9,25,1,6,-5,0.7,3.4,-2.7,21,SPA
c46736ab,23,800,8.9,7,2,16,13,6,18,-12,8.6,18.9,-10.4,21,SPA
c4b888df,32,2581,28.7,31,24,1,0,28,44,-16,24.4,40.0,-15.6,21,SPA
c4dce677,13,580,6.4,6,0,7,23,6,7,-1,6.3,9.1,-2.9,21,SPA
c4f5eb61,2,47,0.5,1,0,1,9,2,0,2,0.3,1.4,-1.1,21,SPA
c5fa58ea,27,2050,22.8,24,17,3,3,20,33,-13,19.6,30.5,-11.0,21,SPA
c67cd65c,32,2316,25.7,25,23,7,1,24,34,-10,25.2,37.5,-12.3,21,SPA
c77a8043,35,2170,24.1,22,14,13,0,24,40,-16,23.6,34.4,-10.8,21,SPA
c78b352d,29,2137,23.7,25,18,4,6,29,31,-2,25.5,28.9,-3.4,21,SPA
c90977db,30,2138,23.8,27,10,3,1,20,31,-11,26.5,34.2,-7.7,21,SPA
c960cfdb,2,24,0.3,0,0,2,0,0,0,0,0.8,0.2,0.6,21,SPA
c966fce1,12,167,1.9,0,0,12,21,2,4,-2,2.5,2.4,0.1,21,SPA
c997b942,1,35,0.4,0,0,1,5,0,0,0,1.0,0.1,1.0,21,SPA
c9cb972b,28,2520,28.0,28,28,0,10,35,42,-7,32.0,38.3,-6.2,21,SPA
c9e39d91,34,2671,29.7,30,20,4,3,49,41,8,42.4,39.6,2.8,21,SPA
cac2537b,26,1682,18.7,19,9,7,2,16,29,-13,17.9,28.4,-10.5,21,SPA
cb574619,31,2602,28.9,30,28,1,1,44,44,0,39.5,36.0,3.5,21,SPA
cbdf7d5c,1,5,0.1,0,0,1,3,0,0,0,0.0,0.0,0.0,21,SPA
ccaa5728,10,375,4.2,5,0,5,20,3,10,-7,2.6,7.0,-4.4,21,SPA
cce181df,30,1051,11.7,9,6,21,6,16,12,4,13.5,15.600000000000001,-2.2,21,SPA
cd9b37a3,2,9,0.1,0,0,2,11,0,0,0,0.1,0.2,0.0,21,SPA
cda0b317,18,1620,18.0,18,18,0,20,25,25,0,21.7,22.2,-0.5,21,SPA
cde52ef5,21,1781,19.8,19,19,2,17,27,30,-3,23.4,30.6,-7.3,21,SPA
ced26057,4,231,2.6,3,0,1,14,4,5,-1,2.7,5.6,-2.8,21,SPA
d080ed5e,26,2154,23.9,25,20,1,1,36,22,14,40.8,19.6,21.2,21,SPA
d2110326,26,2079,23.1,24,19,2,3,32,33,-1,24.8,32.2,-7.4,21,SPA
d2aea9ac,9,388,4.3,3,0,6,9,7,7,0,6.9,6.5,0.4,21,SPA
d2ed99b4,1,11,0.1,0,0,1,4,0,0,0,0.5,0.0,0.5,21,SPA
d38fdf53,25,1168,13.0,12,7,13,6,19,14,5,20.9,15.5,5.4,21,SPA
d3b888e3,9,198,2.2,1,0,8,8,4,3,1,2.1,3.7,-1.6,21,SPA
d49f3e6b,34,2694,29.9,32,16,2,0,28,41,-13,25.1,45.6,-20.5,21,SPA
d4cb83cc,26,2082,23.1,23,20,3,6,38,20,18,36.6,21.1,15.5,21,SPA
d4ef9ac5,12,726,8.1,9,3,3,24,7,12,-5,5.3,15.8,-10.5,21,SPA
d637fc22,32,2492,27.7,29,22,3,2,30,46,-16,33.5,41.3,-7.8,21,SPA
d66b9872,24,935,10.4,10,1,14,13,4,15,-11,11.3,11.5,-0.1,21,SPA
d70ce98e,35,3023,33.6,33,32,2,0,80,35,45,66.4,36.5,29.9,21,SPA
d733aa38,35,1894,21.0,19,9,16,0,22,33,-11,22.2,24.6,-2.4,21,SPA
d83bbc54,35,2979,33.1,35,21,0,2,43,46,-3,37.7,44.9,-7.2,21,SPA
d858d079,1,1,0.0,0,0,1,2,0,0,0,0.0,0.0,0.0,21,SPA
d87e2cae,13,689,7.7,8,4,5,4,12,9,3,12.9,8.9,4.0,21,SPA
db001fa9,32,2601,28.9,31,24,1,1,26,37,-11,27.0,38.7,-11.7,21,SPA
db750822,10,298,3.3,3,0,7,25,10,3,7,4.6,3.9,0.7,21,SPA
dc1c2fce,35,2278,25.3,27,8,8,0,33,23,10,32.7,23.4,9.2,21,SPA
dc56efc9,1,1,0.0,0,0,1,2,0,0,0,0.0,0.0,0.0,21,SPA
dd672e1f,23,1779,19.8,19,18,4,13,16,27,-11,16.5,30.2,-13.7,21,SPA
ddd5348b,13,549,6.1,4,4,9,16,5,12,-7,8.5,9.2,-0.8,21,SPA
de39485a,30,2179,24.2,25,12,5,1,43,13,30,32.0,20.6,11.3,21,SPA
debc6b55,21,370,4.1,0,0,21,17,5,6,-1,5.7,4.9,0.9,21,SPA
dee86451,27,1223,13.6,12,4,15,4,21,23,-2,17.2,23.2,-6.0,21,SPA
def69cd0,32,2183,24.3,27,4,5,1,22,30,-8,26.0,30.4,-4.4,21,SPA
df69b544,36,2604,28.9,32,12,4,2,66,31,35,54.3,30.8,23.5,21,SPA
df8b52a5,34,2991,33.2,34,32,0,0,49,39,10,46.5,37.9,8.6,21,SPA
e08647d6,16,533,5.9,6,0,10,6,9,7,2,9.7,9.3,0.5000000000000001,21,SPA
e1846dde,8,720,8.0,8,8,0,28,8,11,-3,6.5,14.9,-8.4,21,SPA
e208bcc8,7,101,1.1,0,0,7,11,0,1,-1,0.9,1.3,-0.4,21,SPA
e2716bd0,21,1399,15.5,17,3,4,1,30,6,24,30.1,10.4,19.7,21,SPA
e29d1111,23,1813,20.1,21,19,2,14,22,34,-12,21.9,26.0,-4.1,21,SPA
e4346678,30,2700,30.0,30,30,0,8,27,46,-19,21.5,52.4,-30.9,21,SPA
e49ce451,12,462,5.1,3,3,9,7,3,10,-7,5.9,6.9,-0.9,21,SPA
e54bd0a2,33,2575,28.6,31,15,2,0,29,40,-11,32.3,33.4,-1.1,21,SPA
e6bc67d7,31,2287,25.4,27,11,4,5,32,35,-3,28.3,35.0,-6.7,21,SPA
e6eadfb8,3,73,0.8,1,0,2,7,0,1,-1,0.1,1.3,-1.3,21,SPA
e7986081,5,100,1.1,0,0,5,12,4,1,3,2.6,1.1,1.6,21,SPA
e7ab4179,20,1326,14.7,15,10,5,4,12,20,-8,13.0,18.3,-5.3,21,SPA
e7f4603c,21,1117,12.4,13,3,8,14,11,18,-7,13.7,13.7,0.0,21,SPA
e82d2807,17,503,5.6,4,0,13,11,4,10,-6,5.6,6.8,-1.3000000000000003,21,SPA
e897d8ba,37,3087,34.3,36,17,1,0,26,49,-23,40.2,39.8,0.4,21,SPA
e8a0d2f7,1,15,0.2,0,0,1,11,1,0,1,0.9,0.1,0.8,21,SPA
e8deefd6,4,220,2.4,2,2,2,8,5,0,5,0.0,0.0,0.0,21,SPA
e9ada8cf,9,248,2.8,1,0,8,20,3,3,0,3.4,2.3,1.1,21,SPA
e9fbcc21,3,41,0.5,0,0,3,2,0,1,-1,0.3,1.7,-1.4,21,SPA
ea6a7ab4,5,150,1.7,1,0,4,18,3,2,1,2.4,0.8,1.6,21,SPA
ea83bfa6,32,2880,32.0,32,32,0,3,42,55,-13,36.0,45.6,-9.5,21,SPA
ea9b2ef9,34,2638,29.3,29,26,5,1,40,52,-12,30.9,41.8,-10.8,21,SPA
ead61f73,22,1652,18.4,18,16,4,11,24,18,6,24.2,18.1,6.0,21,SPA
eb3dd471,35,2090,23.2,25,3,10,3,27,39,-12,28.8,34.2,-5.4,21,SPA
eb82b6f1,30,2396,26.6,28,19,2,0,26,31,-5,22.1,40.3,-18.1,21,SPA
ec1a731e,2,95,1.1,1,1,1,9,0,0,0,0.5,1.8,-1.3,21,SPA
ecd8c01e,25,1404,15.6,17,6,8,7,16,16,0,16.4,22.4,-6.0,21,SPA
ed3f5f4c,29,1966,21.8,21,15,8,8,20,35,-15,15.5,36.5,-21.0,21,SPA
ed5c5fa3,32,1399,15.5,13,3,19,6,24,28,-4,18.5,27.3,-8.8,21,SPA
ed6ea4d9,32,2026,22.5,21,7,11,0,31,40,-9,25.4,31.6,-6.2,21,SPA
ed9f7cfe,23,1129,12.5,11,7,12,12,26,11,15,23.2,12.0,11.1,21,SPA
ee8508c0,38,3420,38.0,38,38,0,0,67,25,42,52.8,37.1,15.7,21,SPA
ee923664,8,562,6.2,5,4,3,15,9,7,2,6.5,11.5,-5.0,21,SPA
eeba07f8,27,1666,18.5,18,7,9,0,26,28,-2,22.3,26.4,-4.1,21,SPA
ef322658,24,1318,14.6,17,5,7,1,12,20,-8,17.4,14.8,2.5,21,SPA
efaefda0,4,133,1.5,2,0,2,0,3,0,3,2.6,0.3,2.3,21,SPA
efecd633,24,1460,16.2,17,7,7,9,14,23,-9,16.2,23.1,-6.8,21,SPA
f090a37a,14,292,3.2,2,1,12,23,10,4,6,6.4,4.6,1.8,21,SPA
f0da930c,21,1765,19.6,20,18,1,4,37,13,24,28.2,18.1,10.1,21,SPA
f11fe861,27,2263,25.1,25,25,2,8,22,34,-12,25.2,33.7,-8.4,21,SPA
f127d782,22,1980,22.0,22,22,0,16,21,32,-11,24.3,29.7,-5.3,21,SPA
f1bed920,22,1095,12.2,11,5,11,8,11,21,-10,10.8,18.1,-7.3,21,SPA
f28876e5,1,26,0.3,0,0,1,8,1,1,0,0.6,0.9,-0.3,21,SPA
f2a68b97,13,865,9.6,10,7,3,14,10,8,2,8.7,10.2,-1.5,21,SPA
f4c69aa6,14,542,6.0,4,0,10,3,12,6,6,9.1,5.6,3.5,21,SPA
f520049f,7,321,3.6,4,2,3,18,2,5,-3,2.7,5.5,-2.8,21,SPA
f6798fc3,33,2970,33.0,33,33,0,2,46,28,18,46.6,30.2,16.5,21,SPA
f681a8ef,20,767,8.5,9,0,11,11,8,17,-9,7.9,11.8,-3.9,21,SPA
f6ac68c1,33,2953,32.8,33,32,0,1,63,20,43,44.8,32.0,12.7,21,SPA
f6f6b6e8,19,1379,15.3,15,14,4,3,13,22,-9,16.4,20.2,-3.8,21,SPA
f7c491f1,14,741,8.2,9,5,5,20,10,14,-4,8.1,16.0,-7.8,21,SPA
f7dc2ae5,23,1884,20.9,22,18,1,1,36,15,21,35.3,18.5,16.8,21,SPA
f8eca1b6,28,1318,14.6,15,0,13,2,11,13,-2,15.3,14.7,0.6,21,SPA
f934c5c9,1,14,0.2,0,0,1,7,0,0,0,0.1,0.2,-0.1,21,SPA
faed84db,31,2187,24.3,25,15,6,2,28,35,-7,28.6,30.1,-1.5,21,SPA
fb5d47b3,24,1851,20.6,21,17,3,1,34,23,11,32.1,21.0,11.1,21,SPA
fbd6378b,28,2392,26.6,27,25,1,5,37,31,6,36.3,30.4,5.9,21,SPA
fce521d7,1,30,0.3,0,0,1,11,0,1,-1,0.5,0.1,0.4,21,SPA
fd01216a,6,65,0.7,0,0,6,8,0,0,0,0.6,0.8,-0.2,21,SPA
fd47b4f2,8,468,5.2,6,3,2,5,3,6,-3,4.1,5.1,-1.1,21,SPA
fd51b456,24,1848,20.5,21,15,3,2,37,16,21,31.6,20.1,11.4,21,SPA
fd771f95,29,1175,13.1,11,7,18,3,27,12,15,31.8,15.1,16.7,21,SPA
fe05804b,28,2272,25.2,26,22,2,1,22,37,-15,23.1,36.4,-13.3,21,SPA
fea23125,4,360,4.0,4,4,0,34,5,10,-5,4.0,6.8,-2.9,21,SPA
fed17f5a,32,2735,30.4,31,27,1,1,41,41,0,35.4,40.4,-5.0,21,SPA
ffacd3d5,17,1025,11.3,11,7,6,12,17,13,4,14.8,15.6,-0.8,21,SPA
005ca692,6,366,4.1,4,3,2,0,4,7,-3,3.2,6.0,-2.8,21,CL
00672021,5,161,1.8,1,0,4,0,0,6,-6,0.3,4.6,-4.3,21,CL
0076ab7f,7,497,5.5,5,5,2,1,9,8,1,7.3,7.8,-0.5,21,CL
01204d46,1,90,1.0,1,1,0,3,1,1,0,0.7,2.4,-1.7,21,CL
012c975a,6,333,3.7,3,3,3,4,8,3,5,6.0,5.6,0.4,21,CL
016ff750,5,247,2.7,2,1,3,2,6,4,2,4.7,4.1,0.7,21,CL
0176f037,6,369,4.1,4,1,2,0,3,10,-7,3.5,6.9,-3.4,21,CL
01b8a2b2,7,660,7.3,7,7,0,1,15,8,7,12.9,8.8,4.1,21,CL
01c3aff5,7,403,4.5,4,2,3,0,11,6,5,9.1,6.0,3.1,21,CL
01da7812,4,244,2.7,3,1,1,0,2,7,-5,2.3,5.4,-3.2,21,CL
01eb744d,8,482,5.4,5,2,3,0,6,5,1,7.8,4.0,3.8,21,CL
028e70b9,1,5,0.1,0,0,1,3,0,0,0,0.0,0.4,-0.4,21,CL
02c15616,8,654,7.3,8,4,0,0,7,11,-4,8.7,10.1,-1.4,21,CL
02caf6e0,5,324,3.6,4,2,1,0,6,8,-2,7.1,4.8,2.2,21,CL
0331786b,3,207,2.3,2,2,1,3,2,4,-2,3.8,3.5,0.3,21,CL
03622183,1,1,0.0,0,0,1,5,0,1,-1,0.0,0.6,-0.6,21,CL
038aa94a,1,29,0.3,1,0,0,0,0,2,-2,0.4,0.6,-0.3,21,CL
042e8a49,7,544,6.0,7,2,0,2,17,7,10,15.9,8.9,7.0,21,CL
048a1cbc,8,666,7.4,8,5,0,0,15,8,7,10.3,9.0,1.3,21,CL
04e17fd5,8,388,4.3,4,2,4,0,9,9,0,6.1,7.7,-1.6,21,CL
05439de2,9,810,9.0,9,9,0,0,25,10,15,20.1,13.6,6.5,21,CL
056269d7,5,243,2.7,3,2,2,1,7,2,5,8.1,2.5,5.6,21,CL
05a84d52,9,742,8.2,9,2,0,1,11,6,5,11.2,9.5,1.7,21,CL
05d548d8,9,791,8.8,9,8,0,0,15,13,2,12.5,12.2,0.3,21,CL
0630eb63,2,92,1.0,1,0,1,0,0,3,-3,0.1,1.8,-1.7,21,CL
06f33dc8,4,244,2.7,3,1,1,0,2,10,-8,2.0,5.5,-3.5,21,CL
08511d65,5,423,4.7,5,4,0,0,9,6,3,9.0,7.9,1.1,21,CL
0880e10b,1,90,1.0,1,1,0,4,1,2,-1,2.7,3.5,-0.8,21,CL
08aa9cd1,1,6,0.1,0,0,1,2,0,0,0,0.0,0.0,0.0,21,CL
091c86e2,1,6,0.1,0,0,1,4,1,0,1,0.1,0.0,0.1,21,CL
0959c2a2,7,490,5.4,5,4,2,0,9,8,1,8.3,8.6,-0.4,21,CL
096a77c4,3,27,0.3,0,0,3,5,0,0,0,0.1,0.6,-0.5,21,CL
0a3d6d2b,3,129,1.4,1,0,2,0,5,1,4,2.8,3.3,-0.4,21,CL
0a6dbbf7,2,180,2.0,2,2,0,4,5,1,4,4.0,2.4,1.6,21,CL
0a721e85,5,169,1.9,1,1,4,1,2,3,-1,2.9,3.8,-1.0,21,CL
0a89e877,3,115,1.3,1,0,2,3,0,1,-1,0.7,0.8,0.0,21,CL
0ab1f153,6,549,6.1,6,4,0,1,13,5,8,11.3,6.6,4.7,21,CL
0b4f388a,7,301,3.3,4,0,3,1,5,8,-3,5.2,6.2,-1.0,21,CL
0ba976e4,3,160,1.8,2,0,1,0,6,0,6,6.7,2.4,4.3,21,CL
0be95d34,4,132,1.5,1,0,3,1,2,2,0,2.3,2.8,-0.5,21,CL
0c2ac3cb,8,130,1.4,1,0,7,4,5,1,4,4.5,1.5,3.0,21,CL
0cadc46d,5,182,2.0,2,0,3,1,1,3,-2,2.5,3.3,-0.9,21,CL
0d82903c,5,480,5.3,5,5,0,0,12,5,7,10.7,5.5,5.2,21,CL
0d9b2d31,7,491,5.5,6,0,1,1,11,9,2,12.6,10.0,2.6,21,CL
0e6bc38c,7,383,4.3,4,3,3,3,7,5,2,8.7,5.6,3.1,21,CL
0eac2f24,1,11,0.1,0,0,1,5,0,0,0,0.2,0.1,0.1,21,CL
0ef89a37,2,133,1.5,2,0,0,1,5,1,4,3.4,1.4,2.0,21,CL
101da2b5,7,345,3.8,3,3,4,4,5,0,5,6.6,2.1,4.5,21,CL
10549b49,4,288,3.2,3,3,1,0,2,7,-5,3.7,6.2,-2.6,21,CL
108fe016,4,245,2.7,3,1,1,2,3,7,-4,2.7,4.8,-2.1,21,CL
10fe831e,5,450,5.0,5,5,0,0,5,8,-3,4.5,9.4,-4.9,21,CL
119b9a8e,4,277,3.1,3,2,1,8,7,0,7,5.3,1.0,4.3,21,CL
1265a93a,10,569,6.3,6,5,4,3,7,1,6,9.2,3.8,5.4,21,CL
129af0db,8,597,6.6,6,4,2,0,15,4,11,13.9,7.0,6.9,21,CL
12aa7661,5,429,4.8,5,4,0,0,2,8,-6,3.6,6.5,-2.9,21,CL
1394bf42,1,60,0.7,1,0,0,2,0,1,-1,0.1,1.2,-1.1,21,CL
13ea2544,4,286,3.2,4,2,0,0,1,5,-4,1.4,6.6,-5.2,21,CL
1467af0d,7,500,5.6,6,2,1,1,12,8,4,10.2,7.5,2.7,21,CL
148e136f,3,253,2.8,3,1,0,0,3,2,1,2.8,4.5,-1.6,21,CL
14b8fcdf,1,16,0.2,1,0,0,1,0,0,0,0.0,0.3,-0.3,21,CL
14e05913,1,90,1.0,1,1,0,6,0,4,-4,1.3,2.4,-1.1,21,CL
14e8fe86,5,327,3.6,4,2,1,1,3,12,-9,3.9,8.0,-4.1,21,CL
15975a3c,5,288,3.2,3,3,2,1,3,9,-6,3.6,7.5,-3.9,21,CL
15d0c248,4,177,2.0,2,1,2,1,4,2,2,4.7,2.2,2.6,21,CL
15f3ec41,7,338,3.8,4,1,3,5,8,0,8,6.9,4.0,3.0,21,CL
15fd5593,6,453,5.0,5,3,1,0,4,5,-1,7.0,6.2,0.8,21,CL
169fd162,3,94,1.0,0,0,3,2,0,2,-2,1.2,1.0,0.2,21,CL
16ceb862,8,259,2.9,2,0,6,5,7,2,5,6.1,3.2,2.9,21,CL
17145c90,1,72,0.8,1,0,0,1,1,1,0,1.4,1.5,-0.1,21,CL
178ae8f8,9,539,6.0,6,0,3,0,10,5,5,8.8,8.7,0.1,21,CL
17e3e467,5,427,4.7,5,3,0,0,3,9,-6,3.6,8.0,-4.4,21,CL
1840e36d,12,1080,12.0,12,12,0,0,19,14,5,19.2,15.6,3.7,21,CL
18b896d6,11,923,10.3,10,10,1,2,18,3,15,20.9,7.6,13.4,21,CL
19709006,6,280,3.1,3,0,3,2,7,5,2,5.1,4.9,0.2,21,CL
19a967ab,3,137,1.5,2,0,1,4,1,2,-1,1.1,3.1,-2.0,21,CL
19cda00b,10,691,7.7,8,1,2,1,10,11,-1,11.8,12.3,-0.5,21,CL
1a2935f6,5,384,4.3,4,4,1,0,3,10,-7,4.4,8.5,-4.1,21,CL
1a4b9094,5,188,2.1,2,1,3,4,6,1,5,2.6,1.7,0.9,21,CL
1a799243,6,540,6.0,6,6,0,0,10,17,-7,11.2,9.3,2.0,21,CL
1a992676,5,267,3.0,3,1,2,2,5,5,0,4.5,7.9,-3.4,21,CL
1adcf39e,4,299,3.3,3,3,1,1,2,4,-2,2.5,6.0,-3.4,21,CL
1bacc518,7,585,6.5,6,6,1,0,11,10,1,14.4,12.5,1.8,21,CL
1bd5735a,4,225,2.5,3,1,1,1,2,5,-3,2.2,3.9,-1.7,21,CL
1bf33a9a,10,423,4.7,4,1,6,1,9,2,7,8.9,2.8,6.1,21,CL
1c07b06e,6,418,4.6,5,3,1,0,2,6,-4,3.1,6.3,-3.2,21,CL
1c78737d,5,271,3.0,4,1,1,1,2,7,-5,1.5,6.1,-4.6,21,CL
1c90cd29,2,180,2.0,2,2,0,4,1,5,-4,1.2,5.1,-3.9,21,CL
1cb49278,7,592,6.6,6,6,1,5,12,2,10,14.1,5.3,8.8,21,CL
1d1691ad,2,33,0.4,0,0,2,3,0,0,0,0.4,0.2,0.2,21,CL
1d2d5cc8,6,540,6.0,6,6,0,0,2,13,-11,5.9,10.1,-4.3,21,CL
1d5cab82,6,519,5.8,6,4,0,0,9,17,-8,9.8,9.2,0.6,21,CL
1dbfae2d,4,236,2.6,3,0,1,0,0,3,-3,1.6,3.1,-1.5,21,CL
1e064bfb,1,90,1.0,1,1,0,4,2,2,0,1.6,1.0,0.6,21,CL
1e1378e1,3,43,0.5,0,0,3,0,2,1,1,2.1,0.9,1.2,21,CL
1e465e70,2,32,0.4,0,0,2,5,1,0,1,0.9,0.0,0.9,21,CL
1ec7e1c5,6,519,5.8,6,5,0,0,2,10,-8,5.7,11.9,-6.2,21,CL
1f3afdcb,5,450,5.0,5,5,0,0,6,9,-3,6.5,7.1,-0.7,21,CL
1f44ac21,8,703,7.8,8,6,0,0,16,11,5,11.4,10.5,0.9,21,CL
1f9328da,1,4,0.0,0,0,1,3,0,0,0,0.0,0.1,-0.1,21,CL
20030c06,6,326,3.6,3,3,3,2,7,3,4,5.5,4.1,1.4,21,CL
2054d037,3,100,1.1,1,0,2,0,0,4,-4,0.8,2.1,-1.4,21,CL
20df3aaf,3,122,1.4,1,0,2,3,0,4,-4,1.0,3.2,-2.2,21,CL
20e73fac,5,368,4.1,5,2,0,1,2,7,-5,3.6,10.0,-6.4,21,CL
21453b2e,1,1,0.0,0,0,1,1,0,0,0,0.0,0.0,0.0,21,CL
21512407,7,608,6.8,7,6,0,0,7,9,-2,8.1,8.7,-0.6,21,CL
22721b88,5,450,5.0,5,5,0,0,2,10,-8,5.3,7.8,-2.4,21,CL
22798128,5,221,2.5,2,1,3,0,1,5,-4,2.3,3.9,-1.6,21,CL
22aba139,1,45,0.5,1,0,0,5,0,2,-2,0.2,1.5,-1.4,21,CL
24051310,10,866,9.6,10,8,0,0,14,8,6,11.8,13.8,-2.0,21,CL
2475dcc6,6,540,6.0,6,6,0,0,7,7,0,8.1,8.0,0.0,21,CL
24f59bb2,6,258,2.9,1,1,5,2,8,1,7,7.3,3.5,3.8,21,CL
256ac8f4,2,180,2.0,2,2,0,4,1,5,-4,1.4,3.5,-2.1,21,CL
2690dffa,1,3,0.0,0,0,1,5,0,0,0,0.0,0.0,0.0,21,CL
2784f898,6,477,5.3,5,5,1,3,7,8,-1,5.9,10.0,-4.1,21,CL
27d902c8,6,540,6.0,6,6,0,0,10,17,-7,11.2,9.3,2.0,21,CL
288e1e13,4,275,3.1,2,2,2,0,2,6,-4,5.3,7.4,-2.1,21,CL
28b1f3ce,9,700,7.8,9,2,0,0,12,2,10,10.9,9.9,1.0,21,CL
28d596a0,1,90,1.0,1,1,0,10,1,1,0,2.5,0.4,2.1,21,CL
28f66c2e,2,166,1.8,2,1,0,3,1,4,-3,2.5,3.9,-1.4,21,CL
2903a856,5,430,4.8,5,3,0,0,9,8,1,5.3,8.7,-3.4,21,CL
292a652a,1,90,1.0,1,1,0,1,0,4,-4,0.7,3.2,-2.5,21,CL
2944f86f,6,508,5.6,6,4,0,0,4,12,-8,6.5,11.2,-4.8,21,CL
2946f9a1,8,720,8.0,8,8,0,2,10,7,3,11.7,10.6,1.1,21,CL
29733c72,1,60,0.7,1,0,0,5,1,2,-1,0.6,0.9,-0.4,21,CL
29c02c9f,5,223,2.5,2,2,3,6,3,4,-1,3.8,5.6,-1.8,21,CL
2a0c8ba4,7,404,4.5,4,0,3,0,4,10,-6,6.7,5.8,0.9,21,CL
2a1beb34,6,473,5.3,5,5,1,0,9,4,5,7.6,6.0,1.6,21,CL
2b09d998,6,289,3.2,2,2,4,2,2,8,-6,3.6,5.3,-1.8,21,CL
2b114be3,8,578,6.4,6,4,2,1,17,7,10,12.9,8.9,4.0,21,CL
2b9fdeea,6,479,5.3,6,0,0,0,2,9,-7,4.8,7.8,-2.9,21,CL
2baec6ce,5,203,2.3,2,1,3,0,8,4,4,4.8,2.5,2.3,21,CL
2bed3eab,3,207,2.3,3,2,0,9,3,1,2,4.5,0.4,4.1,21,CL
2bef2bca,3,147,1.6,2,0,1,0,3,3,0,2.4,3.1,-0.7,21,CL
2bf50b37,1,7,0.1,0,0,1,4,0,0,0,0.1,0.0,0.1,21,CL
2c0558b8,6,235,2.6,2,0,4,4,8,3,5,3.7,3.0,0.6,21,CL
2c0f8e9e,5,121,1.3,1,0,4,0,1,2,-1,1.5,0.8,0.6,21,CL
2c44a35d,4,342,3.8,4,1,0,1,5,5,0,6.5,4.9,1.6,21,CL
2cb77ec6,6,265,2.9,3,1,3,0,2,9,-7,3.0,8.2,-5.2,21,CL
2ccd89a3,5,312,3.5,4,3,1,0,4,7,-3,5.9,6.7,-0.8,21,CL
2d61d13a,4,319,3.5,4,2,0,0,5,3,2,5.2,4.4,0.7,21,CL
2d970560,7,563,6.3,7,3,0,0,9,5,4,8.6,6.0,2.6,21,CL
2db2fd7b,7,522,5.8,6,4,1,3,17,5,12,11.0,9.0,2.0,21,CL
2e4f5f03,10,754,8.4,8,6,2,0,14,5,9,12.9,11.7,1.1,21,CL
2e7ff968,6,540,6.0,6,6,0,3,10,12,-2,7.9,10.4,-2.4,21,CL
2ebc1b44,6,288,3.2,3,1,3,0,2,9,-7,2.4,6.7,-4.3,21,CL
2ef7c612,6,458,5.1,5,4,1,0,8,7,1,7.4,7.4,-0.1,21,CL
2f90f6b8,6,362,4.0,4,2,2,1,3,2,1,4.9,4.5,0.4,21,CL
2fabebc0,6,540,6.0,6,6,0,0,4,13,-9,5.6,11.3,-5.7,21,CL
2fd337af,3,152,1.7,1,1,2,1,1,3,-2,1.8,3.6,-1.8,21,CL
303636d2,5,365,4.1,4,4,1,1,3,10,-7,4.0,8.3,-4.3,21,CL
30643ce2,2,25,0.3,0,0,2,0,0,1,-1,0.3,0.8,-0.5,21,CL
30941e96,7,626,7.0,7,6,0,0,11,14,-3,9.7,10.3,-0.6,21,CL
30d4a2e5,4,353,3.9,4,3,0,0,1,9,-8,1.9,8.4,-6.5,21,CL
30f5ffa9,3,270,3.0,3,3,0,1,3,4,-1,3.1,3.8,-0.7,21,CL
31114001,6,445,4.9,5,2,1,0,4,13,-9,4.2,10.0,-5.9,21,CL
31c69ef1,11,969,10.8,11,10,0,1,19,5,14,18.2,5.9,12.3,21,CL
32314605,6,155,1.7,1,0,5,0,1,3,-2,1.5,3.0,-1.5,21,CL
335fa267,3,182,2.0,2,1,1,0,6,1,5,5.2,2.0,3.2,21,CL
3376a776,4,218,2.4,2,2,2,4,4,5,-1,3.7,5.3,-1.6,21,CL
33887998,12,1080,12.0,12,12,0,0,22,3,19,23.5,8.6,15.0,21,CL
339fe0e8,1,90,1.0,1,1,0,5,3,1,2,1.7,1.3,0.4,21,CL
33b11df6,4,141,1.6,1,1,3,0,1,5,-4,1.4,3.3,-1.9,21,CL
33b8d077,5,372,4.1,4,4,1,0,6,6,0,6.4,3.6,2.8,21,CL
34b54da7,3,57,0.6,1,0,2,4,1,1,0,0.6,1.0,-0.4,21,CL
34c3b935,1,90,1.0,1,1,0,5,0,4,-4,0.7,3.2,-2.5,21,CL
34caa4b3,3,149,1.7,2,0,1,0,3,2,1,2.8,1.6,1.2,21,CL
36a3ff67,10,693,7.7,8,4,2,0,11,12,-1,9.5,11.7,-2.1,21,CL
36a59ba4,8,698,7.8,8,7,0,0,15,13,2,10.9,13.3,-2.4,21,CL
36a79857,6,456,5.1,6,1,0,0,4,13,-9,3.7,10.2,-6.5,21,CL
378825c7,5,447,5.0,5,4,0,0,10,8,2,6.0,8.6,-2.6,21,CL
37e103f8,1,15,0.2,0,0,1,2,1,0,1,0.4,0.0,0.4,21,CL
3814b753,5,178,2.0,2,0,3,0,0,6,-6,2.8,5.9,-3.1,21,CL
384d58d9,5,292,3.2,2,2,3,0,2,6,-4,2.2,5.6,-3.4,21,CL
38c7feef,3,29,0.3,0,0,3,1,0,0,0,0.1,0.5,-0.4,21,CL
392a7aea,6,530,5.9,6,4,0,0,8,10,-2,8.4,9.3,-0.9,21,CL
39769cff,5,450,5.0,5,5,0,1,8,15,-7,10.1,8.4,1.6,21,CL
3b1ed320,2,21,0.2,0,0,2,0,1,0,1,1.0,0.4,0.6,21,CL
3b333ac3,6,530,5.9,6,5,0,0,10,8,2,9.8,5.7,4.1,21,CL
3b8674e6,7,472,5.2,5,1,2,0,9,5,4,8.4,5.5,2.9,21,CL
3bb7b8b4,12,1080,12.0,12,12,0,0,22,5,17,20.1,6.6,13.5,21,CL
3c6089ab,9,630,7.0,8,3,1,0,18,6,12,15.8,10.0,5.8,21,CL
3cdfc63e,6,540,6.0,6,6,0,0,5,17,-12,5.6,12.7,-7.1,21,CL
3cefcaef,11,962,10.7,11,10,0,0,18,12,6,18.4,11.8,6.6,21,CL
3d2320f7,5,389,4.3,5,2,0,1,4,15,-11,3.6,11.0,-7.4,21,CL
3d50bcdb,9,441,4.9,4,2,5,2,8,6,2,8.2,7.4,0.8,21,CL
3eb22ec9,13,928,10.3,11,7,2,0,20,4,16,18.0,5.2,12.8,21,CL
3eed9821,1,36,0.4,0,0,1,2,0,0,0,0.6,0.7,-0.1,21,CL
3ef0af0d,5,319,3.5,3,0,2,0,3,8,-5,4.6,5.9,-1.3,21,CL
3f10bd22,6,462,5.1,6,4,0,0,6,9,-3,7.9,5.6,2.3,21,CL
3f65d5ce,1,90,1.0,1,1,0,5,2,1,1,2.0,2.2,-0.1,21,CL
3f79a1c8,4,148,1.6,1,0,3,1,1,3,-2,1.8,2.5,-0.7,21,CL
4030c7ae,6,540,6.0,6,6,0,0,5,17,-12,5.6,12.7,-7.1,21,CL
40676b27,1,90,1.0,1,1,0,4,1,1,0,0.7,2.4,-1.7,21,CL
414e1f69,4,39,0.4,0,0,4,2,0,2,-2,1.0,1.2,-0.2,21,CL
41e7ef1c,5,378,4.2,5,1,0,5,9,5,4,8.4,7.3,1.1,21,CL
41f0b196,5,450,5.0,5,5,0,1,5,8,-3,3.9,7.8,-3.8,21,CL
41f32541,7,491,5.5,5,4,2,1,9,7,2,7.8,6.5,1.3,21,CL
420c18a1,8,720,8.0,8,8,0,0,16,13,3,11.6,13.8,-2.3,21,CL
42130443,1,90,1.0,1,1,0,12,3,0,3,2.4,0.5,1.8,21,CL
42dcf26d,6,540,6.0,6,6,0,0,2,13,-11,5.9,10.1,-4.3,21,CL
42fd9c7f,10,899,10.0,10,9,0,1,21,11,10,19.1,15.5,3.7,21,CL
4315f30d,6,420,4.7,4,3,2,3,7,5,2,5.5,7.4,-2.0,21,CL
4352d221,4,150,1.7,1,0,3,0,1,3,-2,3.2,3.1,0.1,21,CL
436a9dd0,10,539,6.0,5,1,5,2,11,6,5,10.4,8.0,2.4,21,CL
43a166b4,4,209,2.3,3,0,1,4,3,2,1,2.8,3.0,-0.3,21,CL
43b78598,3,241,2.7,3,2,0,1,5,3,2,5.1,4.2,0.9,21,CL
43cd8b69,3,74,0.8,1,0,2,1,0,3,-3,0.1,1.3,-1.2,21,CL
4431aed2,5,414,4.6,5,2,0,1,10,8,2,9.7,5.5,4.2,21,CL
448a3608,5,346,3.8,4,3,1,0,3,8,-5,4.5,7.3,-2.7,21,CL
44eb9093,5,309,3.4,3,2,2,1,4,6,-2,5.8,3.3,2.5,21,CL
45a03961,7,566,6.3,7,4,0,2,15,7,8,15.9,9.0,6.9,21,CL
45af8a54,11,619,6.9,7,2,4,1,8,11,-3,9.6,9.0,0.6,21,CL
45b9b619,8,664,7.4,8,4,0,0,12,12,0,12.2,11.0,1.2,21,CL
45db685d,12,1028,11.4,12,9,0,0,18,4,14,22.9,8.2,14.7,21,CL
4601e194,7,485,5.4,6,4,1,0,11,9,2,14.8,9.9,4.9,21,CL
467bae22,4,90,1.0,1,0,3,2,0,3,-3,1.2,1.8,-0.6,21,CL
468fdbad,1,90,1.0,1,1,0,0,0,1,-1,0.1,2.6,-2.5,21,CL
47fd5136,6,471,5.2,6,4,0,0,4,9,-5,5.1,9.3,-4.2,21,CL
48035304,7,618,6.9,7,5,0,0,14,10,4,10.1,12.1,-2.0,21,CL
489e80e3,5,410,4.6,5,3,0,0,9,13,-4,8.5,7.3,1.2,21,CL
48b3dd60,7,333,3.7,4,0,3,0,8,3,5,7.6,4.6,3.0,21,CL
48d5bd33,4,136,1.5,1,1,3,1,1,4,-3,2.0,3.8,-1.8,21,CL
49296448,7,616,6.8,7,6,0,0,21,7,14,17.4,8.0,9.4,21,CL
4958bfb2,2,166,1.8,2,1,0,1,3,1,2,2.6,1.8,0.8,21,CL
496aeede,7,624,6.9,7,6,0,1,16,11,5,11.3,12.0,-0.7,21,CL
49b45985,3,69,0.8,1,0,2,2,1,2,-1,0.8,2.3,-1.5,21,CL
49fe9070,12,810,9.0,10,2,2,1,15,2,13,16.1,6.4,9.8,21,CL
4a1a9578,9,452,5.0,4,1,5,0,9,5,4,6.7,8.0,-1.3,21,CL
4aea5077,8,683,7.6,8,6,0,0,16,12,4,11.2,13.0,-1.7,21,CL
4b6960d2,2,103,1.1,1,1,1,3,0,3,-3,1.5,2.4,-0.8,21,CL
4b77bb89,2,19,0.2,0,0,2,2,1,0,1,0.8,0.3,0.5,21,CL
4b803b3c,6,511,5.7,6,4,0,0,10,16,-6,11.1,9.0,2.1,21,CL
4c14af32,1,23,0.3,0,0,1,2,0,0,0,0.4,0.7,-0.2,21,CL
4c184730,1,45,0.5,1,0,0,3,0,0,0,0.2,0.1,0.1,21,CL
4c2a5d34,6,200,2.2,2,1,4,3,4,2,2,3.0,3.7,-0.7,21,CL
4c2fa917,1,15,0.2,0,0,1,4,0,1,-1,0.2,0.6,-0.4,21,CL
4c32fb38,2,37,0.4,1,0,1,0,2,1,1,0.9,0.9,0.0,21,CL
4c370d81,9,330,3.7,3,0,6,0,4,1,3,5.7,5.3,0.4,21,CL
4c3a6744,7,149,1.7,0,0,7,1,2,7,-5,1.9,3.9,-2.0,21,CL
4c78b5ed,5,352,3.9,5,1,0,1,10,8,2,9.1,5.2,3.9,21,CL
4d034881,7,152,1.7,1,0,6,2,4,1,3,2.4,0.8,1.6,21,CL
4d1666ff,7,515,5.7,6,5,1,0,10,11,-1,9.5,9.4,0.2,21,CL
4d224fe8,10,828,9.2,9,8,1,1,15,10,5,13.5,11.2,2.3,21,CL
4d8cd038,1,58,0.6,1,0,0,2,1,3,-2,0.5,1.2,-0.7,21,CL
4dbd0916,8,192,2.1,1,1,7,0,1,2,-1,2.0,1.8,0.3,21,CL
4e219ad2,4,276,3.1,4,0,0,0,4,5,-1,3.1,4.7,-1.6,21,CL
4e3f5992,3,123,1.4,1,1,2,3,1,4,-3,2.8,5.2,-2.4,21,CL
4e6dbac4,7,585,6.5,7,4,0,0,9,11,-2,8.9,10.6,-1.7,21,CL
4f1e6a0b,4,310,3.4,4,0,0,1,5,5,0,5.9,5.1,0.9,21,CL
4f28a6ff,8,559,6.2,7,4,1,0,14,10,4,13.8,9.7,4.1,21,CL
4fa7cb9b,6,230,2.6,2,1,4,0,5,2,3,3.1,3.3,-0.1,21,CL
4fb9c88f,5,405,4.5,5,4,0,4,9,2,7,6.4,6.2,0.1,21,CL
501055d8,3,52,0.6,0,0,3,0,2,2,0,2.1,1.3,0.8,21,CL
5042e5c2,3,40,0.4,0,0,3,2,0,1,-1,1.0,1.5,-0.5,21,CL
507c7bdf,6,438,4.9,5,3,1,0,13,9,4,10.1,7.7,2.4,21,CL
50871bcc,7,442,4.9,5,2,2,1,13,2,11,8.9,4.6,4.2,21,CL
50dc94ce,6,277,3.1,3,1,3,0,8,5,3,5.7,4.3,1.4,21,CL
5148dcc5,3,241,2.7,3,2,0,0,1,5,-4,3.0,6.5,-3.5,21,CL
515ebe8d,3,270,3.0,3,3,0,1,3,3,0,4.4,3.8,0.6,21,CL
51a3c4c8,5,383,4.3,4,4,1,3,5,8,-3,4.8,7.1,-2.3,21,CL
51cf8561,9,587,6.5,6,5,3,3,10,2,8,9.8,3.7,6.0,21,CL
51dbeea9,5,74,0.8,0,0,5,5,2,0,2,2.2,0.6,1.6,21,CL
520c318f,5,381,4.2,4,3,1,0,4,6,-2,4.2,8.8,-4.6,21,CL
52611641,5,44,0.5,0,0,5,2,1,0,1,0.3,0.1,0.2,21,CL
5271c8f1,1,77,0.9,1,0,0,9,1,0,1,2.4,0.0,2.4,21,CL
527f063d,4,208,2.3,2,1,2,0,7,3,4,5.2,3.1,2.1,21,CL
5294a83f,6,475,5.3,6,1,0,0,10,10,0,10.7,7.1,3.5,21,CL
52e101a8,1,90,1.0,1,1,0,3,1,2,-1,2.7,3.5,-0.8,21,CL
52ec54d0,6,495,5.5,6,4,0,1,13,4,9,11.6,7.3,4.3,21,CL
53cad200,11,962,10.7,11,9,0,2,20,4,16,22.2,7.9,14.3,21,CL
53de807a,2,135,1.5,1,1,1,2,1,3,-2,2.0,2.5,-0.5,21,CL
54f5ce34,3,270,3.0,3,3,0,1,7,3,4,5.1,5.1,0.0,21,CL
55126f3b,8,663,7.4,7,6,1,0,6,10,-4,8.8,9.4,-0.7,21,CL
5526deb1,1,5,0.1,0,0,1,5,0,0,0,0.0,0.1,-0.1,21,CL
552e00b9,2,48,0.5,0,0,2,3,1,1,0,1.5,0.3,1.2,21,CL
555f3a0b,6,348,3.9,3,2,3,2,4,3,1,3.6,4.5,-0.8,21,CL
55abe554,6,532,5.9,6,4,0,0,8,10,-2,8.4,9.3,-0.9,21,CL
5715bb71,3,46,0.5,0,0,3,3,0,0,0,0.7,0.3,0.5,21,CL
5722eced,6,234,2.6,2,0,4,0,1,9,-8,2.3,5.1,-2.8,21,CL
57d88cf9,10,687,7.6,8,5,2,0,14,12,2,10.7,11.5,-0.8,21,CL
580d52dd,4,360,4.0,4,4,0,0,4,5,-1,3.4,7.0,-3.6,21,CL
58a9a4d9,7,279,3.1,2,0,5,1,7,1,6,6.0,3.6,2.4,21,CL
58ae47b2,6,340,3.8,4,1,2,0,2,6,-4,5.6,6.1,-0.5,21,CL
58dda688,5,405,4.5,4,4,1,0,5,11,-6,4.2,8.0,-3.7,21,CL
58eee997,5,211,2.3,2,1,3,0,4,5,-1,3.7,3.1,0.6,21,CL
5976f83e,7,585,6.5,7,5,0,1,16,9,7,17.8,11.5,6.4,21,CL
5ab0ea87,6,334,3.7,4,0,2,1,10,4,6,12.1,5.8,6.3,21,CL
5b54bf3b,3,117,1.3,1,0,2,0,3,6,-3,1.7,3.2,-1.5,21,CL
5c4dc0ff,4,108,1.2,1,0,3,4,2,1,1,2.2,0.2,1.9,21,CL
5c899683,5,120,1.3,1,0,4,5,0,4,-4,1.7,2.6,-0.8,21,CL
5caa62a7,2,66,0.7,0,0,2,0,0,3,-3,1.0,1.1,-0.1,21,CL
5cb1d026,5,390,4.3,4,3,1,0,3,5,-2,3.5,8.3,-4.8,21,CL
5d0e0a1f,5,242,2.7,2,1,3,1,2,4,-2,4.7,5.2,-0.5,21,CL
5da33b33,4,205,2.3,2,0,2,0,2,2,0,2.6,4.4,-1.8,21,CL
5dfc6ad5,5,363,4.0,4,4,1,1,8,4,4,6.5,4.4,2.1,21,CL
5e74d6c8,2,62,0.7,0,0,2,4,3,2,1,2.2,0.8,1.4,21,CL
5eae500a,5,445,4.9,5,4,0,0,5,6,-1,7.6,5.4,2.3,21,CL
5ed9b537,6,476,5.3,5,5,1,2,9,12,-3,7.7,8.4,-0.7,21,CL
5eecec3d,11,798,8.9,8,8,3,2,18,4,14,15.2,6.4,8.8,21,CL
5ef3d210,2,9,0.1,0,0,2,2,0,1,-1,0.0,1.0,-1.0,21,CL
5fcb90ac,1,62,0.7,1,0,0,0,0,3,-3,0.3,2.2,-1.9,21,CL
5fd5e542,7,454,5.0,5,2,2,2,7,7,0,6.1,8.6,-2.5,21,CL
6025fab1,12,912,10.1,10,9,2,0,17,10,7,17.0,13.5,3.5,21,CL
603116a7,2,166,1.8,2,1,0,9,3,4,-1,1.6,3.3,-1.7,21,CL
6043997c,2,180,2.0,2,2,0,4,1,3,-2,1.7,3.7,-2.0,21,CL
608f2092,2,96,1.1,1,0,1,4,0,5,-5,0.8,1.9,-1.2,21,CL
60c07b31,3,190,2.1,2,2,1,1,1,1,0,1.1,3.3,-2.2,21,CL
60e86875,5,280,3.1,4,0,1,0,1,2,-1,2.4,4.2,-1.8,21,CL
620922ed,1,22,0.2,0,0,1,3,0,0,0,0.9,0.1,0.8,21,CL
62d7ef38,2,180,2.0,2,2,0,5,2,1,1,3.1,3.8,-0.7,21,CL
63b9cc6d,3,45,0.5,0,0,3,2,1,5,-4,1.2,1.3,-0.1,21,CL
63e905bc,2,180,2.0,2,2,0,2,1,4,-3,1.9,2.9,-1.0,21,CL
6412cc03,6,160,1.8,2,0,4,3,3,4,-1,1.1,3.2,-2.1,21,CL
6421ec64,5,159,1.8,1,1,4,2,2,0,2,2.9,2.0,0.9,21,CL
6434f10d,10,783,8.7,9,6,1,2,19,4,15,16.7,3.7,12.9,21,CL
652d4c37,3,253,2.8,3,2,0,0,8,3,5,7.9,3.7,4.3,21,CL
6622454d,10,349,3.9,3,0,7,2,10,2,8,9.4,2.0,7.5,21,CL
6639e500,5,138,1.5,0,0,5,2,2,1,1,1.7,2.7,-1.0,21,CL
6747869d,6,407,4.5,5,1,1,0,8,8,0,9.0,5.8,3.1,21,CL
675b0427,5,450,5.0,5,5,0,0,5,10,-5,5.0,9.2,-4.2,21,CL
67cdbc0e,4,286,3.2,4,1,0,0,4,6,-2,5.3,4.1,1.2,21,CL
67f0703d,6,412,4.6,4,4,2,0,4,10,-6,5.8,10.2,-4.4,21,CL
68252d6d,6,278,3.1,2,0,4,2,7,4,3,5.6,3.9,1.7,21,CL
6853490f,3,242,2.7,3,1,0,0,2,8,-6,1.6,6.8,-5.2,21,CL
691bef82,5,413,4.6,5,2,0,0,6,5,1,6.7,5.5,1.2,21,CL
6928979a,6,527,5.9,6,5,0,0,7,8,-1,8.2,6.4,1.8,21,CL
69384e5d,9,743,8.3,9,6,0,0,14,11,3,13.1,12.4,0.7,21,CL
6a2b9aee,2,34,0.4,0,0,2,4,1,0,1,0.8,0.4,0.4,21,CL
6b21b7b5,2,20,0.2,0,0,2,5,0,0,0,0.2,0.1,0.1,21,CL
6b6cbca4,4,319,3.5,3,3,1,1,2,7,-5,3.9,5.0,-1.1,21,CL
6b8887c2,1,10,0.1,0,0,1,3,0,0,0,0.0,0.0,0.0,21,CL
6b915aa1,6,326,3.6,4,1,2,0,4,6,-2,3.5,6.2,-2.7,21,CL
6be41a31,4,96,1.1,1,0,3,2,1,5,-4,1.4,3.8,-2.4,21,CL
6c811eb7,3,124,1.4,1,1,2,3,4,0,4,3.8,0.9,2.9,21,CL
6ce1f46f,12,959,10.7,11,8,1,0,14,11,3,16.3,13.5,2.8,21,CL
6ce43701,1,33,0.4,0,0,1,4,2,0,2,0.8,0.4,0.3,21,CL
6ceef869,5,405,4.5,5,4,0,0,3,8,-5,3.0,8.2,-5.2,21,CL
6d7e4b06,4,93,1.0,1,0,3,2,0,4,-4,0.9,2.5,-1.7,21,CL
6e4df551,8,539,6.0,7,2,1,0,11,11,0,9.4,6.8999999999999995,2.5,21,CL
6e7f1353,6,370,4.1,4,1,2,0,1,9,-8,3.6,8.2,-4.6,21,CL
6eee05f1,8,720,8.0,8,8,0,0,11,12,-1,11.7,10.4,1.3,21,CL
6f3cc2fe,5,79,0.9,0,0,5,5,2,0,2,0.7,2.2,-1.5,21,CL
6f51e382,5,450,5.0,5,5,0,0,8,9,-1,11.2,10.4,0.8,21,CL
6f8cd6d0,8,598,6.6,7,2,1,0,16,10,6,11.2,10.4,0.8,21,CL
6fe90922,6,246,2.7,2,0,4,0,3,4,-1,2.9,2.7,0.3,21,CL
70d74ece,10,840,9.3,9,7,1,0,16,10,6,15.2,14.3,0.8,21,CL
7111d552,12,634,7.0,8,0,4,0,10,7,3,11.3,9.7,1.6,21,CL
7120a04d,6,514,5.7,6,5,0,0,5,12,-7,4.6,10.5,-6.0,21,CL
7155e3e1,4,170,1.9,2,0,2,2,0,1,-1,1.5,2.1,-0.6,21,CL
715e5b0e,5,287,3.2,2,2,3,0,2,5,-3,2.0,5.2,-3.2,21,CL
7272a72a,4,279,3.1,3,0,1,0,1,4,-3,2.2,5.3,-3.2,21,CL
72c812f3,10,488,5.4,7,2,3,0,8,10,-2,9.4,12.0,-2.6,21,CL
733e7ad8,5,323,3.6,3,3,2,0,3,6,-3,5.5,5.5,0.0,21,CL
73affbb6,6,310,3.4,3,1,3,0,2,6,-4,4.3,7.7,-3.5,21,CL
73d6a176,4,91,1.0,1,0,3,2,2,2,0,1.4,2.0,-0.7,21,CL
73fc8cc3,5,87,1.0,0,0,5,1,2,3,-1,2.6,2.1,0.4,21,CL
74419746,6,540,6.0,6,6,0,0,7,9,-2,8.3,6.5,1.8,21,CL
746fec7d,3,26,0.3,0,0,3,3,0,0,0,0.1,0.1,0.0,21,CL
74733221,2,180,2.0,2,2,0,4,1,4,-3,3.1,2.9,0.1,21,CL
7483d9f9,6,540,6.0,6,6,0,0,10,17,-7,11.2,9.3,2.0,21,CL
75b86fb3,6,411,4.6,5,3,1,0,6,7,-1,6.1,5.1,1.0,21,CL
768b28d0,2,15,0.2,0,0,2,2,0,0,0,0.1,0.1,0.0,21,CL
76d5857d,5,450,5.0,5,5,0,0,4,8,-4,5.0,9.9,-4.9,21,CL
7713c72a,6,540,6.0,6,6,0,0,5,12,-7,4.7,11.0,-6.3,21,CL
77e39b04,7,334,3.7,4,1,3,1,9,4,5,9.3,4.7,4.6,21,CL
77e84962,4,222,2.5,2,0,2,0,4,1,3,4.4,2.7,1.6,21,CL
780e3631,7,486,5.4,5,3,2,1,6,5,1,7.1,6.6,0.4,21,CL
79300479,2,133,1.5,2,0,0,0,1,1,0,2.8,1.4,1.5,21,CL
79c0821a,10,600,6.7,7,1,3,0,10,1,9,11.5,6.1,5.5,21,CL
7a11550b,3,270,3.0,3,3,0,0,8,0,8,5.8,3.8,2.0,21,CL
7a2e46a8,7,630,7.0,7,7,0,0,12,5,7,10.6,8.7,1.9,21,CL
7a435eb3,4,38,0.4,0,0,4,1,0,2,-2,0.3,0.1,0.2,21,CL
7a4cea18,3,256,2.8,3,0,0,0,1,3,-2,2.3,3.6,-1.3,21,CL
7b456af7,2,180,2.0,2,2,0,4,5,3,2,3.6,2.5,1.2,21,CL
7b9c2d84,4,328,3.6,4,1,0,0,2,6,-4,5.1,5.7,-0.5,21,CL
7ba6d84e,5,450,5.0,5,5,0,1,14,8,6,10.7,7.4,3.3,21,CL
7c3ed041,3,249,2.8,3,2,0,2,0,7,-7,0.8,5.5,-4.7,21,CL
7c56da38,7,583,6.5,7,5,0,0,7,9,-2,8.3,9.6,-1.3,21,CL
7cd6badb,7,531,5.9,7,0,0,1,12,8,4,8.8,9.1,-0.3,21,CL
7cf431a5,4,213,2.4,3,0,1,2,0,4,-4,1.0,4.8,-3.8,21,CL
7f3b388c,8,554,6.2,7,5,1,0,6,4,2,8.6,8.2,0.4,21,CL
7f97771d,8,191,2.1,1,0,7,1,5,3,2,3.4,3.9,-0.5,21,CL
7fa4e703,8,458,5.1,4,1,4,1,12,4,8,7.8,6.0,1.8,21,CL
7fd58fe3,2,105,1.2,0,0,2,0,2,3,-1,1.4,1.9,-0.6,21,CL
807e869a,6,456,5.1,5,2,1,0,4,8,-4,4.1,8.7,-4.6,21,CL
8104e41e,5,412,4.6,5,2,0,0,4,10,-6,5.6,8.2,-2.6,21,CL
81442ecb,4,327,3.6,3,3,1,0,6,2,4,6.0,3.2,2.8,21,CL
819b3158,12,973,10.8,12,7,0,1,20,5,15,17.0,6.8,10.2,21,CL
81d3318f,4,179,2.0,2,0,2,2,1,1,0,0.8,3.3,-2.5,21,CL
82a39b66,2,83,0.9,1,0,1,5,1,0,1,1.0,2.0,-1.0,21,CL
833a8fbc,6,533,5.9,6,5,0,0,5,10,-5,4.8,10.7,-5.9,21,CL
83e1f40e,3,21,0.2,0,0,3,2,0,1,-1,0.8,1.3,-0.5,21,CL
853b7c48,9,840,9.3,9,9,0,1,13,9,4,11.5,14.0,-2.5,21,CL
85686f86,4,164,1.8,2,0,2,0,5,2,3,3.0,2.1,0.9,21,CL
862fa9fb,4,296,3.3,3,2,1,0,3,8,-5,2.5,5.9,-3.4,21,CL
864db10a,1,9,0.1,0,0,1,7,0,0,0,0.1,0.0,0.1,21,CL
866c67e9,1,45,0.5,0,0,1,1,0,1,-1,0.0,1.8,-1.8,21,CL
867239d3,5,181,2.0,1,0,4,0,6,2,4,4.1,2.3,1.8,21,CL
8690eef7,4,52,0.6,0,0,4,1,1,2,-1,1.6,1.4,0.2,21,CL
8696bc90,6,294,3.3,3,1,3,1,6,5,1,6.9,3.9,3.0,21,CL
86dd16a8,6,540,6.0,6,6,0,0,5,10,-5,4.9,11.1,-6.2,21,CL
86dd77d1,11,981,10.9,11,10,0,1,23,5,18,17.5,7.0,10.5,21,CL
86e7deaf,8,566,6.3,7,5,1,0,9,3,6,13.4,3.2,10.2,21,CL
873619c6,1,11,0.1,0,0,1,4,0,0,0,0.1,0.1,0.1,21,CL
875898c7,7,483,5.4,5,4,2,1,9,6,3,9.7,6.6,3.1,21,CL
8778c910,8,720,8.0,8,8,0,0,24,8,16,18.8,11.2,7.5,21,CL
8794e251,7,500,5.6,5,4,2,1,11,6,5,9.8,7.3,2.5,21,CL
886f9aac,6,370,4.1,4,2,2,0,4,11,-7,2.6,8.2,-5.7,21,CL
88968486,6,540,6.0,6,6,0,0,4,13,-9,6.3,13.0,-6.7,21,CL
88e357ef,6,360,4.0,3,1,3,0,13,4,9,9.7,5.9,3.8,21,CL
892d5bb1,12,811,9.0,9,6,3,1,16,5,11,13.6,6.7,6.9,21,CL
8954fddc,1,65,0.7,1,0,0,4,0,1,-1,0.0,2.2,-2.2,21,CL
89ac64a6,7,630,7.0,7,7,0,0,14,7,7,9.4,8.8,0.6,21,CL
89f951b5,8,458,5.1,6,2,2,0,9,10,-1,6.4,7.7,-1.3,21,CL
8a1d7b51,6,495,5.5,6,5,0,0,6,9,-3,6.0,11.0,-5.0,21,CL
8aafd64f,8,705,7.8,8,5,0,0,7,11,-4,8.8,10.2,-1.4,21,CL
8b298f56,5,222,2.5,2,0,3,1,1,5,-4,2.5,5.3,-2.8,21,CL
8b3ab7ad,4,125,1.4,1,0,3,2,1,2,-1,1.4,2.4,-1.0,21,CL
8b3d765f,2,180,2.0,2,2,0,4,2,3,-1,1.5,4.1,-2.6,21,CL
8b683d09,6,328,3.6,3,2,3,0,6,10,-4,3.4,7.5,-4.1,21,CL
8b788c01,5,426,4.7,5,2,0,0,12,6,6,8.8,5.8,2.9,21,CL
8b8e759d,8,387,4.3,4,2,4,1,5,4,1,5.1,5.2,-0.1,21,CL
8bc373ea,6,451,5.0,5,5,1,0,1,10,-9,3.1,8.6,-5.5,21,CL
8ce30c57,4,237,2.6,3,1,1,2,5,4,1,3.0,3.8,-0.7,21,CL
8d78e732,6,512,5.7,6,4,0,0,20,5,15,13.1,8.4,4.7,21,CL
8e034340,6,297,3.3,4,0,2,0,5,8,-3,4.5,6.1,-1.6,21,CL
8e7f49d3,6,498,5.5,6,4,0,0,4,12,-8,5.4,10.0,-4.6,21,CL
8e8f40e0,2,40,0.4,0,0,2,1,0,2,-2,0.3,1.1,-0.8,21,CL
8f5e92a6,11,323,3.6,3,0,8,0,7,7,0,6.2,5.6,0.6,21,CL
8fd9996f,12,785,8.7,8,8,4,0,17,9,8,16.3,13.6,2.7,21,CL
8ff2354e,3,184,2.0,2,2,1,3,2,5,-3,1.4,3.9,-2.4,21,CL
903b6e8b,6,540,6.0,6,6,0,0,2,10,-8,4.1,9.5,-5.4,21,CL
90463dba,1,45,0.5,0,0,1,4,1,1,0,0.9,0.9,0.0,21,CL
9139bb12,6,426,4.7,6,1,0,0,4,9,-5,4.0,8.9,-4.9,21,CL
91899ca8,1,30,0.3,1,0,0,1,0,2,-2,0.1,0.8,-0.7,21,CL
921f6058,6,210,2.3,2,1,4,2,3,8,-5,4.2,4.4,-0.2,21,CL
922da988,6,449,5.0,6,2,0,0,4,10,-6,5.5,8.7,-3.3,21,CL
923f4dda,4,340,3.8,4,2,0,0,2,6,-4,4.1,8.6,-4.6,21,CL
92432bc6,6,426,4.7,5,2,1,0,9,10,-1,7.6,7.1,0.5,21,CL
928a4a61,4,324,3.6,4,1,0,0,2,7,-5,4.2,5.2,-1.0,21,CL
934e1968,6,505,5.6,6,3,0,0,8,16,-8,9.2,8.4,0.8,21,CL
935e6b8f,6,364,4.0,4,2,2,0,8,1,7,6.2,5.6,0.6,21,CL
93b891d1,5,136,1.5,1,0,4,2,2,2,0,1.1,2.7,-1.6,21,CL
93fffbcf,1,90,1.0,1,1,0,7,2,0,2,1.0,1.0,0.0,21,CL
947e036f,8,734,8.2,8,2,0,0,12,7,5,10.1,11.8,-1.7,21,CL
94b2001f,7,569,6.3,6,6,1,0,13,6,7,11.3,7.1,4.2,21,CL
94f8d10c,4,360,4.0,4,4,0,2,2,8,-6,4.0,5.7,-1.7,21,CL
9614b550,5,449,5.0,5,4,0,0,3,12,-9,6.4,8.9,-2.5,21,CL
9674002f,11,755,8.4,9,2,2,1,15,1,14,17.2,5.4,11.8,21,CL
9686fc54,4,270,3.0,3,2,1,1,2,6,-4,2.4,6.1,-3.6,21,CL
96e0490d,4,167,1.9,2,1,2,2,3,3,0,4.2,2.4,1.8,21,CL
9744ff80,4,143,1.6,1,0,3,6,3,3,0,3.7,2.5,1.3,21,CL
9778d8dd,1,90,1.0,1,1,0,5,2,2,0,1.1,0.8,0.3,21,CL
980522ec,4,101,1.1,1,0,3,2,1,1,0,2.2,0.9,1.2,21,CL
98d2c2c4,7,522,5.8,7,4,0,0,8,8,0,8.9,6.1,2.9,21,CL
99127249,4,358,4.0,4,2,0,1,4,5,-1,4.3,5.6,-1.3,21,CL
9a1f2e1c,6,517,5.7,6,5,0,0,7,18,-11,5.0,11.7,-6.6,21,CL
9a2e0ccc,7,461,5.1,7,1,0,0,8,8,0,7.2,8.7,-1.5,21,CL
9c2b4382,5,82,0.9,0,0,5,1,2,4,-2,2.0,1.8,0.3,21,CL
9c94165b,4,330,3.7,4,3,0,0,8,5,3,5.9,3.7,2.2,21,CL
9d12e142,4,360,4.0,4,4,0,5,9,1,8,6.5,3.3,3.2,21,CL
9d60028d,3,219,2.4,2,1,1,0,2,2,0,1.7,3.5,-1.8,21,CL
9d689a5b,6,287,3.2,4,0,2,0,0,5,-5,1.8,5.3,-3.5,21,CL
9dc96f10,1,23,0.3,0,0,1,2,1,0,1,1.2,0.1,1.1,21,CL
9ddb85e8,4,224,2.5,3,0,1,2,3,6,-3,3.1,5.0,-1.9,21,CL
9e1035f8,6,360,4.0,4,2,2,7,9,0,9,7.4,1.5,5.9,21,CL
9e525177,6,469,5.2,6,1,0,0,10,8,2,8.6,7.5,1.1,21,CL
9f1893b9,1,62,0.7,1,0,0,7,1,0,1,1.0,0.9,0.0,21,CL
9f8e9423,9,810,9.0,9,9,0,0,16,11,5,15.8,9.6,6.2,21,CL
9fc2531b,3,29,0.3,0,0,3,0,1,3,-2,0.9,0.6,0.3,21,CL
a08b974a,7,450,5.0,5,3,2,0,6,8,-2,6.9,7.5,-0.6,21,CL
a0b4bb3e,3,98,1.1,1,0,2,9,0,1,-1,1.2,0.3,0.9,21,CL
a0f9b535,3,43,0.5,0,0,3,1,1,1,0,2.6,0.7,1.8,21,CL
a167537f,8,218,2.4,2,0,6,2,6,3,3,4.5,3.2,1.4,21,CL
a1d5bd30,6,414,4.6,5,2,1,0,13,8,5,9.8,6.8,3.1,21,CL
a39bb753,5,274,3.0,3,0,2,0,6,3,3,5.0,4.7,0.3,21,CL
a3b0ed18,6,540,6.0,6,6,0,0,5,10,-5,4.9,11.1,-6.2,21,CL
a3b952f8,4,360,4.0,4,4,0,1,3,9,-6,5.2,8.4,-3.2,21,CL
a3d94a58,7,625,6.9,7,6,0,1,10,7,3,10.5,7.9,2.6,21,CL
a4b1028a,6,540,6.0,6,6,0,0,3,11,-8,7.6,12.4,-4.8,21,CL
a4e16ab4,3,67,0.7,1,0,2,6,1,0,1,1.0,0.9,0.0,21,CL
a4effc55,2,21,0.2,0,0,2,1,1,1,0,0.0,0.6,-0.5,21,CL
a6154613,6,457,5.1,6,2,0,0,4,9,-5,5.1,8.2,-3.1,21,CL
a65ce836,6,469,5.2,5,5,1,0,9,9,0,6.7,8.7,-1.9,21,CL
a793f5a8,1,5,0.1,0,0,1,5,0,0,0,0.0,0.0,0.0,21,CL
a802405e,4,160,1.8,1,1,3,1,1,5,-4,2.6,3.5,-0.9,21,CL
a81ed730,4,264,2.9,3,1,1,2,1,8,-7,3.5,8.0,-4.5,21,CL
a8542814,5,299,3.3,3,2,2,1,4,8,-4,4.6,5.7,-1.0,21,CL
a8567629,10,410,4.6,3,3,7,2,10,5,5,8.6,5.2,3.5,21,CL
a9142dc3,2,28,0.3,0,0,2,4,2,0,2,1.0,0.0,1.0,21,CL
a9aa0d1d,3,24,0.3,0,0,3,3,1,1,0,0.2,0.2,0.0,21,CL
a9be27f2,6,523,5.8,6,5,0,0,6,11,-5,6.4,11.9,-5.5,21,CL
a9dc785c,3,270,3.0,3,3,0,5,10,1,9,9.2,2.5,6.7,21,CL
ab1b205d,5,85,0.9,0,0,5,1,3,3,0,0.7,1.7,-1.0,21,CL
abb3bb95,6,378,4.2,4,0,2,2,8,3,5,7.7,3.3,4.4,21,CL
ac4003af,5,450,5.0,5,5,0,3,8,11,-3,9.1,8.1,1.0,21,CL
ac73ec79,7,548,6.1,7,4,0,0,11,11,0,8.8,9.4,-0.6,21,CL
ac7e640b,1,7,0.1,0,0,1,1,0,1,-1,0.1,0.2,-0.1,21,CL
ad6df2d5,8,492,5.5,6,3,2,0,11,5,6,13.6,8.0,5.6,21,CL
adfbe1f5,5,387,4.3,5,1,0,0,4,10,-6,3.5,7.0,-3.5,21,CL
adfc9123,3,235,2.6,3,1,0,0,6,4,2,7.2,5.5,1.8,21,CL
ae44e8e2,8,582,6.5,8,2,0,0,9,13,-4,8.8,10.5,-1.7,21,CL
ae9898c5,2,15,0.2,0,0,2,6,0,0,0,0.6,0.7,-0.1,21,CL
aef6e670,11,978,10.9,11,9,0,0,21,15,6,20.2,17.2,3.0,21,CL
afb0c500,2,180,2.0,2,2,0,7,3,2,1,3.0,2.7,0.3,21,CL
b0616e3d,3,183,2.0,3,1,0,3,3,6,-3,2.5,3.0,-0.5,21,CL
b088363d,3,195,2.2,2,2,1,1,1,5,-4,1.6,4.3,-2.7,21,CL
b0b902c8,4,282,3.1,3,3,1,0,2,5,-3,3.8,4.4,-0.6,21,CL
b0c7a51d,6,540,6.0,6,6,0,0,4,13,-9,7.1,11.3,-4.2,21,CL
b0f7e36c,8,551,6.1,6,3,2,0,12,5,7,10.9,7.2,3.7,21,CL
b105919e,1,79,0.9,1,0,0,1,1,1,0,2.5,0.4,2.1,21,CL
b1579026,4,185,2.1,2,2,2,2,4,10,-6,1.5,5.7,-4.3,21,CL
b182a240,5,248,2.8,1,1,4,1,2,3,-1,3.0,3.0,0.0,21,CL
b19db005,6,382,4.2,4,2,2,1,9,7,2,10.3,7.1,3.3,21,CL
b1dae700,4,32,0.4,0,0,4,2,0,1,-1,0.1,1.1,-1.0,21,CL
b217ef29,2,174,1.9,2,1,0,2,1,2,-1,2.2,2.7,-0.6,21,CL
b39bf63f,6,510,5.7,6,2,0,0,6,9,-3,6.1,11.0,-5.0,21,CL
b3a712de,4,289,3.2,3,2,1,0,3,4,-1,3.2,4.7,-1.5,21,CL
b400bde0,11,648,7.2,7,3,4,2,14,2,12,13.5,2.9,10.5,21,CL
b4a014b1,8,720,8.0,8,8,0,0,13,13,0,12.1,11.1,1.0,21,CL
b583aef5,6,540,6.0,6,6,0,0,7,18,-11,5.2,12.2,-7.0,21,CL
b5f66351,5,398,4.4,4,3,1,1,3,12,-9,4.6,9.2,-4.5,21,CL
b5f7d10b,6,540,6.0,6,6,0,0,5,12,-7,4.7,11.0,-6.3,21,CL
b62878a5,1,8,0.1,1,0,0,0,0,0,0,0.0,0.0,0.0,21,CL
b66315ae,7,270,3.0,2,0,5,4,6,1,5,6.6,1.5,5.1,21,CL
b686f4c0,4,204,2.3,2,0,2,2,4,9,-5,1.5,5.8,-4.4,21,CL
b69261a0,4,215,2.4,3,1,1,4,6,5,1,5.4,3.7,1.8,21,CL
b70bde8f,1,13,0.1,0,0,1,2,0,0,0,0.0,0.1,0.0,21,CL
b74277a0,6,477,5.3,6,2,0,0,7,6,1,7.5,7.2,0.2,21,CL
b79d8e93,2,175,1.9,2,1,0,4,2,7,-5,1.6,4.5,-2.8,21,CL
b7a5bc86,6,340,3.8,5,1,1,2,5,5,0,5.1,5.4,-0.4,21,CL
b825a650,7,368,4.1,6,0,1,1,7,5,2,5.0,6.6,-1.5,21,CL
b853e0ad,4,339,3.8,4,3,0,1,12,4,8,8.5,4.9,3.6,21,CL
b8814868,4,344,3.8,4,1,0,0,3,9,-6,5.0,8.7,-3.7,21,CL
b8e740fb,6,528,5.9,6,5,0,0,7,6,1,7.9,7.1,0.8,21,CL
b937e490,2,22,0.2,0,0,2,4,0,1,-1,0.4,0.6,-0.2,21,CL
b96b595c,8,720,8.0,8,8,0,0,13,13,0,13.1,11.6,1.5,21,CL
b997c3de,9,746,8.3,8,7,1,0,11,8,3,8.9,12.3,-3.4,21,CL
b9fbae28,13,714,7.9,7,6,6,0,16,3,13,17.4,3.8,13.6,21,CL
ba3d3bea,4,88,1.0,0,0,4,2,2,0,2,1.8,0.9,0.8,21,CL
bac46a10,5,299,3.3,3,2,2,1,3,4,-1,3.3,3.7,-0.4,21,CL
bc6bd723,8,539,6.0,6,3,2,0,13,7,6,8.4,9.9,-1.5,21,CL
bc6f5f06,3,197,2.2,3,1,0,3,2,4,-2,2.3,3.6,-1.3,21,CL
bcb2ccd8,8,720,8.0,8,8,0,0,11,16,-5,10.6,12.8,-2.2,21,CL
bd20f4eb,5,245,2.7,2,2,3,1,1,7,-6,1.7,6.5,-4.8,21,CL
bd6351cd,9,605,6.7,7,5,2,4,13,3,10,12.9,3.0,9.8,21,CL
be42a291,7,84,0.9,0,0,7,0,1,2,-1,0.9,2.0,-1.1,21,CL
be60b6f4,4,73,0.8,0,0,4,2,1,0,1,0.9,1.9,-1.0,21,CL
be927d03,5,417,4.6,5,2,0,0,5,7,-2,5.0,5.0,0.1,21,CL
bef0a7ac,6,257,2.9,3,0,3,0,0,8,-8,3.3,5.7,-2.4,21,CL
bfc5768b,5,157,1.7,2,0,3,0,1,3,-2,1.0,3.4,-2.4,21,CL
bfe272bd,3,178,2.0,1,0,2,1,4,8,-4,1.5,4.8,-3.3,21,CL
c01f247a,4,358,4.0,4,3,0,0,4,5,-1,3.3,6.9,-3.5,21,CL
c14bc029,6,460,5.1,6,3,0,0,3,5,-2,5.1,6.3,-1.2,21,CL
c1febb46,6,468,5.2,5,4,1,0,5,14,-9,5.0,10.2,-5.2,21,CL
c24544c7,6,517,5.7,6,4,0,0,8,10,-2,8.4,9.3,-0.9,21,CL
c283ddef,1,10,0.1,0,0,1,6,0,0,0,0.5,0.6,-0.1,21,CL
c3ee18ef,10,696,7.7,7,7,3,0,20,9,11,18.2,11.8,6.4,21,CL
c432ba7d,2,37,0.4,0,0,2,4,0,0,0,0.7,0.8,-0.1,21,CL
c43e5e7e,3,159,1.8,2,1,1,0,0,6,-6,0.8,4.7,-4.0,21,CL
c459a650,2,174,1.9,2,1,0,0,1,3,-2,1.5,3.9,-2.4,21,CL
c4987edc,3,183,2.0,2,2,1,6,2,0,2,1.1,3.6,-2.5,21,CL
c50e5bba,5,396,4.4,5,4,0,0,3,10,-7,3.1,6.6,-3.5,21,CL
c56dc39e,8,623,6.9,7,6,1,0,10,10,0,9.7,9.0,0.7,21,CL
c603ad6a,6,373,4.1,5,2,1,0,2,7,-5,3.4,6.8,-3.4,21,CL
c63f6e46,5,424,4.7,5,2,0,0,2,7,-5,4.0,7.0,-3.0,21,CL
c6486b01,6,491,5.5,6,2,0,0,4,13,-9,6.4,11.0,-4.6,21,CL
c64c01fc,1,21,0.2,0,0,1,5,1,1,0,1.8,0.4,1.4,21,CL
c691bfe2,10,714,7.9,8,5,2,0,13,5,8,12.1,11.3,0.8,21,CL
c7069d87,5,384,4.3,4,4,1,0,3,7,-4,4.1,9.0,-4.9,21,CL
c71e97ba,4,354,3.9,4,2,0,0,3,6,-3,3.3,5.9,-2.7,21,CL
c7526c18,5,421,4.7,5,4,0,0,3,10,-7,7.0,9.0,-2.1,21,CL
c864997f,1,1,0.0,0,0,1,3,0,0,0,0.0,0.0,0.0,21,CL
c904f3d5,6,528,5.9,6,5,0,0,2,10,-8,4.1,9.5,-5.4,21,CL
c906ce0f,6,570,6.3,6,6,0,0,8,9,-1,6.9,9.2,-2.3,21,CL
c931d9f9,2,35,0.4,0,0,2,4,1,1,0,0.7,0.3,0.5,21,CL
ca45605e,4,205,2.3,3,1,1,0,3,5,-2,3.2,2.7,0.5,21,CL
ca607d59,4,58,0.6,0,0,4,0,1,6,-5,1.3,1.2,0.1,21,CL
ca8033cb,2,180,2.0,2,2,0,0,0,4,-4,2.2,3.8,-1.6,21,CL
cbbfa2e7,3,199,2.2,3,0,0,0,3,4,-1,2.2,4.3,-2.1,21,CL
cc77354e,5,385,4.3,5,2,0,0,2,9,-7,3.8,6.8,-3.0,21,CL
cc86b9a3,7,434,4.8,7,1,0,0,13,4,9,10.9,6.0,4.9,21,CL
cd1acf9d,8,711,7.9,8,7,0,0,14,4,10,12.0,10.7,1.3,21,CL
ce30bfc8,4,254,2.8,3,1,1,0,3,5,-2,2.8,3.9,-1.1,21,CL
ce4246f5,5,450,5.0,5,5,0,7,11,1,10,10.2,3.1,7.1,21,CL
cecbce23,4,360,4.0,4,4,0,1,2,7,-5,4.5,9.4,-4.9,21,CL
d003e213,6,540,6.0,6,6,0,0,2,10,-8,4.1,9.5,-5.4,21,CL
d0d8dd44,6,540,6.0,6,6,0,0,7,9,-2,8.3,6.5,1.8,21,CL
d125f22f,3,27,0.3,0,0,3,3,0,0,0,0.2,0.1,0.0,21,CL
d14229f3,3,89,1.0,1,0,2,3,0,0,0,2.1,1.1,1.0,21,CL
d1f48bfc,6,362,4.0,4,2,2,0,2,14,-12,2.9,10.9,-8.1,21,CL
d2416c2e,8,508,5.6,5,4,3,0,7,11,-4,6.8,8.6,-1.8,21,CL
d2424d1b,10,773,8.6,9,7,1,3,15,3,12,17.7,5.3,12.3,21,CL
d248cd8f,7,604,6.7,7,6,0,0,8,14,-6,8.8,10.7,-1.9,21,CL
d2795011,3,186,2.1,2,0,1,3,1,3,-2,1.2,3.1,-1.9,21,CL
d2800f47,6,486,5.4,6,3,0,0,6,17,-11,4.9,11.2,-6.3,21,CL
d29202c2,6,457,5.1,6,0,0,0,3,11,-8,5.1,9.0,-3.9,21,CL
d3de9af0,8,522,5.8,6,3,2,0,7,10,-3,8.8,8.3,0.5,21,CL
d4133fa1,6,528,5.9,6,5,0,0,2,10,-8,4.0,9.5,-5.5,21,CL
d436eb94,5,450,5.0,5,5,0,0,6,9,-3,6.5,7.1,-0.7,21,CL
d4535821,8,720,8.0,8,8,0,0,13,13,0,13.1,11.6,1.5,21,CL
d4e93bab,6,443,4.9,6,1,0,0,3,7,-4,4.1,8.1,-4.0,21,CL
d4f034db,3,126,1.4,2,1,1,2,2,0,2,1.3,1.8,-0.4,21,CL
d5dafedb,1,90,1.0,1,1,0,4,1,1,0,1.1,2.3,-1.2,21,CL
d5f2f82b,10,815,9.1,10,8,0,1,20,10,10,17.2,14.0,3.2,21,CL
d63e2912,6,540,6.0,6,6,0,0,2,13,-11,5.9,10.1,-4.3,21,CL
d68cb24c,3,108,1.2,1,1,2,1,2,1,1,1.2,1.3,-0.1,21,CL
d6e53a3a,5,406,4.5,4,4,1,0,10,4,6,8.7,3.9,4.7,21,CL
d70ce98e,6,540,6.0,6,6,0,0,11,10,1,13.4,11.8,1.6,21,CL
d781d855,6,321,3.6,3,1,3,0,9,3,6,6.7,3.9,2.8,21,CL
d80b1835,1,15,0.2,0,0,1,7,1,1,0,0.7,1.1,-0.4,21,CL
d8931174,5,450,5.0,5,5,0,0,13,9,4,10.1,7.0,3.1,21,CL
d93c2511,5,343,3.8,3,3,2,0,9,7,2,7.4,5.9,1.5,21,CL
d94653be,6,206,2.3,2,1,4,0,3,7,-4,2.2,4.9,-2.7,21,CL
d97b252e,4,360,4.0,4,4,0,0,4,8,-4,4.9,7.8,-2.9,21,CL
d97f2e8d,1,10,0.1,0,0,1,4,0,0,0,0.5,0.6,-0.1,21,CL
d9b9b71a,4,139,1.5,1,1,3,6,3,0,3,1.1,2.8,-1.7,21,CL
d9d43555,2,38,0.4,0,0,2,0,0,1,-1,0.5,0.7,-0.1,21,CL
da1185fc,5,423,4.7,5,4,0,0,4,11,-7,4.3,8.9,-4.6,21,CL
da27e268,2,155,1.7,2,1,0,5,4,0,4,2.5,1.8,0.8,21,CL
db4ed67b,6,489,5.4,6,2,0,3,9,7,2,6.9,8.2,-1.3,21,CL
db750822,3,31,0.3,0,0,3,5,0,0,0,0.1,0.1,0.0,21,CL
dba67bc4,6,460,5.1,6,2,0,0,8,12,-4,8.5,8.2,0.3,21,CL
dbf053da,6,387,4.3,4,3,2,1,9,5,4,5.7,3.3,2.4,21,CL
dc52c72f,6,540,6.0,6,6,0,0,4,13,-9,6.3,13.0,-6.7,21,CL
dc7f8a28,1,9,0.1,0,0,1,3,0,0,0,0.0,0.0,0.0,21,CL
dca7b0fb,2,58,0.6,0,0,2,3,0,1,-1,0.4,1.4,-1.0,21,CL
dd323728,4,190,2.1,2,2,2,4,1,2,-1,2.7,3.6,-0.9,21,CL
de39485a,5,380,4.2,5,0,0,0,3,6,-3,3.9,6.4,-2.5,21,CL
dea698d9,6,569,6.3,6,5,0,0,16,6,10,13.4,7.0,6.5,21,CL
defb905a,5,401,4.5,5,3,0,0,4,10,-6,3.9,7.7,-3.8,21,CL
df10e27c,2,96,1.1,1,1,1,5,1,1,0,2.5,0.5,2.0,21,CL
df3cda47,6,268,3.0,3,0,3,2,3,4,-1,3.5,2.9,0.5,21,CL
df69b544,7,501,5.6,6,2,1,1,9,7,2,14.0,9.0,5.0,21,CL
dfb50e5c,5,197,2.2,1,0,4,1,2,9,-7,1.9,6.2,-4.3,21,CL
dfb6490a,4,64,0.7,0,0,4,4,2,3,-1,1.3,3.5,-2.1,21,CL
dff153a4,8,670,7.4,8,5,0,1,13,9,4,12.9,10.5,2.4,21,CL
e08647d6,1,8,0.1,0,0,1,3,0,1,-1,0.1,0.9,-0.8,21,CL
e0921a4f,5,216,2.4,2,1,3,2,4,4,0,2.5,4.2,-1.7,21,CL
e0bc6fdc,6,220,2.4,2,2,4,7,7,1,6,6.1,2.3,3.8,21,CL
e162b013,7,348,3.9,4,2,3,1,10,5,5,6.8,3.9,2.9,21,CL
e27fdbca,9,743,8.3,8,5,1,1,11,7,4,11.2,10.7,0.5,21,CL
e280527c,7,567,6.3,6,5,1,1,9,15,-6,9.3,11.4,-2.1,21,CL
e288d4b3,10,807,9.0,10,2,0,1,17,11,6,15.8,12.6,3.2,21,CL
e33c06cf,7,536,6.0,6,5,1,0,15,6,9,13.6,6.0,7.7,21,CL
e342ad68,10,778,8.6,9,5,1,0,14,5,9,13.2,12.3,0.9,21,CL
e358587b,7,630,7.0,7,7,0,1,10,12,-2,11.4,10.2,1.2,21,CL
e3cceee6,5,400,4.4,3,1,2,0,9,4,5,7.7,5.2,2.4,21,CL
e40d028b,1,90,1.0,1,1,0,5,3,0,3,2.9,0.9,1.9,21,CL
e42d61c7,5,358,4.0,4,2,1,0,4,6,-2,4.1,3.9,0.2,21,CL
e46012d4,8,665,7.4,8,4,0,3,15,4,11,12.0,5.2,6.7,21,CL
e4d5e2ae,1,1,0.0,0,0,1,2,0,0,0,0.0,0.0,0.0,21,CL
e54a9890,2,83,0.9,1,0,1,1,0,3,-3,1.3,1.6,-0.3,21,CL
e599253a,5,281,3.1,3,1,2,0,3,9,-6,3.7,5.1,-1.3,21,CL
e5a76dfe,1,90,1.0,1,1,0,5,1,2,-1,0.7,1.0,-0.2,21,CL
e613313c,6,502,5.6,6,4,0,0,7,7,0,7.9,7.6,0.3,21,CL
e73c9bb2,4,291,3.2,4,2,0,0,6,7,-1,5.8,6.2,-0.4,21,CL
e76cb9cc,10,930,10.3,10,10,0,0,15,9,6,12.5,15.1,-2.6,21,CL
e7986081,2,47,0.5,0,0,2,0,0,1,-1,0.3,0.8,-0.5,21,CL
e81f0356,4,45,0.5,0,0,4,2,0,5,-5,0.2,1.0,-0.8,21,CL
e85fb9b8,3,142,1.6,3,1,0,1,4,2,2,3.3,2.3,0.9,21,CL
e8c0cafd,2,33,0.4,0,0,2,4,0,0,0,0.2,0.7,-0.5,21,CL
e92cd3f7,4,114,1.3,0,0,4,4,2,8,-6,1.1,3.7,-2.5,21,CL
e9c0c1b2,6,540,6.0,6,6,0,0,7,7,0,8.1,8.0,0.0,21,CL
ea0ff634,5,201,2.2,2,0,3,1,2,3,-1,2.5,3.2,-0.6,21,CL
eaeca114,2,180,2.0,2,2,0,7,6,0,6,4.1,1.2,2.9,21,CL
eb2b33aa,4,360,4.0,4,4,0,0,1,9,-8,2.0,8.6,-6.6,21,CL
eb2fe5b6,7,349,3.9,5,0,2,1,5,7,-2,5.8,6.5,-0.7,21,CL
eb58eef0,9,717,8.0,8,5,1,1,14,4,10,12.6,10.1,2.5,21,CL
eb6e14be,6,472,5.2,5,3,1,0,8,12,-4,10.8,8.2,2.5,21,CL
eb7822d7,4,221,2.5,3,1,1,2,3,4,-1,2.5,2.2,0.3,21,CL
ebc56869,5,183,2.0,2,0,3,1,3,1,2,2.9,2.5,0.4,21,CL
ecada4fc,12,1080,12.0,12,12,0,0,22,15,7,21.4,18.8,2.6,21,CL
ecb68eea,5,375,4.2,4,3,1,0,4,9,-5,4.5,7.8,-3.3,21,CL
ed140063,6,522,5.8,6,4,0,0,7,18,-11,5.0,11.6,-6.7,21,CL
ed1e53f3,13,1064,11.8,12,9,1,0,21,4,17,21.0,6.4,14.6,21,CL
ed2b33cb,3,166,1.8,2,0,1,2,2,5,-3,1.7,4.2,-2.5,21,CL
ed33f42d,2,10,0.1,0,0,2,2,0,2,-2,0.0,1.1,-1.1,21,CL
ed45c4a5,6,441,4.9,5,3,1,0,2,10,-8,5.3,7.4,-2.1,21,CL
ed5886d2,5,246,2.7,3,1,2,3,5,4,1,4.0,4.2,-0.1,21,CL
ed87a229,3,104,1.2,1,0,2,2,1,3,-2,0.8,0.9,-0.1,21,CL
ed9f7cfe,8,379,4.2,5,2,3,0,3,8,-5,5.9,5.9,0.0,21,CL
eda40760,1,90,1.0,1,1,0,3,2,2,0,2.8,1.4,1.4,21,CL
edd38473,3,112,1.2,1,0,2,1,2,8,-6,1.2,4.4,-3.2,21,CL
ee3519f5,4,292,3.2,3,3,1,1,2,5,-3,2.5,6.4,-4.0,21,CL
ee37317d,3,5,0.1,0,0,3,6,0,0,0,0.0,0.0,0.0,21,CL
ee8508c0,8,720,8.0,8,8,0,0,7,11,-4,9.2,10.3,-1.1,21,CL
ee93c1a9,7,150,1.7,1,0,6,1,5,4,1,3.3,2.7,0.6,21,CL
ef2e5e1a,3,31,0.3,0,0,3,3,0,3,-3,0.0,1.6,-1.6,21,CL
ef619b0b,7,357,4.0,5,0,2,1,11,1,10,9.7,3.5,6.2,21,CL
f0661424,6,512,5.7,6,5,0,0,7,6,1,7.6,7.0,0.6,21,CL
f090a37a,4,89,1.0,0,0,4,4,2,1,1,3.0,1.7,1.4,21,CL
f0da930c,4,337,3.7,4,3,0,1,2,3,-1,4.4,3.2,1.2,21,CL
f0f7f62f,3,270,3.0,3,3,0,3,3,1,2,2.6,2.3,0.3,21,CL
f0fc9d0e,3,248,2.8,3,2,0,3,2,7,-5,1.8,4.6,-2.8,21,CL
f25c8e3a,4,146,1.6,2,0,2,1,2,2,0,2.4,3.2,-0.8,21,CL
f315ca93,4,130,1.4,2,0,2,4,1,1,0,1.8,2.1,-0.3,21,CL
f36d5624,3,98,1.1,1,0,2,3,0,3,-3,0.2,1.8,-1.6,21,CL
f38cc3b3,3,270,3.0,3,3,0,0,3,8,-5,2.2,5.1,-2.8,21,CL
f3945e07,3,103,1.1,1,0,2,7,3,2,1,1.1,2.4,-1.3,21,CL
f3fa599d,6,475,5.3,6,5,0,0,3,10,-7,5.7,9.9,-4.2,21,CL
f4290206,2,179,2.0,2,1,0,9,2,0,2,2.6,1.3,1.3,21,CL
f45f9427,4,223,2.5,3,1,1,1,2,5,-3,3.9,3.9,0.1,21,CL
f4c69aa6,1,12,0.1,0,0,1,0,0,0,0,0.1,0.7,-0.6,21,CL
f4ceb85b,3,58,0.6,0,0,3,3,0,1,-1,0.3,0.8,-0.5,21,CL
f521b80a,8,720,8.0,8,8,0,0,16,13,3,11.6,13.8,-2.3,21,CL
f586779e,5,230,2.6,3,1,2,6,6,1,5,6.8,1.1,5.6,21,CL
f5deef4c,5,392,4.4,5,3,0,1,11,7,4,8.9,7.1,1.7,21,CL
f5f2ec59,3,48,0.5,0,0,3,3,0,2,-2,0.2,1.3,-1.1,21,CL
f620b04f,5,198,2.2,2,2,3,0,5,3,2,4.2,4.1,0.1,21,CL
f6798fc3,5,450,5.0,5,5,0,1,8,6,2,7.2,6.3,0.9,21,CL
f6ac68c1,8,710,7.9,8,7,0,0,7,10,-3,9.0,9.7,-0.7,21,CL
f7036e1c,6,405,4.5,5,1,1,0,6,7,-1,7.0,5.5,1.5,21,CL
f7223718,6,426,4.7,6,3,0,1,10,9,1,7.4,6.9,0.4,21,CL
f76e6b4e,1,90,1.0,1,1,0,9,1,0,1,1.1,1.4,-0.3,21,CL
f76fdcd2,1,18,0.2,0,0,1,4,1,0,1,1.0,0.0,0.9,21,CL
f7e87032,5,422,4.7,5,1,0,0,4,8,-4,5.7,9.6,-3.9,21,CL
f833a830,4,186,2.1,2,1,2,2,2,1,1,2.6,3.0,-0.4,21,CL
f8ce97ca,1,11,0.1,0,0,1,8,0,0,0,0.1,0.2,-0.1,21,CL
f93c876b,4,227,2.5,3,1,1,1,1,8,-7,1.9,5.2,-3.3,21,CL
fa274d97,3,207,2.3,2,1,1,5,4,3,1,4.0,3.9,0.1,21,CL
fa73ccc7,5,406,4.5,5,2,0,0,5,9,-4,4.6,10.4,-5.8,21,CL
fb938d24,10,756,8.4,9,1,1,0,12,9,3,10.8,9.9,1.0,21,CL
fc62f087,8,508,5.6,6,2,2,4,6,7,-1,8.1,9.4,-1.3,21,CL
fd51b456,8,720,8.0,8,8,0,1,16,8,8,16.2,7.0,9.2,21,CL
fd771f95,6,233,2.6,2,1,4,2,7,2,5,7.4,3.5,4.0,21,CL
fd9c4805,5,342,3.8,4,1,1,0,2,9,-7,3.7,6.4,-2.7,21,CL
fdf4b948,8,289,3.2,2,2,6,0,3,4,-1,3.4,4.9,-1.5,21,CL
fe2db476,3,225,2.5,3,1,0,6,2,4,-2,3.9,3.9,0.0,21,CL
fe641c1a,7,429,4.8,5,3,2,0,12,7,5,8.9,7.2,1.7,21,CL
fe888e39,2,16,0.2,0,0,2,3,0,0,0,0.0,1.0,-1.0,21,CL
fecd43a3,6,384,4.3,4,3,2,0,5,12,-7,4.3,8.1,-3.8,21,CL
fed7cb61,12,785,8.7,9,3,3,0,13,2,11,15.4,6.1,9.3,21,CL
fffea3e5,6,401,4.5,4,2,2,0,1,5,-4,5.1,7.5,-2.4,21,CL
008a6e6d,15,770,8.6,9,5,6,11,4,13,-9,11.9,14.1,-2.2,21,ITA
01040647,14,441,4.9,2,1,12,9,8,12,-4,6.1,9.3,-3.2,21,ITA
01a49bd2,28,2181,24.2,25,19,3,8,30,61,-31,25.9,46.3,-20.5,21,ITA
01b8a2b2,30,2677,29.7,30,29,0,8,55,32,23,56.7,30.0,26.7,21,ITA
01c3aff5,34,1702,18.9,18,6,16,2,33,16,17,38.2,17.5,20.6,21,ITA
01efac19,34,2765,30.7,32,23,2,0,37,41,-4,37.0,41.3,-4.3,21,ITA
023937a9,33,2232,24.8,24,19,9,4,29,33,-4,23.1,38.3,-15.2,21,ITA
028e70b9,4,113,1.3,0,0,4,1,0,2,-2,1.2,2.4,-1.2,21,ITA
02caf6e0,32,2613,29.0,30,20,2,0,51,40,11,46.7,34.7,12.1,21,ITA
0375723e,33,1620,18.0,17,2,16,1,25,24,1,24.7,25.8,-1.1,21,ITA
03f946ed,26,964,10.7,9,2,17,5,22,14,8,21.4,14.7,6.7,21,ITA
0489bb30,21,755,8.4,7,1,14,12,11,10,1,14.4,8.0,6.4,21,ITA
04df29a5,4,94,1.0,1,0,3,13,1,0,1,2.4,0.4,2.0,21,ITA
05e19d6a,37,3226,35.8,36,32,1,0,70,39,31,67.1,43.4,23.7,21,ITA
0728bebe,34,2332,25.9,29,8,5,1,31,39,-8,31.3,37.2,-5.9,21,ITA
07767f42,10,440,4.9,7,0,3,21,9,4,5,7.9,4.9,3.0,21,ITA
081b6080,1,11,0.1,0,0,1,10,0,1,-1,0.0,0.3,-0.3,21,ITA
0821331c,26,2066,22.9,24,17,2,8,26,46,-20,27.3,37.0,-9.7,21,ITA
085e71a7,36,3148,35.0,36,34,0,0,46,56,-10,43.8,56.2,-12.4,21,ITA
089550f5,9,224,2.5,1,1,8,9,3,2,1,5.0,3.8,1.2,21,ITA
08990838,1,32,0.4,0,0,1,1,0,1,-1,0.2,0.9,-0.7,21,ITA
08aa9cd1,8,169,1.9,1,0,7,20,9,0,9,6.1,0.7,5.4,21,ITA
08f5afaa,37,3330,37.0,37,37,0,0,71,38,33,68.2,44.9,23.3,21,ITA
09538fdb,36,2370,26.4,26,16,10,1,28,40,-12,35.6,34.3,1.2000000000000002,21,ITA
099a2de5,2,54,0.6,0,0,2,2,3,2,1,1.3,1.1,0.3,21,ITA
0a1efd3c,12,430,4.8,4,2,8,10,7,12,-5,6.4,11.1,-4.7,21,ITA
0a3065c8,20,1481,16.5,18,6,2,1,18,22,-4,24.0,24.9,-0.9,21,ITA
0a447501,14,978,10.9,12,4,2,1,12,14,-2,14.0,18.4,-4.4,21,ITA
0a483542,23,1456,16.2,16,8,7,15,31,26,5,25.2,24.1,1.1,21,ITA
0ab1f153,30,2175,24.2,26,17,4,0,47,25,22,46.2,22.2,23.9,21,ITA
0b5a292a,27,1669,18.5,17,12,10,10,42,20,22,33.8,20.3,13.6,21,ITA
0c8f27b5,1,32,0.4,0,0,1,1,0,1,-1,0.2,0.9,-0.7,21,ITA
0cadc46d,27,832,9.2,7,2,20,4,9,11,-2,13.8,14.1,-0.3,21,ITA
0d077b88,15,528,5.9,4,2,11,10,15,11,4,10.9,10.1,0.8,21,ITA
0d422df7,34,3060,34.0,34,34,0,4,38,42,-4,40.5,44.9,-4.4,21,ITA
0d82903c,26,1858,20.6,20,15,6,1,49,21,28,42.8,21.9,20.9,21,ITA
0db169ae,25,1330,14.8,17,4,8,10,28,16,12,31.9,17.6,14.3,21,ITA
0e0e4422,1,5,0.1,0,0,1,5,0,0,0,0.1,0.0,0.1,21,ITA
0e21fc3c,20,491,5.5,4,0,16,7,7,8,-1,6.7,10.7,-4.0,21,ITA
0e490f6e,9,177,2.0,1,0,8,14,1,5,-4,1.1,4.2,-3.1,21,ITA
0fee6bda,27,1798,20.0,19,17,8,6,27,37,-10,27.1,34.2,-7.1,21,ITA
1079c685,23,369,4.1,3,0,20,12,5,7,-2,8.3,8.8,-0.5,21,ITA
10dc46f0,32,2880,32.0,32,32,0,3,42,62,-20,39.9,53.8,-13.9,21,ITA
10e7f486,28,1877,20.9,21,16,7,6,30,29,1,32.0,29.1,2.8,21,ITA
11e0904f,7,104,1.2,0,0,7,26,2,2,0,2.3,1.2,1.1,21,ITA
1295552e,28,1672,18.6,18,4,10,8,35,29,6,29.0,26.3,2.7,21,ITA
129af0db,32,2014,22.4,23,10,9,1,44,23,21,45.6,23.5,22.1,21,ITA
12c35abe,18,532,5.9,3,0,15,17,16,7,9,11.5,4.8,6.7,21,ITA
130a7a3f,28,1181,13.1,12,3,16,7,23,13,10,21.8,15.1,6.8,21,ITA
13c8e5f6,1,11,0.1,0,0,1,0,0,0,0,0.1,0.0,0.1,21,ITA
144607cc,34,2739,30.4,31,21,3,0,32,61,-29,32.6,47.8,-15.2,21,ITA
149c5f5d,24,1828,20.3,21,11,3,3,27,37,-10,24.3,30.6,-6.3,21,ITA
14b8fcdf,16,1001,11.1,12,7,4,2,8,17,-9,14.2,12.2,1.9,21,ITA
157d29b6,29,1514,16.8,17,5,12,4,28,31,-3,22.8,30.8,-8.0,21,ITA
15d0c248,14,909,10.1,10,4,4,2,19,12,7,12.9,11.1,1.8,21,ITA
162efffd,36,3201,35.6,36,33,0,0,39,56,-17,41.8,48.9,-7.0,21,ITA
16657b95,34,2155,23.9,22,17,12,1,45,32,13,41.7,27.7,14.0,21,ITA
16b9d5cf,17,1207,13.4,12,9,5,17,28,20,8,23.5,17.3,6.3,21,ITA
16bb656a,30,1860,20.7,22,13,8,2,20,28,-8,27.0,27.6,-0.6,21,ITA
173061c0,28,1956,21.7,22,17,6,0,20,47,-27,24.5,33.5,-9.0,21,ITA
174944a3,1,90,1.0,1,1,0,5,2,2,0,2.4,2.4,0.0,21,ITA
1780bb4a,11,758,8.4,10,4,1,8,13,16,-3,10.0,12.4,-2.4,21,ITA
185bf610,1,90,1.0,1,1,0,0,0,3,-3,0.8,0.9,-0.1,21,ITA
18736214,6,540,6.0,6,6,0,30,7,9,-2,7.2,8.9,-1.7,21,ITA
18f9dbd0,6,351,3.9,4,3,2,10,3,7,-4,6.8,3.8,3.0,21,ITA
19d1c41f,1,28,0.3,0,0,1,11,1,1,0,1.3,0.2,1.1,21,ITA
19e4eab9,35,2780,30.9,32,26,3,2,33,46,-13,37.6,40.9,-3.3,21,ITA
1ac232b8,22,1522,16.9,19,8,3,9,26,34,-8,23.0,26.9,-3.9,21,ITA
1ad1f50d,24,785,8.7,9,1,15,6,7,21,-14,8.0,14.5,-6.5,21,ITA
1b82f8df,16,1159,12.9,13,7,3,0,14,25,-11,12.4,22.6,-10.2,21,ITA
1bd5fc78,18,924,10.3,8,4,10,15,9,30,-21,9.1,20.0,-10.9,21,ITA
1cac99dc,6,83,0.9,0,0,6,11,1,1,0,1.2000000000000002,1.6,-0.4,21,ITA
1cadaf34,20,703,7.8,8,1,12,12,10,16,-6,10.7,13.1,-2.4,21,ITA
1d0bb7e4,7,233,2.6,3,1,4,24,4,3,1,5.0,2.5,2.5,21,ITA
1db295e5,30,2341,26.0,26,24,4,6,34,73,-39,30.0,52.3,-22.3,21,ITA
1de40dae,16,885,9.8,8,3,8,6,16,19,-3,15.1,17.2,-2.2,21,ITA
1ea5f91c,35,2409,26.8,29,11,6,1,38,39,-1,32.4,39.3,-6.8,21,ITA
1f9328da,26,1887,21.0,22,15,4,1,22,24,-2,26.8,25.5,1.3,21,ITA
20094685,29,1864,20.7,22,8,7,5,33,27,6,29.2,26.6,2.6,21,ITA
20730eae,30,1924,21.4,22,7,8,1,37,24,13,37.7,27.2,10.5,21,ITA
2079b3cc,14,699,7.8,8,4,6,0,12,17,-5,12.7,12.0,0.7,21,ITA
20b3a502,28,1255,13.9,15,1,13,3,11,20,-9,15.9,24.5,-8.7,21,ITA
20b9f052,21,1817,20.2,20,20,1,12,37,29,8,35.0,22.0,13.0,21,ITA
2146785a,32,2647,29.4,30,23,2,0,61,32,29,57.4,38.5,19.0,21,ITA
215f3907,35,1773,19.7,18,3,17,2,25,32,-7,24.3,33.9,-9.6,21,ITA
217875a4,19,1618,18.0,18,17,1,14,23,36,-13,21.4,36.2,-14.8,21,ITA
2200181e,19,796,8.8,7,5,12,14,13,7,6,13.8,13.3,0.5,21,ITA
226008f1,25,1572,17.5,17,13,8,4,18,38,-20,16.1,32.5,-16.4,21,ITA
22bfb57e,17,522,5.8,5,0,12,15,8,11,-3,5.9,10.3,-4.4,21,ITA
22ca11f1,10,183,2.0,2,0,8,9,2,6,-4,1.9,5.5,-3.6,21,ITA
2306bf5c,5,283,3.1,3,0,2,8,5,2,3,5.7,5.1,0.5,21,ITA
230a2fac,36,3240,36.0,36,36,0,0,78,41,37,64.8,40.9,23.9,21,ITA
2334478a,16,868,9.600000000000001,10,3,6,9,9,12,-3,8.6,13.100000000000001,-4.5,21,ITA
23610943,29,1828,20.3,18,15,11,4,27,34,-7,22.9,34.0,-11.2,21,ITA
259deea9,1,15,0.2,0,0,1,26,0,1,-1,0.0,0.2,-0.2,21,ITA
263b855a,2,104,1.2,1,1,1,11,0,0,0,0.0,0.1,-0.1,21,ITA
26c54058,27,1765,19.6,19,8,8,3,20,34,-14,22.4,29.1,-6.7,21,ITA
26cd1bff,3,32,0.4,0,0,3,1,1,1,0,0.9,1.3,-0.3,21,ITA
26db8853,30,2055,22.8,23,13,7,1,24,36,-12,24.6,36.6,-12.0,21,ITA
277da414,29,2610,29.0,29,29,0,2,38,55,-17,35.0,48.2,-13.2,21,ITA
2873973b,1,12,0.1,0,0,1,6,0,0,0,0.4,0.0,0.4,21,ITA
2990c466,2,100,1.1,1,1,1,1,1,1,0,1.1,1.5,-0.4,21,ITA
2a1beb34,35,3021,33.6,33,31,2,0,78,42,36,65.4,36.7,28.7,21,ITA
2bae5658,21,640,7.1,7,0,14,10,13,18,-5,8.3,13.2,-4.9,21,ITA
2c0f8e9e,30,1146,12.7,12,2,18,2,37,13,24,29.3,15.1,14.2,21,ITA
2c38b327,35,1418,15.8,15,3,20,0,20,29,-9,17.2,27.3,-10.0,21,ITA
2c851997,25,969,10.8,10,1,15,10,16,19,-3,13.2,15.8,-2.7,21,ITA
2cfae697,34,2512,27.9,28,14,6,0,34,44,-10,40.1,42.9,-2.8,21,ITA
2d970560,32,2523,28.0,30,12,2,0,71,33,38,54.0,28.7,25.3,21,ITA
2d9d9e42,1,2,0.0,0,0,1,3,0,0,0,0.0,0.0,0.0,21,ITA
2e0ae188,6,74,0.8,0,0,6,19,1,4,-3,0.8,4.0,-3.2,21,ITA
2ead2809,37,2563,28.5,29,10,8,1,30,51,-21,33.0,45.3,-12.3,21,ITA
2f3452eb,24,1768,19.6,20,13,4,8,48,18,30,32.4,21.7,10.7,21,ITA
2f557579,35,2865,31.8,33,21,2,0,75,30,45,58.6,34.0,24.6,21,ITA
2f7407fa,1,5,0.1,0,0,1,22,0,0,0,0.0,0.3,-0.3,21,ITA
30223b33,13,1153,12.8,13,12,0,18,21,19,2,22.6,17.0,5.6,21,ITA
30f5ffa9,32,2777,30.9,31,28,1,3,68,24,44,57.3,29.8,27.6,21,ITA
31d7f557,8,297,3.3,2,1,6,5,3,13,-10,2.2,9.3,-7.0,21,ITA
326d09ef,2,180,2.0,2,2,0,3,5,5,0,3.9,2.1,1.8,21,ITA
32a33c68,2,91,1.0,1,1,1,15,0,0,0,0.5,2.2,-1.7,21,ITA
32c0491f,1,59,0.7,0,0,1,2,0,0,0,0.5,0.3,0.1,21,ITA
339c6ed4,3,88,1.0,1,0,2,35,1,2,-1,0.8,1.2,-0.4,21,ITA
339fe0e8,9,810,9.0,9,9,0,19,8,14,-6,13.9,11.0,2.9,21,ITA
33b8d077,33,2581,28.7,29,20,4,1,57,26,31,53.4,27.4,26.0,21,ITA
33e98344,1,7,0.1,0,0,1,0,0,0,0,0.0,0.1,-0.1,21,ITA
33ecf462,27,998,11.1,12,0,15,11,16,16,0,13.6,17.9,-4.3,21,ITA
343c0d52,33,1740,19.3,19,2,14,3,26,37,-11,24.7,34.9,-10.1,21,ITA
343f753a,36,3240,36.0,36,36,0,2,35,76,-41,39.7,56.4,-16.7,21,ITA
348bafd4,3,165,1.8,1,1,2,16,2,4,-2,1.1,5.5,-4.4,21,ITA
34bb6fbd,3,34,0.4,0,0,3,27,2,1,1,0.8,0.4,0.39999999999999997,21,ITA
3535098b,14,870,9.7,10,4,4,9,13,25,-12,10.6,15.2,-4.6,21,ITA
356c9002,35,2505,27.8,28,14,7,0,37,36,1,31.3,39.7,-8.4,21,ITA
35b4bc62,1,2,0.0,0,0,1,2,0,0,0,0.0,0.0,0.0,21,ITA
35dd6d80,23,1726,19.2,20,17,3,2,26,22,4,20.8,27.1,-6.2,21,ITA
3626daea,27,2124,23.6,25,18,2,0,41,35,6,40.9,26.0,14.9,21,ITA
366be751,1,21,0.2,0,0,1,16,0,0,0,0.6,0.3,0.3,21,ITA
3688af6c,4,35,0.4,0,0,4,9,1,1,0,1.7,0.7,0.9,21,ITA
36d7971a,6,294,3.3,2,2,4,6,3,8,-5,3.3,7.9,-4.5,21,ITA
36d9dabe,15,413,4.6,3,1,12,14,5,12,-7,7.9,6.0,1.9,21,ITA
38bf62b5,3,121,1.3,0,0,3,30,2,5,-3,1.0,4.1,-3.1,21,ITA
39583cfd,13,598,6.6,7,2,6,3,8,5,3,7.7,5.3,2.4,21,ITA
39ee6cb6,19,652,7.2,5,1,14,13,5,26,-21,6.1,19.5,-13.3,21,ITA
3a35db3d,7,471,5.2,6,3,1,12,5,14,-9,4.3,10.0,-5.7,21,ITA
3b333ac3,22,1762,19.6,20,15,2,1,57,23,34,43.2,20.9,22.4,21,ITA
3b61c9ec,11,639,7.1,7,3,4,3,4,15,-11,5.9,13.7,-7.7,21,ITA
3b8674e6,33,2324,25.8,27,18,6,1,49,25,24,51.5,25.7,25.8,21,ITA
3bb7af3b,11,441,4.8999999999999995,5,2,6,15,8,8,0,7.6,5.6,2.0,21,ITA
3bb7f478,27,1824,20.3,20,9,7,4,32,33,-1,35.0,24.3,10.7,21,ITA
3ca7254a,27,1591,17.7,20,5,7,1,30,26,4,30.4,22.2,8.1,21,ITA
3cb132e6,9,191,2.1,1,1,8,11,4,1,3,3.1,2.3,0.8,21,ITA
3cd3b384,37,3216,35.7,37,32,0,0,48,49,-1,43.8,52.1,-8.3,21,ITA
3cf7dc7e,29,2229,24.8,26,18,3,3,28,51,-23,25.3,41.8,-16.5,21,ITA
3dd45b70,24,1570,17.4,18,13,6,0,19,30,-11,17.5,30.8,-13.3,21,ITA
3e092724,13,410,4.6,2,2,11,10,2,16,-14,5.1,10.8,-5.8,21,ITA
3ead85f9,22,1907,21.2,21,21,1,7,41,25,16,38.0,29.3,8.8,21,ITA
3ec3c1c9,21,1483,16.5,15,10,6,13,22,27,-5,16.4,29.7,-13.3,21,ITA
3f1107d5,1,12,0.1,0,0,1,19,1,0,1,0.1,0.1,0.0,21,ITA
3f79a1c8,24,733,8.1,4,0,20,5,15,7,8,11.1,11.2,0.0,21,ITA
407feb71,27,1228,13.6,15,0,12,7,27,8,19,27.2,12.1,15.1,21,ITA
41bd99ea,1,90,1.0,1,1,0,34,1,2,-1,0.4,2.0,-1.6,21,ITA
42b1a58a,6,363,4.0,3,2,3,11,5,6,-1,4.1,6.6,-2.6,21,ITA
42fff925,4,113,1.3,1,0,3,7,0,4,-4,1.1,2.5,-1.4,21,ITA
4366d5e9,2,56,0.6,1,0,1,4,1,4,-3,1.7,1.3,0.4,21,ITA
440c84ed,11,358,4.0,4,0,7,6,6,7,-1,5.9,8.4,-2.5,21,ITA
4431aed2,35,2849,31.7,34,16,1,0,55,44,11,50.6,36.9,13.6,21,ITA
44510fde,11,339,3.8,2,1,9,7,3,2,1,5.9,5.1,0.8,21,ITA
44ac04e9,8,283,3.1,3,2,5,9,13,5,8,6.2,4.6,1.6,21,ITA
44eb9093,19,699,7.8,7,6,12,13,23,11,12,17.2,13.6,3.6,21,ITA
45191c29,1,11,0.1,0,0,1,4,1,0,1,0.3,0.0,0.3,21,ITA
45392b06,17,1036,11.5,12,6,5,10,10,21,-11,10.7,19.8,-9.1,21,ITA
4571fa88,10,300,3.3,3,0,7,17,3,10,-7,4.7,9.6,-4.9,21,ITA
457cb02f,4,332,3.7,4,3,0,34,4,6,-2,4.8,4.0,0.7,21,ITA
45b9b619,28,1933,21.5,25,9,3,4,35,40,-5,33.0,28.3,4.7,21,ITA
4611e028,31,2002,22.2,21,16,10,3,28,30,-2,23.9,34.5,-10.5,21,ITA
46fa7204,29,1356,15.1,14,4,15,8,26,26,0,19.7,22.7,-3.0,21,ITA
48b3dd60,22,1157,12.9,13,4,9,10,26,12,14,23.6,13.2,10.4,21,ITA
48d5bd33,36,1876,20.8,22,3,14,0,55,21,34,42.6,22.6,20.1,21,ITA
4a56052c,29,2053,22.8,25,11,4,0,44,32,12,41.4,26.1,15.3,21,ITA
4a5a45c7,34,2598,28.9,30,15,4,0,53,40,13,49.4,32.7,16.7,21,ITA
4a6914ff,1,90,1.0,1,1,0,30,3,0,3,0.9,0.8,0.1,21,ITA
4ae67f27,12,858,9.5,9,7,3,24,10,19,-9,10.6,17.9,-7.3,21,ITA
4b029b31,25,1857,20.6,19,17,6,11,23,35,-12,19.6,36.0,-16.4,21,ITA
4b3e1a38,16,1094,12.2,12,11,4,16,30,15,15,21.9,15.2,6.6,21,ITA
4b520f96,1,5,0.1,0,0,1,0,0,0,0,0.0,0.3,-0.3,21,ITA
4c3a6744,2,19,0.2,0,0,2,1,0,0,0,0.0,0.0,0.0,21,ITA
4c62d0c8,32,2879,32.0,32,31,0,2,41,44,-3,31.7,48.6,-16.9,21,ITA
4c78b5ed,32,2131,23.7,30,2,2,0,38,32,6,38.0,24.0,14.0,21,ITA
4c7919df,1,1,0.0,0,0,1,4,0,0,0,0.0,0.0,0.0,21,ITA
4cde5509,19,1493,16.6,18,12,1,0,31,21,10,32.3,23.9,8.4,21,ITA
4d17df3e,23,1809,20.1,21,16,2,4,22,42,-20,21.4,32.1,-10.7,21,ITA
4dea2f2c,1,90,1.0,1,1,0,32,0,0,0,2.2,0.5,1.7,21,ITA
4e358a2d,6,406,4.5,5,3,1,17,5,8,-3,5.4,8.9,-3.5,21,ITA
4e6dbac4,32,2746,30.5,32,22,0,1,53,47,6,47.2,38.9,8.3,21,ITA
4f2908e5,7,207,2.3,2,2,5,30,5,5,0,5.2,4.6,0.7,21,ITA
4fa7cb9b,2,42,0.5,0,0,2,0,2,0,2,0.8,0.5,0.3,21,ITA
5048486b,16,292,3.2,1,0,15,22,4,7,-3,4.1,7.8,-3.7,21,ITA
509a4ccb,25,1197,13.3,12,2,13,3,17,20,-3,17.5,18.7,-1.3,21,ITA
5128bde4,32,2503,27.8,27,23,5,1,34,38,-4,35.0,36.9,-1.9,21,ITA
51ffa295,15,475,5.3,6,0,9,15,12,7,5,8.5,7.0,1.5,21,ITA
524eb8c5,1,4,0.0,0,0,1,4,0,0,0,0.0,0.4,-0.4,21,ITA
528492ea,23,1230,13.700000000000001,14,5,9,10,10,19,-9,17.2,14.4,2.8,21,ITA
5294a83f,34,2618,29.1,33,10,1,0,46,39,7,45.6,34.2,11.4,21,ITA
52ec54d0,26,2028,22.5,23,16,3,4,44,23,21,42.6,24.3,18.3,21,ITA
536cebe5,27,1776,19.7,20,10,7,0,44,18,26,41.4,22.6,18.8,21,ITA
539230cf,8,703,7.8,8,7,0,29,24,7,17,17.2,7.6,9.6,21,ITA
53a0e358,30,2475,27.5,28,18,2,0,50,37,13,44.0,38.0,6.0,21,ITA
53de807a,31,2458,27.3,30,19,1,0,46,36,10,42.4,31.7,10.8,21,ITA
543d9d2b,1,15,0.2,0,0,1,19,2,3,-1,0.7,1.8,-1.1,21,ITA
54ab971f,29,2315,25.7,28,18,1,0,35,63,-28,30.5,46.7,-16.2,21,ITA
54e53b7e,30,1865,20.7,23,2,7,2,23,36,-13,22.4,34.0,-11.6,21,ITA
5570e6fb,25,1869,20.8,22,15,3,7,30,38,-8,24.7,35.8,-11.1,21,ITA
55a1cac2,20,1229,13.7,17,1,3,12,21,21,0,17.4,20.4,-3.0,21,ITA
55db5c36,11,499,5.5,6,3,5,10,3,16,-13,4.6,11.3,-6.7,21,ITA
563a68ad,11,511,5.7,6,2,5,4,5,13,-8,5.9,10.8,-4.9,21,ITA
56400c01,5,228,2.5,2,1,3,11,1,4,-3,2.5,5.5,-3.1,21,ITA
570bb4b9,35,1789,19.9,20,5,15,2,28,36,-8,29.6,33.1,-3.5,21,ITA
57469b2d,31,1677,18.6,16,4,15,1,26,23,3,19.6,29.9,-10.4,21,ITA
5832ebfe,5,115,1.3,1,0,4,8,2,1,1,2.2,1.5,0.7,21,ITA
585a73a8,19,1632,18.1,18,18,1,11,10,39,-29,13.9,29.6,-15.6,21,ITA
58e933d2,33,995,11.1,9,2,24,2,11,17,-6,12.8,16.1,-3.3,21,ITA
5944af8f,25,1305,14.5,13,4,12,10,15,30,-15,12.8,27.8,-15.1,21,ITA
59bf127b,32,1964,21.8,23,8,9,3,51,29,22,40.5,26.1,14.4,21,ITA
5a2cb25d,31,2441,27.1,28,21,3,4,33,44,-11,33.4,44.0,-10.6,21,ITA
5aa53281,33,2852,31.7,33,30,0,1,52,44,8,52.7,37.6,15.1,21,ITA
5aaef9ef,28,2334,25.9,28,18,0,0,24,50,-26,29.5,36.5,-7.0,21,ITA
5bd72174,25,1697,18.9,19,11,6,1,36,30,6,30.6,28.6,2.0,21,ITA
5c397195,14,333,3.7,2,0,12,15,6,5,1,6.7,5.7,1.1,21,ITA
5cec2c74,30,1508,16.7,15,8,15,7,32,33,-1,24.2,26.4,-2.2,21,ITA
5e861944,37,1908,21.2,22,4,15,1,49,26,23,36.8,23.9,12.9,21,ITA
5eae500a,36,2884,32.0,32,25,4,1,72,28,44,61.5,32.9,28.6,21,ITA
5efc5389,31,2418,26.9,29,13,2,2,29,40,-11,29.3,41.2,-11.9,21,ITA
5f951ef1,17,413,4.6,2,1,15,14,8,7,1,4.2,7.9,-3.6,21,ITA
5fa57166,24,1386,15.4,14,9,10,9,17,17,0,15.4,21.9,-6.5,21,ITA
5fd5ed86,33,2935,32.6,33,32,0,4,38,55,-17,41.1,52.2,-11.1,21,ITA
601ef102,22,1489,16.5,17,9,5,4,20,25,-5,16.1,24.3,-8.2,21,ITA
6029a945,6,320,3.6,3,2,3,4,5,10,-5,2.5,10.8,-8.3,21,ITA
608f2092,11,299,3.3,3,1,8,3,4,3,1,6.4,4.1,2.3,21,ITA
61b3978f,31,2607,29.0,29,28,2,1,37,42,-5,34.1,40.5,-6.3,21,ITA
61f2f56a,8,217,2.4,1,0,7,28,4,6,-2,3.4,5.8,-2.4,21,ITA
620922ed,1,1,0.0,0,0,1,22,0,0,0,0.0,0.0,0.0,21,ITA
6213fd82,30,2313,25.7,28,20,2,0,32,57,-25,26.9,43.2,-16.4,21,ITA
62437b4f,11,754,8.4,9,4,2,0,11,10,1,9.9,6.0,4.0,21,ITA
63071a3f,16,1193,13.3,13,11,3,6,14,26,-12,15.8,18.6,-2.8,21,ITA
649b01d8,37,3330,37.0,37,37,0,1,49,54,-5,44.5,55.3,-10.8,21,ITA
64cd167d,13,915,10.2,11,7,2,3,16,23,-7,13.0,16.6,-3.6,21,ITA
64e8ed6d,31,1551,17.2,18,5,13,4,34,24,10,30.7,22.1,8.5,21,ITA
658d44be,23,1021,11.3,11,3,12,4,11,18,-7,11.2,20.1,-8.9,21,ITA
6604165d,14,389,4.3,3,1,11,20,3,9,-6,4.5,9.6,-5.1,21,ITA
6639e500,26,543,6.0,3,1,23,5,10,9,1,7.7,8.2,-0.4,21,ITA
6662d731,4,360,4.0,4,4,0,18,3,10,-7,6.5,7.8,-1.3,21,ITA
67cdbc0e,23,1138,12.6,14,2,9,3,33,13,20,26.2,12.8,13.4,21,ITA
67f649be,2,135,1.5,1,1,1,33,5,1,4,3.1,1.6,1.5,21,ITA
6817095b,3,21,0.2,0,0,3,0,0,0,0,0.3,0.2,0.0,21,ITA
68252d6d,28,1526,17.0,17,2,11,5,38,17,21,33.6,16.3,17.3,21,ITA
6928979a,36,2896,32.2,32,23,4,1,66,31,35,60.5,35.1,25.5,21,ITA
6a189491,3,85,0.9,1,0,2,31,1,1,0,1.2,1.2,0.0,21,ITA
6b635f5c,17,1297,14.4,14,12,3,12,21,27,-6,16.6,24.3,-7.7,21,ITA
6c1f7328,14,576,6.4,6,1,8,2,5,15,-10,4.9,10.1,-5.2,21,ITA
6cc97b6a,23,1177,13.1,13,4,10,5,11,28,-17,12.9,22.3,-9.4,21,ITA
6e058f06,27,1232,13.7,13,4,14,8,23,16,7,23.0,20.1,2.9,21,ITA
6e4df551,10,666,7.4,9,2,1,1,17,15,2,14.1,11.2,2.9,21,ITA
6eee05f1,33,2625,29.2,28,23,5,2,69,34,35,57.6,31.5,26.1,21,ITA
6f5ead86,33,2189,24.3,27,10,6,0,23,52,-29,24.8,39.3,-14.5,21,ITA
6fe90922,32,1795,19.9,20,4,12,4,46,21,25,38.3,20.9,17.4,21,ITA
7005ac66,1,10,0.1,0,0,1,5,0,1,-1,0.0,0.9,-0.8,21,ITA
7033ca08,1,3,0.0,0,0,1,34,0,0,0,0.0,0.0,0.0,21,ITA
71dc23da,23,1358,15.1,14,7,9,15,18,31,-13,13.0,23.6,-10.5,21,ITA
7280b54f,1,13,0.1,0,0,1,1,0,1,-1,0.2,0.4,-0.2,21,ITA
72be9309,2,180,2.0,2,2,0,34,4,7,-3,2.8,4.6,-1.8,21,ITA
73ddc40c,1,19,0.2,0,0,1,13,0,0,0,0.1,0.7,-0.6,21,ITA
741e058f,27,1637,18.2,18,8,9,9,27,54,-27,18.0,36.7,-18.7,21,ITA
74419746,37,3240,36.0,37,35,0,1,81,33,48,68.9,37.2,31.7,21,ITA
75b86fb3,33,2922,32.5,33,29,0,3,71,26,45,60.4,31.9,28.5,21,ITA
75e60d75,4,226,2.5,2,2,2,4,2,2,0,2.3,2.3,0.0,21,ITA
75efed2e,4,56,0.6,0,0,4,3,1,0,1,0.8,0.6,0.2,21,ITA
75f2c59f,34,2925,32.5,34,23,0,0,36,49,-13,39.4,46.0,-6.6,21,ITA
7737dee2,5,46,0.5,0,0,5,10,1,0,1,1.0,0.4,0.6,21,ITA
77d6fd4d,4,360,4.0,4,4,0,34,8,6,2,5.5,5.2,0.3,21,ITA
780e3631,28,1645,18.3,21,5,7,5,43,21,22,33.4,16.6,16.8,21,ITA
78841da9,20,664,7.4,6,0,14,13,6,13,-7,8.9,15.3,-6.4,21,ITA
79083382,5,157,1.7,0,0,5,21,5,3,2,2.1,2.0,0.2,21,ITA
79443529,37,2923,32.5,34,20,3,1,41,52,-11,38.1,55.4,-17.3,21,ITA
7b075c75,20,1755,19.5,19,19,1,1,27,33,-6,30.6,33.4,-2.9,21,ITA
7b082ec2,24,1195,13.3,11,7,13,5,12,36,-24,14.0,23.8,-9.9,21,ITA
7ba1f1ef,17,1173,13.0,15,9,2,15,12,13,-1,11.9,17.8,-5.9,21,ITA
7cd520e8,6,170,1.9,0,0,6,25,1,4,-3,2.4,2.9,-0.5,21,ITA
7d3cbc67,20,386,4.3,3,1,17,18,7,4,3,4.7,5.5,-0.8,21,ITA
7d50454d,19,1465,16.3,16,11,3,5,17,23,-6,16.9,25.1,-8.2,21,ITA
7eb97a8e,26,1169,13.0,11,1,15,1,16,14,2,18.2,20.7,-2.5,21,ITA
7ec7738e,15,272,3.0,2,0,13,9,6,5,1,8.7,6.4,2.3,21,ITA
7edfbb8a,17,1466,16.3,16,16,1,3,34,14,20,29.2,17.1,12.1,21,ITA
7f267d66,24,975,10.8,11,1,13,11,9,12,-3,12.3,18.4,-6.1,21,ITA
7f78ad23,16,1238,13.8,15,6,1,18,21,31,-10,17.8,22.4,-4.6,21,ITA
7fac99d4,37,2965,32.9,35,18,2,0,36,53,-17,38.5,54.4,-15.9,21,ITA
7fd58fe3,16,718,8.0,8,1,8,5,13,11,2,14.9,10.1,4.8,21,ITA
7fe90ccd,25,2045,22.7,23,18,2,2,32,30,2,25.2,34.5,-9.3,21,ITA
801831fe,5,29,0.3,0,0,5,17,1,1,0,0.4,0.3,0.1,21,ITA
80dbbd10,38,2943,32.7,31,26,7,0,38,73,-35,35.9,59.1,-23.2,21,ITA
81255c03,37,3253,36.1,37,28,0,1,41,55,-14,44.8,57.1,-12.3,21,ITA
817c6964,25,723,8.0,5,2,20,10,16,9,7,12.3,13.6,-1.3,21,ITA
81a4c239,16,698,7.8,4,1,12,2,14,21,-7,12.4,13.9,-1.5,21,ITA
822a7761,9,341,3.8,4,1,5,24,5,6,-1,4.0,6.1,-2.0,21,ITA
82328faf,5,450,5.0,5,5,0,17,10,7,3,7.7,6.6,1.1,21,ITA
825b8997,4,219,2.4,4,1,0,1,2,1,1,2.5,2.9,-0.3,21,ITA
82b1198a,16,1440,16.0,16,16,0,17,33,12,21,28.8,14.5,14.3,21,ITA
82dbf623,17,765,8.5,8,0,9,13,7,12,-5,9.7,13.2,-3.4,21,ITA
82efe6fa,30,2398,26.6,28,22,2,1,48,39,9,48.7,30.8,17.9,21,ITA
83e4643e,31,1863,20.7,22,6,9,6,24,29,-5,21.3,32.6,-11.3,21,ITA
852351df,30,1427,15.9,14,8,16,6,28,22,6,28.9,22.7,6.2,21,ITA
854ee61a,28,1336,14.8,14,1,14,1,30,22,8,23.0,17.4,5.6,21,ITA
85f7d1be,13,727,8.1,7,3,6,23,14,12,2,12.7,8.9,3.8,21,ITA
8650af85,34,3014,33.5,33,32,1,1,58,49,9,49.9,49.5,0.4,21,ITA
8697c095,2,52,0.6,0,0,2,14,1,2,-1,1.0,2.1,-1.1,21,ITA
875898c7,17,952,10.6,10,8,7,12,19,21,-2,14.6,15.7,-1.1,21,ITA
8790f988,26,1352,15.0,13,4,13,5,20,22,-2,15.9,23.7,-7.8,21,ITA
8794e251,34,2313,25.7,25,18,9,1,49,28,21,43.9,28.8,15.1,21,ITA
881ef58c,5,82,0.9,0,0,5,14,5,1,4,3.3,0.7,2.6,21,ITA
88895312,18,615,6.8,4,1,14,4,7,14,-7,8.3,9.3,-1.0,21,ITA
88c89891,10,586,6.5,7,2,3,15,13,12,1,10.4,10.2,0.3,21,ITA
89976232,25,2004,22.3,24,16,1,5,28,29,-1,29.4,32.7,-3.3,21,ITA
89b2c8a9,29,1459,16.2,18,2,11,0,37,18,19,26.9,15.9,11.0,21,ITA
8abd0c03,24,1740,19.3,23,7,1,13,16,29,-13,20.6,23.5,-2.9,21,ITA
8b609c34,28,1854,20.6,20,14,8,3,26,39,-13,26.3,31.4,-5.1,21,ITA
8b66d9cc,24,1294,14.4,16,3,8,2,18,23,-5,20.4,18.6,1.8,21,ITA
8b8a56ce,28,2393,26.6,28,22,0,3,52,29,23,49.3,34.2,15.1,21,ITA
8b95acda,29,2591,28.8,28,28,1,6,38,40,-2,33.5,40.6,-7.1,21,ITA
8bc8829a,12,800,8.9,9,6,3,22,14,14,0,12.6,16.1,-3.5,21,ITA
8c65eb5f,1,34,0.4,0,0,1,0,1,1,0,0.1,1.0,-0.9,21,ITA
8c725b43,32,2743,30.5,32,27,0,2,40,48,-8,35.7,48.6,-12.9,21,ITA
8c90fd7a,24,1573,17.5,16,6,8,1,44,19,25,33.5,17.7,15.8,21,ITA
8c964914,2,26,0.3,0,0,2,16,0,1,-1,0.1,1.3,-1.1,21,ITA
8cabdc1e,37,3330,37.0,37,37,0,0,64,56,8,58.1,54.1,4.0,21,ITA
8cc29864,23,1782,19.8,21,16,2,9,32,27,5,24.3,30.1,-5.7,21,ITA
8d8178ac,36,2502,27.8,28,15,8,1,40,53,-13,41.5,44.7,-3.1,21,ITA
8da74c05,33,2304,25.6,28,12,5,2,30,30,0,31.1,32.2,-1.1,21,ITA
8dfed6e9,15,768,8.5,9,0,6,2,10,19,-9,8.9,13.1,-4.1,21,ITA
8f68aa41,5,232,2.6,2,1,3,13,1,6,-5,2.6,5.7,-3.1,21,ITA
8f866fe8,16,870,9.7,10,1,6,7,17,8,9,12.6,12.5,0.1,21,ITA
8faf7b3c,30,1599,17.8,17,2,13,7,20,40,-20,21.6,31.0,-9.4,21,ITA
8fef5412,14,837,9.3,9,6,5,13,11,19,-8,14.0,12.8,1.2,21,ITA
90573602,7,205,2.3,1,0,6,18,2,3,-1,3.0,3.3,-0.3,21,ITA
9085dd7c,9,392,4.3999999999999995,4,2,5,11,4,5,-1,6.4,10.6,-4.2,21,ITA
909bce7f,20,958,10.6,11,2,9,14,13,25,-12,13.1,19.6,-6.4,21,ITA
90b70194,31,2212,24.6,27,14,4,6,24,44,-20,22.6,34.7,-12.2,21,ITA
91899ca8,5,263,2.9,2,1,3,18,4,2,2,4.9,3.9000000000000004,0.9,21,ITA
919dd4b1,1,11,0.1,0,0,1,5,0,0,0,0.0,0.8,-0.8,21,ITA
91d0fabf,24,1561,17.3,17,10,7,7,24,30,-6,19.4,28.7,-9.4,21,ITA
921f6058,36,2428,27.0,25,23,11,1,61,35,26,52.0,30.4,21.7,21,ITA
92b4758e,30,2216,24.6,24,20,6,6,25,41,-16,33.0,29.5,3.6,21,ITA
92d83c27,34,1852,20.6,24,2,10,1,35,40,-5,31.9,34.6,-2.7,21,ITA
933d3b51,20,1524,16.9,16,15,4,8,23,38,-15,20.5,30.3,-9.8,21,ITA
93b891d1,25,929,10.3,9,1,16,5,19,13,6,17.6,8.4,9.2,21,ITA
93cf32a8,18,1358,15.1,16,13,2,14,20,30,-10,20.1,25.6,-5.5,21,ITA
9413b19f,22,1980,22.0,22,22,0,16,53,29,24,38.9,28.0,10.9,21,ITA
94816803,21,1184,13.2,12,0,9,1,21,21,0,19.3,25.7,-6.4,21,ITA
94a3606c,3,206,2.3,2,2,1,27,3,3,0,3.8,5.1,-1.4,21,ITA
94b2001f,34,2916,32.4,32,28,2,3,69,30,39,63.8,34.2,29.5,21,ITA
952a03fe,15,853,9.5,9,7,6,18,9,15,-6,14.6,11.8,2.8,21,ITA
957e4c87,33,2214,24.6,26,8,7,0,32,42,-10,29.6,39.6,-10.0,21,ITA
9592289a,29,1491,16.6,15,7,14,3,23,35,-12,24.3,28.6,-4.3,21,ITA
95facda1,32,2737,30.4,31,26,1,0,36,49,-13,36.4,45.5,-9.1,21,ITA
963a328b,30,1818,20.2,25,3,5,3,23,20,3,25.7,24.5,1.3,21,ITA
9654d8de,13,614,6.8,6,3,7,1,11,16,-5,11.3,11.0,0.3,21,ITA
96640846,1,90,1.0,1,1,0,19,1,1,0,1.2,0.4,0.8,21,ITA
96960855,8,227,2.5,2,0,6,2,4,5,-1,2.0,4.7,-2.7,21,ITA
96e0490d,29,1368,15.2,16,4,13,8,22,17,5,20.2,15.8,4.4,21,ITA
970b8574,35,2613,29.0,29,21,6,2,33,36,-3,35.2,41.0,-5.8,21,ITA
97e8ea97,5,45,0.5,0,0,5,16,4,3,1,2.0,2.0,0.0,21,ITA
980522ec,26,1385,15.4,17,2,9,11,35,13,22,30.4,14.4,16.0,21,ITA
983ff2c7,28,1757,19.5,21,10,7,9,21,31,-10,20.6,31.2,-10.6,21,ITA
98d2c2c4,34,2712,30.1,32,21,2,4,72,27,45,58.0,28.7,29.3,21,ITA
997fff07,23,1879,20.9,22,15,1,8,28,54,-26,20.8,41.1,-20.3,21,ITA
9d4c45d6,37,3250,36.1,37,32,0,0,50,58,-8,52.2,57.7,-5.5,21,ITA
9d5ab351,3,52,0.6,0,0,3,1,2,0,2,0.9,0.5,0.4,21,ITA
9d60028d,1,4,0.0,0,0,1,13,0,0,0,0.0,0.0,0.0,21,ITA
9dc96f10,1,14,0.2,0,0,1,10,0,1,-1,0.2,0.3,-0.1,21,ITA
9e1577aa,35,2803,31.1,31,22,4,2,37,49,-12,37.7,52.0,-14.3,21,ITA
9f84febe,34,2544,28.3,28,19,6,1,51,39,12,46.6,29.2,17.4,21,ITA
9fa26bc2,5,450,5.0,5,5,0,26,9,9,0,9.0,7.8,1.2,21,ITA
a111cf41,35,3147,35.0,35,34,0,0,36,51,-15,41.4,48.5,-7.0,21,ITA
a128b07e,18,1214,13.5,15,9,3,0,11,28,-17,12.5,24.4,-11.9,21,ITA
a3d94a58,31,2545,28.3,29,24,2,3,69,35,34,56.3,30.0,26.3,21,ITA
a40819d9,21,1363,15.1,14,8,7,8,32,24,8,27.1,18.0,9.1,21,ITA
a4948e67,25,1896,21.1,21,14,4,0,31,38,-7,26.3,37.2,-10.9,21,ITA
a4e85758,21,1168,13.0,13,9,8,11,10,19,-9,13.8,15.7,-1.9,21,ITA
a4fe8cda,11,196,2.2,0,0,11,2,2,6,-4,2.9,3.5,-0.6,21,ITA
a5055b1b,2,19,0.2,0,0,2,1,0,2,-2,0.1,0.7,-0.6,21,ITA
a5296e55,36,2523,28.0,32,3,4,0,63,30,33,46.6,31.7,14.9,21,ITA
a5f458d9,18,899,10.0,8,4,10,11,5,28,-23,7.8,21.3,-13.6,21,ITA
a69cc629,6,95,1.1,0,0,6,29,1,2,-1,0.7,2.6,-1.8,21,ITA
a69e4806,32,1965,21.8,23,9,9,0,45,20,25,41.4,23.2,18.2,21,ITA
a69eb5fd,1,2,0.0,0,0,1,3,0,0,0,0.1,0.0,0.1,21,ITA
a8a874f1,34,2883,32.0,32,28,2,0,53,47,6,48.2,48.6,-0.4,21,ITA
a8f21b9f,21,773,8.6,6,4,15,11,13,16,-3,14.3,13.6,0.8,21,ITA
a96e5dc0,26,1490,16.6,18,7,8,8,26,26,0,24.8,26.4,-1.7,21,ITA
a9aa0d1d,25,675,7.5,4,0,21,8,16,12,4,14.2,8.6,5.6,21,ITA
aae9d04a,34,2891,32.1,33,28,1,0,34,38,-4,37.4,40.1,-2.7,21,ITA
ab1ca213,21,1316,14.6,15,10,6,2,18,18,0,17.9,19.3,-1.4,21,ITA
ab4449d6,28,2520,28.0,28,28,0,2,41,46,-5,41.0,45.9,-4.9,21,ITA
ac4003af,15,1261,14.0,13,13,2,23,35,21,14,27.3,14.4,12.8,21,ITA
ac7e640b,6,111,1.2,1,0,5,21,6,3,3,3.7,2.1,1.6,21,ITA
ad84294f,1,13,0.1,0,0,1,4,0,0,0,0.1,0.5,-0.4,21,ITA
aded8e6f,3,66,0.7,1,0,2,15,0,2,-2,0.5,1.8,-1.3,21,ITA
ae4e2852,1,24,0.3,0,0,1,1,2,0,2,1.2,0.4,0.8,21,ITA
ae5b04fe,13,801,8.9,8,5,5,16,8,18,-10,8.9,14.1,-5.2,21,ITA
ae64d449,14,929,10.3,13,2,1,4,10,19,-9,12.8,16.3,-3.5,21,ITA
ae7058f9,25,1655,18.4,19,14,6,8,22,35,-13,21.2,30.9,-9.6,21,ITA
ae82fa48,16,729,8.1,6,2,10,14,14,17,-3,9.1,16.3,-7.2,21,ITA
ae94a6c5,1,11,0.1,0,0,1,0,1,0,1,0.3,0.0,0.3,21,ITA
ae9898c5,6,208,2.3,3,0,3,24,4,5,-1,2.8,3.6,-0.8,21,ITA
afa0d4e0,10,212,2.4,1,0,9,2,2,7,-5,3.6,4.5,-0.9,21,ITA
afe31d55,1,15,0.2,0,0,1,7,0,0,0,0.1,0.0,0.1,21,ITA
b0243215,8,262,2.9,2,0,6,12,4,9,-5,3.4,6.8,-3.3,21,ITA
b02af64f,2,50,0.6,1,0,1,0,0,0,0,0.1,0.0,0.1,21,ITA
b056e3da,1,90,1.0,1,1,0,37,3,3,0,2.5,2.1,0.4,21,ITA
b0f7e36c,33,2450,27.3,31,8,2,1,55,29,26,53.3,27.6,25.799999999999997,21,ITA
b1236c63,22,701,7.8,4,2,18,8,12,10,2,11.4,8.5,3.0,21,ITA
b1deecf8,12,968,10.8,12,10,0,13,11,14,-3,11.4,17.2,-5.8,21,ITA
b3af9be1,31,2715,30.2,31,27,0,0,42,53,-11,44.5,49.7,-5.3,21,ITA
b3fd7075,18,383,4.3,4,0,14,13,10,9,1,6.6,7.7,-1.1,21,ITA
b4a3d61a,2,65,0.7,0,0,2,6,0,1,-1,1.2,0.4,0.8,21,ITA
b5bf1770,23,1959,21.8,21,20,2,11,32,49,-17,29.4,38.9,-9.5,21,ITA
b6964eb6,16,1111,12.3,13,11,3,0,23,20,3,24.0,12.3,11.7,21,ITA
b6b2b820,14,1165,12.9,14,10,0,0,18,24,-6,15.5,24.2,-8.6,21,ITA
b70bde8f,18,603,6.7,4,0,14,13,22,4,18,14.1,7.7,6.4,21,ITA
b7a5bc86,21,1139,12.7,12,3,9,6,17,21,-4,17.8,18.0,-0.2,21,ITA
b96b595c,32,2813,31.3,32,30,0,0,51,44,7,48.6,39.2,9.3,21,ITA
ba1e04b3,33,1469,16.3,16,5,17,4,24,27,-3,25.9,23.6,2.4,21,ITA
ba3d3bea,19,568,6.3,4,0,15,14,7,14,-7,9.8,10.5,-0.7,21,ITA
bb376bed,29,1835,20.4,19,11,10,9,22,28,-6,23.3,26.7,-3.5,21,ITA
bbafc0c4,31,1947,21.6,20,16,11,3,26,38,-12,30.7,36.9,-6.1,21,ITA
bd84fc61,29,2247,25.0,26,18,3,2,27,52,-25,27.3,44.5,-17.2,21,ITA
bdc74a8f,33,1859,20.7,21,8,12,3,37,29,8,35.1,24.8,10.3,21,ITA
bdd0692f,1,22,0.2,0,0,1,7,0,1,-1,0.0,1.0,-1.0,21,ITA
be2706c0,24,1359,15.1,17,7,7,9,20,28,-8,21.2,26.4,-5.2,21,ITA
be927d03,26,1425,15.8,16,4,10,10,42,17,25,31.7,18.2,13.4,21,ITA
bee704fc,34,3034,33.7,34,32,0,1,44,52,-8,40.7,52.7,-12.0,21,ITA
bf309d24,18,658,7.3,7,2,11,11,10,11,-1,8.7,8.3,0.3,21,ITA
bf356094,23,734,8.2,4,1,19,8,9,10,-1,12.1,10.4,1.7,21,ITA
bf39bdec,6,170,1.9,1,0,5,5,2,2,0,2.5,1.9,0.6,21,ITA
bf4d31d3,1,1,0.0,0,0,1,5,0,0,0,0.2,0.0,0.2,21,ITA
bf57eaab,22,695,7.8,6,3,16,14,15,26,-11,12.700000000000001,18.6,-5.9,21,ITA
c010b898,32,2659,29.5,31,26,1,0,30,55,-25,31.7,46.1,-14.4,21,ITA
c01c66d9,2,63,0.7,0,0,2,0,0,2,-2,0.9,0.6,0.3,21,ITA
c0c7ff58,33,2569,28.5,29,18,4,1,65,32,33,52.4,32.0,20.4,21,ITA
c195ae4a,1,90,1.0,1,1,0,36,1,1,0,1.3,1.6,-0.3,21,ITA
c1d95617,37,3330,37.0,37,37,0,0,39,74,-35,40.2,63.1,-22.9,21,ITA
c1e8e74e,21,1590,17.7,19,12,2,13,19,32,-13,20.6,30.4,-9.8,21,ITA
c235e803,8,557,6.2,7,6,1,16,12,4,8,15.2,5.7,9.5,21,ITA
c283ddef,15,291,3.2,1,0,14,21,4,6,-2,5.8,5.2,0.6,21,ITA
c316607a,24,1837,20.4,22,12,2,6,40,32,8,32.5,30.3,2.3,21,ITA
c3a847c7,1,3,0.0,0,0,1,6,0,0,0,0.0,0.1,-0.1,21,ITA
c459a650,20,1216,13.5,12,9,8,3,31,14,17,27.2,13.2,14.0,21,ITA
c4efe2b4,10,357,4.0,4,0,6,7,4,9,-5,4.3,5.9,-1.5,21,ITA
c50cee19,26,1179,13.1,12,1,14,1,18,19,-1,21.0,19.4,1.6,21,ITA
c53083ad,25,1117,12.4,12,3,13,9,14,31,-17,17.3,26.0,-8.7,21,ITA
c56dc39e,31,2537,28.2,29,23,2,1,63,36,27,54.3,30.4,23.9,21,ITA
c5adc293,11,289,3.2,3,1,8,11,5,4,1,5.6,4.1,1.5,21,ITA
c6056d58,36,3206,35.6,36,35,0,0,39,73,-34,39.8,59.8,-20.0,21,ITA
c609e90e,4,116,1.3,1,0,3,9,3,4,-1,0.9,2.4,-1.5,21,ITA
c693347d,29,1898,21.1,21,12,8,2,19,44,-25,22.7,33.5,-10.8,21,ITA
c6e8cf1f,32,2106,23.4,24,12,8,3,27,39,-12,27.4,36.4,-9.1,21,ITA
c707411f,30,2298,25.5,27,21,3,3,60,26,34,49.7,26.0,23.8,21,ITA
c7259b83,27,1923,21.299999999999997,20,17,7,2,26,38,-12,31.0,35.6,-4.6000000000000005,21,ITA
c730da00,6,418,4.6,4,3,2,24,4,5,-1,3.3,6.3,-3.0,21,ITA
c77be0cf,35,2549,28.3,29,15,6,1,34,61,-27,28.4,52.2,-23.8,21,ITA
c803c92a,1,7,0.1,0,0,1,7,1,0,1,0.2,0.0,0.2,21,ITA
c8c0dccd,5,136,1.5,1,0,4,24,4,3,1,3.0999999999999996,3.2,-0.09999999999999998,21,ITA
c976160c,3,184,2.0,2,2,1,7,0,3,-3,4.1,1.7,2.4,21,ITA
ca241ad3,3,72,0.8,1,0,2,13,0,2,-2,0.4,0.7,-0.3,21,ITA
ca3db240,34,2395,26.6,27,13,7,4,28,46,-18,30.5,46.3,-15.9,21,ITA
caffaf5a,32,2274,25.3,25,21,7,5,32,38,-6,30.2,42.3,-12.1,21,ITA
cc1a0c57,7,603,6.7,7,6,0,13,11,12,-1,8.7,10.7,-2.0,21,ITA
cce9f582,25,1510,16.8,15,9,10,4,24,22,2,22.2,19.6,2.5,21,ITA
cd0fa27b,33,2614,29.0,30,13,3,0,58,32,26,53.8,36.2,17.6,21,ITA
cdf65d12,24,1742,19.4,19,17,5,10,23,28,-5,26.9,26.4,0.4,21,ITA
ce1a6c7e,1,1,0.0,0,0,1,0,0,0,0,0.2,0.0,0.2,21,ITA
ce30bfc8,28,1232,13.7,14,4,14,8,32,13,19,25.1,16.6,8.5,21,ITA
cec60a2f,27,1768,19.6,19,7,8,2,24,39,-15,24.0,30.8,-6.8,21,ITA
cedb3e36,36,2835,31.5,34,20,2,0,34,64,-30,33.2,55.1,-21.9,21,ITA
cf007308,33,740,8.2,3,1,30,3,20,10,10,16.0,10.7,5.3,21,ITA
cf043a33,5,323,3.6,4,1,1,7,8,4,4,4.3,4.4,-0.1,21,ITA
cf1c23d8,1,45,0.5,0,0,1,32,3,1,2,2.2,1.1,1.1,21,ITA
cfb38237,3,67,0.7,0,0,3,9,0,3,-3,0.2,3.5,-3.2,21,ITA
cfbf9881,8,428,4.8,5,2,3,19,5,12,-7,3.2,10.9,-7.7,21,ITA
d023d70f,27,1832,20.4,20,8,7,8,25,40,-15,23.4,33.6,-10.2,21,ITA
d0d8dd44,32,2734,30.4,30,30,2,5,64,27,37,58.1,30.7,27.4,21,ITA
d0dbca9f,12,880,9.8,11,8,1,20,13,15,-2,11.4,14.5,-3.1,21,ITA
d183e9d6,14,569,6.3,7,1,7,14,8,11,-3,6.8,8.2,-1.4,21,ITA
d1b49282,33,2648,29.4,29,25,4,1,39,40,-1,35.8,42.1,-6.3,21,ITA
d3298c99,21,980,10.9,12,0,9,6,13,27,-14,13.1,20.8,-7.7,21,ITA
d37b0350,33,1584,17.6,17,5,16,4,25,21,4,21.9,24.6,-2.7,21,ITA
d3aaad90,10,572,6.4,6,3,4,2,7,8,-1,9.9,9.9,0.0,21,ITA
d3b888e3,10,388,4.3,3,1,7,10,4,5,-1,4.9,9.1,-4.3,21,ITA
d3d758d8,26,892,9.9,8,0,18,12,10,17,-7,10.8,20.2,-9.5,21,ITA
d3de9af0,37,2379,26.4,29,3,8,0,60,33,27,50.4,29.7,20.7,21,ITA
d4535821,36,2966,33.0,33,28,3,1,52,46,6,51.0,39.6,11.4,21,ITA
d4931a5a,19,1063,11.8,15,3,4,1,12,17,-5,13.9,14.2,-0.3,21,ITA
d4c9725f,33,2933,32.6,33,31,0,1,63,37,26,62.6,38.9,23.7,21,ITA
d60099bc,12,475,5.3,4,0,8,17,8,9,-1,6.3,8.2,-1.9,21,ITA
d60c26fc,19,552,6.1,3,0,16,6,9,16,-7,9.1,11.9,-2.8,21,ITA
d6a889ea,7,240,2.6999999999999997,2,1,5,17,3,3,0,2.5,3.7,-1.2,21,ITA
d6e53a3a,27,2220,24.7,25,22,2,2,49,27,22,50.8,24.8,26.0,21,ITA
d6f88a1d,24,1599,17.8,18,7,6,7,29,23,6,23.9,24.0,-0.1,21,ITA
d705ba44,35,2888,32.1,33,23,2,2,41,47,-6,41.9,44.4,-2.4,21,ITA
d711d04f,29,1404,15.6,15,2,14,2,20,25,-5,16.7,22.5,-5.8,21,ITA
d7d32194,29,1606,17.8,22,3,7,6,27,31,-4,18.8,27.6,-8.8,21,ITA
d80b1835,15,689,7.7,8,4,7,18,12,8,4,12.5,7.3,5.2,21,ITA
d85c238b,36,2609,29.0,33,9,3,1,36,33,3,33.3,38.3,-5.1,21,ITA
d9565625,21,1090,12.1,10,9,11,14,23,13,10,18.8,16.4,2.4,21,ITA
d9624b51,28,2008,22.3,26,13,2,3,28,30,-2,31.3,31.8,-0.4,21,ITA
d97f2e8d,22,1388,15.4,18,10,4,12,13,35,-22,14.2,25.200000000000003,-10.9,21,ITA
d995ed27,34,2256,25.1,27,8,7,0,34,38,-4,31.1,41.3,-10.2,21,ITA
da5a981b,6,375,4.2,4,1,2,3,5,15,-10,3.6,9.4,-5.9,21,ITA
da974c7b,26,2209,24.5,25,22,1,1,54,21,33,39.9,25.8,14.0,21,ITA
db092d3b,21,1326,14.7,17,4,4,0,27,17,10,25.4,18.8,6.6,21,ITA
dc1c2fce,2,131,1.5,2,0,0,0,2,4,-2,1.1,3.1,-2.0,21,ITA
dc3fa3b5,24,1590,17.7,20,10,4,9,36,13,23,25.2,18.7,6.5,21,ITA
dd06d56c,3,207,2.3,2,2,1,11,3,5,-2,3.0,6.3,-3.4,21,ITA
dd0daf32,34,2745,30.5,30,25,4,0,57,43,14,53.6,33.9,19.7,21,ITA
dd52d069,2,4,0.0,0,0,2,25,0,0,0,0.0,0.0,0.0,21,ITA
dea698d9,33,2802,31.1,31,28,2,1,64,29,35,62.2,32.9,29.3,21,ITA
df3cda47,35,1923,21.4,19,6,16,2,49,21,28,45.4,22.9,22.6,21,ITA
df85d472,4,37,0.4,0,0,4,1,1,1,0,1.8,0.9,0.9,21,ITA
e0314d87,30,2563,28.5,30,25,0,5,36,43,-7,28.4,44.7,-16.3,21,ITA
e0921a4f,20,1132,12.6,14,4,6,4,25,15,10,22.9,12.4,10.5,21,ITA
e0ce7038,4,14,0.2,0,0,4,13,1,0,1,0.6,1.1,-0.5,21,ITA
e14ec482,34,1755,19.5,21,5,13,0,28,32,-4,27.7,32.9,-5.2,21,ITA
e1b0a70d,4,272,3.0,2,2,2,34,1,4,-3,1.1,5.2,-4.1,21,ITA
e1cbb531,15,154,1.7,0,0,15,18,5,2,3,3.6,3.4,0.1,21,ITA
e33f36d5,20,1641,18.2,19,15,1,4,24,19,5,17.2,26.7,-9.5,21,ITA
e358587b,29,2610,29.0,29,29,0,9,53,41,12,44.3,36.3,7.9,21,ITA
e3cceee6,15,940,10.4,10,10,5,11,24,8,16,21.7,9.3,12.4,21,ITA
e40d028b,8,720,8.0,8,8,0,26,22,5,17,17.2,8.7,8.5,21,ITA
e42d61c7,37,2665,29.6,29,19,8,0,72,26,46,61.0,30.2,30.8,21,ITA
e468c053,27,2021,22.5,25,13,2,1,20,45,-25,21.8,33.6,-11.9,21,ITA
e4b39692,1,90,1.0,1,1,0,37,1,1,0,0.4,1.2,-0.8,21,ITA
e58cbfd5,20,1187,13.2,12,6,8,16,14,23,-9,11.4,21.1,-9.7,21,ITA
e599253a,25,1122,12.5,10,5,15,2,28,22,6,25.5,16.0,9.4,21,ITA
e5bf73f3,38,2921,32.5,34,18,4,0,45,56,-11,46.5,55.3,-8.8,21,ITA
e66ebabb,36,3240,36.0,36,36,0,1,44,91,-47,36.8,68.7,-31.9,21,ITA
e74f0e59,29,2143,23.8,25,16,4,7,31,42,-11,32.9,39.8,-7.0,21,ITA
e81f0356,4,181,2.0,1,1,3,11,3,6,-3,2.5,4.5,-2.0,21,ITA
e85fb9b8,17,1386,15.4,16,13,1,8,29,18,11,28.6,18.5,10.2,21,ITA
e8c930bb,30,2408,26.8,29,21,1,5,35,35,0,29.7,36.8,-7.1,21,ITA
e921b9db,2,79,0.9,1,0,1,9,0,4,-4,0.9,1.7,-0.7,21,ITA
e947ee4a,26,1616,18.0,21,7,5,9,23,40,-17,21.7,26.9,-5.2,21,ITA
e94d79e3,29,2238,24.9,26,19,3,8,36,37,-1,31.2,42.2,-11.1,21,ITA
ea06dd97,15,396,4.4,3,1,12,7,6,5,1,7.6,6.5,1.1,21,ITA
ea164f99,3,153,1.7,3,0,0,3,2,1,1,1.6,1.8,-0.1,21,ITA
ea468ea8,21,1588,17.6,18,16,3,10,14,39,-25,16.0,29.5,-13.5,21,ITA
eb2fe5b6,36,1436,16.0,16,0,20,1,48,20,28,35.2,14.1,21.1,21,ITA
eb76987d,18,1190,13.2,14,10,4,11,24,19,5,18.2,19.8,-1.6,21,ITA
ec1f737d,1,28,0.3,0,0,1,36,1,0,1,0.0,0.5,-0.5,21,ITA
ec5dae45,31,1203,13.4,11,3,20,7,17,28,-11,23.2,19.2,3.9,21,ITA
eccbe56a,32,2079,23.1,27,4,5,1,37,30,7,33.6,30.6,3.0,21,ITA
ed5886d2,18,653,7.3,7,2,11,17,8,14,-6,9.2,11.7,-2.5,21,ITA
ed90babd,22,1507,16.7,18,4,4,2,22,32,-10,21.0,27.1,-5.8999999999999995,21,ITA
eda40760,7,390,4.3,4,4,3,16,13,10,3,12.0,7.3,4.7,21,ITA
ee251371,32,2016,22.4,27,3,5,0,41,25,16,40.7,28.2,12.5,21,ITA
ee4f2f3b,33,2204,24.5,25,8,8,4,35,32,3,28.7,35.8,-7.1,21,ITA
ee6e2b92,3,18,0.2,0,0,3,5,0,2,-2,0.4,0.7,-0.3,21,ITA
ee93c1a9,27,972,10.8,8,4,19,6,17,12,5,19.3,11.2,8.1,21,ITA
ef2e5e1a,18,1314,14.6,18,2,0,1,20,15,5,14.7,20.2,-5.6,21,ITA
ef619b0b,22,1089,12.1,13,1,9,8,31,11,20,27.4,14.2,13.2,21,ITA
ef94dc2f,22,975,10.899999999999999,12,0,10,6,9,25,-16,10.2,17.5,-7.3,21,ITA
f058ed1f,1,90,1.0,1,1,0,34,0,0,0,0.3,1.3,-1.0,21,ITA
f0f7f62f,25,2156,24.0,25,23,0,7,55,26,29,47.4,26.6,20.8,21,ITA
f1cfc209,36,2846,31.6,33,16,3,0,43,56,-13,41.1,49.2,-8.1,21,ITA
f1f1f238,27,1768,19.6,21,12,6,3,22,28,-6,20.3,25.9,-5.5,21,ITA
f49c4ae9,36,3215,35.7,36,32,0,0,44,86,-42,38.4,66.4,-28.0,21,ITA
f503ea63,32,2299,25.5,26,18,6,1,33,40,-7,28.8,38.6,-9.9,21,ITA
f5409698,1,13,0.1,0,0,1,3,0,0,0,0.1,0.6,-0.5,21,ITA
f554e29b,34,3060,34.0,34,34,0,0,35,53,-18,41.6,56.4,-14.9,21,ITA
f61c7c4e,29,2149,23.9,28,5,1,1,30,32,-2,28.2,35.0,-6.8,21,ITA
f6a06749,1,23,0.3,0,0,1,34,2,2,0,0.5,0.7,-0.2,21,ITA
f6dfa5b8,34,2335,25.9,23,15,11,1,26,50,-24,29.8,40.9,-11.1,21,ITA
f7036e1c,38,2561,28.5,30,8,8,0,66,24,42,55.0,27.8,27.2,21,ITA
f7223718,25,1595,17.7,18,9,7,9,25,28,-3,28.4,25.7,2.8,21,ITA
f794b426,4,334,3.7,4,3,0,25,3,11,-8,3.4,6.8,-3.5,21,ITA
f7e2af2c,15,1085,12.1,12,8,3,13,15,14,1,15.8,19.2,-3.4,21,ITA
f8d41a8c,3,63,0.7,1,0,2,15,0,2,-2,0.6,0.5,0.1,21,ITA
f91e81c9,33,2638,29.3,30,19,3,0,33,43,-10,33.3,44.1,-10.8,21,ITA
f95f49d2,1,45,0.5,0,0,1,0,0,0,0,0.7,1.6,-0.9,21,ITA
f9758dae,37,2851,31.7,32,21,5,1,36,57,-21,36.1,51.6,-15.5,21,ITA
fb77bfef,30,2469,27.4,28,22,2,4,31,44,-13,30.4,42.9,-12.6,21,ITA
fba81826,1,36,0.4,0,0,1,0,0,0,0,0.3,1.0,-0.7,21,ITA
fc4f85b1,28,2508,27.9,28,26,0,2,35,41,-6,34.6,37.8,-3.3,21,ITA
fdf4b948,32,1056,11.7,6,2,26,4,18,15,3,15.0,13.8,1.2,21,ITA
fe012aca,27,1785,19.8,20,8,7,2,29,31,-2,28.0,28.9,-1.0,21,ITA
fec5accc,4,94,1.0,0,0,4,5,1,2,-1,0.7,2.1,-1.5,21,ITA
fed5f993,35,3132,34.8,34,34,1,0,48,58,-10,50.4,56.8,-6.3,21,ITA
ff120e44,1,10,0.1,0,0,1,6,0,0,0,0.0,0.1,0.0,21,ITA
ff800ed8,12,498,5.5,4,2,8,4,6,10,-4,5.7,11.1,-5.4,21,ITA
0033fb1b,30,1799,20.0,19,3,11,2,20,40,-20,22.2,37.7,-15.5,21,FRA
005c0807,33,2957,32.9,33,30,0,0,39,61,-22,39.2,55.1,-15.9,21,FRA
0118c54c,33,2797,31.1,32,22,1,5,39,43,-4,43.7,36.5,7.3,21,FRA
032f894e,23,1270,14.1,14,4,9,2,23,9,14,18.0,14.0,4.0,21,FRA
037f2523,6,223,2.5,2,0,4,7,1,4,-3,2.6,4.2,-1.7,21,FRA
0557ff4f,4,250,2.8,3,2,1,1,2,4,-2,5.2,2.2,3.1,21,FRA
0630eb63,12,396,4.4,4,0,8,4,7,3,4,5.4,5.9,-0.5,21,FRA
065dc209,32,2073,23.0,26,3,6,0,33,39,-6,29.2,30.4,-1.2,21,FRA
06c48679,33,2823,31.4,33,27,0,1,42,40,2,47.6,39.9,7.7,21,FRA
06df8256,35,2870,31.9,32,26,3,3,63,37,26,56.5,30.1,26.4,21,FRA
08082af0,20,1626,18.1,20,17,0,6,21,33,-12,20.9,31.7,-10.8,21,FRA
08534272,13,294,3.3,2,0,11,5,3,9,-6,4.1,8.2,-4.0,21,FRA
09507ffa,1,90,1.0,1,1,0,0,0,4,-4,0.4,2.5,-2.1,21,FRA
095e4199,28,1289,14.3,14,0,14,3,16,19,-3,12.0,24.6,-12.6,21,FRA
0a8d6b91,5,109,1.2,1,0,4,26,1,3,-2,2.2,1.2,1.0,21,FRA
0ad37003,31,2438,27.1,29,14,2,0,29,37,-8,35.8,33.6,2.2,21,FRA
0b0cbe5b,36,2720,30.2,30,10,6,0,38,39,-1,39.9,35.1,4.8,21,FRA
0b4d8274,29,1769,19.7,19,7,10,0,22,30,-8,25.4,26.7,-1.3,21,FRA
0bb6e193,6,539,6.0,6,5,0,0,8,7,1,6.2,8.4,-2.2,21,FRA
0be95d34,26,652,7.2,5,0,21,6,15,8,7,10.8,4.5,6.4,21,FRA
0c2ac3cb,23,1361,15.1,15,2,8,4,31,8,23,28.8,18.0,10.8,21,FRA
0cbc8baa,27,2029,22.5,22,21,5,11,32,43,-11,31.3,37.4,-6.1,21,FRA
0d2158d5,24,1432,15.9,16,9,8,13,7,34,-27,12.6,30.8,-18.3,21,FRA
0d3585b5,10,524,5.8,6,2,4,4,10,8,2,7.8,8.6,-0.7,21,FRA
0d7b6576,18,555,6.2,3,0,15,5,13,8,5,11.2,14.1,-2.9,21,FRA
0d99c6e1,3,21,0.2,0,0,3,1,0,1,-1,0.2,0.3,-0.1,21,FRA
0e46fa2f,1,2,0.0,0,0,1,3,1,0,1,0.4,0.0,0.4,21,FRA
0e7ccfc4,25,2066,23.0,23,20,2,1,31,32,-1,31.1,33.8,-2.7,21,FRA
0f26fd24,3,97,1.1,1,0,2,6,0,1,-1,0.3,3.1,-2.8,21,FRA
0f8418aa,36,2581,28.7,29,18,7,0,40,38,2,42.9,37.6,5.4,21,FRA
0f86995c,12,458,5.1,4,2,8,12,8,10,-2,8.5,8.4,0.0,21,FRA
0f9b8301,15,355,3.9,2,0,13,2,4,11,-7,4.3,9.2,-4.8,21,FRA
1001ae82,14,651,7.2,7,1,7,4,5,15,-10,12.3,10.6,1.7,21,FRA
10efd0e1,12,707,7.9,9,3,3,2,10,20,-10,8.8,13.8,-5.0,21,FRA
10f0fdd3,36,2086,23.2,25,4,11,0,27,35,-8,29.3,29.7,-0.4,21,FRA
114bbdee,31,2610,29.0,29,27,2,0,39,44,-5,41.5,36.5,5.0,21,FRA
11ff3d56,5,440,4.9,5,3,0,0,8,12,-4,8.1,5.4,2.7,21,FRA
12bd0579,9,474,5.3,6,4,3,11,3,14,-11,4.0,9.6,-5.6,21,FRA
132a82f1,4,315,3.5,3,3,1,0,6,2,4,4.9,4.6,0.3,21,FRA
1467af0d,21,1492,16.6,16,12,5,0,36,15,21,34.4,16.1,18.3,21,FRA
14b8fcdf,1,90,1.0,1,1,0,2,1,1,0,0.9,1.1,-0.1,21,FRA
1545cf15,17,1297,14.4,15,8,2,10,18,25,-7,15.6,19.4,-3.9,21,FRA
15944afd,10,314,3.5,3,0,7,19,6,5,1,6.0,3.6,2.4,21,FRA
16324e1d,16,1225,13.6,14,11,2,2,12,27,-15,15.9,23.7,-7.8,21,FRA
165a2e40,28,2051,22.8,23,13,5,0,37,16,21,27.6,19.8,7.8,21,FRA
166a981d,1,17,0.2,0,0,1,4,0,0,0,0.0,0.1,0.0,21,FRA
16aa7d4c,33,2716,30.2,30,29,3,3,37,49,-12,39.3,48.7,-9.4,21,FRA
1787195f,23,801,8.9,8,0,15,9,12,17,-5,13.2,14.5,-1.3,21,FRA
17f29fb0,7,125,1.4,0,0,7,5,1,3,-2,3.3,2.8,0.5,21,FRA
18ebca4b,36,1570,17.4,17,4,19,1,25,30,-5,27.8,27.1,0.7,21,FRA
19053e31,32,2023,22.5,24,4,8,0,46,27,19,42.1,23.6,18.5,21,FRA
19a12bed,36,2960,32.9,34,27,2,0,44,41,3,40.8,46.1,-5.3,21,FRA
19ba6c6d,35,2680,29.8,31,16,4,0,42,48,-6,38.0,43.3,-5.2,21,FRA
19cda00b,27,1853,20.6,23,7,4,2,47,13,34,47.1,20.7,26.4,21,FRA
1a4b9094,2,76,0.8,0,0,2,0,1,1,0,2.0,1.4,0.5,21,FRA
1a992676,24,1064,11.8,12,3,12,5,29,6,23,27.9,12.2,15.8,21,FRA
1ad8cb67,7,540,6.0,6,3,1,3,8,13,-5,5.5,12.0,-6.6,21,FRA
1b6862e8,28,687,7.6,6,0,22,9,6,12,-6,4.4,10.8,-6.5,21,FRA
1bfe34dc,7,333,3.7,3,3,4,10,7,9,-2,2.8,5.9,-3.1,21,FRA
1d2d5cc8,37,3330,37.0,37,37,0,0,53,45,8,45.0,46.0,-1.0,21,FRA
1ddbc7ca,14,432,4.8,4,3,10,20,6,5,1,9.0,5.0,4.1,21,FRA
1df4a109,3,65,0.7,1,0,2,3,1,1,0,1.0,1.5,-0.5,21,FRA
1ec7e1c5,30,2661,29.6,30,26,0,3,39,32,7,37.3,28.7,8.5,21,FRA
1f6298f2,1,7,0.1,0,0,1,8,0,0,0,0.4,0.0,0.4,21,FRA
20094685,4,134,1.5,2,0,2,2,2,1,1,1.8,3.0,-1.2,21,FRA
2054d037,9,422,4.7,4,0,5,2,4,3,1,4.5,4.6,-0.1,21,FRA
20de219a,1,90,1.0,1,1,0,27,2,1,1,2.3,1.2,1.1,21,FRA
20e73fac,37,2552,28.4,29,15,8,0,33,27,6,35.2,27.5,7.6,21,FRA
2145368f,32,2175,24.2,24,16,8,4,27,37,-10,25.8,37.9,-12.1,21,FRA
22721b88,13,813,9.0,10,7,3,2,16,6,10,11.3,12.6,-1.3,21,FRA
2306bfde,2,23,0.3,0,0,2,2,1,0,1,0.1,0.3,-0.2,21,FRA
2321ea6e,26,2306,25.6,26,25,0,3,34,47,-13,33.1,35.5,-2.4,21,FRA
23bf644d,12,312,3.5,3,0,9,18,6,5,1,6.3,6.9,-0.7,21,FRA
23c63b7f,24,1304,14.5,16,4,8,3,15,20,-5,21.5,19.4,2.1,21,FRA
2434f24a,38,3420,38.0,38,38,0,0,42,56,-14,43.5,54.9,-11.4,21,FRA
243f4a0b,18,1559,17.3,18,16,0,0,17,18,-1,17.5,24.0,-6.5,21,FRA
244bc2c8,36,2930,32.6,35,16,1,1,41,39,2,30.8,48.0,-17.1,21,FRA
24eb7ed6,36,2448,27.2,26,20,10,2,44,48,-4,37.6,48.4,-10.8,21,FRA
2500cef9,38,2674,29.7,30,12,8,0,41,49,-8,38.1,39.0,-0.9,21,FRA
25146df0,1,1,0.0,0,0,1,5,0,0,0,0.0,0.0,0.0,21,FRA
2515040a,31,2614,29.0,29,28,2,3,36,43,-7,36.5,43.0,-6.6,21,FRA
2591b066,19,743,8.3,6,4,13,11,6,17,-11,8.2,14.7,-6.5,21,FRA
26777636,35,2418,26.9,25,16,10,0,28,47,-19,30.4,40.4,-9.9,21,FRA
2677a1de,22,1181,13.1,16,0,6,1,13,10,3,16.0,14.3,1.7,21,FRA
2693f6bc,2,21,0.2,0,0,2,5,0,1,-1,0.1,0.3,-0.2,21,FRA
2736b85e,3,77,0.9,1,0,2,11,1,1,0,0.9,2.0,-1.2,21,FRA
275e2c51,34,3024,33.6,34,32,0,1,32,45,-13,36.7,43.5,-6.8,21,FRA
279ddf6a,30,2547,28.3,29,25,1,0,26,33,-7,21.5,42.6,-21.2,21,FRA
288e1e13,35,3147,35.0,35,34,0,0,46,36,10,41.7,35.0,6.7,21,FRA
28a65a2c,29,2610,29.0,29,29,0,0,30,42,-12,35.5,35.1,0.4,21,FRA
28dabd43,38,3420,38.0,38,38,0,0,40,58,-18,41.6,52.3,-10.7,21,FRA
28f66c2e,10,559,6.2,5,4,5,21,12,5,7,9.2,4.5,4.7,21,FRA
2945f4b7,23,753,8.4,5,0,18,10,13,12,1,9.6,11.5,-1.9,21,FRA
295ba708,13,523,5.8,6,1,7,6,5,11,-6,6.1,8.6,-2.5,21,FRA
29939a1d,13,197,2.2,2,0,11,13,3,5,-2,1.7,4.7,-3.0,21,FRA
29aee77c,3,35,0.4,0,0,3,7,0,0,0,0.4,1.6,-1.2,21,FRA
29c02c9f,25,1357,15.1,15,7,10,7,38,10,28,34.1,19.8,14.3,21,FRA
29d8ad3f,13,1076,12.0,12,11,1,2,13,16,-3,12.6,14.7,-2.1,21,FRA
29ef0f49,21,1008,11.2,12,1,9,5,8,15,-7,13.5,12.3,1.2,21,FRA
2a657da0,31,2074,23.0,27,5,4,3,28,25,3,20.9,32.8,-11.9,21,FRA
2ab14aaa,6,149,1.7,0,0,6,19,1,3,-2,3.9,1.7,2.1,21,FRA
2acf0cd7,27,1928,21.4,21,17,6,3,26,31,-5,19.7,34.6,-14.9,21,FRA
2aeb43f1,2,8,0.1,0,0,2,3,0,1,-1,0.2,0.1,0.0,21,FRA
2b1bed19,35,2727,30.3,33,20,2,0,33,51,-18,35.4,45.6,-10.2,21,FRA
2b5a35e5,7,56,0.6,0,0,7,10,2,2,0,1.7,0.7,0.9,21,FRA
2b9b37b2,3,270,3.0,3,3,0,25,4,4,0,3.5,4.8,-1.2,21,FRA
2b9fdeea,36,2732,30.4,33,13,3,0,43,34,9,40.5,34.2,6.3,21,FRA
2c127b6f,3,107,1.2,1,1,2,35,1,3,-2,2.2,2.3,-0.1,21,FRA
2d22cea7,29,1622,18.0,16,8,13,2,23,33,-10,25.7,24.4,1.3,21,FRA
2d70dbe5,23,2070,23.0,23,23,0,7,29,43,-14,29.5,31.5,-2.0,21,FRA
2d9f280e,4,43,0.5,0,0,4,9,1,3,-2,1.4,1.2,0.2,21,FRA
2fa2a875,28,2520,28.0,28,28,0,0,56,27,29,49.4,22.3,27.2,21,FRA
3010aefb,32,1474,16.4,16,2,16,4,17,23,-6,21.1,23.4,-2.3,21,FRA
30144daa,35,2030,22.6,23,4,12,0,37,30,7,32.5,36.4,-3.8,21,FRA
3043d33f,32,2298,25.5,25,16,7,0,18,42,-24,20.8,46.1,-25.3,21,FRA
3071a619,19,651,7.2,6,0,13,9,3,13,-10,4.7,15.3,-10.6,21,FRA
309937e7,6,173,1.9,1,1,5,13,1,4,-3,1.4,5.5,-4.1,21,FRA
30af8b93,31,2368,26.3,26,16,5,1,56,17,39,52.4,19.2,33.2,21,FRA
31626657,38,2963,32.9,32,22,6,0,42,53,-11,41.8,43.0,-1.2,21,FRA
31a62dc7,29,2381,26.5,28,19,1,1,45,12,33,31.6,19.3,12.3,21,FRA
3225654e,3,122,1.4,1,1,2,13,1,1,0,1.3,2.4,-1.1,21,FRA
329e7a13,1,8,0.1,0,0,1,1,0,0,0,0.2,0.1,0.1,21,FRA
32c2d95f,33,2889,32.1,33,32,0,0,37,39,-2,29.1,45.4,-16.2,21,FRA
32f3d97e,29,917,10.2,6,0,23,1,10,21,-11,12.6,17.0,-4.4,21,FRA
33508c78,21,877,9.7,7,0,14,5,25,9,16,21.2,8.4,12.8,21,FRA
33887998,1,90,1.0,1,1,0,0,1,1,0,1.6,0.4,1.1,21,FRA
3423f250,6,404,4.5,5,1,1,0,8,6,2,5.3,3.9,1.5,21,FRA
34e4343c,7,293,3.3,3,0,4,1,4,2,2,4.6,3.1,1.5,21,FRA
3544641e,8,229,2.5,2,0,6,6,4,4,0,2.6,4.0,-1.4,21,FRA
3681cfff,16,1377,15.3,15,14,1,3,22,27,-5,22.3,22.2,0.1,21,FRA
3708e9fa,21,1069,11.9,12,1,9,0,28,8,20,20.4,7.6,12.8,21,FRA
375622c5,34,2577,28.6,31,14,3,0,47,44,3,41.7,44.7,-3.0,21,FRA
380a15e2,9,745,8.3,7,7,2,25,10,11,-1,7.4,13.4,-6.0,21,FRA
3814120d,8,720,8.0,8,8,0,14,9,14,-5,12.4,11.2,1.2,21,FRA
39c0c75b,1,10,0.1,0,0,1,4,0,0,0,0.0,0.2,-0.2,21,FRA
3befc2b6,34,2668,29.6,29,28,5,2,37,41,-4,39.4,40.1,-0.7,21,FRA
3c6bbbab,36,3221,35.8,36,35,0,0,41,45,-4,41.2,45.7,-4.5,21,FRA
3cd7820a,30,1327,14.7,13,6,17,7,19,27,-8,17.9,22.9,-5.0,21,FRA
3d50bcdb,26,1698,18.9,22,6,4,4,37,16,21,35.2,20.4,14.8,21,FRA
3dd738a1,33,2225,24.7,27,15,6,2,37,30,7,38.2,24.8,13.4,21,FRA
3ef0fa48,23,1551,17.2,20,2,3,2,29,24,5,30.9,18.2,12.7,21,FRA
3ef68782,33,1755,19.5,21,0,12,3,24,37,-13,25.3,26.4,-1.1,21,FRA
3f5b4635,38,3292,36.6,38,34,0,0,58,61,-3,50.3,63.4,-13.1,21,FRA
4047c976,10,557,6.2,7,1,3,0,5,11,-6,7.1,11.1,-4.0,21,FRA
40774c6b,5,129,1.4,2,0,3,6,5,3,2,2.5,2.9,-0.4,21,FRA
414e1f69,9,146,1.6,0,0,9,11,3,3,0,3.1,3.4,-0.4,21,FRA
41e7ef1c,19,1278,14.2,15,8,4,6,28,11,17,26.6,16.7,9.8,21,FRA
42dcf26d,32,2831,31.5,32,29,0,0,45,38,7,42.1,35.8,6.3,21,FRA
42eaa028,37,2177,24.2,26,6,11,0,36,20,16,27.2,20.6,6.7,21,FRA
42fd9c7f,31,2380,26.4,27,16,4,0,68,20,48,62.7,26.6,36.1,21,FRA
433dc9a2,3,194,2.2,2,0,1,0,0,2,-2,3.4,2.3,1.1,21,FRA
436a9dd0,31,1851,20.6,18,12,13,1,47,11,36,44.1,21.3,22.7,21,FRA
43b78598,20,1079,12.0,11,7,9,1,32,12,20,28.4,13.6,14.8,21,FRA
43e7a164,30,2552,28.4,29,24,1,0,33,37,-4,35.9,31.5,4.4,21,FRA
44f8c299,25,1754,19.5,19,14,6,1,20,42,-22,22.5,33.7,-11.2,21,FRA
450e277f,14,1104,12.3,12,11,2,21,15,24,-9,12.7,20.2,-7.4,21,FRA
45bb4303,10,106,1.2,0,0,10,18,5,2,3,3.7,1.9,1.8,21,FRA
45c1c326,23,1288,14.3,14,4,9,5,8,30,-22,13.1,29.9,-16.8,21,FRA
462475ed,35,2967,33.0,34,28,1,1,46,49,-3,48.7,45.0,3.7,21,FRA
46359159,22,942,10.5,8,0,14,2,13,19,-6,12.1,13.7,-1.6,21,FRA
46750e9c,32,2210,24.6,28,4,4,2,26,28,-2,21.5,37.6,-16.2,21,FRA
468fdbad,12,482,5.4,6,2,6,8,8,8,0,7.7,7.1,0.6,21,FRA
46907171,15,552,6.1,5,0,10,12,1,9,-8,5.0,6.9,-2.0,21,FRA
469d3d84,24,912,10.1,9,1,15,2,16,23,-7,15.5,16.1,-0.6,21,FRA
46a7b605,17,239,2.7,1,0,16,10,1,5,-4,3.4,5.0,-1.6,21,FRA
46faabfa,10,663,7.4,9,2,1,0,8,7,1,7.5,9.8,-2.3,21,FRA
475583ff,16,1046,11.6,11,7,5,19,9,23,-14,13.1,23.6,-10.5,21,FRA
47af88b8,31,2614,29.0,31,26,0,2,58,33,25,60.2,31.0,29.3,21,FRA
47c609d5,33,1245,13.8,11,0,22,3,15,27,-12,10.3,24.5,-14.2,21,FRA
48b28bfd,29,2182,24.2,26,14,3,1,34,38,-4,34.2,35.8,-1.6,21,FRA
49070d66,7,308,3.4,3,1,4,18,5,5,0,4.0,5.1,-1.1,21,FRA
49136c42,26,2272,25.2,26,24,0,4,30,44,-14,31.5,38.5,-7.0,21,FRA
4914ed4a,4,355,3.9,4,3,0,8,6,4,2,8.0,4.9,3.1,21,FRA
4a537185,2,24,0.3,0,0,2,2,1,0,1,0.2,0.4,-0.2,21,FRA
4a57580c,16,564,6.3,7,0,9,9,7,11,-4,5.9,8.9,-3.0,21,FRA
4a987ffa,33,961,10.7,9,1,24,5,13,21,-8,15.4,16.4,-1.0,21,FRA
4b6960d2,25,1594,17.7,20,8,5,8,16,20,-4,16.8,18.9,-2.1,21,FRA
4b96c347,33,2725,30.3,33,17,0,0,33,46,-13,33.6,43.4,-9.8,21,FRA
4bd00a50,4,272,3.0,4,2,0,2,2,7,-5,3.0,5.6,-2.6,21,FRA
4be0b467,36,1749,19.4,20,1,16,0,22,29,-7,21.1,26.9,-5.9,21,FRA
4bf69118,18,1038,11.5,12,7,6,19,10,14,-4,11.4,16.0,-4.6,21,FRA
4c4ffacc,16,1070,11.9,11,8,5,21,14,15,-1,16.0,16.9,-1.0,21,FRA
4c5b714f,30,1980,22.0,21,17,9,0,45,24,21,37.4,17.2,20.2,21,FRA
4e0afc5d,23,1224,13.6,14,4,9,11,20,23,-3,16.2,24.1,-7.9,21,FRA
4e7db402,38,3420,38.0,38,38,0,0,47,55,-8,49.0,53.6,-4.6,21,FRA
4e9957ff,1,90,1.0,1,1,0,5,2,1,1,1.1,1.0,0.1,21,FRA
4eb0686f,19,304,3.4,0,0,19,8,2,7,-5,3.5,5.8,-2.3,21,FRA
4ef705ab,9,200,2.2,2,0,7,13,2,9,-7,2.6,6.7,-4.2,21,FRA
4f255115,36,3063,34.0,36,26,0,0,67,39,28,60.3,31.5,28.8,21,FRA
5046b7d4,30,1616,18.0,18,1,12,0,18,28,-10,19.8,25.9,-6.2,21,FRA
514270e8,11,257,2.9,2,0,9,23,2,4,-2,1.8,2.8,-1.0,21,FRA
5148dcc5,34,2436,27.1,30,7,4,0,35,23,12,30.4,26.4,4.0,21,FRA
5167c97e,25,2132,23.7,24,19,1,5,36,31,5,32.4,32.3,0.1,21,FRA
51b41c5c,28,2197,24.4,24,21,4,2,30,29,1,28.1,34.3,-6.2,21,FRA
51c30111,14,353,3.9,3,0,11,22,7,10,-3,7.3,6.4,0.9,21,FRA
51dbeea9,24,1616,18.0,16,14,8,2,42,14,28,37.2,18.2,19.0,21,FRA
5219ab4a,33,2521,28.0,30,11,3,4,42,41,1,41.0,35.7,5.3,21,FRA
5313ed43,30,2309,25.7,25,18,5,0,37,37,0,35.7,35.4,0.4,21,FRA
5314e067,22,1505,16.7,17,9,5,9,22,34,-12,19.8,28.4,-8.6,21,FRA
539b4f25,9,711,7.9,8,7,1,6,11,14,-3,11.6,11.6,-0.1,21,FRA
53f6306f,27,1187,13.2,15,0,12,0,17,19,-2,16.2,17.6,-1.5,21,FRA
542cc80f,22,1681,18.7,19,10,3,2,27,22,5,20.7,28.1,-7.5,21,FRA
54d51e22,30,1934,21.5,24,3,6,5,32,43,-11,26.7,26.1,0.6,21,FRA
5515376c,29,2237,24.9,24,19,5,2,33,46,-13,32.6,35.6,-3.0,21,FRA
562a4799,25,1964,21.8,21,21,4,9,21,29,-8,24.2,28.1,-3.8,21,FRA
5722eced,23,1024,11.4,11,1,12,5,19,11,8,14.0,11.4,2.6,21,FRA
574aa9ec,18,1435,15.9,16,11,2,18,24,24,0,24.5,17.5,6.9,21,FRA
57a46f3f,15,196,2.2,1,0,14,17,7,2,5,4.9,3.1,1.8,21,FRA
58ad9383,37,3285,36.5,37,36,0,0,41,49,-8,30.7,57.5,-26.8,21,FRA
58ae47b2,33,2417,26.9,28,12,5,0,37,33,4,35.2,29.1,6.1,21,FRA
59948ef7,8,158,1.8,1,0,7,18,7,6,1,2.6,4.3,-1.7,21,FRA
5b146df3,11,962,10.7,11,10,0,16,14,17,-3,11.0,13.7,-2.8,21,FRA
5b1bf5e3,35,2394,26.6,30,5,5,0,38,36,2,39.3,29.9,9.4,21,FRA
5b5724d2,27,1342,14.9,14,11,13,11,16,27,-11,17.5,20.8,-3.4,21,FRA
5b92d896,2,88,1.0,0,0,2,4,0,3,-3,0.7,2.7,-2.1,21,FRA
5c61496e,3,31,0.3,0,0,3,4,0,1,-1,0.1,0.7,-0.5,21,FRA
5c9ac7f0,22,354,3.9,3,0,19,14,3,6,-3,5.3,5.7,-0.4,21,FRA
5ceba7fc,35,2811,31.2,34,14,1,0,69,37,32,68.6,33.7,34.9,21,FRA
5d0e0a1f,29,1951,21.7,23,9,6,4,27,23,4,27.9,23.2,4.7,21,FRA
5d5219b1,17,828,9.2,11,1,6,1,8,18,-10,9.0,18.1,-9.1,21,FRA
5d8d7454,13,1114,12.4,13,11,0,0,15,16,-1,15.0,13.3,1.7,21,FRA
5d93ccee,8,514,5.7,5,5,3,29,1,9,-8,3.9,10.6,-6.7,21,FRA
5e080f73,36,2029,22.5,22,5,14,2,37,45,-8,31.1,35.6,-4.6,21,FRA
5e22e2a4,3,270,3.0,3,3,0,0,2,2,0,4.3,3.3,1.0,21,FRA
5ea9ebd4,20,899,10.0,10,5,10,14,5,21,-16,9.2,21.8,-12.6,21,FRA
5ee6e943,5,361,4.0,4,4,1,33,3,10,-7,4.0,7.6,-3.6,21,FRA
5f0241b2,10,810,9.0,8,8,2,26,22,9,13,22.7,11.3,11.4,21,FRA
5f26e0c5,26,2276,25.3,26,25,0,3,32,38,-6,35.5,33.9,1.6,21,FRA
5f3eaaf5,33,2324,25.8,28,8,5,0,35,34,1,34.1,34.9,-0.8,21,FRA
5fdcb075,8,496,5.5,6,2,2,28,8,7,1,6.3,8.4,-2.1,21,FRA
602fc7b5,6,42,0.5,0,0,6,7,1,1,0,0.6,0.8,-0.2,21,FRA
6043997c,14,871,9.7,10,8,4,16,13,9,4,12.4,10.0,2.4,21,FRA
60f58477,6,56,0.6,0,0,6,11,0,2,-2,0.6,1.5,-0.9,21,FRA
61590953,18,1246,13.8,13,11,5,13,14,24,-10,19.4,18.7,0.7,21,FRA
6191093d,36,2787,31.0,32,14,4,1,42,45,-3,39.9,42.8,-2.9,21,FRA
62e02107,19,816,9.1,8,2,11,11,11,15,-4,13.3,9.7,3.7,21,FRA
6481421d,23,899,10.0,9,0,14,7,11,11,0,9.9,13.6,-3.7,21,FRA
64ba07c0,29,2305,25.6,28,16,1,3,30,47,-17,29.8,40.4,-10.7,21,FRA
64c14d49,4,256,2.8,3,2,1,1,3,4,-1,2.2,4.8,-2.6,21,FRA
64f69877,35,2769,30.8,34,13,1,0,64,32,32,53.6,26.3,27.3,21,FRA
6554bb97,4,120,1.3,2,0,2,9,0,2,-2,0.4,2.1,-1.7,21,FRA
6605d143,36,2465,27.400000000000002,28,11,8,1,39,36,3,37.5,34.6,2.8000000000000003,21,FRA
667b65da,8,720,8.0,8,8,0,3,12,8,4,12.8,12.6,0.1,21,FRA
6690ef25,22,1626,18.1,19,12,3,7,28,28,0,23.3,28.7,-5.4,21,FRA
677ee102,30,2252,25.0,26,18,4,6,34,29,5,39.1,27.8,11.4,21,FRA
67b7357e,22,1934,21.5,22,19,0,6,16,45,-29,20.8,38.5,-17.8,21,FRA
68a26d51,32,2280,25.3,26,18,6,6,38,35,3,35.9,35.6,0.2,21,FRA
69384e5d,18,1415,15.7,15,11,3,0,32,15,17,36.2,17.1,19.1,21,FRA
6a827d8e,18,956,10.6,13,1,5,0,15,21,-6,13.2,18.0,-4.8,21,FRA
6b2c894b,31,2613,29.0,29,27,2,0,27,35,-8,23.6,45.3,-21.7,21,FRA
6b4436ba,3,38,0.4,0,0,3,12,0,3,-3,0.4,1.1,-0.7,21,FRA
6bde367b,27,2165,24.1,26,15,1,0,43,35,8,38.3,40.1,-1.8,21,FRA
6be41a31,10,303,3.4,2,0,8,14,4,7,-3,7.5,4.3,3.2,21,FRA
6c8ddd52,26,1987,22.099999999999998,23,18,3,4,17,35,-18,20.9,40.300000000000004,-19.400000000000002,21,FRA
6d075c67,7,21,0.2,0,0,7,19,1,1,0,0.8,0.3,0.5,21,FRA
6de23ab0,27,1133,12.6,10,8,17,9,29,13,16,28.9,15.6,13.3,21,FRA
6dfd8f05,36,3140,34.9,35,34,1,0,47,56,-9,47.6,51.2,-3.6,21,FRA
6e2c94ad,5,61,0.7,0,0,5,4,2,0,2,1.4,0.7,0.7,21,FRA
6e5b5a45,25,1608,17.9,19,9,6,3,9,42,-33,15.9,41.5,-25.6,21,FRA
6e7f1353,12,826,9.2,10,6,2,0,13,9,4,11.3,13.6,-2.2,21,FRA
6f5ec8bb,24,2007,22.3,23,20,1,6,35,27,8,36.9,23.5,13.4,21,FRA
6f806d99,36,1816,20.2,21,6,15,2,24,36,-12,26.1,29.2,-3.1,21,FRA
6fbde63a,7,407,4.5,5,0,2,1,4,7,-3,4.6,8.4,-3.8,21,FRA
706a60e1,19,1077,12.0,11,5,8,4,18,17,1,15.7,19.6,-3.9,21,FRA
70c52749,26,2328,25.9,26,25,0,1,33,45,-12,31.6,38.2,-6.6,21,FRA
7155e3e1,32,2058,22.9,22,15,10,2,33,32,1,29.2,30.5,-1.3,21,FRA
72a0fb65,38,3420,38.0,38,38,0,0,25,73,-48,33.7,72.5,-38.8,21,FRA
72c812f3,28,1581,17.6,20,8,8,5,34,12,22,32.0,16.2,15.8,21,FRA
741418c3,30,1910,21.2,21,14,9,3,31,34,-3,28.8,33.3,-4.5,21,FRA
743fd71f,26,967,10.7,10,0,16,4,17,16,1,13.4,16.6,-3.3,21,FRA
745ca0a3,36,2891,32.1,33,19,3,0,40,58,-18,41.9,49.9,-8.0,21,FRA
74733221,15,1350,15.0,15,15,0,20,26,14,12,17.1,14.8,2.2,21,FRA
74dc806c,24,1703,18.9,19,9,5,0,18,35,-17,20.3,29.4,-9.2,21,FRA
754d5c33,1,6,0.1,0,0,1,2,1,0,1,0.9,0.1,0.8,21,FRA
75a63397,16,1132,12.6,13,3,3,0,15,14,1,14.7,14.9,-0.2,21,FRA
7615f332,1,30,0.3,0,0,1,1,0,0,0,1.0,0.3,0.7,21,FRA
767212e6,17,955,10.6,9,7,8,12,18,19,-1,16.2,12.9,3.3,21,FRA
76806215,1,90,1.0,1,1,0,34,1,2,-1,2.0,1.4,0.6,21,FRA
770d7eb8,21,1834,20.4,21,18,0,0,30,32,-2,32.9,29.8,3.1,21,FRA
775185ae,23,436,4.8,2,0,21,10,5,8,-3,7.6,5.9,1.7,21,FRA
779847d6,32,2776,30.8,31,30,1,2,39,44,-5,39.1,44.0,-4.9,21,FRA
77d7c96f,1,20,0.2,0,0,1,0,0,0,0,0.2,0.0,0.1,21,FRA
7909ffa4,29,1165,12.9,11,3,18,7,15,28,-13,14.4,25.0,-10.6,21,FRA
792a9d41,6,78,0.9,0,0,6,4,3,1,2,1.1,2.1,-1.0,21,FRA
79685569,18,906,10.1,9,6,9,3,12,17,-5,12.9,12.1,0.7,21,FRA
796b1c41,17,606,6.7,5,0,12,12,12,8,4,6.5,8.0,-1.6,21,FRA
79b2399c,35,2053,22.8,24,12,11,1,27,41,-14,26.1,33.3,-7.2,21,FRA
7a0b1e96,1,43,0.5,0,0,1,5,0,1,-1,0.3,0.2,0.1,21,FRA
7a42d0df,33,2413,26.8,28,15,5,1,38,38,0,38.0,32.3,5.8,21,FRA
7b075c75,3,145,1.6,1,1,2,7,4,0,4,4.4,1.0,3.4,21,FRA
7b9a9e25,32,1771,19.7,20,1,12,0,20,24,-4,26.4,23.5,2.9,21,FRA
7b9c2d84,35,2402,26.7,28,10,7,0,36,28,8,33.0,26.5,6.5,21,FRA
7c2965bb,28,1783,19.8,23,2,5,2,26,31,-5,26.8,28.0,-1.2,21,FRA
7c3ed041,21,1634,18.2,19,17,2,15,24,24,0,19.1,22.3,-3.2,21,FRA
7cbf91b2,4,33,0.4,0,0,4,14,2,0,2,1.3,0.7,0.6,21,FRA
7cdda3bf,38,3256,36.2,38,24,0,0,59,58,1,50.6,61.0,-10.4,21,FRA
7cf431a5,7,255,2.8,3,0,4,9,2,4,-2,4.1,1.7,2.5,21,FRA
7d08063d,33,2009,22.3,24,5,9,0,47,24,23,45.8,26.7,19.2,21,FRA
7d937aa1,23,911,10.1,10,2,13,15,11,15,-4,11.7,14.4,-2.7,21,FRA
7d9397f8,29,1494,16.6,17,6,12,6,25,21,4,21.2,24.7,-3.4,21,FRA
7d9b37bf,23,580,6.4,6,0,17,11,10,11,-1,10.9,7.9,3.0,21,FRA
7d9f3d69,1,13,0.1,0,0,1,0,0,0,0,0.2,0.1,0.1,21,FRA
7e82a78f,34,2355,26.2,30,11,4,0,41,44,-3,36.2,44.4,-8.1,21,FRA
7ef972c3,23,1477,16.4,15,10,8,14,19,20,-1,21.8,23.2,-1.5,21,FRA
7f622eef,1,1,0.0,0,0,1,0,0,0,0,0.0,0.0,0.0,21,FRA
7fecbcdb,16,1347,15.0,16,13,0,15,15,25,-10,16.4,20.0,-3.6,21,FRA
80556f08,34,2601,28.9,32,20,2,1,31,41,-10,34.2,41.3,-7.2,21,FRA
8104e41e,12,389,4.3,3,0,9,1,14,4,10,8.8,2.7,6.0,21,FRA
822d51d7,35,2873,31.9,35,24,0,1,65,32,33,58.8,27.7,31.0,21,FRA
82518f62,33,1754,19.5,21,5,12,2,45,18,27,46.9,18.7,28.1,21,FRA
8332db56,24,1779,19.8,19,13,5,11,18,25,-7,21.9,28.9,-7.0,21,FRA
833ce5f0,1,2,0.0,0,0,1,0,0,0,0,0.1,0.0,0.1,21,FRA
834b5c4c,6,540,6.0,6,6,0,2,9,13,-4,8.0,7.8,0.2,21,FRA
8413ceb1,3,157,1.7,2,1,1,9,1,4,-3,1.2,4.8,-3.6,21,FRA
84c0768a,13,744,8.3,9,6,4,7,5,19,-14,5.9,16.8,-10.9,21,FRA
84d94b91,27,1153,12.8,12,3,15,3,19,30,-11,16.0,21.8,-5.8,21,FRA
85613cf0,15,1220,13.6,14,8,1,0,20,20,0,18.5,16.0,2.5,21,FRA
8577e60a,37,3290,36.6,37,32,0,0,40,52,-12,45.6,47.8,-2.2,21,FRA
85847c67,1,8,0.1,0,0,1,1,0,0,0,0.0,0.1,-0.1,21,FRA
85a44ecc,29,1687,18.7,18,11,11,1,20,30,-10,18.0,23.1,-5.1,21,FRA
861227d2,35,3041,33.8,35,29,0,0,39,38,1,40.0,42.8,-2.8,21,FRA
873ce3a2,21,1089,12.1,13,3,8,7,8,17,-9,11.0,21.0,-10.0,21,FRA
8746d5d0,23,1318,14.6,14,10,9,9,9,29,-20,15.1,26.8,-11.7,21,FRA
87e9c7cd,28,1001,11.1,9,1,19,10,15,11,4,13.7,13.8,-0.1,21,FRA
8802c1d5,30,1130,12.6,10,0,20,2,9,26,-17,11.4,21.6,-10.3,21,FRA
881cd6be,9,241,2.7,2,0,7,6,4,6,-2,4.2,4.0,0.2,21,FRA
8846a40f,28,1467,16.3,16,1,12,1,18,21,-3,16.8,21.4,-4.6,21,FRA
885b7aa7,29,2610,29.0,29,29,0,0,20,50,-30,26.0,55.8,-29.8,21,FRA
88970207,4,128,1.4,1,1,3,2,1,2,-1,1.8,1.4,0.4,21,FRA
88c4d190,28,816,9.1,7,0,21,3,13,17,-4,13.6,13.3,0.3,21,FRA
88f130ed,15,1330,14.8,15,13,0,0,24,20,4,20.8,20.2,0.6,21,FRA
8a2248b4,38,3420,38.0,38,38,0,0,50,53,-3,48.0,55.6,-7.7,21,FRA
8b298f56,23,1078,12.0,12,2,11,4,15,7,8,11.5,12.8,-1.3,21,FRA
8bbe2df5,26,1263,14.0,14,9,12,11,29,11,18,22.6,13.2,9.4,21,FRA
8bc373ea,14,1260,14.0,14,14,0,1,21,18,3,20.0,19.6,0.4,21,FRA
8db95f95,1,3,0.0,0,0,1,4,0,0,0,0.1,0.0,0.1,21,FRA
8e697a8f,28,551,6.1,3,0,25,9,9,8,1,7.0,12.1,-5.2,21,FRA
8eec784d,28,878,9.8,7,0,21,6,14,7,7,13.0,7.8,5.2,21,FRA
8f325097,20,1369,15.2,15,7,5,17,23,28,-5,17.2,30.5,-13.3,21,FRA
8f4d116f,23,1227,13.6,13,7,10,6,19,24,-5,16.2,28.7,-12.4,21,FRA
8f696594,37,2923,32.5,33,20,4,0,74,38,36,70.4,37.8,32.7,21,FRA
8fd9996f,23,1430,15.9,16,11,7,3,38,15,23,30.8,18.0,12.8,21,FRA
90a9cc01,7,186,2.1,1,0,6,9,7,2,5,5.1,4.4,0.7,21,FRA
90c99c5c,5,42,0.5,0,0,5,7,1,1,0,0.4,1.8,-1.4,21,FRA
90eb507d,37,3324,36.9,37,36,0,0,42,49,-7,32.5,57.8,-25.4,21,FRA
90f87966,36,3185,35.4,36,34,0,0,58,22,36,42.6,28.2,14.3,21,FRA
91f2da4c,1,23,0.3,0,0,1,0,0,0,0,0.5,0.0,0.5,21,FRA
92232aad,26,2103,23.4,25,20,1,0,31,24,7,34.4,27.2,7.2,21,FRA
923f4dda,27,1764,19.6,19,10,8,0,24,24,0,23.1,21.1,2.0,21,FRA
9260926b,24,1504,16.7,20,7,4,0,13,19,-6,17.9,20.9,-3.0,21,FRA
92b56413,1,15,0.2,0,0,1,4,0,0,0,0.1,0.1,-0.1,21,FRA
93b8f9f4,15,495,5.5,4,0,11,11,10,8,2,9.5,7.2,2.4,21,FRA
942b4f90,37,2607,29.0,32,8,5,0,57,36,21,51.0,27.1,23.8,21,FRA
94f8d10c,33,2813,31.3,32,28,1,0,42,41,1,37.1,40.1,-3.0,21,FRA
95192fe4,2,38,0.4,0,0,2,13,0,1,-1,0.4,0.3,0.1,21,FRA
95981861,1,70,0.8,1,0,0,2,0,2,-2,0.6,1.2,-0.6,21,FRA
95bb6ddc,30,2144,23.8,25,11,5,2,14,47,-33,18.8,45.5,-26.7,21,FRA
96726741,1,19,0.2,0,0,1,9,0,0,0,0.6,0.4,0.2,21,FRA
96e5168e,26,502,5.6,2,0,24,8,8,14,-6,8.8,7.3,1.5,21,FRA
972aeb2a,20,1800,20.0,20,20,0,0,24,28,-4,23.6,30.3,-6.7,21,FRA
9744ff80,27,1320,14.7,13,8,14,3,31,8,23,28.7,17.9,10.8,21,FRA
97bfa797,3,36,0.4,0,0,3,3,0,1,-1,0.2,0.5,-0.3,21,FRA
9826ea33,3,45,0.5,0,0,3,0,1,1,0,0.2,0.9,-0.7,21,FRA
9836e892,14,294,3.3,2,0,12,7,5,6,-1,7.6,4.3,3.4,21,FRA
9980269a,17,981,10.9,11,5,6,7,15,9,6,14.9,11.4,3.4,21,FRA
999ceb5f,2,54,0.6,0,0,2,12,1,3,-2,0.3,1.2,-0.9,21,FRA
9ae9eaea,1,78,0.9,1,0,0,0,4,1,3,4.5,0.2,4.3,21,FRA
9b398aea,3,187,2.1,2,0,1,0,3,8,-5,2.0,5.7,-3.7,21,FRA
9b40a6ea,27,2242,24.9,27,17,0,1,25,45,-20,29.0,41.0,-12.0,21,FRA
9b5237b1,1,12,0.1,0,0,1,1,0,0,0,0.1,0.0,0.1,21,FRA
9b6556d2,20,773,8.6,8,0,12,7,3,13,-10,8.9,16.9,-8.1,21,FRA
9b6f7fd5,30,2275,25.3,27,12,3,1,61,31,30,53.7,30.1,23.6,21,FRA
9ba7b4fa,6,260,2.9,3,1,3,3,4,10,-6,3.0,4.1,-1.1,21,FRA
9c221d14,33,2899,32.2,33,31,0,0,39,41,-2,27.7,47.1,-19.4,21,FRA
9c2b1f11,24,652,7.2,6,1,18,13,11,9,2,8.2,11.1,-2.9,21,FRA
9d5dcc23,26,1454,16.2,19,2,7,4,14,22,-8,18.8,21.3,-2.5,21,FRA
9daeac61,27,2222,24.7,24,22,3,1,25,32,-7,29.4,32.7,-3.3,21,FRA
9ddf7fae,1,12,0.1,0,0,1,1,0,0,0,0.4,0.0,0.4,21,FRA
9f90c06b,4,320,3.6,4,2,0,10,4,9,-5,3.3,5.9,-2.6,21,FRA
a046fc35,4,93,1.0,1,0,3,1,0,1,-1,0.6,2.2,-1.5,21,FRA
a0791826,33,2815,31.3,32,23,1,1,37,34,3,37.9,38.1,-0.2,21,FRA
a0b65401,9,463,5.1,6,2,3,3,5,11,-6,7.1,8.7,-1.6,21,FRA
a0f9b535,23,1368,15.2,16,7,7,5,27,21,6,20.4,15.6,4.8,21,FRA
a13028f6,1,11,0.1,0,0,1,0,0,1,-1,0.0,0.6,-0.6,21,FRA
a1f3f5a0,22,529,5.9,4,0,18,12,5,16,-11,5.6,8.8,-3.3,21,FRA
a27ecdc2,8,124,1.4,0,0,8,7,1,5,-4,1.8,2.1,-0.3,21,FRA
a2d873dd,36,2503,27.8,32,6,4,1,30,40,-10,34.1,41.1,-7.0,21,FRA
a44d3a3c,16,230,2.6,0,0,16,9,5,2,3,5.9,1.8,4.1,21,FRA
a4527d33,24,2160,24.0,24,24,0,14,31,31,0,32.5,31.7,0.7,21,FRA
a46472d0,15,1042,11.6,12,9,3,9,15,24,-9,14.3,20.1,-5.8,21,FRA
a4b1028a,35,3000,33.3,34,30,1,0,48,35,13,42.4,34.6,7.8,21,FRA
a4c3f7af,18,1320,14.7,15,10,3,1,13,23,-10,16.2,22.8,-6.6,21,FRA
a59d55b1,1,90,1.0,1,1,0,3,3,2,1,1.2,1.3,0.0,21,FRA
a5db0bec,30,1781,19.8,23,6,7,1,48,27,21,46.8,24.7,22.0,21,FRA
a634b9d2,6,318,3.5,4,0,2,17,5,4,1,6.9,3.6,3.3,21,FRA
a7e4760c,2,11,0.1,0,0,2,18,0,0,0,0.0,0.2,-0.2,21,FRA
a84f9a4b,22,1625,18.1,19,14,3,11,24,28,-4,23.4,25.9,-2.6,21,FRA
a8567629,26,1694,18.8,18,13,8,12,49,10,39,45.5,20.4,25.2,21,FRA
a99138af,24,1183,13.1,12,7,12,10,15,21,-6,17.0,17.900000000000002,-1.0,21,FRA
a99da9ec,23,849,9.4,7,0,16,11,13,18,-5,12.6,12.6,0.0,21,FRA
aa21406e,2,22,0.2,0,0,2,3,1,0,1,0.2,0.1,0.1,21,FRA
aa67d758,1,2,0.0,0,0,1,0,0,0,0,0.1,0.0,0.1,21,FRA
aad56ca3,34,2747,30.5,31,21,3,0,40,40,0,39.6,44.8,-5.1,21,FRA
ab096c6f,24,2036,22.6,23,20,1,8,22,31,-9,26.7,26.9,-0.2,21,FRA
abc06eb3,21,1890,21.0,21,21,0,13,16,33,-17,19.6,36.4,-16.8,21,FRA
ad82197c,29,2011,22.3,24,16,5,6,44,24,20,42.8,21.5,21.2,21,FRA
ae4e2852,29,1467,16.3,14,8,15,0,33,21,12,29.3,18.4,10.9,21,FRA
ae59b359,32,1919,21.3,21,14,11,5,36,15,21,27.2,18.9,8.3,21,FRA
ae7d0ecd,34,3058,34.0,34,32,0,0,41,38,3,40.0,41.6,-1.6,21,FRA
aef6e670,28,2303,25.6,26,20,2,3,53,26,27,49.0,27.7,21.4,21,FRA
af0c835b,1,82,0.9,1,0,0,4,0,0,0,0.2,0.5,-0.3,21,FRA
b052b8bf,12,1080,12.0,12,12,0,20,6,30,-24,10.8,23.1,-12.3,21,FRA
b0547a87,33,1611,17.9,15,0,18,2,20,28,-8,21.9,26.9,-5.0,21,FRA
b0c71810,14,732,8.1,9,0,5,0,9,10,-1,10.4,9.2,1.3,21,FRA
b2336681,17,873,9.7,8,5,9,17,16,7,9,11.5,7.1,4.5,21,FRA
b2791a55,2,86,1.0,1,0,1,11,1,2,-1,1.0,2.1,-1.2,21,FRA
b2bd0f6c,38,2985,33.2,34,21,4,0,52,19,33,41.1,25.6,15.5,21,FRA
b34c63a5,27,698,7.8,5,1,22,10,13,6,7,14.7,6.7,8.0,21,FRA
b49729cb,35,3150,35.0,35,35,0,3,46,62,-16,46.5,53.3,-6.9,21,FRA
b4c816a9,2,132,1.5,2,0,0,0,1,2,-1,1.5,2.8,-1.3,21,FRA
b6047994,3,73,0.8,1,0,2,3,0,2,-2,0.3,1.1,-0.7,21,FRA
b666421b,34,2993,33.3,34,33,0,1,34,51,-17,36.4,46.2,-9.8,21,FRA
b66d1d8a,21,1538,17.1,18,14,3,10,13,28,-15,16.5,26.8,-10.4,21,FRA
b73f17f8,3,29,0.3,0,0,3,1,0,0,0,0.4,0.4,0.0,21,FRA
b748968d,30,2307,25.6,25,20,5,3,16,48,-32,23.2,44.5,-21.3,21,FRA
b8d22478,20,964,10.7,14,0,6,0,13,9,4,10.5,10.0,0.4,21,FRA
b92edde2,14,491,5.5,4,1,10,18,6,6,0,6.6,4.9,1.7,21,FRA
b94b8be1,34,1731,19.2,21,2,13,2,24,25,-1,25.6,23.9,1.6,21,FRA
b99bec05,20,1116,12.4,13,6,7,8,19,13,6,16.6,12.0,4.6,21,FRA
bc0bfc64,17,804,8.9,11,0,6,5,11,5,6,11.7,7.3,4.3,21,FRA
bc224243,2,133,1.5,2,0,0,1,0,3,-3,1.6,3.8,-2.2,21,FRA
bc7b4580,22,1507,16.7,19,11,3,7,16,25,-9,19.6,21.8,-2.2,21,FRA
bc9479b9,10,342,3.8,3,1,7,6,1,9,-8,2.7,10.9,-8.2,21,FRA
bcf1b2e9,38,3420,38.0,38,38,0,0,40,71,-31,43.3,64.2,-20.9,21,FRA
bdedd861,1,15,0.2,0,0,1,0,0,0,0,0.0,0.0,0.0,21,FRA
be13e5a8,1,90,1.0,1,1,0,29,0,4,-4,0.5,2.3,-1.9,21,FRA
be47b750,34,1372,15.2,12,1,22,3,25,18,7,24.5,16.3,8.2,21,FRA
beae3a73,38,3054,33.9,35,25,3,0,37,62,-25,36.8,56.0,-19.2,21,FRA
beb391dd,36,2446,27.2,29,12,7,0,65,34,31,62.3,31.5,30.8,21,FRA
bef0a7ac,32,1579,17.5,19,2,13,2,25,21,4,22.1,22.1,0.0,21,FRA
bf4c41f9,29,1291,14.3,14,0,15,6,25,24,1,20.599999999999998,18.5,2.2,21,FRA
bfcef334,2,39,0.4,0,0,2,3,1,2,-1,1.4,1.1,0.4,21,FRA
c05d65d1,1,7,0.1,0,0,1,1,1,0,1,0.8,0.1,0.7,21,FRA
c0b3669f,37,3029,33.7,35,19,2,0,46,48,-2,44.5,49.1,-4.6,21,FRA
c0f706f3,4,66,0.7,0,0,4,10,1,0,1,0.7,0.3,0.4,21,FRA
c20bdcd7,29,2180,24.2,24,18,5,5,37,13,24,26.2,17.4,8.8,21,FRA
c26a3918,27,2309,25.7,25,25,2,5,28,35,-7,27.1,34.4,-7.3,21,FRA
c39b09e3,5,169,1.9,2,1,3,0,1,3,-2,1.7,2.9,-1.2,21,FRA
c4173f1a,9,810,9.0,9,9,0,13,18,14,4,17.0,11.2,5.8,21,FRA
c4bbea9f,29,2117,23.5,24,22,5,3,37,33,4,33.6,39.3,-5.6,21,FRA
c631f952,31,2673,29.7,31,29,0,0,50,51,-1,44.5,52.8,-8.3,21,FRA
c64c01fc,4,44,0.5,0,0,4,5,1,2,-1,0.9,0.4,0.5,21,FRA
c6e5d20f,32,2243,24.9,23,17,9,1,50,28,22,49.1,27.6,21.5,21,FRA
c7526c18,34,2908,32.3,33,30,1,1,49,35,14,40.8,32.8,8.0,21,FRA
c76b7567,37,2624,29.2,31,12,6,0,38,41,-3,40.1,37.1,3.0,21,FRA
c795c408,22,1801,20.0,21,16,1,12,11,37,-26,15.3,36.3,-21.1,21,FRA
c801616a,35,2691,29.9,32,16,3,1,33,42,-9,31.8,39.6,-7.8,21,FRA
caef7840,2,43,0.5,0,0,2,5,1,0,1,0.2,0.6,-0.4,21,FRA
cb9ec45d,26,1154,12.8,13,7,13,4,19,16,3,19.3,16.2,3.1,21,FRA
cc41f558,25,1724,19.2,19,16,6,4,29,25,4,23.6,22.7,0.8,21,FRA
cc588cbe,1,6,0.1,0,0,1,1,0,0,0,0.5,0.1,0.4,21,FRA
cc77354e,35,2894,32.2,35,24,0,0,47,38,9,40.5,39.0,1.6,21,FRA
cc83b74d,25,1928,21.4,21,14,4,0,27,27,0,23.9,30.1,-6.2,21,FRA
cc972842,1,30,0.3,0,0,1,0,0,0,0,0.3,1.0,-0.7,21,FRA
ccb1c3af,18,452,5.0,3,0,15,17,5,8,-3,3.4,7.4,-4.0,21,FRA
ccce7025,37,3309,36.8,37,35,0,1,63,23,40,46.9,29.3,17.6,21,FRA
cdc4458b,6,94,1.0,0,0,6,1,4,1,3,3.0,1.0,2.0,21,FRA
ce492295,9,712,7.9,8,5,1,12,8,17,-9,8.0,11.6,-3.6,21,FRA
ce4f40c7,33,2627,29.2,30,20,3,2,42,42,0,44.2,37.3,6.9,21,FRA
ce50fd99,37,2354,26.2,29,7,8,0,48,12,36,34.8,16.2,18.6,21,FRA
cecbce23,27,2430,27.0,27,27,0,4,29,35,-6,32.6,35.8,-3.1999999999999993,21,FRA
cf1ef7ec,9,352,3.9,3,3,6,16,6,4,2,9.5,3.9,5.6,21,FRA
d14229f3,20,589,6.5,5,0,15,13,11,5,6,12.2,5.2,7.0,21,FRA
d21e361a,17,414,4.6,4,0,13,7,6,8,-2,6.7,7.0,-0.3,21,FRA
d33c706e,30,2482,27.6,30,18,0,0,49,43,6,39.3,43.5,-4.1,21,FRA
d3ce9f1f,7,296,3.3,3,1,4,31,5,9,-4,4.8,7.8,-2.9,21,FRA
d4133fa1,1,20,0.2,0,0,1,0,0,0,0,0.0,0.1,-0.1,21,FRA
d4d35152,13,603,6.7,7,4,6,19,7,10,-3,11.4,8.8,2.6,21,FRA
d4fa7d01,15,1046,11.6,12,9,3,17,18,15,3,13.1,18.1,-5.0,21,FRA
d504b3e1,15,1082,12.100000000000001,12,9,3,0,10,15,-5,13.899999999999999,15.9,-2.0,21,FRA
d5575935,24,1645,18.3,17,11,7,1,23,20,3,18.1,24.5,-6.5,21,FRA
d56b9520,2,2,0.0,0,0,2,11,0,0,0,0.0,0.1,-0.1,21,FRA
d5f2f82b,25,2128,23.6,24,22,1,2,51,12,39,47.5,20.7,26.8,21,FRA
d63e2912,29,2385,26.5,26,21,3,1,40,37,3,35.0,35.7,-0.7,21,FRA
d7bf3d19,2,116,1.3,1,0,1,0,1,4,-3,0.3,5.3,-5.0,21,FRA
d87e6889,3,4,0.0,0,0,3,10,0,0,0,0.1,0.4,-0.3,21,FRA
d8992b84,26,1672,18.6,21,7,5,8,21,23,-2,19.9,21.1,-1.2,21,FRA
d9764034,28,2089,23.2,22,21,6,5,48,20,28,39.0,18.0,21.0,21,FRA
d9a66c60,19,234,2.6,1,0,18,14,4,6,-2,4.6,6.7,-2.1,21,FRA
da4d670f,1,2,0.0,0,0,1,11,0,0,0,0.1,0.0,0.1,21,FRA
db7849ca,36,2458,27.3,28,9,8,0,35,45,-10,33.9,42.1,-8.1,21,FRA
db87a2c4,1,90,1.0,1,1,0,3,0,1,-1,0.4,1.5,-1.1,21,FRA
ddcc9e22,1,15,0.2,0,0,1,0,0,1,-1,0.0,0.3,-0.2,21,FRA
de40e38c,2,92,1.0,1,0,1,2,0,1,-1,0.7,0.7,0.0,21,FRA
de488e56,22,1700,18.9,19,15,3,7,18,25,-7,21.1,23.3,-2.2,21,FRA
dff153a4,21,1302,14.5,16,5,5,6,35,14,21,28.8,14.7,14.1,21,FRA
e0f3a1f6,24,1947,21.6,22,20,2,12,27,35,-8,29.5,31.3,-1.8,21,FRA
e1df6989,33,2379,26.4,28,13,5,1,33,39,-6,34.1,37.4,-3.2,21,FRA
e288d4b3,21,1538,17.1,18,10,3,5,35,13,22,37.5,14.7,22.8,21,FRA
e2f9bb5f,29,1229,13.7,14,2,15,6,16,20,-4,17.3,17.7,-0.4,21,FRA
e34fc66d,3,192,2.1,2,2,1,3,1,2,-1,4.4,2.0,2.3,21,FRA
e3ad3368,1,5,0.1,0,0,1,3,0,0,0,0.0,0.0,0.0,21,FRA
e3d0b0c4,34,2907,32.3,34,28,0,0,68,36,32,65.2,35.3,29.9,21,FRA
e3e05edf,13,558,6.2,5,3,8,7,9,11,-2,5.8,10.6,-4.8,21,FRA
e4448c8c,1,7,0.1,0,0,1,0,0,0,0,0.1,0.0,0.1,21,FRA
e472a6f6,2,76,0.8,0,0,2,9,2,1,1,1.3,1.9,-0.6,21,FRA
e4b72e34,26,2035,22.6,22,19,4,2,23,27,-4,30.1,29.6,0.5,21,FRA
e50623a0,6,307,3.4,4,1,2,0,3,7,-4,2.3,6.7,-4.4,21,FRA
e53ab10b,1,14,0.2,0,0,1,1,0,0,0,0.0,0.1,-0.1,21,FRA
e54a9890,23,1170,13.0,13,4,10,3,16,13,3,14.2,12.4,1.8,21,FRA
e6777e6b,32,2784,30.9,31,30,1,3,35,51,-16,41.8,42.0,-0.2,21,FRA
e768de1f,31,2693,29.9,31,26,0,0,34,36,-2,34.2,39.2,-5.0,21,FRA
e7986081,16,677,7.5,6,3,10,0,9,5,4,18.6,4.8,13.8,21,FRA
e90dc1d5,4,140,1.6,2,0,2,2,3,3,0,2.7,0.9,1.8,21,FRA
e97150c0,28,2493,27.7,28,27,0,2,41,52,-11,35.9,37.9,-2.1,21,FRA
ea02beaf,38,2420,26.9,27,5,11,0,31,39,-8,30.3,40.0,-9.7,21,FRA
ea0aa7e0,34,2236,24.8,26,15,8,0,39,40,-1,36.6,40.2,-3.6,21,FRA
ea0ff634,24,857,9.5,6,2,18,12,11,18,-7,6.5,14.5,-8.0,21,FRA
ecada4fc,29,2520,28.0,29,27,0,1,64,18,46,57.0,27.8,29.1,21,FRA
ed45c4a5,26,1887,21.0,21,10,5,1,25,22,3,27.2,25.3,1.9,21,FRA
edbe46dc,37,3313,36.8,37,35,0,0,54,51,3,54.2,44.5,9.7,21,FRA
edd1466a,23,1622,18.0,18,13,5,11,12,41,-29,16.7,36.3,-19.6,21,FRA
edd81e2a,38,3412,37.9,38,37,0,0,44,48,-4,44.1,49.2,-5.2,21,FRA
eedea60b,2,135,1.5,1,1,1,32,1,1,0,2.0,1.5,0.5,21,FRA
ef2e5e1a,11,233,2.6,1,0,10,6,5,2,3,2.2,3.5,-1.3,21,FRA
ef7cd87a,29,1681,18.7,20,11,9,7,18,28,-10,22.0,24.8,-2.8,21,FRA
ef9c1c95,35,2885,32.1,35,17,0,0,47,17,30,36.1,23.1,13.0,21,FRA
f00de885,38,3420,38.0,38,38,0,0,81,43,38,81.4,41.5,39.9,21,FRA
f066022d,30,2659,29.5,30,29,0,4,38,47,-9,37.9,37.1,0.8,21,FRA
f18d7ab2,19,1207,13.4,12,11,7,15,21,20,1,17.6,19.7,-2.1,21,FRA
f329ec76,2,34,0.4,0,0,2,4,0,2,-2,0.2,1.4,-1.2,21,FRA
f3600c02,33,1200,13.3,11,4,22,1,30,9,21,20.5,9.4,11.1,21,FRA
f36c432f,29,802,8.9,6,1,23,3,24,10,14,20.8,8.2,12.7,21,FRA
f36d5624,19,675,7.5,6,1,13,11,18,10,8,13.3,10.2,3.1,21,FRA
f449640d,24,662,7.4,6,4,18,9,17,16,1,14.1,10.0,4.2,21,FRA
f45f9427,13,373,4.1,3,2,10,10,8,4,4,5.9,4.2,1.7,21,FRA
f4bc42b1,27,1256,14.0,12,1,15,2,13,22,-9,13.1,21.5,-8.5,21,FRA
f5044e54,29,2063,22.9,23,16,6,1,31,35,-4,30.4,35.4,-4.9,21,FRA
f54d2149,29,2031,22.6,26,11,3,2,25,35,-10,17.9,38.0,-20.0,21,FRA
f5b6fb78,31,2651,29.5,30,27,1,3,31,42,-11,35.4,42.3,-7.0,21,FRA
f5c8b425,32,1086,12.1,10,0,22,1,20,5,15,18.8,7.9,10.9,21,FRA
f5efb153,26,2218,24.6,25,24,1,0,25,35,-10,27.6,38.2,-10.5,21,FRA
f6496133,24,1314,14.6,17,2,7,3,16,23,-7,17.3,15.6,1.7,21,FRA
f6b94e8d,15,1000,11.1,10,9,5,18,5,16,-11,9.5,12.7,-3.2,21,FRA
f76022e7,2,41,0.5,0,0,2,14,1,0,1,1.5,0.1,1.4,21,FRA
f7691f63,34,1829,20.3,19,6,15,0,26,30,-4,28.3,25.7,2.6,21,FRA
f81ef10d,29,1761,19.6,19,10,10,6,37,25,12,36.7,20.4,16.4,21,FRA
f83c8d6c,24,571,6.3,1,0,23,13,5,10,-5,6.3,12.9,-6.6,21,FRA
f8405304,21,348,3.9,1,0,20,10,5,8,-3,5.6,5.8,-0.2,21,FRA
f86ca403,12,914,10.2,11,6,1,0,12,11,1,10.9,12.6,-1.7,21,FRA
f8ce97ca,6,383,4.3,3,3,3,19,12,3,9,10.3,6.0,4.3,21,FRA
f98b15f0,20,795,8.9,11,1,9,7,9,15,-6,9.7,13.200000000000001,-3.3,21,FRA
f9921b7f,2,21,0.2,0,0,2,6,0,0,0,0.0,0.1,-0.1,21,FRA
f9d5908e,25,1736,19.3,22,6,3,1,22,33,-11,22.8,27.9,-5.2,21,FRA
fa18c72e,28,1496,16.6,17,2,11,2,33,6,27,22.9,11.3,11.6,21,FRA
fb14aa28,29,2161,24.0,24,8,5,0,16,43,-27,21.0,41.6,-20.6,21,FRA
fbbb9269,33,2909,32.3,33,27,0,1,40,47,-7,37.8,48.5,-10.7,21,FRA
fbf76716,23,1239,13.8,15,3,8,6,18,24,-6,18.8,19.5,-0.8,21,FRA
fbf83734,15,1350,15.0,15,15,0,23,21,25,-4,19.1,21.0,-2.0,21,FRA
fc4cf6a7,30,2123,23.6,24,13,6,1,29,29,0,28.5,34.0,-5.6,21,FRA
fc62f087,22,1490,16.6,17,13,5,4,41,10,31,34.7,18.9,15.8,21,FRA
fcb27134,19,1615,17.9,19,15,0,0,25,31,-6,26.4,27.7,-1.3,21,FRA
fcb38f57,38,3420,38.0,38,38,0,0,64,23,41,48.5,29.8,18.7,21,FRA
fcbcbd94,27,1196,13.3,13,3,14,1,11,23,-12,13.7,26.9,-13.2,21,FRA
fd2bc67d,9,774,8.6,9,8,0,0,13,10,3,10.4,12.4,-2.0,21,FRA
fe296c72,15,1128,12.5,11,10,4,8,14,19,-5,14.9,16.8,-1.9,21,FRA
fe6c1add,1,2,0.0,0,0,1,3,0,0,0,0.0,0.0,0.0,21,FRA
feb5d3ab,22,1556,17.3,16,13,6,13,27,28,-1,25.1,28.6,-3.6,21,FRA
feb5d972,22,1594,17.7,18,14,4,9,24,29,-5,19.7,24.9,-5.2,21,FRA
ff0ab48c,37,2903,32.3,35,17,2,1,70,33,37,73.4,33.3,40.0,21,FRA
ff3a6a60,4,97,1.1,1,0,3,2,2,1,1,1.7,1.7,0.0,21,FRA
ff800ed8,19,1553,17.3,17,15,2,0,24,24,0,21.7,20.5,1.1,21,FRA
ffec9769,18,579,6.4,4,2,14,0,17,5,12,14.8,6.1,8.7,21,FRA
fffea3e5,30,2313,25.7,26,18,4,0,31,27,4,32.0,27.8,4.3,21,FRA
00242715,30,2567,28.5,29,28,1,0,45,37,8,44.4,36.6,7.8,22,GER
00242b75,31,1789,19.9,20,7,11,2,25,24,1,28.6,24.6,4.0,22,GER
00672803,5,161,1.8,1,1,4,12,1,7,-6,2.0,5.1,-3.1,22,GER
00963611,31,2705,30.1,31,26,0,0,39,54,-15,38.6,48.4,-9.8,22,GER
009a4f60,28,1429,15.9,13,11,15,3,28,25,3,24.1,18.3,5.8,22,GER
0174ba21,30,1364,15.2,13,6,17,1,9,30,-21,11.5,31.2,-19.7,22,GER
01834aa0,27,2007,22.3,23,18,4,5,30,37,-7,32.3,30.1,2.2,22,GER
037130ca,11,349,3.9,5,1,6,13,1,16,-15,2.4,12.5,-10.1,22,GER
042e8a49,21,1359,15.1,16,3,5,0,38,17,21,39.7,18.5,21.2,22,GER
048a1cbc,23,1795,19.9,21,10,2,0,45,36,9,32.5,25.6,6.9,22,GER
049751d7,8,239,2.7,1,0,7,1,4,3,1,3.9,2.0,1.9,22,GER
054849d2,28,2174,24.2,26,19,2,0,30,34,-4,27.9,37.3,-9.4,22,GER
056d2d95,25,1990,22.1,23,14,2,8,32,25,7,30.4,24.2,6.2,22,GER
05ba9d7c,21,1079,12.0,11,0,10,7,12,24,-12,11.6,19.3,-7.8,22,GER
05d548d8,23,1765,19.6,20,15,3,1,48,23,25,34.6,26.7,8.0,22,GER
05e2d5ea,3,27,0.3,0,0,3,1,3,0,3,0.5,0.2,0.3,22,GER
05f99a4a,34,2611,29.0,32,9,2,0,41,39,2,43.9,38.6,5.3,22,GER
061e8e23,22,963,10.7,12,0,10,8,13,13,0,11.7,11.1,0.6,22,GER
07c7eb0c,33,2935,32.6,33,31,0,0,37,50,-13,39.4,55.2,-15.8,22,GER
07d3bfec,1,14,0.2,0,0,1,6,0,0,0,0.0,0.1,-0.1,22,GER
080440a4,27,2222,24.7,25,24,2,2,32,37,-5,29.5,36.4,-6.9,22,GER
08593525,24,1655,18.4,21,5,3,6,30,30,0,31.9,27.7,4.3,22,GER
088ca1bd,13,588,6.5,6,3,7,5,10,7,3,8.6,7.3,1.2,22,GER
091c86e2,16,323,3.6,1,0,15,11,3,6,-3,5.2,7.7,-2.5,22,GER
0a3d6d2b,20,1307,14.5,13,12,7,3,24,28,-4,19.4,21.4,-2.0,22,GER
0a3f6cde,25,1130,12.6,12,3,13,4,13,18,-5,15.4,20.3,-4.9,22,GER
0a89e877,22,1143,12.7,12,7,10,8,27,15,12,23.8,15.0,8.8,22,GER
0b104510,26,2280,25.3,25,25,1,0,21,59,-38,24.1,45.1,-21.0,22,GER
0b4f388a,29,2166,24.1,24,18,5,0,39,36,3,38.8,37.8,1.0,22,GER
0c61c77c,22,1058,11.8,9,5,13,10,13,26,-13,18.5,18.5,0.0,22,GER
0c7a48f8,27,1754,19.5,20,14,7,2,47,29,18,38.5,24.0,14.4,22,GER
0cc5f4a5,25,1627,18.1,18,7,7,0,26,30,-4,26.9,23.1,3.8,22,GER
0cddeaa7,6,338,3.8,3,0,3,3,7,8,-1,6.2,7.2,-0.9,22,GER
0cf778df,25,1714,19.0,21,5,4,0,21,27,-6,24.3,30.2,-5.9,22,GER
0d55d942,25,2175,24.2,25,24,0,0,28,51,-23,23.6,41.4,-17.8,22,GER
0d8a37c2,1,90,1.0,1,1,0,33,1,1,0,1.4,0.8,0.6,22,GER
0da32a38,4,99,1.1,1,0,3,9,0,3,-3,0.5,2.3,-1.8,22,GER
0e0102eb,23,1595,17.8,19,5,4,1,23,26,-3,20.5,25.6,-5.1,22,GER
0e6bc38c,20,377,4.2,1,0,19,2,11,5,6,11.0,5.5,5.5,22,GER
0f59a7bf,29,1861,20.7,20,9,9,2,31,33,-2,28.5,30.7,-2.2,22,GER
0fbecd11,22,1614,17.9,19,6,3,0,30,21,9,30.5,20.1,10.5,22,GER
1025db8e,29,2576,28.6,29,27,0,0,34,44,-10,29.2,46.5,-17.4,22,GER
10549b49,9,359,4.0,4,0,5,0,7,5,2,8.7,4.7,4.0,22,GER
106bca06,31,2397,26.6,27,17,4,1,21,44,-23,21.7,51.3,-29.6,22,GER
10745192,4,134,1.5,1,0,3,1,5,3,2,5.0,1.7,3.4,22,GER
116c35df,27,1684,18.7,20,3,7,0,44,25,19,30.8,25.2,5.6,22,GER
11d8aff0,1,90,1.0,1,1,0,33,1,3,-2,1.5,1.4,0.1,22,GER
1238a3f9,25,1004,11.2,10,2,15,4,11,25,-14,11.6,16.9,-5.3,22,GER
12c35abe,26,1040,11.6,9,4,17,3,14,17,-3,12.8,13.4,-0.5,22,GER
13203c45,26,1775,19.7,18,8,8,3,25,24,1,27.8,26.0,1.8,22,GER
13d23b29,2,17,0.2,0,0,2,9,0,1,-1,0.1,0.6,-0.5,22,GER
13ddc856,27,1608,17.9,20,3,7,1,21,24,-3,20.1,29.9,-9.8,22,GER
13fe7b69,33,1959,21.8,22,11,11,0,21,50,-29,18.9,38.3,-19.4,22,GER
15413fa5,31,2312,25.7,26,23,5,2,36,36,0,35.7,38.1,-2.3,22,GER
15b287da,32,2139,23.8,23,9,9,1,35,29,6,30.5,30.4,0.2,22,GER
15f24fe7,15,1221,13.6,13,12,2,1,16,21,-5,21.0,17.2,3.7,22,GER
169fd162,2,49,0.5,0,0,2,0,0,0,0,1.0,0.2,0.7,22,GER
16daec92,4,110,1.2,1,0,3,9,4,2,2,4.0,2.0,2.0,22,GER
17376543,34,3060,34.0,34,34,0,0,39,56,-17,36.7,57.9,-21.2,22,GER
17780d2b,5,323,3.6,4,2,1,2,5,6,-1,4.0,5.7,-1.8,22,GER
17f3620a,9,347,3.9,4,0,5,3,4,6,-2,4.1,3.6,0.6,22,GER
18c2e247,1,5,0.1,0,0,1,0,0,0,0,0.0,0.1,-0.1,22,GER
1940be91,1,10,0.1,0,0,1,16,0,0,0,0.8,0.1,0.7,22,GER
19a967ab,17,873,9.700000000000001,8,3,9,12,13,11,2,11.799999999999999,12.0,-0.2,22,GER
1a4b9094,5,64,0.7,0,0,5,11,4,0,4,3.6,0.8,2.8,22,GER
1a83027b,4,55,0.6,0,0,4,9,1,1,0,1.9,0.5,1.4,22,GER
1ae836b1,32,2542,28.2,30,13,2,0,31,41,-10,29.9,44.2,-14.3,22,GER
1b6d8083,10,228,2.5,2,0,8,11,3,1,2,2.9,3.1,-0.2,22,GER
1cbe4984,7,362,4.0,5,1,2,1,3,7,-4,5.0,5.6,-0.7,22,GER
1d8e9add,30,2569,28.5,29,27,1,2,48,52,-4,47.4,45.7,1.7,22,GER
1df0c0b9,28,2272,25.2,27,20,1,2,28,40,-12,27.7,41.6,-13.9,22,GER
1e274a0a,13,338,3.8,2,0,11,1,6,6,0,6.1,4.9,1.3,22,GER
1f2d714c,23,964,10.7,9,3,14,6,7,16,-9,10.4,15.8,-5.4,22,GER
1f3afdcb,27,1793,19.9,20,16,7,2,43,24,19,33.3,27.8,5.5,22,GER
1f44ac21,24,1911,21.2,21,14,3,0,58,38,20,42.2,28.8,13.4,22,GER
20030c06,30,2642,29.4,30,26,0,0,63,29,34,53.9,31.9,22.0,22,GER
204dded0,29,2348,26.1,26,23,3,3,27,45,-18,33.5,42.7,-9.2,22,GER
2077ae86,14,1180,13.1,14,7,0,0,23,20,3,21.5,18.6,3.0,22,GER
22919e97,13,331,3.7,2,0,11,3,8,6,2,7.7,4.3,3.4,22,GER
229cd98a,13,328,3.6,2,0,11,1,6,6,0,5.1,7.2,-2.1,22,GER
236f02cd,30,1909,21.2,20,16,10,3,31,41,-10,34.0,38.6,-4.6,22,GER
24b8e7bd,2,16,0.2,0,0,2,1,0,1,-1,0.3,0.2,0.1,22,GER
25ab9c9c,20,1225,13.6,14,6,6,9,15,19,-4,15.9,18.5,-2.6,22,GER
25bdea4b,14,1260,14.0,14,14,0,17,11,28,-17,11.9,21.5,-9.6,22,GER
25f50295,1,14,0.2,0,0,1,0,0,0,0,0.0,0.3,-0.3,22,GER
271b8617,28,802,9.0,8,0,20,1,14,15,-1,10.9,12.9,-2.1,22,GER
27270af4,11,487,5.4,6,2,5,8,3,6,-3,4.9,7.3,-2.4,22,GER
277c49ed,29,2491,27.7,29,23,0,0,32,47,-15,37.8,37.9,-0.2,22,GER
2903a856,26,2078,23.1,24,18,2,0,37,48,-11,41.6,35.0,6.6,22,GER
2979c05a,29,1840,20.4,23,4,6,0,25,36,-11,24.2,34.9,-10.7,22,GER
29ddfb9c,3,113,1.3,1,0,2,16,0,4,-4,1.1,2.5,-1.3,22,GER
29f7cfd9,10,596,6.6,6,4,4,0,9,12,-3,5.8,12.6,-6.9,22,GER
2a29eb9b,29,2327,25.9,27,13,2,1,45,34,11,38.8,33.5,5.3,22,GER
2a6cd437,17,827,9.2,9,5,8,14,19,12,7,14.1,10.3,3.8,22,GER
2b09d998,24,1351,15.0,12,8,12,6,27,14,13,28.5,18.6,10.0,22,GER
2b114be3,32,1976,22.0,22,8,10,0,68,21,47,63.0,19.3,43.6,22,GER
2b7c56b4,15,603,6.7,7,1,8,9,10,12,-2,8.1,11.6,-3.5,22,GER
2b83fa49,11,478,5.3,3,1,8,9,8,8,0,8.7,8.4,0.3,22,GER
2c0558b8,30,1465,16.3,12,5,18,2,44,17,27,42.1,18.8,23.3,22,GER
2e7ff968,5,405,4.5,4,4,1,28,10,12,-2,8.7,7.0,1.7,22,GER
2f3e911a,28,2292,25.5,25,20,3,3,44,35,9,41.5,33.2,8.3,22,GER
2f7fec15,4,31,0.3,0,0,4,1,0,0,0,0.2,0.5,-0.4,22,GER
302527b2,32,2870,31.9,32,30,0,0,55,44,11,48.0,41.5,6.5,22,GER
30261ba1,8,404,4.5,4,2,4,4,2,8,-6,3.1,7.8,-4.7,22,GER
30941e96,29,2298,25.5,26,21,3,2,48,31,17,45.5,30.8,14.6,22,GER
30ae134d,24,499,5.5,2,0,22,5,13,8,5,10.3,7.4,2.9,22,GER
313254a3,7,169,1.9,1,1,6,13,4,4,0,2.7,3.4,-0.7,22,GER
32c016f8,8,70,0.8,0,0,8,4,0,3,-3,0.3,1.2,-0.9,22,GER
34a0f5ff,2,138,1.5,1,0,1,1,1,4,-3,1.3,2.9,-1.6,22,GER
34b0387f,27,1436,16.0,19,1,8,2,25,20,5,26.3,20.7,5.7,22,GER
34b54da7,3,225,2.5,3,1,0,17,3,2,1,3.1,4.7,-1.6,22,GER
34e12499,32,2785,30.9,32,28,0,0,55,37,18,46.4,39.5,6.9,22,GER
34e4343c,32,2606,29.0,31,18,1,0,46,41,5,44.8,43.3,1.6,22,GER
35d64857,26,2183,24.3,26,19,0,4,36,37,-1,30.5,34.5,-3.9,22,GER
35f67a30,2,9,0.1,0,0,2,5,0,0,0,0.2,0.1,0.2,22,GER
36a3ff67,29,2503,27.8,29,18,0,0,73,45,28,55.5,39.8,15.7,22,GER
36a59ba4,29,2121,23.6,24,13,5,5,40,45,-5,40.4,38.8,1.6,22,GER
36cf2caf,1,6,0.1,0,0,1,0,0,0,0,0.0,0.5,-0.5,22,GER
3724baa1,9,353,3.9,2,2,7,1,4,16,-12,4.4,11.7,-7.3,22,GER
3745e8bd,33,2341,26.0,27,13,6,0,26,34,-8,28.7,38.1,-9.4,22,GER
378825c7,23,2020,22.4,22,21,1,0,37,48,-11,34.4,37.0,-2.6,22,GER
37998008,1,90,1.0,1,1,0,14,5,2,3,2.0,1.7,0.2,22,GER
37dc1a48,29,1976,22.0,26,5,3,2,28,27,1,30.3,26.8,3.5,22,GER
37f606f0,20,1377,15.3,17,5,3,2,25,21,4,29.2,20.5,8.7,22,GER
384d58d9,16,1395,15.5,15,15,1,0,22,27,-5,25.7,21.6,4.2,22,GER
3b1ed320,26,1693,18.8,18,12,8,5,34,39,-5,31.3,36.6,-5.2,22,GER
3ba95f20,5,31,0.3,0,0,5,14,3,2,1,0.9,0.6,0.3,22,GER
3bb625ac,7,283,3.1,2,0,5,8,3,7,-4,2.6,7.4,-4.9,22,GER
3c569f37,2,41,0.5,0,0,2,9,0,1,-1,0.6,0.3,0.3,22,GER
3c6089ab,32,2558,28.4,32,12,0,0,87,31,56,74.9,29.8,45.1,22,GER
3cd9e95a,13,1170,13.0,13,13,0,13,19,21,-2,21.3,19.1,2.2,22,GER
3eb0f2df,25,1786,19.8,23,9,2,5,20,42,-22,19.6,35.5,-15.9,22,GER
3eeb80e0,12,418,4.6,2,0,10,2,5,6,-1,5.0,9.1,-4.1,22,GER
3effaa34,33,2076,23.1,24,9,9,1,50,28,22,41.4,29.8,11.5,22,GER
40b58bfc,26,1117,12.4,15,1,11,4,12,21,-9,10.2,23.0,-12.8,22,GER
41bff4fa,12,755,8.4,9,5,3,7,7,20,-13,7.2,14.2,-7.0,22,GER
41df88b8,1,9,0.1,0,0,1,4,0,0,0,0.1,0.0,0.1,22,GER
420c18a1,33,2970,33.0,33,33,0,1,53,60,-7,54.8,54.1,0.6,22,GER
437f2b00,29,1888,21.0,23,9,6,0,29,33,-4,34.4,32.5,1.9,22,GER
441197b8,32,2857,31.7,32,31,0,1,43,46,-3,39.0,42.6,-3.6,22,GER
442b56fa,34,2446,27.2,28,18,6,0,40,40,0,40.0,36.8,3.1,22,GER
44a20f0c,26,1690,18.8,18,16,8,4,12,54,-42,15.3,36.2,-20.9,22,GER
45a03961,25,2076,23.1,24,18,1,3,57,25,32,56.1,25.2,30.9,22,GER
47064058,33,2970,33.0,33,33,0,0,52,57,-5,54.3,53.5,0.8,22,GER
48035304,28,2430,27.0,28,26,0,0,37,54,-17,43.2,46.8,-3.5,22,GER
49296448,28,2474,27.5,28,24,0,0,80,32,48,71.4,30.9,40.5,22,GER
493924a7,24,1391,15.5,14,9,10,9,11,26,-15,16.8,22.2,-5.4,22,GER
496aeede,18,748,8.3,7,4,11,6,9,17,-8,13.1,18.3,-5.3,22,GER
4aea5077,21,1471,16.3,19,7,2,2,26,30,-4,26.8,26.3,0.5,22,GER
4bd00a50,4,32,0.4,0,0,4,14,0,1,-1,0.8,0.4,0.4,22,GER
4c184730,9,131,1.5,1,0,8,5,4,3,1,2.5,2.9,-0.4,22,GER
4c6facae,31,2415,26.8,28,18,3,0,37,36,1,35.2,36.3,-1.1,22,GER
4d6a842d,12,1080,12.0,12,12,0,4,9,24,-15,9.8,19.2,-9.4,22,GER
4e204552,25,812,9.0,9,1,16,2,14,19,-5,13.0,16.5,-3.6,22,GER
50871bcc,23,1337,14.9,14,6,9,0,32,17,15,24.2,18.0,6.3,22,GER
526ea7cc,27,2379,26.4,27,24,0,5,21,41,-20,20.6,49.8,-29.1,22,GER
52afb588,21,831,9.2,7,0,14,3,20,8,12,14.1,8.9,5.2,22,GER
53070b63,24,1218,13.5,14,3,10,8,30,19,11,24.4,17.7,6.8,22,GER
5360a956,3,36,0.4,0,0,3,0,0,0,0,0.9,0.2,0.7,22,GER
53e07d0b,12,260,2.9,2,0,10,0,4,0,4,4.1,0.9,3.2,22,GER
5458f670,8,136,1.5,1,0,7,15,2,0,2,1.7,1.4,0.3,22,GER
54b4dc4e,29,2049,22.8,23,12,6,0,46,29,17,39.6,30.5,9.2,22,GER
54e4866f,34,2775,30.8,33,15,1,0,53,42,11,46.0,39.9,6.1,22,GER
555d5edd,13,369,4.1,3,1,10,5,6,6,0,7.3,6.0,1.3,22,GER
5569bf9a,13,743,8.3,9,6,4,11,5,10,-5,8.2,10.4,-2.2,22,GER
5584552e,10,885,9.8,9,9,1,3,9,20,-11,9.7,12.9,-3.3,22,GER
56413b1f,26,1578,17.5,16,10,10,0,46,22,24,34.2,21.6,12.6,22,GER
5722eced,1,13,0.1,0,0,1,5,0,0,0,0.7,0.0,0.7,22,GER
5723931e,10,498,5.5,7,2,3,4,10,11,-1,8.0,7.6,0.5,22,GER
5762be5c,24,1898,21.1,23,15,1,4,24,35,-11,26.3,34.0,-7.6,22,GER
57d88cf9,32,2790,31.0,32,27,0,0,76,46,30,58.5,41.4,17.1,22,GER
582a5247,29,1391,15.5,15,2,14,2,18,26,-8,15.1,26.8,-11.7,22,GER
5853ac44,17,582,6.5,6,3,11,14,18,4,14,16.7,5.2,11.5,22,GER
58a2e9f6,11,565,6.3,6,3,5,2,9,18,-9,5.7,11.8,-6.1,22,GER
591477c9,13,1168,13.0,13,12,0,13,15,21,-6,15.7,24.1,-8.4,22,GER
59e4b92e,32,2757,30.6,32,24,0,1,47,36,11,41.4,33.7,7.7,22,GER
5a8d6540,22,1134,12.6,15,3,7,3,12,26,-14,14.2,19.3,-5.1,22,GER
5ad50391,29,2409,26.8,28,23,1,3,59,28,31,52.9,30.2,22.7,22,GER
5ad8c360,18,850,9.4,7,6,11,9,7,19,-12,7.5,19.8,-12.3,22,GER
5c4bf6ba,32,2880,32.0,32,32,0,2,46,42,4,48.4,41.1,7.3,22,GER
5c50fdbc,2,16,0.2,0,0,2,5,0,0,0,0.0,0.2,-0.2,22,GER
5c899683,10,472,5.2,5,2,5,17,12,9,3,10.6,8.4,2.2,22,GER
5d4f7d61,27,2076,23.1,26,5,1,0,60,35,25,42.1,31.1,11.0,22,GER
5d8e331f,30,2600,28.9,30,26,0,1,55,44,11,45.2,39.8,5.5,22,GER
5dc15574,28,1533,17.0,18,3,10,4,18,23,-5,21.9,26.6,-4.7,22,GER
5ddb8f9f,11,725,8.1,7,4,4,6,14,16,-2,9.0,14.1,-5.1,22,GER
5dfc6ad5,29,1941,21.6,22,12,7,4,50,32,18,37.8,29.0,8.7,22,GER
5e22e2a4,1,21,0.2,0,0,1,0,0,0,0,0.4,0.1,0.4,22,GER
5e66fa06,29,2595,28.8,29,27,0,0,35,48,-13,38.2,44.8,-6.6,22,GER
60097ff6,3,32,0.4,0,0,3,5,2,2,0,2.0,1.2,0.8,22,GER
603cb947,32,2707,30.1,30,25,2,0,47,56,-9,48.6,50.7,-2.1,22,GER
610aa1e9,31,2282,25.3,25,21,6,3,39,34,5,34.3,35.9,-1.6,22,GER
611b1aae,1,22,0.2,0,0,1,3,0,2,-2,0.2,1.4,-1.2,22,GER
6190474d,32,1782,19.8,23,0,9,0,28,29,-1,28.8,27.7,1.0,22,GER
626fab5f,23,848,9.4,9,5,14,10,8,12,-4,8.5,18.5,-9.9,22,GER
62ab9184,27,1574,17.5,17,8,10,6,26,28,-2,26.8,24.0,2.8,22,GER
62ba5881,1,90,1.0,1,1,0,29,2,0,2,0.8,1.6,-0.8,22,GER
635f2732,33,1800,20.0,19,7,14,0,31,34,-3,28.1,28.6,-0.5,22,GER
63b9cc6d,33,2531,28.1,30,13,3,1,23,37,-14,21.6,48.5,-26.9,22,GER
652d4c37,15,703,7.8,8,2,7,4,25,9,16,24.5,8.2,16.3,22,GER
66385c46,18,572,6.4,5,0,13,8,6,11,-5,10.2,7.9,2.3,22,GER
677da306,13,787,8.7,8,7,5,3,5,25,-20,7.9,21.0,-13.2,22,GER
683dec01,5,139,1.5,1,0,4,3,1,4,-3,2.4,4.2,-1.8,22,GER
68829001,12,436,4.8,4,1,8,3,3,9,-6,2.9,9.1,-6.2,22,GER
69374ff5,6,88,1.0,1,0,5,5,4,0,4,2.8,0.9,1.8,22,GER
699fb8db,8,496,5.5,7,0,1,15,4,7,-3,6.300000000000001,4.6,1.9,22,GER
6b21b7b5,13,162,1.8,1,0,12,17,2,6,-4,2.6,3.2,-0.5,22,GER
6b8887c2,9,112,1.2,0,0,9,7,6,2,4,3.7,3.0,0.8,22,GER
6bba916f,8,225,2.5,1,0,7,5,5,8,-3,2.7,5.4,-2.7,22,GER
6bd5cd5d,33,2970,33.0,33,33,0,0,50,43,7,46.1,37.7,8.4,22,GER
6c731625,9,153,1.7,0,0,9,3,2,7,-5,2.4,6.0,-3.6,22,GER
6cafd68d,11,304,3.4,1,1,10,8,4,7,-3,4.2,5.0,-0.8,22,GER
6cc47ae1,11,444,4.9,4,0,7,1,9,7,2,8.0,5.7,2.3,22,GER
6ce43701,16,223,2.5,1,0,15,7,7,5,2,6.2,4.5,1.7,22,GER
6d7598d5,4,77,0.9,0,0,4,5,0,2,-2,0.6,0.9,-0.3,22,GER
6ea23758,17,1046,11.6,12,9,5,9,12,18,-6,8.2,21.4,-13.2,22,GER
6ebbc28a,3,17,0.2,0,0,3,4,0,1,-1,0.2,0.9,-0.6,22,GER
6ec6fde0,26,1527,17.0,19,5,7,4,33,30,3,28.4,26.6,1.8,22,GER
6ecbddf6,29,1984,22.0,26,3,3,0,22,36,-14,22.2,34.3,-12.1,22,GER
6f8cd6d0,21,979,10.9,9,3,12,1,15,28,-13,17.5,24.5,-6.9,22,GER
6fb91ea9,6,80,0.9,0,0,6,6,3,0,3,3.2,0.7,2.6,22,GER
70678132,26,1416,15.7,15,4,11,1,19,25,-6,22.5,23.9,-1.3,22,GER
706a60e1,14,776,8.6,9,1,5,9,9,19,-10,6.1,17.3,-11.2,22,GER
70dcf94d,26,818,9.1,7,1,19,8,12,12,0,12.3,10.4,1.8,22,GER
710fbdd1,34,2777,30.9,33,18,1,0,26,74,-48,27.9,53.4,-25.5,22,GER
71ec39ef,30,1962,21.8,22,18,8,1,23,58,-35,20.5,40.6,-20.1,22,GER
7242b495,28,2083,23.1,25,14,3,3,32,26,6,29.6,25.2,4.4,22,GER
73000a79,12,351,3.9,3,0,9,18,9,2,7,8.0,4.3,3.7,22,GER
73d6a176,21,718,8.0,6,0,15,6,14,13,1,8.8,12.2,-3.3,22,GER
73e2f6eb,1,3,0.0,0,0,1,13,0,0,0,0.0,0.0,0.0,22,GER
74f2e748,25,2052,22.8,25,15,0,1,58,35,23,37.4,30.5,6.9,22,GER
75402e99,2,9,0.1,0,0,2,2,0,0,0,0.1,0.1,0.0,22,GER
763b8b37,12,178,2.0,1,0,11,7,5,2,3,1.2,2.8,-1.6,22,GER
76b2817e,16,681,7.6,6,2,10,17,12,11,1,10.9,16.5,-5.6,22,GER
76fa965f,20,967,10.7,11,2,9,6,18,22,-4,14.8,19.3,-4.5,22,GER
792ffa71,13,149,1.7,0,0,13,10,4,5,-1,3.7,3.8,-0.1,22,GER
79c90e45,19,1195,13.3,14,5,5,0,16,20,-4,23.5,21.9,1.6,22,GER
79ca3e23,31,1611,17.9,20,3,11,1,18,31,-13,24.8,24.2,0.6,22,GER
7aac47fe,1,5,0.1,0,0,1,0,0,0,0,0.2,0.0,0.2,22,GER
7ba1f1ef,4,131,1.5,1,0,3,6,2,3,-1,1.8,2.5,-0.7,22,GER
7c473e12,23,1898,21.1,22,19,1,1,25,40,-15,21.2,30.6,-9.4,22,GER
7c56da38,34,2723,30.3,31,18,3,0,65,34,31,59.0,37.3,21.7,22,GER
7cd6badb,26,1629,18.1,20,7,6,1,29,23,6,29.7,28.1,1.6,22,GER
7d3e7da6,6,540,6.0,6,6,0,18,10,11,-1,11.0,9.5,1.5,22,GER
7d450ed3,32,2757,30.6,31,26,1,0,52,57,-5,53.0,52.4,0.6,22,GER
7e12a98d,19,1538,17.1,17,17,2,1,20,22,-2,22.1,26.0,-3.9,22,GER
7e629adc,1,3,0.0,0,0,1,2,0,0,0,0.0,0.0,0.0,22,GER
7ed08d5c,13,644,7.2,6,2,7,10,25,9,16,20.2,8.2,11.9,22,GER
7f609bfc,28,2199,24.4,26,20,2,4,42,40,2,41.6,37.2,4.4,22,GER
7f73bdf4,30,2324,25.8,27,20,3,0,27,44,-17,29.0,45.8,-16.8,22,GER
7fa4e703,10,439,4.9,6,1,4,0,12,8,4,10.6,7.0,3.7,22,GER
7fe12375,27,2430,27.0,27,27,0,3,37,39,-2,37.5,33.6,3.9,22,GER
80c9e555,1,9,0.1,0,0,1,10,0,0,0,0.0,0.0,0.0,22,GER
80f36c88,21,773,8.6,7,3,14,4,21,19,2,15.7,18.5,-2.8,22,GER
815c314f,24,1891,21.0,22,18,2,2,27,40,-13,22.9,30.299999999999997,-7.5,22,GER
816192f0,3,270,3.0,3,3,0,1,2,9,-7,3.8,6.5,-2.7,22,GER
8307b663,4,71,0.8,0,0,4,16,1,1,0,1.6,0.7,0.9,22,GER
834d0be5,27,655,7.3,5,3,22,2,17,9,8,16.8,8.5,8.3,22,GER
8356931a,1,16,0.2,0,0,1,1,0,0,0,0.3,0.2,0.0,22,GER
83e0eeb4,3,270,3.0,3,3,0,30,9,7,2,3.8,7.4,-3.6,22,GER
8494acc4,12,266,3.0,3,1,9,17,4,6,-2,2.3,6.3,-4.0,22,GER
857a5abe,33,2864,31.8,33,27,0,0,46,41,5,48.0,41.5,6.4,22,GER
8593f88c,34,3060,34.0,34,34,0,0,58,46,12,50.4,44.0,6.4,22,GER
861e0116,24,1388,15.4,15,7,9,3,15,27,-12,18.6,25.2,-6.5,22,GER
86314793,8,720,8.0,8,8,0,10,8,30,-22,8.3,19.6,-11.2,22,GER
86574238,27,2183,24.3,26,12,1,1,43,40,3,39.7,37.0,2.7,22,GER
86adbcc7,3,17,0.2,0,0,3,6,0,0,0,0.4,0.0,0.4,22,GER
86e119e0,34,2994,33.3,34,31,0,0,43,53,-10,46.8,46.9,-0.1,22,GER
87436846,21,1890,21.0,21,21,0,10,33,28,5,28.8,31.5,-2.8,22,GER
8778c910,28,2510,27.9,28,27,0,1,87,26,61,77.2,26.7,50.5,22,GER
87ebd8c9,1,3,0.0,0,0,1,1,0,0,0,0.0,0.0,0.0,22,GER
87ebfdb8,1,1,0.0,0,0,1,1,0,0,0,0.0,0.1,-0.1,22,GER
8872ed17,27,2108,23.4,23,18,4,0,18,54,-36,21.6,39.6,-18.1,22,GER
88d4144a,24,1493,16.6,16,8,8,7,19,32,-13,14.7,22.6,-7.9,22,GER
88e357ef,34,2185,24.3,25,10,9,0,69,28,41,63.8,28.2,35.6,22,GER
89ac64a6,26,2261,25.1,25,23,1,0,64,44,20,47.9,38.0,10.0,22,GER
8a6ab963,1,90,1.0,1,1,0,23,2,1,1,2.2,1.1,1.1,22,GER
8b6e0db2,30,2693,29.9,30,29,0,0,35,45,-10,31.0,48.2,-17.2,22,GER
8d78e732,34,2946,32.7,34,28,0,0,92,36,56,84.8,35.3,49.4,22,GER
8df328f4,8,210,2.3,1,0,7,10,3,12,-9,1.7,6.2,-4.6,22,GER
8e235926,25,1392,15.5,15,6,10,6,18,29,-11,17.0,29.3,-12.3,22,GER
8eb55dbb,28,1758,19.5,22,4,6,3,30,24,6,27.1,22.3,4.8,22,GER
8f056768,14,1040,11.6,13,4,1,0,19,16,3,16.9,15.5,1.4,22,GER
8fe2a392,5,189,2.1,2,0,3,11,3,3,0,2.8,2.7,0.1,22,GER
8ff2354e,8,507,5.6,5,3,3,3,13,6,7,10.0,5.2,4.8,22,GER
901c0f97,26,2123,23.6,23,22,3,2,17,41,-24,19.0,46.1,-27.2,22,GER
90339309,8,604,6.7,7,6,1,2,7,4,3,9.4,5.8,3.6,22,GER
9050ddc4,24,1598,17.8,20,3,4,7,15,39,-24,13.2,29.5,-16.2,22,GER
90c1f9a4,2,94,1.0,1,0,1,1,6,2,4,3.0,2.3,0.7,22,GER
92432bc6,20,1326,14.7,15,9,5,0,38,13,25,31.8,14.8,17.1,22,GER
924f9191,29,2422,26.9,28,21,1,0,42,31,11,37.2,27.2,10.1,22,GER
92948149,5,194,2.2,2,1,3,5,0,3,-3,1.1,3.5,-2.4,22,GER
934e1968,31,1543,17.1,15,5,16,3,33,24,9,31.6,22.8,8.8,22,GER
93a50d2c,3,5,0.1,0,0,3,9,0,0,0,0.3,0.1,0.3,22,GER
93c9e7d9,6,123,1.4,0,0,6,3,1,2,-1,0.6,3.1,-2.5,22,GER
94302c52,20,1740,19.3,20,17,0,8,30,26,4,26.8,29.2,-2.4,22,GER
943b9602,1,45,0.5,1,0,0,1,0,1,-1,0.3,1.5,-1.2,22,GER
94c18565,32,2320,25.8,31,2,1,0,33,36,-3,35.2,38.4,-3.1,22,GER
9593331d,8,643,7.1,7,6,1,9,7,22,-15,8.1,16.5,-8.4,22,GER
962e54cb,18,516,5.7,4,2,14,8,4,10,-6,7.7,7.4,0.2,22,GER
9662c9ec,13,599,6.7,6,3,7,16,9,11,-2,8.7,11.0,-2.3,22,GER
96d0b6f0,4,118,1.3,1,0,3,3,1,5,-4,1.2,3.1,-2.0,22,GER
99be8fb5,3,35,0.4,0,0,3,10,0,0,0,0.7,0.1,0.6,22,GER
99de6b6f,5,375,4.2,5,2,0,9,7,4,3,8.3,6.1,2.2,22,GER
99f7e9aa,16,899,10.0,9,6,7,11,9,13,-4,14.5,14.6,-0.1,22,GER
9a2e0ccc,31,1706,19.0,20,5,11,0,33,16,17,35.2,21.0,14.3,22,GER
9ab16552,18,1187,13.2,12,10,6,13,14,20,-6,17.3,18.3,-1.0,22,GER
9af1f9ff,17,1384,15.4,15,13,2,6,25,19,6,25.1,19.8,5.3,22,GER
9cf4fd68,1,27,0.3,0,0,1,0,0,1,-1,0.6,0.3,0.3,22,GER
9d12e142,1,90,1.0,1,1,0,2,2,1,1,1.3,1.0,0.4,22,GER
9f941969,31,2790,31.0,31,31,0,0,29,45,-16,36.9,48.4,-11.5,22,GER
9f979eb2,8,490,5.4,5,3,3,9,7,11,-4,8.8,11.2,-2.4,22,GER
a1257b5e,4,328,3.6,3,3,1,22,6,7,-1,5.5,6.0,-0.6,22,GER
a167537f,31,2078,23.1,22,8,9,0,63,33,30,47.4,29.9,17.5,22,GER
a2a85828,5,160,1.8,2,0,3,4,2,5,-3,1.2,3.9,-2.7,22,GER
a2b1ed42,11,477,5.3,4,0,7,5,5,8,-3,4.6,9.6,-5.0,22,GER
a2e7de6f,5,142,1.6,1,1,4,5,1,7,-6,1.7,3.3,-1.5,22,GER
a396fb61,20,1552,17.2,17,17,3,11,21,22,-1,23.6,27.8,-4.2,22,GER
a39d11bc,22,1768,19.6,20,18,2,9,18,35,-17,20.5,30.3,-9.8,22,GER
a3ddb1b9,30,2025,22.5,24,3,6,0,41,32,9,35.7,33.4,2.2,22,GER
a3f30508,1,2,0.0,0,0,1,2,0,0,0,0.0,0.1,0.0,22,GER
a4effc55,15,952,10.6,10,8,5,3,29,17,12,22.3,14.7,7.6,22,GER
a53b661f,28,2091,23.2,25,6,3,0,34,40,-6,38.4,37.5,0.9,22,GER
a5420709,4,104,1.2,1,0,3,13,2,2,0,3.1,0.9,2.2,22,GER
a572e291,28,1853,20.6,22,8,6,2,23,31,-8,26.4,31.3,-5.0,22,GER
a5bea1fb,29,2004,22.3,23,4,6,5,21,47,-26,18.8,41.0,-22.2,22,GER
a5ce09f2,16,354,3.9,3,0,13,13,2,9,-7,5.5,6.8,-1.3,22,GER
a5ec3ede,28,2074,23.0,24,17,4,1,40,23,17,37.7,26.8,10.9,22,GER
a65ce836,24,1690,18.8,19,14,5,0,45,22,23,33.9,23.0,10.9,22,GER
a6c58494,3,61,0.7,0,0,3,9,1,1,0,0.8,0.7,0.1,22,GER
a70b8345,7,630,7.0,7,7,0,26,13,5,8,9.5,4.9,4.6,22,GER
a73c8f95,22,1814,20.2,19,19,3,1,43,26,17,36.6,22.3,14.3,22,GER
a7813ac4,11,390,4.3,4,2,7,21,6,10,-4,5.2,8.0,-2.7,22,GER
a8090a41,1,4,0.0,0,0,1,10,0,0,0,0.0,0.0,0.0,22,GER
a8567629,25,1822,20.2,19,13,6,1,49,29,20,37.8,29.4,8.4,22,GER
a8db7ebb,30,2448,27.200000000000003,28,25,2,2,20,60,-40,23.0,46.1,-23.1,22,GER
a8ee54ad,26,1879,20.9,21,13,5,1,29,32,-3,21.5,27.7,-6.2,22,GER
a9142dc3,6,145,1.6,0,0,6,3,3,3,0,6.9,2.3,4.6,22,GER
a92ab7be,32,2880,32.0,32,32,0,0,55,39,16,47.8,40.6,7.2,22,GER
a93b6f4e,24,2047,22.7,22,22,2,8,34,29,5,31.7,27.1,4.6,22,GER
a9a6fc08,2,180,2.0,2,2,0,31,3,7,-4,2.6,3.4,-0.7,22,GER
aad48be9,26,2031,22.6,22,21,4,1,26,44,-18,21.6,33.8,-12.1,22,GER
ab700320,29,1864,20.7,21,8,8,0,24,35,-11,22.2,34.0,-11.8,22,GER
ac73ec79,28,1842,20.5,21,12,7,4,46,26,20,37.9,27.4,10.5,22,GER
aca0a525,10,434,4.8,3,3,7,3,2,12,-10,2.7,12.5,-9.7,22,GER
ad00b1a8,31,2421,26.9,29,16,2,1,39,41,-2,39.5,37.6,1.9,22,GER
ad1d6fa4,24,1054,11.7,12,2,12,9,4,34,-30,8.3,20.7,-12.3,22,GER
ad2b068c,13,716,8.0,6,5,7,6,7,23,-16,8.0,19.5,-11.5,22,GER
ad3389d5,32,2880,32.0,32,32,0,1,73,44,29,58.5,41.2,17.3,22,GER
ae44e8e2,19,743,8.3,7,1,12,1,22,14,8,14.0,11.0,3.0,22,GER
ae7058f9,4,209,2.3,2,1,2,9,3,3,0,3.2,3.8,-0.5,22,GER
aeed5c06,32,2760,30.7,32,17,0,0,77,41,36,57.0,37.2,19.8,22,GER
af0d79a9,28,2498,27.8,28,26,0,0,36,47,-11,35.5,41.5,-6.0,22,GER
b0a0698b,17,1402,15.6,16,14,1,0,25,24,1,26.3,21.2,5.1,22,GER
b18ef366,26,1367,15.2,14,2,12,0,13,43,-30,11.7,27.9,-16.2,22,GER
b1cd37e6,31,2522,28.0,28,23,3,0,39,42,-3,34.6,40.5,-5.9,22,GER
b3325a30,30,2218,24.6,27,13,3,0,25,49,-24,24.8,37.1,-12.3,22,GER
b3b7f5a6,17,1212,13.5,15,8,2,14,18,21,-3,15.5,18.2,-2.7,22,GER
b492126a,14,1075,11.9,13,6,1,0,15,19,-4,19.4,18.0,1.4,22,GER
b4b08774,5,83,0.9,0,0,5,10,1,2,-1,0.7,1.1,-0.4,22,GER
b4cf5806,26,1257,14.0,13,3,13,1,15,17,-2,19.2,20.8,-1.6,22,GER
b500b384,1,4,0.0,0,0,1,4,0,0,0,0.2,0.1,0.1,22,GER
b50ec54b,28,654,7.3,6,0,22,6,15,14,1,12.2,13.2,-1.0,22,GER
b77f44a4,21,1769,19.7,20,17,1,3,33,26,7,30.700000000000003,26.6,4.1,22,GER
b825a650,27,1899,21.1,25,10,2,4,38,23,15,40.4,24.5,15.9,22,GER
b90c4a43,1,90,1.0,1,1,0,19,1,1,0,2.6,1.0,1.6,22,GER
bbd86530,15,664,7.4,6,4,9,1,8,8,0,9.1,8.9,0.2,22,GER
bc249af8,6,341,3.8,4,0,2,1,4,8,-4,2.7,7.0,-4.3,22,GER
bc6bd723,33,2070,23.0,24,12,9,1,41,45,-4,39.5,36.5,2.9,22,GER
bcb2ccd8,33,2967,33.0,33,32,0,0,71,34,37,63.0,38.6,24.4,22,GER
bd142efb,33,2878,32.0,33,29,0,0,76,45,31,59.2,42.4,16.9,22,GER
bd527260,18,349,3.9,1,0,17,9,13,4,9,7.9,5.8,2.1,22,GER
bd7d2e6d,25,2166,24.1,25,22,0,4,29,33,-4,30.4,28.6,1.8,22,GER
bd992863,10,597,6.6,7,3,3,4,4,8,-4,4.1,8.4,-4.3,22,GER
be42a291,7,307,3.4,2,0,5,11,3,7,-4,4.8,5.7,-1.0,22,GER
be625686,1,4,0.0,0,0,1,0,0,0,0,0.1,0.0,0.1,22,GER
beb882a8,31,2194,24.4,26,10,5,1,41,28,13,36.0,29.9,6.0,22,GER
bee0bab1,16,683,7.6,9,0,7,1,23,6,17,16.9,8.7,8.3,22,GER
bf075f6b,31,1551,17.2,18,1,13,0,26,25,1,25.9,22.6,3.3,22,GER
c05f2f8c,30,2564,28.5,30,26,0,1,32,41,-9,34.4,45.5,-11.2,22,GER
c0d3bd23,24,1632,18.1,20,8,4,4,12,27,-15,15.6,33.1,-17.5,22,GER
c1242d4e,33,2970,33.0,33,33,0,0,25,53,-28,25.5,61.3,-35.7,22,GER
c149016b,33,2899,32.2,33,29,0,0,37,57,-20,40.9,52.0,-11.1,22,GER
c18d22f5,27,2234,24.8,26,20,1,4,27,50,-23,26.4,37.3,-10.9,22,GER
c1b7847c,26,1240,13.8,15,1,11,3,38,20,18,26.0,18.9,7.1,22,GER
c2009df3,30,2553,28.4,30,27,0,0,43,38,5,42.1,39.7,2.5,22,GER
c2211709,22,1820,20.2,20,18,2,0,33,25,8,29.2,29.4,-0.1,22,GER
c283ddef,15,517,5.7,5,0,10,9,4,9,-5,3.9,9.6,-5.7,22,GER
c3ee18ef,25,2030,22.6,25,14,0,1,67,27,40,62.3,24.0,38.3,22,GER
c41f7379,1,90,1.0,1,1,0,16,6,3,3,4.0,1.1,2.9,22,GER
c455a2b2,30,1969,21.9,22,8,8,0,37,27,10,33.0,30.9,2.1,22,GER
c4e87b8b,18,1553,17.3,17,17,1,0,15,29,-14,21.8,24.7,-2.9,22,GER
c562c5b4,31,2735,30.4,31,27,0,2,25,45,-20,23.4,53.2,-29.8,22,GER
c64c01fc,33,1611,17.9,13,3,20,0,39,36,3,35.6,28.8,6.8,22,GER
c68da769,31,2378,26.4,28,13,3,1,41,40,1,34.8,35.6,-0.8,22,GER
c6cf860f,1,22,0.2,0,0,1,7,0,3,-3,0.2,1.4,-1.2,22,GER
c89e8aae,6,540,6.0,6,6,0,28,4,14,-10,7.2,8.6,-1.3,22,GER
c8c60119,10,506,5.6,5,1,5,14,6,8,-2,8.9,10.8,-1.9,22,GER
ca618d23,34,2583,28.7,30,13,4,0,46,38,8,41.8,37.0,4.9,22,GER
ca6f4846,13,385,4.3,2,0,11,5,4,10,-6,4.9,6.5,-1.6,22,GER
ca8033cb,23,1648,18.3,17,12,6,3,43,19,24,35.8,22.5,13.3,22,GER
cadd666a,24,726,8.1,5,2,19,8,8,29,-21,6.6,17.6,-11.0,22,GER
cb11b429,31,2052,22.8,27,7,4,2,20,37,-17,17.6,40.9,-23.3,22,GER
cb64672e,4,39,0.4,0,0,4,5,1,1,0,0.7,0.4,0.3,22,GER
cbac6ec9,30,2700,30.0,30,30,0,1,38,52,-14,41.2,46.6,-5.4,22,GER
cc86b9a3,19,1396,15.5,19,8,0,1,43,17,26,38.1,15.1,23.0,22,GER
ccc6d365,3,52,0.6,0,0,3,19,1,2,-1,0.2,1.4,-1.2,22,GER
cd59b9df,29,2565,28.5,29,28,0,0,73,39,34,54.0,38.3,15.7,22,GER
cd82452e,32,2101,23.3,25,6,7,0,25,37,-12,24.0,35.7,-11.8,22,GER
ce17b5eb,32,2880,32.0,32,32,0,0,44,46,-2,38.5,44.9,-6.4,22,GER
cf623c78,7,474,5.3,7,3,0,7,3,3,0,4.3,5.6,-1.4,22,GER
d01231f0,22,1016,11.3,11,1,11,2,13,18,-5,11.0,18.9,-7.9,22,GER
d01b9ad6,1,5,0.1,0,0,1,8,0,0,0,0.1,0.0,0.1,22,GER
d1273f09,28,2004,22.3,24,8,4,4,26,38,-12,24.7,36.5,-11.8,22,GER
d1661819,18,932,10.4,9,5,9,9,17,18,-1,16.0,13.1,2.8,22,GER
d2416c2e,25,1079,12.0,12,2,13,1,23,7,16,25.4,9.6,15.9,22,GER
d248cd8f,28,2211,24.6,25,23,3,4,63,27,36,56.2,23.9,32.3,22,GER
d25fee56,22,1260,14.0,13,8,9,6,8,18,-10,9.4,23.3,-13.9,22,GER
d28339cb,4,360,4.0,4,4,0,26,3,7,-4,2.5,7.4,-4.8,22,GER
d2c580ce,12,504,5.6,5,2,7,5,7,8,-1,6.7,7.8,-1.1,22,GER
d3096421,10,277,3.1,2,1,8,5,3,7,-4,3.8,7.9,-4.1,22,GER
d3112d86,19,1193,13.3,16,4,3,2,11,18,-7,9.6,21.5,-12.0,22,GER
d4a2533d,1,21,0.2,0,0,1,1,2,0,2,0.7,0.1,0.5,22,GER
d6862409,26,1165,12.9,13,1,13,1,19,27,-8,16.9,24.4,-7.5,22,GER
d686dbc0,19,775,8.6,7,5,12,10,5,20,-15,5.4,20.1,-14.7,22,GER
d781d855,22,1740,19.3,20,14,2,0,59,21,38,49.9,20.3,29.6,22,GER
d9e196bf,2,42,0.5,0,0,2,4,3,0,3,2.9,0.2,2.8,22,GER
da27e268,9,379,4.2,4,0,5,15,15,2,13,11.1,4.0,7.1,22,GER
da76715c,6,311,3.5,2,1,4,20,6,8,-2,4.8,3.8,0.9,22,GER
daa78200,32,882,9.8,5,0,27,1,13,14,-1,14.3,10.7,3.6,22,GER
db401046,28,2520,28.0,28,28,0,0,39,40,-1,40.5,38.7,1.8,22,GER
db4ed67b,22,1658,18.4,20,12,2,1,52,31,21,34.9,24.5,10.4,22,GER
db8c8860,1,12,0.1,0,0,1,1,1,0,1,0.6,0.1,0.5,22,GER
dc38e3bc,13,259,2.9,1,0,12,6,5,4,1,3.7,4.7,-1.0,22,GER
dc62b55d,1,64,0.7,1,0,0,0,1,3,-2,1.3,1.5,-0.2,22,GER
dcfb17f4,25,1256,14.0,13,3,12,0,24,23,1,23.3,18.9,4.4,22,GER
dd669209,20,967,10.7,13,1,7,11,8,18,-10,14.1,14.0,0.1,22,GER
dd676a97,10,97,1.1,0,0,10,10,4,3,1,3.2,1.9,1.3,22,GER
dd7b6eb8,1,6,0.1,0,0,1,6,0,0,0,0.9,0.0,0.9,22,GER
de4cac2d,9,277,3.1,3,0,6,0,3,11,-8,2.3,7.9,-5.6,22,GER
dee3013b,2,180,2.0,2,2,0,28,4,3,1,2.0,2.8,-0.8,22,GER
df8e7b62,11,274,3.0,1,0,10,9,2,6,-4,3.9,4.7,-0.9,22,GER
df9c3473,13,906,10.1,9,9,4,19,9,16,-7,7.9,18.4,-10.5,22,GER
dfb6490a,23,754,8.4,5,2,18,10,14,10,4,15.3,12.4,2.8,22,GER
dfc85b89,13,783,8.7,9,6,4,13,9,22,-13,6.6,16.7,-10.1,22,GER
e0b113a7,26,1817,20.2,21,14,5,1,48,31,17,34.3,24.6,9.7,22,GER
e0d515ef,1,26,0.3,0,0,1,1,0,0,0,0.4,0.7,-0.3,22,GER
e12b0b5b,17,759,8.4,10,0,7,3,16,11,5,14.8,11.9,2.9,22,GER
e162b013,17,1402,15.6,17,12,0,1,39,27,12,27.0,23.7,3.3,22,GER
e21042ae,25,1420,15.8,14,3,11,1,11,21,-10,13.0,29.6,-16.6,22,GER
e26fcca3,28,2375,26.4,27,20,1,6,29,52,-23,25.6,40.3,-14.7,22,GER
e27da244,31,2615,29.1,29,24,2,3,38,44,-6,41.0,40.6,0.4,22,GER
e27de4fa,1,16,0.2,0,0,1,0,0,1,-1,0.0,0.5,-0.5,22,GER
e280527c,27,954,10.6,8,1,19,0,25,11,14,24.9,9.7,15.1,22,GER
e33c06cf,28,1837,20.4,19,15,9,0,64,22,42,58.6,25.1,33.5,22,GER
e38f1636,24,2133,23.7,24,23,0,0,19,50,-31,20.5,37.3,-16.8,22,GER
e5478b87,31,2174,24.2,29,1,2,0,33,31,2,32.7,26.6,6.1,22,GER
e547d3cf,1,5,0.1,0,0,1,0,0,0,0,0.2,0.0,0.2,22,GER
e5649a78,23,419,4.7,1,1,22,10,6,3,3,6.9,4.2,2.6,22,GER
e5a35ae9,14,717,8.0,9,2,5,6,4,15,-11,10.3,10.2,0.1,22,GER
e5f63987,2,13,0.1,0,0,2,12,0,1,-1,0.3,1.5,-1.2,22,GER
e6c15f6e,24,1455,16.2,16,11,8,2,12,36,-24,15.6,27.8,-12.2,22,GER
e6c43eec,15,942,10.5,10,6,5,4,9,17,-8,12.4,14.7,-2.3,22,GER
e79269bd,24,1396,15.5,17,5,7,8,28,22,6,24.6,20.2,4.4,22,GER
e7b899b8,27,2054,22.8,22,17,5,3,21,56,-35,20.6,43.1,-22.5,22,GER
e7d22eae,17,471,5.2,5,0,12,4,3,7,-4,5.8,10.1,-4.3,22,GER
e7fcf289,24,1851,20.6,22,8,2,0,55,34,21,37.7,28.5,9.1,22,GER
e82adcab,23,1097,12.2,12,3,11,3,25,15,10,20.7,15.4,5.2,22,GER
ea003d07,2,12,0.1,0,0,2,1,1,0,1,0.1,0.5,-0.4,22,GER
eac044ad,27,1310,14.6,17,2,10,5,32,25,7,23.7,19.2,4.5,22,GER
eb61713c,13,346,3.8,2,0,11,4,4,2,2,6.0,5.7,0.3,22,GER
ebac0ace,23,877,9.7,7,2,16,6,9,12,-3,6.1,15.4,-9.4,22,GER
ed79b7d3,31,871,9.7,9,0,22,2,23,13,10,15.4,12.9,2.4,22,GER
eec1f7f4,3,18,0.2,0,0,3,4,1,0,1,0.7,0.0,0.7,22,GER
ef233486,12,635,7.1,7,3,5,3,5,14,-9,8.1,10.5,-2.3,22,GER
f0a37d36,27,2183,24.3,26,19,1,0,20,30,-10,19.2,40.7,-21.5,22,GER
f168d9b9,1,1,0.0,0,0,1,1,0,0,0,0.1,0.0,0.1,22,GER
f24ea523,30,1755,19.5,23,0,7,3,29,24,5,23.0,23.2,-0.1,22,GER
f26834c7,31,2361,26.2,28,10,3,0,39,35,4,41.2,33.9,7.3,22,GER
f26dee6b,1,90,1.0,1,1,0,14,0,2,-2,0.5,1.1,-0.6,22,GER
f27680d9,23,1722,19.1,20,13,3,4,25,25,0,24.4,28.6,-4.1,22,GER
f2dd9a21,17,970,10.8,9,2,8,6,16,17,-1,11.5,17.3,-5.8,22,GER
f36c432f,18,1017,11.3,13,5,5,3,11,26,-15,12.4,19.1,-6.7,22,GER
f4c69aa6,2,32,0.4,0,0,2,9,0,0,0,0.1,2.2,-2.1,22,GER
f4c7c708,4,50,0.6,0,0,4,19,1,0,1,3.0,0.7,2.3,22,GER
f4ec4fd0,18,696,7.7,8,0,10,6,10,13,-3,9.4,7.9,1.6,22,GER
f521b80a,28,2355,26.2,27,24,1,3,39,49,-10,43.9,39.9,3.9,22,GER
f68b64fc,33,2920,32.4,33,28,0,0,46,43,3,47.3,41.8,5.5,22,GER
f6bdc830,12,315,3.5,3,2,9,18,6,6,0,4.9,4.3,0.7,22,GER
f76022e7,6,53,0.6,0,0,6,5,1,1,0,0.9,0.6,0.4,22,GER
f7aa75bd,21,1637,18.2,19,16,2,4,20,30,-10,19.9,25.7,-5.8,22,GER
f86cabbd,7,483,5.4,6,4,1,5,8,9,-1,5.0,7.2,-2.2,22,GER
f86cd5df,24,1141,12.7,12,5,12,6,15,21,-6,19.0,20.1,-1.1,22,GER
f93e6e94,22,580,6.4,3,0,19,5,17,10,7,12.2,7.7,4.5,22,GER
f9446dcd,30,2398,26.6,30,8,0,2,47,34,13,40.6,30.4,10.2,22,GER
f956479d,6,105,1.2,0,0,6,2,3,3,0,2.6,1.7,0.9,22,GER
f972644c,30,1704,18.9,19,2,11,2,20,31,-11,17.4,25.5,-8.1,22,GER
f9b1b7bf,12,438,4.9,5,1,7,19,12,5,7,12.1,4.6,7.5,22,GER
f9e7c4ac,10,292,3.2,3,1,7,8,6,3,3,5.4,5.0,0.5,22,GER
f9f92b5f,27,1129,12.5,12,2,15,2,13,19,-6,10.3,23.2,-12.9,22,GER
fa274d97,16,836,9.3,9,6,7,8,26,10,16,20.9,10.7,10.2,22,GER
fa661778,27,1321,14.7,15,2,12,2,35,24,11,30.8,18.9,12.0,22,GER
fbbc8e15,14,241,2.7,1,0,13,3,5,3,2,4.0,5.3,-1.3,22,GER
fc62fdf4,19,877,9.7,11,3,8,3,15,18,-3,14.1,13.2,0.9,22,GER
fcb27134,28,2009,22.3,23,15,5,2,48,20,28,45.1,22.4,22.7,22,GER
fd53759d,29,1192,13.2,10,2,19,0,20,22,-2,17.2,20.7,-3.4,22,GER
fe641c1a,1,18,0.2,0,0,1,1,0,1,-1,0.1,0.7,-0.6,22,GER
fe888e39,13,246,2.7,2,0,11,17,6,6,0,4.1,6.3,-2.2,22,GER
ff182fdc,26,1636,18.2,17,3,9,4,20,38,-18,16.0,33.7,-17.7,22,GER
ff98492b,12,368,4.1,3,1,9,4,5,11,-6,5.2,8.6,-3.3,22,GER
ffbbc83b,18,1496,16.6,16,15,2,0,29,23,6,33.1,25.3,7.8,22,GER
00f0482f,1,16,0.2,0,0,1,1,0,0,0,0.1,0.0,0.1,22,ENG
01226327,4,337,3.7,4,3,0,5,5,7,-2,5.4,6.5,-1.0,22,ENG
01962d0d,20,746,8.3,5,2,15,11,11,25,-14,13.0,20.0,-7.1,22,ENG
02b29014,30,2537,28.2,29,27,1,1,33,47,-14,29.6,39.3,-9.7,22,ENG
0313a347,29,2477,27.5,29,24,0,3,36,41,-5,30.3,35.3,-5.0,22,ENG
0420d84f,30,2656,29.5,30,28,0,4,34,50,-16,30.7,41.7,-11.0,22,ENG
0442183b,16,1351,15.0,15,15,1,17,19,12,7,18.3,13.7,4.6,22,ENG
0562b7f1,28,1564,17.4,18,6,10,7,25,19,6,22.5,19.2,3.3,22,ENG
05e8ca6d,3,27,0.3,0,0,3,9,1,0,1,0.2,0.8,-0.6,22,ENG
0745b37d,37,3253,36.1,37,29,0,0,22,79,-57,29.8,72.1,-42.4,22,ENG
076bb352,1,10,0.1,0,0,1,10,0,1,-1,0.0,0.4,-0.4,22,ENG
07802f7f,30,1898,21.1,22,7,8,3,29,26,3,26.3,24.3,2.0,22,ENG
099e666f,15,1018,11.3,11,9,4,22,10,24,-14,12.1,21.5,-9.4,22,ENG
0b33f6ad,34,2972,33.0,33,32,1,2,42,57,-15,41.2,49.8,-8.6,22,ENG
0d4ceb32,22,679,7.5,5,1,17,0,7,7,0,8.8,10.2,-1.5,22,ENG
0db5d2c8,8,518,5.8,6,5,2,6,8,10,-2,7.3,7.5,-0.2,22,ENG
0ef89a37,19,1329,14.8,16,5,3,0,21,17,4,19.6,18.3,1.3,22,ENG
0f134faf,31,1601,17.8,19,8,12,4,15,30,-15,21.5,24.7,-3.2,22,ENG
0f933743,5,427,4.7,5,4,0,11,1,9,-8,3.0,10.2,-7.2,22,ENG
1000a059,1,4,0.0,0,0,1,8,0,0,0,0.0,0.0,0.0,22,ENG
101da2b5,19,964,10.7,10,7,9,19,34,12,22,25.8,10.4,15.4,22,ENG
111c3236,11,662,7.4,8,2,3,5,6,6,0,6.1,8.9,-2.9,22,ENG
112c495e,18,1169,13.0,14,10,4,19,5,27,-22,11.8,23.8,-12.0,22,ENG
1137759d,31,2083,23.1,25,9,6,2,25,35,-10,25.2,29.0,-3.8,22,ENG
119b9a8e,33,2828,31.4,33,27,0,2,87,23,64,74.7,19.8,54.9,22,ENG
11ff3d56,23,1023,11.4,10,7,13,12,13,21,-8,13.3,17.4,-4.1,22,ENG
1265a93a,26,1864,20.7,22,17,4,1,41,21,20,38.4,16.3,22.1,22,ENG
132a82f1,7,630,7.0,7,7,0,2,13,7,6,9.4,8.8,0.6,22,ENG
1544f145,34,2467,27.4,29,14,5,1,39,35,4,32.9,32.2,0.7,22,ENG
1598599e,14,1032,11.5,12,7,2,3,19,15,4,11.4,15.6,-4.2,22,ENG
15ea812b,35,3106,34.5,35,34,0,0,30,51,-21,37.0,52.7,-15.7,22,ENG
15f3ec41,15,962,10.7,11,3,4,7,24,8,16,18.8,8.2,10.6,22,ENG
16264a81,8,660,7.3,8,4,0,11,13,6,7,10.1,7.2,2.9,22,ENG
169fd162,30,1816,20.2,20,4,10,1,19,22,-3,17.4,33.4,-16.0,22,ENG
172e52d8,37,3321,36.9,37,36,0,0,46,56,-10,44.1,48.0,-4.0,22,ENG
17695062,33,1921,21.3,21,10,12,2,28,28,0,30.5,29.0,1.5,22,ENG
1770bd68,18,852,9.5,7,4,11,13,6,16,-10,8.3,16.1,-7.8,22,ENG
17734ea0,1,7,0.1,0,0,1,2,1,0,1,1.0,0.0,1.0,22,ENG
178ae8f8,35,2364,26.3,27,10,8,1,58,19,39,57.3,23.5,33.8,22,ENG
17d45fb2,7,334,3.7,4,0,3,9,4,9,-5,4.3,8.8,-4.5,22,ENG
18b896d6,34,3035,33.7,34,33,0,1,68,27,41,57.1,28.1,29.0,22,ENG
1900032e,10,567,6.3,6,5,4,15,12,16,-4,11.0,13.2,-2.2,22,ENG
1961b2aa,14,619,6.9,7,2,7,7,10,19,-9,7.6,12.7,-5.1,22,ENG
197640fd,27,2127,23.6,22,20,5,2,42,30,12,31.8,34.3,-2.6,22,ENG
19a12bed,19,1623,18.0,18,15,1,0,10,37,-27,16.9,28.5,-11.6,22,ENG
19a9cb70,1,9,0.1,0,0,1,3,0,0,0,0.5,0.3,0.2,22,ENG
19e50035,4,360,4.0,4,4,0,1,5,12,-7,3.9,10.1,-6.2,22,ENG
19f4d211,1,5,0.1,0,0,1,8,0,0,0,0.0,0.2,-0.1,22,ENG
1a4ef233,28,2123,23.6,23,22,5,6,35,40,-5,26.0,36.3,-10.3,22,ENG
1b4f1169,19,1134,12.6,12,9,7,18,11,12,-1,17.5,14.2,3.3,22,ENG
1b84dbe1,29,2439,27.1,29,26,0,1,37,42,-5,34.1,37.3,-3.3,22,ENG
1bf33a9a,22,1290,14.3,13,9,9,5,27,10,17,23.4,10.8,12.5,22,ENG
1bf811d4,15,1027,11.4,11,10,4,6,7,27,-20,10.1,24.7,-14.6,22,ENG
1c0eea98,12,1080,12.0,12,12,0,25,10,28,-18,11.4,22.6,-11.2,22,ENG
1c7012b8,36,3179,35.3,35,35,1,0,56,49,7,46.3,48.8,-2.6,22,ENG
1cb49278,19,1496,16.6,17,15,2,9,38,11,27,25.9,14.8,11.1,22,ENG
1d5cab82,18,996,11.1,12,5,6,6,18,13,5,14.6,12.9,1.7,22,ENG
1daec722,35,3089,34.3,35,32,0,0,37,39,-2,42.5,38.7,3.8,22,ENG
1ecb65be,9,379,4.2,5,0,4,14,7,8,-1,4.2,6.7,-2.5,22,ENG
1ef37668,12,730,8.1,8,7,4,13,7,5,2,7.7,10.2,-2.5,22,ENG
1fb1c435,31,2265,25.2,27,16,4,2,25,37,-12,28.1,41.2,-13.1,22,ENG
21166ff4,28,2497,27.7,28,27,0,8,41,44,-3,31.8,42.5,-10.7,22,ENG
21512407,6,429,4.8,5,3,1,1,8,5,3,6.3,5.7,0.6,22,ENG
21945a9e,1,4,0.0,0,0,1,23,0,0,0,0.0,0.4,-0.4,22,ENG
21a66f6a,37,3232,35.9,36,35,1,0,66,40,26,58.2,36.2,22.0,22,ENG
235a62f8,2,146,1.6,2,0,0,11,0,3,-3,0.8,1.7,-0.9,22,ENG
2389cdc2,38,3377,37.5,38,35,0,0,52,50,2,43.6,46.6,-3.0,22,ENG
240c8ab6,1,1,0.0,0,0,1,1,0,0,0,0.0,0.1,-0.1,22,ENG
24f59bb2,24,1711,19.0,19,11,5,1,18,49,-31,20.8,37.2,-16.4,22,ENG
24fae784,21,1692,18.8,19,17,2,4,15,23,-8,17.7,28.4,-10.7,22,ENG
2500cef9,30,1284,14.3,12,5,18,3,20,22,-2,17.0,16.6,0.5,22,ENG
254147d4,12,457,5.1,5,2,7,10,4,10,-6,7.2,8.7,-1.5,22,ENG
2628fd2b,4,360,4.0,4,4,0,29,1,9,-8,3.1,9.2,-6.1,22,ENG
2691c772,23,808,9.0,8,2,15,7,6,19,-13,9.9,14.7,-4.8,22,ENG
26d3b5be,1,61,0.7,1,0,0,6,0,0,0,0.1,2.5,-2.4,22,ENG
26f6dca8,30,1786,19.8,19,7,11,6,32,29,3,28.5,29.9,-1.5,22,ENG
27c01749,4,156,1.7,1,0,3,5,2,1,1,2.8,1.9,0.9,22,ENG
282679b4,33,2073,23.0,26,7,7,4,24,52,-28,28.1,42.4,-14.3,22,ENG
282f75f3,29,2573,28.6,29,28,0,1,32,32,0,35.3,32.9,2.4,22,ENG
28300a16,1,90,1.0,1,1,0,32,0,2,-2,0.4,0.7,-0.3,22,ENG
2886c9b5,22,910,10.1,9,3,13,10,15,15,0,10.7,11.0,-0.3,22,ENG
28d596a0,4,360,4.0,4,4,0,34,6,2,4,4.4,2.7,1.7,22,ENG
291e3ec3,17,625,6.9,6,3,11,6,7,11,-4,7.2,12.2,-5.0,22,ENG
2928dca2,38,3361,37.3,38,35,0,0,37,43,-6,36.6,56.5,-19.9,22,ENG
2944f86f,20,1045,11.6,12,1,8,6,12,19,-7,11.3,15.8,-4.4,22,ENG
29733c72,7,235,2.6,2,0,5,22,4,4,0,3.4,3.2,0.2,22,ENG
2acd49b9,36,3220,35.8,36,35,0,0,31,73,-42,38.3,61.8,-23.5,22,ENG
2b16cb1a,35,2804,31.2,31,20,4,0,35,54,-19,29.8,50.0,-20.2,22,ENG
2b622f01,34,1775,19.7,19,6,15,2,29,21,8,30.3,21.5,8.9,22,ENG
2b91cf8e,13,1014,11.3,12,10,1,4,14,26,-12,9.6,19.4,-9.7,22,ENG
2baec6ce,9,508,5.6,6,5,3,8,6,10,-4,4.5,8.1,-3.6,22,ENG
2bc28bb9,2,66,0.7,1,0,1,7,1,1,0,0.7,2.4,-1.7,22,ENG
2bd83368,35,2285,25.4,25,14,10,2,24,40,-16,26.5,33.8,-7.4,22,ENG
2c44a35d,33,2581,28.7,30,17,3,0,28,59,-31,30.0,46.7,-16.7,22,ENG
2ce2508a,15,774,8.6,9,1,6,14,13,16,-3,11.2,7.9,3.4,22,ENG
2d5f03bf,3,157,1.7,2,0,1,10,0,8,-8,1.0,5.2,-4.2,22,ENG
2d61d13a,11,922,10.2,11,9,0,8,4,25,-21,8.0,18.7,-10.7,22,ENG
2d760d7b,1,45,0.5,0,0,1,5,0,3,-3,0.1,1.9,-1.9,22,ENG
2e4f5f03,29,2537,28.2,29,25,0,4,71,20,51,64.8,26.3,38.5,22,ENG
2f6ec02a,19,912,10.1,11,3,8,17,8,24,-16,9.4,20.9,-11.6,22,ENG
2f7acede,19,912,10.1,9,6,10,16,15,15,0,17.7,12.4,5.3,22,ENG
2f8d27bc,1,9,0.1,0,0,1,3,0,0,0,0.0,0.5,-0.5,22,ENG
2f90f6b8,24,853,9.5,9,4,15,8,27,6,21,21.3,8.8,12.5,22,ENG
2f965a72,1,90,1.0,1,1,0,37,0,1,-1,0.3,1.9,-1.6,22,ENG
2fba6108,21,1214,13.5,14,5,7,3,20,17,3,18.0,16.4,1.6,22,ENG
2ff964a0,28,1551,17.2,17,8,11,7,11,25,-14,16.4,26.7,-10.3,22,ENG
30d4a2e5,13,1055,11.7,12,10,1,4,14,17,-3,11.7,12.9,-1.2,22,ENG
30db8574,11,835,9.3,9,7,2,14,9,14,-5,11.8,13.8,-2.1,22,ENG
31822f8c,2,70,0.8,1,0,1,0,0,1,-1,0.4,0.9,-0.5,22,ENG
31c69ef1,29,2402,26.7,27,24,2,2,69,18,51,62.9,18.7,44.1,22,ENG
32f60ed8,2,9,0.1,0,0,2,1,0,0,0,0.3,0.1,0.3,22,ENG
3312f911,32,1851,20.6,20,13,12,4,23,19,4,25.3,23.6,1.7,22,ENG
3353737a,25,1916,21.3,22,13,3,6,32,25,7,31.1,22.9,8.2,22,ENG
33887998,34,3060,34.0,34,34,0,0,70,31,39,59.0,30.6,28.4,22,ENG
3423f250,35,2915,32.4,34,26,1,0,34,68,-34,37.2,57.5,-20.3,22,ENG
3515d404,36,3215,35.7,36,34,0,0,40,63,-23,41.3,57.0,-15.7,22,ENG
35be8087,3,141,1.6,1,0,2,3,0,6,-6,1.6,4.7,-3.1,22,ENG
35e413f1,32,2880,32.0,32,32,0,2,52,35,17,52.4,33.4,19.0,22,ENG
3631ad41,16,903,10.0,9,5,7,17,8,19,-11,9.5,20.6,-11.1,22,ENG
36c2ca73,17,1530,17.0,17,17,0,1,16,27,-11,20.9,25.0,-4.2,22,ENG
3727dd3c,24,1983,22.0,22,19,2,1,28,30,-2,23.1,29.7,-6.6,22,ENG
38c7feef,17,785,8.7,9,0,8,12,15,7,8,19.1,7.0,12.1,22,ENG
38ceb24a,34,2805,31.2,32,23,2,1,33,33,0,39.0,36.3,2.7,22,ENG
3935e52e,2,91,1.0,1,1,1,2,0,5,-5,0.2,4.4,-4.2,22,ENG
3a233281,18,761,8.5,7,3,11,2,12,13,-1,10.4,6.3,4.0,22,ENG
3a24769f,6,179,2.0,1,0,5,21,10,2,8,6.6,0.7,5.9,22,ENG
3a949a25,26,2340,26.0,26,26,0,3,29,35,-6,27.6,35.6,-7.9,22,ENG
3ae14ed1,1,11,0.1,0,0,1,3,0,1,-1,0.4,0.3,0.1,22,ENG
3b8674e6,17,1361,15.1,16,10,1,0,36,12,24,27.2,12.9,14.3,22,ENG
3bb7b8b4,37,3330,37.0,37,37,0,0,97,26,71,86.5,23.7,62.8,22,ENG
3c33f9d9,12,504,5.6,6,0,6,12,1,12,-11,3.5,7.9,-4.4,22,ENG
3d50bcdb,1,1,0.0,0,0,1,0,0,0,0,0.1,0.3,-0.3,22,ENG
3dcef539,1,17,0.2,0,0,1,7,1,0,1,0.1,0.2,-0.1,22,ENG
3e9e06cb,34,2754,30.6,30,28,4,3,48,42,6,40.8,44.1,-3.3,22,ENG
3ea50f67,32,2101,23.3,24,13,8,3,38,30,8,31.2,33.8,-2.6,22,ENG
3eb22ec9,35,2857,31.7,33,27,2,3,75,23,52,69.1,21.4,47.7,22,ENG
3f70db80,1,36,0.4,0,0,1,37,3,0,3,1.5,0.2,1.2,22,ENG
3faa1780,19,769,8.5,7,2,12,7,3,16,-13,10.3,13.4,-3.1,22,ENG
3fe6bd8c,3,198,2.2,2,1,1,13,1,1,0,1.9,2.2,-0.3,22,ENG
407db0d5,4,41,0.5,0,0,4,14,1,0,1,0.4,0.5,-0.1,22,ENG
4115ce4e,31,2629,29.2,30,26,1,6,33,52,-19,34.8,45.0,-10.2,22,ENG
420d7c7d,26,2272,25.2,26,23,0,0,30,66,-36,30.8,50.9,-20.0,22,ENG
42130443,1,90,1.0,1,1,0,29,2,0,2,2.1,0.9,1.2,22,ENG
4315f30d,8,546,6.1,6,4,2,21,6,7,-1,4.2,6.0,-1.8,22,ENG
43458538,32,2248,25.0,27,20,5,1,23,47,-24,28.8,45.4,-16.6,22,ENG
43a166b4,7,133,1.5,0,0,7,11,11,0,11,6.1,0.4,5.8,22,ENG
4468ec10,34,2338,26.0,28,9,6,0,30,39,-9,27.9,32.1,-4.2,22,ENG
44781702,29,2538,28.2,28,26,1,8,57,30,27,50.0,27.9,22.1,22,ENG
44bfb6c5,33,2661,29.6,31,27,2,0,27,34,-7,28.3,46.4,-18.1,22,ENG
450ab6fc,26,2058,22.9,22,21,4,8,25,44,-19,20.3,41.2,-20.9,22,ENG
45685411,2,80,0.9,1,0,1,5,1,0,1,0.5,0.5,0.1,22,ENG
45963054,25,1806,20.1,20,15,5,2,37,27,10,26.6,32.7,-6.1,22,ENG
4596da74,1,23,0.3,0,0,1,16,0,1,-1,0.2,0.4,-0.3,22,ENG
45db685d,29,2273,25.3,26,18,3,7,53,16,37,44.7,17.1,27.6,22,ENG
4654e5f5,5,141,1.6,1,1,4,26,4,4,0,2.7,2.7,0.0,22,ENG
466fb2c5,34,3060,34.0,34,34,0,2,60,39,21,57.4,36.5,20.9,22,ENG
471f16b3,31,2706,30.1,29,27,2,1,20,62,-42,25.9,61.3,-35.5,22,ENG
47369df8,35,2955,32.8,32,31,3,0,31,45,-14,34.0,50.1,-16.0,22,ENG
47a34c4f,14,806,9.0,8,8,6,19,20,17,3,15.7,13.8,1.9,22,ENG
4806ec67,35,3150,35.0,35,35,0,0,41,58,-17,38.7,49.5,-10.8,22,ENG
48a5a5d6,29,1860,20.7,21,9,8,7,34,25,9,33.8,21.9,12.0,22,ENG
495945ef,27,2287,25.4,26,23,1,0,20,40,-20,24.5,39.1,-14.7,22,ENG
49fe9070,21,1283,14.3,15,7,6,7,26,17,9,23.0,15.7,7.3,22,ENG
4a1a9578,13,958,10.6,11,4,2,3,25,4,21,25.5,7.6,17.8,22,ENG
4ab53cdb,29,1382,15.4,13,5,16,2,13,15,-2,18.9,20.8,-1.9,22,ENG
4b40d9ca,36,3240,36.0,36,36,0,0,32,47,-15,37.6,52.8,-15.2,22,ENG
4b511457,36,2889,32.1,34,21,2,1,40,52,-12,39.4,47.5,-8.1,22,ENG
4bcf39f6,32,2276,25.3,25,19,7,5,25,31,-6,29.1,28.6,0.5,22,ENG
4c370d81,20,990,11.0,10,3,10,2,32,9,23,23.1,12.0,11.2,22,ENG
4e9a0555,34,2694,29.9,32,18,2,1,32,41,-9,30.299999999999997,39.7,-9.3,22,ENG
4f565d77,20,1596,17.7,18,16,2,3,18,25,-7,19.9,27.9,-8.0,22,ENG
4f974391,31,2726,30.3,31,29,0,0,44,38,6,38.6,41.0,-2.4,22,ENG
4fb9c88f,15,851,9.5,10,4,5,10,26,9,17,20.0,10.8,9.2,22,ENG
507c7bdf,36,3111,34.6,35,26,1,0,49,54,-5,50.6,48.9,1.7,22,ENG
50dc94ce,15,558,6.2,5,3,10,16,6,14,-8,6.6,10.4,-3.8000000000000003,22,ENG
50e6dc35,22,1145,12.7,13,1,9,8,20,14,6,18.2,11.4,6.8,22,ENG
51cf8561,15,1047,11.6,10,10,5,17,49,9,40,37.2,8.9,28.3,22,ENG
5271c8f1,1,78,0.9,1,0,0,1,0,1,-1,1.7,1.0,0.7,22,ENG
527f063d,15,766,8.5,7,4,8,0,13,10,3,12.5,10.8,1.6,22,ENG
529f49ab,24,2028,22.5,23,17,1,0,40,24,16,36.6,24.5,12.1,22,ENG
531a4aa8,5,370,4.1,3,3,2,29,2,7,-5,3.0,7.9,-4.9,22,ENG
53af52f3,37,3330,37.0,37,37,0,1,57,58,-1,45.3,57.9,-12.6,22,ENG
53cad200,27,2070,23.0,24,16,3,7,36,23,13,33.6,23.7,9.9,22,ENG
5515376c,20,1449,16.1,17,13,3,13,38,9,29,27.6,12.0,15.7,22,ENG
56f7a928,32,2631,29.2,29,24,3,1,52,42,10,40.1,41.1,-1.0,22,ENG
57c94db2,21,1240,13.8,12,11,9,15,17,27,-10,12.7,18.6,-5.9,22,ENG
57df7a11,13,650,7.2,6,4,7,16,7,12,-5,8.9,14.1,-5.3,22,ENG
57e3f0c7,20,696,7.7,5,5,15,15,11,9,2,13.3,9.9,3.4,22,ENG
58eee997,18,1271,14.1,16,4,2,3,22,18,4,21.8,17.7,4.1,22,ENG
59e6e5bf,17,1283,14.3,15,9,2,3,23,31,-8,18.9,21.6,-2.7,22,ENG
5a04fd92,32,2168,24.1,26,4,6,1,44,27,17,33.6,28.7,4.9,22,ENG
5a4280b1,6,410,4.6,4,4,2,24,3,7,-4,5.3,8.2,-2.9,22,ENG
5a7301ae,30,1950,21.7,21,17,9,7,23,29,-6,20.5,35.2,-14.7,22,ENG
5aaef9ef,26,1920,21.3,22,15,4,2,18,34,-16,22.4,33.2,-10.8,22,ENG
5c74c0f5,28,2105,23.4,23,19,5,8,37,27,10,28.8,35.3,-6.4,22,ENG
5cbd1eb0,36,3101,34.5,35,32,1,1,45,43,2,40.7,37.9,2.7,22,ENG
5cdddffa,9,484,5.4,6,1,3,6,6,11,-5,7.2,5.7,1.5,22,ENG
5e105217,4,133,1.5,2,0,2,12,3,5,-2,1.1,2.9,-1.8,22,ENG
5e74d6c8,26,2120,23.6,23,19,3,6,16,52,-36,19.4,49.3,-29.9,22,ENG
5eae500a,26,1589,17.7,16,11,10,3,33,14,19,26.7,16.7,10.0,22,ENG
5ed9b537,11,990,11.0,11,11,0,26,28,10,18,23.6,12.2,11.4,22,ENG
5eebbfdf,1,58,0.6,1,0,0,7,1,0,1,1.6,0.4,1.2,22,ENG
5eecec3d,14,1119,12.4,12,11,2,13,30,6,24,26.2,6.7,19.5,22,ENG
60344e4f,9,257,2.9,2,0,7,1,4,4,0,1.9,2.7,-0.9,22,ENG
6250083a,18,1350,15.0,14,12,4,1,21,13,8,20.9,16.0,4.9,22,ENG
62d7ef38,2,180,2.0,2,2,0,34,7,2,5,4.6,1.7,2.9,22,ENG
6434f10d,33,2884,32.0,33,29,0,2,83,22,61,73.9,18.3,55.6,22,ENG
653ee42d,3,124,1.4,1,1,2,16,0,0,0,1.1,1.0,0.1,22,ENG
6613c819,35,3062,34.0,34,33,1,1,51,46,5,42.8,49.1,-6.3,22,ENG
6622454d,23,1319,14.7,14,8,9,13,22,12,10,23.4,11.2,12.2,22,ENG
66b76d44,35,1899,21.1,22,5,13,2,30,32,-2,23.8,27.4,-3.6,22,ENG
67ac5bb8,35,3063,34.0,35,31,0,0,61,37,24,58.2,35.0,23.3,22,ENG
67ca8566,34,2919,32.4,34,31,0,0,38,66,-28,39.2,57.2,-18.0,22,ENG
68c720b5,23,1413,15.7,17,10,6,14,12,31,-19,16.6,28.9,-12.3,22,ENG
68dc0dac,30,2042,22.7,23,12,7,5,24,35,-11,29.7,32.7,-3.0,22,ENG
6a713852,37,3329,37.0,37,36,0,0,42,42,0,45.7,42.1,3.6,22,ENG
6aa3e78b,15,1047,11.6,13,4,2,7,25,11,14,20.0,11.3,8.7,22,ENG
6adbc307,11,811,9.0,9,8,2,11,8,19,-11,9.5,16.1,-6.6,22,ENG
6afaebf2,35,2905,32.3,34,22,1,1,41,47,-6,41.2,39.5,1.7,22,ENG
6b47c5db,19,1618,18.0,18,16,1,2,26,26,0,21.1,29.2,-8.1,22,ENG
6b625ac2,38,3384,37.6,38,37,0,0,39,79,-40,42.9,67.6,-24.7,22,ENG
6bd603db,3,67,0.7,1,0,2,13,1,2,-1,1.1,1.2,-0.1,22,ENG
6c17e046,23,987,11.0,7,4,16,4,10,26,-16,12.4,21.5,-9.1,22,ENG
6c203af0,26,2111,23.5,25,18,1,4,27,28,-1,28.7,26.5,2.2,22,ENG
6c6a3300,31,2229,24.8,25,11,6,1,21,56,-35,21.3,52.1,-30.8,22,ENG
6ca5ec4b,28,2035,22.6,22,15,6,7,27,38,-11,25.5,35.1,-9.6,22,ENG
6cc47ae1,1,23,0.3,0,0,1,8,0,0,0,0.3,0.2,0.1,22,ENG
6cdd8245,28,1616,18.0,20,5,8,6,20,38,-18,19.0,30.6,-11.6,22,ENG
6d5701f2,13,846,9.4,11,8,2,1,12,10,2,12.7,8.2,4.5,22,ENG
6dfd8f05,20,1623,18.0,18,14,2,15,21,33,-12,19.3,31.0,-11.8,22,ENG
6e7f1353,10,356,4.0,3,0,7,17,2,8,-6,2.7,5.6,-2.8,22,ENG
6f711f67,1,13,0.1,0,0,1,6,0,0,0,0.3,0.1,0.1,22,ENG
6f7d826d,34,2715,30.2,31,22,3,0,43,38,5,37.1,39.2,-2.1,22,ENG
71b47ab9,25,1147,12.7,11,5,14,7,19,34,-15,15.9,20.8,-4.9,22,ENG
71ef519e,18,1337,14.9,14,13,4,12,15,37,-22,11.8,29.3,-17.5,22,ENG
7314bba4,18,1436,16.0,15,15,3,12,15,19,-4,16.0,18.1,-2.0,22,ENG
74b2cd7e,11,921,10.2,11,10,0,0,21,11,10,16.6,11.0,5.6,22,ENG
74e12f1e,20,1670,18.6,20,14,0,18,19,26,-7,19.9,28.7,-8.8,22,ENG
758dd7f0,19,1257,14.0,15,9,4,11,14,27,-13,11.1,23.4,-12.2,22,ENG
75a72a99,14,991,11.0,13,9,1,10,19,20,-1,15.0,15.4,-0.4,22,ENG
76eca7e2,2,180,2.0,2,2,0,36,2,6,-4,2.1,4.3,-2.2,22,ENG
774cf58b,34,2881,32.0,32,29,2,2,18,69,-51,25.5,60.0,-34.6,22,ENG
77cf6852,20,1634,18.2,18,12,2,15,21,20,1,19.1,23.5,-4.3,22,ENG
77e39b04,28,1336,14.8,16,1,12,9,13,15,-2,16.8,20.0,-3.2,22,ENG
77e84962,25,1534,17.0,17,5,8,1,43,7,36,42.7,10.9,31.9,22,ENG
79300479,36,2785,30.9,32,20,4,0,53,39,14,51.0,33.6,17.4,22,ENG
7956236f,36,3240,36.0,36,36,0,0,50,48,2,42.6,44.3,-1.8,22,ENG
79c0821a,25,1558,17.3,16,11,9,0,39,11,28,28.2,15.2,13.0,22,ENG
79c84d1c,36,2983,33.1,34,22,2,0,57,46,11,47.1,44.1,3.0,22,ENG
7a11550b,8,331,3.7,4,3,4,21,7,3,4,8.9,2.3,6.7,22,ENG
7a1f2c08,3,118,1.3,1,0,2,15,2,5,-3,1.3,1.1,0.2,22,ENG
7a2e46a8,36,3240,36.0,36,36,0,0,87,24,63,84.1,32.1,52.0,22,ENG
7aa8adfe,2,13,0.1,0,0,2,5,0,0,0,0.2,0.0,0.2,22,ENG
7aee4dd3,6,450,5.0,4,4,2,6,6,6,0,6.5,5.8,0.7,22,ENG
7b4de647,3,270,3.0,3,3,0,35,2,8,-6,2.5,5.9,-3.4,22,ENG
7b5ab7f2,9,94,1.0,0,0,9,7,2,1,1,2.5,1.5,1.0,22,ENG
7ba2eaa9,13,466,5.2,5,0,8,0,4,14,-10,4.6,10.4,-5.8,22,ENG
7ba6d84e,38,3420,38.0,38,38,0,0,57,57,0,55.8,53.0,2.8,22,ENG
7c104bb7,26,1453,16.1,16,3,10,7,28,31,-3,22.6,27.0,-4.4,22,ENG
7d2d3329,6,285,3.2,4,1,2,25,4,4,0,3.1,8.2,-5.1,22,ENG
7e003182,1,15,0.2,0,0,1,22,0,0,0,0.4,0.0,0.4,22,ENG
7ed4921e,17,1390,15.4,15,15,2,11,19,30,-11,17.5,27.4,-9.9,22,ENG
7f3b388c,29,2314,25.7,26,21,3,1,62,18,44,60.7,23.5,37.2,22,ENG
7fcc71d8,26,1484,16.5,15,4,11,3,27,12,15,17.4,22.8,-5.4,22,ENG
7fec31a0,4,166,1.8,2,1,2,14,2,5,-3,1.3,3.3,-1.9,22,ENG
810e3c74,16,367,4.1,2,0,14,16,9,13,-4,5.5,8.2,-2.7,22,ENG
819aa8e7,14,445,4.9,6,0,8,18,9,12,-3,7.2,9.2,-2.0,22,ENG
819b3158,27,1857,20.6,20,15,7,8,62,10,52,51.7,13.0,38.7,22,ENG
82518f62,17,1034,11.5,11,7,6,0,13,13,0,13.1,14.2,-1.1,22,ENG
82927de4,36,2795,31.1,32,19,4,0,45,38,7,37.8,41.5,-3.7,22,ENG
82c215a0,7,209,2.3,1,1,6,16,4,4,0,4.3,4.2,0.1,22,ENG
82e34b69,2,25,0.3,0,0,2,0,0,1,-1,0.3,1.3,-1.0,22,ENG
8397a50c,36,3189,35.4,35,35,1,0,49,49,0,42.0,46.8,-4.9,22,ENG
839c14e1,21,1486,16.5,16,12,5,12,22,27,-5,26.4,23.1,3.2,22,ENG
83d074ff,33,2123,23.6,22,18,11,5,31,29,2,30.4,24.1,6.4,22,ENG
8449d35e,31,2298,25.5,27,13,4,1,35,37,-2,31.6,31.1,0.5,22,ENG
849c826a,19,316,3.5,1,0,18,16,3,4,-1,5.6,7.2,-1.6,22,ENG
84c5ceea,3,92,1.0,1,0,2,19,1,0,1,1.1,0.6,0.5,22,ENG
862a1c15,30,1716,19.1,19,5,11,6,16,32,-16,16.6,30.6,-14.0,22,ENG
867239d3,20,1349,15.0,16,9,4,0,26,22,4,25.6,17.8,7.8,22,ENG
86dd77d1,20,1755,19.5,20,19,0,7,42,14,28,43.0,11.9,31.1,22,ENG
86e7deaf,32,2650,29.4,28,26,4,4,59,28,31,52.8,26.2,26.6,22,ENG
87f12e30,1,4,0.0,0,0,1,4,0,0,0,0.9,0.0,0.9,22,ENG
892d5bb1,28,1498,16.6,15,10,13,8,44,14,30,43.1,11.7,31.4,22,ENG
8996350d,23,1645,18.3,20,10,3,1,13,40,-27,14.9,37.5,-22.6,22,ENG
89d10e53,8,689,7.7,7,6,1,7,5,16,-11,5.9,15.1,-9.2,22,ENG
89e4b358,31,2396,26.6,27,24,4,4,28,55,-27,31.0,45.8,-14.8,22,ENG
8a3c1dc7,34,2776,30.8,33,24,1,0,40,41,-1,38.4,39.7,-1.3,22,ENG
8a7ff278,28,2487,27.6,27,27,1,5,37,37,0,35.1,30.2,5.0,22,ENG
8aec0537,29,2038,22.6,24,14,5,6,19,24,-5,26.1,26.6,-0.5,22,ENG
8b04d6c1,36,3196,35.5,36,33,0,1,66,34,32,55.9,36.6,19.2,22,ENG
8b788c01,8,212,2.4,2,0,6,5,6,3,3,4.6,2.1,2.6,22,ENG
8c12f884,13,223,2.5,0,0,13,8,2,5,-3,2.4,4.7,-2.2,22,ENG
8d03ca5a,14,709,7.9,7,3,7,14,9,14,-5,9.2,11.9,-2.7,22,ENG
8d3c902d,27,1974,21.9,23,14,4,6,27,28,-1,24.2,25.8,-1.6,22,ENG
8d62d31a,3,89,1.0,0,0,3,29,0,3,-3,0.1,2.1,-2.0,22,ENG
8df7a2fb,21,1839,20.4,21,20,0,0,20,25,-5,18.3,28.4,-10.1,22,ENG
8f62b6ee,38,3420,38.0,38,38,0,0,69,40,29,61.2,39.3,21.9,22,ENG
903b6e8b,37,3285,36.5,37,36,0,1,37,40,-3,36.4,54.4,-18.0,22,ENG
90f91999,35,3090,34.3,35,32,0,0,45,48,-3,40.3,43.8,-3.5,22,ENG
914ab9a1,16,1193,13.3,12,12,4,15,10,30,-20,12.5,21.4,-8.9,22,ENG
9228b07c,6,234,2.6,2,1,4,9,3,9,-6,3.8,8.4,-4.6,22,ENG
92b4758e,19,1673,18.6,19,16,0,0,11,36,-25,16.9,27.8,-10.9,22,ENG
92e7e919,35,3006,33.4,35,20,0,0,65,30,35,54.7,32.4,22.3,22,ENG
9319781b,20,1397,15.5,16,13,4,12,23,18,5,20.8,23.9,-3.2,22,ENG
9328b835,37,3330,37.0,37,37,0,0,60,50,10,51.1,51.6,-0.5,22,ENG
935e6b8f,35,2597,28.9,29,18,6,0,73,22,51,66.8,25.1,41.7,22,ENG
939bc634,2,180,2.0,2,2,0,10,2,5,-3,3.4,2.5,0.8,22,ENG
93cf32a8,3,168,1.9,2,1,1,2,6,2,4,4.7,2.8,1.8,22,ENG
93feac6e,9,559,6.2,7,4,2,1,7,14,-7,7.8,11.4,-3.7,22,ENG
953c30b0,10,604,6.7,6,5,4,17,2,18,-16,5.2,13.6,-8.4,22,ENG
96593e89,2,20,0.2,0,0,2,11,1,0,1,1.6,0.0,1.5,22,ENG
9674002f,32,2363,26.3,27,20,5,3,56,25,31,45.1,23.2,21.9,22,ENG
97220da2,32,1975,21.9,21,6,11,0,26,37,-11,28.6,31.5,-3.0,22,ENG
97333cf5,25,1473,16.4,15,8,10,2,17,30,-13,19.1,29.4,-10.2,22,ENG
980522ec,11,939,10.4,10,10,1,0,20,10,10,15.6,13.0,2.6,22,ENG
984a5a64,32,2633,29.3,29,27,3,5,33,49,-16,34.7,45.5,-10.7,22,ENG
989d5705,3,72,0.8,0,0,3,14,1,3,-2,0.8,1.7,-0.9,22,ENG
98ea5115,24,2160,24.0,24,24,0,0,33,27,6,31.2,29.4,1.8,22,ENG
99813635,24,1561,17.3,18,10,6,10,20,20,0,20.3,18.6,1.6,22,ENG
9a104dee,1,7,0.1,0,0,1,7,0,0,0,0.0,0.0,0.0,22,ENG
9a28eba4,20,1067,11.9,10,5,10,1,9,10,-1,13.5,16.3,-2.8,22,ENG
9a71e978,8,308,3.4,4,3,4,21,0,5,-5,2.7,5.7,-3.0,22,ENG
9a9c05db,25,1772,19.7,20,17,5,12,18,30,-12,21.7,30.5,-8.8,22,ENG
9ae9eaea,18,1449,16.1,17,12,1,14,10,14,-4,16.4,20.5,-4.1,22,ENG
9b398aea,23,1828,20.3,20,17,3,12,25,26,-1,18.6,33.6,-15.0,22,ENG
9c94165b,20,1601,17.8,19,15,1,2,31,24,7,27.9,23.3,4.6,22,ENG
9dbb75ca,30,1782,19.8,20,6,10,5,36,17,19,34.6,19.8,14.8,22,ENG
9deaf2c8,1,12,0.1,0,0,1,5,0,0,0,0.1,0.0,0.1,22,ENG
9e1035f8,4,303,3.4,4,2,0,3,8,1,7,9.0,1.5,7.5,22,ENG
9e525177,20,1793,19.9,20,19,0,10,29,35,-6,28.5,30.7,-2.1,22,ENG
9f1938ab,22,1530,17.0,17,13,5,4,20,41,-21,21.1,33.6,-12.5,22,ENG
9f333379,14,336,3.7,3,0,11,16,0,9,-9,3.6,8.9,-5.3,22,ENG
9f472354,13,308,3.4,3,0,10,18,6,5,1,3.2,5.3,-2.1,22,ENG
9f7c837d,23,2029,22.5,23,21,0,1,21,39,-18,23.2,32.4,-9.1,22,ENG
9f8e9423,22,1831,20.3,20,20,2,2,30,22,8,31.8,25.6,6.3,22,ENG
9fbbcf39,31,2705,30.1,31,27,0,2,26,30,-4,28.8,44.4,-15.6,22,ENG
a0666d3e,16,1053,11.7,13,5,3,15,17,16,1,14.9,15.6,-0.7,22,ENG
a1232f4e,4,217,2.4,3,1,1,17,5,4,1,5.5,4.8,0.7,22,ENG
a179d516,2,180,2.0,2,2,0,19,2,5,-3,1.3,3.0,-1.7,22,ENG
a1d5bd30,25,1235,13.7,13,3,12,3,18,28,-10,18.2,23.1,-4.9,22,ENG
a2081c6b,1,24,0.3,0,0,1,4,1,1,0,0.2,0.2,0.0,22,ENG
a29b1131,25,565,6.3,4,1,21,7,9,6,3,8.1,8.5,-0.4,22,ENG
a2b105e0,24,1464,16.3,15,12,9,13,19,29,-10,16.3,27.4,-11.2,22,ENG
a3b03921,29,2038,22.6,24,9,5,2,26,37,-11,22.4,32.1,-9.7,22,ENG
a3d94a58,22,1844,20.5,21,19,1,2,38,25,13,28.1,22.1,6.1,22,ENG
a4ac4b8f,10,900,10.0,10,10,0,14,13,20,-7,9.5,18.0,-8.6,22,ENG
a53649b7,21,835,9.3,8,4,13,5,18,18,0,16.0,12.6,3.4,22,ENG
a65c844b,22,1176,13.1,13,10,9,16,25,19,6,21.8,17.0,4.8,22,ENG
a712ca2b,13,963,10.7,10,9,3,21,19,19,0,17.9,17.3,0.5,22,ENG
a8a3d139,1,90,1.0,1,1,0,18,0,3,-3,1.2,1.3,-0.1,22,ENG
a8c0acb7,24,1995,22.2,23,17,1,3,28,31,-3,27.7,29.8,-2.1,22,ENG
a8c19eb8,19,1670,18.6,18,17,1,17,17,25,-8,22.3,27.5,-5.2,22,ENG
a8d4428b,26,1572,17.5,18,5,8,0,11,33,-22,14.3,29.1,-14.8,22,ENG
aa54ec6f,2,180,2.0,2,2,0,4,0,4,-4,1.6,4.3,-2.8,22,ENG
aa849a12,35,2639,29.3,32,20,3,2,31,68,-37,30.9,56.1,-25.2,22,ENG
aa8e289e,19,560,6.2,6,0,13,13,7,10,-3,8.3,11.9,-3.7,22,ENG
ab070c55,25,1145,12.7,11,6,14,12,16,20,-4,16.9,16.4,0.6,22,ENG
ab13a5aa,30,2655,29.5,30,29,0,5,38,33,5,37.7,31.9,5.9,22,ENG
ab651565,27,1833,20.4,20,14,7,3,25,33,-8,23.3,30.9,-7.6,22,ENG
ac05f970,36,2971,33.0,34,23,2,1,55,43,12,45.8,43.7,2.1,22,ENG
ac0d576d,5,48,0.5,1,0,4,7,0,2,-2,0.5,1.1,-0.6,22,ENG
ac861941,35,3071,34.1,35,34,0,0,64,30,34,55.6,32.6,22.9,22,ENG
ad1f61f3,9,404,4.5,5,1,4,18,3,7,-4,3.5,7.0,-3.5,22,ENG
ae4fc6a4,13,605,6.7,6,2,7,12,6,8,-2,8.6,5.7,2.9,22,ENG
ae59b359,19,1102,12.2,12,6,7,7,19,27,-8,16.0,19.4,-3.4,22,ENG
aed3a70f,35,2952,32.8,33,28,2,0,46,48,-2,37.9,44.5,-6.5,22,ENG
afed6722,28,2202,24.5,25,22,3,0,25,42,-17,31.6,35.1,-3.5,22,ENG
b0b4fd3e,26,1914,21.3,22,15,4,8,52,8,44,51.1,11.1,40.0,22,ENG
b217ef29,31,2790,31.0,31,31,0,4,76,21,55,72.8,26.2,46.6,22,ENG
b28bbd58,21,1455,16.2,17,11,4,4,14,30,-16,16.2,23.5,-7.4,22,ENG
b2bc3b1f,33,2760,30.7,31,28,2,0,38,33,5,35.4,30.3,5.1,22,ENG
b2c66859,1,3,0.0,0,0,1,4,0,0,0,0.0,0.5,-0.4,22,ENG
b2d31e83,29,2462,27.4,28,26,1,3,30,30,0,31.0,32.3,-1.4,22,ENG
b2f9c73e,12,301,3.3,2,0,10,19,5,6,-1,4.3,6.0,-1.8,22,ENG
b318a643,20,790,8.8,8,5,12,10,8,16,-8,10.1,13.5,-3.4,22,ENG
b391383a,1,7,0.1,0,0,1,7,0,1,-1,0.1,0.1,0.0,22,ENG
b3af9be1,21,1679,18.7,20,16,1,1,30,20,10,27.4,22.1,5.3,22,ENG
b400bde0,30,2128,23.6,23,17,7,7,64,17,47,57.5,16.9,40.7,22,ENG
b561db50,34,2631,29.2,30,20,4,0,28,28,0,29.7,37.6,-7.9,22,ENG
b579e83d,9,401,4.5,4,3,5,3,3,8,-5,3.2,5.9,-2.7,22,ENG
b5bf1770,15,911,10.1,9,9,6,9,11,20,-9,9.2,17.6,-8.4,22,ENG
b66315ae,28,1877,20.9,21,13,7,6,50,15,35,44.6,13.0,31.7,22,ENG
b827d5b3,17,1132,12.6,11,11,6,17,17,24,-7,13.3,24.6,-11.3,22,ENG
b853e0ad,28,2028,22.5,24,14,4,3,32,31,1,31.2,31.3,-0.2,22,ENG
b8d22478,4,222,2.5,2,1,2,7,1,6,-5,1.8,3.6,-1.9,22,ENG
b9403c99,1,14,0.2,0,0,1,4,0,1,-1,0.1,0.3,-0.1,22,ENG
b9e1436c,6,346,3.8,4,2,2,6,7,2,5,10.3,3.6,6.7,22,ENG
b9fbae28,26,1773,19.7,21,11,5,1,34,19,15,30.8,15.5,15.3,22,ENG
bb5fbd2b,31,1746,19.4,17,10,14,6,26,23,3,25.9,22.7,3.2,22,ENG
bba30585,28,2340,26.0,28,24,0,2,27,44,-17,28.1,42.3,-14.2,22,ENG
bc7dc64d,38,2978,33.1,36,16,2,0,53,39,14,54.1,38.0,16.1,22,ENG
bcfb0142,28,2494,27.7,28,27,0,7,20,55,-35,24.2,52.2,-28.0,22,ENG
bd6351cd,36,3227,35.9,36,35,0,1,88,25,63,80.9,23.7,57.2,22,ENG
be927d03,24,1250,13.9,10,6,14,12,19,19,0,16.0,17.2,-1.2,22,ENG
beb391dd,26,1766,19.6,21,8,5,2,24,24,0,21.2,31.2,-10.0,22,ENG
bf8fad51,7,397,4.4,4,3,3,19,6,9,-3,5.4,6.5,-1.1,22,ENG
bfae110f,1,1,0.0,0,0,1,1,0,0,0,0.0,0.2,-0.1,22,ENG
bfdb33aa,22,1861,20.7,21,17,1,0,15,40,-25,20.8,37.3,-16.5,22,ENG
c067631c,7,307,3.4,3,2,4,18,7,6,1,3.6,4.3,-0.7,22,ENG
c14bc029,10,480,5.3,5,3,5,23,14,6,8,10.0,5.7,4.2,22,ENG
c17bfb65,35,2558,28.4,30,24,5,1,34,46,-12,31.0,40.0,-9.0,22,ENG
c1949191,6,388,4.3,4,3,2,20,6,14,-8,5.9,12.4,-6.5,22,ENG
c2731c10,34,2845,31.6,33,26,1,0,41,38,3,37.6,34.0,3.6,22,ENG
c393a6c4,5,382,4.2,4,4,1,9,3,9,-6,4.0,9.1,-5.1,22,ENG
c3e39f12,19,1710,19.0,19,19,0,14,25,35,-10,22.6,32.0,-9.3,22,ENG
c40b6180,22,1434,15.9,16,13,6,4,21,20,1,19.2,15.9,3.3,22,ENG
c4486bac,26,1141,12.7,12,4,14,2,18,14,4,16.3,13.2,3.1,22,ENG
c47541e0,9,220,2.4,1,0,8,10,2,3,-1,3.1,3.1,0.0,22,ENG
c4e87b8b,20,1450,16.1,17,7,3,0,14,20,-6,17.8,24.1,-6.3,22,ENG
c596fcb0,18,1386,15.4,16,11,2,0,16,32,-16,12.5,27.5,-15.0,22,ENG
c5b7c315,32,2792,31.0,31,29,1,4,36,54,-18,31.5,46.5,-15.0,22,ENG
c5bdb6e3,1,20,0.2,0,0,1,1,0,1,-1,0.5,0.7,-0.2,22,ENG
c691bfe2,34,2819,31.3,32,25,2,0,76,24,52,74.1,28.1,46.0,22,ENG
c8aa95da,25,2158,24.0,25,22,0,13,26,32,-6,24.2,31.7,-7.5,22,ENG
c92e1a31,26,1264,14.0,13,4,13,9,18,25,-7,14.3,21.8,-7.5,22,ENG
c931d9f9,34,2492,27.7,31,18,3,1,36,49,-13,33.9,46.0,-12.0,22,ENG
c951a6df,14,1002,11.1,12,9,2,3,11,25,-14,8.2,20.1,-11.9,22,ENG
ca22ccb0,2,68,0.8,1,0,1,5,0,2,-2,0.5,1.0,-0.5,22,ENG
ca45605e,23,1159,12.9,13,2,10,13,20,20,0,17.6,17.6,-0.1,22,ENG
cc2d7ad5,31,2731,30.3,30,30,1,0,28,48,-20,34.0,47.2,-13.2,22,ENG
cc3b8e78,4,180,2.0,2,1,2,29,2,1,1,1.7,2.7,-1.0,22,ENG
cc700722,28,2183,24.3,25,17,3,5,26,38,-12,27.5,32.8,-5.4,22,ENG
cc70a1d5,9,765,8.5,8,8,1,29,12,13,-1,8.7,8.9,-0.2,22,ENG
cd1acf9d,32,2853,31.7,32,30,0,2,80,22,58,74.1,30.0,44.1,22,ENG
cd4256d3,3,146,1.6,1,0,2,13,3,4,-1,1.9,2.6,-0.8,22,ENG
cde3309f,8,720,8.0,8,8,0,26,10,15,-5,6.6,11.5,-4.9,22,ENG
ce4246f5,24,2078,23.1,24,22,0,1,33,29,4,26.2,30.3,-4.2,22,ENG
ce5143da,25,1478,16.4,15,8,10,1,24,16,8,22.2,16.3,5.9,22,ENG
cea4ee8f,21,995,11.1,9,5,12,16,13,23,-10,12.3,19.7,-7.300000000000001,22,ENG
cee31595,21,1439,16.0,15,11,6,1,22,15,7,18.5,13.2,5.3,22,ENG
d0042ab9,25,2134,23.7,23,22,2,10,29,42,-13,26.2,36.4,-10.2,22,ENG
d04b94db,25,2131,23.7,25,19,0,4,24,18,6,24.4,32.7,-8.3,22,ENG
d0706b27,36,3222,35.8,36,35,0,1,49,43,6,44.8,37.6,7.2,22,ENG
d0b3ceb9,26,2340,26.0,26,26,0,2,24,49,-25,28.6,41.9,-13.3,22,ENG
d0f72bf1,30,2687,29.9,30,28,0,2,27,25,2,29.2,42.4,-13.1,22,ENG
d102b8a2,2,150,1.7,0,0,2,14,2,5,-3,2.2,4.8,-2.5,22,ENG
d2424d1b,7,542,6.0,6,6,1,6,19,2,17,13.1,4.1,9.0,22,ENG
d313e8ff,1,4,0.0,0,0,1,6,2,0,2,1.1,0.0,1.1,22,ENG
d3ce0e89,1,90,1.0,1,1,0,31,5,1,4,2.5,1.4,1.1,22,ENG
d557d734,15,875,9.7,9,6,6,13,27,11,16,19.1,9.2,9.9,22,ENG
d56543a0,27,1465,16.3,18,5,9,3,21,23,-2,16.6,23.4,-6.8,22,ENG
d5dd5f1f,14,1037,11.5,12,7,2,0,17,16,1,16.6,16.4,0.2,22,ENG
d7553721,9,238,2.6,2,0,7,4,3,5,-2,4.2,2.9,1.3,22,ENG
d79a8c87,15,845,9.4,9,8,6,21,18,14,4,14.0,12.9,1.0,22,ENG
d86a1f3e,3,28,0.3,0,0,3,2,0,0,0,0.9,0.1,0.8,22,ENG
d8931174,30,2515,27.9,28,26,2,3,46,41,5,41.1,36.4,4.7,22,ENG
d93c2511,30,2387,26.5,28,20,2,1,40,37,3,39.2,38.1,1.1,22,ENG
d9565625,24,1801,20.0,19,18,5,13,28,29,-1,29.3,26.0,3.4,22,ENG
da052c14,31,2019,22.4,23,10,8,6,31,31,0,27.1,25.4,1.7,22,ENG
da7b447d,23,1631,18.1,17,17,6,14,33,16,17,34.8,17.8,17.0,22,ENG
da8b19e2,2,135,1.5,1,1,1,36,1,3,-2,1.1,2.6,-1.4,22,ENG
dad4b285,34,2874,31.9,33,26,1,1,31,39,-8,40.5,37.6,2.9,22,ENG
dbf053da,29,1900,21.1,20,11,9,3,29,28,1,29.0,29.0,0.0,22,ENG
dc64b8b3,21,1814,20.2,21,20,0,1,20,26,-6,21.4,30.4,-9.0,22,ENG
dc6c2f02,8,208,2.3,1,1,7,7,5,5,0,3.1,3.5,-0.4,22,ENG
dc6f5bdd,13,1001,11.1,11,9,2,10,17,16,1,14.299999999999999,17.1,-2.8,22,ENG
dc7f8a28,4,123,1.4,1,0,3,20,6,0,6,4.5,0.4,4.2,22,ENG
dd323728,1,8,0.1,0,0,1,12,1,0,1,0.7,0.4,0.3,22,ENG
dd897ee7,1,10,0.1,0,0,1,3,1,0,1,1.0,0.0,1.0,22,ENG
de0f152c,15,1077,12.0,13,11,2,18,17,26,-9,16.7,22.0,-5.3,22,ENG
de112b84,33,1473,16.4,13,9,20,5,24,35,-11,20.2,28.3,-8.2,22,ENG
de5b5570,16,904,10.0,10,5,6,8,15,20,-5,9.1,14.1,-5.0,22,ENG
dea698d9,30,2456,27.3,27,21,3,0,40,41,-1,44.8,38.7,6.1,22,ENG
def899bd,4,163,1.8,2,1,2,20,0,3,-3,1.1,2.3,-1.2,22,ENG
df04eb4b,6,130,1.4,0,0,6,19,3,1,2,3.0,1.7,1.4,22,ENG
df0a4c90,35,3054,33.9,35,30,0,0,44,51,-7,41.7,44.8,-3.0,22,ENG
df10e27c,24,1855,20.6,21,15,3,7,8,52,-44,17.8,44.5,-26.6,22,ENG
df3cda47,18,1261,14.0,14,4,4,0,35,11,24,25.0,12.7,12.3,22,ENG
df8b52a5,31,2286,25.4,26,17,5,3,44,26,18,41.2,24.2,17.0,22,ENG
e0243d23,2,25,0.3,0,0,2,14,0,0,0,0.3,0.3,0.0,22,ENG
e06683ca,34,3060,34.0,34,34,0,1,84,21,63,80.9,29.1,51.8,22,ENG
e082af5b,9,810,9.0,9,9,0,29,6,22,-16,6.2,20.5,-14.3,22,ENG
e09f279b,33,2909,32.3,32,32,1,0,43,47,-4,40.5,40.9,-0.4,22,ENG
e0bc6fdc,1,5,0.1,0,0,1,0,0,0,0,0.0,0.0,0.0,22,ENG
e0d1510a,3,128,1.4,1,1,2,7,1,6,-5,1.8,4.6,-2.8,22,ENG
e1df6989,20,1416,15.7,17,8,3,9,12,38,-26,17.8,27.5,-9.7,22,ENG
e28868f3,13,1024,11.4,10,8,3,4,13,22,-9,10.7,19.3,-8.6,22,ENG
e342ad68,35,2762,30.7,30,25,5,0,78,22,56,75.7,27.1,48.6,22,ENG
e34fc66d,34,2916,32.4,32,31,2,0,44,37,7,40.4,35.8,4.6,22,ENG
e3a5814e,8,268,3.0,2,1,6,9,2,4,-2,3.8,6.1,-2.3,22,ENG
e46012d4,30,2201,24.5,25,16,5,3,64,22,42,52.0,17.6,34.4,22,ENG
e514ab62,33,2871,31.9,33,30,0,3,38,47,-9,33.0,41.4,-8.4,22,ENG
e541326e,32,2694,29.9,32,28,0,0,35,43,-8,34.8,36.4,-1.6,22,ENG
e58a03c6,8,38,0.4,0,0,8,28,1,0,1,1.5,0.3,1.2,22,ENG
e5d01ecf,27,2142,23.8,26,17,1,0,21,49,-28,23.6,36.5,-12.9,22,ENG
e61b8aee,27,2327,25.9,27,23,0,0,46,35,11,43.6,28.6,15.0,22,ENG
e717705a,1,1,0.0,0,0,1,31,1,0,1,1.5,0.5,0.9,22,ENG
e73c9bb2,21,1660,18.4,18,16,3,8,26,26,0,26.3,26.9,-0.6,22,ENG
e7aa9d7c,22,572,6.4,6,2,16,15,9,7,2,7.2,9.8,-2.6,22,ENG
e7ca0439,8,547,6.1,6,5,2,19,6,11,-5,6.1,7.3,-1.2,22,ENG
e7ee38c3,1,90,1.0,1,1,0,17,2,3,-1,0.2,3.4,-3.1,22,ENG
e814e1cf,3,32,0.4,0,0,3,8,1,1,0,0.5,0.4,0.0,22,ENG
e8832875,28,1644,18.3,15,10,13,1,19,35,-16,21.3,31.0,-9.8,22,ENG
e9254eec,33,2897,32.2,33,31,0,0,20,70,-50,26.9,62.1,-35.2,22,ENG
e97fd090,24,1394,15.5,13,10,11,6,30,21,9,27.0,18.8,8.2,22,ENG
e9971f2d,11,735,8.2,10,4,1,7,11,8,3,12.0,11.0,1.0,22,ENG
ea6bc03a,20,1574,17.5,17,15,3,1,21,40,-19,20.7,30.0,-9.4,22,ENG
eaeca114,14,923,10.3,10,8,4,22,19,3,16,20.3,5.3,15.0,22,ENG
eb7822d7,23,1382,15.4,16,7,7,10,22,26,-4,21.2,23.0,-1.7,22,ENG
ed1e53f3,28,2128,23.6,24,15,4,5,59,16,43,52.4,14.7,37.7,22,ENG
ee38d9c5,35,2459,27.3,28,14,7,0,48,41,7,34.2,45.5,-11.3,22,ENG
eeb6551f,3,30,0.3,0,0,3,14,0,0,0,1.2,0.2,1.0,22,ENG
efb9215a,5,262,2.9,4,2,1,14,3,4,-1,2.6,4.3,-1.7,22,ENG
f0caab96,4,360,4.0,4,4,0,12,7,6,1,4.9,5.6,-0.7,22,ENG
f127d782,12,1080,12.0,12,12,0,19,13,24,-11,11.2,16.6,-5.4,22,ENG
f13d02a6,1,22,0.2,0,0,1,2,0,0,0,0.3,0.0,0.2,22,ENG
f1e94cd6,14,804,8.9,10,1,4,14,13,18,-5,8.9,13.5,-4.6,22,ENG
f230bc30,28,1701,18.9,19,10,9,2,17,23,-6,20.4,21.2,-0.8,22,ENG
f23f9d20,29,2610,29.0,29,29,0,3,17,62,-45,26.1,55.0,-28.8,22,ENG
f25b010f,7,523,5.8,5,4,2,11,7,12,-5,7.0,10.5,-3.6,22,ENG
f25c8e3a,23,1173,13.0,14,4,9,6,30,6,24,28.0,12.7,15.4,22,ENG
f2bf1b0f,30,2039,22.7,23,13,7,4,25,40,-15,28.5,36.1,-7.7,22,ENG
f315ca93,13,877,9.7,9,8,4,23,23,6,17,23.9,7.0,17.0,22,ENG
f3354c07,7,237,2.6,1,0,6,14,7,5,2,4.5,3.8,0.7,22,ENG
f4290206,28,2167,24.1,25,16,3,6,42,22,20,37.0,21.2,15.9,22,ENG
f4d296e4,29,2055,22.8,22,20,7,2,25,52,-27,25.6,38.4,-12.9,22,ENG
f4e433d4,30,1561,17.3,16,7,14,3,14,21,-7,19.7,18.0,1.7,22,ENG
f5044e54,33,2265,25.2,27,15,6,4,17,55,-38,21.9,51.5,-29.6,22,ENG
f5a00fa4,35,2970,33.0,34,28,1,1,32,40,-8,31.8,48.0,-16.2,22,ENG
f5deef4c,28,2355,26.2,26,25,2,5,38,47,-9,35.6,40.8,-5.2,22,ENG
f63d8a4b,8,441,4.9,5,2,3,4,2,15,-13,3.3,11.9,-8.5,22,ENG
f72293fc,18,1102,12.2,13,5,5,0,10,19,-9,12.0,17.1,-5.2,22,ENG
f7b1d4e0,17,536,6.0,4,0,13,16,10,4,6,9.4,6.1,3.3,22,ENG
f833a830,11,186,2.1,1,1,10,15,6,1,5,5.1,0.6,4.4,22,ENG
f8fcd2a5,18,1348,15.0,16,12,2,2,27,23,4,21.3,21.7,-0.3,22,ENG
f9682888,1,4,0.0,0,0,1,7,0,0,0,0.0,0.0,0.0,22,ENG
f99b71de,13,799,8.9,9,4,4,7,3,17,-14,6.8,12.3,-5.6,22,ENG
fa031b34,30,2523,28.0,28,21,2,0,33,46,-13,29.6,38.5,-8.9,22,ENG
fb614c44,13,998,11.1,11,10,2,2,20,13,7,14.2,14.5,-0.4,22,ENG
fc027d02,22,1912,21.2,21,20,1,5,32,35,-3,24.2,36.4,-12.2,22,ENG
fc15fb84,38,3107,34.5,35,26,3,0,32,49,-17,34.6,49.8,-15.2,22,ENG
fce2302c,22,1915,21.3,22,18,0,4,33,21,12,33.4,22.9,10.5,22,ENG
fdf3cb77,28,2209,24.5,25,21,3,3,42,35,7,35.4,33.6,1.8,22,ENG
fed7cb61,29,1809,20.1,22,11,7,6,44,18,26,34.0,19.2,14.8,22,ENG
ff527768,11,332,3.7,3,1,8,22,5,5,0,6.5,6.4,0.1,22,ENG
ffa90327,11,399,4.3999999999999995,4,2,7,17,7,8,-1,4.5,6.8,-2.4000000000000004,22,ENG
0076ab7f,3,241,2.7,2,1,1,1,1,1,0,2.9,3.8,-0.9,22,EL
01226327,4,246,2.7,3,2,1,2,5,7,-2,3.0,4.7,-1.7,22,EL
0127419a,5,290,3.2,3,0,2,0,6,1,5,5.5,3.2,2.3,22,EL
01ccefab,1,22,0.2,0,0,1,2,0,0,0,0.3,0.0,0.3,22,EL
01da7812,5,385,4.3,4,4,1,0,4,9,-5,3.5,7.7,-4.1,22,EL
02caf6e0,6,315,3.5,4,2,2,0,3,1,2,6.0,3.4,2.6,22,EL
0331786b,3,34,0.4,0,0,3,3,0,0,0,0.7,0.9,-0.1,22,EL
0362c29e,4,282,3.1,3,3,1,1,2,7,-5,3.6,6.8,-3.2,22,EL
03b6afa9,6,469,5.2,5,5,1,0,6,7,-1,10.1,6.8,3.4,22,EL
03f946ed,7,342,3.8,4,2,3,1,13,5,8,10.0,5.1,5.0,22,EL
048a1cbc,1,90,1.0,1,1,0,1,2,4,-2,1.5,2.1,-0.6,22,EL
04e17fd5,4,219,2.4,2,0,2,0,1,1,0,2.8,2.7,0.1,22,EL
056269d7,2,140,1.6,2,0,0,4,1,3,-2,3.4,2.0,1.5,22,EL
05bffdb1,6,540,6.0,6,6,0,0,4,9,-5,4.7,12.1,-7.4,22,EL
05d548d8,2,180,2.0,2,2,0,0,4,6,-2,5.1,3.8,1.4,22,EL
0683f364,5,357,4.0,4,1,1,0,2,8,-6,3.8,7.7,-3.9,22,EL
068f4dec,4,90,1.0,0,0,4,2,1,0,1,1.7,0.3,1.5,22,EL
06df8256,6,472,5.2,5,4,1,1,6,5,1,6.7,5.4,1.2,22,EL
072e68ed,3,270,3.0,3,3,0,0,3,6,-3,7.7,4.6,3.1,22,EL
0743d0ec,3,270,3.0,3,3,0,2,5,3,2,2.9,3.1,-0.2,22,EL
080440a4,9,757,8.4,9,8,0,2,14,8,6,14.8,13.4,1.4,22,EL
08c982a0,3,162,1.8,3,1,0,3,0,2,-2,0.8,3.2,-2.4,22,EL
0a084b35,3,270,3.0,3,3,0,1,8,9,-1,5.2,5.5,-0.3,22,EL
0a215326,4,254,2.8,4,1,0,0,4,4,0,2.4,5.7,-3.3,22,EL
0a89e877,6,445,4.9,5,1,1,0,7,5,2,8.5,5.6,2.9,22,EL
0a98ecc2,1,4,0.0,0,0,1,4,0,0,0,0.5,0.1,0.4,22,EL
0b243559,4,268,3.0,3,0,1,2,3,2,1,4.6,1.6,3.0,22,EL
0b5a292a,5,305,3.4,4,3,1,0,7,8,-1,6.1,6.4,-0.3,22,EL
0c2ac3cb,2,159,1.8,2,0,0,0,3,3,0,1.6,2.4,-0.8,22,EL
0c5c94d0,3,183,2.0,2,1,1,0,0,1,-1,1.4,4.5,-3.1,22,EL
0c7a48f8,6,430,4.8,5,2,1,2,8,4,4,9.2,6.9,2.3,22,EL
0cadc46d,3,109,1.2,0,0,3,3,1,1,0,3.9,1.2,2.6,22,EL
0cb29e91,1,66,0.7,1,0,0,4,1,0,1,1.0,0.3,0.7,22,EL
0cc07deb,1,14,0.2,0,0,1,1,0,1,-1,0.0,0.4,-0.4,22,EL
0ceb43f6,4,341,3.8,4,2,0,1,7,7,0,4.5,8.4,-3.8,22,EL
0d9b2d31,6,479,5.3,6,4,0,0,8,6,2,9.4,5.4,3.9,22,EL
0da6a13e,5,324,3.6,4,2,1,1,1,6,-5,4.2,4.2,0.1,22,EL
0de73fa4,4,136,1.5,2,0,2,0,3,6,-3,2.4,4.2,-1.8,22,EL
0df2b165,14,1132,12.6,12,10,2,1,20,13,7,18.7,17.4,1.4,22,EL
0eb83e1a,2,210,2.3,2,2,0,0,2,2,0,2.4,3.9,-1.5,22,EL
0f888175,4,171,1.9,1,1,3,2,1,2,-1,1.1,3.6,-2.6,22,EL
10072610,4,341,3.8,4,3,0,4,8,6,2,6.9,6.4,0.5,22,EL
10549b49,2,36,0.4,0,0,2,0,0,1,-1,0.7,0.6,0.1,22,EL
10b26721,1,2,0.0,0,0,1,0,0,0,0,0.0,0.0,0.0,22,EL
10fe831e,3,186,2.1,2,2,1,0,1,4,-3,1.4,6.0,-4.6,22,EL
1124ac8a,1,90,1.0,1,1,0,5,3,2,1,1.8,2.7,-0.9,22,EL
116c35df,2,143,1.6,2,0,0,0,3,6,-3,4.7,3.7,1.1,22,EL
118b60ce,1,90,1.0,1,1,0,1,0,0,0,1.1,0.8,0.3,22,EL
121101a4,1,90,1.0,1,1,0,3,1,0,1,1.1,0.7,0.4,22,EL
1295b5e3,6,533,5.9,6,5,0,0,5,8,-3,7.3,8.5,-1.2,22,EL
12c35abe,12,379,4.2,2,0,10,1,5,5,0,4.0,7.2,-3.2,22,EL
1339039e,5,338,3.8,4,2,1,0,7,9,-2,6.7,8.7,-2.0,22,EL
133faa84,8,720,8.0,8,8,0,0,8,5,3,8.0,13.5,-5.5,22,EL
13c8e5f6,6,413,4.6,5,3,1,0,3,7,-4,2.9,8.0,-5.1,22,EL
13ea2544,8,572,6.4,7,2,1,0,6,9,-3,7.0,8.8,-1.8,22,EL
1443ca7d,1,29,0.3,0,0,1,5,0,0,0,0.3,0.2,0.0,22,EL
149c5f5d,4,112,1.2,1,1,3,2,3,1,2,3.0,1.4,1.6,22,EL
14e8fe86,4,188,2.1,2,1,2,1,1,2,-1,2.4,4.2,-1.8,22,EL
15944afd,5,241,2.7,3,1,2,2,3,2,1,5.0,4.5,0.5,22,EL
15b287da,13,1105,12.3,12,8,1,0,19,12,7,20.5,17.4,3.1,22,EL
15d0c248,7,630,7.0,7,7,0,1,8,7,1,10.7,8.7,1.9,22,EL
16380240,2,141,1.6,2,0,0,1,3,3,0,4.3,2.3,2.0,22,EL
169f5976,3,128,1.4,1,0,2,1,1,4,-3,1.7,2.0,-0.3,22,EL
16e9d0ea,7,397,4.4,3,3,4,1,7,9,-2,5.9,7.3,-1.4,22,EL
172bab0a,3,145,1.6,1,0,2,1,2,0,2,1.3,1.7,-0.5,22,EL
173eb3cd,6,397,4.4,5,2,1,0,4,11,-7,4.6,8.6,-4.0,22,EL
1774c547,2,26,0.3,0,0,2,0,1,0,1,1.2,1.1,0.1,22,EL
182a8b9d,1,90,1.0,1,1,0,8,0,1,-1,0.7,1.1,-0.4,22,EL
1880614f,5,445,4.9,5,4,0,1,4,3,1,9.1,3.3,5.8,22,EL
1900032e,3,189,2.1,2,2,1,1,2,4,-2,2.6,3.7,-1.1,22,EL
19053e31,7,303,3.4,3,0,4,1,4,4,0,5.0,4.4,0.6,22,EL
1944818c,9,694,7.7,8,5,1,3,14,9,5,14.3,9.9,4.3,22,EL
1971591f,4,301,3.3,4,0,0,0,7,5,2,4.5,4.4,0.1,22,EL
197640fd,5,450,5.0,5,5,0,1,8,8,0,8.3,6.2,2.2,22,EL
19a967ab,7,689,7.7,7,6,0,0,11,6,5,12.2,10.9,1.2,22,EL
19cae58d,5,230,2.6,2,1,3,0,2,5,-3,4.3,3.9,0.4,22,EL
1a4ef233,4,347,3.9,4,3,0,1,8,6,2,8.3,3.6,4.6,22,EL
1b280c66,1,90,1.0,1,1,0,3,2,1,1,1.2,1.6,-0.4,22,EL
1bacc518,6,384,4.3,4,2,2,0,10,5,5,10.2,3.8,6.4,22,EL
1bda5842,7,460,5.1,6,2,1,1,7,6,1,8.0,5.5,2.6,22,EL
1c07b06e,6,366,4.1,4,3,2,2,7,5,2,6.3,7.1,-0.9,22,EL
1c7012b8,10,896,10.0,10,7,0,1,16,7,9,17.3,12.3,5.0,22,EL
1c78737d,2,10,0.1,0,0,2,0,0,0,0,0.4,0.0,0.4,22,EL
1d2d5cc8,1,90,1.0,1,1,0,5,1,0,1,2.3,0.3,1.9,22,EL
1d54e8f8,5,398,4.4,5,2,0,0,5,5,0,4.9,5.2,-0.3,22,EL
1dff86ec,2,39,0.4,0,0,2,2,1,1,0,0.8,0.9,-0.1,22,EL
1e8dbb59,6,299,3.3,3,2,3,2,3,1,2,4.6,3.7,0.9,22,EL
1e9aa637,2,50,0.6,0,0,2,4,0,1,-1,1.3,1.9,-0.6,22,EL
1ec7e1c5,4,360,4.0,4,4,0,6,10,2,8,8.5,3.8,4.7,22,EL
1eecc0c6,4,306,3.4,4,1,0,0,6,4,2,5.1,4.3,0.8,22,EL
1f1229a9,4,192,2.1,2,1,2,1,2,6,-4,2.2,5.4,-3.2,22,EL
1f2d714c,5,93,1.0,1,0,4,6,1,3,-2,0.6,2.7,-2.1,22,EL
1f3afdcb,5,303,3.4,3,3,2,3,7,4,3,6.8,3.5,3.4,22,EL
1f9328da,3,246,2.7,3,2,0,1,2,4,-2,3.0,4.4,-1.4,22,EL
1fd1df9c,5,288,3.2,3,2,2,1,0,3,-3,1.4,4.5,-3.1,22,EL
20030c06,4,360,4.0,4,4,0,0,7,5,2,8.7,6.3,2.4,22,EL
200e89e1,4,112,1.2,0,0,4,0,1,0,1,2.9,0.4,2.5,22,EL
20b9f052,5,450,5.0,5,5,0,1,5,7,-2,9.9,5.2,4.7,22,EL
20dbf9e0,4,48,0.5,0,0,4,1,1,0,1,2.1,1.1,1.0,22,EL
20de219a,1,90,1.0,1,1,0,6,1,1,0,1.8,2.5,-0.6,22,EL
211589b8,1,1,0.0,0,0,1,0,0,0,0,0.1,0.0,0.1,22,EL
21164a21,4,270,3.0,3,2,1,2,3,6,-3,4.8,5.2,-0.3,22,EL
21166ff4,6,495,5.5,5,5,1,0,11,11,0,11.1,6.2,4.9,22,EL
222dfffb,8,665,7.4,7,6,1,0,8,11,-3,8.2,10.9,-2.7,22,EL
22798128,5,353,3.9,4,2,1,0,4,6,-2,3.3,5.6,-2.4,22,EL
228b0d9d,8,622,6.9,7,5,1,0,11,10,1,13.1,9.3,3.8,22,EL
230a2fac,8,720,8.0,8,8,0,0,18,15,3,17.1,12.3,4.8,22,EL
230f0471,2,115,1.3,1,1,1,4,1,1,0,0.5,2.2,-1.7,22,EL
24051310,4,360,4.0,4,4,0,0,5,5,0,6.2,6.8,-0.6,22,EL
240c8ab6,1,2,0.0,0,0,1,6,0,0,0,0.0,0.1,-0.1,22,EL
24228180,7,520,5.8,7,2,0,0,9,9,0,8.8,9.1,-0.3,22,EL
244a31b9,1,53,0.6,1,0,0,0,1,1,0,0.5,0.9,-0.3,22,EL
24d9435b,3,188,2.1,2,2,1,2,3,5,-2,3.5,4.6,-1.0,22,EL
2506009f,2,210,2.3,2,2,0,0,2,2,0,2.4,3.9,-1.5,22,EL
25146df0,3,181,2.0,2,2,1,3,2,1,1,3.7,2.7,1.1,22,EL
258aff54,6,442,4.9,5,3,1,0,1,7,-6,2.6,8.2,-5.6,22,EL
25b74470,5,229,2.5,2,0,3,3,4,2,2,3.2,3.1,0.1,22,EL
25e6f8cb,6,506,5.6,6,5,0,0,6,9,-3,7.2,8.0,-0.9,22,EL
25ef5b47,6,229,2.5,2,0,4,0,1,4,-3,1.2,4.4,-3.2,22,EL
262e5a82,3,138,1.5,1,1,2,2,4,2,2,3.9,2.8,1.1,22,EL
264b6d64,2,18,0.2,0,0,2,3,0,0,0,0.1,0.6,-0.5,22,EL
2690dffa,2,91,1.0,0,0,2,3,1,3,-2,0.4,3.4,-3.0,22,EL
26f6dca8,10,673,7.5,9,0,1,1,16,4,12,15.5,8.9,6.6,22,EL
270c700c,1,4,0.0,0,0,1,0,0,0,0,0.0,0.0,0.0,22,EL
27e6fbbc,1,16,0.2,0,0,1,5,0,0,0,0.5,0.2,0.3,22,EL
27ff9bdb,3,225,2.5,3,1,0,0,4,7,-3,5.5,5.4,0.1,22,EL
284f2ce6,3,270,3.0,3,3,0,3,2,8,-6,3.8,7.2,-3.4,22,EL
28b1f3ce,3,267,3.0,3,2,0,0,4,4,0,5.2,4.4,0.8,22,EL
28eaa0f3,6,540,6.0,6,6,0,0,6,10,-4,6.5,10.5,-4.0,22,EL
28eea0fc,2,83,0.9,0,0,2,0,0,1,-1,1.8,2.4,-0.6,22,EL
29d8ad3f,3,263,2.9,3,2,0,2,0,4,-4,2.3,7.2,-4.9,22,EL
29fbdc88,6,493,5.5,6,2,0,0,8,6,2,7.0,7.8,-0.7,22,EL
2a0c8ba4,3,230,2.6,2,2,1,0,1,2,-1,2.8,3.6,-0.8,22,EL
2a1beb34,6,521,5.8,6,5,0,0,10,6,4,8.7,7.4,1.4,22,EL
2a70dcc9,2,39,0.4,0,0,2,4,0,0,0,0.2,0.4,-0.2,22,EL
2ab7149e,4,210,2.3,2,1,2,8,1,5,-4,2.7,3.4,-0.7,22,EL
2b09d998,4,154,1.7,2,1,2,1,3,1,2,2.3,0.8,1.5,22,EL
2b1c4abd,4,149,1.7,2,1,2,1,4,7,-3,3.4,4.8,-1.4,22,EL
2ba38347,1,21,0.2,0,0,1,3,0,0,0,0.1,0.3,-0.2,22,EL
2bed3eab,5,429,4.8,5,4,0,1,4,6,-2,8.8,4.4,4.4,22,EL
2bef2bca,5,350,3.9,4,3,1,0,7,6,1,6.1,4.9,1.2,22,EL
2c320058,3,89,1.0,1,0,2,2,2,1,1,1.9,0.9,1.1,22,EL
2c56a792,3,125,1.4,2,0,1,3,1,2,-1,2.1,1.0,1.1,22,EL
2c5f04ba,6,422,4.7,6,2,0,0,3,7,-4,4.1,11.1,-7.0,22,EL
2cb77ec6,3,249,2.8,3,1,0,1,2,4,-2,1.9,4.1,-2.2,22,EL
2ce71308,4,291,3.2,4,0,0,1,2,4,-2,2.8,6.9,-4.1,22,EL
2d54d501,3,42,0.5,0,0,3,3,0,1,-1,0.2,1.1,-0.9,22,EL
2d6e535f,3,270,3.0,3,3,0,0,4,7,-3,3.2,7.0,-3.8,22,EL
2db2fd7b,3,195,2.2,3,0,0,3,5,3,2,4.3,1.0,3.3,22,EL
2dce876a,1,10,0.1,0,0,1,3,0,1,-1,0.0,0.6,-0.5,22,EL
2de6641f,1,7,0.1,0,0,1,3,0,0,0,0.6,0.0,0.6,22,EL
2f3452eb,7,478,5.3,5,4,2,1,8,4,4,11.4,5.9,5.5,22,EL
2f557579,5,345,3.8,5,0,0,0,6,7,-1,6.2,5.2,0.9,22,EL
2f965a72,11,1020,11.3,11,11,0,1,16,8,8,20.0,14.9,5.1,22,EL
2fabebc0,1,90,1.0,1,1,0,1,2,3,-1,1.2,1.3,0.0,22,EL
2ff76adc,6,494,5.5,6,4,0,0,9,7,2,8.2,6.5,1.7,22,EL
2ffa6348,4,223,2.5,2,2,2,2,3,4,-1,3.3,3.1,0.2,22,EL
30941e96,6,466,5.2,5,4,1,0,8,7,1,9.5,7.5,2.1,22,EL
30af8b93,8,600,6.7,7,4,1,0,7,7,0,9.1,8.4,0.7,22,EL
30e03a25,2,210,2.3,2,2,0,0,2,2,0,2.4,3.9,-1.5,22,EL
313d5ee5,5,353,3.9,5,1,0,1,3,7,-4,3.3,8.1,-4.8,22,EL
316de854,13,1141,12.7,12,9,1,0,21,13,8,20.6,17.1,3.5,22,EL
31f5b89b,2,146,1.6,2,1,0,3,3,4,-1,3.4,2.8,0.6,22,EL
32314605,4,271,3.0,3,1,1,1,0,5,-5,1.8,7.2,-5.3,22,EL
328f7d51,15,1105,12.3,13,3,2,0,21,11,10,20.4,16.6,3.8,22,EL
32c0491f,2,126,1.4,2,0,0,0,1,4,-3,2.3,1.7,0.6,22,EL
32fb87b4,4,318,3.5,4,2,0,2,5,8,-3,6.3,7.8,-1.5,22,EL
33182cb8,6,390,4.3,4,2,2,0,5,9,-4,5.3,9.2,-3.9,22,EL
332695f4,2,180,2.0,2,2,0,2,2,2,0,2.7,3.2,-0.5,22,EL
33508c78,1,45,0.5,0,0,1,0,1,0,1,0.9,0.1,0.8,22,EL
33591ff0,6,333,3.7,3,2,3,0,2,7,-5,4.2,9.7,-5.5,22,EL
3376a776,1,49,0.5,1,0,0,0,3,1,2,1.4,0.5,0.9,22,EL
339fe0e8,8,720,8.0,8,8,0,0,10,7,3,14.0,9.6,4.4,22,EL
33a6a650,7,585,6.5,6,6,1,1,7,7,0,8.1,8.4,-0.3,22,EL
33b11df6,2,180,2.0,2,2,0,0,2,3,-1,2.3,2.1,0.3,22,EL
33bd3dae,6,247,2.7,2,1,4,0,1,5,-4,4.4,4.1,0.3,22,EL
34ccf6fa,2,180,2.0,2,2,0,0,1,1,0,3.3,3.1,0.1,22,EL
34e393f2,9,716,8.0,7,7,2,1,10,11,-1,11.1,11.4,-0.3,22,EL
35862524,2,163,1.8,1,0,1,0,2,0,2,1.5,2.2,-0.7,22,EL
3594a357,1,1,0.0,0,0,1,1,0,0,0,0.1,0.1,0.0,22,EL
35d64857,11,854,9.5,10,7,1,1,15,10,5,15.5,12.7,2.8,22,EL
35f67791,7,330,3.7,3,0,4,1,5,3,2,5.0,5.9,-0.9,22,EL
360e3062,5,450,5.0,5,5,0,0,4,9,-5,7.5,8.1,-0.6,22,EL
3642b47f,3,224,2.5,2,1,1,0,1,6,-5,1.2,4.2,-3.1,22,EL
36463103,1,90,1.0,1,1,0,1,2,0,2,1.4,0.9,0.5,22,EL
36a3ff67,2,166,1.8,2,0,0,0,4,6,-2,5.0,3.8,1.2,22,EL
36a79857,6,400,4.4,5,1,1,0,2,11,-9,3.6,9.0,-5.4,22,EL
3708e9fa,7,333,3.7,2,0,5,0,5,3,2,6.4,3.9,2.5,22,EL
374d5158,2,60,0.7,1,0,1,0,0,1,-1,0.3,0.8,-0.5,22,EL
374ee424,5,450,5.0,5,5,0,3,8,4,4,10.1,3.6,6.5,22,EL
37d0048f,10,546,6.1,7,0,3,0,8,8,0,7.4,10.4,-3.0,22,EL
37dc1a48,9,585,6.5,7,0,2,2,12,6,6,13.3,7.4,6.0,22,EL
393a257c,4,276,3.1,4,3,0,0,4,4,0,3.5,3.0,0.5,22,EL
3b0108d6,1,90,1.0,1,1,0,13,1,1,0,0.5,1.0,-0.6,22,EL
3b029691,4,224,2.5,2,1,2,0,3,2,1,4.3,3.3,1.0,22,EL
3b12b11f,1,8,0.1,0,0,1,5,1,0,1,0.5,0.0,0.5,22,EL
3b333ac3,6,454,5.0,5,5,1,0,8,5,3,7.0,7.1,-0.1,22,EL
3ca7254a,8,483,5.4,5,1,3,0,9,7,2,9.7,7.5,2.2,22,EL
3cdfc63e,6,540,6.0,6,6,0,0,5,12,-7,5.3,11.1,-5.8,22,EL
3ce20eda,5,507,5.6,5,4,0,1,7,4,3,6.4,10.5,-4.0,22,EL
3d6686f9,2,85,0.9,1,0,1,0,1,2,-1,0.6,2.8,-2.2,22,EL
3d6691dd,4,293,3.3,3,2,1,0,1,4,-3,2.2,7.8,-5.6,22,EL
3dd738a1,6,367,4.1,4,3,2,2,5,3,2,5.2,5.0,0.3,22,EL
3e9e06cb,10,930,10.3,10,10,0,1,16,7,9,19.3,13.9,5.5,22,EL
3ea50f67,4,275,3.1,3,2,1,1,7,6,1,4.6,5.1,-0.6,22,EL
3ecc8c5f,6,540,6.0,6,6,0,0,4,11,-7,6.4,13.5,-7.1,22,EL
3ee0dd59,7,552,6.1,7,5,0,0,8,9,-1,11.7,8.5,3.2,22,EL
3ef0fa48,6,229,2.5,3,1,3,2,1,3,-2,4.1,3.3,0.8,22,EL
3efaa30d,3,132,1.5,1,1,2,1,1,1,0,1.7,1.1,0.6,22,EL
3effaa34,6,306,3.4,4,1,2,0,7,3,4,6.6,2.7,3.9,22,EL
3f10bd22,4,247,2.7,2,1,2,0,1,2,-1,3.1,3.9,-0.8,22,EL
4030c7ae,5,450,5.0,5,5,0,0,3,9,-6,4.6,9.9,-5.3,22,EL
4037db79,6,465,5.2,5,2,1,0,2,5,-3,3.1,7.1,-4.0,22,EL
403f5d20,6,507,5.6,6,5,0,0,9,8,1,8.4,6.9,1.5,22,EL
4044e8d8,3,76,0.8,0,0,3,2,0,0,0,2.1,0.8,1.3,22,EL
40774c6b,5,270,3.0,3,1,2,1,3,4,-1,7.1,3.3,3.8,22,EL
40ab93b4,1,2,0.0,0,0,1,1,0,0,0,0.0,0.2,-0.2,22,EL
414b2ce4,3,87,1.0,1,0,2,4,0,1,-1,1.1,2.7,-1.6,22,EL
41d3704d,1,90,1.0,1,1,0,2,0,1,-1,0.7,1.1,-0.4,22,EL
41eebdf5,6,540,6.0,6,6,0,0,10,9,1,9.2,12.9,-3.7,22,EL
41f32541,2,150,1.7,2,1,0,0,3,2,1,2.3,2.4,-0.1,22,EL
42a55711,5,274,3.0,3,0,2,1,7,4,3,5.2,6.2,-1.0,22,EL
42dcf26d,2,180,2.0,2,2,0,4,1,1,0,3.9,0.6,3.4,22,EL
4352d221,6,540,6.0,6,6,0,0,7,7,0,10.1,6.7,3.4,22,EL
4374d81c,7,617,6.9,7,6,0,1,7,4,3,6.8,11.2,-4.4,22,EL
43b23d3a,6,53,0.6,0,0,6,0,1,2,-1,1.9,3.5,-1.6,22,EL
441197b8,11,969,10.8,10,8,1,0,15,10,5,15.2,13.6,1.6,22,EL
44150beb,3,50,0.6,0,0,3,4,1,1,0,0.4,1.6,-1.2,22,EL
4431aed2,7,521,5.8,7,4,0,0,8,4,4,9.7,6.8,2.9,22,EL
444940e2,5,374,4.2,4,4,1,0,6,4,2,7.3,8.5,-1.2,22,EL
448a3608,2,135,1.5,2,0,0,0,2,3,-1,1.6,1.7,-0.1,22,EL
4535e4bb,3,270,3.0,3,3,0,5,4,7,-3,3.5,6.8,-3.2,22,EL
45954ec7,3,252,2.8,3,2,0,1,5,3,2,5.4,3.4,2.0,22,EL
45963054,4,120,1.3,1,1,3,2,2,3,-1,3.8,2.0,1.8,22,EL
45bb4303,1,17,0.2,0,0,1,1,0,0,0,0.0,0.3,-0.3,22,EL
4601e194,6,540,6.0,6,6,0,0,10,8,2,11.8,6.4,5.4,22,EL
46152b69,7,551,6.1,6,5,1,0,9,6,3,8.7,8.4,0.3,22,EL
4737cebe,7,506,5.6,6,2,1,0,9,7,2,11.5,6.3,5.2,22,EL
4760b2f2,6,495,5.5,5,5,1,0,3,7,-4,3.7,9.4,-5.7,22,EL
47681787,4,254,2.8,3,1,1,2,7,5,2,4.2,3.6,0.6,22,EL
47af88b8,5,359,4.0,4,3,1,3,9,6,3,7.6,3.7,3.9,22,EL
47dbe004,6,437,4.9,6,1,0,0,3,9,-6,4.3,8.8,-4.5,22,EL
47fd5136,1,45,0.5,1,0,0,1,2,3,-1,0.8,0.8,0.0,22,EL
48d5bd33,5,336,3.7,5,0,0,1,8,4,4,5.1,3.0,2.1,22,EL
48df060a,1,1,0.0,0,0,1,1,0,0,0,0.0,0.0,0.0,22,EL
4980c6be,2,180,2.0,2,2,0,4,0,4,-4,0.8,5.8,-5.0,22,EL
49b45985,5,167,1.9,2,1,3,0,1,4,-3,0.9,4.7,-3.8,22,EL
49d028db,7,630,7.0,7,7,0,3,13,11,2,12.3,10.8,1.5,22,EL
49df363f,1,11,0.1,0,0,1,1,0,0,0,0.1,0.2,0.0,22,EL
4a5e83ad,6,506,5.6,6,4,0,0,1,9,-8,4.3,14.5,-10.2,22,EL
4b00cd47,6,540,6.0,6,6,0,0,3,10,-7,5.7,13.7,-8.0,22,EL
4b3e1a38,7,473,5.3,5,5,2,1,13,10,3,11.1,7.7,3.4,22,EL
4b5ed2f7,3,108,1.2,1,1,2,3,4,2,2,3.3,2.9,0.4,22,EL
4b77bb89,4,155,1.7,1,0,3,2,4,3,1,4.2,2.1,2.1,22,EL
4bd00a50,3,106,1.2,1,1,2,3,2,1,1,2.7,0.9,1.8,22,EL
4be0b467,4,151,1.7,1,0,3,0,3,2,1,2.3,2.0,0.4,22,EL
4c2a5d34,3,173,1.9,2,0,1,1,2,2,0,2.9,3.1,-0.2,22,EL
4c5b14d2,10,553,6.1,8,1,2,0,12,10,2,10.9,10.0,0.9,22,EL
4c5b714f,3,180,2.0,2,1,1,3,3,1,2,3.1,2.3,0.8,22,EL
4c6facae,12,1082,12.0,12,6,0,0,16,11,5,18.8,15.3,3.5,22,EL
4c78b5ed,8,428,4.8,6,0,2,0,5,5,0,6.1,5.7,0.4,22,EL
4c82730b,8,701,7.8,8,7,0,0,7,8,-1,10.3,9.6,0.7,22,EL
4d1666ff,4,390,4.3,4,4,0,0,4,4,0,5.2,6.1,-0.8,22,EL
4d982baf,8,328,3.6,4,0,4,0,6,7,-1,3.9,5.6,-1.6,22,EL
4da9191b,14,996,11.1,11,8,3,0,13,11,2,13.8,14.5,-0.8,22,EL
4dedd469,7,603,6.7,7,5,0,0,6,8,-2,8.7,8.4,0.3,22,EL
4e4b59a4,1,15,0.2,0,0,1,6,0,0,0,0.0,1.2,-1.2,22,EL
4e6dbac4,8,462,5.1,4,3,4,0,5,6,-1,8.7,6.2,2.5,22,EL
4f255115,7,585,6.5,7,6,0,0,6,6,0,8.2,7.3,0.9,22,EL
4f28a6ff,2,78,0.9,0,0,2,2,1,1,0,0.9,1.0,-0.1,22,EL
4f974391,9,696,7.7,9,6,0,1,12,5,7,14.5,7.5,6.9,22,EL
4fac8f81,6,540,6.0,6,6,0,0,6,9,-3,7.5,8.7,-1.2,22,EL
4fdf1fd9,1,34,0.4,0,0,1,2,0,0,0,0.5,0.2,0.3,22,EL
50871bcc,1,68,0.8,1,0,0,1,2,2,0,3.4,1.7,1.7,22,EL
50c1ff86,5,420,4.7,5,3,0,2,4,4,0,4.2,6.0,-1.8,22,EL
50ff205b,6,387,4.3,4,3,2,0,4,8,-4,8.4,6.2,2.3,22,EL
510c6a3f,6,540,6.0,6,6,0,0,9,8,1,8.7,7.1,1.5,22,EL
51ffa295,8,438,4.9,5,3,3,0,8,6,2,7.9,6.8,1.1,22,EL
5294a83f,8,482,5.4,6,1,2,0,8,5,3,8.5,7.8,0.7,22,EL
52b8ea30,1,20,0.2,0,0,1,5,0,0,0,0.0,0.4,-0.4,22,EL
52fdf512,6,540,6.0,6,6,0,0,2,11,-9,4.0,10.9,-6.9,22,EL
53070b63,6,334,3.7,4,1,2,2,7,3,4,7.2,3.8,3.4,22,EL
53af52f3,6,540,6.0,6,6,0,0,12,11,1,11.5,7.7,3.8,22,EL
53de807a,2,124,1.4,2,0,0,6,2,3,-1,1.0,2.5,-1.5,22,EL
53e360bb,4,360,4.0,4,4,0,2,3,7,-4,2.1,7.5,-5.3,22,EL
53e442e2,1,23,0.3,0,0,1,4,0,0,0,0.6,0.4,0.2,22,EL
53f1c5de,9,302,3.4,2,1,7,0,5,7,-2,4.2,6.0,-1.8,22,EL
540c9a17,6,377,4.2,5,1,1,0,4,5,-1,4.2,7.1,-2.9,22,EL
5458f670,1,4,0.0,0,0,1,5,0,0,0,0.9,0.4,0.4,22,EL
54b4dc4e,5,419,4.7,5,3,0,0,11,2,9,10.3,6.8,3.5,22,EL
5521f419,5,442,4.9,5,3,0,1,6,6,0,5.2,6.1,-0.9,22,EL
555d5edd,5,156,1.7,1,1,4,1,5,1,4,5.2,1.4,3.8,22,EL
55b93ae0,2,210,2.3,2,2,0,0,2,2,0,2.4,3.9,-1.5,22,EL
55c95c3e,3,160,1.8,2,0,1,2,1,0,1,1.3,1.2,0.1,22,EL
56208b05,5,450,5.0,5,5,0,0,10,13,-3,9.9,9.8,0.1,22,EL
5631b735,5,114,1.3,0,0,5,3,3,2,1,2.0,1.9,0.0,22,EL
563cbac0,6,540,6.0,6,6,0,0,7,7,0,10.1,6.7,3.4,22,EL
56413b1f,5,346,3.8,4,1,1,0,6,3,3,6.5,4.6,1.9,22,EL
56545648,3,86,1.0,1,0,2,2,3,1,2,1.7,1.1,0.7,22,EL
56901a62,1,90,1.0,1,1,0,5,3,2,1,1.8,2.7,-0.9,22,EL
56b1933d,2,23,0.3,0,0,2,4,0,0,0,0.4,0.1,0.3,22,EL
56f6f826,14,1320,14.7,14,14,0,0,23,15,8,23.9,19.5,4.3,22,EL
56f7a928,5,365,4.1,4,2,1,0,7,9,-2,8.4,4.0,4.3,22,EL
56f99ec7,1,90,1.0,1,1,0,5,2,3,-1,0.7,1.2,-0.5,22,EL
5715bb71,6,478,5.3,6,2,0,0,6,6,0,8.8,5.6,3.2,22,EL
574fff8c,4,270,3.0,3,2,1,0,1,4,-3,3.6,3.6,0.1,22,EL
5777eca0,6,444,4.9,5,4,1,0,1,8,-7,2.7,9.7,-7.0,22,EL
577efaec,2,59,0.7,1,0,1,2,1,1,0,0.7,0.9,-0.2,22,EL
57d88cf9,2,180,2.0,2,2,0,0,4,6,-2,5.1,3.8,1.4,22,EL
57df7a11,4,142,1.6,2,0,2,8,2,1,1,4.8,1.7,3.1,22,EL
58027adc,2,112,1.2,1,1,1,1,0,2,-2,0.7,2.0,-1.3,22,EL
58a9a4d9,4,205,2.3,1,1,3,0,1,1,0,2.3,3.0,-0.6,22,EL
58ae47b2,4,293,3.3,3,3,1,1,2,2,0,5.5,2.9,2.6,22,EL
58f077c0,8,720,8.0,8,8,0,0,11,9,2,11.0,10.9,0.1,22,EL
595e6f3e,7,190,2.1,2,0,5,1,0,0,0,1.8,3.1,-1.4,22,EL
5976f83e,5,275,3.1,3,2,2,0,8,4,4,7.0,2.9,4.0,22,EL
5a04fd92,12,498,5.5,4,2,8,0,5,2,3,9.8,6.1,3.7,22,EL
5a068ec6,5,311,3.5,3,2,2,0,9,8,1,5.7,8.8,-3.1,22,EL
5ab0ea87,6,402,4.5,4,3,2,0,9,6,3,9.5,5.1,4.4,22,EL
5ad50391,6,510,5.7,6,4,0,0,9,7,2,9.6,6.9,2.7,22,EL
5b3d1a7a,10,657,7.3,7,3,3,0,14,9,5,13.5,9.9,3.6999999999999997,22,EL
5b479568,7,311,3.5,3,0,4,0,3,3,0,2.6,4.3,-1.8,22,EL
5b5c2228,4,256,2.8,3,2,1,0,3,6,-3,4.3,5.9,-1.6,22,EL
5b9512c5,6,540,6.0,6,6,0,4,7,7,0,10.9,6.0,4.9,22,EL
5c397195,6,450,5.0,6,1,0,0,6,8,-2,4.9,7.0,-2.1,22,EL
5c74c0f5,4,191,2.1,2,0,2,2,2,4,-2,4.4,2.2,2.2,22,EL
5c7845f6,7,570,6.3,6,6,1,1,9,7,2,11.0,6.9,4.1,22,EL
5c78cb9e,6,493,5.5,6,4,0,0,3,8,-5,3.2,9.2,-6.0,22,EL
5ca20b7a,7,493,5.5,6,3,1,1,11,10,1,7.5,8.5,-0.9,22,EL
5caa62a7,5,255,2.8,2,2,3,1,2,4,-2,4.3,3.8,0.4,22,EL
5cdddffa,4,315,3.5,4,3,0,0,3,4,-1,8.1,3.9,4.2,22,EL
5ce0b5ba,1,1,0.0,0,0,1,2,0,0,0,0.0,0.0,0.0,22,EL
5ceba7fc,10,629,7.0,7,5,3,0,14,8,6,15.8,6.4,9.5,22,EL
5cec2487,4,285,3.2,3,3,1,1,8,6,2,6.4,5.5,0.9,22,EL
5cfec13d,3,270,3.0,3,3,0,0,5,8,-3,7.3,6.7,0.7,22,EL
5d4f7d61,3,65,0.7,0,0,3,0,3,1,2,2.1,1.2,0.9,22,EL
5ddb8f9f,2,112,1.2,1,1,1,10,1,1,0,1.1,2.5,-1.4,22,EL
5dfc6ad5,2,50,0.6,1,0,1,0,0,2,-2,0.8,1.9,-1.1,22,EL
5e167a35,6,419,4.7,5,1,1,0,2,8,-6,3.1,7.9,-4.8,22,EL
5e42afa3,6,426,4.7,5,3,1,0,2,7,-5,3.8,11.2,-7.4,22,EL
5e7fff2d,3,200,2.2,3,2,0,0,2,3,-1,1.9,5.1,-3.2,22,EL
5e861944,5,189,2.1,1,0,4,1,10,3,7,5.0,1.9,3.1,22,EL
5e8936be,7,630,7.0,7,7,0,0,7,8,-1,9.5,9.7,-0.2,22,EL
5ea8ef20,6,492,5.5,6,3,0,0,6,6,0,11.1,5.1,6.0,22,EL
5eb77bef,4,85,0.9,0,0,4,2,1,3,-2,2.2,2.1,0.1,22,EL
5ef3d210,1,3,0.0,0,0,1,3,0,0,0,0.0,0.0,0.0,22,EL
5f09991f,8,698,7.8,8,5,0,0,8,5,3,7.5,12.2,-4.7,22,EL
5f3d00d1,9,419,4.7,4,0,5,2,7,4,3,9.6,4.4,5.2,22,EL
5fcb90ac,4,342,3.8,4,3,0,0,3,10,-7,4.0,7.8,-3.8,22,EL
6011e63a,1,4,0.0,0,0,1,0,0,0,0,0.1,0.0,0.0,22,EL
60c07b31,4,204,2.3,2,1,2,4,3,2,1,3.2,1.5,1.7,22,EL
617f2e27,1,18,0.2,0,0,1,0,0,0,0,0.7,0.2,0.5,22,EL
62d0dcc5,5,156,1.7,1,0,4,1,2,1,1,1.7,2.8,-1.1,22,EL
6412cc03,3,146,1.6,2,1,1,1,2,2,0,2.7,2.7,0.0,22,EL
6421ec64,5,309,3.4,4,1,1,1,8,3,5,7.5,2.8,4.7,22,EL
6438d426,7,303,3.4,4,0,3,1,2,3,-1,2.2,4.6,-2.4,22,EL
64748421,1,1,0.0,0,0,1,1,0,0,0,0.0,0.0,0.0,22,EL
64b08de7,5,178,2.0,1,1,4,0,4,6,-2,3.0,5.0,-2.0,22,EL
64f69877,8,601,6.7,7,3,1,0,6,5,1,9.7,7.9,1.9,22,EL
6510079f,4,302,3.4,4,0,0,0,4,5,-1,4.2,4.8,-0.6,22,EL
65159211,2,109,1.2,1,0,1,0,0,0,0,1.1,1.3,-0.2,22,EL
6603fed7,12,1117,12.4,12,10,0,0,18,15,3,17.4,19.3,-1.9,22,EL
6613c819,11,876,9.7,9,8,2,0,17,6,11,17.9,12.3,5.6,22,EL
6637e6a7,6,275,3.1,3,2,3,0,2,2,0,4.2,7.0,-2.8,22,EL
66c52a77,5,310,3.4,4,0,1,1,6,7,-1,7.2,5.8,1.5,22,EL
6800f515,5,361,4.0,4,3,1,0,9,10,-1,8.4,7.8,0.6,22,EL
683a8f5f,2,122,1.4,2,0,0,0,1,2,-1,1.9,2.5,-0.6,22,EL
6853490f,2,180,2.0,2,2,0,0,2,3,-1,2.3,2.1,0.3,22,EL
688fcea2,4,69,0.8,0,0,4,4,1,0,1,2.0,1.8,0.3,22,EL
691f64f5,5,297,3.3,4,0,1,2,4,1,3,3.1,4.7,-1.6,22,EL
692cd6de,4,359,4.0,4,3,0,1,3,7,-4,3.5,8.5,-5.0,22,EL
697dc00a,7,609,6.8,7,6,0,0,10,9,1,9.8,10.0,-0.1,22,EL
6af56975,1,120,1.3,1,1,0,0,0,2,-2,1.0,3.0,-2.0,22,EL
6afcaaa3,6,440,4.9,5,2,1,0,2,7,-5,3.4,8.5,-5.1,22,EL
6b0802ea,5,47,0.5,0,0,5,1,1,0,1,0.6,0.3,0.3,22,EL
6b21b7b5,2,31,0.3,0,0,2,0,0,0,0,0.4,0.0,0.4,22,EL
6b47c5db,4,302,3.4,3,2,1,0,7,6,1,6.1,5.0,1.1,22,EL
6b8887c2,2,37,0.4,0,0,2,0,1,0,1,0.4,0.1,0.3,22,EL
6b88c810,5,282,3.1,4,1,1,1,3,7,-4,3.6,6.3,-2.7,22,EL
6b994195,8,630,7.0,8,6,0,0,11,8,3,9.7,10.0,-0.3,22,EL
6bb2c084,5,357,4.0,4,1,1,0,7,7,0,9.0,5.4,3.6,22,EL
6be813ab,5,228,2.5,2,2,3,1,1,3,-2,2.1,7.1,-4.9,22,EL
6c249ea7,8,720,8.0,8,8,0,0,9,12,-3,8.7,11.5,-2.8,22,EL
6c8ddd52,3,244,2.7,3,2,0,0,1,2,-1,1.2,5.2,-4.0,22,EL
6cbf8d0d,10,513,5.7,6,0,4,1,5,4,1,6.0,7.6,-1.6,22,EL
6ce43701,2,67,0.7,0,0,2,0,2,2,0,1.0,0.3,0.7,22,EL
6de23ab0,4,228,2.5,2,2,2,0,7,1,6,6.6,2.6,4.0,22,EL
6e4df551,2,180,2.0,2,2,0,0,3,2,1,2.7,2.6,0.1,22,EL
6eee05f1,4,329,3.7,3,2,1,1,9,3,6,5.4,2.2,3.2,22,EL
6f3cc2fe,4,122,1.4,1,0,3,0,0,2,-2,1.2,4.2,-2.9,22,EL
6f4e1c93,3,270,3.0,3,3,0,3,6,7,-1,5.9,6.6,-0.6,22,EL
6f51e382,6,540,6.0,6,6,0,0,10,8,2,11.8,6.4,5.4,22,EL
6f5f82c0,6,233,2.6,2,1,4,2,2,1,1,6.4,1.9,4.5,22,EL
6fd8a334,7,630,7.0,7,7,0,0,7,8,-1,9.5,9.7,-0.2,22,EL
6ff91a3a,4,179,2.0,2,1,2,2,2,1,1,3.8,1.1,2.7,22,EL
7120a04d,2,72,0.8,0,0,2,0,1,1,0,2.1,0.3,1.8,22,EL
712dd708,14,1090,12.1,12,8,2,1,17,14,3,18.5,16.4,2.1,22,EL
7155e3e1,6,251,2.8,3,1,3,0,1,3,-2,5.2,1.5,3.7,22,EL
716e7308,1,2,0.0,0,0,1,2,0,0,0,0.0,0.0,0.0,22,EL
7220ffd7,2,180,2.0,2,2,0,1,2,0,2,2.1,1.1,1.0,22,EL
72984eee,3,170,1.9,2,0,1,1,3,4,-1,3.4,3.8,-0.4,22,EL
72a99e38,6,250,2.8,2,1,4,2,6,3,3,5.4,3.5,1.9,22,EL
72c01cfb,5,360,4.0,4,3,1,0,5,5,0,7.4,5.0,2.5,22,EL
73000a79,4,185,2.1,2,1,2,4,5,2,3,4.9,2.3,2.5,22,EL
73b9fa8a,2,99,1.1,1,0,1,0,2,3,-1,2.3,2.1,0.2,22,EL
73fc8cc3,3,52,0.6,0,0,3,1,1,0,1,0.4,1.2,-0.8,22,EL
745ca0a3,4,251,2.8,4,0,0,0,2,4,-2,5.6,2.8,2.8,22,EL
7483d9f9,6,540,6.0,6,6,0,0,9,8,1,8.7,7.1,1.5,22,EL
74d4cec6,9,502,5.6,5,0,4,3,9,7,2,8.8,9.2,-0.4,22,EL
74f2e748,7,546,6.1,6,4,1,0,15,8,7,11.6,9.5,2.1,22,EL
751a0fb5,5,426,4.7,5,3,0,0,6,6,0,7.9,5.2,2.7,22,EL
75645f0e,10,557,6.2,6,3,4,0,11,11,0,12.1,8.6,3.5,22,EL
75a72a99,1,58,0.6,1,0,0,2,3,2,1,2.9,0.7,2.2,22,EL
76c98b58,2,210,2.3,2,2,0,0,2,2,0,2.4,3.9,-1.5,22,EL
76ff8d0d,6,436,4.8,5,2,1,0,2,8,-6,7.0,6.2,0.8,22,EL
770d7eb8,7,523,5.8,6,3,1,1,6,10,-4,6.6,8.7,-2.0,22,EL
778ef829,3,240,2.7,3,1,0,0,2,4,-2,3.7,4.1,-0.4,22,EL
77bf714c,3,109,1.2,1,0,2,0,0,2,-2,1.2,3.3,-2.1,22,EL
780e3631,4,173,1.9,3,0,1,2,3,2,1,2.8,2.0,0.8,22,EL
78e68b4d,10,682,7.6,7,5,3,2,10,8,2,9.9,10.3,-0.4,22,EL
79083382,6,457,5.1,5,5,1,2,13,6,7,11.8,7.3,4.5,22,EL
794364d7,8,712,7.9,8,5,0,0,8,5,3,7.8,13.4,-5.7,22,EL
79c84d1c,9,590,6.6,6,4,3,0,13,5,8,12.7,9.0,3.7,22,EL
7a2cf111,4,213,2.4,3,1,1,0,5,2,3,4.9,1.8,3.1,22,EL
7a4cea18,5,91,1.0,0,0,5,2,2,3,-1,1.2,1.3,-0.1,22,EL
7b456af7,8,720,8.0,8,8,0,0,9,12,-3,8.7,11.5,-2.8,22,EL
7b4c1f6e,3,149,1.7,2,1,1,1,3,3,0,2.8,3.1,-0.4,22,EL
7b9ecf02,6,511,5.7,6,4,0,0,3,10,-7,5.4,13.2,-7.8,22,EL
7bb0fe4a,2,23,0.3,0,0,2,0,1,0,1,0.5,0.2,0.3,22,EL
7bcc0708,4,44,0.5,0,0,4,4,0,0,0,0.6,1.5,-0.9,22,EL
7be09c86,8,475,5.3,5,0,3,0,4,10,-6,5.199999999999999,11.200000000000001,-6.0,22,EL
7bf8ad6c,4,248,2.8,3,1,1,0,2,4,-2,1.4,4.4,-3.0,22,EL
7c104bb7,4,151,1.7,1,0,3,1,3,2,1,3.9,2.0,1.9,22,EL
7c2965bb,5,118,1.3,1,0,4,2,1,2,-1,1.7,1.1,0.6,22,EL
7c3ed041,2,96,1.1,1,1,1,4,1,0,1,2.4,0.6,1.8,22,EL
7c56da38,6,523,5.8,6,3,0,0,9,7,2,9.5,7.1,2.4,22,EL
7c7fdb0f,3,168,1.9,0,0,3,3,0,3,-3,2.5,3.3,-0.8,22,EL
7cb9de24,5,331,3.7,4,3,1,1,2,6,-4,2.3,6.5,-4.2,22,EL
7cd78926,4,346,3.8,4,3,0,0,3,6,-3,2.6,7.0,-4.5,22,EL
7d06360d,6,383,4.3,4,2,2,0,1,10,-9,1.9,7.4,-5.5,22,EL
7d08063d,5,198,2.2,2,0,3,3,5,3,2,3.8,2.0,1.8,22,EL
7d2d3329,1,26,0.3,0,0,1,5,1,1,0,0.2,0.7,-0.5,22,EL
7e56d3db,7,456,5.1,6,2,1,1,6,7,-1,6.8,7.3,-0.5,22,EL
7ee64741,6,435,4.8,5,3,1,0,4,8,-4,4.9,10.2,-5.3,22,EL
7ef181cf,2,65,0.7,1,0,1,0,1,1,0,0.5,0.4,0.1,22,EL
7f40333d,6,540,6.0,6,6,0,0,6,10,-4,6.5,10.5,-4.0,22,EL
7fa4e703,1,45,0.5,0,0,1,0,2,2,0,0.8,0.3,0.5,22,EL
7fe90ccd,4,331,3.7,4,1,0,2,4,5,-1,5.2,5.7,-0.6,22,EL
80490d7f,5,405,4.5,4,4,1,1,3,8,-5,6.1,6.8,-0.7,22,EL
80556f08,7,390,4.3,5,2,2,1,7,2,5,9.9,3.5,6.4,22,EL
807cb743,2,39,0.4,0,0,2,4,0,1,-1,0.0,0.9,-0.9,22,EL
8104e41e,3,196,2.2,2,2,1,0,2,1,1,2.4,1.8,0.6,22,EL
81442ecb,3,270,3.0,3,3,0,0,4,2,2,4.2,3.7,0.5,22,EL
816bdfdd,6,290,3.2,3,1,3,0,2,6,-4,2.6,6.6,-4.0,22,EL
819aa8e7,4,197,2.2,3,0,1,0,2,2,0,2.6,2.4,0.2,22,EL
81a4c239,2,33,0.4,0,0,2,4,0,0,0,0.4,0.1,0.3,22,EL
81d3318f,4,207,2.3,3,0,1,1,1,3,-2,2.5,6.3,-3.8,22,EL
822d51d7,5,329,3.7,4,1,1,1,4,3,1,4.1,3.7,0.4,22,EL
82518f62,5,234,2.6,2,2,3,1,8,3,5,4.6,1.7,2.9,22,EL
82671804,4,268,3.0,3,2,1,0,3,6,-3,7.1,4.2,2.9,22,EL
826e8b63,5,365,4.1,4,4,1,0,7,6,1,5.3,4.7,0.6,22,EL
82927de4,12,760,8.4,8,3,4,0,12,7,5,13.2,11.5,1.7,22,EL
82a39b66,4,221,2.5,2,0,2,0,2,3,-1,2.9,5.3,-2.4,22,EL
82b1198a,1,90,1.0,1,1,0,7,2,2,0,2.1,0.7,1.4,22,EL
82e9b1bb,3,136,1.5,1,1,2,2,0,1,-1,1.1,1.2,-0.1,22,EL
8321285a,2,77,0.9,1,0,1,4,0,3,-3,1.4,2.3,-1.0,22,EL
833a8fbc,3,137,1.5,1,1,2,1,1,2,-1,2.9,4.0,-1.1,22,EL
834d0be5,6,354,3.9,5,0,1,1,5,5,0,6.2,6.3,-0.2,22,EL
83e4643e,5,211,2.3,2,0,3,0,1,1,0,3.1,2.2,1.0,22,EL
84399660,7,326,3.6,3,1,4,3,10,11,-1,7.4,7.7,-0.3,22,EL
8494acc4,2,28,0.3,0,0,2,4,2,0,2,1.9,0.3,1.7,22,EL
849c826a,8,392,4.4,4,2,4,2,7,1,6,9.3,4.1,5.2,22,EL
85613cf0,5,350,3.9,4,2,1,0,5,6,-1,7.7,4.6,3.1,22,EL
85937928,5,409,4.5,5,2,0,0,2,8,-6,4.7,10.1,-5.4,22,EL
85bed4ee,3,122,1.4,1,0,2,2,2,4,-2,1.6,2.7,-1.1,22,EL
8696bc90,3,159,1.8,2,0,1,1,4,2,2,2.9,3.2,-0.3,22,EL
86b575a7,4,219,2.4,3,0,1,0,4,4,0,2.9,2.6,0.3,22,EL
86bf27f0,1,4,0.0,0,0,1,1,0,0,0,0.0,0.0,0.0,22,EL
86dd16a8,4,358,4.0,4,3,0,0,1,6,-5,4.0,9.0,-4.9,22,EL
871961e8,5,329,3.7,4,2,1,1,2,6,-4,2.3,6.1,-3.8,22,EL
87d8b5a3,4,178,2.0,2,0,2,0,1,4,-3,2.1,3.1,-1.0,22,EL
87f12e30,2,100,1.1,1,0,1,4,0,1,-1,1.0,1.3,-0.3,22,EL
88015937,2,32,0.4,0,0,2,1,0,0,0,1.1,0.7,0.5,22,EL
88062e83,4,267,3.0,3,1,1,2,2,5,-3,4.6,4.9,-0.3,22,EL
8827bf46,4,280,3.1,3,2,1,2,4,4,0,7.5,3.0,4.5,22,EL
88ced02c,5,450,5.0,5,5,0,0,10,13,-3,9.9,9.8,0.1,22,EL
89ac64a6,1,54,0.6,1,0,0,0,1,4,-3,1.1,1.9,-0.9,22,EL
89b2c8a9,6,236,2.6,2,1,4,1,5,2,3,6.5,3.3,3.2,22,EL
89f951b5,3,215,2.4,3,1,0,0,3,3,0,3.3,3.3,0.1,22,EL
8a3aabc1,4,276,3.1,4,1,0,2,1,6,-5,2.7,5.7,-3.0,22,EL
8a53d24b,5,172,1.9,2,1,3,1,2,2,0,3.6,2.5,1.0,22,EL
8a56c04c,6,409,4.5,4,3,2,0,4,9,-5,4.5,8.8,-4.2,22,EL
8a6ab963,1,90,1.0,1,1,0,5,0,1,-1,1.2,0.6,0.6,22,EL
8b0b02c9,2,74,0.8,1,0,1,0,3,0,3,2.3,1.1,1.2,22,EL
8b150514,1,45,0.5,0,0,1,3,0,0,0,0.0,0.6,-0.6,22,EL
8b47ce35,6,518,5.8,6,5,0,0,4,10,-6,8.2,8.7,-0.6,22,EL
8b529245,6,282,3.1,3,0,3,0,5,3,2,5.5,2.9,2.6,22,EL
8b788c01,3,177,2.0,2,0,1,0,3,2,1,2.5,3.1,-0.6,22,EL
8b8e759d,3,136,1.5,2,0,1,1,2,3,-1,2.0,3.5,-1.6,22,EL
8b929ec2,4,270,3.0,3,2,1,3,4,4,0,4.3,4.9,-0.6,22,EL
8babb812,6,383,4.3,4,2,2,0,4,5,-1,4.0,6.6,-2.5,22,EL
8bc373ea,7,585,6.5,7,6,0,0,8,8,0,7.2,10.1,-2.9,22,EL
8c3c640c,6,532,5.9,6,3,0,0,9,10,-1,8.0,9.1,-1.1,22,EL
8c5f1522,5,410,4.6,5,3,0,0,10,10,0,9.6,8.5,1.1,22,EL
8c725b43,7,660,7.3,7,7,0,2,11,10,1,11.4,10.4,1.0,22,EL
8c90fd7a,5,321,3.6,3,1,2,0,8,10,-2,6.7,6.7,0.1,22,EL
8cd49575,1,9,0.1,0,0,1,5,0,0,0,0.4,0.2,0.2,22,EL
8d3d3b0a,3,58,0.6,0,0,3,0,1,2,-1,1.8,1.1,0.7,22,EL
8d46713e,2,154,1.7,2,1,0,0,2,3,-1,2.0,1.6,0.3,22,EL
8d7fe72a,6,222,2.5,2,1,4,2,3,3,0,3.1,2.9,0.2,22,EL
8dcf77c0,6,416,4.6,6,1,0,1,5,3,2,5.0,7.3,-2.3,22,EL
8df5b30f,5,103,1.1,1,0,4,0,0,1,-1,1.8,2.2,-0.4,22,EL
8e34b9f5,2,180,2.0,2,2,0,1,2,2,0,3.0,2.0,0.9,22,EL
8e48dc61,3,222,2.5,2,1,1,4,4,3,1,2.8,1.9,0.8,22,EL
8e7f49d3,2,180,2.0,2,2,0,0,2,3,-1,2.3,2.1,0.3,22,EL
8e92be30,6,407,4.5,5,0,1,0,7,7,0,6.8,6.7,0.1,22,EL
8f696594,3,81,0.9,1,0,2,0,2,0,2,2.0,0.1,1.9,22,EL
8fb94908,2,198,2.2,2,0,0,0,2,2,0,2.4,3.8,-1.4,22,EL
8ff2354e,4,130,1.4,1,1,3,1,2,0,2,3.1,1.0,2.1,22,EL
8ff4872e,5,380,4.2,4,4,1,0,2,6,-4,2.9,7.4,-4.6,22,EL
90d7dda6,7,545,6.1,6,5,1,0,6,7,-1,9.0,7.7,1.3,22,EL
919dd4b1,5,74,0.8,0,0,5,3,1,1,0,2.5,1.4,1.2,22,EL
921f6058,4,292,3.2,3,3,1,0,2,3,-1,4.5,6.5,-2.0,22,EL
922da988,2,17,0.2,0,0,2,1,0,0,0,0.4,0.0,0.4,22,EL
92432bc6,2,31,0.3,0,0,2,0,1,1,0,1.1,1.1,0.1,22,EL
928a4a61,4,110,1.2,1,0,3,0,1,2,-1,1.8,1.6,0.2,22,EL
93088fbb,1,10,0.1,0,0,1,3,0,0,0,0.2,0.5,-0.3,22,EL
9319781b,8,684,7.6,6,6,2,3,12,5,7,12.8,10.6,2.1,22,EL
9328b835,1,90,1.0,1,1,0,9,2,0,2,1.9,0.4,1.5,22,EL
934e1968,5,157,1.7,1,0,4,1,3,1,2,4.7,1.4,3.3,22,EL
939bc634,3,270,3.0,3,3,0,2,4,2,2,5.7,2.6,3.2,22,EL
93e368f9,1,90,1.0,1,1,0,4,0,1,-1,0.3,2.3,-1.9,22,EL
93fffbcf,4,360,4.0,4,4,0,0,5,5,0,6.2,6.8,-0.6,22,EL
9413b19f,7,630,7.0,7,7,0,0,16,13,3,15.0,11.5,3.5,22,EL
942b4f90,7,362,4.0,4,1,3,1,6,4,2,7.9,5.2,2.7,22,EL
94f8d10c,3,270,3.0,3,3,0,3,4,6,-2,6.0,4.6,1.3,22,EL
951f1739,10,495,5.5,6,0,4,2,8,6,2,8.5,8.8,-0.3,22,EL
95efdac2,1,27,0.3,0,0,1,2,0,0,0,0.5,0.1,0.4,22,EL
95f7099e,2,13,0.1,0,0,2,2,1,0,1,0.1,0.0,0.1,22,EL
9614b550,6,453,5.0,5,5,1,0,7,7,0,8.9,6.3,2.6,22,EL
962e54cb,6,165,1.8,1,0,5,5,6,2,4,4.7,3.5,1.2,22,EL
9719d14f,2,99,1.1,1,1,1,4,0,1,-1,0.4,2.3,-1.9,22,EL
972aeb2a,6,540,6.0,6,6,0,0,6,7,-1,12.2,5.5,6.7,22,EL
972d595a,3,270,3.0,3,3,0,3,4,2,2,3.2,6.3,-3.1,22,EL
976e1238,1,20,0.2,0,0,1,5,0,0,0,0.0,0.4,-0.4,22,EL
97e2aa67,11,669,7.4,8,1,3,0,14,8,6,12.6,9.8,2.9,22,EL
97e996a7,5,450,5.0,5,5,0,1,6,9,-3,6.6,8.4,-1.8,22,EL
98ca4feb,5,193,2.1,2,0,3,1,1,3,-2,2.4,4.5,-2.1,22,EL
98d2c2c4,6,442,4.9,5,3,1,0,8,5,3,6.4,6.1,0.3,22,EL
99047b00,3,270,3.0,3,3,0,3,3,5,-2,4.4,4.2,0.2,22,EL
99a8ddc9,5,353,3.9,4,2,1,0,4,7,-3,3.7,8.0,-4.3,22,EL
9a28eba4,6,353,3.9,5,0,1,0,8,5,3,7.7,4.7,3.0,22,EL
9a2e0ccc,4,103,1.1,0,0,4,2,3,2,1,3.5,2.9,0.7,22,EL
9a64e67e,7,571,6.3,7,5,0,1,10,9,1,11.0,8.6,2.4,22,EL
9ab16552,7,495,5.5,5,4,2,6,9,6,3,7.9,6.5,1.4,22,EL
9ade9ce1,6,273,3.0,3,0,3,0,0,10,-10,1.3,5.6,-4.3,22,EL
9b6f7fd5,9,571,6.3,5,4,4,0,12,4,8,14.3,5.3,9.1,22,EL
9bd73cce,4,71,0.8,0,0,4,0,2,5,-3,2.0,2.8,-0.8,22,EL
9c74fa25,5,417,4.6,5,3,0,0,2,9,-7,4.4,9.7,-5.3,22,EL
9ca07baf,1,34,0.4,0,0,1,4,0,0,0,0.5,0.2,0.3,22,EL
9ceb7642,4,66,0.7,0,0,4,3,2,1,1,1.3,1.5,-0.3,22,EL
9d115f7a,2,122,1.4,2,0,0,0,1,4,-3,2.2,1.7,0.5,22,EL
9d689a5b,7,466,5.2,5,0,2,0,6,8,-2,6.0,8.4,-2.4,22,EL
9d804092,2,45,0.5,0,0,2,0,0,0,0,0.7,0.4,0.3,22,EL
9d8cf204,4,265,2.9,3,0,1,4,2,1,1,2.4,5.2,-2.8,22,EL
9e1035f8,6,475,5.3,6,3,0,0,8,7,1,9.2,6.2,3.0,22,EL
9efa1d25,5,419,4.7,5,3,0,0,9,8,1,7.7,6.1,1.7,22,EL
9f115e20,1,2,0.0,0,0,1,1,0,0,0,0.0,0.0,0.0,22,EL
9f1893b9,8,537,6.0,7,3,1,0,7,5,2,9.1,8.0,1.1,22,EL
9f6325f9,5,174,1.9,1,1,4,3,3,0,3,4.4,2.4,1.9,22,EL
9fd158d6,1,70,0.8,0,0,1,0,0,2,-2,0.4,2.5,-2.1,22,EL
9fec8860,2,124,1.4,1,1,1,2,0,2,-2,1.1,2.5,-1.4,22,EL
a0415710,3,119,1.3,1,0,2,5,1,0,1,2.0,1.3,0.8,22,EL
a08b974a,3,263,2.9,3,2,0,0,4,2,2,4.2,3.6,0.5,22,EL
a0d55a09,2,30,0.3,0,0,2,6,1,0,1,1.1,0.5,0.6,22,EL
a111cf41,6,540,6.0,6,6,0,0,10,6,4,8.9,7.4,1.4,22,EL
a11c995d,3,82,0.9,1,0,2,5,0,0,0,0.2,0.5,-0.3,22,EL
a167537f,2,113,1.3,2,0,0,0,2,4,-2,4.2,3.5,0.6,22,EL
a1c5b23e,3,175,1.9,2,0,1,3,2,1,1,2.5,1.7,0.8,22,EL
a26fb8aa,6,440,4.9,4,4,2,0,9,5,4,7.4,7.0,0.4,22,EL
a2950e2d,5,300,3.3,4,2,1,1,2,8,-6,2.4,8.4,-6.1,22,EL
a29e5244,3,176,2.0,2,1,1,3,2,2,0,3.4,2.8,0.6,22,EL
a2a85828,1,57,0.6,1,0,0,11,1,1,0,0.3,1.2,-0.9,22,EL
a2abe631,6,540,6.0,6,6,0,2,7,3,4,7.1,9.4,-2.3,22,EL
a36524bf,14,1177,13.1,12,12,2,1,20,13,7,21.3,19.6,1.7,22,EL
a3b0ed18,4,360,4.0,4,4,0,0,2,5,-3,4.4,9.0,-4.6,22,EL
a3eabee0,5,430,4.8,5,4,0,0,4,10,-6,4.5,12.0,-7.5,22,EL
a4effc55,1,90,1.0,1,1,0,0,2,4,-2,1.5,2.1,-0.6,22,EL
a5296e55,7,511,5.7,7,2,0,0,8,11,-3,10.5,9.1,1.4,22,EL
a5549ec1,6,540,6.0,6,6,0,0,6,7,-1,12.2,5.5,6.7,22,EL
a55d8df5,8,612,6.8,7,2,1,2,7,10,-3,9.1,9.3,-0.2,22,EL
a5db0bec,9,563,6.3,6,3,3,1,12,6,6,14.7,5.5,9.2,22,EL
a5f5d094,3,181,2.0,2,2,1,3,1,2,-1,3.0,1.9,1.1,22,EL
a65ce836,1,90,1.0,1,1,0,0,2,2,0,3.6,1.7,1.9,22,EL
a671316d,2,124,1.4,2,0,0,4,1,1,0,2.7,1.9,0.7,22,EL
a69e4806,6,353,3.9,5,1,1,0,7,8,-1,10.8,5.3,5.5,22,EL
a6de370d,8,494,5.5,5,2,3,0,10,10,0,9.8,10.6,-0.7,22,EL
a712ca2b,7,542,6.0,6,6,1,4,14,2,12,13.4,6.1,7.3,22,EL
a7220785,2,119,1.3,2,0,0,4,3,4,-1,2.5,3.6,-1.1,22,EL
a72c139d,3,250,2.8,3,2,0,0,1,3,-2,1.1,4.1,-3.0,22,EL
a73c8f95,6,407,4.5,5,4,1,0,7,5,2,6.3,6.4,-0.1,22,EL
a802405e,2,135,1.5,1,1,1,0,0,0,0,1.5,1.3,0.2,22,EL
a81dba8c,6,303,3.4,3,1,3,0,1,4,-3,5.4,3.7,1.7,22,EL
a8567629,4,285,3.2,3,3,1,1,7,4,3,5.9,4.7,1.1,22,EL
a8b8af8d,3,268,3.0,3,2,0,3,8,7,1,4.4,5.9,-1.4,22,EL
a8ee54ad,12,938,10.4,10,6,2,0,15,11,4,16.7,15.3,1.4,22,EL
a8fbae1d,11,864,9.6,9,8,2,0,15,15,0,13.8,16.7,-2.9,22,EL
a9142dc3,2,71,0.8,1,0,1,0,0,0,0,1.1,0.7,0.4,22,EL
a952a529,1,14,0.2,0,0,1,4,0,0,0,0.1,0.0,0.1,22,EL
a99138af,7,484,5.4,6,3,1,1,4,6,-2,6.4,7.3,-0.9,22,EL
a9a3b55d,4,360,4.0,4,4,0,2,4,7,-3,4.8,5.5,-0.6,22,EL
a9aa0d1d,3,59,0.7,0,0,3,0,0,1,-1,0.9,2.0,-1.1,22,EL
aa34ed38,6,459,5.1,5,4,1,0,12,14,-2,11.0,10.4,0.5,22,EL
aa681ea5,4,116,1.3,1,1,3,2,1,2,-1,0.7,2.2,-1.5,22,EL
aa8e289e,6,443,4.9,6,1,0,5,8,2,6,9.2,4.6,4.7,22,EL
aaf1bf05,4,99,1.1,1,0,3,2,1,1,0,1.6,0.9,0.8,22,EL
ab2a6ae8,5,264,2.9,3,0,2,0,5,5,0,2.9,6.5,-3.6,22,EL
abb3bb95,4,53,0.6,0,0,4,1,2,1,1,1.8,0.9,0.9,22,EL
ac05f970,9,762,8.5,9,4,0,0,10,6,4,13.8,11.7,2.1,22,EL
ac73ec79,2,6,0.1,0,0,2,4,0,0,0,0.9,0.4,0.4,22,EL
acf5410c,1,19,0.2,0,0,1,3,0,1,-1,0.1,0.7,-0.6,22,EL
ad3389d5,7,630,7.0,7,7,0,0,16,8,8,13.8,10.4,3.3,22,EL
ad81ba78,1,12,0.1,0,0,1,1,0,0,0,0.1,0.4,-0.3,22,EL
ad82197c,6,411,4.6,5,3,1,2,3,5,-2,4.1,5.6,-1.5,22,EL
adfbe1f5,4,261,2.9,3,0,1,1,3,6,-3,2.7,4.8,-2.1,22,EL
adfc9123,5,327,3.6,4,2,1,0,7,4,3,8.1,3.3,4.8,22,EL
ae0a7ddf,6,476,5.3,5,5,1,0,7,3,4,6.8,8.3,-1.5,22,EL
ae44e8e2,6,449,5.0,6,1,0,0,6,6,0,7.3,6.1,1.2,22,EL
ae59b359,6,414,4.6,5,2,1,0,10,7,3,8.8,6.0,2.9,22,EL
aeed5c06,8,623,6.9,7,5,1,0,15,9,6,12.5,10.5,2.1,22,EL
af3ddb2e,5,216,2.4,2,0,3,3,3,1,2,2.7,3.1,-0.5,22,EL
af50141d,8,662,7.4,8,4,0,0,8,8,0,9.6,9.0,0.6,22,EL
afb0c500,7,630,7.0,7,7,0,0,7,6,1,9.3,7.3,2.0,22,EL
b088363d,1,90,1.0,1,1,0,0,1,1,0,0.2,2.4,-2.2,22,EL
b088d5d3,5,362,4.0,4,3,1,1,2,6,-4,2.6,7.1,-4.5,22,EL
b0b902c8,1,45,0.5,1,0,0,1,2,3,-1,0.8,0.8,0.0,22,EL
b105919e,2,109,1.2,1,0,1,0,1,2,-1,0.9,3.6,-2.7,22,EL
b1313ec4,12,439,4.9,4,1,8,2,7,8,-1,8.2,8.7,-0.5,22,EL
b182a240,6,458,5.1,5,3,1,0,8,6,2,8.3,9.2,-0.9,22,EL
b19db005,6,251,2.8,1,1,5,0,4,4,0,6.5,2.4,4.1,22,EL
b1cd37e6,12,1140,12.7,12,12,0,0,19,12,7,20.5,17.9,2.6,22,EL
b2a81fc6,3,90,1.0,0,0,3,3,1,1,0,2.2,1.4,0.9,22,EL
b34c63a5,4,286,3.2,3,2,1,2,8,2,6,5.2,2.8,2.4,22,EL
b391383a,1,90,1.0,1,1,0,1,0,1,-1,0.7,1.1,-0.4,22,EL
b3aed40d,1,90,1.0,1,1,0,3,1,1,0,2.1,1.0,1.1,22,EL
b3b7f5a6,5,339,3.8,4,3,1,7,7,5,2,5.1,4.5,0.6,22,EL
b3dc6eca,2,180,2.0,2,2,0,7,4,7,-3,3.3,5.3,-2.0,22,EL
b4705807,2,180,2.0,2,2,0,0,1,3,-2,2.4,2.9,-0.5,22,EL
b483167a,4,190,2.1,2,0,2,1,1,5,-4,1.7,5.7,-4.0,22,EL
b4a014b1,2,135,1.5,2,1,0,0,3,1,2,2.1,1.7,0.4,22,EL
b5920350,5,359,4.0,5,2,0,1,3,9,-6,4.7,7.8,-3.1,22,EL
b5f66351,6,524,5.8,6,5,0,0,7,7,0,9.8,6.2,3.5,22,EL
b648463f,3,157,1.7,2,1,1,3,0,2,-2,1.3,4.2,-2.9,22,EL
b682dcf6,8,654,7.3,8,7,0,0,8,12,-4,7.5,11.3,-3.8,22,EL
b69dfb42,6,540,6.0,6,6,0,0,3,10,-7,5.7,13.7,-8.0,22,EL
b742cc0d,4,390,4.3,4,4,0,5,6,6,0,6.6,6.0,0.6,22,EL
b77706dd,2,8,0.1,0,0,2,2,0,0,0,0.0,0.5,-0.5,22,EL
b79d8e93,2,180,2.0,2,2,0,4,1,2,-1,1.1,3.3,-2.2,22,EL
b825a650,5,432,4.8,5,2,0,0,8,7,1,9.3,7.0,2.3,22,EL
b827d5b3,3,40,0.4,0,0,3,2,1,1,0,0.5,0.8,-0.4,22,EL
b9139383,4,360,4.0,4,4,0,2,3,10,-7,3.2,10.4,-7.2,22,EL
b9392438,4,182,2.0,2,0,2,1,1,3,-2,1.9,4.1,-2.2,22,EL
b96b595c,6,540,6.0,6,6,0,1,7,3,4,11.3,6.0,5.3,22,EL
b997c3de,4,304,3.4,3,3,1,0,4,4,0,5.6,5.9,-0.4,22,EL
ba3d3bea,8,292,3.2,2,0,6,0,5,2,3,8.0,3.9,4.0,22,EL
bab440b1,4,83,0.9,0,0,4,4,0,0,0,0.2,1.4,-1.2,22,EL
bafcf742,5,389,4.3,4,4,1,0,3,5,-2,3.5,7.5,-4.0,22,EL
bbd74918,6,482,5.4,6,4,0,0,4,11,-7,6.1,12.3,-6.3,22,EL
bbd86530,2,34,0.4,0,0,2,5,0,0,0,0.4,0.6,-0.2,22,EL
bbf5c11b,3,111,1.2,1,0,2,1,0,2,-2,1.0,2.0,-1.1,22,EL
bcb2ccd8,6,540,6.0,6,6,0,0,10,7,3,11.5,7.5,3.9,22,EL
bccc1bb4,4,302,3.4,4,1,0,0,4,5,-1,5.3,5.0,0.3,22,EL
bced0375,4,342,3.8,4,2,0,0,6,3,3,5.8,3.7,2.1,22,EL
bd142efb,8,675,7.5,7,7,1,0,16,9,7,14.4,10.9,3.5,22,EL
bd20f4eb,1,85,0.9,1,0,0,1,0,0,0,0.7,0.8,-0.1,22,EL
bd3fb505,5,157,1.7,1,0,4,1,0,4,-4,0.5,5.0,-4.5,22,EL
bd69355b,4,281,3.1,3,2,1,2,3,3,0,2.5,4.6,-2.0,22,EL
be6a794c,11,394,4.4,3,1,8,2,1,5,-4,4.5,5.7,-1.2,22,EL
be765073,14,1320,14.7,14,14,0,1,22,15,7,23.9,20.4,3.5,22,EL
be84c466,5,356,4.0,5,0,0,0,2,6,-4,2.9,4.6,-1.6,22,EL
be855308,2,180,2.0,2,2,0,4,0,1,-1,1.6,2.6,-1.0,22,EL
bec8a4ba,2,177,2.0,2,1,0,0,2,3,-1,2.3,2.1,0.3,22,EL
bece776f,7,591,6.6,7,2,0,0,9,9,0,9.8,11.1,-1.3,22,EL
bee0bab1,5,226,2.5,2,0,3,0,2,2,0,3.9,3.3,0.7,22,EL
bf12926c,4,181,2.0,1,0,3,4,2,3,-1,4.5,1.6,2.9,22,EL
bf34eebd,3,124,1.4,2,0,1,0,2,4,-2,1.9,2.1,-0.2,22,EL
bf80db4d,6,540,6.0,6,6,0,0,5,12,-7,5.3,11.1,-5.8,22,EL
c01f247a,2,145,1.6,2,1,0,1,0,2,-2,1.1,4.8,-3.8,22,EL
c067631c,5,219,2.4,2,2,3,5,3,1,2,2.7,4.6,-1.9,22,EL
c06d1086,5,372,4.1,4,2,1,1,3,8,-5,4.9,6.7,-1.7,22,EL
c08fc464,5,416,4.6,5,2,0,0,3,8,-5,3.6,11.1,-7.5,22,EL
c0c7ff58,5,377,4.2,4,3,1,1,9,10,-1,7.7,7.6,0.1,22,EL
c1b7847c,6,468,5.2,6,3,0,0,7,5,2,8.6,5.4,3.2,22,EL
c1febb46,3,136,1.5,1,1,2,0,3,4,-1,1.2,3.1,-1.9,22,EL
c283ddef,7,284,3.2,3,1,4,6,4,3,1,2.4,5.6,-3.2,22,EL
c459a650,3,183,2.0,2,0,1,1,5,1,4,2.6,0.7,1.9,22,EL
c4987edc,6,532,5.9,6,5,0,5,12,9,3,10.8,7.5,3.3,22,EL
c50e5bba,2,180,2.0,2,2,0,0,2,3,-1,2.3,2.1,0.3,22,EL
c56dc39e,4,279,3.1,4,3,0,0,8,3,5,4.6,1.3,3.3,22,EL
c5adc293,1,17,0.2,0,0,1,1,1,0,1,0.2,0.0,0.1,22,EL
c603091a,1,13,0.1,0,0,1,1,0,0,0,0.3,0.5,-0.2,22,EL
c63f6e46,8,405,4.5,4,0,4,0,4,6,-2,4.9,6.2,-1.3,22,EL
c68da769,13,1084,12.0,13,2,0,0,17,9,8,18.5,14.6,3.9,22,EL
c6e5d20f,8,702,7.8,8,6,0,1,15,9,6,17.8,8.1,9.6,22,EL
c707411f,5,354,3.9,4,3,1,2,3,8,-5,4.2,5.9,-1.8000000000000003,22,EL
c7842dab,4,259,2.9,3,2,1,2,2,3,-1,3.9,3.4,0.6,22,EL
c8160af7,1,20,0.2,0,0,1,1,2,1,1,1.3,1.1,0.2,22,EL
c8a953f6,1,14,0.2,0,0,1,0,0,1,-1,0.0,0.4,-0.4,22,EL
c8c60119,8,597,6.6,5,3,3,5,12,4,8,12.0,9.4,2.6,22,EL
c8e65157,4,205,2.3,3,2,1,0,3,2,1,1.9,2.7,-0.8,22,EL
c904f3d5,1,45,0.5,0,0,1,3,0,1,-1,1.1,0.5,0.6,22,EL
c906ce0f,4,315,3.5,4,3,0,0,5,4,1,5.1,6.3,-1.2,22,EL
c924b17d,5,450,5.0,5,5,0,0,2,9,-7,3.2,8.7,-5.4,22,EL
c9280e51,2,52,0.6,0,0,2,1,0,0,0,0.1,0.7,-0.6,22,EL
c92c24f0,4,351,3.9,4,3,0,1,6,3,3,4.3,7.4,-3.0,22,EL
c92e1a31,4,273,3.0,3,2,1,0,7,6,1,5.8,3.8,1.9,22,EL
ca45605e,6,415,4.6,5,1,1,0,10,7,3,8.4,5.6,2.8,22,EL
ca8033cb,6,468,5.2,5,5,1,0,9,7,2,9.9,6.6,3.3,22,EL
caaf2ed1,5,413,4.6,5,2,0,1,4,5,-1,3.9,6.8,-2.9,22,EL
cabb3a1d,4,345,3.8,4,2,0,0,4,7,-3,4.6,6.8,-2.2,22,EL
cb4f24c6,5,450,5.0,5,5,0,1,10,13,-3,9.9,9.8,0.1,22,EL
cbbfa2e7,6,421,4.7,4,3,2,0,1,7,-6,4.6,12.9,-8.3,22,EL
cc1c5035,2,180,2.0,2,2,0,0,1,2,-1,0.9,4.0,-3.2,22,EL
cc588cbe,3,171,1.9,2,1,1,6,4,2,2,2.3,1.9,0.4,22,EL
cc77354e,5,347,3.9,4,3,1,1,4,7,-3,8.1,4.8,3.3,22,EL
ccbbe661,2,134,1.5,2,1,0,0,0,2,-2,2.4,2.2,0.3,22,EL
ccbf1b54,2,29,0.3,0,0,2,3,0,0,0,0.9,0.5,0.4,22,EL
cd59b9df,2,180,2.0,2,2,0,0,4,6,-2,5.1,3.8,1.4,22,EL
cd6a1a59,11,971,10.8,11,7,0,0,15,10,5,16.4,14.1,2.3,22,EL
cdafb19d,7,493,5.5,6,2,1,0,6,3,3,5.7,9.5,-3.8,22,EL
ce17b5eb,13,1230,13.7,13,13,0,0,21,13,8,21.4,19.3,2.1,22,EL
ce4246f5,6,570,6.3,6,6,0,4,6,5,1,9.7,8.5,1.2,22,EL
cf007308,8,615,6.8,7,4,1,0,14,13,1,12.3,10.1,2.3,22,EL
cf15bbb1,7,489,5.4,5,2,2,6,4,5,-1,7.2,6.5,0.7,22,EL
cf1ef7ec,3,136,1.5,2,1,1,5,1,2,-1,2.4,4.1,-1.7,22,EL
cf623c78,2,99,1.1,1,1,1,2,1,1,0,1.0,2.4,-1.4,22,EL
cf8ef0a1,6,351,3.9,5,2,1,2,2,4,-2,4.6,5.0,-0.3,22,EL
d01bbb6f,4,244,2.7,3,0,1,1,4,2,2,4.7,3.0,1.8,22,EL
d080ed5e,6,514,5.7,6,4,0,0,8,8,0,9.8,7.1,2.7,22,EL
d0d98611,1,90,1.0,1,1,0,5,0,2,-2,0.8,2.3,-1.5,22,EL
d189e48f,6,154,1.7,0,0,6,0,6,4,2,3.9,2.6,1.2,22,EL
d1943c8b,5,450,5.0,5,5,0,0,4,10,-6,4.5,12.4,-7.9,22,EL
d1a08b5a,1,90,1.0,1,1,0,7,1,0,1,1.6,0.5,1.1,22,EL
d1bf91e0,2,44,0.5,1,0,1,2,1,1,0,0.4,0.3,0.1,22,EL
d1eda5f0,2,53,0.6,0,0,2,6,0,0,0,0.1,0.5,-0.4,22,EL
d2416c2e,5,118,1.3,1,0,4,0,4,3,1,3.8,2.9,0.9,22,EL
d2795011,4,66,0.7,0,0,4,4,1,1,0,0.3,1.0,-0.6,22,EL
d2800f47,3,202,2.2,3,0,0,0,4,1,3,1.9,2.3,-0.4,22,EL
d2a83712,6,91,1.0,0,0,6,0,2,1,1,2.3,1.8,0.5,22,EL
d2d74d9c,4,147,1.6,2,0,2,1,0,1,-1,1.3,2.7,-1.4,22,EL
d32daf5d,3,60,0.7,0,0,3,3,0,1,-1,0.5,1.6,-1.2,22,EL
d3de9af0,2,119,1.3,1,1,1,0,0,2,-2,2.2,3.5,-1.3,22,EL
d4133fa1,7,555,6.2,7,3,0,0,5,11,-6,6.1,8.9,-2.8,22,EL
d4535821,6,442,4.9,4,4,2,1,5,6,-1,6.5,7.1,-0.5,22,EL
d4aa40b8,8,426,4.7,4,0,4,0,5,2,3,6.5,5.8,0.7,22,EL
d4e93bab,1,90,1.0,1,1,0,0,2,3,-1,1.2,1.3,0.0,22,EL
d504b3e1,1,2,0.0,0,0,1,3,0,0,0,0.1,0.0,0.1,22,EL
d5127c3f,6,441,4.9,6,1,0,0,5,7,-2,7.5,6.4,1.1,22,EL
d51d1d9d,10,326,3.6,0,0,10,2,7,6,1,5.4,7.2,-1.7,22,EL
d56b9520,7,446,5.0,5,3,2,2,10,7,3,9.1,4.8,4.4,22,EL
d571df78,4,145,1.6,2,0,2,2,2,2,0,1.6,1.2,0.5,22,EL
d5dd5f1f,6,419,4.7,5,1,1,0,8,6,2,9.3,5.3,4.0,22,EL
d6a889ea,4,186,2.1,1,0,3,1,3,5,-2,4.0,4.3,-0.4,22,EL
d6f6ce93,2,180,2.0,2,2,0,7,1,4,-3,2.8,1.7,1.1,22,EL
d7c09951,5,450,5.0,5,5,0,0,2,8,-6,4.8,12.5,-7.7,22,EL
d7f99582,5,254,2.8,3,0,2,1,2,4,-2,2.5,2.4,0.1,22,EL
d810c13b,6,540,6.0,6,6,0,0,4,9,-5,4.7,12.1,-7.4,22,EL
d85c238b,5,420,4.7,5,2,0,0,3,3,0,6.8,4.0,2.8,22,EL
d87e2cae,8,385,4.3,4,0,4,2,6,6,0,5.3,7.6,-2.3,22,EL
d8feae4a,5,18,0.2,0,0,5,1,1,1,0,0.5,0.4,0.0,22,EL
d9764034,6,416,4.6,4,4,2,0,6,2,4,6.8,4.0,2.7,22,EL
d97cccc9,9,670,7.4,9,1,0,1,15,7,8,12.2,11.5,0.8,22,EL
d9ba39fc,2,68,0.8,1,0,1,2,1,1,0,0.5,0.5,-0.1,22,EL
da7f2781,6,495,5.5,6,5,0,0,3,9,-6,5.4,12.6,-7.2,22,EL
da974c7b,7,630,7.0,7,7,0,0,15,13,2,15.5,10.2,5.3,22,EL
dae8623e,6,384,4.3,4,3,2,0,5,6,-1,5.1,7.5,-2.4,22,EL
db3cb6ee,1,11,0.1,0,0,1,4,0,0,0,0.0,0.1,-0.1,22,EL
db4ed67b,2,180,2.0,2,2,0,0,4,6,-2,5.1,3.8,1.4,22,EL
db90b737,6,518,5.8,6,5,0,0,10,8,2,8.8,11.6,-2.9,22,EL
dbd3a428,6,441,4.9,6,2,0,0,4,10,-6,5.8,8.4,-2.6,22,EL
dc234f98,6,506,5.6,6,5,0,0,6,10,-4,6.0,10.3,-4.3,22,EL
dc38e3bc,3,4,0.0,0,0,3,2,0,2,-2,0.0,1.1,-1.1,22,EL
dc3fa3b5,5,287,3.2,4,1,1,1,8,6,2,6.9,4.3,2.6,22,EL
dccd127f,5,91,1.0,0,0,5,4,0,3,-3,1.7,2.0,-0.3,22,EL
dcfb17f4,8,496,5.5,6,2,2,0,9,8,1,8.5,8.1,0.4,22,EL
dda3969e,5,193,2.1,2,0,3,1,5,2,3,3.6,3.5,0.1,22,EL
ddc5a43e,1,19,0.2,0,0,1,5,0,0,0,0.1,0.3,-0.2,22,EL
de8f6250,1,7,0.1,0,0,1,4,0,1,-1,0.0,0.4,-0.4,22,EL
dee86451,8,404,4.5,4,1,4,0,5,9,-4,7.1,7.3,-0.2,22,EL
dfb50e5c,2,50,0.6,0,0,2,0,0,0,0,0.8,0.4,0.3,22,EL
e0b113a7,5,327,3.6,3,3,2,1,8,5,3,7.3,5.3,2.0,22,EL
e0bc6fdc,7,585,6.5,6,6,1,3,11,6,5,14.9,5.9,9.0,22,EL
e0f613ad,5,332,3.7,4,2,1,1,4,4,0,4.8,4.8,0.0,22,EL
e0f8151c,6,540,6.0,6,6,0,0,7,8,-1,10.6,7.7,2.9,22,EL
e12b0b5b,10,397,4.4,4,1,6,1,10,2,8,6.8,6.2,0.6,22,EL
e162b013,1,45,0.5,1,0,0,0,2,1,1,2.8,1.3,1.5,22,EL
e1cbb531,2,103,1.1,1,0,1,1,4,2,2,4.4,1.9,2.5,22,EL
e1e75690,1,1,0.0,0,0,1,1,0,0,0,0.0,0.0,0.0,22,EL
e23f56c1,2,74,0.8,1,0,1,5,1,0,1,1.0,1.2,-0.2,22,EL
e2716bd0,4,224,2.5,3,1,1,1,3,4,-1,6.7,4.3,2.5,22,EL
e28245d9,5,408,4.5,5,2,0,0,3,7,-4,5.6,6.9,-1.4,22,EL
e34e086c,1,7,0.1,0,0,1,1,0,0,0,0.0,0.1,0.0,22,EL
e373f1ec,5,244,2.7,3,1,2,1,1,4,-3,1.6,5.2,-3.6,22,EL
e3cceee6,6,518,5.8,6,4,0,0,10,5,5,8.5,6.7,1.9,22,EL
e426b012,1,120,1.3,1,1,0,0,0,2,-2,1.0,3.0,-2.0,22,EL
e45ee4bc,5,295,3.3,3,2,2,1,4,7,-3,3.6,7.2,-3.5,22,EL
e4ba67f2,1,1,0.0,0,0,1,2,0,0,0,0.0,0.0,0.0,22,EL
e4eea72d,3,22,0.2,0,0,3,2,0,0,0,0.7,0.1,0.6,22,EL
e53b5534,8,720,8.0,8,8,0,0,8,5,3,8.0,13.5,-5.5,22,EL
e5711bd9,5,307,3.4,4,0,1,1,2,8,-6,2.9,7.2,-4.3,22,EL
e599253a,4,209,2.3,3,1,1,2,4,2,2,3.2,1.9,1.3,22,EL
e717705a,3,122,1.4,1,1,2,8,0,2,-2,1.5,1.5,0.0,22,EL
e726e11e,6,523,5.8,6,4,0,0,10,8,2,9.0,12.1,-3.1,22,EL
e73659d3,2,92,1.0,1,0,1,0,2,2,0,1.0,1.3,-0.3,22,EL
e75dc411,3,172,1.9,2,0,1,0,1,2,-1,0.9,3.4,-2.5,22,EL
e76cb9cc,4,360,4.0,4,4,0,0,5,5,0,6.2,6.8,-0.6,22,EL
e7986081,6,483,5.4,6,3,0,0,6,7,-1,9.2,5.6,3.6,22,EL
e7d59f4f,3,170,1.9,2,0,1,3,1,0,1,3.7,0.6,3.1,22,EL
e7e0736b,1,10,0.1,0,0,1,0,0,1,-1,0.0,1.3,-1.3,22,EL
e7ef333b,6,540,6.0,6,6,0,0,10,9,1,9.2,12.9,-3.7,22,EL
e7fcf289,6,433,4.8,5,0,1,0,14,7,7,9.3,7.4,1.9,22,EL
e82adcab,7,376,4.2,5,2,2,0,8,6,2,7.2,5.4,1.8,22,EL
e872ca65,5,228,2.5,2,0,3,0,2,5,-3,3.4,5.6,-2.2,22,EL
e8796ba6,6,417,4.6,5,2,1,0,2,8,-6,4.7,11.3,-6.5,22,EL
e8dcb664,3,51,0.6,0,0,3,3,0,2,-2,0.1,1.7,-1.6,22,EL
e8ef59da,6,188,2.1,1,0,5,0,3,2,1,2.3,2.3,0.0,22,EL
e90dc1d5,8,490,5.4,7,0,1,0,5,6,-1,4.8,6.1,-1.3,22,EL
e92cd3f7,7,245,2.7,2,1,5,0,5,4,1,6.2,4.2,2.0,22,EL
e9b0ccaf,9,348,3.9,4,0,5,6,5,4,1,5.9,4.2,1.7,22,EL
ea0893d6,5,324,3.6,4,0,1,0,1,7,-6,2.5,7.9,-5.4,22,EL
ea76b7e8,1,90,1.0,1,1,0,0,0,1,-1,0.7,1.1,-0.4,22,EL
ea770abf,6,458,5.1,5,5,1,2,5,5,0,8.7,6.6,2.1,22,EL
ea83bfa6,7,589,6.5,6,6,1,3,9,11,-2,9.9,9.8,0.1,22,EL
ead61f73,7,398,4.4,6,1,1,1,8,5,3,8.3,6.4,1.9,22,EL
eadc8e4f,5,282,3.1,3,2,2,1,2,5,-3,4.4,3.8,0.6,22,EL
eaeefc50,4,74,0.8,0,0,4,4,2,0,2,2.5,0.8,1.7,22,EL
eb2fe5b6,5,293,3.3,4,0,1,0,4,5,-1,5.3,4.6,0.8,22,EL
eb6e14be,6,370,4.1,4,3,2,0,6,4,2,7.1,4.9,2.2,22,EL
eb907bfc,4,215,2.4,2,2,2,1,2,2,0,3.4,4.0,-0.6,22,EL
eba42d2b,5,161,1.8,1,1,4,1,3,1,2,3.5,2.0,1.5,22,EL
ecc10d95,6,282,3.1,3,0,3,0,2,3,-1,3.5,7.1,-3.6,22,EL
ed1cc44a,7,611,6.8,7,6,0,2,7,6,1,7.8,8.9,-1.1,22,EL
ed45c4a5,4,343,3.8,4,2,0,1,4,3,1,7.5,2.6,4.8,22,EL
ed87a229,4,323,3.6,4,2,0,0,1,5,-4,4.2,8.8,-4.6,22,EL
ed90babd,6,132,1.5,1,0,5,0,7,3,4,3.5,3.2,0.4,22,EL
ee38d9c5,5,278,3.1,3,2,2,0,9,8,1,7.1,5.0,2.0,22,EL
ee45fd85,2,173,1.9,2,1,0,0,0,3,-3,2.8,2.4,0.3,22,EL
ee926a02,5,388,4.3,5,2,0,0,5,6,-1,5.3,6.2,-0.9,22,EL
ee950928,8,668,7.4,8,4,0,0,11,9,2,9.8,9.5,0.2,22,EL
eed332df,6,353,3.9,3,2,3,0,5,2,3,6.9,4.3,2.6,22,EL
ef322658,5,361,4.0,4,2,1,3,10,5,5,6.2,5.6,0.7,22,EL
ef3909cd,11,1050,11.7,11,11,0,0,17,12,5,17.6,16.6,1.0,22,EL
ef619b0b,3,88,1.0,1,0,2,4,2,0,2,4.3,0.3,4.0,22,EL
ef88f778,9,678,7.5,8,4,1,0,14,8,6,11.5,12.7,-1.3,22,EL
ef8cafeb,1,1,0.0,0,0,1,4,0,0,0,0.0,0.0,0.0,22,EL
efc33b33,1,90,1.0,1,1,0,5,0,1,-1,0.9,1.3,-0.5,22,EL
f00de885,8,720,8.0,8,8,0,1,18,6,12,17.6,7.5,10.2,22,EL
f014e1bd,6,540,6.0,6,6,0,0,6,10,-4,6.5,10.5,-4.0,22,EL
f04a3092,1,7,0.1,0,0,1,4,0,0,0,0.3,0.2,0.1,22,EL
f090a37a,1,9,0.1,0,0,1,5,0,1,-1,0.0,0.1,-0.1,22,EL
f0e3b343,4,202,2.2,2,2,2,2,0,5,-5,1.5,6.7,-5.2,22,EL
f11b1937,1,14,0.2,0,0,1,0,0,0,0,0.2,1.1,-0.9,22,EL
f17ba2da,1,64,0.7,1,0,0,5,1,0,1,0.5,1.3,-0.8,22,EL
f201798c,4,176,2.0,2,0,2,2,2,2,0,3.9,1.7,2.2,22,EL
f28474a4,4,315,3.5,4,3,0,6,8,4,4,5.6,3.3,2.3,22,EL
f28659fb,8,624,6.9,7,2,1,0,7,4,3,6.8,12.1,-5.3,22,EL
f2d063ec,4,360,4.0,4,4,0,2,3,7,-4,5.8,5.9,-0.1,22,EL
f2de3a43,4,206,2.3,2,1,2,2,2,1,1,1.6,2.9,-1.3,22,EL
f36d5624,2,13,0.1,0,0,2,4,0,1,-1,0.6,0.1,0.6,22,EL
f3945e07,4,215,2.4,3,0,1,0,4,3,1,4.2,2.6,1.6,22,EL
f3a97d02,14,1320,14.7,14,14,0,1,22,15,7,23.9,20.4,3.5,22,EL
f3fa599d,6,513,5.7,6,3,0,0,6,6,0,8.8,6.3,2.5,22,EL
f4d60499,6,522,5.8,6,5,0,0,2,11,-9,4.0,10.3,-6.3,22,EL
f4d8ce5a,5,216,2.4,2,0,3,0,1,4,-3,1.1,5.1,-4.0,22,EL
f533776b,5,287,3.2,3,1,2,0,9,5,4,5.9,6.0,-0.1,22,EL
f5e7fdf9,7,685,7.6,7,6,0,5,9,6,3,8.7,12.0,-3.3,22,EL
f6798fc3,4,390,4.3,4,4,0,0,4,4,0,5.2,6.1,-0.8,22,EL
f719fae8,4,144,1.6,1,1,3,2,1,2,-1,1.3,4.3,-2.9,22,EL
f7223718,4,360,4.0,4,4,0,4,8,4,4,9.6,5.0,4.6,22,EL
f7a3ec21,1,1,0.0,0,0,1,0,0,0,0,0.8,0.1,0.7,22,EL
f7dc2ae5,6,540,6.0,6,6,0,2,10,10,0,8.4,9.1,-0.7,22,EL
f804cfd9,4,40,0.4,0,0,4,2,0,0,0,1.5,0.5,1.0,22,EL
f80d03ca,3,48,0.5,0,0,3,3,1,2,-1,1.8,1.5,0.3,22,EL
f81ef10d,8,513,5.7,6,3,2,0,10,3,7,11.4,5.1,6.3,22,EL
f820504e,5,450,5.0,5,5,0,0,2,7,-5,4.2,11.4,-7.2,22,EL
f874dd44,4,275,3.1,3,3,1,4,2,4,-2,3.9,4.4,-0.5,22,EL
f8817892,4,360,4.0,4,4,0,0,2,4,-2,4.5,7.4,-2.8,22,EL
f8fcd2a5,4,306,3.4,4,2,0,0,8,6,2,7.5,4.2,3.2,22,EL
f9dfb7ae,3,233,2.6,3,1,0,0,2,2,0,2.2,3.2,-1.0,22,EL
f9e0c603,6,540,6.0,6,6,0,0,4,10,-6,8.5,8.7,-0.3,22,EL
f9edc384,2,210,2.3,2,2,0,0,2,2,0,2.4,3.9,-1.5,22,EL
fa274d97,2,126,1.4,1,1,1,0,3,2,1,4.1,1.8,2.2,22,EL
fa661778,1,45,0.5,0,0,1,0,0,1,-1,0.8,0.4,0.4,22,EL
faf55ce4,3,99,1.1,1,1,2,0,0,3,-3,0.5,3.0,-2.4,22,EL
fb22f7a0,2,17,0.2,0,0,2,1,0,0,0,0.5,0.5,0.0,22,EL
fb46125f,2,209,2.3,2,1,0,0,2,2,0,2.4,3.9,-1.5,22,EL
fb485406,3,240,2.7,3,1,0,0,3,6,-3,6.2,4.1,2.1,22,EL
fb5022e4,1,13,0.1,0,0,1,0,0,1,-1,0.1,0.8,-0.7,22,EL
fb938d24,3,251,2.8,3,0,0,0,1,2,-1,3.0,3.5,-0.4,22,EL
fbbb9269,3,300,3.3,3,3,0,1,5,5,0,4.4,5.3,-0.9,22,EL
fc027d02,3,261,2.9,3,2,0,3,7,4,3,6.9,3.0,3.9,22,EL
fc4e7637,4,336,3.7,4,2,0,0,5,4,1,5.9,5.2,0.7,22,EL
fc9b373e,2,151,1.7,2,0,0,0,1,5,-4,1.1,3.4,-2.3,22,EL
fcb27134,3,270,3.0,3,3,0,2,7,3,4,6.7,3.4,3.4,22,EL
fd4d5f81,5,345,3.8,4,0,1,0,7,6,1,6.8,6.6,0.2,22,EL
fd834d1d,1,90,1.0,1,1,0,10,5,4,1,1.0,2.8,-1.7,22,EL
fd9c4805,6,489,5.4,6,1,0,0,6,6,0,8.6,5.1,3.4,22,EL
fdae8b47,4,299,3.3,3,3,1,2,2,7,-5,1.9,5.6,-3.8,22,EL
fdd85f94,1,21,0.2,0,0,1,2,0,0,0,0.2,0.3,0.0,22,EL
fdf3cb77,4,356,4.0,4,3,0,4,7,3,4,8.5,4.7,3.8,22,EL
fdf4b948,3,106,1.2,1,0,2,5,0,1,-1,1.0,1.7,-0.8,22,EL
fe012aca,6,226,2.5,1,0,5,0,5,1,4,3.9,3.5,0.4,22,EL
fe641c1a,3,194,2.2,1,1,2,0,0,3,-3,2.1,3.4,-1.3,22,EL
ff0ab48c,5,298,3.3,3,1,2,3,5,2,3,8.3,2.7,5.7,22,EL
ff527768,9,359,4.0,4,2,5,3,3,2,1,7.7,4.7,3.0,22,EL
ff800ed8,6,354,3.9,4,2,2,0,4,7,-3,7.5,4.6,2.8,22,EL
ffec9769,4,263,2.9,3,2,1,0,7,1,6,4.4,2.8,1.5,22,EL
004d185e,32,1632,18.1,18,3,14,5,21,22,-1,18.4,27.6,-9.1,22,SPA
0076ab7f,21,1046,11.6,9,5,12,13,8,9,-1,10.3,12.6,-2.3,22,SPA
00b28772,35,2936,32.6,34,26,1,1,25,37,-12,23.4,31.9,-8.5,22,SPA
01da7812,15,856,9.5,9,2,6,1,12,19,-7,11.5,19.0,-7.5,22,SPA
01eb744d,36,1856,20.6,21,5,15,0,39,21,18,31.3,16.2,15.1,22,SPA
02319ad7,22,672,7.5,4,0,18,3,5,9,-4,5.8,9.6,-3.9,22,SPA
02c15616,29,2447,27.2,29,20,0,0,40,26,14,34.0,24.9,9.1,22,SPA
02d2c436,16,1366,15.2,15,15,1,0,15,13,2,20.0,13.9,6.1,22,SPA
02ef8778,34,2914,32.4,33,19,1,0,37,44,-7,32.8,42.8,-10.0,22,SPA
03049c8c,25,1481,16.5,18,6,7,3,14,20,-6,13.7,19.5,-5.7,22,SPA
030ef8d6,3,20,0.2,0,0,3,5,2,0,2,1.5,0.3,1.2,22,SPA
036bba5f,14,1105,12.3,12,10,2,0,10,12,-2,14.6,12.7,1.9,22,SPA
037dbd30,26,1971,21.9,22,13,4,9,31,40,-9,33.6,28.9,4.7,22,SPA
04965583,31,1901,21.1,21,9,10,1,21,34,-13,19.9,31.9,-12.0,22,SPA
04ac8285,17,1457,16.2,17,16,0,12,22,29,-7,19.3,23.8,-4.5,22,SPA
04e17fd5,23,1277,14.2,15,3,8,2,13,5,8,16.7,12.8,3.9,22,SPA
05439de2,30,2642,29.4,30,27,0,0,60,26,34,53.3,31.4,21.9,22,SPA
056269d7,19,894,9.9,9,3,10,16,13,10,3,14.0,8.1,5.8,22,SPA
068f4dec,8,207,2.3,1,0,7,13,2,2,0,3.7,2.7,0.9,22,SPA
070a3904,36,3125,34.7,36,25,0,0,39,49,-10,32.8,47.0,-14.2,22,SPA
0959c2a2,31,1833,20.4,19,11,12,2,44,19,25,38.0,24.0,14.0,22,SPA
09a9e921,17,513,5.7,4,1,13,16,7,10,-3,6.6,8.0,-1.4,22,SPA
0a8fd9cb,5,68,0.8,1,0,4,15,1,0,1,0.5,0.1,0.4,22,SPA
0abc51f2,32,2683,29.8,31,26,1,0,26,32,-6,22.6,31.8,-9.2,22,SPA
0ac94a23,17,563,6.3,5,0,12,12,12,9,3,10.5,10.2,0.3,22,SPA
0ae4e09a,29,2115,23.5,25,12,4,0,27,42,-15,27.6,33.2,-5.5,22,SPA
0b2c8585,31,1627,18.1,17,8,14,5,16,17,-1,13.9,26.0,-12.1,22,SPA
0b90bb97,33,2367,26.3,30,14,3,0,28,26,2,26.3,30.8,-4.5,22,SPA
0ba976e4,10,336,3.7,3,0,7,0,8,4,4,4.3,3.3,1.0,22,SPA
0bc4e720,20,468,5.199999999999999,2,0,18,17,9,16,-7,6.5,12.200000000000001,-5.6,22,SPA
0c2ac3cb,17,1050,11.7,13,0,4,0,10,10,0,15.6,9.9,5.7,22,SPA
0c717ae6,1,75,0.8,1,0,0,4,0,1,-1,0.4,0.8,-0.5,22,SPA
0cadc46d,16,1438,16.0,16,15,0,0,18,28,-10,18.2,21.3,-3.1,22,SPA
0cb29e91,15,918,10.2,10,5,5,0,12,23,-11,9.7,18.8,-9.1,22,SPA
0d9b2d31,12,885,9.8,10,4,2,0,28,9,19,23.4,9.1,14.3,22,SPA
0e4fef6e,33,2725,30.3,32,22,1,2,27,36,-9,28.0,30.9,-2.9,22,SPA
0e50f929,10,266,3.0,3,0,7,24,1,6,-5,2.2,4.2,-2.0,22,SPA
0e5ddc7c,28,1063,11.8,11,1,17,5,18,28,-10,19.6,20.6,-1.0,22,SPA
0ef89a37,12,503,5.6,5,0,7,4,7,7,0,10.6,6.7,3.9,22,SPA
10072610,17,1456,16.2,17,16,0,11,30,19,11,24.1,19.4,4.7,22,SPA
106c142c,15,813,9.0,8,3,7,20,7,12,-5,7.1,10.4,-3.2,22,SPA
112521d1,31,2720,30.2,31,27,0,0,34,40,-6,29.0,38.6,-9.6,22,SPA
11b9265b,24,1223,13.6,13,3,11,3,19,9,10,22.3,14.5,7.7,22,SPA
11fd2b75,32,2493,27.7,30,15,2,2,28,39,-11,23.4,40.8,-17.4,22,SPA
12c50af5,38,2819,31.3,33,13,5,0,39,38,1,34.6,40.6,-6.0,22,SPA
132ac341,15,1159,12.9,12,11,3,6,16,22,-6,15.2,20.9,-5.8,22,SPA
15937e17,8,408,4.5,5,2,3,8,5,6,-1,4.8,5.5,-0.7,22,SPA
162efffd,36,2151,23.9,24,9,12,1,43,24,19,37.0,20.0,17.0,22,SPA
16aa3654,28,1605,17.8,17,3,11,1,20,33,-13,19.9,22.8,-2.9,22,SPA
16e9d0ea,30,2404,26.7,28,22,2,2,49,30,19,41.0,31.9,9.2,22,SPA
174651c8,7,341,3.8,3,1,4,8,0,7,-7,1.5,7.3,-5.8,22,SPA
17a1299d,1,90,1.0,1,1,0,33,1,1,0,0.9,0.5,0.4,22,SPA
1827a42d,9,276,3.1,3,2,6,25,1,4,-3,3.9,3.6,0.3,22,SPA
1840e36d,36,3240,36.0,36,36,0,1,79,29,50,69.0,38.9,30.1,22,SPA
18abe173,32,2637,29.3,30,24,2,3,35,31,4,34.1,33.1,1.0,22,SPA
18f0a9f0,1,1,0.0,0,0,1,1,0,0,0,0.0,0.0,0.0,22,SPA
19709006,29,1360,15.1,13,2,16,8,17,11,6,16.1,12.1,4.0,22,SPA
19b776e9,34,1875,20.9,19,9,15,3,18,31,-13,24.6,28.900000000000002,-4.3,22,SPA
19c36442,34,2773,30.8,33,21,1,0,37,45,-8,30.0,46.5,-16.5,22,SPA
19cae58d,34,2316,25.7,28,11,6,2,44,27,17,41.0,19.8,21.2,22,SPA
1bacc518,32,2476,27.5,30,17,2,1,49,30,19,43.1,24.2,18.9,22,SPA
1bc432b7,5,131,1.5,1,0,4,20,1,5,-4,1.2,2.5,-1.3,22,SPA
1bda5842,37,1590,17.7,17,1,20,1,17,16,1,22.9,19.0,3.9,22,SPA
1c2c55fc,19,1397,15.5,16,11,3,11,17,15,2,10.5,17.9,-7.4,22,SPA
1c5d79e2,3,54,0.6,0,0,3,0,0,2,-2,0.4,1.8,-1.4,22,SPA
1c96ad85,4,186,2.1,2,0,2,6,7,4,3,3.4,2.6,0.8,22,SPA
1ccd3dae,3,27,0.3,0,0,3,1,1,0,1,0.9,0.5,0.4,22,SPA
1daec722,1,23,0.3,0,0,1,0,0,0,0,0.7,0.0,0.7,22,SPA
1ea5f91c,14,587,6.5,6,3,8,10,9,12,-3,6.5,9.0,-2.5,22,SPA
1f079188,7,132,1.5,1,0,6,18,1,0,1,4.5,1.1,3.4,22,SPA
1f1c8a15,7,201,2.2,2,0,5,4,1,4,-3,1.9,3.3,-1.4,22,SPA
1f462f95,8,560,6.2,6,4,2,12,8,5,3,5.2,7.2,-1.9,22,SPA
1fc474ae,9,365,4.1,3,1,6,8,2,9,-7,3.9,5.7,-1.9,22,SPA
1fe0492d,34,2621,29.1,31,19,3,0,25,44,-19,30.1,40.0,-9.9,22,SPA
1fe67e86,26,2027,22.5,23,19,3,11,25,23,2,27.9,25.6,2.2,22,SPA
200e89e1,11,547,6.1,6,0,5,1,5,8,-3,5.9,6.8,-0.8,22,SPA
21512407,15,976,10.8,12,7,3,1,13,13,0,12.8,7.9,4.9,22,SPA
228b0d9d,20,1342,14.9,15,9,5,11,19,18,1,21.9,17.4,4.5,22,SPA
237a3851,12,519,5.8,5,0,7,4,7,5,2,7.0,7.4,-0.3,22,SPA
240d3a0b,32,2177,24.2,27,6,5,2,25,22,3,28.5,24.5,4.0,22,SPA
244bc2c8,25,1269,14.1,13,3,12,4,22,9,13,25.4,15.5,9.9,22,SPA
253a06b9,36,1870,20.8,22,2,14,0,20,22,-2,18.4,27.0,-8.6,22,SPA
2683eda7,30,2245,24.9,26,10,4,0,26,38,-12,22.2,33.9,-11.7,22,SPA
274ab13c,36,3240,36.0,36,36,0,0,39,46,-7,41.6,45.6,-4.0,22,SPA
2784f898,34,3031,33.7,34,32,0,2,63,30,33,60.7,38.8,21.9,22,SPA
27a013f7,34,2617,29.1,29,24,5,3,32,30,2,30.3,32.0,-1.7,22,SPA
27dc1378,29,2012,22.4,23,14,6,5,29,39,-10,36.2,30.9,5.3,22,SPA
2946f9a1,28,1555,17.3,17,14,11,8,42,19,23,35.6,25.2,10.4,22,SPA
29b61deb,27,1366,15.2,17,0,10,3,9,26,-17,12.2,21.4,-9.2,22,SPA
2a0c8ba4,36,2514,27.9,31,11,5,1,38,21,17,31.4,25.8,5.6,22,SPA
2a9f6b4d,6,301,3.3,4,1,2,2,6,3,3,6.1,3.0,3.2,22,SPA
2ad0e5e5,14,317,3.5,3,1,11,17,3,6,-3,2.5,5.4,-2.9,22,SPA
2ae30661,7,186,2.1,1,0,6,13,0,4,-4,1.8,5.5,-3.7,22,SPA
2bea832e,1,9,0.1,0,0,1,2,0,0,0,0.3,0.2,0.1,22,SPA
2bed3eab,26,2039,22.7,23,16,3,7,46,20,26,42.1,21.7,20.4,22,SPA
2bef2bca,30,2272,25.2,25,22,5,1,48,29,19,42.2,23.8,18.4,22,SPA
2c56a792,27,1114,12.4,12,2,15,4,21,10,11,21.5,12.8,8.6,22,SPA
2dce876a,1,24,0.3,0,0,1,14,0,0,0,0.0,0.1,0.0,22,SPA
2fbe6af0,5,178,2.0,2,0,3,20,4,1,3,2.4,0.8,1.6,22,SPA
30061f53,1,90,1.0,1,1,0,13,2,3,-1,2.6,0.9,1.6,22,SPA
3024e383,23,1083,12.0,12,4,11,12,14,20,-6,13.6,22.0,-8.4,22,SPA
3061e1ec,2,180,2.0,2,2,0,32,1,2,-1,2.6,5.0,-2.4,22,SPA
31f5b89b,8,516,5.7,6,2,2,19,7,3,4,5.8,4.6,1.3,22,SPA
32974271,32,1710,19.0,20,3,12,3,21,25,-4,21.5,18.6,3.0,22,SPA
32c0491f,6,322,3.6,3,0,3,4,7,9,-2,4.7,9.2,-4.5,22,SPA
3318286e,35,3136,34.8,35,34,0,2,43,55,-12,36.6,56.2,-19.6,22,SPA
335039a2,32,1644,18.3,17,8,15,5,22,24,-2,16.6,29.3,-12.6,22,SPA
335fa267,9,400,4.4,4,0,5,1,7,7,0,6.2,4.9,1.2,22,SPA
3376a776,18,1098,12.2,11,9,7,4,19,8,11,12.8,10.3,2.4,22,SPA
33a61a52,19,1514,16.8,18,13,1,5,16,37,-21,18.1,23.1,-5.0,22,SPA
34269bdf,29,1412,15.7,13,6,16,2,11,19,-8,17.4,14.9,2.4,22,SPA
34caa4b3,17,1029,11.4,13,3,4,20,15,12,3,19.1,9.5,9.600000000000001,22,SPA
34e393f2,32,2529,28.1,29,23,3,3,49,26,23,41.0,28.9,12.2,22,SPA
3521abfe,8,344,3.8,3,2,5,24,6,2,4,5.9,5.0,0.9,22,SPA
355c883a,24,1616,18.0,17,11,7,13,13,31,-18,16.7,26.7,-10.1,22,SPA
3594a357,7,219,2.4,1,0,6,17,3,4,-1,3.4,3.3,0.1,22,SPA
35a6e5c7,7,108,1.2,0,0,7,4,0,3,-3,2.2,1.4,0.8,22,SPA
35d4f151,4,150,1.7,1,1,3,4,2,3,-1,1.0,3.5,-2.5,22,SPA
360d70f8,6,177,2.0,1,0,5,7,1,8,-7,1.6,3.8,-2.2,22,SPA
3624ce4c,22,1500,16.7,18,10,4,11,22,32,-10,17.3,28.5,-11.2,22,SPA
365113c0,11,512,5.7,5,2,6,9,9,17,-8,9.4,10.6,-1.2,22,SPA
3672b352,26,879,9.8,9,1,17,12,13,16,-3,9.8,16.6,-6.8,22,SPA
374d5158,18,1066,11.8,15,6,3,12,16,11,5,10.6,11.7,-1.1,22,SPA
374ee424,35,3150,35.0,35,35,0,3,34,32,2,47.2,33.1,14.1,22,SPA
375ed9d7,10,257,2.9,2,0,8,6,2,5,-3,2.0,5.0,-3.0,22,SPA
379652be,21,990,11.0,14,0,7,17,16,20,-4,12.6,15.3,-2.8,22,SPA
37e103f8,31,1846,20.5,22,4,9,3,27,28,-1,20.700000000000003,21.9,-1.2000000000000002,22,SPA
37f1cf47,1,4,0.0,0,0,1,29,0,0,0,0.1,0.0,0.1,22,SPA
37f827ec,30,2552,28.4,29,25,1,4,29,40,-11,28.2,46.6,-18.5,22,SPA
38126309,4,117,1.3,1,0,3,14,2,5,-3,1.3,2.7,-1.5,22,SPA
38699c72,31,1672,18.6,21,4,10,2,21,25,-4,20.3,21.2,-0.9,22,SPA
38b0cf42,5,132,1.5,1,0,4,16,0,2,-2,2.0,1.1,0.9,22,SPA
38ce1150,25,1760,19.6,20,8,5,0,23,43,-20,22.4,27.1,-4.7,22,SPA
3902e91b,29,1692,18.8,20,6,9,1,25,39,-14,24.8,27.1,-2.3,22,SPA
3a58d075,10,181,2.0,1,0,9,14,5,5,0,2.9,5.3,-2.4,22,SPA
3a9c4b7b,35,2902,32.2,33,27,2,1,32,40,-8,33.0,35.9,-2.9,22,SPA
3aa4a3be,22,567,6.3,4,0,18,16,5,10,-5,6.199999999999999,7.0,-0.8,22,SPA
3aa74860,1,2,0.0,0,0,1,4,0,1,-1,0.0,0.1,-0.1,22,SPA
3b3cbebb,1,4,0.0,0,0,1,8,0,0,0,0.0,0.0,0.0,22,SPA
3ca6106c,26,714,7.9,4,0,22,7,5,13,-8,11.1,13.1,-1.9,22,SPA
3cefcaef,22,1734,19.3,20,14,2,2,41,12,29,38.3,20.0,18.3,22,SPA
3d688b46,12,343,3.8,2,0,10,14,6,6,0,6.6,5.2,1.3,22,SPA
3d7e48ce,20,1065,11.8,11,2,9,7,14,9,5,11.8,12.4,-0.6,22,SPA
3e42f707,35,3105,34.5,35,34,0,1,37,45,-8,34.5,41.5,-7.0,22,SPA
3ecc11d8,22,1860,20.7,21,20,1,6,20,20,0,27.4,19.5,7.9,22,SPA
3ee0dd59,36,2591,28.8,26,25,10,0,30,30,0,41.4,31.8,9.7,22,SPA
3eed9821,1,90,1.0,1,1,0,22,2,2,0,0.9,0.3,0.6,22,SPA
3f10bd22,25,1786,19.8,19,14,6,0,29,16,13,25.3,20.2,5.2,22,SPA
3f2d59fe,11,658,7.3,8,5,3,1,5,12,-7,8.7,10.0,-1.2,22,SPA
3f79a1c8,17,1300,14.4,15,6,2,0,14,26,-12,16.0,21.9,-5.9,22,SPA
3fc45c73,27,2341,26.0,26,23,1,0,28,18,10,31.2,25.0,6.2,22,SPA
405f267a,23,1395,15.5,17,6,6,9,13,20,-7,15.0,21.1,-6.1,22,SPA
40883e3a,16,625,6.9,6,4,10,17,7,12,-5,9.5,9.9,-0.4,22,SPA
4112ace5,34,2383,26.5,29,13,5,0,28,26,2,34.2,27.7,6.6,22,SPA
411fabd7,7,99,1.1,0,0,7,11,1,1,0,2.5,1.0,1.5,22,SPA
41b3069f,16,1090,12.1,13,8,3,15,11,17,-6,10.0,14.3,-4.3,22,SPA
41c12f75,32,2803,31.1,32,28,0,0,24,28,-4,22.3,27.8,-5.6,22,SPA
41f32541,24,1850,20.6,21,17,3,0,29,17,12,21.7,19.2,2.5,22,SPA
42a028c5,6,197,2.2,2,0,4,14,4,6,-2,1.9,3.7,-1.9,22,SPA
43f71e77,35,1966,21.8,19,10,16,2,30,35,-5,27.0,33.3,-6.3,22,SPA
44150beb,10,381,4.2,4,3,6,25,8,4,4,7.8,4.5,3.3,22,SPA
4442fbcd,6,118,1.3,0,0,6,26,1,3,-2,2.5,2.1,0.5,22,SPA
452c3055,16,578,6.4,7,1,9,18,11,14,-3,8.2,13.1,-4.9,22,SPA
4535e4bb,3,270,3.0,3,3,0,32,6,5,1,4.3,5.6,-1.2,22,SPA
45af8a54,31,1731,19.2,19,7,12,2,42,13,29,40.1,22.6,17.6,22,SPA
45d96179,31,2361,26.2,28,19,3,2,38,40,-2,0.0,0.0,0.0,22,SPA
45e17712,31,2522,28.0,27,25,4,0,31,37,-6,26.3,31.8,-5.5,22,SPA
45f771db,1,9,0.1,0,0,1,5,0,0,0,0.0,0.6,-0.6,22,SPA
4601e194,30,2644,29.4,30,26,0,1,54,32,22,50.4,28.2,22.2,22,SPA
466824fb,25,758,8.4,8,1,17,12,11,15,-4,9.8,13.1,-3.4,22,SPA
46a8347f,21,914,10.2,10,4,11,10,18,12,6,15.5,9.0,6.5,22,SPA
4737cebe,33,1625,18.1,17,1,16,0,13,14,-1,22.6,16.9,5.7,22,SPA
474ecac8,13,848,9.4,10,6,3,7,13,23,-10,15.8,15.4,0.4,22,SPA
484ebdb0,8,162,1.8,1,0,7,8,4,5,-1,3.1,5.9,-2.8,22,SPA
487d9b09,16,1020,11.3,12,5,4,18,8,20,-12,6.3,18.4,-12.1,22,SPA
4887118d,11,434,4.8,5,0,6,10,4,6,-2,4.1,5.5,-1.4,22,SPA
48e89655,10,312,3.5,3,0,7,21,3,6,-3,2.1,7.2,-5.1,22,SPA
4958bfb2,24,1551,17.2,17,9,7,4,37,13,24,34.0,16.5,17.5,22,SPA
49d028db,21,1464,16.3,14,14,7,16,32,21,11,24.7,20.4,4.2,22,SPA
49dbab27,34,2288,25.4,27,7,7,1,25,26,-1,24.5,28.9,-4.4,22,SPA
4a478107,35,2719,30.2,31,20,4,0,41,54,-13,46.8,41.2,5.6,22,SPA
4a5f2032,1,58,0.6,1,0,0,17,1,4,-3,0.8,1.9,-1.1,22,SPA
4a633cfe,18,1408,15.6,15,14,3,18,10,18,-8,10.5,15.6,-5.1,22,SPA
4aa253fd,25,610,6.8,4,0,21,11,16,16,0,14.0,11.5,2.5,22,SPA
4ac7608e,28,1793,19.9,19,17,9,8,21,26,-5,17.2,35.6,-18.4,22,SPA
4accb7e0,35,2405,26.7,27,13,8,1,28,34,-6,24.9,31.7,-6.8,22,SPA
4bd414c1,28,2465,27.4,28,26,0,6,42,25,17,42.3,29.6,12.8,22,SPA
4c0a6a48,8,206,2.3,1,0,7,16,2,4,-2,4.2,2.8,1.4,22,SPA
4c2e9442,29,1956,21.7,21,9,8,0,27,28,-1,22.2,26.4,-4.2,22,SPA
4c2fa917,1,1,0.0,0,0,1,5,0,0,0,0.1,0.0,0.1,22,SPA
4c5b14d2,21,471,5.2,2,0,19,12,12,5,7,9.5,5.3,4.2,22,SPA
4cee5954,5,295,3.3,3,3,2,10,5,4,1,4.1,5.4,-1.3,22,SPA
4d034881,4,151,1.7,2,1,2,0,1,2,-1,3.4,1.7,1.7,22,SPA
4d1666ff,32,2736,30.4,31,28,1,0,45,25,20,35.3,32.0,3.3,22,SPA
4d224fe8,32,2569,28.5,31,22,1,2,52,23,29,50.0,33.3,16.7,22,SPA
4d753a3f,18,1282,14.2,15,12,3,11,15,20,-5,15.2,22.2,-7.1,22,SPA
4d8cd038,15,369,4.1,1,0,14,12,13,2,11,10.0,5.6,4.4,22,SPA
4dbd0916,24,1440,16.0,17,5,7,0,25,25,0,22.1,15.3,6.8,22,SPA
4e219ad2,8,384,4.3,6,0,2,1,8,6,2,5.2,4.6,0.6,22,SPA
4eae5bc4,1,6,0.1,0,0,1,36,1,0,1,0.2,0.1,0.0,22,SPA
4f28a6ff,21,826,9.2,7,5,14,14,13,12,1,11.8,8.9,2.8,22,SPA
505dce2b,1,1,0.0,0,0,1,9,1,0,1,0.4,0.0,0.4,22,SPA
5083a734,23,1645,18.3,19,10,4,1,17,24,-7,14.9,24.3,-9.4,22,SPA
50cbc806,4,118,1.3,1,0,3,6,0,4,-4,1.3,4.3,-3.0,22,SPA
51a3c4c8,26,1504,16.7,15,13,11,8,32,25,7,25.8,17.8,8.0,22,SPA
532e1e4f,33,2855,31.7,33,30,0,1,54,33,21,54.5,37.2,17.3,22,SPA
53520a67,22,1303,14.5,17,1,5,11,9,19,-10,13.1,19.6,-6.4,22,SPA
540ec57b,31,1678,18.6,21,3,10,2,31,20,11,28.8,20.9,7.9,22,SPA
5496cc91,18,777,8.6,8,3,10,12,7,16,-9,11.8,13.0,-1.2,22,SPA
55126f3b,31,2508,27.9,29,23,2,1,50,34,16,40.7,23.0,17.8,22,SPA
555f3a0b,26,1865,20.7,21,13,5,6,34,31,3,30.1,17.1,13.0,22,SPA
56545648,4,135,1.5,1,0,3,6,4,1,3,2.5,0.8,1.8,22,SPA
57be54ec,19,548,6.1,3,1,16,3,8,8,0,8.0,6.3,1.6,22,SPA
58a9a4d9,26,1008,11.2,11,1,15,3,19,16,3,11.4,13.6,-2.2,22,SPA
58afe001,31,2663,29.6,31,27,0,0,31,27,4,25.0,28.2,-3.2,22,SPA
58bc7d18,14,1260,14.0,14,14,0,20,12,17,-5,11.8,18.9,-7.2,22,SPA
592f3158,35,2569,28.5,29,13,6,2,28,38,-10,30.3,35.0,-4.7,22,SPA
5976f83e,21,1512,16.8,17,9,4,4,23,15,8,27.0,13.5,13.5,22,SPA
59b7d823,25,1925,21.4,22,18,3,8,19,23,-4,25.5,24.9,0.6,22,SPA
5a626448,29,1286,14.3,13,4,16,8,20,14,6,22.9,17.3,5.6,22,SPA
5ab0ea87,36,3198,35.5,36,32,0,0,60,36,24,57.7,32.0,25.6,22,SPA
5acc4a10,30,2290,25.4,26,15,4,3,36,23,13,37.0,26.5,10.5,22,SPA
5ae499d0,35,2682,29.8,32,13,3,0,32,34,-2,34.8,34.7,0.1,22,SPA
5b28b2f6,31,1211,13.5,10,4,21,7,17,25,-8,14.8,22.7,-8.0,22,SPA
5c2b4f07,19,1010,11.2,10,8,9,2,22,12,10,23.1,16.1,6.9,22,SPA
5c4dc0ff,9,342,3.8,3,1,6,15,8,4,4,6.1,7.5,-1.4,22,SPA
5c7845f6,26,1648,18.3,19,12,7,7,17,25,-8,22.6,21.2,1.4,22,SPA
5c96b017,37,2375,26.4,30,1,7,1,25,36,-11,25.6,28.3,-2.7,22,SPA
5ca20b7a,24,1172,13.0,14,5,10,10,14,17,-3,15.0,15.9,-0.9,22,SPA
5ccc9672,5,188,2.1,2,0,3,13,0,4,-4,0.7,1.9,-1.2,22,SPA
5ce0b5ba,8,374,4.2,6,0,2,14,4,5,-1,6.0,2.6,3.4,22,SPA
5cec2487,6,518,5.8,6,5,0,8,9,8,1,7.1,7.8,-0.7,22,SPA
5db04597,35,2945,32.7,35,26,0,0,33,47,-14,30.5,41.7,-11.2,22,SPA
5dcf3e90,34,3060,34.0,34,34,0,0,38,31,7,45.4,33.1,12.3,22,SPA
5e1028e5,33,1801,20.0,21,3,12,2,31,22,9,22.1,22.8,-0.7,22,SPA
5e95c000,2,180,2.0,2,2,0,12,3,2,1,3.2,3.4,-0.2,22,SPA
5f0241b2,14,1260,14.0,14,14,0,4,15,29,-14,16.7,19.2,-2.5,22,SPA
5f5501ed,9,234,2.6,1,0,8,11,2,9,-7,1.4,3.6,-2.2,22,SPA
5fa714d5,2,41,0.5,0,0,2,3,0,0,0,0.5,0.2,0.3,22,SPA
6025fab1,28,2032,22.6,25,6,3,2,47,20,27,42.0,24.4,17.6,22,SPA
603116a7,12,525,5.8,5,2,7,12,10,0,10,9.2,4.2,5.1,22,SPA
605eb473,21,1890,21.0,21,21,0,13,25,31,-6,17.1,26.2,-9.1,22,SPA
608f2092,33,2855,31.7,32,28,1,1,33,40,-7,28.4,49.1,-20.7,22,SPA
61220da2,20,1422,15.8,16,8,4,0,21,28,-7,20.6,21.6,-0.9,22,SPA
61b62b33,3,7,0.1,0,0,3,9,0,0,0,0.2,0.1,0.1,22,SPA
625c144a,32,2880,32.0,32,32,0,6,50,28,22,51.6,34.0,17.7,22,SPA
6265208f,37,3122,34.7,35,30,2,0,30,58,-28,35.7,50.5,-14.9,22,SPA
63b0ca6b,34,2157,24.0,24,15,10,4,22,30,-8,25.7,28.8,-3.1,22,SPA
63f04c6c,28,1701,18.9,19,8,9,9,33,18,15,30.3,22.7,7.6,22,SPA
64035864,1,6,0.1,0,0,1,9,1,0,1,0.2,0.1,0.1,22,SPA
647d39d2,2,88,1.0,1,0,1,8,2,1,1,1.9,1.1,0.7,22,SPA
64e8ed6d,18,1044,11.6,11,2,7,0,13,10,3,11.0,9.5,1.5,22,SPA
66116290,22,838,9.3,8,2,14,4,10,12,-2,12.1,13.4,-1.4,22,SPA
6652cf96,22,1688,18.8,20,8,2,1,21,21,0,19.3,20.4,-1.1,22,SPA
66654daa,14,1073,11.9,12,10,2,2,10,21,-11,12.6,21.2,-8.6,22,SPA
6763373d,22,829,9.2,10,1,12,13,8,13,-5,9.6,13.8,-4.3,22,SPA
67669ce7,4,284,3.2,3,3,1,31,4,8,-4,2.4,5.0,-2.6,22,SPA
683a1d81,1,15,0.2,0,0,1,3,0,0,0,0.0,0.4,-0.4,22,SPA
697295b1,19,1551,17.2,19,13,0,5,18,26,-8,15.5,22.9,-7.4,22,SPA
69c5633e,3,79,0.9,1,0,2,8,2,1,1,0.6,1.0,-0.4,22,SPA
69cbc8b6,37,3330,37.0,37,37,0,0,39,49,-10,35.3,48.8,-13.5,22,SPA
6a99e0b1,38,2777,30.9,32,18,6,0,33,25,8,40.7,31.3,9.4,22,SPA
6c4776b1,38,3420,38.0,38,38,0,0,35,51,-16,39.5,48.3,-8.7,22,SPA
6c7762c3,25,1924,21.4,22,12,3,5,29,19,10,31.3,22.2,9.1,22,SPA
6c811eb7,33,2320,25.8,30,6,3,1,23,20,3,18.0,23.5,-5.6,22,SPA
6ce1f46f,28,2103,23.4,25,15,3,2,37,18,19,40.2,25.3,14.9,22,SPA
6d8f8441,6,118,1.3,1,0,5,32,6,2,4,5.1,2.9,2.2,22,SPA
6e36226f,8,283,3.1,3,0,5,23,4,5,-1,2.7,4.6,-2.0,22,SPA
6e4df551,29,1784,19.8,19,6,10,1,29,11,18,19.4,18.4,1.0,22,SPA
6eaed4eb,30,2699,30.0,30,29,0,2,28,54,-26,31.9,44.0,-12.2,22,SPA
6ed1a2a2,24,1077,12.0,10,3,14,13,9,15,-6,11.0,15.7,-4.7,22,SPA
6f392eb8,1,11,0.1,0,0,1,5,0,0,0,0.3,0.0,0.3,22,SPA
6f4c734d,11,386,4.3,4,0,7,4,6,3,3,7.9,3.3,4.5,22,SPA
6f51e382,35,3150,35.0,35,35,0,0,61,34,27,58.4,31.5,26.9,22,SPA
6f5f82c0,32,2289,25.4,25,12,7,5,28,22,6,36.8,22.9,13.9,22,SPA
70d74ece,32,2593,28.8,31,18,1,1,65,23,42,56.6,28.6,28.0,22,SPA
70f8e0bd,36,2832,31.5,33,20,3,1,29,43,-14,30.0,38.2,-8.2,22,SPA
7106f0a0,14,712,7.9,8,7,6,23,4,15,-11,7.3,15.4,-8.0,22,SPA
7111d552,35,2690,29.9,30,15,5,0,65,22,43,54.9,31.0,23.9,22,SPA
719384c1,24,1331,14.8,13,4,11,3,17,30,-13,14.4,26.4,-12.0,22,SPA
7226539b,34,3025,33.6,34,32,0,2,36,40,-4,37.7,42.7,-5.0,22,SPA
72a84002,28,1803,20.0,23,11,5,5,20,24,-4,21.8,24.9,-3.1,22,SPA
72a99e38,23,819,9.1,5,2,18,12,15,14,1,13.8,13.7,0.1,22,SPA
73683fa9,36,3177,35.3,36,34,0,0,39,49,-10,34.4,47.5,-13.1,22,SPA
7460ca0d,33,2704,30.0,32,23,1,1,54,32,22,53.6,34.4,19.2,22,SPA
755da865,4,137,1.5,1,1,3,7,2,6,-4,1.7,4.4,-2.7,22,SPA
75645f0e,33,1573,17.5,18,2,15,4,30,18,12,24.4,20.5,3.9,22,SPA
759d8dd7,14,469,5.2,5,1,9,20,5,7,-2,3.2,6.8,-3.7,22,SPA
75bd85ea,28,1507,16.7,17,1,11,6,19,28,-9,20.5,19.8,0.7,22,SPA
766f48dd,31,1148,12.8,9,3,22,2,18,16,2,19.0,14.3,4.7,22,SPA
7868c973,1,12,0.1,0,0,1,0,0,0,0,0.0,0.0,0.0,22,SPA
79f2a5f5,21,1700,18.9,21,12,0,6,22,20,2,22.1,22.2,-0.1,22,SPA
7a538238,32,2304,25.6,27,19,5,4,28,41,-13,24.3,41.7,-17.4,22,SPA
7b5ab7f2,13,753,8.4,9,2,4,2,5,7,-2,7.8,8.5,-0.8,22,SPA
7b9c2d84,26,1236,13.7,13,6,13,8,33,13,20,27.7,19.1,8.6,22,SPA
7dcf86f6,37,3087,34.3,36,26,1,0,41,39,2,38.8,42.4,-3.6,22,SPA
7e98cff1,3,260,2.9,3,1,0,8,12,3,9,6.5,3.6,2.8,22,SPA
7f203b54,1,45,0.5,1,0,0,10,0,4,-4,0.2,0.8,-0.6,22,SPA
7f4c7c9f,29,1977,22.0,22,15,7,4,28,43,-15,34.4,34.4,0.0,22,SPA
808d48f3,25,1828,20.3,21,14,4,6,17,32,-15,20.5,26.9,-6.4,22,SPA
81442ecb,31,2260,25.1,26,17,5,1,32,13,19,29.6,19.2,10.4,22,SPA
81d5c497,23,884,9.8,9,2,14,12,10,20,-10,11.9,13.6,-1.7,22,SPA
81f0781e,17,1191,13.2,14,9,3,1,22,14,8,22.2,13.1,9.1,22,SPA
8249ff06,1,7,0.1,0,0,1,3,0,0,0,0.6,0.0,0.6,22,SPA
833fb62e,29,1462,16.2,19,0,10,1,14,15,-1,12.4,15.8,-3.4,22,SPA
84399660,33,2131,23.7,26,2,7,3,42,21,21,34.9,22.5,12.4,22,SPA
8455ad90,30,1411,15.7,15,2,15,3,16,27,-11,16.3,18.5,-2.2,22,SPA
84f55b4a,3,51,0.6,0,0,3,2,1,1,0,1.1,1.0,0.1,22,SPA
857cb4f3,1,1,0.0,0,0,1,1,0,0,0,0.0,0.0,0.0,22,SPA
85bed4ee,21,881,9.8,10,0,11,12,16,14,2,15.2,15.0,0.2,22,SPA
85dace26,17,1020,11.3,13,3,4,2,9,16,-7,10.7,17.5,-6.8,22,SPA
8696bc90,16,474,5.3,4,0,12,16,14,8,6,6.3,5.3,1.0,22,SPA
87b498b0,2,108,1.2,1,1,1,30,1,3,-2,1.4,1.1,0.3,22,SPA
88050721,27,1160,12.9,13,3,14,0,14,24,-10,15.4,17.6,-2.2,22,SPA
881cd6be,22,992,11.0,9,4,13,13,7,15,-8,6.9,11.5,-4.6,22,SPA
881ef58c,13,525,5.8,6,0,7,12,3,12,-9,5.0,8.3,-3.4,22,SPA
89f951b5,35,2182,24.2,26,12,9,1,30,19,11,26.9,22.4,4.5,22,SPA
8aafd64f,24,1263,14.0,13,4,11,0,28,22,6,20.0,13.1,7.0,22,SPA
8ac501f5,14,668,7.4,7,3,7,7,6,11,-5,7.1,12.4,-5.3,22,SPA
8b298f56,5,60,0.7,0,0,5,5,2,0,2,1.5,0.9,0.6,22,SPA
8b625720,5,239,2.7,2,1,3,17,0,5,-5,1.0,5.1,-4.0,22,SPA
8b788c01,9,490,5.4,7,0,2,0,7,2,5,4.8,4.1,0.8,22,SPA
8c3c640c,22,1671,18.6,19,11,3,0,18,22,-4,24.8,20.5,4.3,22,SPA
8c725b43,23,1988,22.1,22,18,1,7,32,20,12,27.4,25.1,2.4,22,SPA
8cfc2f69,29,1544,17.2,19,1,10,4,18,26,-8,18.5,23.3,-4.8,22,SPA
8d47bb39,26,2108,23.4,24,15,2,2,19,36,-17,19.6,37.8,-18.2,22,SPA
8db394aa,18,1347,15.0,16,11,2,5,10,23,-13,12.2,22.4,-10.2,22,SPA
8e088e04,11,590,6.6,7,3,4,4,5,9,-4,6.0,6.5,-0.5,22,SPA
8e48dc61,17,867,9.6,11,3,6,21,10,10,0,11.5,8.5,3.0,22,SPA
8e92be30,32,2140,23.8,26,5,6,1,21,21,0,31.0,23.5,7.5,22,SPA
8f29e08b,2,180,2.0,2,2,0,31,1,3,-2,1.1,2.3,-1.2,22,SPA
8f3565b3,28,1738,19.3,20,9,8,2,18,24,-6,19.4,23.9,-4.5,22,SPA
8f5e92a6,33,1523,16.9,17,2,16,1,38,13,25,31.9,22.5,9.4,22,SPA
8f696594,28,1851,20.6,20,15,8,1,31,21,10,31.5,19.3,12.2,22,SPA
8f898ba8,29,1168,13.0,11,5,18,6,12,20,-8,12.8,18.7,-5.9,22,SPA
8f8c6934,38,3414,37.9,38,37,0,0,32,41,-9,29.1,38.5,-9.4,22,SPA
90162357,9,395,4.4,5,2,4,26,6,6,0,4.4,3.7,0.8,22,SPA
9038c2a1,19,753,8.3,11,1,8,14,10,13,-3,9.7,12.6,-2.8,22,SPA
90bbd822,36,2998,33.3,34,24,2,0,36,44,-8,39.8,42.1,-2.2,22,SPA
91f7631f,22,1378,15.3,17,2,5,0,12,18,-6,14.0,16.5,-2.6,22,SPA
924ff27e,2,180,2.0,2,2,0,13,0,5,-5,2.5,3.1,-0.6,22,SPA
93090f69,21,1687,18.7,19,16,2,4,21,31,-10,19.1,30.3,-11.1,22,SPA
93b054dc,1,9,0.1,0,0,1,0,0,0,0,0.0,0.1,0.0,22,SPA
94e01ec6,3,188,2.1,2,1,1,15,2,5,-3,1.2,5.2,-4.0,22,SPA
963829d0,35,2178,24.2,27,6,8,1,51,22,29,45.6,26.4,19.2,22,SPA
968a1c2f,31,1166,13.0,8,3,23,2,15,13,2,14.9,14.1,0.7,22,SPA
974322dc,20,719,8.0,7,2,13,18,7,14,-7,6.4,9.0,-2.5,22,SPA
97572117,5,244,2.7,3,1,2,14,3,3,0,1.5,3.7,-2.3,22,SPA
97852360,34,3053,33.9,34,33,0,1,29,60,-31,33.6,51.7,-18.1,22,SPA
97d08e60,17,412,4.6,1,1,16,19,5,8,-3,6.0,6.4,-0.4,22,SPA
981c1863,6,21,0.2,0,0,6,22,2,3,-1,1.2,2.1,-0.9,22,SPA
98529579,1,1,0.0,0,0,1,3,0,0,0,0.0,0.1,-0.1,22,SPA
9939e168,36,2915,32.4,33,21,3,1,30,41,-11,29.7,38.6,-8.9,22,SPA
9970da54,4,277,3.1,3,3,1,33,1,4,-3,2.0,4.5,-2.5,22,SPA
99bebd12,10,279,3.1,2,0,8,14,3,7,-4,3.9,4.6,-0.7,22,SPA
99ea2ddd,23,1425,15.8,16,9,7,5,12,23,-11,12.8,21.4,-8.6,22,SPA
9a0408b6,31,1097,12.2,11,1,20,4,12,15,-3,14.7,16.1,-1.4,22,SPA
9a28eba4,11,382,4.2,4,1,7,6,12,7,5,8.3,4.0,4.3,22,SPA
9a64e67e,37,3330,37.0,37,37,0,0,37,37,0,48.5,38.0,10.6,22,SPA
9c36ed83,9,165,1.8,0,0,9,2,3,3,0,3.9,2.7,1.1,22,SPA
9c435456,2,25,0.3,0,0,2,1,2,0,2,0.7,0.1,0.6,22,SPA
9d66fbe3,18,664,7.4,7,0,11,7,11,15,-4,10.7,8.4,2.3,22,SPA
9e098912,28,1386,15.4,17,4,11,9,8,27,-19,14.2,25.2,-11.0,22,SPA
9e1035f8,18,1412,15.7,17,10,1,0,31,11,20,25.9,14.9,11.0,22,SPA
9ed40a69,9,398,4.4,4,0,5,11,4,9,-5,2.3,6.8,-4.6,22,SPA
9f0ea33f,6,540,6.0,6,6,0,30,13,9,4,12.6,10.8,1.8,22,SPA
9f323c71,22,1679,18.7,19,9,3,12,27,13,14,28.5,15.3,13.2,22,SPA
9fc0f253,11,833,9.3,9,9,2,21,3,15,-12,6.4,15.9,-9.5,22,SPA
9fec8860,19,793,8.8,9,3,10,16,16,13,3,9.9,11.6,-1.7,22,SPA
a01c3d54,13,1166,13.0,13,12,0,22,12,29,-17,14.6,17.9,-3.3,22,SPA
a0255c67,27,1144,12.7,11,2,16,3,23,23,0,17.3,19.8,-2.6,22,SPA
a08b974a,30,2125,23.6,23,14,7,1,30,20,10,23.8,23.6,0.2,22,SPA
a0b4bb3e,14,331,3.7,3,0,11,14,11,2,9,8.2,3.6,4.7,22,SPA
a254bbe0,29,1616,18.0,19,1,10,6,10,31,-21,16.6,24.5,-8.0,22,SPA
a2c1a8d3,4,360,4.0,4,4,0,10,5,5,0,4.2,5.3,-1.1,22,SPA
a300ac7e,33,2326,25.9,27,8,6,1,29,31,-2,29.0,35.8,-6.8,22,SPA
a35134ae,10,404,4.5,3,3,7,13,2,9,-7,3.6,5.5,-1.9,22,SPA
a39bb753,18,717,8.0,7,1,11,11,11,10,1,12.9,8.4,4.4,22,SPA
a3e4bf46,28,2189,24.3,24,22,4,8,24,39,-15,25.4,30.7,-5.3,22,SPA
a4971d84,35,3115,34.6,35,33,0,0,30,37,-7,26.9,32.3,-5.4,22,SPA
a4995f48,36,3240,36.0,36,36,0,1,36,48,-12,35.5,44.0,-8.4,22,SPA
a4b00319,37,3298,36.6,37,35,0,0,43,43,0,41.5,44.7,-3.2,22,SPA
a55d8df5,19,856,9.5,9,1,10,17,7,11,-4,10.2,10.5,-0.3,22,SPA
a56da3ba,23,1934,21.5,22,19,1,9,19,27,-8,17.9,21.0,-3.1,22,SPA
a58bb1e1,5,280,3.1,4,0,1,8,5,3,2,3.9,3.3,0.6,22,SPA
a6103274,34,1462,16.2,16,0,18,1,18,20,-2,19.4,19.7,-0.3,22,SPA
a6154613,35,1835,20.4,20,5,15,2,35,26,9,31.2,17.6,13.5,22,SPA
a6536561,1,1,0.0,0,0,1,13,0,0,0,0.0,0.0,0.0,22,SPA
a6951bf8,20,830,9.2,8,1,12,1,9,10,-1,10.1,11.7,-1.5,22,SPA
a6de370d,34,2791,31.0,33,19,1,0,48,31,17,38.1,33.0,5.1,22,SPA
a7416105,1,31,0.3,0,0,1,0,0,0,0,0.0,0.4,-0.4,22,SPA
a7a9d95a,18,787,8.7,10,0,8,8,16,11,5,13.9,10.9,3.1,22,SPA
a83d8b0c,3,39,0.4,0,0,3,10,0,2,-2,0.1,1.9,-1.8,22,SPA
a8542814,21,859,9.5,8,4,13,9,17,9,8,14.4,8.2,6.2,22,SPA
a952a529,13,284,3.2,2,1,11,9,6,4,2,4.5,3.4,1.1,22,SPA
a98f3cbf,1,2,0.0,0,0,1,16,0,0,0,0.4,0.3,0.1,22,SPA
a9dc785c,3,270,3.0,3,3,0,33,7,4,3,5.0,2.9,2.1,22,SPA
aa0ac32d,23,1773,19.7,20,15,3,10,25,36,-11,25.9,25.9,0.0,22,SPA
aa677a35,32,2051,22.8,22,14,10,4,21,32,-11,24.1,32.7,-8.6,22,SPA
aad53e64,21,865,9.6,9,0,12,7,6,11,-5,9.8,8.8,1.0,22,SPA
ab7bf91d,24,1986,22.1,22,21,2,4,28,23,5,30.3,24.4,5.9,22,SPA
abb3bb95,21,654,7.3,6,2,15,13,12,3,9,12.7,3.9,8.8,22,SPA
abe66106,20,1015,11.3,10,2,10,1,19,5,14,16.6,9.5,7.1,22,SPA
ac295d9e,6,540,6.0,6,6,0,31,12,5,7,8.5,4.9,3.6,22,SPA
ac454a4f,31,1890,21.0,20,10,11,2,26,34,-8,16.0,35.1,-19.1,22,SPA
ac7e7b1c,21,672,7.5,6,0,15,14,4,10,-6,6.4,11.0,-4.6,22,SPA
ac8b2421,26,1931,21.5,22,17,4,5,22,28,-6,17.1,32.8,-15.7,22,SPA
ace50e9f,1,11,0.1,0,0,1,0,0,0,0,0.0,0.6,-0.6,22,SPA
acf5410c,2,13,0.1,0,0,2,13,0,0,0,0.6,0.2,0.4,22,SPA
ad1ffcfd,20,1034,11.5,12,8,8,18,24,10,14,26.5,16.0,10.5,22,SPA
ad81ba78,1,17,0.2,0,0,1,3,1,0,1,1.1,0.0,1.0,22,SPA
adfc9123,27,2092,23.2,25,19,2,1,44,19,25,45.3,20.0,25.2,22,SPA
ae48c5cb,6,166,1.8,2,0,4,15,2,4,-2,1.6,2.9,-1.3,22,SPA
ae86d473,29,973,10.8,8,2,21,3,19,16,3,13.6,12.9,0.8,22,SPA
aed746df,32,1614,17.9,17,3,15,0,19,35,-16,19.1,28.0,-8.9,22,SPA
afdc14d7,34,1337,14.9,11,1,23,0,19,15,4,19.6,15.3,4.3,22,SPA
b05e2dbd,24,1871,20.8,22,16,2,0,31,32,-1,25.4,27.5,-2.1,22,SPA
b0616e3d,27,1434,15.9,15,9,12,3,23,22,1,18.6,22.5,-3.9,22,SPA
b0fce72c,32,1358,15.1,17,4,15,5,16,16,0,21.6,15.9,5.7,22,SPA
b14f755d,20,809,9.0,10,2,10,13,7,16,-9,9.9,17.7,-7.7,22,SPA
b19db005,21,1409,15.7,15,7,6,2,33,14,19,29.6,13.6,16.0,22,SPA
b233e8e4,19,1117,12.4,12,8,7,12,12,22,-10,13.6,17.8,-4.2,22,SPA
b2d03887,7,108,1.2,0,0,7,2,1,2,-1,1.0,1.9,-0.9,22,SPA
b2d0ec1b,32,1384,15.4,15,1,17,4,12,20,-8,16.4,21.9,-5.5,22,SPA
b3b62f94,3,136,1.5,1,1,2,13,0,3,-3,0.7,2.7,-2.0,22,SPA
b3dc6eca,18,1424,15.8,17,15,1,13,28,17,11,24.0,17.9,6.1,22,SPA
b418dbd4,35,1802,20.0,24,1,11,1,19,17,2,24.2,20.7,3.5,22,SPA
b4a014b1,34,2957,32.9,34,30,0,0,48,27,21,37.8,31.4,6.4,22,SPA
b4c23f36,2,12,0.1,0,0,2,2,0,0,0,1.0,0.0,1.0,22,SPA
b51b1b9c,29,1259,14.0,13,1,16,5,13,18,-5,11.3,17.2,-5.9,22,SPA
b5bdf144,2,135,1.5,1,1,1,22,0,1,-1,0.9,2.5,-1.6,22,SPA
b5dd3469,19,1214,13.5,17,5,2,13,17,27,-10,19.9,19.0,0.9,22,SPA
b5f63410,17,541,6.0,4,1,13,14,6,10,-4,7.5,9.9,-2.3,22,SPA
b6160ad0,38,3420,38.0,38,38,0,0,43,43,0,43.1,45.7,-2.6,22,SPA
b6e50615,14,1015,11.3,11,8,3,3,16,10,6,16.4,8.6,7.8,22,SPA
b742cc0d,23,1993,22.1,23,22,0,8,34,24,10,30.9,24.6,6.3,22,SPA
b75ac54b,19,1464,16.3,17,14,2,12,14,18,-4,15.4,18.9,-3.5,22,SPA
b7c99b9b,34,3042,33.8,34,32,0,2,31,56,-25,35.3,47.8,-12.6,22,SPA
b7ca5c51,19,1592,17.7,19,15,0,2,22,17,5,15.7,17.1,-1.4,22,SPA
b7d7f3bf,7,54,0.6,0,0,7,12,1,1,0,2.0,1.1,0.9,22,SPA
b7de5bad,1,4,0.0,0,0,1,0,0,0,0,0.1,0.0,0.1,22,SPA
b857bd29,17,1530,17.0,17,17,0,0,20,30,-10,19.3,21.5,-2.1,22,SPA
b8a642fc,27,1333,14.8,12,3,15,0,26,14,12,25.2,21.2,4.0,22,SPA
b8bd60fe,2,124,1.4,2,0,0,3,1,0,1,1.8,0.3,1.4,22,SPA
b8c1de25,25,1550,17.2,20,9,5,1,19,25,-6,14.1,29.1,-15.1,22,SPA
b9d0446f,16,1044,11.6,11,9,5,17,11,18,-7,10.2,13.2,-3.0,22,SPA
ba5004e1,35,2711,30.1,31,19,4,1,26,28,-2,22.8,30.4,-7.6,22,SPA
bad38a94,9,203,2.3,1,1,8,23,1,4,-3,2.6,4.8,-2.2,22,SPA
bb08bce9,29,2403,26.7,28,20,1,3,32,34,-2,26.7,32.1,-5.4,22,SPA
bbc19252,26,1143,12.7,11,3,15,6,22,32,-10,18.5,22.9,-4.3,22,SPA
bbf5c11b,34,1808,20.1,18,9,16,0,35,23,12,23.4,21.1,2.3,22,SPA
bc49fd34,3,82,0.9,0,0,3,2,0,3,-3,0.9,2.4,-1.5,22,SPA
bc61cc65,10,338,3.8,4,0,6,28,2,7,-5,3.9,7.4,-3.6,22,SPA
bc6f5f06,31,2720,30.2,31,27,0,6,34,47,-13,31.9,43.9,-12.0,22,SPA
bdb624a3,27,1422,15.8,16,0,11,0,23,17,6,22.5,14.3,8.2,22,SPA
bdc74a8f,10,298,3.3,2,1,8,8,2,6,-4,2.1,5.3,-3.2,22,SPA
be170419,9,622,6.9,7,6,2,24,8,11,-3,9.6,8.1,1.5,22,SPA
be32269e,17,1437,16.0,16,13,1,8,13,27,-14,14.0,21.9,-7.9,22,SPA
be3a0121,3,243,2.7,3,1,0,23,1,2,-1,1.5,2.2,-0.7,22,SPA
bece776f,34,2794,31.0,33,15,1,1,51,32,19,42.8,34.1,8.8,22,SPA
bed68338,10,580,6.4,6,1,4,3,8,8,0,10.5,5.3,5.2,22,SPA
bef0a7ac,14,590,6.6,6,0,8,3,9,8,1,5.7,8.1,-2.4,22,SPA
bf12926c,7,140,1.6,1,0,6,20,1,2,-1,1.9,2.8,-0.9,22,SPA
bfd381b3,26,1934,21.5,23,11,3,5,18,36,-18,18.8,27.5,-8.7,22,SPA
c00097d2,27,2010,22.3,21,17,6,9,39,41,-2,39.6,33.6,6.0,22,SPA
c05dfb74,35,2785,30.9,34,15,1,2,35,27,8,40.5,27.1,13.4,22,SPA
c0617e2b,11,276,3.1,2,1,9,6,8,2,6,8.0,4.7,3.3,22,SPA
c14bc029,3,201,2.2,2,2,1,0,4,2,2,2.9,2.7,0.2,22,SPA
c20bdcd7,17,1298,14.4,15,11,2,0,27,12,15,20.5,14.0,6.5,22,SPA
c2111b45,5,341,3.8,4,3,1,26,11,2,9,7.7,7.0,0.6,22,SPA
c261b5dd,1,90,1.0,1,1,0,5,0,2,-2,0.5,1.2,-0.7,22,SPA
c31ea173,1,45,0.5,0,0,1,0,0,2,-2,0.1,0.4,-0.4,22,SPA
c4b888df,25,1544,17.2,17,9,8,4,16,22,-6,17.0,25.2,-8.1,22,SPA
c67cd65c,32,2420,26.9,27,23,5,2,35,55,-20,39.1,37.2,1.9,22,SPA
c7069d87,17,928,10.3,13,0,4,0,9,15,-6,7.7,12.6,-4.9,22,SPA
c7429db3,4,93,1.0,1,0,3,10,3,4,-1,1.7,1.9,-0.3,22,SPA
c77a8043,33,2261,25.1,25,8,8,5,27,34,-7,24.6,36.1,-11.5,22,SPA
c78b352d,19,1414,15.7,18,9,1,1,20,11,9,15.1,14.8,0.3,22,SPA
c818c4d9,8,645,7.2,8,7,0,29,4,13,-9,8.6,11.7,-3.1,22,SPA
c997b942,6,199,2.2,3,0,3,12,2,3,-1,2.4,1.3,1.1,22,SPA
c9cb972b,4,343,3.8,3,3,1,28,8,4,4,4.3,4.7,-0.4,22,SPA
c9e39d91,37,3021,33.6,36,20,1,0,38,33,5,36.9,37.2,-0.3,22,SPA
c9e99e49,14,1098,12.2,13,6,1,3,26,10,16,20.1,10.7,9.3,22,SPA
cac2537b,30,1701,18.9,17,6,13,2,27,44,-17,26.6,28.5,-1.9,22,SPA
cb574619,21,1826,20.3,21,17,0,1,23,25,-2,22.9,23.3,-0.4,22,SPA
cbdf7d5c,15,380,4.2,3,1,12,3,5,4,1,3.1,5.6,-2.5,22,SPA
cbec0059,6,115,1.3,1,0,5,7,1,1,0,0.4,1.1,-0.7,22,SPA
ccbbe661,13,667,7.4,5,3,8,0,11,7,4,8.8,12.1,-3.3,22,SPA
cce181df,28,1882,20.9,21,13,7,1,33,24,9,26.0,20.1,5.9,22,SPA
ce8039aa,31,1116,12.4,7,0,24,4,15,14,1,12.9,16.8,-3.8,22,SPA
cee88597,35,3147,35.0,35,34,0,0,35,48,-13,39.6,46.8,-7.2,22,SPA
cf59e05f,1,11,0.1,0,0,1,0,1,0,1,0.5,0.3,0.2,22,SPA
d080ed5e,34,2890,32.1,33,26,1,0,40,24,16,44.2,31.8,12.4,22,SPA
d1b060e2,23,641,7.1,6,0,17,14,9,16,-7,7.8,8.2,-0.4,22,SPA
d2110326,29,1948,21.6,21,17,8,4,23,35,-12,19.9,31.6,-11.7,22,SPA
d38fdf53,28,1575,17.5,17,7,11,9,30,17,13,32.8,19.7,13.0,22,SPA
d49f3e6b,24,1713,19.0,22,9,2,0,20,25,-5,16.1,30.0,-13.9,22,SPA
d4b73232,18,1620,18.0,18,18,0,17,18,20,-2,15.4,19.3,-3.8,22,SPA
d5dd5f1f,17,1082,12.0,13,0,4,0,26,10,16,21.5,11.2,10.3,22,SPA
d637fc22,26,1179,13.1,12,7,14,10,11,25,-14,11.9,22.6,-10.7,22,SPA
d6e3d7fb,1,90,1.0,1,1,0,2,1,1,0,1.7,0.9,0.9,22,SPA
d709cd5c,2,25,0.3,0,0,2,2,0,0,0,0.2,0.1,0.2,22,SPA
d733aa38,28,809,9.0,6,0,22,10,10,14,-4,10.0,12.1,-2.1,22,SPA
d7553721,16,994,11.0,11,4,5,0,19,10,9,17.1,13.9,3.2,22,SPA
d83bbc54,20,1627,18.1,19,9,1,9,25,29,-4,21.0,21.599999999999998,-0.6,22,SPA
d83f09ff,2,70,0.8,1,0,1,27,0,2,-2,0.3,0.7,-0.4,22,SPA
d8712bf9,29,867,9.6,6,0,23,9,10,16,-6,13.2,14.1,-0.9,22,SPA
d87e2cae,32,1604,17.8,19,3,13,2,30,18,12,27.2,18.5,8.7,22,SPA
d9ba39fc,21,1644,18.3,19,14,2,3,13,13,0,24.2,16.1,8.1,22,SPA
da4e70e5,1,65,0.7,0,0,1,2,1,0,1,0.4,0.1,0.4,22,SPA
dafa5038,1,4,0.0,0,0,1,21,0,0,0,0.0,0.2,-0.2,22,SPA
db001fa9,37,3329,37.0,37,36,0,0,35,51,-16,38.8,48.1,-9.2,22,SPA
db750822,7,221,2.5,1,0,6,15,1,3,-2,2.5,2.3,0.2,22,SPA
db8f0eba,32,1986,22.1,24,6,8,6,21,23,-2,21.1,28.2,-7.1,22,SPA
dc008610,5,176,2.0,1,0,4,14,1,7,-6,1.2,4.4,-3.2,22,SPA
dc1c2fce,34,2168,24.1,24,11,10,2,28,17,11,33.3,20.2,13.1,22,SPA
dc1ce4f5,6,212,2.4,3,1,3,16,1,5,-4,1.3,4.5,-3.3,22,SPA
dc62b55d,29,1063,11.8,8,0,21,1,28,14,14,22.9,12.6,10.2,22,SPA
ddd5348b,4,173,1.9,3,0,1,0,4,1,3,2.8,2.8,0.1,22,SPA
de39485a,34,2583,28.7,28,14,6,0,52,34,18,42.2,24.7,17.5,22,SPA
de627c8a,1,4,0.0,0,0,1,1,0,0,0,0.0,0.6,-0.6,22,SPA
de903ae2,1,23,0.3,0,0,1,2,0,0,0,0.1,0.8,-0.8,22,SPA
dea912dc,1,90,1.0,1,1,0,2,3,1,2,2.4,1.0,1.5,22,SPA
debc6b55,1,45,0.5,0,0,1,1,2,2,0,0.8,1.8,-1.0,22,SPA
dee86451,33,1805,20.1,20,8,13,2,37,25,12,32.8,29.1,3.7,22,SPA
df69b544,29,1958,21.7,24,7,5,1,31,20,11,28.5,17.400000000000002,11.1,22,SPA
df8b52a5,3,91,1.0,1,0,2,0,3,3,0,1.8,1.0,0.8,22,SPA
e1846dde,24,2160,24.0,24,24,0,12,36,46,-10,38.6,36.4,2.2,22,SPA
e1e75690,5,88,1.0,1,0,4,8,2,2,0,1.6,1.5,0.1,22,SPA
e2716bd0,25,1720,19.1,22,5,3,1,24,11,13,27.6,18.2,9.4,22,SPA
e3fabb0a,23,474,5.3,4,0,19,14,2,7,-5,4.9,7.7,-2.8,22,SPA
e4346678,24,2160,24.0,24,24,0,14,28,35,-7,21.9,40.2,-18.3,22,SPA
e49ce451,19,605,6.800000000000001,6,4,13,14,4,4,0,7.3,6.1,1.2000000000000002,22,SPA
e54bd0a2,29,1444,16.0,16,3,13,4,12,32,-20,14.2,23.2,-9.0,22,SPA
e5ec95f8,25,647,7.2,5,0,20,11,4,15,-11,6.0,14.1,-8.100000000000001,22,SPA
e6777e6b,32,2667,29.6,31,24,1,4,31,32,-1,23.6,29.3,-5.8,22,SPA
e6bc67d7,36,2606,29.0,30,14,6,1,40,42,-2,30.3,35.2,-4.9,22,SPA
e7630876,1,1,0.0,0,0,1,1,0,0,0,0.0,0.0,0.0,22,SPA
e7ab4179,10,403,4.5,5,0,5,12,3,6,-3,3.2,5.4,-2.2,22,SPA
e897d8ba,33,1862,20.7,18,8,15,1,20,30,-10,21.8,23.2,-1.5,22,SPA
e8deefd6,1,31,0.3,0,0,1,14,2,0,2,0.0,0.0,0.0,22,SPA
e92cd3f7,33,1763,19.6,20,8,13,0,23,18,5,29.5,18.8,10.7,22,SPA
e94d79e3,10,663,7.4,9,2,1,3,6,13,-7,7.2,10.5,-3.2,22,SPA
e9ada8cf,9,462,5.1,4,3,5,21,3,12,-9,4.1,8.3,-4.2,22,SPA
ea6a7ab4,9,115,1.3,0,0,9,15,0,4,-4,1.5,4.7,-3.2,22,SPA
ea83bfa6,22,1964,21.8,21,21,1,14,32,21,11,29.4,24.0,5.4,22,SPA
ea9b2ef9,32,2299,25.5,25,21,7,2,30,47,-17,27.2,43.6,-16.5,22,SPA
ead61f73,13,783,8.7,9,6,4,17,10,6,4,10.3,7.5,2.8,22,SPA
eaefa2d0,2,29,0.3,0,0,2,5,0,1,-1,0.1,1.0,-0.9,22,SPA
eb3dd471,37,3111,34.6,36,18,1,0,29,57,-28,35.4,49.0,-13.6,22,SPA
eb82b6f1,33,2261,25.1,29,7,4,1,21,31,-10,19.9,37.5,-17.6,22,SPA
ec1a731e,25,1830,20.3,20,17,5,12,22,27,-5,19.7,25.3,-5.6,22,SPA
ecc77652,13,656,7.3,7,2,6,5,5,15,-10,10.1,9.3,0.8,22,SPA
ecd8c01e,15,743,8.3,8,5,7,4,11,12,-1,7.5,11.3,-3.9,22,SPA
ed3f5f4c,6,183,2.0,1,0,5,12,3,5,-2,1.6,3.4,-1.8,22,SPA
ed5c5fa3,37,2597,28.9,31,14,6,0,34,28,6,31.5,34.3,-2.8,22,SPA
ed6ea4d9,25,1376,15.3,16,3,9,5,18,22,-4,16.4,22.9,-6.5,22,SPA
ed9f7cfe,29,1181,13.1,13,3,16,7,17,13,4,15.2,10.8,4.4,22,SPA
ee37317d,32,2312,25.7,26,16,6,0,27,43,-16,0.0,0.0,0.0,22,SPA
ee8508c0,38,3420,38.0,38,38,0,0,65,43,22,54.4,33.4,21.1,22,SPA
ee923664,17,1334,14.8,16,10,1,18,16,15,1,14.3,18.0,-3.8,22,SPA
eeba07f8,37,2844,31.6,34,19,3,0,33,51,-18,32.2,50.6,-18.3,22,SPA
ef322658,28,1393,15.5,17,5,11,7,21,15,6,20.7,18.9,1.8,22,SPA
efecd633,12,830,9.2,10,2,2,0,9,10,-1,6.9,8.9,-2.0,22,SPA
f03f284b,18,743,8.3,8,1,10,8,4,7,-3,6.8,12.1,-5.2,22,SPA
f08490a6,23,1472,16.4,17,6,6,0,25,19,6,25.1,20.8,4.3,22,SPA
f090a37a,15,487,5.4,2,2,13,23,7,4,3,7.0,5.3,1.7,22,SPA
f0da930c,24,2042,22.7,24,19,0,5,39,22,17,33.8,18.7,15.1,22,SPA
f13d02a6,22,1118,12.4,13,5,9,11,14,23,-9,13.0,19.8,-6.8,22,SPA
f1bed920,13,435,4.8,5,1,8,24,3,13,-10,4.5,7.8,-3.4,22,SPA
f2308b33,9,226,2.5,1,0,8,13,0,8,-8,2.1,5.4,-3.3,22,SPA
f2a68b97,25,1844,20.5,21,14,4,5,15,27,-12,21.0,25.1,-4.1,22,SPA
f2c6ac01,36,3181,35.3,36,34,0,1,36,59,-23,36.8,45.3,-8.5,22,SPA
f3451c66,1,9,0.1,0,0,1,4,0,0,0,0.1,0.0,0.1,22,SPA
f38284bb,1,90,1.0,1,1,0,1,3,1,2,1.9,0.5,1.4,22,SPA
f3b1d9a2,19,884,9.8,9,1,10,4,10,13,-3,11.3,11.9,-0.7,22,SPA
f4c69aa6,14,818,9.1,9,4,5,0,6,11,-5,8.5,11.9,-3.4,22,SPA
f6798fc3,31,2790,31.0,31,31,0,2,40,24,16,33.0,31.5,1.5,22,SPA
f6ac68c1,28,2440,27.1,28,27,0,2,48,24,24,38.8,23.4,15.4,22,SPA
f7dc2ae5,30,2105,23.4,22,19,8,6,27,21,6,31.5,22.6,8.9,22,SPA
f874dd44,23,1979,22.0,22,21,1,5,40,23,17,34.6,23.9,10.7,22,SPA
f8eca1b6,37,2798,31.1,33,14,4,0,28,35,-7,24.6,30.1,-5.5,22,SPA
f9358b61,1,7,0.1,0,0,1,1,0,0,0,1.0,0.3,0.7,22,SPA
f9acf8bf,7,258,2.9,2,2,5,10,3,10,-7,4.5,5.0,-0.5,22,SPA
fa265f6d,6,192,2.1,2,0,4,10,2,1,1,3.0,2.3,0.7,22,SPA
faed84db,28,1206,13.4,13,4,15,9,15,20,-5,13.6,18.2,-4.6,22,SPA
fb5d47b3,12,623,6.9,7,4,5,26,14,8,6,11.7,9.4,2.3,22,SPA
fb938d24,18,1157,12.9,12,3,6,0,14,10,4,13.9,12.8,1.1,22,SPA
fbbb9269,10,788,8.8,9,8,1,7,10,8,2,9.1,10.7,-1.6,22,SPA
fbd6378b,17,1375,15.3,14,14,3,19,28,15,13,29.3,20.2,9.0,22,SPA
fc076f78,1,1,0.0,0,0,1,0,0,0,0,0.0,0.4,-0.4,22,SPA
fc3d2006,1,3,0.0,0,0,1,10,0,0,0,0.0,0.0,0.0,22,SPA
fc647b34,32,2007,22.3,24,2,8,1,23,21,2,23.4,24.5,-1.1,22,SPA
fc70e345,31,2772,30.8,30,30,1,6,35,37,-2,34.2,36.8,-2.5,22,SPA
fc8b614b,5,72,0.8,0,0,5,11,1,1,0,2.0,1.6,0.5,22,SPA
fd51b456,29,1833,20.4,20,11,9,8,39,18,21,37.7,25.9,11.8,22,SPA
fd771f95,4,235,2.6,3,1,1,15,6,4,2,4.0,2.4,1.6,22,SPA
fdd60087,12,440,4.9,4,2,8,8,12,9,3,7.7,9.2,-1.5,22,SPA
fe05804b,14,947,10.5,10,8,4,20,9,23,-14,8.0,17.3,-9.3,22,SPA
fe641c1a,26,1549,17.2,15,9,11,1,23,12,11,16.1,20.1,-4.1,22,SPA
fed17f5a,32,2474,27.5,28,15,4,0,38,33,5,28.6,32.2,-3.6,22,SPA
ffacd3d5,33,2257,25.1,25,14,8,3,24,29,-5,23.6,25.7,-2.1,22,SPA
005ca692,6,474,5.3,5,5,1,0,1,12,-11,5.4,9.9,-4.5,22,CL
00672021,4,266,3.0,3,0,1,0,1,6,-5,2.9,5.3,-2.4,22,CL
00844823,3,188,2.1,2,2,1,1,1,2,-1,0.4,4.1,-3.7,22,CL
00f0482f,1,23,0.3,0,0,1,0,0,0,0,0.0,0.2,-0.2,22,CL
016ff750,6,117,1.3,1,0,5,2,1,0,1,1.0,1.9,-0.9,22,CL
01834aa0,3,205,2.3,2,2,1,2,2,4,-2,1.9,4.8,-2.9,22,CL
0193a8bf,6,531,5.9,6,5,0,0,7,11,-4,7.2,10.2,-3.0,22,CL
01b8a2b2,7,630,7.0,7,7,0,1,10,10,0,11.1,10.4,0.8,22,CL
01c3aff5,6,389,4.3,4,3,2,0,6,7,-1,6.0,7.2,-1.2,22,CL
01eb744d,10,405,4.5,3,2,7,0,5,7,-2,6.4,7.7,-1.3,22,CL
02c15616,9,700,7.8,8,7,1,0,7,4,3,9.8,8.5,1.3,22,CL
032f894e,5,404,4.5,5,2,0,0,6,4,2,6.4,4.2,2.3,22,CL
03df04ff,10,900,10.0,10,10,0,0,14,17,-3,11.8,21.4,-9.7,22,CL
042e8a49,9,628,7.0,8,3,1,0,21,4,17,19.9,5.5,14.4,22,CL
048a1cbc,3,182,2.0,2,1,1,0,4,1,3,4.2,1.5,2.6,22,CL
049a888d,6,182,2.0,1,0,5,0,1,4,-3,2.7,3.3,-0.6,22,CL
04e17fd5,2,83,0.9,1,0,1,0,1,1,0,1.4,2.8,-1.3,22,CL
05439de2,12,1039,11.5,12,10,0,1,24,11,13,17.4,16.5,0.9,22,CL
056269d7,5,222,2.5,2,1,3,1,2,4,-2,3.2,5.0,-1.8,22,CL
05d548d8,5,355,3.9,5,2,0,0,8,4,4,7.6,3.4,4.2,22,CL
05e19d6a,5,321,3.6,4,3,1,0,5,5,0,5.0,5.4,-0.4,22,CL
061e8e23,2,90,1.0,1,0,1,4,0,1,-1,0.1,1.2,-1.2,22,CL
0630eb63,1,32,0.4,0,0,1,7,0,0,0,0.1,0.4,-0.3,22,CL
0670ee51,5,329,3.7,4,3,1,1,3,6,-3,5.4,7.9,-2.5,22,CL
06a1d642,2,53,0.6,1,0,1,6,0,1,-1,0.8,1.9,-1.1,22,CL
06d4b2e4,3,95,1.1,0,0,3,3,1,0,1,1.6,0.4,1.2,22,CL
06e5b0e4,5,450,5.0,5,5,0,1,0,13,-13,1.4,13.3,-11.8,22,CL
08d37c53,5,446,5.0,5,4,0,1,1,12,-11,1.4,12.2,-10.8,22,CL
08f5afaa,5,450,5.0,5,5,0,3,10,6,4,9.0,8.4,0.6,22,CL
091c86e2,2,38,0.4,0,0,2,4,1,2,-1,0.2,2.1,-1.9,22,CL
0959c2a2,11,805,8.9,8,6,3,0,19,13,6,14.4,14.4,0.1,22,CL
0a396655,5,355,3.9,5,1,0,1,4,8,-4,1.9,7.6,-5.7,22,CL
0a6dbbf7,3,133,1.5,1,1,2,3,2,6,-4,1.9,7.5,-5.7,22,CL
0a89e877,4,55,0.6,0,0,4,2,2,0,2,2.5,1.5,1.0,22,CL
0a8fd9cb,1,16,0.2,0,0,1,4,0,0,0,0.1,0.2,-0.1,22,CL
0ab1f153,7,472,5.2,5,3,2,1,6,7,-1,7.7,7.7,0.0,22,CL
0aeeed3f,3,269,3.0,3,2,0,0,3,6,-3,5.1,4.9,0.2,22,CL
0ba976e4,3,154,1.7,1,0,2,0,1,2,-1,1.4,2.5,-1.1,22,CL
0c09c984,2,124,1.4,1,1,1,0,1,1,0,0.2,2.6,-2.3,22,CL
0c152537,5,133,1.5,1,0,4,2,2,4,-2,2.2,2.7,-0.5,22,CL
0c61c77c,6,299,3.3,2,2,4,0,3,7,-4,2.9,7.8,-5.0,22,CL
0cc5f4a5,5,324,3.6,3,3,2,0,3,7,-4,3.4,7.9,-4.5,22,CL
0d267745,9,810,9.0,9,9,0,1,12,12,0,10.8,16.6,-5.8,22,CL
0d82903c,7,552,6.1,7,5,0,0,10,6,4,11.2,7.1,4.1,22,CL
0d9b2d31,2,157,1.7,2,1,0,0,0,4,-4,1.4,3.1,-1.7,22,CL
0db169ae,6,331,3.7,4,0,2,0,2,6,-4,2.3,6.1,-3.7,22,CL
0e5b695f,1,1,0.0,0,0,1,0,0,0,0,0.0,0.0,0.0,22,CL
0e6bc38c,4,52,0.6,0,0,4,2,4,1,3,1.5,0.8,0.7,22,CL
0e96a5e1,5,417,4.6,5,2,0,1,5,8,-3,4.8,7.0,-2.2,22,CL
0eb83e1a,6,314,3.5,3,2,3,0,4,9,-5,1.9,7.4,-5.5,22,CL
0ef89a37,4,111,1.2,0,0,4,2,0,3,-3,0.4,3.5,-3.0,22,CL
0f41e2ee,2,180,2.0,2,2,0,8,2,5,-3,2.0,5.4,-3.4,22,CL
101da2b5,8,353,3.9,2,2,6,4,6,9,-3,8.8,6.9,2.0,22,CL
10549b49,5,304,3.4,3,2,2,0,6,8,-2,5.8,6.4,-0.6,22,CL
108fe016,5,256,2.8,2,1,3,1,1,9,-8,4.0,4.7,-0.8,22,CL
116c35df,6,390,4.3,5,2,1,0,9,7,2,8.1,5.3,2.7,22,CL
119b9a8e,9,791,8.8,9,6,0,1,18,9,9,17.9,6.8,11.1,22,CL
11b9265b,7,311,3.5,3,0,4,0,9,8,1,6.4,5.3,1.1,22,CL
11c7fa75,3,270,3.0,3,3,0,2,4,6,-2,3.1,4.6,-1.5,22,CL
11d8aff0,1,90,1.0,1,1,0,5,5,0,5,3.8,0.9,2.9,22,CL
1265a93a,6,506,5.6,5,5,1,1,12,8,4,10.6,7.4,3.3,22,CL
129af0db,7,517,5.7,6,2,1,0,8,8,0,10.5,7.0,3.5,22,CL
12dcbdcc,8,386,4.3,2,2,6,0,9,13,-4,5.3,8.5,-3.2,22,CL
13203c45,6,361,4.0,4,1,2,0,3,6,-3,2.4,7.4,-4.9,22,CL
1338e42b,9,713,7.9,8,3,1,1,13,13,0,10.8,16.7,-5.9,22,CL
1467af0d,5,430,4.8,5,3,0,1,11,6,5,9.8,6.8,2.9,22,CL
149c5f5d,3,58,0.6,0,0,3,3,2,3,-1,0.8,0.9,-0.1,22,CL
14b8fcdf,4,179,2.0,2,1,2,3,1,2,-1,4.2,2.2,1.9,22,CL
15f3ec41,5,288,3.2,3,0,2,1,8,2,6,8.7,3.8,4.9,22,CL
15fd5593,7,236,2.6,1,1,6,0,7,2,5,5.0,3.0,2.0,22,CL
162efffd,9,578,6.4,5,3,4,1,8,7,1,9.7,10.2,-0.5,22,CL
165a2e40,7,529,5.9,6,4,1,0,5,4,1,6.5,5.2,1.4,22,CL
16ceb862,5,260,2.9,3,0,2,0,1,4,-3,1.6,4.6,-3.0,22,CL
17370b95,2,25,0.3,0,0,2,4,1,0,1,0.8,0.1,0.7,22,CL
178ae8f8,11,578,6.4,7,1,4,1,14,7,7,15.3,4.8,10.5,22,CL
17e3e467,6,485,5.4,6,4,0,0,1,8,-7,3.8,7.9,-4.1,22,CL
1840e36d,13,1230,13.7,13,13,0,0,29,14,15,21.6,20.1,1.5,22,CL
18a88e3e,1,3,0.0,0,0,1,4,1,0,1,0.5,0.0,0.5,22,CL
18b896d6,9,840,9.3,9,9,0,1,18,7,11,16.3,8.4,7.9,22,CL
19709006,1,23,0.3,0,0,1,5,0,0,0,0.0,0.1,-0.1,22,CL
19a967ab,3,23,0.3,0,0,3,3,0,3,-3,0.6,1.1,-0.5,22,CL
19cae58d,6,397,4.4,4,1,2,0,1,6,-5,4.8,7.1,-2.3,22,CL
19cda00b,5,259,2.9,3,0,2,0,5,3,2,7.0,4.2,2.8,22,CL
1a2935f6,4,315,3.5,4,3,0,1,5,9,-4,4.7,6.7,-2.0,22,CL
1a4b9094,5,128,1.4,0,0,5,3,4,2,2,2.4,1.4,1.0,22,CL
1a799243,8,715,7.9,8,7,0,0,10,14,-4,12.2,12.7,-0.5,22,CL
1a992676,4,143,1.6,1,0,3,2,3,3,0,3.2,3.5,-0.3,22,CL
1adcf39e,4,360,4.0,4,4,0,1,1,6,-5,4.1,6.6,-2.5,22,CL
1b81794d,4,63,0.7,0,0,4,1,2,3,-1,0.8,2.0,-1.2,22,CL
1bacc518,6,522,5.8,6,5,0,0,2,9,-7,6.4,9.1,-2.7,22,CL
1bd5735a,6,159,1.8,1,1,5,0,0,3,-3,1.8,1.8,0.0,22,CL
1bf33a9a,7,366,4.1,4,0,3,0,9,6,3,6.4,5.5,0.9,22,CL
1c78737d,6,109,1.2,0,0,6,0,5,2,3,4.5,1.1,3.4,22,CL
1cb49278,8,601,6.7,8,5,0,2,12,6,6,10.6,6.9,3.6,22,CL
1cbe4984,4,171,1.9,2,0,2,0,2,4,-2,2.4,3.5,-1.1,22,CL
1e064bfb,1,90,1.0,1,1,0,5,0,0,0,0.6,1.0,-0.4,22,CL
1e1378e1,8,513,5.7,6,2,2,0,9,10,-1,10.6,7.2,3.4,22,CL
1e4319ac,1,10,0.1,0,0,1,1,0,0,0,0.1,0.1,0.0,22,CL
1f079188,2,18,0.2,0,0,2,9,0,1,-1,1.3,0.5,0.8,22,CL
1f44ac21,3,203,2.3,2,1,1,0,4,4,0,5.1,3.0,2.1,22,CL
1fbbfbde,6,540,6.0,6,6,0,0,11,8,3,10.3,7.5,2.8,22,CL
20030c06,4,315,3.5,4,3,0,0,7,13,-6,6.3,8.0,-1.7,22,CL
20730eae,4,291,3.2,4,1,0,1,4,4,0,2.8,5.8,-2.9,22,CL
2146785a,4,315,3.5,4,3,0,0,3,7,-4,2.6,6.9,-4.3,22,CL
21512407,3,219,2.4,3,2,0,1,2,6,-4,2.5,4.9,-2.4,22,CL
24051310,6,387,4.3,5,2,1,0,2,6,-4,4.3,5.7,-1.5,22,CL
244bc2c8,8,259,2.9,3,0,5,1,4,7,-3,5.4,4.5,0.9,22,CL
2475dcc6,7,630,7.0,7,7,0,1,18,6,12,16.9,8.8,8.1,22,CL
24fc70d3,4,346,3.8,4,3,0,0,4,7,-3,5.5,6.9,-1.5,22,CL
2567b7b6,6,540,6.0,6,6,0,0,7,11,-4,4.4,12.2,-7.9,22,CL
277c49ed,6,540,6.0,6,6,0,0,5,10,-5,4.8,11.1,-6.2,22,CL
2784f898,12,1074,11.9,12,9,0,0,26,11,15,20.1,16.3,3.9,22,CL
27d0a506,7,524,5.8,7,2,0,1,8,12,-4,8.9,8.0,0.9,22,CL
28b1f3ce,6,447,5.0,6,2,0,0,2,4,-2,6.2,4.1,2.1,22,CL
28c6e925,8,646,7.2,8,4,0,0,9,10,-1,11.4,11.5,-0.1,22,CL
28d596a0,1,90,1.0,1,1,0,9,3,3,0,2.7,2.6,0.0,22,CL
292a652a,3,193,2.1,2,2,1,2,1,6,-5,2.8,3.7,-0.9,22,CL
292f1130,4,312,3.5,4,3,0,1,2,11,-9,3.3,10.9,-7.5,22,CL
2946f9a1,9,575,6.4,5,3,4,4,11,8,3,10.6,9.5,1.1,22,CL
29733c72,3,96,1.1,1,0,2,5,1,1,0,1.2,1.3,-0.1,22,CL
2973d8ff,5,384,4.3,4,4,1,0,2,14,-12,3.2,15.3,-12.1,22,CL
2a0c8ba4,6,326,3.6,4,0,2,0,2,3,-1,3.6,4.4,-0.8,22,CL
2a1beb34,6,482,5.4,6,4,0,0,9,12,-3,8.1,7.8,0.3,22,CL
2a6cd437,5,174,1.9,1,0,4,1,2,6,-4,3.8,3.4,0.3,22,CL
2b0852db,4,42,0.5,0,0,4,4,1,3,-2,0.2,0.8,-0.6,22,CL
2b09d998,5,293,3.3,3,2,2,0,7,12,-5,6.1,8.1,-2.0,22,CL
2b114be3,10,795,8.8,9,5,1,0,28,5,23,22.9,5.9,16.9,22,CL
2bab583c,1,1,0.0,0,0,1,1,1,0,1,0.4,0.0,0.4,22,CL
2bc28bb9,2,180,2.0,2,2,0,1,4,1,3,2.5,2.5,0.0,22,CL
2bed3eab,4,246,2.7,3,1,1,1,1,5,-4,2.6,5.1,-2.5,22,CL
2bef2bca,5,367,4.1,4,3,1,0,0,9,-9,3.1,8.0,-4.9,22,CL
2bf50b37,5,165,1.8,1,0,4,1,2,8,-6,1.3,7.1,-5.8,22,CL
2c0558b8,8,449,5.0,5,2,3,0,14,2,12,11.8,3.3,8.5,22,CL
2c0f8e9e,6,159,1.8,1,0,5,1,2,4,-2,1.5,1.4,0.1,22,CL
2c56a792,4,248,2.8,2,2,2,2,1,3,-2,2.7,5.8,-3.1,22,CL
2ccd89a3,4,329,3.7,4,2,0,1,5,10,-5,4.0,11.4,-7.4,22,CL
2cf496fb,2,85,0.9,0,0,2,2,1,3,-2,0.6,1.3,-0.7,22,CL
2d970560,2,100,1.1,2,1,0,0,2,2,0,1.4,2.3,-0.9,22,CL
2e4f5f03,10,826,9.2,9,8,1,3,22,10,12,19.5,9.2,10.4,22,CL
2ebc1b44,3,92,1.0,1,0,2,3,0,2,-2,1.8,1.2,0.6,22,CL
2edbd8d5,1,90,1.0,1,1,0,5,1,3,-2,0.4,2.3,-1.9,22,CL
2ef7c612,6,496,5.5,6,2,0,0,5,17,-12,5.4,16.7,-11.3,22,CL
2f33776f,1,55,0.6,1,0,0,0,0,3,-3,0.8,2.5,-1.7,22,CL
2f72f79e,6,288,3.2,2,2,4,0,0,8,-8,0.5,8.2,-7.7,22,CL
2f7af524,3,190,2.1,2,2,1,2,0,9,-9,1.3,6.3,-5.1,22,CL
2f90f6b8,8,213,2.4,3,0,5,3,7,3,4,5.2,3.1,2.2,22,CL
2fabebc0,2,180,2.0,2,2,0,4,4,4,0,4.5,2.9,1.7,22,CL
2fba6108,3,172,1.9,2,1,1,3,2,2,0,2.4,1.7,0.7,22,CL
2fbe6af0,1,21,0.2,0,0,1,3,1,0,1,0.9,0.4,0.5,22,CL
30941e96,5,430,4.8,5,3,0,0,14,11,3,11.9,8.1,3.7,22,CL
30d4a2e5,5,450,5.0,5,5,0,0,1,10,-9,3.1,8.1,-4.9,22,CL
30e03a25,3,81,0.9,0,0,3,3,2,4,-2,0.3,2.7,-2.4,22,CL
30f5ffa9,8,720,8.0,8,8,0,0,9,7,2,12.8,7.8,5.0,22,CL
31a62dc7,7,589,6.5,7,5,0,1,7,4,3,9.2,4.5,4.7,22,CL
31c69ef1,8,664,7.4,7,7,1,2,23,13,10,17.2,7.4,9.8,22,CL
3260690c,6,235,2.6,2,0,4,0,2,5,-3,3.4,3.4,0.1,22,CL
32f76907,1,1,0.0,0,0,1,0,0,0,0,0.0,0.0,0.0,22,CL
335fa267,3,168,1.9,2,0,1,0,0,5,-5,1.4,3.3,-1.8,22,CL
33651873,7,560,6.2,7,6,0,0,13,13,0,11.3,10.7,0.5,22,CL
3376a776,4,125,1.4,1,0,3,2,2,1,1,2.4,1.8,0.6,22,CL
33887998,9,840,9.3,9,9,0,1,18,7,11,16.3,8.4,7.9,22,CL
3392603d,6,540,6.0,6,6,0,1,20,6,14,15.2,7.7,7.5,22,CL
33b11df6,6,481,5.3,6,3,0,0,8,8,0,8.2,6.8,1.4,22,CL
33b8d077,8,631,7.0,8,4,0,0,9,6,3,12.2,6.7,5.5,22,CL
33fdf90d,4,203,2.3,2,2,2,3,2,4,-2,2.0,3.7,-1.7,22,CL
34693494,1,1,0.0,0,0,1,1,0,0,0,0.0,0.0,0.0,22,CL
346d51d9,9,810,9.0,9,9,0,1,12,12,0,10.8,16.6,-5.8,22,CL
34a88e3e,1,10,0.1,0,0,1,1,0,0,0,0.1,0.0,0.1,22,CL
34c3b935,3,265,2.9,3,2,0,3,1,2,-1,3.6,2.4,1.2,22,CL
35862524,5,99,1.1,0,0,5,0,1,0,1,2.1,1.9,0.2,22,CL
36a3ff67,6,497,5.5,6,4,0,0,8,9,-1,10.1,6.8,3.3,22,CL
374d5158,4,187,2.1,2,1,2,2,2,1,1,2.6,1.2,1.4,22,CL
384d58d9,1,10,0.1,0,0,1,0,0,0,0,0.1,0.0,0.1,22,CL
387e1d35,1,7,0.1,0,0,1,3,0,0,0,0.5,0.0,0.4,22,CL
38c7feef,6,301,3.3,3,1,3,7,9,2,7,6.7,3.1,3.6,22,CL
392a7aea,6,540,6.0,6,6,0,0,6,20,-14,6.1,19.5,-13.4,22,CL
39769cff,8,720,8.0,8,8,0,0,10,14,-4,12.3,12.7,-0.5,22,CL
3a24769f,3,97,1.1,1,0,2,3,2,2,0,3.8,2.4,1.4,22,CL
3b029691,6,223,2.5,1,1,5,0,2,7,-5,3.4,5.8,-2.3,22,CL
3b333ac3,1,90,1.0,1,1,0,0,2,3,-1,2.0,2.2,-0.2,22,CL
3b61c9ec,1,4,0.0,0,0,1,1,0,0,0,0.0,0.0,0.0,22,CL
3b8674e6,5,378,4.2,5,0,0,1,5,3,2,7.2,3.7,3.5,22,CL
3b996663,4,162,1.8,2,1,2,1,0,4,-4,1.8,2.7,-0.9,22,CL
3bb7b8b4,11,1002,11.1,11,10,0,1,28,14,14,24.7,9.2,15.5,22,CL
3bb7f478,7,537,6.0,7,3,0,1,7,5,2,11.2,5.6,5.6,22,CL
3c6089ab,10,776,8.6,9,5,1,0,23,6,17,18.4,6.8,11.6,22,CL
3cefcaef,10,864,9.6,10,7,0,0,21,11,10,12.9,13.2,-0.3,22,CL
3d50bcdb,6,172,1.9,1,0,5,1,2,2,0,3.3,3.2,0.1,22,CL
3d62c18b,5,450,5.0,5,5,0,1,1,6,-5,4.0,6.5,-2.5,22,CL
3e1550ee,1,18,0.2,0,0,1,11,0,0,0,0.7,0.5,0.2,22,CL
3e96f3e7,4,305,3.4,4,2,0,1,2,12,-10,3.5,10.7,-7.3,22,CL
3ead85f9,5,393,4.4,4,4,1,1,4,6,-2,4.1,6.8,-2.6,22,CL
3eb22ec9,11,874,9.7,11,5,0,0,23,12,11,20.2,7.2,13.0,22,CL
3ef0af0d,1,12,0.1,0,0,1,1,1,1,0,0.1,0.2,0.0,22,CL
3effaa34,6,407,4.5,5,1,1,0,12,10,2,10.4,7.6,2.8,22,CL
3f034750,6,540,6.0,6,6,0,2,7,4,3,8.0,5.4,2.6,22,CL
3f10bd22,4,330,3.7,4,2,0,0,3,4,-1,4.6,6.5,-1.9,22,CL
3f359b33,2,180,2.0,2,2,0,1,2,6,-4,2.9,6.9,-4.1,22,CL
407feb71,5,348,3.9,5,1,0,0,5,6,-1,4.3,6.1,-1.8,22,CL
41034650,8,572,6.4,6,5,2,0,16,6,10,14.6,7.1,7.5,22,CL
4142f132,5,43,0.5,0,0,5,2,1,1,0,0.4,1.0,-0.6,22,CL
415568b5,2,84,0.9,1,0,1,3,1,0,1,1.8,0.4,1.4,22,CL
41f0b196,3,270,3.0,3,3,0,2,1,9,-8,2.7,7.1,-4.5,22,CL
41f32541,6,540,6.0,6,6,0,0,5,5,0,7.2,7.8,-0.6,22,CL
42130443,1,90,1.0,1,1,0,8,1,2,-1,1.2,1.7,-0.5,22,CL
42eaa028,5,297,3.3,3,1,2,0,6,1,5,5.6,1.9,3.7,22,CL
42fd9c7f,8,671,7.5,8,5,0,0,15,11,4,13.4,13.4,0.1,22,CL
4315f30d,2,101,1.1,1,1,1,7,3,3,0,2.7,2.7,-0.1,22,CL
436a9dd0,6,326,3.6,4,2,2,1,6,4,2,3.9,6.7,-2.9,22,CL
43a166b4,7,187,2.1,2,0,5,4,4,3,1,3.9,2.3,1.6,22,CL
43b78598,3,49,0.5,0,0,3,4,0,0,0,1.1,0.5,0.6,22,CL
442b56fa,6,411,4.6,5,2,1,0,5,7,-2,4.1,7.9,-3.8,22,CL
448a3608,6,278,3.1,3,1,3,0,6,3,3,5.8,2.2,3.5,22,CL
44ac04e9,4,126,1.4,1,0,3,3,0,2,-2,1.1,2.4,-1.3,22,CL
44eb9093,3,147,1.6,1,1,2,5,1,2,-1,1.4,2.9,-1.5,22,CL
45a03961,10,762,8.5,9,6,1,0,23,7,16,20.7,7.0,13.7,22,CL
45af8a54,8,209,2.3,2,0,6,5,5,1,4,2.8,4.0,-1.2,22,CL
45b9b619,5,111,1.2,0,0,5,1,1,2,-1,0.9,2.1,-1.1,22,CL
45db685d,8,557,6.2,7,3,1,1,12,5,7,9.7,5.6,4.1,22,CL
4601e194,5,373,4.1,5,3,0,0,2,2,0,5.0,3.9,1.1,22,CL
46a8347f,5,306,3.4,3,3,2,4,4,4,0,5.8,3.9,1.9,22,CL
47aaf574,4,119,1.3,0,0,4,2,0,4,-4,0.3,3.9,-3.6,22,CL
47dc80f5,9,345,3.8,4,0,5,0,5,9,-4,5.3,9.8,-4.6,22,CL
47fd5136,6,494,5.5,6,3,0,0,8,8,0,8.6,7.1,1.4,22,CL
481c9ece,7,466,5.2,5,2,2,1,7,6,1,6.7,5.5,1.2,22,CL
484a3eae,1,2,0.0,0,0,1,0,0,0,0,0.0,0.4,-0.4,22,CL
489e80e3,8,669,7.4,8,5,0,0,8,12,-4,11.3,11.9,-0.7,22,CL
48b3dd60,6,268,3.0,2,2,4,0,3,5,-2,4.7,5.0,-0.3,22,CL
48d5bd33,5,301,3.3,3,1,2,1,7,7,0,5.6,4.2,1.4,22,CL
48df060a,1,1,0.0,0,0,1,5,0,0,0,0.0,0.1,-0.1,22,CL
49296448,8,701,7.8,8,7,0,0,25,5,20,22.1,5.6,16.5,22,CL
493924a7,6,328,3.6,4,2,2,0,2,5,-3,2.3,5.8,-3.5,22,CL
4958bfb2,11,955,10.6,11,7,0,0,21,11,10,13.7,18.0,-4.2,22,CL
49fe9070,5,246,2.7,3,1,2,4,9,4,5,6.3,3.7,2.6,22,CL
4a1a9578,13,905,10.1,10,5,3,0,17,14,3,18.9,11.399999999999999,7.5,22,CL
4a5839fa,2,156,1.7,1,1,1,2,1,7,-6,1.2,3.8,-2.6,22,CL
4b803b3c,7,571,6.3,7,5,0,0,8,14,-6,10.4,11.4,-1.0,22,CL
4bd414c1,12,1042,11.6,12,9,0,0,18,15,3,17.5,17.1,0.4,22,CL
4c184730,5,118,1.3,1,0,4,0,5,2,3,3.1,1.2,1.8,22,CL
4c2a5d34,6,490,5.4,6,2,0,0,3,8,-5,7.1,7.2,-0.2,22,CL
4c370d81,7,325,3.6,2,1,5,0,11,6,5,7.1,4.3,2.8,22,CL
4c62d0c8,1,90,1.0,1,1,0,7,1,0,1,2.1,0.2,1.9,22,CL
4cde5509,4,163,1.8,1,1,3,0,2,3,-1,2.1,2.7,-0.6,22,CL
4ce20e90,1,24,0.3,0,0,1,1,1,2,-1,0.2,0.7,-0.5,22,CL
4d034881,1,16,0.2,0,0,1,0,0,0,0,0.0,0.0,0.0,22,CL
4d1666ff,5,450,5.0,5,5,0,0,5,5,0,6.2,7.0,-0.8,22,CL
4d224fe8,11,910,10.1,11,6,0,1,17,8,9,13.9,13.8,0.1,22,CL
4d77b365,10,614,6.8,6,2,4,0,11,11,0,9.1,13.5,-4.4,22,CL
4d8cd038,3,114,1.3,1,0,2,6,1,1,0,2.3,1.0,1.3,22,CL
4dbd0916,8,375,4.2,5,0,3,0,5,4,1,6.6,4.1,2.5,22,CL
4e219ad2,4,225,2.5,4,0,0,0,2,4,-2,3.1,5.4,-2.4,22,CL
4e3f5992,2,95,1.1,1,1,1,4,0,5,-5,0.3,2.7,-2.4,22,CL
4f1e6a0b,5,205,2.3,2,1,3,1,5,2,3,4.5,3.2,1.3,22,CL
4f28a6ff,4,343,3.8,4,2,0,2,2,3,-1,4.8,3.6,1.2,22,CL
4fb9c88f,4,186,2.1,2,1,2,3,5,2,3,5.2,1.5,3.7,22,CL
501055d8,8,602,6.7,8,1,0,0,9,11,-2,11.6,11.2,0.4,22,CL
507c7bdf,7,518,5.8,6,3,1,0,10,8,2,7.8,8.0,-0.3,22,CL
50871bcc,3,141,1.6,2,0,1,0,1,2,-1,1.6,1.0,0.6,22,CL
50dc94ce,4,204,2.3,3,1,1,2,3,1,2,2.0,2.4,-0.3,22,CL
515ebe8d,2,91,1.0,1,1,1,4,2,1,1,1.9,1.4,0.4,22,CL
51960957,4,78,0.9,0,0,4,0,1,1,0,0.9,2.2,-1.3,22,CL
51a3c4c8,7,469,5.2,6,3,1,1,4,7,-3,5.2,5.4,-0.1,22,CL
51cf8561,8,502,5.6,5,4,3,3,13,12,1,10.1,7.3,2.7,22,CL
51dbeea9,3,67,0.7,0,0,3,5,1,2,-1,2.5,1.1,1.4,22,CL
527f063d,4,79,0.9,0,0,4,0,4,0,4,1.6,1.4,0.3,22,CL
52b3c895,5,450,5.0,5,5,0,1,2,17,-15,4.2,17.2,-13.0,22,CL
52e101a8,1,90,1.0,1,1,0,5,0,5,-5,0.3,2.7,-2.4,22,CL
52ec54d0,7,579,6.4,6,5,1,0,10,6,4,11.3,6.7,4.7,22,CL
532e1e4f,12,1080,12.0,12,12,0,0,20,16,4,19.4,18.6,0.9,22,CL
536cebe5,2,115,1.3,2,0,0,0,3,3,0,2.2,2.5,-0.4,22,CL
539230cf,3,100,1.1,1,1,2,4,2,1,1,2.8,0.7,2.1,22,CL
53cad200,9,677,7.5,8,5,1,0,18,10,8,12.9,8.6,4.4,22,CL
540ec57b,7,426,4.7,6,0,1,2,6,3,3,7.6,6.8,0.8,22,CL
5458f670,1,25,0.3,0,0,1,2,1,0,1,1.5,0.6,0.9,22,CL
546bb36e,6,493,5.5,6,3,0,0,1,12,-11,1.4,13.2,-11.8,22,CL
54f5ce34,4,166,1.8,1,1,3,1,1,6,-5,1.9,5.9,-4.0,22,CL
55126f3b,9,659,7.3,9,3,0,0,6,8,-2,8.4,10.3,-1.8,22,CL
5515376c,3,177,2.0,1,1,2,6,6,1,5,5.0,2.5,2.5,22,CL
555f3a0b,6,422,4.7,6,2,0,4,5,7,-2,6.7,7.9,-1.2,22,CL
55abe554,6,527,5.9,6,5,0,0,6,19,-13,6.0,19.0,-13.0,22,CL
55b93ae0,5,450,5.0,5,5,0,0,6,8,-2,4.0,10.0,-6.0,22,CL
572498c7,3,220,2.4,3,1,0,0,1,5,-4,0.7,6.7,-5.9,22,CL
57760e66,1,33,0.4,0,0,1,1,0,0,0,0.7,0.7,0.0,22,CL
57a46f3f,3,25,0.3,0,0,3,4,0,0,0,0.4,0.0,0.4,22,CL
57d88cf9,6,500,5.6,6,4,0,0,9,10,-1,9.7,7.2,2.5,22,CL
5853ac44,4,213,2.4,2,1,2,6,9,4,5,7.0,2.2,4.8,22,CL
58a9a4d9,4,168,1.9,2,0,2,2,2,2,0,2.5,2.5,0.0,22,CL
58eee997,4,303,3.4,3,1,1,1,5,5,0,4.9,6.1,-1.2,22,CL
5976f83e,4,230,2.6,3,2,1,2,1,5,-4,3.7,3.3,0.5,22,CL
59bf127b,3,59,0.7,0,0,3,1,1,0,1,1.2,1.3,-0.1,22,CL
59fd245c,1,9,0.1,0,0,1,4,0,0,0,0.0,0.6,-0.6,22,CL
5a626448,6,224,2.5,2,0,4,6,5,5,0,4.4,4.2,0.2,22,CL
5ab0ea87,6,485,5.4,6,4,0,0,2,6,-4,6.4,6.5,-0.1,22,CL
5acc4a10,12,1044,11.6,12,10,0,0,19,15,4,18.5,17.5,1.0,22,CL
5ad50391,6,335,3.7,3,2,3,0,8,5,3,9.5,6.5,3.0,22,CL
5bc43860,8,714,7.9,8,7,0,0,10,14,-4,12.2,12.7,-0.5,22,CL
5c2b4f07,5,132,1.5,1,1,4,1,3,0,3,2.7,2.6,0.0,22,CL
5c4dc0ff,1,13,0.1,0,0,1,9,1,0,1,0.1,0.1,0.0,22,CL
5c899683,2,62,0.7,0,0,2,4,2,3,-1,1.4,1.7,-0.3,22,CL
5ccc9672,2,21,0.2,0,0,2,3,0,1,-1,0.1,1.7,-1.6,22,CL
5cec2c74,3,156,1.7,1,1,2,7,3,6,-3,1.3,6.4,-5.1,22,CL
5d51b074,6,486,5.4,6,2,0,0,4,10,-6,6.4,8.3,-1.9,22,CL
5dfc6ad5,6,470,5.2,5,4,1,0,7,10,-3,8.9,6.5,2.4,22,CL
5eae500a,6,320,3.6,4,2,2,2,5,3,2,6.7,4.4,2.4,22,CL
5eaf85b5,3,270,3.0,3,3,0,0,5,9,-4,3.6,9.1,-5.5,22,CL
5ed9b537,8,720,8.0,8,8,0,4,17,8,9,15.4,7.7,7.7,22,CL
5eecec3d,8,635,7.1,8,6,0,1,15,5,10,14.2,5.6,8.6,22,CL
5ef3d210,2,39,0.4,0,0,2,3,0,1,-1,0.0,0.3,-0.2,22,CL
5fa57166,1,45,0.5,0,0,1,4,0,3,-3,0.3,2.2,-1.9,22,CL
6025fab1,13,1073,11.9,12,6,1,0,22,12,10,16.4,18.2,-1.8,22,CL
603116a7,3,96,1.1,0,0,3,8,3,0,3,2.4,3.3,-0.9,22,CL
61590953,6,483,5.4,6,4,0,0,5,18,-13,4.8,16.4,-11.5,22,CL
615c4d8f,1,8,0.1,0,0,1,5,1,0,1,0.4,0.0,0.4,22,CL
625c144a,12,1080,12.0,12,12,0,0,20,16,4,19.4,18.6,0.9,22,CL
62ab9184,5,191,2.1,3,0,2,0,2,3,-1,2.5,3.1,-0.6,22,CL
636247ca,6,352,3.9,5,1,1,0,1,9,-8,1.1,9.0,-7.9,22,CL
63f04c6c,10,434,4.8,4,1,6,2,10,5,5,10.7,8.9,1.7,22,CL
6412cc03,2,87,1.0,0,0,2,4,2,7,-5,1.8,4.7,-2.9,22,CL
6434f10d,10,838,9.3,10,6,0,1,25,12,13,20.5,7.7,12.7,22,CL
645a3363,4,168,1.9,2,0,2,4,2,3,-1,3.3,2.7,0.6,22,CL
652d4c37,4,233,2.6,3,1,1,1,4,2,2,4.6,2.0,2.7,22,CL
65d62814,7,630,7.0,7,7,0,1,12,13,-1,11.0,10.6,0.3,22,CL
6622454d,9,445,4.9,5,1,4,1,7,3,4,8.8,3.2,5.7,22,CL
6796e284,4,342,3.8,4,3,0,0,0,9,-9,3.1,7.0,-3.8,22,CL
67b3d74b,5,236,2.6,3,2,2,2,3,0,3,3.6,3.5,0.1,22,CL
67cdbc0e,7,410,4.6,4,2,3,1,7,6,1,6.0,4.6,1.5,22,CL
68252d6d,4,248,2.8,3,1,1,2,7,6,1,5.2,5.9,-0.6,22,CL
683a8f5f,3,157,1.7,1,1,2,2,2,1,1,2.7,3.0,-0.3,22,CL
6853490f,6,432,4.8,5,1,1,0,8,6,2,8.6,5.3,3.2,22,CL
6885cc44,7,286,3.2,2,2,5,0,3,8,-5,3.1,6.9,-3.8,22,CL
691bef82,8,571,6.3,7,4,1,0,18,6,12,15.8,7.7,8.1,22,CL
6928979a,6,493,5.5,6,3,0,0,8,3,5,11.4,4.0,7.4,22,CL
69384e5d,6,469,5.2,5,5,1,0,8,8,0,6.1,10.6,-4.5,22,CL
6a829019,6,463,5.1,5,4,1,0,5,11,-6,5.8,9.2,-3.3,22,CL
6af56975,6,488,5.4,6,3,0,0,6,9,-3,4.2,10.5,-6.3,22,CL
6b21b7b5,3,126,1.4,1,0,2,3,3,2,1,2.7,1.2,1.5,22,CL
6b8887c2,2,99,1.1,1,0,1,2,2,2,0,2.7,2.1,0.6,22,CL
6b915aa1,6,373,4.1,5,1,1,0,0,9,-9,1.4,7.7,-6.3,22,CL
6c330f30,3,115,1.3,1,1,2,3,1,2,-1,1.5,2.0,-0.6,22,CL
6c7762c3,10,890,9.9,10,9,0,1,15,16,-1,14.6,15.9,-1.3,22,CL
6ce1f46f,12,897,10.0,11,5,1,0,17,11,6,14.0,13.7,0.3,22,CL
6ce43701,1,21,0.2,0,0,1,2,0,1,-1,0.9,0.4,0.5,22,CL
6e4df551,5,320,3.6,4,1,1,0,3,3,0,4.3,4.8,-0.5,22,CL
6eee05f1,5,260,2.9,2,1,3,0,6,5,1,6.4,3.3,3.0,22,CL
6f3cc2fe,4,310,3.4,4,1,0,2,3,6,-3,5.4,5.0,0.4,22,CL
6f51e382,6,540,6.0,6,6,0,0,2,9,-7,6.5,9.5,-3.0,22,CL
6fa3c28e,1,2,0.0,0,0,1,0,0,0,0,0.0,0.0,0.0,22,CL
6fe90922,8,530,5.9,6,3,2,0,8,6,2,10.4,5.6,4.8,22,CL
708d068c,1,18,0.2,0,0,1,0,0,0,0,0.2,0.0,0.1,22,CL
70cf63ca,9,701,7.8,8,3,1,0,10,8,2,9.4,13.4,-4.0,22,CL
70d74ece,12,1102,12.2,12,8,0,0,27,13,14,20.3,18.3,2.0,22,CL
7111d552,13,1193,13.3,13,6,0,0,29,13,16,21.6,19.4,2.3,22,CL
7120a04d,6,372,4.1,4,0,2,0,1,7,-6,3.9,7.4,-3.5,22,CL
713c144a,8,622,6.9,8,2,0,0,18,8,10,16.8,9.5,7.2,22,CL
728e9b2e,1,90,1.0,1,1,0,7,2,4,-2,1.2,2.1,-0.9,22,CL
72c812f3,7,399,4.4,5,1,2,0,10,8,2,6.3,10.2,-3.9,22,CL
733e7ad8,6,413,4.6,5,1,1,0,5,12,-7,5.0,13.1,-8.1,22,CL
73affbb6,2,81,0.9,1,0,1,1,0,3,-3,0.1,2.6,-2.5,22,CL
74419746,8,720,8.0,8,8,0,0,9,7,2,12.8,7.8,5.0,22,CL
7460ca0d,12,1053,11.7,12,7,0,0,19,16,3,18.1,18.3,-0.2,22,CL
74b7375f,5,296,3.3,4,0,1,1,3,10,-7,3.6,7.4,-3.8,22,CL
74dc806c,2,23,0.3,0,0,2,0,0,0,0,0.2,0.5,-0.3,22,CL
75b86fb3,8,667,7.4,7,6,1,0,8,6,2,11.6,7.4,4.2,22,CL
760fd987,1,90,1.0,1,1,0,3,0,2,-2,0.9,3.5,-2.6,22,CL
76c131da,1,90,1.0,1,1,0,0,1,2,-1,1.9,2.5,-0.6,22,CL
76c98b58,3,55,0.6,0,0,3,3,2,1,1,1.4,1.8,-0.4,22,CL
770ebf00,4,327,3.6,4,3,0,0,0,12,-12,1.2,10.4,-9.3,22,CL
7713c72a,1,90,1.0,1,1,0,4,1,1,0,2.0,1.0,1.0,22,CL
77e84962,10,601,6.7,7,1,3,0,11,7,4,10.8,6.7,4.1,22,CL
780e3631,4,211,2.3,3,0,1,0,3,6,-3,3.1,3.7,-0.6,22,CL
79443529,2,180,2.0,2,2,0,0,1,4,-3,2.1,3.8,-1.6,22,CL
79c0821a,6,425,4.7,5,2,1,1,6,5,1,5.8,5.6,0.2,22,CL
7a11550b,7,250,2.8,2,2,5,4,8,6,2,5.9,3.8,2.1,22,CL
7a20d90a,2,127,1.4,1,1,1,1,1,5,-4,1.9,3.6,-1.8,22,CL
7a2e46a8,13,1170,13.0,13,13,0,0,30,14,16,27.3,13.1,14.2,22,CL
7b4c1f6e,1,12,0.1,0,0,1,5,0,0,0,0.0,0.0,0.0,22,CL
7b9c2d84,10,305,3.4,1,1,9,3,13,4,9,8.9,4.6,4.4,22,CL
7ba6d84e,7,630,7.0,7,7,0,0,11,9,2,8.3,9.3,-1.0,22,CL
7c56da38,6,530,5.9,6,5,0,0,15,13,2,13.2,10.4,2.9,22,CL
7d3e7da6,1,90,1.0,1,1,0,6,1,1,0,2.3,1.1,1.1,22,CL
7e98cff1,1,65,0.7,1,0,0,3,1,1,0,2.1,0.3,1.8,22,CL
7ea03b7d,1,4,0.0,0,0,1,2,0,0,0,0.0,0.0,0.0,22,CL
7ed08d5c,2,23,0.3,0,0,2,6,4,0,4,2.9,0.0,2.9,22,CL
7edfbb8a,5,417,4.6,5,4,0,0,5,8,-3,4.4,9.2,-4.8,22,CL
7f3b388c,13,849,9.4,9,6,4,0,20,10,10,23.1,9.1,14.0,22,CL
7fe90ccd,6,404,4.5,5,3,1,0,8,8,0,7.5,6.9,0.6,22,CL
801831fe,3,23,0.3,0,0,3,3,0,0,0,0.1,0.0,0.1,22,CL
810e3c74,4,118,1.3,1,0,3,4,2,2,0,1.5,1.9,-0.4,22,CL
81442ecb,5,378,4.2,5,3,0,0,4,3,1,5.2,5.9,-0.8,22,CL
817c6964,4,250,2.8,3,0,1,0,1,3,-2,1.8,2.8,-1.0,22,CL
819b3158,10,663,7.4,6,5,4,1,12,9,3,15.6,7.8,7.8,22,CL
81f0781e,7,523,5.8,6,4,1,0,16,8,8,12.0,8.8,3.2,22,CL
828657ff,8,260,2.9,2,0,6,0,2,4,-2,3.6,3.2,0.4,22,CL
82a39b66,4,350,3.9,4,3,0,2,2,4,-2,4.6,3.8,0.8,22,CL
82e12fe7,8,237,2.6,1,0,7,0,1,6,-5,2.2,6.2,-4.0,22,CL
8474cb83,4,275,3.1,3,3,1,2,1,9,-8,0.7,7.0,-6.3,22,CL
85686f86,1,5,0.1,0,0,1,1,0,0,0,0.1,0.0,0.0,22,CL
85f7d1be,5,215,2.4,2,0,3,1,2,5,-3,2.1,3.0,-0.9,22,CL
867239d3,6,346,3.8,4,1,2,0,5,6,-1,2.9,5.9,-3.0,22,CL
8696bc90,4,205,2.3,2,1,2,2,2,1,1,2.9,1.1,1.8,22,CL
86dd77d1,7,575,6.4,7,3,0,1,11,7,4,15.0,5.6,9.3,22,CL
86e119e0,6,540,6.0,6,6,0,0,5,10,-5,4.8,11.1,-6.2,22,CL
86e7deaf,9,758,8.4,8,8,1,1,17,7,10,15.7,7.4,8.3,22,CL
8778c910,9,810,9.0,9,9,0,0,30,6,24,24.0,6.5,17.4,22,CL
8794e251,7,536,6.0,6,5,1,0,7,9,-2,9.7,8.9,0.8,22,CL
886f9aac,5,322,3.6,4,2,1,0,1,4,-3,4.1,5.5,-1.3,22,CL
88968486,6,540,6.0,6,6,0,0,1,11,-10,4.3,9.2,-4.9,22,CL
88e357ef,8,389,4.3,5,0,3,0,17,5,12,15.9,4.1,11.9,22,CL
89151b16,6,451,5.0,5,4,1,1,12,8,4,9.6,7.5,2.1,22,CL
892d5bb1,12,983,10.9,11,8,1,0,26,13,13,23.3,9.9,13.3,22,CL
89ac64a6,5,450,5.0,5,5,0,0,5,11,-6,7.9,7.6,0.3,22,CL
89f951b5,5,276,3.1,3,0,2,1,3,2,1,4.3,4.2,0.0,22,CL
8aafd64f,8,568,6.3,7,0,1,1,6,6,0,6.5,7.4,-0.9,22,CL
8b3ab7ad,7,556,6.2,7,4,0,0,17,6,11,14.7,7.6,7.1,22,CL
8b788c01,2,67,0.7,1,0,1,2,0,1,-1,0.2,0.9,-0.7,22,CL
8b8a56ce,3,270,3.0,3,3,0,1,3,4,-1,3.0,4.5,-1.5,22,CL
8b8e759d,6,320,3.6,3,2,3,0,2,5,-3,4.8,5.1,-0.2,22,CL
8bbe2df5,1,14,0.2,0,0,1,1,0,0,0,0.1,0.5,-0.4,22,CL
8ce30c57,5,405,4.5,5,3,0,0,4,14,-10,4.6,11.7,-7.2,22,CL
8d46713e,6,456,5.1,6,1,0,0,6,9,-3,6.3,7.2,-0.9,22,CL
8d78e732,10,874,9.7,10,8,0,0,30,7,23,25.3,7.6,17.8,22,CL
8e034340,6,527,5.9,6,5,0,0,6,19,-13,6.0,19.0,-13.0,22,CL
8e7f49d3,6,540,6.0,6,6,0,0,10,10,0,9.8,8.0,1.9,22,CL
8eec784d,5,254,2.8,3,0,2,1,3,4,-1,3.1,4.3,-1.2,22,CL
8f0f2230,5,266,3.0,3,2,2,1,1,9,-8,2.9,9.5,-6.6,22,CL
8f5e92a6,11,507,5.6,4,0,7,1,19,6,13,10.8,7.9,2.9,22,CL
8f696594,6,524,5.8,6,5,0,0,2,9,-7,6.4,9.5,-3.1,22,CL
8fb94908,3,202,2.2,3,0,0,1,3,2,1,1.2,4.1,-2.9,22,CL
8fd9996f,7,362,4.0,3,1,4,1,5,7,-2,8.9,7.4,1.4,22,CL
90f87966,8,720,8.0,8,8,0,0,8,8,0,10.5,7.5,2.9,22,CL
9139bb12,6,209,2.3,1,1,5,0,1,6,-5,3.7,3.7,-0.1,22,CL
91748070,1,30,0.3,0,0,1,0,0,0,0,0.0,0.7,-0.7,22,CL
921f6058,5,450,5.0,5,5,0,0,11,13,-2,7.7,9.0,-1.3,22,CL
92432bc6,4,182,2.0,1,0,3,0,4,3,1,5.0,2.2,2.7,22,CL
92ffb8f9,5,240,2.7,3,0,2,1,2,4,-2,2.8,4.9,-2.1,22,CL
934e1968,4,210,2.3,2,1,2,1,5,5,0,4.6,3.8,0.8,22,CL
935e6b8f,12,666,7.4,7,2,5,0,19,6,13,16.9,5.9,11.0,22,CL
93fffbcf,6,540,6.0,6,6,0,0,4,11,-7,8.0,8.8,-0.8,22,CL
94721522,2,135,1.5,2,1,0,3,0,6,-6,1.5,5.0,-3.5,22,CL
947e036f,6,298,3.3,4,0,2,0,3,7,-4,6.2,5.5,0.7,22,CL
94b2001f,5,450,5.0,5,5,0,1,9,6,3,9.2,6.8,2.5,22,CL
953597a1,6,368,4.1,4,3,2,2,3,10,-7,3.4,6.6,-3.1,22,CL
95bb6ddc,1,7,0.1,0,0,1,6,0,0,0,0.1,0.2,-0.1,22,CL
96094cbc,6,158,1.8,2,0,4,0,3,6,-3,2.2,7.1,-4.9,22,CL
963829d0,9,330,3.7,4,0,5,3,3,2,1,4.8,4.4,0.4,22,CL
96593e89,1,45,0.5,0,0,1,7,0,0,0,0.8,0.8,0.1,22,CL
9674002f,7,539,6.0,5,4,2,1,14,8,6,11.7,7.3,4.5,22,CL
96e0490d,5,197,2.2,3,0,2,2,2,0,2,5.7,1.5,4.2,22,CL
970b8574,7,282,3.1,3,0,4,1,2,3,-1,3.6,3.0,0.6,22,CL
9744ff80,8,506,5.6,6,1,2,0,10,9,1,8.5,6.9,1.6,22,CL
98d2c2c4,6,524,5.8,6,4,0,0,11,11,0,10.1,8.7,1.4,22,CL
99127249,7,574,6.4,7,4,0,0,20,7,13,16.3,7.7,8.6,22,CL
9a2e0ccc,6,383,4.3,5,2,1,0,11,9,2,9.1,7.4,1.7,22,CL
9b6d9b53,5,405,4.5,4,4,1,0,3,13,-10,5.0,15.6,-10.5,22,CL
9c94165b,5,396,4.4,5,3,0,0,7,8,-1,5.7,6.3,-0.6,22,CL
9dc96f10,1,67,0.7,1,0,0,1,1,1,0,1.2,1.1,0.1,22,CL
9e1035f8,1,70,0.8,1,0,0,1,4,2,2,1.7,0.6,1.0,22,CL
9e525177,6,419,4.7,5,4,1,1,10,5,5,7.3,5.5,1.8,22,CL
9f8e9423,5,352,3.9,4,3,1,0,3,6,-3,3.0,5.6,-2.6,22,CL
9fec8860,3,80,0.9,1,0,2,3,1,1,0,1.5,0.6,0.9,22,CL
a04e2dd2,4,315,3.5,4,3,0,2,1,8,-7,1.0,8.3,-7.3,22,CL
a086ae11,1,5,0.1,0,0,1,1,0,0,0,0.1,0.0,0.0,22,CL
a08b974a,6,461,5.1,5,3,1,0,3,4,-1,5.0,5.2,-0.2,22,CL
a111cf41,6,540,6.0,6,6,0,0,12,13,-1,10.2,9.1,1.1,22,CL
a1232f4e,2,180,2.0,2,2,0,6,3,3,0,2.2,2.8,-0.6,22,CL
a167537f,5,395,4.4,4,2,1,0,5,10,-5,6.4,6.6,-0.2,22,CL
a1d5bd30,5,256,2.8,3,0,2,0,4,5,-1,4.3,4.2,0.2,22,CL
a26fb8aa,5,212,2.4,2,1,3,1,6,7,-1,4.3,4.7,-0.4,22,CL
a2c51161,2,16,0.2,0,0,2,4,1,0,1,0.8,0.1,0.7,22,CL
a39bb753,3,85,0.9,1,0,2,4,1,2,-1,2.1,0.5,1.6,22,CL
a45eac1f,1,10,0.1,0,0,1,4,0,0,0,0.8,0.2,0.6,22,CL
a4851d9e,2,180,2.0,2,2,0,4,3,5,-2,1.8,3.4,-1.7,22,CL
a4effc55,2,97,1.1,1,0,1,2,5,1,4,3.7,0.9,2.8,22,CL
a5420709,2,20,0.2,0,0,2,4,0,0,0,0.4,0.2,0.2,22,CL
a58bb1e1,2,9,0.1,0,0,2,4,0,1,-1,0.0,0.2,-0.2,22,CL
a6154613,7,346,3.8,5,2,2,3,2,3,-1,3.3,6.5,-3.2,22,CL
a62c16d0,8,578,6.4,7,2,1,0,13,13,0,10.8,8.4,2.4,22,CL
a63a995f,1,90,1.0,1,1,0,1,1,1,0,1.3,1.2,0.1,22,CL
a65ce836,2,73,0.8,0,0,2,0,0,2,-2,1.4,1.7,-0.3,22,CL
a6951bf8,8,458,5.1,6,0,2,0,10,6,4,8.9,7.1,1.7,22,CL
a6de6361,1,23,0.3,0,0,1,5,0,0,0,0.0,0.2,-0.2,22,CL
a6ee4f55,7,220,2.4,2,0,5,1,3,8,-5,3.4,6.7,-3.3,22,CL
a78ff07f,6,533,5.9,6,5,0,0,12,13,-1,10.2,9.2,1.0,22,CL
a793f5a8,2,57,0.6,1,0,1,2,1,0,1,1.4,0.2,1.2,22,CL
a7a9d95a,3,74,0.8,1,0,2,7,1,0,1,1.4,1.2,0.2,22,CL
a802405e,6,73,0.8,0,0,6,0,3,3,0,2.3,1.3,1.0,22,CL
a81ed730,2,55,0.6,0,0,2,4,0,3,-3,0.5,1.3,-0.8,22,CL
a8542814,4,228,2.5,2,2,2,4,2,1,1,2.2,2.7,-0.5,22,CL
a8a874f1,7,534,5.9,7,2,0,1,8,6,2,10.1,6.7,3.4,22,CL
a9107589,3,225,2.5,2,2,1,3,0,6,-6,0.7,6.9,-6.2,22,CL
a9aa0d1d,2,35,0.4,0,0,2,4,1,2,-1,0.8,0.8,0.1,22,CL
abb3bb95,3,177,2.0,3,0,0,3,1,3,-2,3.2,1.7,1.5,22,CL
abe66106,4,123,1.4,0,0,4,0,1,0,1,1.6,1.2,0.4,22,CL
ac73ec79,6,483,5.4,6,4,0,0,15,14,1,12.5,10.8,1.8,22,CL
ad1ffcfd,1,11,0.1,0,0,1,11,0,0,0,0.6,0.9,-0.3,22,CL
ad597bf7,5,88,1.0,0,0,5,1,0,1,-1,0.3,2.4,-2.2,22,CL
ad6df2d5,3,260,2.9,3,2,0,0,3,8,-5,4.0,9.9,-5.8,22,CL
ad9b2747,3,41,0.5,0,0,3,5,0,1,-1,0.3,0.3,0.0,22,CL
adfc9123,5,392,4.4,5,4,0,0,1,7,-6,5.2,6.6,-1.3,22,CL
ae1159bf,8,607,6.7,7,3,1,0,11,13,-2,9.6,9.6,0.0,22,CL
ae44e8e2,2,88,1.0,1,0,1,0,3,4,-1,1.5,1.7,-0.2,22,CL
ae4e2852,4,286,3.2,3,2,1,2,2,4,-2,4.0,4.4,-0.4,22,CL
ae530c73,3,182,2.0,2,0,1,0,2,5,-3,3.6,6.5,-3.0,22,CL
aef6e670,7,630,7.0,7,7,0,1,11,10,1,10.9,12.8,-2.0,22,CL
b056e3da,3,270,3.0,3,3,0,3,2,2,0,2.1,3.8,-1.7,22,CL
b0b4fd3e,7,460,5.1,5,2,2,3,14,11,3,13.8,5.9,8.0,22,CL
b0b902c8,4,297,3.3,4,2,0,0,5,6,-1,5.0,5.5,-0.4,22,CL
b0f7e36c,4,334,3.7,4,2,0,0,6,5,1,5.3,4.4,1.0,22,CL
b19db005,3,123,1.4,1,0,2,0,1,3,-2,0.9,3.3,-2.4,22,CL
b1cbc666,9,539,6.0,7,0,2,1,6,14,-8,5.2,15.0,-9.7,22,CL
b1dae700,1,10,0.1,0,0,1,5,0,0,0,0.5,0.0,0.4,22,CL
b1f4086c,10,860,9.6,10,7,0,0,13,16,-3,10.1,20.5,-10.4,22,CL
b217ef29,7,630,7.0,7,7,0,6,18,9,9,14.3,7.7,6.6,22,CL
b2336681,7,533,5.9,6,5,1,1,5,8,-3,6.8,6.9,-0.1,22,CL
b2bd0f6c,6,469,5.2,5,4,1,0,5,5,0,6.1,4.3,1.9,22,CL
b37c0a9f,2,103,1.1,2,0,0,4,0,2,-2,0.2,1.8,-1.6,22,CL
b400bde0,12,585,6.5,5,3,7,0,14,6,8,14.1,4.6,9.5,22,CL
b492126a,5,163,1.8,2,0,3,0,2,6,-4,1.8,3.6,-1.8,22,CL
b4a014b1,6,539,6.0,6,5,0,0,4,5,-1,6.7,7.8,-1.1,22,CL
b4c816a9,5,79,0.9,0,0,5,0,2,3,-1,2.2,2.6,-0.4,22,CL
b583aef5,1,90,1.0,1,1,0,4,1,2,-1,1.9,2.5,-0.6,22,CL
b5f7d10b,6,540,6.0,6,6,0,0,2,12,-10,6.8,10.1,-3.3,22,CL
b62878a5,2,25,0.3,0,0,2,3,3,0,3,1.5,0.0,1.5,22,CL
b66315ae,8,355,3.9,3,1,5,1,11,3,8,8.5,4.1,4.4,22,CL
b684a484,6,339,3.8,4,1,2,0,6,7,-1,4.3,5.1,-0.8,22,CL
b70bde8f,2,11,0.1,0,0,2,2,0,0,0,0.3,0.0,0.3,22,CL
b74277a0,8,657,7.3,8,3,0,0,22,7,15,18.7,9.7,9.0,22,CL
b797f558,4,219,2.4,2,1,2,2,0,7,-7,1.8,7.5,-5.7,22,CL
b825a650,3,270,3.0,3,3,0,3,8,3,5,6.8,3.5,3.3,22,CL
b853e0ad,6,431,4.8,5,2,1,1,8,5,3,6.1,5.0,1.1,22,CL
b8798a46,4,360,4.0,4,4,0,0,6,6,0,5.3,5.1,0.2,22,CL
b8814868,5,434,4.8,5,3,0,0,1,6,-5,3.5,6.4,-2.9,22,CL
b8a642fc,9,277,3.1,2,0,7,1,7,6,1,5.6,4.9,0.7,22,CL
b8e740fb,8,702,7.8,8,7,0,0,22,8,14,18.9,10.0,8.9,22,CL
b937e490,2,64,0.7,1,0,1,4,1,3,-2,1.1,2.1,-1.1,22,CL
b997c3de,4,286,3.2,4,1,0,0,1,4,-3,3.0,2.8,0.2,22,CL
b9e1436c,1,58,0.6,1,0,0,6,0,0,0,0.7,0.4,0.3,22,CL
b9f92e76,2,18,0.2,0,0,2,2,0,0,0,0.0,0.0,0.0,22,CL
b9fbae28,6,424,4.7,6,2,0,0,13,5,8,7.6,5.3,2.3,22,CL
ba115a40,8,667,7.4,7,6,1,0,22,7,15,18.1,8.1,10.0,22,CL
ba23a904,10,900,10.0,10,10,0,0,14,17,-3,11.8,21.4,-9.7,22,CL
bac46a10,8,720,8.0,8,8,0,0,22,8,14,19.0,10.0,8.9,22,CL
bbd67769,1,1,0.0,0,0,1,0,0,0,0,0.0,0.0,0.0,22,CL
bbf5c11b,6,272,3.0,3,1,3,0,2,3,-1,3.1,3.5,-0.4,22,CL
bc8df459,6,402,4.5,6,0,0,0,4,10,-6,1.6,9.8,-8.2,22,CL
bcb2ccd8,5,450,5.0,5,5,0,0,10,14,-4,9.6,10.1,-0.5,22,CL
bd20f4eb,4,293,3.3,3,2,1,2,5,6,-1,4.2,4.3,-0.1,22,CL
bd6351cd,9,840,9.3,9,9,0,0,24,11,13,21.3,7.4,13.9,22,CL
be305255,2,17,0.2,0,0,2,4,0,0,0,0.1,0.8,-0.7,22,CL
bec8a4ba,5,442,4.9,5,3,0,0,6,7,-1,6.3,5.2,1.1,22,CL
bfae110f,2,28,0.3,0,0,2,3,0,1,-1,0.1,1.3,-1.2,22,CL
bfc5768b,6,324,3.6,3,0,3,0,1,6,-5,3.4,4.6,-1.3,22,CL
bfde3de5,6,498,5.5,6,4,0,0,1,12,-11,1.5,13.2,-11.7,22,CL
c0617e2b,5,41,0.5,0,0,5,2,1,0,1,0.9,1.4,-0.5,22,CL
c14bc029,5,161,1.8,1,0,4,4,4,2,2,4.7,2.8,1.8,22,CL
c1b7847c,6,401,4.5,6,1,0,0,11,11,0,9.4,9.0,0.3,22,CL
c20bdcd7,10,817,9.1,9,9,1,0,8,4,4,10.3,7.1,3.1999999999999997,22,CL
c2111b45,2,9,0.1,0,0,2,8,1,0,1,0.2,0.4,-0.2,22,CL
c24544c7,4,159,1.8,1,1,3,2,2,7,-5,1.6,8.4,-6.7,22,CL
c275947b,5,327,3.6,4,0,1,0,12,6,6,8.5,4.8,3.7,22,CL
c2bd8585,6,272,3.0,3,1,3,0,4,8,-4,3.1,6.7,-3.5,22,CL
c3e4ecbb,3,167,1.9,2,1,1,2,1,4,-3,3.3,3.0,0.3,22,CL
c3ee18ef,8,570,6.3,7,3,1,1,19,2,17,16.5,4.4,12.1,22,CL
c459a650,5,435,4.8,4,2,1,1,9,11,-2,8.8,6.1,2.7,22,CL
c4e87b8b,5,396,4.4,5,2,0,0,4,7,-3,3.3,7.1,-3.7,22,CL
c50e5bba,5,443,4.9,5,4,0,0,7,6,1,7.8,5.2,2.6,22,CL
c56dc39e,4,360,4.0,4,4,0,0,8,8,0,7.0,5.3,1.8,22,CL
c5cbbcff,5,75,0.8,0,0,5,3,1,1,0,0.5,0.6,-0.1,22,CL
c691bfe2,13,818,9.1,11,3,2,0,19,10,9,17.9,9.9,8.0,22,CL
c71e97ba,6,535,5.9,6,5,0,0,1,11,-10,4.3,9.2,-4.9,22,CL
c8112d1e,3,252,2.8,3,2,0,2,1,9,-8,2.7,9.5,-6.8,22,CL
c89e8aae,1,90,1.0,1,1,0,5,0,2,-2,0.3,1.6,-1.3,22,CL
c906ce0f,5,347,3.9,5,3,0,0,3,4,-1,5.9,4.8,1.1,22,CL
c952f633,5,434,4.8,5,4,0,0,6,10,-4,5.9,8.9,-3.0,22,CL
c9817014,4,206,2.3,2,1,2,4,1,6,-5,1.7,4.5,-2.8,22,CL
ca2bc3df,1,9,0.1,0,0,1,3,0,1,-1,0.0,0.7,-0.6,22,CL
ca607d59,6,341,3.8,5,1,1,0,7,3,4,7.2,3.9,3.4,22,CL
ca8033cb,5,355,3.9,5,2,0,0,11,10,1,8.0,6.0,2.0,22,CL
cb641b9d,10,511,5.7,6,0,4,0,9,8,1,6.7,11.9,-5.2,22,CL
cc86b9a3,6,466,5.2,5,4,1,0,15,4,11,13.1,3.8,9.3,22,CL
ccce7025,5,417,4.6,5,4,0,0,5,6,-1,6.7,4.2,2.6,22,CL
cce181df,9,579,6.4,7,5,2,0,6,7,-1,9.2,7.3,1.9,22,CL
cd0fa27b,6,416,4.6,5,1,1,1,3,3,0,6.7,4.8,2.0,22,CL
cd1acf9d,9,791,8.8,9,5,0,3,18,9,9,19.2,8.4,10.8,22,CL
cd59b9df,6,540,6.0,6,6,0,0,10,11,-1,11.5,7.6,3.8,22,CL
cdf65d12,5,450,5.0,5,5,0,0,1,11,-10,4.8,9.1,-4.3,22,CL
ce30bfc8,5,71,0.8,0,0,5,3,0,1,-1,0.5,0.9,-0.4,22,CL
ce50fd99,8,674,7.5,8,2,0,0,8,8,0,10.2,6.9,3.3,22,CL
ce747d2a,2,89,1.0,1,0,1,3,0,1,-1,0.4,2.5,-2.1,22,CL
cf182add,5,354,3.9,4,2,1,0,1,9,-8,4.4,6.9,-2.5,22,CL
d0d8dd44,6,485,5.4,6,3,0,1,6,4,2,8.7,4.5,4.2,22,CL
d2416c2e,4,149,1.7,1,0,3,0,3,4,-1,3.6,3.4,0.2,22,CL
d2424d1b,4,187,2.1,2,0,2,1,7,1,6,5.6,1.4,4.2,22,CL
d248cd8f,8,661,7.3,7,7,1,1,23,5,18,19.4,4.9,14.5,22,CL
d313e8ff,1,90,1.0,1,1,0,4,0,0,0,1.5,0.8,0.7,22,CL
d38fdf53,10,645,7.2,7,4,3,2,11,10,1,9.8,11.0,-1.2,22,CL
d3de9af0,6,464,5.2,5,4,1,0,9,11,-2,8.4,7.2,1.2,22,CL
d436eb94,6,540,6.0,6,6,0,0,6,20,-14,6.1,19.5,-13.4,22,CL
d4c9725f,5,450,5.0,5,5,0,0,6,8,-2,5.6,9.2,-3.5,22,CL
d4e93bab,4,255,2.8,3,0,1,1,4,4,0,5.2,3.9,1.3,22,CL
d4f034db,1,90,1.0,1,1,0,5,0,2,-2,0.6,2.6,-2.0,22,CL
d5d22a58,4,241,2.7,3,0,1,3,3,4,-1,2.8,3.1,-0.3,22,CL
d5f2f82b,8,720,8.0,8,8,0,0,15,11,4,14.5,13.9,0.6,22,CL
d6e53a3a,7,625,6.9,7,6,0,1,10,10,0,10.6,10.3,0.3,22,CL
d70ce98e,7,630,7.0,7,7,0,0,13,9,4,12.4,10.6,1.7,22,CL
d7553721,6,523,5.8,6,5,0,0,5,7,-2,5.1,9.2,-4.2,22,CL
d781d855,7,475,5.3,6,3,1,0,15,4,11,13.7,4.2,9.5,22,CL
d8931174,6,533,5.9,6,5,0,0,9,8,1,7.2,7.0,0.2,22,CL
d8c679be,2,53,0.6,0,0,2,4,0,0,0,0.5,1.2,-0.7,22,CL
d93c2511,5,397,4.4,5,2,0,0,6,6,0,6.1,6.1,0.1,22,CL
d9565625,3,234,2.6,2,2,1,4,2,4,-2,2.0,4.0,-2.0,22,CL
d9d43555,5,346,3.8,5,0,0,0,2,10,-8,3.9,7.6,-3.7,22,CL
da27e268,4,81,0.9,0,0,4,6,3,2,1,1.9,0.9,1.0,22,CL
db092d3b,6,375,4.2,4,2,2,0,5,5,0,4.0,7.9,-3.9,22,CL
db401046,5,450,5.0,5,5,0,0,5,8,-3,4.6,9.5,-5.0,22,CL
db4ed67b,4,212,2.4,3,2,1,0,8,2,6,7.6,2.2,5.4,22,CL
dbf053da,7,392,4.4,5,1,2,0,8,3,5,4.6,4.1,0.5,22,CL
dc3a9a0d,5,343,3.8,4,1,1,0,2,12,-10,4.7,12.3,-7.6,22,CL
dc52c72f,5,363,4.0,4,1,1,0,1,7,-6,2.2,6.4,-4.1,22,CL
dc62b55d,5,146,1.6,0,0,5,3,1,2,-1,3.7,2.4,1.2,22,CL
dc7f8a28,3,42,0.5,0,0,3,4,3,1,2,2.6,0.6,2.0,22,CL
dc90cfbe,3,70,0.8,1,0,2,3,1,6,-5,0.8,4.0,-3.2,22,CL
dd323728,3,180,2.0,2,1,1,2,4,1,3,2.5,2.5,0.1,22,CL
dd669209,5,258,2.9,3,1,2,0,3,4,-1,2.3,4.8,-2.5,22,CL
dd7b6eb8,1,11,0.1,0,0,1,1,1,0,1,0.7,0.0,0.6,22,CL
dd897ee7,1,6,0.1,0,0,1,2,0,0,0,0.1,0.0,0.1,22,CL
de39485a,7,471,5.2,6,3,1,0,3,7,-4,6.7,8.8,-2.1,22,CL
de85e3cc,3,270,3.0,3,3,0,1,2,8,-6,3.0,11.0,-7.9,22,CL
dea698d9,7,610,6.8,7,5,0,0,11,8,3,8.3,8.8,-0.6,22,CL
df3cda47,5,85,0.9,0,0,5,0,1,2,-1,1.2,3.3,-2.0,22,CL
df418fc0,6,540,6.0,6,6,0,0,7,11,-4,4.4,12.2,-7.9,22,CL
df69b544,9,517,5.7,6,1,3,0,8,4,4,8.6,6.2,2.4,22,CL
dfb50e5c,5,152,1.7,1,0,4,1,4,4,0,3.1,3.1,0.0,22,CL
dff153a4,5,315,3.5,4,2,1,1,5,4,1,5.3,4.2,1.1,22,CL
e06683ca,9,810,9.0,9,9,0,3,20,8,12,20.6,7.9,12.7,22,CL
e07398f8,1,2,0.0,0,0,1,0,0,0,0,0.0,0.0,0.0,22,CL
e0921a4f,5,254,2.8,3,0,2,0,8,4,4,6.6,3.2,3.3,22,CL
e150254d,6,272,3.0,4,0,2,0,0,8,-8,0.9,8.3,-7.4,22,CL
e1574c2d,1,4,0.0,0,0,1,4,0,1,-1,0.0,0.8,-0.8,22,CL
e162b013,6,483,5.4,6,4,0,0,7,11,-4,9.2,7.6,1.6,22,CL
e1d4f20d,1,5,0.1,0,0,1,2,0,1,-1,0.6,0.6,0.0,22,CL
e27da244,4,329,3.7,4,2,0,1,3,5,-2,2.9,5.7,-2.7,22,CL
e280527c,5,136,1.5,1,0,4,3,8,1,7,5.6,2.0,3.6,22,CL
e288d4b3,4,92,1.0,0,0,4,0,1,3,-2,1.4,2.7,-1.3,22,CL
e33c06cf,7,512,5.7,6,3,1,0,20,1,19,15.1,3.3,11.8,22,CL
e342ad68,13,1004,11.2,12,6,1,0,25,12,13,23.6,11.7,11.8,22,CL
e34e086c,3,81,0.9,1,0,2,1,1,3,-2,1.1,2.1,-1.0,22,CL
e382905a,1,5,0.1,0,0,1,6,0,0,0,0.1,0.0,0.0,22,CL
e3cceee6,6,370,4.1,5,2,1,0,8,6,2,7.0,4.0,3.0,22,CL
e426b012,6,540,6.0,6,6,0,0,7,11,-4,4.4,12.2,-7.9,22,CL
e42d61c7,8,717,8.0,8,7,0,0,15,11,4,14.4,13.8,0.6,22,CL
e46012d4,10,730,8.1,9,4,1,1,19,9,10,14.5,5.7,8.8,22,CL
e54a9890,1,1,0.0,0,0,1,5,0,0,0,0.0,0.0,0.0,22,CL
e599253a,5,219,2.4,3,0,2,1,6,4,2,3.9,3.9,0.0,22,CL
e5a35ae9,3,120,1.3,1,0,2,1,0,3,-3,0.6,3.3,-2.7,22,CL
e5a76dfe,1,67,0.7,1,0,0,6,1,1,0,1.2,1.1,0.1,22,CL
e5f63987,1,3,0.0,0,0,1,5,0,1,-1,0.0,0.6,-0.6,22,CL
e613313c,3,145,1.6,2,0,1,5,5,2,3,4.2,2.7,1.5,22,CL
e61bdd69,1,1,0.0,0,0,1,3,0,0,0,0.0,0.0,0.0,22,CL
e6af02e0,6,508,5.6,6,4,0,1,12,13,-1,9.2,8.4,0.8,22,CL
e6c43eec,5,427,4.7,5,3,0,0,3,5,-2,3.9,6.3,-2.4,22,CL
e7281ea9,2,21,0.2,0,0,2,0,1,1,0,0.3,0.9,-0.7,22,CL
e73c9bb2,4,292,3.2,3,2,1,2,4,2,2,3.5,3.6,-0.1,22,CL
e75129bd,3,58,0.6,0,0,3,3,1,3,-2,0.8,3.6,-2.7,22,CL
e76cb9cc,5,449,5.0,5,4,0,0,3,6,-3,7.1,5.4,1.8,22,CL
e7af9060,5,350,3.9,5,1,0,0,2,15,-13,3.7,13.0,-9.3,22,CL
e81f0356,5,436,4.8,5,4,0,1,7,5,2,7.3,4.8,2.6,22,CL
e85fb9b8,1,8,0.1,0,0,1,5,0,0,0,0.0,0.4,-0.4,22,CL
e8deefd6,1,7,0.1,0,0,1,4,0,0,0,0.0,0.0,0.0,22,CL
e97fd090,8,363,4.0,2,1,6,2,8,2,6,9.8,2.5,7.3,22,CL
e9c0c1b2,2,180,2.0,2,2,0,2,2,2,0,3.8,2.3,1.5,22,CL
ea3b4578,1,72,0.8,1,0,0,3,1,4,-3,0.9,1.9,-1.0,22,CL
ea6a7ab4,1,12,0.1,0,0,1,3,0,1,-1,0.0,0.5,-0.5,22,CL
eab957a3,5,412,4.6,5,4,0,0,1,8,-7,1.5,11.0,-9.5,22,CL
eaeca114,6,326,3.6,3,2,3,5,10,6,4,7.7,4.1,3.7,22,CL
eb2b33aa,5,450,5.0,5,5,0,1,1,11,-10,3.7,8.2,-4.5,22,CL
eb2fe5b6,5,132,1.5,1,0,4,0,5,2,3,3.8,2.4,1.3,22,CL
eb58eef0,5,262,2.9,3,1,2,3,9,3,6,8.8,4.9,3.9,22,CL
eb7822d7,8,200,2.2,1,1,7,0,4,2,2,2.6,3.2,-0.6,22,CL
ecada4fc,3,270,3.0,3,3,0,5,5,5,0,5.5,5.5,0.0,22,CL
ed1e53f3,11,658,7.3,8,3,3,0,19,10,9,16.3,7.7,8.6,22,CL
ed9f7cfe,10,482,5.4,4,2,6,0,6,3,3,6.2,5.5,0.8,22,CL
eda40760,1,6,0.1,0,0,1,5,0,0,0,0.1,0.0,0.1,22,CL
eda8506a,5,280,3.1,3,0,2,0,1,7,-6,0.8,8.0,-7.2,22,CL
ee251371,6,443,4.9,5,3,1,0,5,4,1,4.8,8.0,-3.2,22,CL
ee3519f5,4,225,2.5,3,1,1,1,1,3,-2,3.2,4.8,-1.7,22,CL
ee8508c0,10,900,10.0,10,10,0,0,9,10,-1,12.2,13.2,-1.1,22,CL
ee93c1a9,5,289,3.2,4,0,1,0,5,3,2,5.3,2.5,2.7,22,CL
ef619b0b,2,16,0.2,0,0,2,0,1,0,1,0.9,0.2,0.7,22,CL
ef9c1c95,7,630,7.0,7,7,0,0,7,8,-1,9.7,7.1,2.7,22,CL
f0021247,8,489,5.4,6,1,2,2,9,7,2,6.9,10.2,-3.3,22,CL
f0661424,3,139,1.5,1,0,2,5,4,2,2,3.1,2.3,0.8,22,CL
f08490a6,11,903,10.0,10,4,1,0,15,12,3,15.2,15.1,0.1,22,CL
f090a37a,1,18,0.2,0,0,1,5,0,0,0,0.1,0.4,-0.4,22,CL
f0da930c,7,585,6.5,6,6,1,0,4,6,-2,6.2,9.3,-3.1,22,CL
f1b55719,4,156,1.7,2,0,2,0,0,6,-6,1.3,5.2,-3.9,22,CL
f20e4cc9,8,580,6.4,7,5,1,0,13,8,5,12.2,11.6,0.6,22,CL
f25c8e3a,10,489,5.4,5,1,5,1,16,10,6,12.5,7.5,5.0,22,CL
f315ca93,5,344,3.8,4,3,1,7,8,4,4,7.8,3.9,3.8,22,CL
f3600c02,7,435,4.8,5,3,2,0,2,6,-4,4.9,5.0,-0.1,22,CL
f38cc3b3,2,83,0.9,1,0,1,4,1,1,0,1.8,0.5,1.3,22,CL
f3945e07,6,146,1.6,2,0,4,0,1,4,-3,1.8,3.3,-1.5,22,CL
f4290206,8,548,6.1,6,3,2,2,10,4,6,8.5,5.1,3.4,22,CL
f449640d,2,91,1.0,1,0,1,3,0,2,-2,0.2,2.4,-2.2,22,CL
f4797849,2,81,0.9,1,0,1,0,1,1,0,1.6,1.2,0.4,22,CL
f49c4ae9,2,116,1.3,1,1,1,0,2,2,0,2.0,2.5,-0.5,22,CL
f4b52308,5,134,1.5,1,0,4,3,2,6,-4,1.1,3.2,-2.0,22,CL
f4c69aa6,3,63,0.7,0,0,3,3,1,2,-1,1.9,3.1,-1.2,22,CL
f512a009,5,437,4.9,5,3,0,0,0,13,-13,1.4,13.1,-11.7,22,CL
f5c8b425,4,51,0.6,0,0,4,2,0,1,-1,1.0,0.3,0.8,22,CL
f5deef4c,5,425,4.7,5,4,0,1,8,6,2,5.8,7.0,-1.3,22,CL
f5dfc256,2,180,2.0,2,2,0,1,1,4,-3,2.5,2.1,0.3,22,CL
f620b04f,2,100,1.1,2,1,0,0,0,2,-2,0.9,1.0,-0.2,22,CL
f63cda26,7,371,4.1,4,1,3,3,6,10,-4,4.6,10.4,-5.9,22,CL
f6798fc3,6,540,6.0,6,6,0,0,5,5,0,7.2,7.8,-0.6,22,CL
f6ac68c1,5,450,5.0,5,5,0,0,2,3,-1,3.6,5.0,-1.5,22,CL
f7036e1c,8,580,6.4,8,1,0,0,8,2,6,11.7,5.6,6.0,22,CL
f7b10c66,3,270,3.0,3,3,0,0,3,6,-3,4.3,5.7,-1.5,22,CL
f7e87032,6,486,5.4,6,2,0,0,1,9,-8,3.8,8.6,-4.8,22,CL
f833a830,4,217,2.4,2,1,2,8,6,2,4,3.2,2.9,0.3,22,CL
f8342731,6,385,4.3,4,1,2,0,5,8,-3,4.3,6.8,-2.5,22,CL
f86cd5df,4,335,3.7,4,2,0,2,4,8,-4,3.5,7.5,-4.0,22,CL
f93c876b,3,260,2.9,3,2,0,1,1,11,-10,3.1,8.6,-5.5,22,CL
f9acca3a,4,132,1.5,1,0,3,1,1,3,-2,2.8,1.8,1.1,22,CL
f9b1b7bf,4,56,0.6,0,0,4,6,1,1,0,1.5,0.8,0.7,22,CL
f9c927de,6,502,5.6,6,4,0,0,7,12,-5,6.6,9.7,-3.1,22,CL
f9edc384,6,529,5.9,6,4,0,0,7,11,-4,4.2,11.5,-7.2,22,CL
fa265f6d,3,102,1.1,1,0,2,3,0,1,-1,1.2,2.2,-1.1,22,CL
fa274d97,4,196,2.2,3,1,1,0,5,4,1,4.2,1.6,2.6,22,CL
fa661778,5,172,1.9,2,0,3,0,4,1,3,5.1,0.9,4.1,22,CL
fb46125f,6,540,6.0,6,6,0,0,7,11,-4,4.4,12.2,-7.9,22,CL
fb5d47b3,2,93,1.0,1,1,1,10,2,0,2,2.3,1.1,1.2,22,CL
fb6530de,5,440,4.9,5,3,0,0,2,17,-15,4.2,16.8,-12.6,22,CL
fb938d24,4,214,2.4,2,2,2,2,2,7,-5,3.5,5.1,-1.5,22,CL
fbd6378b,2,26,0.3,0,0,2,10,2,1,1,1.9,0.7,1.3,22,CL
fc4e7637,3,37,0.4,0,0,3,2,1,2,-1,0.8,0.7,0.1,22,CL
fc62f087,2,164,1.8,2,1,0,6,5,2,3,4.2,2.3,1.9,22,CL
fcb27134,4,295,3.3,3,1,1,1,6,8,-2,6.6,6.4,0.2,22,CL
fcb38f57,3,270,3.0,3,3,0,0,4,7,-3,3.7,6.5,-2.7,22,CL
fd51b456,8,353,3.9,3,2,5,5,10,2,8,7.5,6.6,0.9,22,CL
fe154b26,5,113,1.3,1,0,4,1,1,3,-2,1.6,4.3,-2.8,22,CL
fe29c96e,6,540,6.0,6,6,0,0,7,11,-4,4.4,12.2,-7.9,22,CL
fe641c1a,4,200,2.2,2,1,2,2,2,2,0,2.8,3.0,-0.2,22,CL
fed7cb61,9,674,7.5,6,5,3,0,13,8,5,11.6,7.6,4.0,22,CL
ff74841d,8,720,8.0,8,8,0,0,10,14,-4,12.3,12.7,-0.5,22,CL
ffec9769,2,104,1.2,1,0,1,0,0,0,0,0.7,1.2,-0.5,22,CL
ffed43e3,6,540,6.0,6,6,0,0,6,20,-14,6.1,19.5,-13.4,22,CL
0000acda,18,540,6.0,4,0,14,15,4,14,-10,7.1000000000000005,11.9,-4.9,22,ITA
00459419,33,2694,29.9,32,20,1,1,35,43,-8,38.0,40.1,-2.1,22,ITA
0154d290,17,668,7.4,6,0,11,8,13,9,4,11.2,7.0,4.2,22,ITA
01b8a2b2,33,2970,33.0,33,33,0,4,50,29,21,46.2,33.3,12.9,22,ITA
01c3aff5,21,1369,15.2,15,9,6,2,20,16,4,17.4,16.2,1.3,22,ITA
01efac19,29,2340,26.0,27,20,2,1,48,42,6,35.5,34.0,1.5,22,ITA
023937a9,14,1053,11.7,12,9,2,0,12,17,-5,14.0,17.5,-3.5,22,ITA
02caf6e0,31,1665,18.5,16,9,15,3,39,30,9,26.6,23.1,3.5,22,ITA
0375723e,18,875,9.7,11,0,7,7,13,19,-6,11.600000000000001,17.3,-5.6000000000000005,22,ITA
03f946ed,24,586,6.5,4,1,20,11,11,6,5,10.4,5.4,5.0,22,ITA
0489bb30,12,429,4.8,5,0,7,7,2,10,-8,5.2,9.4,-4.2,22,ITA
04b40c58,2,35,0.4,0,0,2,28,0,1,-1,1.3,0.6,0.8,22,ITA
05e19d6a,31,2308,25.6,25,18,6,0,43,21,22,38.5,25.3,13.2,22,ITA
0728bebe,23,1391,15.5,16,5,7,2,18,19,-1,25.0,15.6,9.4,22,ITA
07767f42,12,271,3.0,2,0,10,22,5,10,-5,3.6,7.5,-3.9,22,ITA
07ea0ef2,5,175,1.9,2,0,3,8,3,6,-3,1.8,3.0,-1.2,22,ITA
0821331c,17,1211,13.5,13,8,4,7,8,16,-8,12.7,18.7,-5.9,22,ITA
0847b5a5,32,2100,23.3,25,7,7,0,24,39,-15,24.8,39.9,-15.1,22,ITA
085e71a7,7,556,6.2,7,6,0,18,7,8,-1,7.2,7.5,-0.3,22,ITA
08990838,1,8,0.1,0,0,1,12,0,0,0,0.1,0.0,0.1,22,ITA
08aa9cd1,36,2869,31.9,32,25,4,0,44,59,-15,39.3,54.4,-15.1,22,ITA
08eb3b58,26,1565,17.4,18,9,8,8,26,24,2,27.4,19.2,8.3,22,ITA
09538fdb,28,1184,13.2,11,4,17,6,20,25,-5,17.6,17.3,0.3,22,ITA
0967845b,25,1477,16.4,16,9,9,7,22,27,-5,19.1,27.3,-8.2,22,ITA
09899de8,19,1497,16.6,17,15,2,14,20,27,-7,17.5,24.5,-6.9,22,ITA
0a3065c8,16,694,7.7,7,4,9,14,9,12,-3,9.9,11.4,-1.5,22,ITA
0a447501,29,1803,20.0,22,6,7,3,29,20,9,25.7,19.4,6.3,22,ITA
0a483542,29,1975,21.9,22,17,7,5,40,39,1,33.1,43.7,-10.6,22,ITA
0ab1f153,33,2487,27.6,28,18,5,2,45,23,22,39.3,23.7,15.7,22,ITA
0acda699,2,177,2.0,2,1,0,36,3,2,1,1.8,2.7,-0.8,22,ITA
0b5a292a,34,2992,33.2,34,24,0,1,67,29,38,51.9,27.2,24.7,22,ITA
0be276c6,31,2563,28.5,30,24,1,3,22,51,-29,27.3,43.6,-16.3,22,ITA
0cadc46d,11,215,2.4,1,0,10,12,2,7,-5,1.9,3.8,-1.9,22,ITA
0ccac09c,7,348,3.9,5,0,2,10,2,8,-6,1.6,6.6,-5.1,22,ITA
0cf465f2,9,121,1.3,0,0,9,11,4,2,2,3.2,1.2,2.0,22,ITA
0d077b88,8,282,3.1,2,1,6,11,4,8,-4,2.9,6.0,-3.0,22,ITA
0d422df7,35,3150,35.0,35,35,0,0,55,50,5,47.3,46.4,0.8,22,ITA
0d82903c,28,1780,19.8,17,13,11,4,26,25,1,25.7,21.0,4.7,22,ITA
0db169ae,36,2600,28.9,31,18,5,1,54,18,36,46.1,23.6,22.5,22,ITA
0dfce079,3,270,3.0,3,3,0,33,2,6,-4,2.6,6.3,-3.7,22,ITA
0fdcef0e,23,1353,15.0,14,12,9,10,13,24,-11,14.9,25.0,-10.1,22,ITA
0fee6bda,30,2576,28.6,30,27,0,0,29,51,-22,27.1,52.0,-24.9,22,ITA
102e2599,1,18,0.2,0,0,1,5,1,0,1,0.0,1.3,-1.2,22,ITA
10b9fa99,29,2282,25.4,26,18,3,0,20,44,-24,22.2,47.5,-25.3,22,ITA
10dc46f0,37,3330,37.0,37,37,0,1,27,59,-32,36.2,53.3,-17.1,22,ITA
10e7f486,23,1729,19.2,19,14,4,11,31,35,-4,29.2,27.6,1.6,22,ITA
11962fe7,17,952,10.6,10,6,7,7,8,29,-21,9.8,22.0,-12.1,22,ITA
1295552e,31,2046,22.7,24,16,7,6,35,43,-8,30.3,41.1,-10.8,22,ITA
129af0db,35,2302,25.6,26,7,9,1,37,20,17,36.5,25.6,10.9,22,ITA
12e6d21a,11,245,2.7,1,0,10,4,2,4,-2,3.4,5.4,-1.9,22,ITA
130a7a3f,5,125,1.4,1,0,4,17,6,0,6,2.4,1.3,1.1,22,ITA
13b44b02,33,2735,30.4,32,23,1,1,39,48,-9,36.6,50.8,-14.2,22,ITA
149c5f5d,21,1072,11.9,10,5,11,11,18,12,6,15.0,13.5,1.5,22,ITA
14a96e1c,17,1485,16.5,16,16,1,13,13,27,-14,15.4,30.9,-15.5,22,ITA
14b8fcdf,12,879,9.8,9,8,3,23,14,9,5,10.0,12.9,-2.9,22,ITA
157d29b6,4,66,0.7,0,0,4,5,0,3,-3,1.0,1.7,-0.7,22,ITA
15d0c248,31,2491,27.7,28,22,3,3,51,39,12,38.2,33.2,5.0,22,ITA
15e9c7e6,10,287,3.2,3,0,7,7,4,8,-4,3.4,5.8,-2.4,22,ITA
16463a79,6,146,1.6,1,0,5,9,4,1,3,4.8,1.7,3.1,22,ITA
16657b95,34,2678,29.8,29,27,5,0,45,36,9,52.0,31.8,20.2,22,ITA
16b9d5cf,14,1115,12.4,13,11,1,2,10,16,-6,13.3,13.7,-0.5,22,ITA
16bb656a,17,1198,13.3,13,12,4,0,29,22,7,19.3,17.2,2.2,22,ITA
16ceb862,29,1892,21.0,22,6,7,1,36,15,21,30.8,16.6,14.2,22,ITA
173061c0,17,1138,12.6,12,11,5,15,10,25,-15,11.5,22.5,-11.0,22,ITA
1780bb4a,36,2820,31.3,34,17,2,0,34,42,-8,34.8,42.7,-7.9,22,ITA
17f3620a,14,733,8.1,9,1,5,4,7,11,-4,13.2,8.4,4.8,22,ITA
19e4eab9,35,3130,34.8,35,33,0,0,57,49,8,47.5,46.1,1.4,22,ITA
1ac232b8,31,2288,25.4,26,17,5,1,23,43,-20,24.5,40.9,-16.4,22,ITA
1c341b14,4,142,1.6,2,0,2,10,1,2,-1,2.0,1.7,0.2,22,ITA
1c8c5aed,8,548,6.1,6,4,2,16,6,13,-7,5.5,10.0,-4.6,22,ITA
1cadaf34,17,414,4.6,3,1,14,10,5,7,-2,3.7,6.2,-2.5,22,ITA
1d00a56c,2,13,0.1,0,0,2,6,0,0,0,0.0,0.0,0.0,22,ITA
1d0bb7e4,24,920,10.2,6,4,18,9,14,20,-6,13.1,12.5,0.6,22,ITA
1d1691ad,25,1733,19.3,18,12,7,5,34,28,6,33.0,24.1,8.9,22,ITA
1e26e376,16,1440,16.0,16,16,0,1,16,33,-17,16.4,31.4,-15.0,22,ITA
1e9aa637,18,763,8.5,9,2,9,14,12,16,-4,15.1,12.9,2.2,22,ITA
1fca9171,26,1367,15.2,17,2,9,4,24,26,-2,16.7,25.8,-9.0,22,ITA
20094685,35,2938,32.6,33,29,2,0,55,56,-1,46.8,55.8,-9.0,22,ITA
20730eae,34,2605,28.9,31,13,3,1,54,20,34,46.3,24.1,22.3,22,ITA
20b3a502,28,2015,22.4,23,9,5,1,33,33,0,29.1,28.6,0.5,22,ITA
2110f96c,1,2,0.0,0,0,1,1,0,0,0,0.0,0.1,-0.1,22,ITA
2146785a,26,2119,23.5,24,17,2,1,40,17,23,37.1,22.0,15.0,22,ITA
215f3907,11,578,6.4,6,2,5,2,9,10,-1,7.4,9.5,-2.1,22,ITA
217875a4,7,302,3.4,4,0,3,7,3,8,-5,3.4,4.3,-0.9,22,ITA
217c93a1,22,490,5.4,1,1,21,15,10,5,5,9.1,7.9,1.3,22,ITA
2200181e,23,1354,15.0,14,13,9,11,27,28,-1,24.3,25.7,-1.4,22,ITA
22ae86f9,4,249,2.8,3,2,1,10,7,5,2,5.4,4.7,0.7,22,ITA
22bfb57e,33,2351,26.1,26,13,7,2,40,36,4,35.9,34.2,1.7,22,ITA
22cd43d2,34,1881,20.9,22,4,12,1,20,40,-20,19.6,36.6,-17.0,22,ITA
2306bf5c,1,2,0.0,0,0,1,10,1,0,1,0.0,0.0,0.0,22,ITA
230a2fac,33,2869,31.9,33,29,0,1,62,21,41,50.1,23.4,26.7,22,ITA
2334478a,25,1766,19.6,24,8,1,0,8,25,-17,15.7,26.8,-11.1,22,ITA
23610943,35,2638,29.3,31,16,4,0,50,46,4,41.6,41.8,-0.2,22,ITA
2374aaca,33,2357,26.2,26,14,7,1,42,36,6,42.6,26.3,16.3,22,ITA
246d153b,21,1437,16.0,17,7,4,12,17,19,-2,19.9,16.5,3.5,22,ITA
247ed022,26,1790,19.9,21,13,5,3,13,31,-18,16.2,25.5,-9.3,22,ITA
26db8853,36,2970,33.0,33,27,3,0,56,54,2,44.9,46.8,-1.8,22,ITA
277da414,31,2761,30.7,31,30,0,7,33,52,-19,31.7,52.4,-20.6,22,ITA
2873973b,6,102,1.1,1,0,5,13,2,4,-2,0.5,5.2,-4.6,22,ITA
28f66c2e,28,777,8.6,7,0,21,8,13,12,1,11.3,11.0,0.3,22,ITA
2967bcd0,1,3,0.0,0,0,1,3,0,0,0,0.0,0.0,0.0,22,ITA
2a1beb34,30,2548,28.3,28,26,2,1,53,39,14,49.1,36.5,12.6,22,ITA
2a7d27c1,36,2854,31.7,35,6,1,0,55,51,4,45.0,55.5,-10.5,22,ITA
2a82aa85,27,1348,15.0,16,4,11,6,15,32,-17,16.3,26.1,-9.8,22,ITA
2b7c18ae,2,39,0.4,0,0,2,3,1,1,0,1.2,0.7,0.5,22,ITA
2baec6ce,1,11,0.1,0,0,1,9,0,0,0,0.2,0.1,0.1,22,ITA
2c0f8e9e,27,881,9.8,7,2,20,6,18,10,8,23.0,10.5,12.5,22,ITA
2c38b327,24,1149,12.8,13,4,11,7,16,17,-1,16.5,12.2,4.4,22,ITA
2cb9486d,10,502,5.6,7,1,3,15,4,8,-4,4.7,8.7,-3.9,22,ITA
2cfae697,17,1392,15.5,16,12,1,1,15,20,-5,19.9,24.0,-4.1,22,ITA
2d970560,13,629,7.0,5,2,8,4,10,5,5,15.3,9.9,5.300000000000001,22,ITA
2d9d9e42,1,45,0.5,0,0,1,0,1,0,1,0.5,0.5,0.0,22,ITA
2f3452eb,29,2027,22.5,24,15,5,7,42,40,2,29.8,32.9,-3.0,22,ITA
2f557579,32,2290,25.4,28,4,4,1,51,21,30,39.4,22.0,17.4,22,ITA
305a3820,2,8,0.1,0,0,2,15,1,0,1,0.4,1.0,-0.6,22,ITA
30f5ffa9,35,3150,35.0,35,35,0,3,77,32,45,75.1,37.2,37.9,22,ITA
311027cb,8,425,4.7,5,0,3,14,2,9,-7,3.9,6.8,-2.9,22,ITA
33502726,7,87,1.0,0,0,7,9,1,0,1,1.7,0.4,1.3,22,ITA
339fe0e8,23,2070,23.0,23,23,0,15,48,29,19,36.0,26.7,9.3,22,ITA
33b8d077,35,2937,32.6,35,23,0,0,77,26,51,70.4,32.8,37.5,22,ITA
33ecf462,19,730,8.1,10,0,9,4,8,16,-8,8.4,12.4,-4.0,22,ITA
343c0d52,36,2660,29.6,32,16,4,1,52,37,15,37.6,36.0,1.5999999999999999,22,ITA
343f753a,16,1392,15.5,16,14,0,0,18,24,-6,17.6,22.9,-5.3,22,ITA
34693494,6,321,3.6,4,1,2,7,6,4,2,3.5,3.3,0.2,22,ITA
356c9002,36,3119,34.7,36,24,0,0,44,56,-12,34.2,48.2,-14.0,22,ITA
35a2557c,1,62,0.7,1,0,0,0,0,1,-1,0.4,2.1,-1.7,22,ITA
35b4bc62,1,71,0.8,1,0,0,4,1,0,1,0.7,0.6,0.1,22,ITA
35dd6d80,20,1618,18.0,18,15,2,3,22,35,-13,22.2,26.7,-4.5,22,ITA
3626daea,3,127,1.4,2,0,1,4,3,1,2,2.9,0.9,2.0,22,ITA
36e88fbc,15,646,7.2,7,3,8,22,7,13,-6,8.3,10.3,-2.0,22,ITA
384d58d9,9,597,6.6,6,4,3,1,11,7,4,9.3,7.0,2.3,22,ITA
38d9ce53,18,796,8.8,9,2,9,17,8,23,-15,13.1,14.3,-1.3,22,ITA
39583cfd,34,2616,29.1,31,14,3,0,43,46,-3,35.5,43.7,-8.1,22,ITA
39aa05a7,1,25,0.3,0,0,1,2,0,1,-1,0.4,0.7,-0.3,22,ITA
3b12b11f,12,457,5.1,5,4,7,21,11,6,5,7.1,7.2,-0.1,22,ITA
3b333ac3,21,1386,15.4,16,8,5,2,25,21,4,27.4,19.0,8.5,22,ITA
3b387cc7,2,20,0.2,0,0,2,0,1,0,1,0.1,0.0,0.1,22,ITA
3b61c9ec,18,1107,12.3,15,4,3,17,21,8,13,18.6,8.0,10.6,22,ITA
3b8674e6,19,1155,12.8,13,5,6,3,18,11,7,17.8,9.6,8.1,22,ITA
3bb7af3b,29,1284,14.3,13,3,16,7,30,13,17,23.3,13.3,10.0,22,ITA
3bb7f478,36,2469,27.4,27,13,9,2,58,20,38,54.6,28.3,26.2,22,ITA
3ca7254a,32,2033,22.6,25,10,7,0,47,39,8,31.2,33.2,-1.9,22,ITA
3cd3b384,36,2395,26.6,25,15,11,0,30,37,-7,25.7,36.1,-10.5,22,ITA
3d50bcdb,32,1098,12.2,12,1,20,0,19,14,5,16.2,14.1,2.1,22,ITA
3ead85f9,19,1409,15.7,16,14,3,10,25,16,9,20.2,15.9,4.3,22,ITA
3ec3c1c9,20,1431,15.9,16,13,4,15,26,23,3,27.0,16.2,10.8,22,ITA
3ef0a2d7,14,274,3.0,1,1,13,24,4,3,1,3.7,1.9,1.9,22,ITA
3ef965c1,7,314,3.5,4,0,3,5,1,7,-6,2.2,5.2,-3.0,22,ITA
3f5f38fb,36,2586,28.7,30,18,6,0,42,40,2,37.8,36.9,0.9,22,ITA
3f79a1c8,1,9,0.1,0,0,1,15,0,0,0,0.0,0.3,-0.3,22,ITA
405f6586,33,2165,24.1,23,9,10,0,22,39,-17,26.8,37.4,-10.7,22,ITA
407feb71,31,1855,20.6,25,2,6,4,34,15,19,33.9,18.6,15.3,22,ITA
414e1f69,4,77,0.9,0,0,4,8,1,4,-3,0.7,3.4,-2.7,22,ITA
42eaa028,17,649,7.2,7,0,10,2,10,11,-1,13.7,8.1,5.5,22,ITA
4431aed2,31,2711,30.1,31,25,0,0,64,43,21,45.8,37.2,8.5,22,ITA
444c89d9,21,1064,11.8,15,0,6,2,17,18,-1,14.1,18.7,-4.6,22,ITA
44510fde,1,36,0.4,0,0,1,1,0,2,-2,0.3,1.0,-0.7,22,ITA
44ac04e9,17,377,4.2,2,1,15,18,12,4,8,12.5,3.9,8.6,22,ITA
44eb9093,20,1000,11.1,9,8,11,18,20,3,17,23.1,11.2,11.9,22,ITA
45191c29,16,793,8.8,9,0,7,18,12,7,5,15.2,8.5,6.7,22,ITA
45392b06,6,102,1.1,1,0,5,18,1,4,-3,1.3,3.2,-2.0,22,ITA
457cb02f,3,270,3.0,3,3,0,20,5,6,-1,5.0,4.1,0.9,22,ITA
45b9b619,26,1025,11.4,12,0,14,0,26,8,18,25.1,10.8,14.3,22,ITA
4611e028,6,341,3.8,4,2,2,6,5,6,-1,3.6,5.0,-1.4,22,ITA
46fa7204,23,1237,13.7,12,3,11,0,16,23,-7,15.2,23.7,-8.4,22,ITA
481c9ece,33,2028,22.5,21,13,12,5,54,14,40,51.3,22.8,28.5,22,ITA
4830e0af,14,893,9.9,9,6,5,1,11,13,-2,10.3,15.8,-5.5,22,ITA
48b3dd60,20,962,10.7,11,5,9,7,22,7,15,14.6,9.9,4.7,22,ITA
48d5bd33,30,1592,17.7,19,3,11,1,31,23,8,25.3,19.5,5.9,22,ITA
4a0b7f07,29,1950,21.7,23,10,6,5,15,37,-22,18.0,38.0,-20.0,22,ITA
4a56052c,36,2319,25.8,26,9,10,0,44,29,15,44.6,26.6,18.0,22,ITA
4a5a45c7,28,2289,25.4,27,15,1,0,40,30,10,45.8,25.5,20.4,22,ITA
4ae67f27,23,1181,13.1,12,5,11,13,22,16,6,18.3,17.3,1.1,22,ITA
4b029b31,12,935,10.4,11,8,1,16,8,19,-11,9.7,20.3,-10.6,22,ITA
4b3e1a38,33,2927,32.5,33,32,0,4,60,28,32,48.4,26.8,21.6,22,ITA
4b55eb4d,14,571,6.3,5,2,9,7,2,18,-16,3.4,13.6,-10.2,22,ITA
4bd00a50,5,55,0.6,1,0,4,7,1,1,0,0.7,0.7,0.0,22,ITA
4c62d0c8,5,405,4.5,5,4,0,32,7,7,0,5.2,3.5,1.7,22,ITA
4c78b5ed,35,1697,18.9,19,5,16,2,36,27,9,28.6,25.6,3.1,22,ITA
4c8845f7,28,1019,11.3,11,1,17,9,23,17,6,23.3,12.8,10.4,22,ITA
4cde5509,23,1016,11.3,11,7,12,2,24,14,10,18.6,13.3,5.3,22,ITA
4d1efb48,35,3122,34.7,35,34,0,1,31,63,-32,35.3,66.3,-30.9,22,ITA
4e1d5e59,35,2307,25.6,29,11,6,2,36,43,-7,27.2,42.2,-15.1,22,ITA
4e358a2d,16,1434,15.9,16,15,0,0,18,26,-8,18.9,23.7,-4.8,22,ITA
4e6dbac4,37,3100,34.4,36,26,1,0,75,52,23,54.0,44.2,9.8,22,ITA
4f2908e5,2,11,0.1,0,0,2,33,0,0,0,0.1,0.3,-0.1,22,ITA
4f8ce0e1,23,1938,21.5,21,21,2,15,15,49,-34,18.2,39.4,-21.2,22,ITA
509a4ccb,26,1229,13.7,14,1,12,3,14,23,-9,15.4,20.7,-5.3,22,ITA
5128bde4,34,2766,30.7,32,19,2,1,56,48,8,42.4,40.4,2.0,22,ITA
52611641,31,2195,24.4,26,12,5,3,42,32,10,45.3,23.9,21.4,22,ITA
528492ea,33,1931,21.5,21,5,12,5,30,25,5,28.9,20.1,8.8,22,ITA
5294a83f,34,2353,26.1,27,11,7,1,51,35,16,37.3,29.0,8.2,22,ITA
52ec54d0,24,2005,22.3,22,21,2,6,32,28,4,30.5,25.4,5.1,22,ITA
536cebe5,24,891,9.9,6,3,18,2,14,8,6,16.2,11.5,4.8,22,ITA
539230cf,6,341,3.8,3,3,3,30,9,4,5,8.9,3.8,5.1,22,ITA
53a0e358,33,2819,31.3,33,16,0,0,57,50,7,45.5,51.3,-5.8,22,ITA
53de807a,10,556,6.2,6,3,4,23,12,11,1,8.7,8.6,0.1,22,ITA
53e494ec,1,90,1.0,1,1,0,27,4,0,4,1.9,0.5,1.4,22,ITA
548fea2f,2,5,0.1,0,0,2,3,1,0,1,0.6,0.0,0.6,22,ITA
54e53b7e,35,2739,30.4,33,15,2,0,56,40,16,41.9,36.9,5.0,22,ITA
54f6afe3,1,29,0.3,0,0,1,36,1,2,-1,0.9,0.2,0.7,22,ITA
555d5edd,13,683,7.6,9,2,4,0,4,10,-6,7.6,10.3,-2.7,22,ITA
55a1cac2,33,2240,24.9,24,17,9,1,28,29,-1,31.3,25.0,6.3,22,ITA
55e098cd,4,58,0.6,0,0,4,23,0,0,0,0.7,0.2,0.5,22,ITA
563a68ad,33,2823,31.4,32,24,1,1,35,46,-11,37.4,43.0,-5.6,22,ITA
570bb4b9,31,1775,19.7,21,3,10,1,35,31,4,28.0,31.2,-3.2,22,ITA
5722eced,13,918,10.2,13,2,0,2,9,19,-10,9.3,21.2,-12.0,22,ITA
57469b2d,28,784,8.7,5,1,23,9,21,14,7,22.2,11.5,10.7,22,ITA
59be3a74,4,65,0.7,0,0,4,12,1,0,1,0.7,0.6,0.2,22,ITA
59bf127b,14,501,5.6,5,2,9,15,12,9,3,10.8,7.4,3.4,22,ITA
59f2d958,4,63,0.7,0,0,4,6,1,2,-1,0.5,0.5,0.0,22,ITA
5a2cb25d,23,944,10.5,8,6,15,8,12,13,-1,11.5,11.0,0.5,22,ITA
5aa53281,33,2878,32.0,33,27,0,1,45,35,10,51.2,34.3,16.8,22,ITA
5add9b29,1,18,0.2,0,0,1,0,0,0,0,0.2,0.6,-0.5,22,ITA
5b418e15,4,38,0.4,0,0,4,18,1,0,1,0.2,0.7,-0.5,22,ITA
5bd72174,38,2946,32.7,33,19,5,0,44,55,-11,33.7,49.4,-15.700000000000001,22,ITA
5c522c88,2,18,0.2,0,0,2,4,0,1,-1,0.2,0.1,0.1,22,ITA
5cbb5ad6,1,7,0.1,0,0,1,2,0,0,0,0.1,0.0,0.1,22,ITA
5dafcdce,1,1,0.0,0,0,1,3,0,0,0,0.0,0.1,-0.1,22,ITA
5e861944,33,1650,18.3,20,0,13,2,25,16,9,26.3,15.0,11.3,22,ITA
5eaed77a,28,2279,25.3,27,22,1,7,14,31,-17,21.3,34.3,-13.0,22,ITA
5efc5389,28,1817,20.2,21,12,7,9,17,36,-19,15.7,32.0,-16.3,22,ITA
5fa57166,22,1543,17.2,17,12,5,10,22,24,-2,20.900000000000002,22.6,-1.8000000000000003,22,ITA
5fd5ed86,33,2890,32.1,33,29,0,1,39,30,9,42.8,30.4,12.4,22,ITA
601ef102,2,22,0.2,0,0,2,0,2,0,2,0.9,0.2,0.7,22,ITA
614c38fb,21,1143,12.7,12,3,9,11,8,26,-18,10.2,23.6,-13.3,22,ITA
61b3978f,35,2946,32.7,35,25,0,0,43,51,-8,31.2,48.1,-16.9,22,ITA
620922ed,20,1108,12.3,9,8,11,18,11,27,-16,10.8,22.5,-11.7,22,ITA
6213fd82,25,1772,19.7,22,13,3,1,18,31,-13,19.2,31.7,-12.5,22,ITA
62437b4f,28,1204,13.4,11,1,17,7,15,23,-8,16.7,19.7,-3.0,22,ITA
649b01d8,29,2560,28.4,29,27,0,7,36,48,-12,27.3,43.1,-15.9,22,ITA
64cd167d,14,930,10.3,11,5,3,4,6,19,-13,6.4,17.1,-10.7,22,ITA
64e8ed6d,5,96,1.1,1,0,4,11,2,0,2,2.7,1.1,1.6,22,ITA
65fd099c,22,452,5.0,3,1,19,6,7,10,-3,8.3,8.1,0.2,22,ITA
6604165d,25,980,10.9,10,2,15,9,4,15,-11,7.9,12.6,-4.7,22,ITA
66784dee,26,1445,16.1,17,3,9,3,13,27,-14,15.6,28.8,-13.3,22,ITA
67cdbc0e,28,741,8.2,2,0,26,2,16,5,11,17.7,7.9,9.8,22,ITA
67f649be,1,90,1.0,1,1,0,37,1,2,-1,2.1,1.2,0.9,22,ITA
68252d6d,20,841,9.3,8,0,12,1,23,8,15,18.2,10.3,7.9,22,ITA
6928979a,36,2913,32.4,36,17,0,1,74,29,45,68.4,33.6,34.9,22,ITA
69e11a01,12,422,4.7,4,2,8,8,4,9,-5,3.5,7.4,-3.9,22,ITA
6a1f66a7,2,135,1.5,2,1,0,4,0,8,-8,0.6,4.4,-3.8,22,ITA
6af30900,19,1138,12.6,12,5,7,4,7,18,-11,10.6,17.7,-7.1,22,ITA
6b635f5c,20,1272,14.1,13,12,7,13,18,35,-17,17.0,28.7,-11.7,22,ITA
6bb2c084,25,1926,21.4,21,18,4,0,43,16,27,34.1,18.7,15.4,22,ITA
6cc97b6a,30,2174,24.2,26,12,4,6,21,36,-15,25.7,36.5,-10.8,22,ITA
6cd33e2a,1,15,0.2,0,0,1,2,0,0,0,0.1,0.2,-0.1,22,ITA
6d5e62b0,11,933,10.4,11,10,0,0,8,19,-11,10.4,16.4,-6.0,22,ITA
6d70c771,7,256,2.8,2,0,5,12,2,7,-5,2.7,5.4,-2.7,22,ITA
6e058f06,36,2740,30.4,32,16,4,0,51,47,4,45.5,52.8,-7.3,22,ITA
6eee05f1,31,2256,25.1,25,19,6,1,39,28,11,41.0,29.8,11.2,22,ITA
6f30a1d5,1,1,0.0,0,0,1,6,0,0,0,0.0,0.0,0.0,22,ITA
6f5ead86,18,682,7.6,7,1,11,10,4,20,-16,5.1,12.7,-7.6,22,ITA
6fe90922,35,2821,31.3,35,16,0,2,64,25,39,64.7,30.8,33.9,22,ITA
7152082d,1,29,0.3,0,0,1,2,0,0,0,0.0,0.7,-0.7,22,ITA
71dc23da,13,603,6.7,6,3,7,18,7,16,-9,6.5,12.2,-5.7,22,ITA
72f87f25,3,38,0.4,0,0,3,5,2,0,2,1.2,0.1,1.1,22,ITA
73affbb6,1,22,0.2,0,0,1,10,0,0,0,0.2,0.5,-0.3,22,ITA
74419746,37,3330,37.0,37,37,0,1,83,30,53,79.5,37.9,41.6,22,ITA
7452c7a8,1,81,0.9,0,0,1,12,0,1,-1,1.0,1.4,-0.5,22,ITA
75438a9a,20,1491,16.6,16,14,4,14,24,24,0,17.7,28.3,-10.6,22,ITA
75b86fb3,31,2311,25.7,29,13,2,1,57,18,39,50.5,26.1,24.4,22,ITA
75e60d75,14,495,5.5,4,0,10,4,6,6,0,5.7,10.0,-4.4,22,ITA
75f2c59f,24,1794,19.9,22,13,2,1,32,28,4,27.8,27.4,0.4,22,ITA
7703afb6,30,1768,19.6,19,7,11,3,22,36,-14,21.8,30.8,-9.0,22,ITA
77d6fd4d,38,3420,38.0,38,38,0,0,50,70,-20,44.9,66.0,-21.2,22,ITA
780e3631,27,1438,16.0,18,3,9,7,24,22,2,23.3,19.8,3.5,22,ITA
78841da9,30,1298,14.4,16,3,14,8,21,24,-3,19.8,19.5,0.3,22,ITA
79083382,21,1278,14.2,14,13,7,17,22,15,7,22.0,14.8,7.2,22,ITA
79443529,36,2933,32.6,33,23,3,0,59,39,20,48.9,36.0,12.9,22,ITA
79b0d6a0,38,3420,38.0,38,38,0,0,59,43,16,65.1,38.4,26.8,22,ITA
79d60e74,1,45,0.5,0,0,1,5,0,2,-2,0.4,1.0,-0.7,22,ITA
7ae36711,7,180,2.0,1,0,6,8,1,3,-2,3.3,2.4,0.9,22,ITA
7afbd2c3,30,1716,19.1,18,7,12,2,13,29,-16,18.3,27.4,-9.1,22,ITA
7b075c75,28,2266,25.2,26,23,2,5,27,26,1,30.3,32.2,-1.9,22,ITA
7b5f516f,1,37,0.4,0,0,1,35,1,1,0,0.4,0.6,-0.1,22,ITA
7cd520e8,35,2477,27.5,29,16,6,1,50,39,11,40.2,35.1,5.1,22,ITA
7d50454d,24,1445,16.1,16,9,8,6,14,31,-17,16.7,25.1,-8.3,22,ITA
7eb97a8e,27,896,10.0,6,1,21,8,19,20,-1,17.1,16.8,0.3,22,ITA
7ec7738e,29,975,10.8,9,3,20,9,11,18,-7,13.7,21.6,-7.9,22,ITA
7edfbb8a,31,2718,30.2,30,28,1,1,56,20,36,45.7,28.8,16.9,22,ITA
7f267d66,33,2129,23.7,28,6,5,3,21,47,-26,22.5,39.8,-17.3,22,ITA
7f78ad23,34,2473,27.5,28,22,6,1,30,29,1,34.3,24.6,9.7,22,ITA
7f9d956a,1,6,0.1,0,0,1,2,0,0,0,0.0,0.0,0.0,22,ITA
7fac99d4,36,2816,31.3,31,26,5,0,30,58,-28,33.3,48.9,-15.6,22,ITA
7fe90ccd,34,2345,26.1,29,14,5,1,43,36,7,43.8,31.9,11.9,22,ITA
801831fe,8,148,1.6,2,0,6,22,2,2,0,2.3,3.3,-1.0,22,ITA
80556f08,29,982,10.9,9,2,20,7,22,21,1,15.2,15.0,0.2,22,ITA
80dbbd10,19,842,9.4,10,2,9,0,7,26,-19,8.6,18.4,-9.7,22,ITA
81255c03,37,3323,36.9,37,35,0,0,32,67,-35,38.0,59.9,-22.0,22,ITA
817c6964,28,1416,15.7,15,5,13,5,32,12,20,26.2,15.7,10.5,22,ITA
81a4c239,5,76,0.8,0,0,5,11,1,0,1,0.8,1.0,-0.2,22,ITA
82598b71,29,1410,15.7,13,6,16,6,15,29,-14,17.4,25.0,-7.6,22,ITA
82b1198a,31,2790,31.0,31,31,0,5,58,25,33,44.1,25.6,18.5,22,ITA
82efe6fa,34,2889,32.1,32,32,2,1,50,39,11,54.0,34.6,19.4,22,ITA
854ee61a,38,1362,15.1,11,1,27,0,19,32,-13,19.7,29.2,-9.5,22,ITA
85a44ecc,31,2332,25.9,29,18,2,0,20,55,-35,23.3,43.6,-20.3,22,ITA
85f7d1be,28,1944,21.6,21,18,7,10,35,9,26,35.7,16.4,19.3,22,ITA
86383d0e,4,38,0.4,0,0,4,9,1,0,1,0.8,0.4,0.4,22,ITA
8650af85,36,3124,34.7,35,32,1,1,59,63,-4,51.1,60.8,-9.6,22,ITA
86695068,23,1539,17.1,17,7,6,0,28,20,8,26.4,18.7,7.8,22,ITA
875d65d1,1,9,0.1,0,0,1,3,0,0,0,0.1,0.0,0.1,22,ITA
8790f988,36,2146,23.8,25,9,11,0,44,42,2,36.6,42.8,-6.2,22,ITA
8794e251,32,2285,25.4,28,17,4,2,30,25,5,34.4,26.2,8.2,22,ITA
880fcdbb,1,11,0.1,0,0,1,34,0,0,0,0.1,0.5,-0.5,22,ITA
88895312,24,768,8.5,5,0,19,10,17,16,1,10.2,12.3,-2.2,22,ITA
88f53b75,1,19,0.2,0,0,1,4,0,0,0,0.6,0.3,0.2,22,ITA
89976232,11,526,5.8,6,2,5,21,3,5,-2,6.1,6.8,-0.7,22,ITA
89b2c8a9,30,1384,15.4,16,3,14,3,36,11,25,24.4,14.0,10.4,22,ITA
8abd0c03,14,643,7.1,6,5,8,22,9,15,-6,10.3,7.4,2.9,22,ITA
8abd174d,18,1236,13.7,13,10,5,17,14,29,-15,15.7,28.6,-12.9,22,ITA
8b609c34,35,2607,29.0,32,15,3,0,34,28,6,35.1,26.1,9.0,22,ITA
8b8a56ce,11,802,8.9,10,8,1,2,19,15,4,12.9,12.3,0.6,22,ITA
8b95acda,32,2745,30.5,31,26,1,0,42,47,-5,30.6,42.5,-12.0,22,ITA
8c63fae5,27,2103,23.4,25,10,2,2,20,47,-27,17.7,36.0,-18.3,22,ITA
8c65eb5f,22,629,7.0,6,2,16,15,13,10,3,11.4,7.7,3.7,22,ITA
8c90fd7a,27,1983,22.0,23,9,4,0,42,16,26,32.3,19.8,12.5,22,ITA
8c964914,1,15,0.2,0,0,1,0,0,0,0,0.3,0.2,0.1,22,ITA
8cabdc1e,37,3322,36.9,37,36,0,0,64,63,1,54.9,64.3,-9.4,22,ITA
8cc29864,14,870,9.7,8,7,6,11,14,19,-5,13.3,18.8,-5.5,22,ITA
8da74c05,38,2574,28.6,26,16,12,0,45,36,9,35.6,35.0,0.6,22,ITA
8daee720,1,23,0.3,0,0,1,1,0,0,0,0.3,0.8,-0.5,22,ITA
8f866fe8,18,1140,12.7,15,5,3,0,15,19,-4,12.0,15.7,-3.7,22,ITA
8fef5412,8,247,2.7,2,1,6,17,4,6,-2,3.3,4.5,-1.3,22,ITA
9085dd7c,1,16,0.2,0,0,1,2,0,0,0,0.8,0.0,0.8,22,ITA
90e1d9dc,1,45,0.5,0,0,1,4,1,0,1,0.5,0.5,0.0,22,ITA
919dd4b1,11,201,2.2,1,0,10,24,1,4,-3,1.5,2.5,-1.0,22,ITA
91d0fabf,19,1346,15.0,16,8,3,3,20,34,-14,18.7,26.2,-7.5,22,ITA
921f6058,34,2672,29.7,30,25,4,1,54,40,14,51.8,34.5,17.2,22,ITA
92948398,23,833,9.3,8,1,15,14,14,21,-7,9.5,22.1,-12.6,22,ITA
92b4758e,17,1421,15.8,17,12,0,0,21,25,-4,16.3,20.5,-4.3,22,ITA
92d83c27,36,2564,28.5,31,15,5,1,25,42,-17,27.8,39.1,-11.3,22,ITA
933d3b51,25,1735,19.3,21,13,4,4,24,19,5,23.1,17.2,5.9,22,ITA
93b891d1,12,307,3.5,1,1,11,10,6,6,0,5.7,6.1000000000000005,-0.3,22,ITA
9413b19f,7,619,6.9,7,6,0,25,16,6,10,13.7,6.4,7.3,22,ITA
947e036f,14,892,9.9,13,2,1,1,12,13,-1,14.0,8.3,5.7,22,ITA
94816803,24,1239,13.8,14,2,10,9,16,19,-3,20.9,14.3,6.5,22,ITA
94b2001f,22,1893,21.0,22,20,0,2,31,19,12,28.7,21.2,7.5,22,ITA
952a03fe,2,180,2.0,2,2,0,17,3,9,-6,2.8,5.5,-2.7,22,ITA
956a78ea,1,9,0.1,0,0,1,1,0,0,0,0.0,0.0,0.0,22,ITA
957e4c87,35,2819,31.3,33,17,2,0,36,54,-18,32.6,52.2,-19.6,22,ITA
958a601f,13,516,5.7,4,2,9,12,6,20,-14,5.4,16.4,-11.0,22,ITA
9592289a,10,129,1.4,0,0,10,6,0,0,0,2.8,1.5,1.3,22,ITA
95facda1,21,1523,16.9,16,14,5,0,16,32,-16,18.3,27.5,-9.2,22,ITA
963a328b,30,1658,18.4,22,0,8,6,26,20,6,22.3,23.4,-1.2,22,ITA
96960855,1,7,0.1,0,0,1,1,0,0,0,0.0,0.0,0.0,22,ITA
96e0490d,25,1507,16.7,18,9,7,9,34,21,13,32.3,18.8,13.5,22,ITA
970b8574,32,1430,15.9,13,6,19,6,39,16,23,37.8,15.6,22.2,22,ITA
97e8ea97,2,8,0.1,0,0,2,11,1,0,1,0.7,0.0,0.7,22,ITA
9823be92,33,2252,25.0,26,15,7,4,39,43,-4,35.7,37.8,-2.1999999999999997,22,ITA
983ff2c7,23,1571,17.5,20,11,3,12,26,21,5,25.2,15.3,9.9,22,ITA
98a84572,6,53,0.6,0,0,6,8,1,3,-2,0.9,2.6,-1.7,22,ITA
98d2c2c4,29,2369,26.3,28,18,1,5,34,35,-1,40.5,31.5,9.0,22,ITA
9907b1c8,28,1971,21.9,23,8,5,2,28,24,4,34.8,23.5,11.3,22,ITA
997fff07,24,1958,21.8,22,20,2,8,30,40,-10,26.6,37.2,-10.6,22,ITA
9bb1ad91,15,661,7.3,5,1,10,9,5,14,-9,7.5,17.7,-10.2,22,ITA
9d4c45d6,35,2622,29.1,32,14,3,0,36,40,-4,34.7,36.2,-1.5,22,ITA
9d60028d,26,1325,14.7,16,6,10,6,12,25,-13,14.8,25.0,-10.3,22,ITA
9e1577aa,37,3153,35.0,37,25,0,0,56,49,7,57.1,39.0,18.1,22,ITA
9ef42479,33,2115,23.5,23,9,10,0,25,48,-23,24.0,46.6,-22.5,22,ITA
9f1893b9,38,2888,32.1,33,16,5,0,61,50,11,47.6,39.9,7.7,22,ITA
9f5a610b,10,855,9.5,9,9,1,27,10,14,-4,9.5,12.1,-2.7,22,ITA
9f84febe,36,2883,32.0,32,21,4,0,49,34,15,54.8,31.7,23.1,22,ITA
9f9b9269,10,620,6.9,7,4,3,22,9,16,-7,7.5,13.4,-5.9,22,ITA
9fa26bc2,27,2430,27.0,27,27,0,8,35,33,2,35.2,27.2,8.0,22,ITA
a111cf41,33,2932,32.6,33,32,0,4,61,42,19,53.6,39.9,13.6,22,ITA
a2565f79,1,90,1.0,1,1,0,19,0,5,-5,0.7,3.0,-2.3,22,ITA
a26fb8aa,30,2126,23.6,23,17,7,4,43,27,16,39.6,26.0,13.5,22,ITA
a2d9f138,25,1078,12.0,10,5,15,7,23,22,1,18.0,22.5,-4.4,22,ITA
a378a02a,10,214,2.4,0,0,10,9,2,5,-3,3.3,7.7,-4.4,22,ITA
a39b9ef6,6,66,0.7,0,0,6,6,0,1,-1,1.0,0.5,0.5,22,ITA
a40819d9,17,1025,11.4,13,8,4,18,15,11,4,22.1,8.4,13.7,22,ITA
a40d5a0c,11,287,3.2,1,0,10,4,3,6,-3,3.7,4.9,-1.1,22,ITA
a44d3a3c,15,347,3.9,2,0,13,9,6,7,-1,3.9,5.2,-1.2,22,ITA
a4948e67,21,1068,11.9,10,8,11,5,12,20,-8,12.4,21.2,-8.8,22,ITA
a4e85758,30,2242,24.9,23,22,7,8,41,30,11,39.8,26.2,13.5,22,ITA
a4fe8cda,28,1401,15.6,15,3,13,9,20,27,-7,18.6,26.6,-8.0,22,ITA
a5296e55,35,2086,23.2,26,7,9,1,41,24,17,32.7,21.3,11.4,22,ITA
a69cc629,19,754,8.4,7,2,12,13,6,11,-5,7.3,10.7,-3.4,22,ITA
a69e4806,30,1613,17.9,20,2,10,1,42,12,30,28.6,13.6,15.1,22,ITA
a796492f,1,16,0.2,0,0,1,0,0,0,0,0.0,0.0,0.0,22,ITA
a820e429,14,749,8.3,8,2,6,2,11,11,0,13.8,8.8,5.1,22,ITA
a8a874f1,31,2160,24.0,23,15,8,0,37,22,15,32.7,23.3,9.4,22,ITA
a8f21b9f,19,554,6.2,3,0,16,16,13,2,11,12.4,6.8,5.6,22,ITA
a9202def,15,1147,12.7,13,7,2,1,16,18,-2,16.1,17.5,-1.4,22,ITA
a96e5dc0,20,1399,15.5,15,12,5,5,30,25,5,26.6,24.7,1.9,22,ITA
a9aa0d1d,19,772,8.6,7,1,12,14,12,13,-1,11.4,11.3,0.0,22,ITA
aa25ce92,6,274,3.0,3,1,3,17,3,3,0,2.5,4.3,-1.8,22,ITA
aa5322d5,19,1466,16.3,17,12,2,18,14,23,-9,17.6,24.8,-7.2,22,ITA
aa54ec6f,15,1341,14.9,15,14,0,2,24,21,3,21.0,21.5,-0.5,22,ITA
aae9d04a,32,2572,28.6,30,21,2,0,51,41,10,37.8,36.7,1.1,22,ITA
ab1ca213,22,1343,14.9,17,8,5,3,24,25,-1,22.0,17.9,4.2,22,ITA
ab4449d6,36,3240,36.0,36,36,0,0,41,53,-12,42.9,49.8,-6.9,22,ITA
ac277993,20,680,7.6,6,2,14,17,3,13,-10,5.6,17.2,-11.6,22,ITA
ac4003af,5,450,5.0,5,5,0,31,3,6,-3,8.4,4.8,3.7,22,ITA
ac7e640b,31,2704,30.0,30,30,1,5,27,52,-25,27.2,56.2,-29.0,22,ITA
acf7e795,20,1314,14.6,13,11,7,15,20,19,1,20.3,16.4,3.9,22,ITA
ad263695,1,3,0.0,0,0,1,9,0,0,0,0.2,0.1,0.0,22,ITA
aded8e6f,9,256,2.8,3,0,6,20,3,6,-3,2.7,5.1,-2.5,22,ITA
ae4e2852,20,1168,13.0,13,9,7,7,18,13,5,15.6,17.4,-1.8,22,ITA
ae7058f9,11,490,5.4,4,4,7,11,3,13,-10,3.9,9.3,-5.3,22,ITA
ae94a6c5,11,68,0.8,0,0,11,21,4,0,4,1.8,0.5,1.3,22,ITA
ae9898c5,14,676,7.5,8,2,6,0,7,15,-8,9.4,12.9,-3.5,22,ITA
afbf187b,14,989,11.0,11,8,3,4,8,25,-17,9.7,17.3,-7.5,22,ITA
b056e3da,6,540,6.0,6,6,0,30,14,10,4,8.3,8.3,0.0,22,ITA
b0f7e36c,14,863,9.6,11,3,3,0,15,11,4,14.7,8.5,6.2,22,ITA
b1236c63,7,188,2.1,1,0,6,21,8,0,8,5.2,2.9,2.4,22,ITA
b1f0b916,1,8,0.1,0,0,1,28,0,0,0,0.1,0.2,-0.1,22,ITA
b35a7399,15,1172,13.0,13,12,2,1,5,19,-14,14.0,18.5,-4.5,22,ITA
b3af9be1,1,10,0.1,0,0,1,0,0,0,0,0.1,0.1,0.0,22,ITA
b5c3ff9f,18,1255,13.9,14,10,4,14,9,34,-25,9.0,27.3,-18.3,22,ITA
b64073a0,1,90,1.0,1,1,0,2,0,3,-3,0.3,1.9,-1.5,22,ITA
b6964eb6,27,2091,23.2,23,21,4,3,35,28,7,35.7,21.1,14.6,22,ITA
b6a1cdf9,12,227,2.5,1,0,11,19,4,6,-2,3.7,3.9,-0.2,22,ITA
b6b2b820,8,311,3.5,2,0,6,0,2,5,-3,2.8,4.7,-1.9,22,ITA
b70bde8f,20,921,10.3,11,4,9,9,12,13,-1,10.4,13.2,-2.9,22,ITA
b79858d5,12,607,6.7,6,2,6,2,4,6,-2,9.9,8.3,1.6,22,ITA
b7a5bc86,9,587,6.5,6,4,3,0,11,13,-2,9.6,10.5,-0.8,22,ITA
b804c280,1,7,0.1,0,0,1,1,0,0,0,0.2,0.4,-0.2,22,ITA
b85bf253,18,651,7.2,7,2,11,11,10,15,-5,9.0,12.6,-3.6,22,ITA
b96b595c,30,2536,28.2,29,27,1,0,59,48,11,38.1,35.9,2.1,22,ITA
ba3d3bea,32,1707,19.0,19,1,13,2,40,29,11,26.9,21.3,5.6,22,ITA
bb376bed,32,2526,28.1,30,16,2,0,46,45,1,34.9,34.4,0.5,22,ITA
bbafc0c4,19,691,7.7,5,2,14,10,12,12,0,9.6,11.0,-1.4,22,ITA
bcc81786,32,2646,29.4,31,26,1,1,36,56,-20,32.4,48.0,-15.6,22,ITA
be2706c0,29,1976,22.0,22,14,7,7,26,21,5,29.7,22.4,7.3,22,ITA
be6c1ccc,2,54,0.6,0,0,2,0,0,2,-2,0.2,1.4,-1.3,22,ITA
bee704fc,34,2926,32.5,34,29,0,2,46,41,5,50.0,32.9,17.1,22,ITA
bf309d24,4,170,1.9,2,1,2,25,1,1,0,2.2,1.5,0.7,22,ITA
bf356094,11,394,4.4,3,1,8,6,6,13,-7,5.7,9.3,-3.6,22,ITA
bf39bdec,10,116,1.3,0,0,10,4,2,3,-1,1.5,2.8,-1.3,22,ITA
bf57eaab,32,1866,20.7,19,7,13,1,19,44,-25,20.2,36.0,-15.8,22,ITA
c0c7ff58,32,2384,26.5,29,12,3,1,56,17,39,42.6,20.5,22.0,22,ITA
c13ddd3e,2,5,0.1,0,0,2,7,0,0,0,0.9,0.0,0.9,22,ITA
c1d95617,34,3060,34.0,34,34,0,2,57,50,7,43.3,41.7,1.7,22,ITA
c1e8e74e,2,85,0.9,1,0,1,0,1,5,-4,1.1,3.0,-1.9,22,ITA
c235e803,8,537,6.0,6,4,2,28,13,7,6,12.4,4.8,7.6,22,ITA
c283ddef,2,38,0.4,0,0,2,0,1,1,0,0.4,0.1,0.3,22,ITA
c316607a,29,2300,25.6,27,21,2,8,43,43,0,35.4,44.5,-9.1,22,ITA
c375dfa5,18,488,5.4,3,0,15,20,8,8,0,8.9,9.3,-0.4,22,ITA
c459a650,26,1471,16.3,15,9,11,6,36,24,12,27.2,18.6,8.6,22,ITA
c50cee19,18,747,8.3,6,2,12,2,13,16,-3,9.1,12.0,-2.9,22,ITA
c56dc39e,20,1438,16.0,16,12,4,1,33,22,11,27.2,18.7,8.5,22,ITA
c5adc293,14,332,3.7,3,2,11,15,7,2,5,5.6,5.0,0.6,22,ITA
c6e8cf1f,35,2982,33.1,34,29,1,0,41,35,6,42.5,35.2,7.2,22,ITA
c707411f,4,313,3.5,3,3,1,5,8,2,6,6.3,2.3,4.0,22,ITA
c7259b83,21,1319,14.7,16,10,5,4,17,10,7,17.8,12.8,4.9,22,ITA
c730da00,2,46,0.5,0,0,2,13,1,0,1,0.2,0.5,-0.4,22,ITA
c83c203f,11,699,7.8,8,5,3,5,9,8,1,7.4,8.5,-1.2,22,ITA
c8c0dccd,24,1322,14.7,17,2,7,10,5,15,-10,13.4,19.0,-5.6,22,ITA
c8d7131c,25,2056,22.8,24,18,1,3,16,39,-23,20.7,45.4,-24.8,22,ITA
c976160c,12,808,9.0,9,5,3,1,7,17,-10,11.9,13.6,-1.7,22,ITA
c9c32262,6,495,5.5,6,5,0,7,5,9,-4,4.7,9.5,-4.8,22,ITA
ca3db240,25,1144,12.7,11,5,14,11,11,26,-15,12.1,25.8,-13.7,22,ITA
ca6edaa0,8,84,0.9,0,0,8,21,2,1,1,1.1,2.4,-1.3,22,ITA
caaf2ed1,5,246,2.7,2,2,3,10,3,6,-3,2.0,7.9,-5.9,22,ITA
caffaf5a,26,1823,20.3,19,16,7,5,27,42,-15,21.9,33.6,-11.7,22,ITA
cb678320,6,399,4.4,4,4,2,8,1,17,-16,2.4,13.1,-10.7,22,ITA
cc1a0c57,7,630,7.0,7,7,0,29,8,19,-11,7.4,11.8,-4.4,22,ITA
cce9f582,18,769,8.600000000000001,8,3,10,16,16,15,1,8.6,10.799999999999999,-2.2,22,ITA
cd0fa27b,34,2480,27.6,33,7,1,2,59,21,38,54.2,26.6,27.5,22,ITA
ce1806be,26,1239,13.8,14,4,12,4,17,28,-11,14.8,26.5,-11.7,22,ITA
ce1a6c7e,1,74,0.8,1,0,0,3,1,0,1,0.7,0.6,0.0,22,ITA
ce30bfc8,18,649,7.2,6,1,12,17,14,10,4,17.2,9.8,7.4,22,ITA
cf007308,37,1620,18.0,12,6,25,0,38,15,23,29.4,15.2,14.2,22,ITA
cf043a33,1,63,0.7,1,0,0,21,2,0,2,1.0,0.5,0.5,22,ITA
cf1c23d8,3,270,3.0,3,3,0,34,6,8,-2,4.1,6.0,-1.9,22,ITA
cf961d8d,36,3240,36.0,36,36,0,1,39,64,-25,39.0,59.2,-20.1,22,ITA
cfbf9881,6,108,1.2,1,0,5,24,0,3,-3,0.1,3.1,-2.9,22,ITA
d023d70f,16,896,10.0,11,2,5,20,10,9,1,10.3,7.3,3.0,22,ITA
d0d8dd44,30,2410,26.8,28,23,2,2,64,27,37,59.5,28.4,31.1,22,ITA
d0dbca9f,23,1643,18.3,20,8,3,15,21,26,-5,16.6,25.6,-8.9,22,ITA
d125f22f,32,2053,22.8,24,8,8,0,19,40,-21,19.0,43.5,-24.5,22,ITA
d183e9d6,22,983,10.9,13,1,9,15,15,24,-9,10.6,19.0,-8.4,22,ITA
d1b49282,35,2943,32.7,35,25,0,0,41,58,-17,31.0,49.1,-18.1,22,ITA
d2e8fd9b,5,334,3.7,3,3,2,14,1,15,-14,1.5,10.6,-9.1,22,ITA
d3298c99,33,1957,21.7,21,7,12,2,31,46,-15,24.2,34.9,-10.7,22,ITA
d37b0350,33,1518,16.9,14,5,19,2,14,30,-16,18.0,24.3,-6.3,22,ITA
d3aaad90,27,1055,11.7,8,1,19,4,16,14,2,22.5,12.5,9.9,22,ITA
d3b888e3,4,48,0.5,0,0,4,14,0,1,-1,0.3,0.2,0.1,22,ITA
d3d758d8,10,311,3.5,2,0,8,5,10,9,1,6.8,8.2,-1.4,22,ITA
d3de9af0,24,1722,19.1,20,9,4,2,35,31,4,35.2,26.2,9.0,22,ITA
d3e0c826,1,45,0.5,0,0,1,13,1,1,0,2.3,1.3,1.0,22,ITA
d44360be,35,1955,21.7,24,2,11,0,22,43,-21,23.8,36.5,-12.7,22,ITA
d4535821,33,2721,30.2,30,26,3,2,63,41,22,46.5,35.6,10.9,22,ITA
d4931a5a,14,406,4.5,4,0,10,3,8,9,-1,7.8,8.1,-0.3,22,ITA
d4a2533d,32,2286,25.4,26,12,6,2,27,26,1,30.4,28.3,2.2,22,ITA
d4c9725f,32,2711,30.1,30,26,2,0,58,22,36,51.0,26.5,24.5,22,ITA
d541e703,9,596,6.6,8,4,1,10,5,15,-10,3.9,13.8,-9.9,22,ITA
d60c26fc,4,58,0.6,0,0,4,12,4,0,4,1.9,0.5,1.4,22,ITA
d697a2d0,5,113,1.3,1,0,4,13,4,5,-1,2.4,0.8,1.6,22,ITA
d6a889ea,8,288,3.2,2,1,6,18,4,7,-3,2.6,4.3,-1.7,22,ITA
d6e53a3a,31,2674,29.7,29,27,2,6,47,29,18,40.6,26.3,14.4,22,ITA
d6f88a1d,17,1083,12.0,12,6,5,0,21,21,0,14.8,15.8,-1.0,22,ITA
d705ba44,22,1371,15.2,16,4,6,1,14,16,-2,18.7,15.2,3.5,22,ITA
d711d04f,20,843,9.4,7,2,13,3,11,19,-8,11.0,16.9,-5.9,22,ITA
d7918b13,38,2020,22.4,23,9,15,0,31,44,-13,25.9,41.2,-15.3,22,ITA
d7a35008,1,5,0.1,0,0,1,34,0,1,-1,0.0,0.8,-0.8,22,ITA
d7d32194,27,1744,19.4,21,7,6,3,19,32,-13,20.1,29.6,-9.5,22,ITA
d80b1835,2,20,0.2,0,0,2,10,0,0,0,0.1,0.1,-0.1,22,ITA
d85c238b,31,2056,22.8,23,13,8,0,51,30,21,35.3,24.3,11.0,22,ITA
d8800a46,17,1248,13.9,13,12,4,17,17,34,-17,14.9,25.0,-10.1,22,ITA
d9624b51,34,2358,26.2,29,11,5,2,41,41,0,33.6,31.6,1.9,22,ITA
d97ec0d1,1,2,0.0,0,0,1,0,0,0,0,0.0,0.1,-0.1,22,ITA
d97f2e8d,24,815,9.0,8,2,16,11,12,17,-5,9.600000000000001,13.5,-3.8,22,ITA
d995ed27,31,2266,25.2,28,10,3,1,44,31,13,40.0,25.0,14.9,22,ITA
d9cfca3d,6,160,1.8,2,0,4,1,4,6,-2,1.3,4.3,-3.0,22,ITA
da5a981b,18,880,9.8,13,0,5,8,10,17,-7,8.7,15.1,-6.3,22,ITA
da77b60b,10,227,2.5,1,0,9,11,3,4,-1,3.0,3.9,-1.0,22,ITA
da974c7b,27,2405,26.7,27,25,0,0,58,19,39,39.8,22.6,17.3,22,ITA
db092d3b,31,1525,16.9,15,4,16,0,29,14,15,22.0,16.0,6.0,22,ITA
dc3e663e,22,1964,21.8,21,21,1,8,24,35,-11,23.0,37.7,-14.6,22,ITA
dc3fa3b5,19,692,7.7,7,1,12,13,10,7,3,8.5,8.8,-0.3,22,ITA
dd0daf32,31,2495,27.7,29,18,2,1,42,28,14,47.0,25.6,21.5,22,ITA
dd403465,19,1028,11.4,11,4,8,10,6,20,-14,11.4,17.6,-6.2,22,ITA
dd86e8e4,10,466,5.2,5,2,5,5,5,9,-4,5.4,8.7,-3.3,22,ITA
de135234,3,51,0.6,0,0,3,17,0,1,-1,0.7,0.6,0.1,22,ITA
dea698d9,1,31,0.3,0,0,1,0,0,1,-1,0.3,0.5,-0.2,22,ITA
deb748c9,9,727,8.1,9,5,0,4,9,15,-6,9.5,19.8,-10.2,22,ITA
df3cda47,20,772,8.6,5,2,15,2,16,9,7,14.0,7.9,6.1,22,ITA
df85d472,7,67,0.7,0,0,7,16,2,2,0,2.7,1.3,1.3,22,ITA
df8d6029,31,2424,26.9,28,22,3,3,29,36,-7,29.0,37.9,-8.9,22,ITA
e0314d87,7,515,5.7,6,4,1,25,4,11,-7,4.1,8.9,-4.8,22,ITA
e0921a4f,29,2061,22.9,26,11,3,0,34,23,11,28.9,20.0,9.0,22,ITA
e14ec482,29,1785,19.8,21,6,8,8,21,24,-3,21.5,26.4,-4.9,22,ITA
e1b0a70d,32,2862,31.8,31,31,1,5,52,43,9,52.9,33.1,19.8,22,ITA
e1cbb531,23,1686,18.7,19,13,4,6,37,16,21,27.0,13.1,13.9,22,ITA
e288d4b3,24,1152,12.8,12,3,12,4,23,10,13,19.6,10.8,8.8,22,ITA
e2a302a8,18,585,6.5,4,0,14,16,5,12,-7,5.8,13.9,-8.1,22,ITA
e33f36d5,27,2033,22.6,23,17,4,6,37,36,1,30.0,32.4,-2.3,22,ITA
e34e086c,3,190,2.1,2,0,1,12,5,4,1,5.3,2.0,3.3,22,ITA
e358587b,15,1350,15.0,15,15,0,23,29,29,0,19.3,21.0,-1.7,22,ITA
e3756e72,31,2496,27.7,27,19,4,4,22,49,-27,27.7,45.8,-18.2,22,ITA
e3a5814e,8,487,5.4,7,1,1,10,10,8,2,8.6,3.8,4.8,22,ITA
e3cceee6,28,1917,21.3,22,16,6,6,30,22,8,33.0,27.0,6.0,22,ITA
e4ba67f2,2,4,0.0,0,0,2,9,1,0,1,0.1,0.0,0.1,22,ITA
e58cbfd5,21,1468,16.3,16,12,5,4,15,27,-12,18.1,22.3,-4.2,22,ITA
e599253a,37,2002,22.2,24,5,13,0,41,19,22,38.1,20.8,17.3,22,ITA
e5bf73f3,34,2134,23.7,25,5,9,1,26,34,-8,26.3,29.1,-2.8,22,ITA
e63e122d,2,76,0.8,1,0,1,1,1,0,1,0.5,0.9,-0.4,22,ITA
e74f0e59,31,2294,25.5,27,18,4,1,30,44,-14,30.3,36.5,-6.2,22,ITA
e85fb9b8,21,1354,15.0,16,11,5,6,18,12,6,20.4,14.1,6.3,22,ITA
e8c930bb,34,2844,31.6,34,24,0,1,20,47,-27,28.9,41.6,-12.7,22,ITA
e921b9db,1,16,0.2,0,0,1,0,0,0,0,0.0,0.0,0.0,22,ITA
e94d79e3,14,832,9.2,9,6,5,0,8,17,-9,8.6,13.9,-5.4,22,ITA
ea06dd97,15,440,4.9,2,0,13,15,3,9,-6,5.6,9.3,-3.7,22,ITA
ea0893d6,17,850,9.4,9,3,8,0,5,11,-6,12.9,12.2,0.7,22,ITA
eade5337,1,6,0.1,0,0,1,10,0,0,0,0.0,0.1,-0.1,22,ITA
eb0ec070,33,2512,27.9,30,19,3,1,31,48,-17,29.1,43.3,-14.2,22,ITA
eb2fe5b6,27,1539,17.1,17,2,10,4,31,21,10,29.6,19.8,9.8,22,ITA
eb76987d,27,1495,16.6,14,11,13,11,19,37,-18,18.3,33.0,-14.7,22,ITA
ec1f737d,1,90,1.0,1,1,0,30,3,3,0,2.1,3.2,-1.1,22,ITA
ec5dae45,24,594,6.6,3,0,21,11,10,13,-3,10.1,11.8,-1.6,22,ITA
ec6773f5,2,25,0.3,0,0,2,10,1,0,1,0.5,0.7,-0.2,22,ITA
eccbe56a,12,671,7.5,9,1,3,3,8,10,-2,11.0,11.5,-0.6,22,ITA
ed5c0319,28,2173,24.1,24,17,4,0,37,40,-3,31.0,29.5,1.6,22,ITA
ed90babd,15,326,3.6,1,1,14,6,6,4,2,5.8,2.6,3.2,22,ITA
eda40760,3,42,0.5,0,0,3,20,1,1,0,1.3,0.4,0.9,22,ITA
ee251371,36,1865,20.7,22,6,14,2,37,21,16,34.7,20.0,14.7,22,ITA
ee3c4b3f,3,38,0.4,0,0,3,4,1,0,1,0.7,0.5,0.2,22,ITA
ee4f2f3b,33,1664,18.5,19,7,14,3,22,34,-12,15.9,28.4,-12.5,22,ITA
ee833569,10,900,10.0,10,10,0,26,7,8,-1,11.6,11.2,0.4,22,ITA
ee9040b4,4,21,0.2,0,0,4,14,0,0,0,0.1,0.9,-0.8,22,ITA
ee93c1a9,28,1475,16.4,16,3,12,3,26,13,13,22.5,17.5,5.0,22,ITA
ef2e5e1a,10,640,7.1,7,2,3,6,9,14,-5,7.9,10.0,-2.1,22,ITA
ef301f96,1,45,0.5,0,0,1,16,0,1,-1,0.5,0.2,0.4,22,ITA
ef619b0b,3,99,1.1,1,0,2,6,2,3,-1,0.7,2.2,-1.5,22,ITA
ef7cd87a,8,430,4.8,6,1,2,10,4,9,-5,3.3,7.9,-4.6,22,ITA
ef94dc2f,1,36,0.4,0,0,1,0,2,1,1,1.1,0.7,0.4,22,ITA
f02dde20,1,90,1.0,1,1,0,34,0,1,-1,1.1,0.8,0.3,22,ITA
f058ed1f,1,90,1.0,1,1,0,37,0,3,-3,0.6,1.8,-1.2,22,ITA
f1cfc209,24,1329,14.8,14,5,10,11,16,23,-7,15.0,20.6,-5.6,22,ITA
f1d25de7,1,3,0.0,0,0,1,13,0,0,0,0.0,0.0,0.0,22,ITA
f1f1f238,30,2411,26.8,29,23,1,2,44,42,2,34.8,36.0,-1.2,22,ITA
f209b81e,9,183,2.0,0,0,9,12,3,5,-2,3.4,4.5,-1.1,22,ITA
f35430a4,5,219,2.4,2,2,3,24,1,7,-6,2.4,5.5,-3.1,22,ITA
f42d6c13,35,2054,22.8,23,5,12,3,33,39,-6,31.3,35.9,-4.6,22,ITA
f449640d,10,446,5.0,5,2,5,22,8,9,-1,5.7,8.4,-2.7,22,ITA
f45f9427,28,2081,23.1,27,10,1,2,22,43,-21,24.1,37.8,-13.7,22,ITA
f49c4ae9,26,1428,15.9,14,2,12,1,30,13,17,23.5,13.8,9.8,22,ITA
f4d60499,10,695,7.7,6,5,4,5,4,9,-5,8.7,9.7,-1.0,22,ITA
f503ea63,26,1637,18.2,19,7,7,5,20,27,-7,14.8,25.0,-10.2,22,ITA
f554e29b,35,3150,35.0,35,35,0,0,32,63,-31,36.4,54.7,-18.3,22,ITA
f573a8bf,22,911,10.1,11,1,11,2,19,20,-1,15.5,15.0,0.5,22,ITA
f586779e,37,3084,34.3,36,23,1,0,54,38,16,59.3,33.2,26.1,22,ITA
f5f21026,5,65,0.7,0,0,5,30,1,2,-1,1.8,2.0,-0.2,22,ITA
f61c7c4e,23,1421,15.8,16,5,7,0,13,29,-16,13.1,23.2,-10.1,22,ITA
f6a06749,1,45,0.5,0,0,1,35,0,1,-1,0.0,1.2,-1.2,22,ITA
f7036e1c,35,2282,25.4,28,4,7,1,60,25,35,58.8,26.5,32.3,22,ITA
f7223718,24,1649,18.3,19,11,5,11,40,27,13,30.6,20.9,9.7,22,ITA
f7c491f1,20,1692,18.8,19,15,1,12,31,32,-1,26.1,28.5,-2.4,22,ITA
f7e2af2c,30,2215,24.6,25,18,5,7,24,41,-17,27.5,36.4,-8.9,22,ITA
f8342731,16,1288,14.3,14,12,2,2,6,19,-13,15.1,17.6,-2.6,22,ITA
f8d41a8c,1,13,0.1,0,0,1,0,0,1,-1,0.0,0.1,-0.1,22,ITA
f91e81c9,11,684,7.6,8,2,3,0,7,12,-5,6.6,11.9,-5.3,22,ITA
f944979d,1,6,0.1,0,0,1,0,0,0,0,0.0,0.0,0.0,22,ITA
f95f49d2,15,636,7.1,5,2,10,6,11,13,-2,10.2,9.8,0.4,22,ITA
f9758dae,36,3035,33.7,35,25,1,0,37,58,-21,34.4,54.9,-20.6,22,ITA
f9c927de,12,443,4.9,4,2,8,4,3,2,1,4.6,7.8,-3.2,22,ITA
fa449bba,16,1001,11.1,11,3,5,1,18,18,0,15.3,18.4,-3.1,22,ITA
fb77bfef,22,1210,13.4,14,8,8,8,18,20,-2,15.7,17.8,-2.2,22,ITA
fc4f85b1,11,818,9.1,9,7,2,0,6,22,-16,6.9,16.0,-9.1,22,ITA
fcb38f57,32,2880,32.0,32,32,0,0,55,21,34,51.4,27.7,23.8,22,ITA
fdcdb521,6,392,4.4,4,4,2,20,4,6,-2,4.2,9.0,-4.8,22,ITA
fdf4b948,10,315,3.5,4,0,6,21,6,8,-2,2.5,6.0,-3.5,22,ITA
fe012aca,27,1434,15.9,15,4,12,0,18,21,-3,24.6,22.4,2.1999999999999997,22,ITA
fec5accc,6,55,0.6,0,0,6,21,1,2,-1,0.4,2.1,-1.7,22,ITA
ff37d2ef,14,699,7.8,10,0,4,0,4,18,-14,6.2,12.3,-6.1,22,ITA
00638016,22,1815,20.2,21,16,1,11,19,35,-16,22.0,26.0,-4.0,22,FRA
007faf7a,25,1229,13.700000000000001,16,0,9,10,17,21,-4,21.1,15.0,6.0,22,FRA
00891164,23,2034,22.6,23,22,0,0,22,42,-20,24.5,32.2,-7.7,22,FRA
00a8d210,37,2448,27.2,28,16,9,0,45,37,8,36.3,32.7,3.6,22,FRA
0118c54c,37,2395,26.6,26,19,11,0,39,24,15,38.6,28.9,9.7,22,FRA
01870104,32,2413,26.8,27,11,5,0,33,44,-11,33.5,33.3,0.2,22,FRA
02bcaf8e,20,716,8.0,5,1,15,5,13,11,2,12.2,12.3,0.09999999999999998,22,FRA
032f894e,25,1651,18.3,20,11,5,0,24,20,4,23.8,18.3,5.5,22,FRA
037f2523,16,453,5.0,5,0,11,5,8,13,-5,6.4,8.6,-2.2,22,FRA
03e91055,29,1732,19.2,22,2,7,1,19,30,-11,22.0,24.1,-2.1,22,FRA
04bb2b06,16,732,8.1,6,2,10,0,13,13,0,11.1,9.8,1.3,22,FRA
0512a60a,1,17,0.2,0,0,1,3,0,0,0,0.1,0.0,0.1,22,FRA
0557ff4f,1,90,1.0,1,1,0,8,0,0,0,0.2,0.8,-0.6,22,FRA
0630eb63,1,18,0.2,0,0,1,1,0,0,0,0.2,0.0,0.2,22,FRA
065dc209,37,2711,30.1,34,7,3,0,26,49,-23,30.6,41.4,-10.7,22,FRA
06c48679,35,3067,34.1,35,29,0,0,56,42,14,43.8,38.2,5.6,22,FRA
06df8256,24,1838,20.4,21,18,3,2,35,22,13,31.6,22.2,9.5,22,FRA
06f33dc8,4,102,1.1,0,0,4,1,2,3,-1,2.4,2.4,-0.1,22,FRA
080de72a,2,5,0.1,0,0,2,7,0,0,0,0.2,0.0,0.2,22,FRA
08511d65,12,801,8.9,8,8,4,2,31,6,25,25.3,7.7,17.5,22,FRA
08f5afaa,17,1530,17.0,17,17,0,15,45,17,28,37.5,18.2,19.4,22,FRA
095e4199,9,409,4.5,4,0,5,1,8,7,1,5.9,7.0,-1.1,22,FRA
0ad37003,16,936,10.4,12,4,4,0,7,25,-18,8.6,17.2,-8.6,22,FRA
0af4dcf0,12,356,4.0,5,0,7,3,11,10,1,8.6,3.5,5.2,22,FRA
0b0cbe5b,34,2436,27.1,28,12,6,0,33,62,-29,27.2,44.0,-16.8,22,FRA
0b2c9aec,20,983,10.9,11,0,9,5,9,11,-2,9.6,11.9,-2.2,22,FRA
0b4d8274,22,886,9.8,7,0,15,0,12,15,-3,14.1,14.7,-0.6,22,FRA
0bb6e193,22,1529,17.0,19,9,3,3,15,34,-19,16.1,23.2,-7.1,22,FRA
0be95d34,22,1003,11.100000000000001,13,0,9,5,15,16,-1,12.0,15.9,-3.9,22,FRA
0bfca6a1,28,1926,21.4,21,16,7,5,34,28,6,25.1,30.6,-5.6,22,FRA
0c2ac3cb,5,220,2.4,3,1,2,9,5,2,3,3.9,2.9,1.1,22,FRA
0cbc8baa,37,3007,33.4,33,31,4,1,44,50,-6,38.5,50.8,-12.3,22,FRA
0d7b6576,33,1786,19.8,21,5,12,2,32,25,7,24.4,27.6,-3.2,22,FRA
0e46fa2f,7,103,1.1,1,0,6,9,0,1,-1,0.9,1.8,-1.0,22,FRA
0e7ccfc4,28,1324,14.7,13,5,15,2,20,21,-1,14.4,22.9,-8.5,22,FRA
0ed063d6,12,341,3.8,2,0,10,4,5,7,-2,6.2,5.9,0.3,22,FRA
0f26fd24,13,370,4.1,3,0,10,6,5,4,1,4.1,2.6,1.6,22,FRA
0f697e02,1,11,0.1,0,0,1,4,0,0,0,0.0,0.0,0.0,22,FRA
0f8418aa,35,2303,25.6,26,13,9,0,43,28,15,38.8,28.4,10.4,22,FRA
0f86995c,14,799,8.9,9,7,5,17,11,16,-5,10.9,9.7,1.2,22,FRA
0ff630d0,38,3337,37.1,37,35,1,0,38,69,-31,44.3,51.5,-7.1,22,FRA
1001ae82,30,2252,25.0,27,11,3,1,29,50,-21,23.7,36.0,-12.3,22,FRA
104b4ad3,20,1409,15.7,16,6,4,1,24,44,-20,20.5,28.1,-7.6,22,FRA
10f0fdd3,36,2332,25.9,26,14,10,0,35,31,4,35.5,30.6,4.9,22,FRA
114bbdee,14,985,10.9,11,9,3,12,17,9,8,16.7,13.4,3.3,22,FRA
12bd0579,1,45,0.5,1,0,0,1,1,1,0,0.5,1.0,-0.5,22,FRA
1467af0d,24,1937,21.5,23,12,1,0,47,22,25,46.5,23.8,22.7,22,FRA
148e136f,5,313,3.5,3,1,2,0,4,8,-4,5.2,6.0,-0.7,22,FRA
14d2670e,12,610,6.8,5,4,7,12,5,15,-10,5.6,14.8,-9.2,22,FRA
14df1d7f,9,610,6.8,8,2,1,6,5,15,-10,5.8,15.6,-9.8,22,FRA
1545cf15,36,3220,35.8,36,33,0,1,32,60,-28,38.0,48.7,-10.6,22,FRA
15944afd,18,790,8.8,8,3,10,16,15,9,6,12.4,8.4,4.0,22,FRA
165a2e40,31,2211,24.6,25,12,6,1,31,27,4,33.2,23.1,10.2,22,FRA
16aa7d4c,32,2686,29.8,31,29,1,0,41,38,3,34.2,41.3,-7.0,22,FRA
1787195f,1,16,0.2,0,0,1,3,0,1,-1,0.1,0.3,-0.2,22,FRA
1880614f,32,2200,24.4,25,10,7,1,40,22,18,39.9,26.5,13.3,22,FRA
19053e31,30,1948,21.6,24,10,6,7,33,24,9,34.2,22.1,12.1,22,FRA
1956b948,30,1488,16.5,13,3,17,1,15,32,-17,18.8,23.4,-4.5,22,FRA
199ff86e,5,67,0.7,0,0,5,5,0,1,-1,0.4,1.2,-0.7,22,FRA
19a12bed,11,544,6.0,7,2,4,5,7,4,3,9.4,4.0,5.4,22,FRA
19ba6c6d,35,2312,25.7,25,14,10,0,35,38,-3,29.7,39.6,-9.9,22,FRA
19cda00b,26,1645,18.3,19,4,7,3,39,13,26,39.4,18.4,21.0,22,FRA
1a066e69,24,1857,20.6,20,17,4,3,18,33,-15,20.6,34.4,-13.7,22,FRA
1a248246,13,825,9.2,11,1,2,1,15,16,-1,12.7,14.0,-1.3,22,FRA
1a6b7ea4,36,2729,30.3,31,19,5,0,42,29,13,44.4,31.9,12.5,22,FRA
1a992676,18,548,6.1,5,0,13,3,20,5,15,12.9,5.6,7.3,22,FRA
1bfe34dc,3,154,1.7,1,1,2,6,2,4,-2,2.0,2.5,-0.5,22,FRA
1d2d5cc8,9,810,9.0,9,9,0,28,18,7,11,14.6,7.1,7.6,22,FRA
1ddbc7ca,33,2589,28.8,30,23,3,2,38,28,10,42.3,34.0,8.4,22,FRA
1df4a109,18,405,4.5,3,1,15,13,5,9,-4,5.5,8.0,-2.4,22,FRA
1e93fc5d,1,10,0.1,0,0,1,4,0,0,0,0.0,0.0,0.0,22,FRA
1ec7e1c5,17,1126,12.5,13,8,4,15,20,9,11,22.1,15.6,6.5,22,FRA
1f6298f2,1,1,0.0,0,0,1,15,0,0,0,0.2,0.0,0.1,22,FRA
2054d037,22,777,8.6,7,1,15,4,9,17,-8,11.4,12.0,-0.6,22,FRA
20b9f052,29,2610,29.0,29,29,0,7,45,31,14,43.6,32.0,11.6,22,FRA
20e73fac,38,3193,35.5,38,15,0,0,70,34,36,56.7,37.7,19.0,22,FRA
2180c761,1,5,0.1,0,0,1,10,0,0,0,0.0,0.0,0.0,22,FRA
22721b88,10,541,6.0,6,1,4,19,10,4,6,8.9,3.6999999999999997,5.0,22,FRA
2306bfde,1,6,0.1,0,0,1,1,0,0,0,0.0,0.0,0.0,22,FRA
2321ea6e,34,3060,34.0,34,34,0,0,33,54,-21,37.2,45.9,-8.7,22,FRA
23c63b7f,28,1024,11.4,11,0,17,3,15,16,-1,15.8,12.7,3.1,22,FRA
2434f24a,25,2250,25.0,25,25,0,4,34,62,-28,30.2,47.8,-17.6,22,FRA
243f4a0b,16,1147,12.7,13,8,3,2,16,30,-14,11.8,22.3,-10.5,22,FRA
249ac66d,34,2789,31.0,31,27,3,0,31,50,-19,35.7,38.6,-3.0,22,FRA
24eb7ed6,30,1533,17.0,16,7,14,5,23,28,-5,16.4,21.1,-4.7,22,FRA
25146df0,7,451,5.0,5,4,2,10,7,7,0,5.7,6.5,-0.8,22,FRA
2515040a,2,11,0.1,0,0,2,7,0,0,0,0.0,0.4,-0.4,22,FRA
25749008,29,1759,19.5,22,4,7,0,22,31,-9,20.6,26.7,-6.1,22,FRA
2591b066,14,432,4.8,4,0,10,3,5,5,0,4.9,5.1,-0.2,22,FRA
26777636,36,2260,25.1,25,10,11,1,33,59,-26,26.6,43.4,-16.8,22,FRA
2677a1de,30,2225,24.7,26,10,4,0,28,46,-18,26.6,34.9,-8.3,22,FRA
2693f6bc,3,5,0.1,0,0,3,8,0,0,0,0.0,0.0,0.0,22,FRA
275e2c51,30,2563,28.5,29,25,1,2,32,39,-7,35.7,40.0,-4.2,22,FRA
279ddf6a,37,2937,32.6,33,24,4,0,35,43,-8,34.1,39.9,-5.800000000000001,22,FRA
288e1e13,31,2735,30.4,31,28,0,0,66,29,37,49.4,33.1,16.2,22,FRA
28a65a2c,7,630,7.0,7,7,0,18,8,9,-1,9.2,8.6,0.7,22,FRA
28dabd43,32,2880,32.0,32,32,0,0,44,56,-12,35.2,43.8,-8.700000000000001,22,FRA
295ba708,13,907,10.1,11,2,2,10,16,19,-3,9.3,16.2,-6.8,22,FRA
29939a1d,15,525,5.8,5,0,10,0,8,10,-2,10.1,5.9,4.2,22,FRA
29aee77c,8,350,3.9,4,0,4,5,0,1,-1,2.6,3.6,-1.1,22,FRA
29c02c9f,3,165,1.8,2,0,1,17,3,2,1,3.2,2.0,1.2,22,FRA
2a00c6c0,11,231,2.6,1,0,10,7,2,3,-1,3.4,4.1,-0.6,22,FRA
2a657da0,4,192,2.1,3,0,1,3,3,4,-1,1.5,3.7,-2.1,22,FRA
2acf0cd7,24,1885,20.9,20,17,4,0,28,24,4,21.9,25.3,-3.5,22,FRA
2aeb43f1,2,157,1.7,2,1,0,18,3,4,-1,1.6,3.8,-2.3,22,FRA
2b1bed19,31,2310,25.7,26,19,5,3,32,37,-5,24.9,39.9,-14.9,22,FRA
2b471f99,32,1967,21.9,24,8,8,1,31,25,6,33.2,31.0,2.3,22,FRA
2b5a35e5,5,43,0.5,0,0,5,4,0,2,-2,0.3,1.6,-1.3,22,FRA
2c127b6f,13,1105,12.3,11,11,2,23,24,15,9,17.8,12.4,5.4,22,FRA
2d22cea7,35,2477,27.5,28,5,7,0,26,40,-14,30.2,34.4,-4.1,22,FRA
2d70dbe5,22,1980,22.0,22,22,0,16,18,38,-20,22.6,31.4,-8.8,22,FRA
2db2fd7b,24,1622,18.0,19,9,5,4,33,28,5,33.6,29.5,4.0,22,FRA
2f9e4435,25,812,9.0,7,3,18,1,7,18,-11,12.0,10.9,1.1,22,FRA
3010aefb,24,930,10.3,9,1,15,9,8,10,-2,11.2,14.3,-3.1,22,FRA
30144daa,30,2299,25.5,27,7,3,1,31,37,-6,26.2,36.0,-9.8,22,FRA
30af8b93,34,2662,29.6,31,20,3,3,53,31,22,47.9,32.0,15.8,22,FRA
31626657,34,2956,32.8,34,26,0,0,27,59,-32,35.5,45.7,-10.2,22,FRA
316e70c7,3,40,0.4,0,0,3,5,1,1,0,0.3,0.6,-0.4,22,FRA
3189f61a,18,1515,16.8,18,10,0,0,16,24,-8,18.2,23.3,-5.1,22,FRA
31a62dc7,32,2696,30.0,30,27,2,3,38,38,0,41.0,32.5,8.6,22,FRA
321a71a7,12,860,9.6,9,9,3,4,17,9,8,13.8,10.9,2.9,22,FRA
32c2d95f,34,2983,33.1,34,33,0,0,38,41,-3,31.8,41.3,-9.5,22,FRA
33508c78,2,38,0.4,0,0,2,3,0,1,-1,0.3,0.4,-0.1,22,FRA
34a0f5ff,32,1732,19.2,19,2,13,2,28,40,-12,25.3,33.2,-7.9,22,FRA
34a88e3e,13,481,5.3,5,1,8,4,7,8,-1,5.3,6.2,-0.9,22,FRA
3544641e,26,905,10.1,8,1,18,7,17,22,-5,15.3,17.2,-1.9,22,FRA
3681cfff,23,1932,21.5,23,16,0,2,25,31,-6,23.3,33.8,-10.5,22,FRA
3708e9fa,27,1502,16.7,17,2,10,1,30,14,16,25.7,15.1,10.5,22,FRA
375622c5,34,2911,32.3,33,23,1,0,45,49,-4,35.9,47.2,-11.3,22,FRA
37d04e90,31,1772,19.7,21,3,10,7,24,21,3,20.2,22.4,-2.2,22,FRA
380a15e2,11,833,9.3,9,9,2,25,14,20,-6,12.8,15.1,-2.4,22,FRA
3814b753,12,848,9.4,9,6,3,1,6,15,-9,8.5,16.8,-8.3,22,FRA
381d7d54,7,156,1.7,1,0,6,7,1,3,-2,0.9,2.3,-1.4,22,FRA
3935e52e,14,440,4.9,6,0,8,3,9,7,2,7.9,3.9,4.1,22,FRA
397ba086,14,396,4.4,4,0,10,1,2,9,-7,5.6,7.6,-2.0,22,FRA
3befc2b6,36,3146,35.0,36,32,0,0,51,44,7,41.9,46.6,-4.8,22,FRA
3c6bbbab,19,1586,17.6,18,17,1,0,21,34,-13,13.6,25.7,-12.1,22,FRA
3cc4bb19,11,973,10.8,11,9,0,0,5,18,-13,6.7,17.9,-11.3,22,FRA
3cd7820a,31,1804,20.0,20,8,11,5,26,43,-17,20.3,30.0,-9.7,22,FRA
3d214e5f,38,3420,38.0,38,38,0,0,49,57,-8,43.4,56.3,-12.8,22,FRA
3d738df0,2,22,0.2,0,0,2,15,0,1,-1,1.0,0.3,0.7,22,FRA
3dd738a1,28,2140,23.8,22,19,6,8,44,24,20,37.2,25.0,12.2,22,FRA
3e092724,24,1490,16.6,17,6,7,5,29,24,5,22.8,23.5,-0.7,22,FRA
3eaf8817,14,523,5.8,5,0,9,2,6,5,1,6.8,6.2,0.6,22,FRA
3ef0fa48,32,1905,21.2,24,1,8,2,33,18,15,32.1,20.2,11.9,22,FRA
3f034750,21,1890,21.0,21,21,0,11,28,28,0,29.5,22.6,6.9,22,FRA
3f3a2cba,1,90,1.0,1,1,0,8,1,1,0,0.8,1.4,-0.7,22,FRA
40221fa7,24,1011,11.2,11,3,13,12,20,21,-1,12.9,17.6,-4.7,22,FRA
40774c6b,25,975,10.8,11,1,14,4,22,8,14,20.5,9.9,10.6,22,FRA
42276181,35,2385,26.5,28,10,7,0,39,30,9,37.1,29.6,7.5,22,FRA
42dcf26d,6,451,5.0,5,5,1,16,7,4,3,6.8,4.1,2.6,22,FRA
42eaa028,18,1062,11.8,13,1,5,0,14,15,-1,17.1,11.4,5.7,22,FRA
42fd9c7f,35,3023,33.6,34,24,1,0,85,30,55,69.9,33.7,36.2,22,FRA
433dc9a2,15,958,10.6,12,3,3,7,23,10,13,22.2,11.7,10.5,22,FRA
436a9dd0,19,1091,12.1,12,5,7,6,28,11,17,21.1,11.3,9.8,22,FRA
43b78598,24,1027,11.4,10,6,14,5,26,13,13,20.7,12.6,8.1,22,FRA
43e7a164,31,2694,29.9,30,27,1,1,43,35,8,40.9,36.0,4.9,22,FRA
4534a352,34,2796,31.1,31,28,3,3,73,35,38,52.5,33.3,19.2,22,FRA
462475ed,36,2738,30.4,31,20,5,0,46,36,10,44.6,34.1,10.5,22,FRA
46359159,24,2008,22.3,24,20,0,0,29,27,2,27.4,26.4,1.1,22,FRA
46750e9c,31,1418,15.8,18,2,13,7,17,16,1,13.5,16.9,-3.4,22,FRA
468fdbad,29,2105,23.4,24,12,5,2,52,25,27,40.1,26.6,13.5,22,FRA
46907171,15,327,3.6,2,1,13,14,8,5,3,5.7,4.3,1.5,22,FRA
469d3d84,1,45,0.5,1,0,0,0,0,0,0,0.5,0.3,0.2,22,FRA
46a7b605,1,5,0.1,0,0,1,4,0,0,0,0.0,0.1,-0.1,22,FRA
46faabfa,26,1582,17.6,20,6,6,8,19,28,-9,12.9,24.5,-11.6,22,FRA
4788cb6b,1,1,0.0,0,0,1,1,0,1,-1,0.2,0.0,0.2,22,FRA
47af88b8,15,1002,11.1,12,10,3,2,19,18,1,18.0,20.2,-2.2,22,FRA
47c609d5,21,1194,13.3,15,2,6,0,17,14,3,12.4,16.7,-4.2,22,FRA
48b28bfd,25,1004,11.2,11,0,14,6,17,12,5,16.5,12.7,3.7,22,FRA
49070d66,31,2502,27.8,29,22,2,4,43,34,9,40.3,33.2,7.1,22,FRA
49136c42,26,2135,23.7,24,18,2,0,26,26,0,21.7,27.1,-5.4,22,FRA
4914ed4a,13,713,7.9,9,5,4,13,7,16,-9,8.2,10.2,-2.0,22,FRA
4937a9f7,10,622,6.9,6,4,4,18,12,20,-8,6.8,12.2,-5.4,22,FRA
49712367,9,201,2.2,2,0,7,18,0,6,-6,1.8,3.7,-1.9,22,FRA
4a987ffa,16,518,5.8,4,0,12,1,5,10,-5,4.9,9.6,-4.7,22,FRA
4ade359f,1,1,0.0,0,0,1,9,0,0,0,0.0,0.0,0.0,22,FRA
4b77bb89,16,785,8.7,9,0,7,4,14,9,5,12.8,7.6,5.2,22,FRA
4b96c347,36,2929,32.5,35,13,1,0,40,48,-8,40.1,42.6,-2.4,22,FRA
4bf69118,29,2002,22.2,22,17,7,3,34,53,-19,27.4,40.4,-13.0,22,FRA
4c3a6744,27,1868,20.8,24,5,3,1,25,23,2,25.0,21.0,4.0,22,FRA
4c4ffacc,1,33,0.4,0,0,1,0,0,2,-2,0.3,0.6,-0.3,22,FRA
4c5b714f,17,949,10.5,12,6,5,15,17,13,4,17.1,10.6,6.5,22,FRA
4e0afc5d,34,2334,25.9,27,14,7,3,35,39,-4,31.2,40.2,-9.1,22,FRA
4e47507a,28,1457,16.2,16,1,12,1,15,23,-8,15.1,20.1,-5.0,22,FRA
4e7db402,38,3420,38.0,38,38,0,0,55,48,7,45.5,52.7,-7.2,22,FRA
4eb0686f,1,19,0.2,0,0,1,1,0,2,-2,0.0,1.4,-1.4,22,FRA
4f093689,15,290,3.2,1,0,14,4,6,6,0,5.1,3.8,1.3,22,FRA
4f255115,35,2929,32.5,33,29,2,0,58,33,25,51.6,33.7,18.0,22,FRA
5046b7d4,29,1099,12.2,12,0,17,2,15,16,-1,16.3,14.1,2.2,22,FRA
5065d67d,2,180,2.0,2,2,0,17,2,6,-4,1.1,6.0,-4.9,22,FRA
507d7569,1,2,0.0,0,0,1,0,0,1,-1,0.2,0.1,0.1,22,FRA
50ac8941,16,560,6.2,7,0,9,16,6,10,-4,7.9,7.9,0.0,22,FRA
5148dcc5,37,2779,30.9,37,7,0,0,68,27,41,51.2,32.1,19.2,22,FRA
5167c97e,20,1076,12.0,12,5,8,6,16,20,-4,13.1,14.2,-1.1,22,FRA
51b41c5c,20,649,7.2,5,4,15,8,12,5,7,8.6,10.2,-1.6,22,FRA
51c30111,32,2186,24.3,27,11,5,4,43,25,18,35.3,25.5,9.8,22,FRA
51dbeea9,27,1513,16.8,16,11,11,8,42,17,25,30.6,18.8,11.8,22,FRA
5219ab4a,37,3046,33.8,35,15,2,0,51,42,9,42.4,36.7,5.7,22,FRA
5313ed43,38,3357,37.3,38,31,0,0,61,48,13,49.6,42.0,7.6,22,FRA
5314e067,4,158,1.8,0,0,4,13,0,2,-2,1.6,3.2,-1.6,22,FRA
53f6306f,6,83,0.9,0,0,6,4,2,5,-3,1.7,3.7,-2.1,22,FRA
5413ef36,3,200,2.2,2,1,1,7,5,3,2,2.6,3.8,-1.2,22,FRA
542cc80f,15,847,9.4,9,4,6,5,13,15,-2,9.9,16.7,-6.8,22,FRA
546bb36e,12,874,9.7,11,6,1,3,7,11,-4,8.9,11.8,-2.9,22,FRA
54d51e22,21,1117,12.4,13,3,8,0,14,21,-7,12.8,16.9,-4.1,22,FRA
562a4799,30,2665,29.6,30,29,0,0,30,49,-19,23.0,47.3,-24.3,22,FRA
5630a6e0,5,67,0.7,0,0,5,2,2,2,0,2.6,1.0,1.6,22,FRA
574aa9ec,1,90,1.0,1,1,0,0,1,1,0,2.1,0.7,1.4,22,FRA
57a46f3f,13,238,2.6,2,0,11,20,8,3,5,5.7,2.0,3.8,22,FRA
58ad9383,38,3420,38.0,38,38,0,0,43,44,-1,37.7,46.4,-8.7,22,FRA
58ae47b2,31,2592,28.8,28,22,3,0,45,30,15,45.3,29.3,16.0,22,FRA
59948ef7,33,1464,16.3,16,1,17,5,25,21,4,19.5,22.3,-2.7,22,FRA
59d93937,1,14,0.2,0,0,1,5,0,1,-1,0.4,0.3,0.1,22,FRA
5b146df3,31,2263,25.1,23,23,8,6,34,41,-7,28.8,35.1,-6.3,22,FRA
5b1bf5e3,29,1673,18.6,20,1,9,1,27,22,5,24.4,18.1,6.3,22,FRA
5b3cfa12,1,2,0.0,0,0,1,5,0,0,0,0.1,0.0,0.1,22,FRA
5b479568,31,960,10.7,7,0,24,1,18,16,2,16.4,13.7,2.7,22,FRA
5b92d896,24,1273,14.1,15,5,9,0,21,14,7,15.3,14.8,0.5,22,FRA
5b9512c5,24,2095,23.3,24,22,0,7,42,29,13,42.9,31.3,11.6,22,FRA
5c42e7ce,2,15,0.2,0,0,2,6,0,0,0,0.1,0.0,0.0,22,FRA
5c61496e,8,96,1.1,1,0,7,11,1,0,1,1.2,0.9,0.4,22,FRA
5c7895a0,4,16,0.2,0,0,4,9,1,0,1,0.6,0.6,0.0,22,FRA
5c9ac7f0,6,190,2.1,2,0,4,5,3,2,1,2.3,2.6,-0.3,22,FRA
5cdddffa,11,701,7.8,7,2,4,1,10,10,0,12.4,8.5,3.9,22,FRA
5ceba7fc,30,2296,25.5,26,15,4,0,49,32,17,46.4,34.8,11.7,22,FRA
5d0e0a1f,30,1639,18.2,18,9,12,6,42,24,18,30.7,22.4,8.2,22,FRA
5d8d7454,33,2516,28.0,28,19,5,0,47,30,17,40.6,30.0,10.6,22,FRA
5e080f73,32,1334,14.8,13,0,19,3,18,30,-12,17.6,24.1,-6.5,22,FRA
5e22e2a4,34,2518,28.0,28,23,6,1,62,36,26,46.2,32.4,13.8,22,FRA
5ea8ef20,38,3152,35.0,35,30,3,0,61,36,25,54.3,36.5,17.8,22,FRA
5ee6e943,19,1542,17.1,17,17,2,15,16,30,-14,12.9,31.1,-18.2,22,FRA
5f011e05,24,1953,21.7,22,18,2,1,28,47,-19,25.7,37.1,-11.3,22,FRA
5f0241b2,1,23,0.3,0,0,1,6,2,1,1,0.3,0.3,0.0,22,FRA
5f26e0c5,24,1661,18.5,17,15,7,3,16,40,-24,19.7,30.5,-10.8,22,FRA
5f3eaaf5,30,2332,25.9,29,7,1,2,34,28,6,31.0,32.5,-1.5,22,FRA
6043997c,34,2984,33.2,33,33,1,0,54,33,21,50.4,36.6,13.7,22,FRA
60740e70,2,70,0.8,1,0,1,0,1,2,-1,0.5,1.2,-0.7,22,FRA
60f58477,17,573,6.4,5,0,12,10,5,8,-3,5.3,8.3,-3.1,22,FRA
6191093d,35,2961,32.9,35,18,0,0,48,41,7,39.3,44.1,-4.7,22,FRA
62124972,24,2116,23.5,23,23,1,14,20,36,-16,27.0,30.2,-3.2,22,FRA
62e02107,5,95,1.1,1,1,4,4,2,1,1,2.5,0.7,1.8,22,FRA
6388e356,9,667,7.4,8,7,1,0,10,8,2,9.0,8.9,0.1,22,FRA
639ca1cf,15,579,6.4,5,2,10,3,7,15,-8,7.3,8.9,-1.6,22,FRA
6421ec64,11,679,7.5,9,1,2,7,13,7,6,10.6,9.7,0.9,22,FRA
642f9f79,3,11,0.1,0,0,3,4,0,0,0,0.1,0.2,-0.1,22,FRA
645a3363,24,954,10.6,12,0,12,13,17,13,4,13.9,11.5,2.4,22,FRA
6481421d,4,86,1.0,0,0,4,3,4,1,3,2.7,1.3,1.5,22,FRA
64ba07c0,30,2548,28.3,29,20,1,2,38,44,-6,35.0,41.5,-6.4,22,FRA
64c14d49,26,1642,18.2,19,9,7,7,16,23,-7,17.0,27.5,-10.5,22,FRA
64f69877,34,2436,27.1,29,10,5,0,51,27,24,46.7,29.4,17.3,22,FRA
654f49ca,23,322,3.6,1,1,22,10,2,9,-7,5.3,8.7,-3.3,22,FRA
65bbfba3,11,692,7.7,7,7,4,1,12,13,-1,13.5,8.9,4.6,22,FRA
6605d143,31,1541,17.1,16,6,15,2,28,19,9,27.0,20.8,6.2,22,FRA
667b65da,15,1197,13.3,15,12,0,18,13,27,-14,13.2,19.4,-6.1,22,FRA
6690ef25,1,16,0.2,0,0,1,2,0,0,0,0.1,0.2,-0.1,22,FRA
6751b938,1,1,0.0,0,0,1,1,0,0,0,0.0,0.0,0.0,22,FRA
6763f716,1,13,0.1,0,0,1,4,1,0,1,0.3,0.3,0.0,22,FRA
677ee102,17,618,6.9,6,2,11,19,14,15,-1,10.2,8.6,1.5,22,FRA
68a26d51,31,2637,29.3,31,21,0,0,41,33,8,33.5,36.2,-2.7,22,FRA
69384e5d,22,1851,20.6,22,12,0,0,47,23,24,42.8,21.9,20.9,22,FRA
6993927b,30,2429,27.0,29,23,1,5,30,45,-15,32.9,35.4,-2.5,22,FRA
6a04bb7c,5,34,0.4,0,0,5,2,0,1,-1,0.4,0.6,-0.3,22,FRA
6a2b9aee,9,135,1.5,1,0,8,8,2,3,-1,1.0,2.9,-1.9,22,FRA
6a827d8e,17,1140,12.7,13,6,4,4,20,12,8,19.3,11.4,7.9,22,FRA
6b2c894b,28,2418,26.9,28,24,0,1,28,26,2,25.4,29.5,-4.1,22,FRA
6ba71da5,19,1619,18.0,18,16,1,2,17,26,-9,16.3,23.3,-7.1,22,FRA
6bde367b,29,2414,26.8,28,20,1,0,39,40,-1,30.8,36.4,-5.6,22,FRA
6d075c67,2,17,0.2,0,0,2,7,0,1,-1,0.4,1.1,-0.7,22,FRA
6d0fe035,4,109,1.2,1,0,3,20,1,1,0,2.4,1.6,0.8,22,FRA
6de23ab0,11,579,6.4,5,4,6,6,10,11,-1,9.9,10.1,-0.2,22,FRA
6e33125f,33,2790,31.0,32,28,1,2,50,36,14,39.5,32.7,6.8,22,FRA
6f5ec8bb,31,2593,28.8,30,25,1,1,48,36,12,37.8,30.8,6.9,22,FRA
6f806d99,36,2194,24.4,25,10,11,0,20,41,-21,23.9,33.7,-9.8,22,FRA
706a60e1,1,34,0.4,0,0,1,1,1,0,1,0.4,0.4,0.1,22,FRA
70c52749,31,1829,20.3,20,13,11,3,46,18,28,34.6,21.9,12.7,22,FRA
7120a04d,9,583,6.5,7,3,2,0,19,11,8,13.3,10.3,3.0,22,FRA
7155e3e1,28,1528,17.0,17,9,11,5,31,17,14,26.4,18.3,8.1,22,FRA
72c812f3,26,1641,18.2,18,9,8,3,37,19,18,35.0,21.4,13.6,22,FRA
741418c3,10,209,2.3,0,0,10,8,8,3,5,7.3,3.0,4.3,22,FRA
743fd71f,3,86,1.0,0,0,3,1,0,0,0,0.6,1.0,-0.4,22,FRA
745ca0a3,35,2684,29.799999999999997,29,20,6,0,46,41,5,42.7,37.8,4.9,22,FRA
74733221,1,90,1.0,1,1,0,23,0,2,-2,0.6,0.5,0.1,22,FRA
74dc806c,7,314,3.5,4,0,3,2,4,6,-2,4.5,6.7,-2.2,22,FRA
75186a6a,2,57,0.6,0,0,2,6,0,1,-1,0.1,0.9,-0.8,22,FRA
7587446d,8,352,3.9,2,1,6,3,4,5,-1,3.4,4.9,-1.5,22,FRA
75a63397,26,1048,11.6,10,0,16,5,14,24,-10,9.4,17.2,-7.7,22,FRA
767212e6,16,489,5.4,4,3,12,18,8,8,0,6.0,9.9,-3.9,22,FRA
76a4233b,10,664,7.4,8,3,2,1,3,14,-11,4.6,14.7,-10.0,22,FRA
779847d6,30,2447,27.2,29,25,1,1,39,31,8,32.7,36.2,-3.5,22,FRA
7909ffa4,36,2935,32.6,33,22,3,1,42,48,-6,35.8,46.8,-11.0,22,FRA
792a9d41,7,436,4.8,6,2,1,5,3,11,-8,3.0,11.0,-8.0,22,FRA
796b1c41,23,927,10.3,9,0,14,3,10,25,-15,11.2,15.5,-4.3,22,FRA
79ab7593,28,497,5.5,3,0,25,5,9,12,-3,8.4,9.0,-0.7,22,FRA
79b2399c,30,1193,13.3,12,2,18,5,16,15,1,17.2,16.7,0.5,22,FRA
7a42d0df,35,2480,27.6,28,11,7,1,48,36,12,35.0,31.5,3.5,22,FRA
7a72e960,1,4,0.0,0,0,1,0,0,1,-1,0.0,0.3,-0.2,22,FRA
7b082ec2,18,1296,14.4,13,10,5,1,15,19,-4,14.9,19.5,-4.6,22,FRA
7b9a9e25,36,1874,20.8,20,3,16,0,26,41,-15,20.5,31.5,-11.0,22,FRA
7b9c2d84,4,143,1.6,1,0,3,0,2,4,-2,1.3,3.5,-2.2,22,FRA
7c3ed041,17,950,10.6,10,7,7,8,21,11,10,15.6,10.7,4.9,22,FRA
7cab69b5,15,1202,13.4,15,10,0,6,6,26,-20,10.0,20.3,-10.3,22,FRA
7cc00776,21,447,5.0,4,0,17,3,6,6,0,7.9,4.2,3.7,22,FRA
7cdda3bf,38,3070,34.1,36,18,2,0,74,38,36,55.099999999999994,36.4,18.8,22,FRA
7d08063d,15,506,5.6,3,0,12,11,10,5,5,11.5,4.9,6.6,22,FRA
7d937aa1,4,38,0.4,0,0,4,7,1,1,0,0.5,1.1,-0.6,22,FRA
7d9397f8,36,1901,21.1,20,9,16,1,23,19,4,30.0,18.7,11.3,22,FRA
7d9b37bf,17,255,2.8,1,0,16,10,7,5,2,5.6,3.1,2.5,22,FRA
7d9f3d69,3,73,0.8,0,0,3,1,1,1,0,0.8,1.3,-0.5,22,FRA
7e82a78f,35,2630,29.2,32,12,3,1,31,44,-13,29.0,43.0,-14.1,22,FRA
7ef972c3,24,1293,14.4,14,9,10,13,22,14,8,19.6,18.1,1.6,22,FRA
7f622eef,4,23,0.3,0,0,4,19,0,1,-1,0.1,0.5,-0.4,22,FRA
7fecbcdb,10,458,5.1,4,3,6,13,4,9,-5,4.6,10.5,-5.9,22,FRA
7ffaf233,9,153,1.7,0,0,9,2,0,2,-2,2.5,1.8,0.7,22,FRA
80556f08,3,209,2.3,3,0,0,0,3,3,0,1.3,3.5,-2.3,22,FRA
8104e41e,8,285,3.2,3,0,5,0,4,5,-1,4.3,3.5,0.8,22,FRA
810edef9,2,3,0.0,0,0,2,4,0,0,0,0.0,0.2,-0.2,22,FRA
8197a269,2,15,0.2,0,0,2,2,0,0,0,0.4,0.0,0.4,22,FRA
81ac108d,3,96,1.1,1,0,2,7,0,3,-3,0.3,1.8,-1.5,22,FRA
822d51d7,33,2190,24.3,23,19,10,2,44,27,17,37.5,30.0,7.5,22,FRA
82464ce3,31,2462,27.4,29,19,2,1,26,44,-18,28.9,36.2,-7.3,22,FRA
82518f62,20,1634,18.2,19,11,1,0,27,18,9,30.7,25.7,5.0,22,FRA
828657ff,32,1359,15.1,11,6,21,4,23,17,6,19.7,16.3,3.4,22,FRA
829aa60c,7,56,0.6,0,0,7,13,2,1,1,1.1,0.4,0.7,22,FRA
83299cc0,32,1633,18.1,16,10,16,1,19,34,-15,19.3,29.1,-9.7,22,FRA
8332db56,29,2316,25.7,26,22,3,1,24,40,-16,19.0,39.4,-20.4,22,FRA
834b5c4c,37,3330,37.0,37,37,0,0,58,43,15,53.0,43.2,9.8,22,FRA
84d94b91,34,2248,25.0,26,12,8,1,26,39,-13,29.5,29.7,-0.1,22,FRA
85613cf0,23,1416,15.7,15,5,8,3,20,14,6,20.3,18.5,1.7,22,FRA
8577e60a,35,3073,34.1,34,30,1,0,36,68,-32,33.4,51.2,-17.7,22,FRA
86383d0e,15,932,10.4,11,1,4,0,14,12,2,11.8,16.1,-4.4,22,FRA
868eaba0,32,2746,30.5,32,26,0,0,31,48,-17,39.6,39.6,0.1,22,FRA
86a2ba20,34,2968,33.0,34,26,0,1,34,46,-12,33.9,42.3,-8.5,22,FRA
87935cf3,29,2575,28.6,29,26,0,0,39,42,-3,34.8,39.4,-4.6,22,FRA
87e9c7cd,18,696,7.7,5,3,13,16,3,16,-13,5.2,16.0,-10.8,22,FRA
8827bf46,35,2544,28.3,29,16,6,1,46,33,13,43.5,26.6,16.9,22,FRA
8846a40f,24,1040,11.6,11,2,13,9,15,21,-6,15.4,16.6,-1.2,22,FRA
88c4d190,32,1446,16.1,16,2,16,1,19,21,-2,18.0,24.1,-6.0,22,FRA
88f130ed,36,3115,34.6,35,33,1,1,49,35,14,51.8,39.5,12.2,22,FRA
890bc029,1,17,0.2,0,0,1,2,0,0,0,0.0,0.0,0.0,22,FRA
8a2248b4,37,3330,37.0,37,37,0,0,52,35,17,54.6,40.9,13.7,22,FRA
8a53d24b,14,814,9.0,11,1,3,1,10,15,-5,11.9,11.4,0.4,22,FRA
8bbe2df5,15,417,4.6,2,2,13,16,7,6,1,8.1,5.2,2.9,22,FRA
8bc8829a,27,1868,20.8,21,13,6,4,27,32,-5,27.5,31.5,-3.9,22,FRA
8ca9415f,1,9,0.1,0,0,1,8,0,1,-1,0.0,1.0,-1.0,22,FRA
8dbff17c,17,1171,13.0,14,8,3,2,8,21,-13,10.3,19.2,-8.9,22,FRA
8e697a8f,3,205,2.3,2,2,1,0,4,0,4,4.0,1.6,2.4,22,FRA
8eec784d,29,1616,18.0,17,9,12,1,23,29,-6,25.4,21.3,4.1,22,FRA
8eef18aa,12,661,7.3,8,4,4,14,11,11,0,6.7,11.7,-5.0,22,FRA
8f325097,34,2770,30.8,32,22,2,3,40,53,-13,34.9,43.9,-9.0,22,FRA
8f7e6783,24,1073,11.9,11,1,13,8,14,8,6,19.9,14.9,5.0,22,FRA
8fd9996f,27,2038,22.6,22,19,5,9,57,24,33,48.7,25.0,23.7,22,FRA
9004f318,3,269,3.0,3,2,0,15,0,5,-5,1.9,3.7,-1.8,22,FRA
90eb507d,29,2235,24.8,26,16,3,0,24,28,-4,24.0,32.2,-8.3,22,FRA
90f87966,38,3420,38.0,38,38,0,0,48,48,0,50.5,39.9,10.6,22,FRA
90fcf472,21,654,7.3,7,0,14,3,15,7,8,14.0,6.5,7.5,22,FRA
91f2da4c,16,409,4.5,3,0,13,15,2,6,-4,4.1,5.4,-1.3,22,FRA
9226aa22,8,352,3.9,2,1,6,10,5,6,-1,4.0,5.6,-1.6,22,FRA
923f4dda,37,1016,11.3,7,0,30,1,31,14,17,22.5,13.8,8.7,22,FRA
9260926b,10,812,9.0,10,7,0,1,3,13,-10,5.4,13.2,-7.8,22,FRA
928a4a61,8,364,4.0,4,0,4,0,4,8,-4,6.1,5.4,0.6,22,FRA
92b56413,25,1077,12.0,12,2,13,3,13,13,0,12.5,14.7,-2.2,22,FRA
93b8f9f4,9,205,2.3,1,0,8,7,0,3,-3,2.0,4.4,-2.4,22,FRA
942b4f90,37,2529,28.1,29,7,8,0,50,28,22,42.9,29.2,13.6,22,FRA
94b442c0,1,3,0.0,0,0,1,1,0,0,0,0.0,0.0,0.0,22,FRA
94f8d10c,26,2057,22.9,24,17,2,9,33,25,8,32.3,26.3,6.0,22,FRA
95192fe4,7,132,1.5,1,0,6,21,1,0,1,1.3,0.6,0.7,22,FRA
95bb6ddc,10,316,3.5,4,0,6,20,9,1,8,5.8,2.5,3.3,22,FRA
96f4ebc0,10,229,2.5,2,0,8,3,1,4,-3,4.7,4.0,0.7,22,FRA
96fcd380,1,8,0.1,0,0,1,3,0,0,0,0.1,0.0,0.1,22,FRA
972aeb2a,36,3240,36.0,36,36,0,1,59,38,21,55.1,37.5,17.6,22,FRA
9744ff80,2,22,0.2,0,0,2,0,1,0,1,1.0,0.5,0.5,22,FRA
97bfa797,7,84,0.9,0,0,7,7,1,1,0,0.5,1.2,-0.7,22,FRA
9836e892,22,544,6.0,4,0,18,6,9,13,-4,6.8,11.7,-4.9,22,FRA
9980269a,21,850,9.4,9,0,12,7,19,17,2,17.6,15.0,2.6,22,FRA
999ceb5f,27,1726,19.2,17,14,10,6,14,31,-17,15.7,32.2,-16.6,22,FRA
9af3613f,1,12,0.1,0,0,1,1,0,0,0,0.1,0.0,0.1,22,FRA
9b5237b1,5,14,0.2,0,0,5,16,2,0,2,0.9,1.2,-0.3,22,FRA
9b6f7fd5,35,2699,30.0,32,18,3,1,54,39,15,54.9,43.2,11.7,22,FRA
9ba7b4fa,27,1890,21.0,21,17,6,4,21,32,-11,27.2,30.0,-2.8,22,FRA
9bdd8118,23,1208,13.4,13,8,10,7,14,35,-21,13.9,23.7,-9.8,22,FRA
9c221d14,37,3330,37.0,37,37,0,0,42,43,-1,36.9,45.0,-8.1,22,FRA
9c2b1f11,2,80,0.9,1,0,1,0,1,0,1,0.9,0.9,0.1,22,FRA
9d5dcc23,14,555,6.2,7,0,7,6,7,13,-6,5.9,10.1,-4.2,22,FRA
9daeac61,27,2219,24.7,27,15,0,6,30,37,-7,30.9,30.5,0.4,22,FRA
9ddf7fae,6,150,1.7,2,0,4,5,4,2,2,1.2,2.0,-0.8,22,FRA
9e17ccff,12,1080,12.0,12,12,0,7,29,13,16,20.4,14.0,6.4,22,FRA
9f0f4b49,18,792,8.8,9,2,9,18,6,20,-14,8.5,16.9,-8.4,22,FRA
9f1c2822,10,375,4.2,3,0,7,5,4,4,0,4.5,3.4,1.1,22,FRA
9f29c204,19,1072,11.9,12,2,7,13,15,19,-4,12.8,16.5,-3.6,22,FRA
9f90c06b,2,167,1.9,2,1,0,16,3,4,-1,1.3,3.9,-2.6,22,FRA
a0415710,28,1203,13.4,10,6,18,8,22,13,9,21.7,14.0,7.7,22,FRA
a0791826,24,1526,17.0,18,7,6,4,16,34,-18,13.6,26.9,-13.4,22,FRA
a0d55a09,11,263,2.9,2,0,9,8,11,5,6,8.9,7.6,1.3,22,FRA
a0f9b535,28,2125,23.6,24,14,4,1,44,23,21,37.0,29.3,7.7,22,FRA
a17a94d6,29,2463,27.4,29,23,0,0,31,28,3,26.9,31.6,-4.7,22,FRA
a1dbfcb1,35,2008,22.3,23,2,12,2,23,44,-21,27.7,30.9,-3.3,22,FRA
a2d873dd,32,2508,27.9,29,9,3,0,38,66,-28,30.3,46.9,-16.6,22,FRA
a30cb0d4,4,58,0.6,0,0,4,9,1,1,0,0.7,0.5,0.1,22,FRA
a3c8b4d3,10,87,1.0,0,0,10,18,2,3,-1,2.2,2.4,-0.2,22,FRA
a3e1d20d,15,980,10.9,10,9,5,10,10,28,-18,11.9,14.5,-2.6,22,FRA
a4527d33,1,90,1.0,1,1,0,33,2,0,2,2.6,0.3,2.3,22,FRA
a4b1028a,33,2890,32.1,33,25,0,2,62,36,26,50.5,38.1,12.5,22,FRA
a5549ec1,34,2679,29.8,29,26,5,2,50,25,25,46.3,31.0,15.3,22,FRA
a5db0bec,36,2504,27.8,29,17,7,0,47,37,10,50.8,41.7,9.2,22,FRA
a62f8bf1,20,1015,11.3,11,1,9,1,22,9,13,15.8,11.0,4.8,22,FRA
a634b9d2,2,13,0.1,0,0,2,27,1,0,1,0.4,0.0,0.4,22,FRA
a671316d,4,50,0.6,0,0,4,7,0,0,0,0.3,0.5,-0.2,22,FRA
a6b6fa6e,30,2563,28.5,29,24,1,8,30,58,-28,27.1,45.4,-18.3,22,FRA
a84f9a4b,8,352,3.9,5,1,3,27,3,7,-4,4.4,5.2,-0.8,22,FRA
a99138af,28,1445,16.1,18,4,10,10,21,15,6,23.4,14.8,8.6,22,FRA
a99da9ec,20,553,6.1,6,2,14,6,0,19,-19,3.8,13.1,-9.4,22,FRA
aad56ca3,38,2754,30.6,32,16,6,0,43,31,12,45.2,32.9,12.2,22,FRA
ab096c6f,30,2565,28.5,30,25,0,3,33,52,-19,27.0,40.8,-13.8,22,FRA
abd56820,2,5,0.1,0,0,2,19,0,0,0,0.0,0.1,-0.1,22,FRA
ad513a6b,5,126,1.4,1,0,4,7,2,3,-1,1.3,2.6,-1.3,22,FRA
ad82197c,32,2721,30.2,30,26,2,4,52,34,18,48.4,33.7,14.7,22,FRA
ae5b93a0,1,6,0.1,0,0,1,1,0,0,0,0.0,0.0,0.0,22,FRA
ae7d0ecd,21,1875,20.8,21,19,0,13,19,39,-20,16.3,31.4,-15.1,22,FRA
aef6e670,30,2576,28.6,29,25,1,3,64,31,33,59.2,31.6,27.6,22,FRA
aefa3050,4,77,0.9,0,0,4,4,0,3,-3,0.8,1.5,-0.6,22,FRA
af0c835b,30,1509,16.8,16,10,14,4,23,20,3,15.9,27.4,-11.5,22,FRA
afb0c500,38,3420,38.0,38,38,0,0,65,40,25,59.3,40.3,19.0,22,FRA
afe39ca8,4,61,0.7,0,0,4,11,0,2,-2,0.7,2.2,-1.5,22,FRA
b003239d,14,1050,11.7,11,9,3,23,16,17,-1,16.0,15.9,0.1,22,FRA
b026bbf6,20,616,6.8,5,5,15,16,23,6,17,13.7,6.0,7.7,22,FRA
b0547a87,27,1969,21.9,24,7,3,0,23,37,-14,17.0,33.7,-16.6,22,FRA
b0c71810,29,2330,25.9,28,13,1,0,29,42,-13,30.7,34.2,-3.5,22,FRA
b229aa13,9,605,6.7,8,3,1,0,6,10,-4,6.1,15.0,-8.9,22,FRA
b2336681,28,2329,25.9,26,24,2,6,32,27,5,36.0,22.7,13.3,22,FRA
b2bd0f6c,31,2428,27.0,28,10,3,0,31,31,0,34.0,26.3,7.7,22,FRA
b34c63a5,16,440,4.9,3,1,13,7,5,8,-3,7.2,6.6,0.6,22,FRA
b3f8bdef,22,523,5.8,5,1,17,6,13,6,7,10.8,5.5,5.3,22,FRA
b5bb8188,23,1832,20.4,23,9,0,1,31,47,-16,24.4,34.6,-10.2,22,FRA
b625b241,7,54,0.6,0,0,7,4,1,2,-1,1.0,1.2,-0.2,22,FRA
b666421b,37,3215,35.7,36,35,1,0,41,51,-10,43.0,45.8,-2.8,22,FRA
b73f17f8,20,438,4.9,2,1,18,10,11,7,4,10.5,5.4,5.1,22,FRA
b85e57bb,2,98,1.1,0,0,2,2,3,1,2,2.9,1.6,1.4,22,FRA
b8d22478,11,328,3.6,3,0,8,3,5,6,-1,4.2,4.2,0.0,22,FRA
b94b8be1,35,1081,12.0,11,0,24,2,14,25,-11,13.7,21.5,-7.7,22,FRA
b98cea65,15,1350,15.0,15,15,0,22,12,22,-10,17.3,19.3,-2.0,22,FRA
bbdb2789,1,2,0.0,0,0,1,1,0,0,0,0.0,0.1,-0.1,22,FRA
bbdd999a,4,32,0.4,0,0,4,9,0,0,0,0.3,0.5,-0.2,22,FRA
bc0bfc64,2,9,0.1,0,0,2,1,0,3,-3,0.2,1.2,-1.0,22,FRA
bc7b4580,27,1667,18.5,21,5,6,1,31,26,5,25.1,26.3,-1.2,22,FRA
bce37ac0,1,16,0.2,0,0,1,1,1,0,1,0.6,0.0,0.6,22,FRA
be13e5a8,7,510,5.7,4,4,3,12,4,13,-9,5.2,9.5,-4.4,22,FRA
be47b750,4,124,1.4,1,0,3,0,4,1,3,2.1,0.7,1.4,22,FRA
beae3a73,28,1893,21.0,22,7,6,1,22,30,-8,21.0,30.8,-9.8,22,FRA
beb391dd,1,63,0.7,1,0,0,0,0,2,-2,0.9,1.6,-0.7,22,FRA
bec3d251,15,525,5.8,5,0,10,2,4,10,-6,4.5,8.4,-4.0,22,FRA
bef0a7ac,2,54,0.6,0,0,2,0,3,0,3,1.0,0.2,0.8,22,FRA
bf4c41f9,34,2156,24.0,27,5,7,2,41,28,13,29.599999999999998,27.8,1.8,22,FRA
c066d1a5,31,2254,25.0,26,15,5,1,27,32,-5,28.3,29.4,-1.1,22,FRA
c0b3669f,36,2948,32.8,34,21,2,1,49,39,10,40.0,42.7,-2.6,22,FRA
c20bdcd7,18,1524,16.9,18,13,0,0,22,26,-4,22.6,17.8,4.8,22,FRA
c252c705,13,1170,13.0,13,13,0,23,18,29,-11,14.7,19.0,-4.3,22,FRA
c26a3918,28,2361,26.2,25,24,3,9,34,36,-2,33.3,31.8,1.5,22,FRA
c2e5f306,14,122,1.4,0,0,14,13,0,3,-3,1.1,2.0,-0.9,22,FRA
c3725db2,31,2668,29.6,30,26,1,0,28,40,-12,27.9,39.7,-11.8,22,FRA
c5908bc4,5,90,1.0,0,0,5,18,6,3,3,2.2,1.6,0.6,22,FRA
c631f952,29,2587,28.7,29,27,0,0,35,41,-6,29.9,42.0,-12.0,22,FRA
c678ddd7,1,12,0.1,0,0,1,10,0,1,-1,0.0,0.7,-0.7,22,FRA
c6e5d20f,29,1863,20.7,21,14,8,4,33,32,1,34.4,29.0,5.3,22,FRA
c76b7567,31,2389,26.5,27,17,4,0,45,33,12,40.8,31.3,9.5,22,FRA
c801616a,33,2193,24.4,25,16,8,4,31,34,-3,32.0,31.0,1.0,22,FRA
caa7aaea,24,1717,19.1,19,15,5,0,20,34,-14,23.6,28.3,-4.6,22,FRA
caef7840,25,1056,11.7,13,1,12,11,13,9,4,14.6,10.1,4.6,22,FRA
cc41f558,12,1007,11.2,11,11,1,0,12,26,-14,8.9,17.6,-8.7,22,FRA
cc588cbe,3,7,0.1,0,0,3,22,0,2,-2,0.2,1.4,-1.2,22,FRA
cc77354e,34,2778,30.9,31,26,3,2,53,30,23,46.6,30.6,16.0,22,FRA
cc83b74d,26,1492,16.6,19,4,7,5,18,14,4,20.6,18.0,2.7,22,FRA
cc972842,5,72,0.8,0,0,5,0,0,3,-3,0.7,1.6,-0.9,22,FRA
ccce7025,25,2250,25.0,25,25,0,1,33,33,0,30.8,28.3,2.5,22,FRA
cdc4458b,8,128,1.4,0,0,8,15,3,1,2,3.1,0.8,2.2,22,FRA
ce492295,16,1227,13.6,14,13,2,2,20,37,-17,15.9,28.8,-12.9,22,FRA
ce4f40c7,34,2946,32.7,33,28,1,0,52,39,13,42.3,37.7,4.6,22,FRA
ce50fd99,38,2804,31.2,32,14,6,0,38,34,4,41.0,31.8,9.2,22,FRA
ce84946a,1,1,0.0,0,0,1,0,0,1,-1,0.0,0.0,0.0,22,FRA
cea59f02,21,1410,15.7,16,12,5,13,14,25,-11,19.0,22.9,-3.9,22,FRA
cecbce23,25,2250,25.0,25,25,0,1,53,25,28,41.7,28.4,13.3,22,FRA
ced1d98f,5,184,2.0,2,0,3,13,1,3,-2,1.5,3.1,-1.6,22,FRA
cf1ef7ec,7,134,1.5,1,0,6,15,1,2,-1,1.4,2.6,-1.2,22,FRA
cfa49cc1,17,1347,15.0,17,7,0,0,12,20,-8,14.9,20.6,-5.7,22,FRA
d1828392,8,153,1.7,0,0,8,12,0,3,-3,0.9,4.5,-3.6,22,FRA
d21e361a,2,14,0.2,0,0,2,6,0,0,0,0.1,0.0,0.1,22,FRA
d33c706e,35,2717,30.2,29,23,6,0,41,37,4,45.8,36.199999999999996,9.6,22,FRA
d4d35152,28,1463,16.3,16,8,12,10,22,23,-1,19.7,21.4,-1.7,22,FRA
d504b3e1,10,198,2.2,1,0,9,2,8,3,5,5.8,5.7,0.2,22,FRA
d5575935,13,455,5.1,5,0,8,8,2,5,-3,3.6,8.1,-4.5,22,FRA
d56b9520,30,1884,20.9,21,15,9,7,39,29,10,37.5,29.7,7.8,22,FRA
d5d22a58,30,1344,14.9,15,4,15,2,14,21,-7,17.8,19.1,-1.3,22,FRA
d5f2f82b,32,2861,31.8,32,31,0,1,67,28,39,63.1,33.0,30.1,22,FRA
d6f6ce93,6,436,4.8,4,4,2,29,15,6,9,11.7,7.7,4.0,22,FRA
d70ce98e,26,2153,23.9,24,22,2,0,54,23,31,51.3,25.8,25.5,22,FRA
d75f3980,15,878,9.8,10,4,5,17,8,15,-7,9.7,13.0,-3.3,22,FRA
d8c19a60,1,4,0.0,0,0,1,1,0,1,-1,0.0,0.8,-0.8,22,FRA
d9764034,26,1832,20.4,21,18,5,4,36,19,17,33.9,18.5,15.4,22,FRA
da4d670f,6,132,1.5,1,0,5,12,1,0,1,1.2,1.1,0.0,22,FRA
db013c7d,5,86,1.0,0,0,5,5,0,2,-2,3.6,1.7,1.9,22,FRA
db23d9fc,16,855,9.5,10,5,6,16,13,19,-6,9.3,16.0,-6.7,22,FRA
db3164e1,31,2790,31.0,31,31,0,0,29,45,-16,30.0,42.2,-12.2,22,FRA
db7849ca,34,2899,32.2,34,21,0,0,40,45,-5,35.5,43.9,-8.4,22,FRA
db87a2c4,1,90,1.0,1,1,0,37,0,1,-1,1.0,1.5,-0.6,22,FRA
dbde4959,19,753,8.4,9,2,10,19,7,9,-2,8.6,12.6,-4.0,22,FRA
de40e38c,33,2292,25.5,26,18,7,0,27,33,-6,27.1,33.9,-6.8,22,FRA
de488e56,16,718,8.0,7,5,9,7,11,10,1,10.1,8.4,1.7,22,FRA
deba6b05,26,1258,14.0,14,6,12,8,17,47,-30,17.0,30.2,-13.2,22,FRA
dff0c299,2,6,0.1,0,0,2,6,0,0,0,0.1,0.0,0.1,22,FRA
dff153a4,15,838,9.3,10,3,5,3,21,6,15,16.6,7.8,8.9,22,FRA
e0bc6fdc,29,2264,25.2,26,19,3,4,42,39,3,43.5,38.8,4.7,22,FRA
e0f3a1f6,28,2510,27.9,28,26,0,0,40,35,5,36.8,37.5,-0.7,22,FRA
e2f9bb5f,30,1553,17.3,18,2,12,5,14,35,-21,16.3,26.8,-10.5,22,FRA
e3d0b0c4,13,1078,12.0,13,9,0,1,12,25,-13,13.100000000000001,17.9,-4.7,22,FRA
e3e05edf,11,659,7.3,7,4,4,11,6,14,-8,7.3,14.0,-6.7,22,FRA
e3e32fbb,28,1578,17.5,17,13,11,10,16,33,-17,17.7,25.8,-8.1,22,FRA
e4114f5d,14,307,3.4,2,1,12,4,6,2,4,3.7,2.1,1.7,22,FRA
e42d61c7,32,2479,27.5,28,19,4,0,70,25,45,57.5,26.8,30.8,22,FRA
e4448c8c,11,262,2.9,3,0,8,19,2,9,-7,3.9,7.0,-3.1,22,FRA
e472a6f6,34,2413,26.8,27,16,7,2,32,41,-9,31.4,36.3,-4.9,22,FRA
e4b72e34,17,1112,12.4,12,7,5,5,11,25,-14,12.2,22.8,-10.6,22,FRA
e4bb1f08,8,176,2.0,0,0,8,7,3,5,-2,2.8,3.2,-0.4,22,FRA
e50623a0,19,1235,13.7,16,7,3,0,13,28,-15,10.1,22.9,-12.8,22,FRA
e5c1e0ca,21,1734,19.3,19,15,2,5,17,26,-9,21.3,26.3,-5.0,22,FRA
e6c43eec,15,1331,14.8,15,14,0,0,18,38,-20,19.1,22.9,-3.8,22,FRA
e6eadfb8,21,980,10.9,11,5,10,5,8,18,-10,10.6,15.7,-5.1,22,FRA
e768de1f,17,1267,14.1,16,8,1,0,18,26,-8,11.0,21.2,-10.2,22,FRA
e7986081,30,2207,24.5,25,16,5,0,46,31,15,45.3,33.9,11.3,22,FRA
e7d59f4f,23,1165,12.9,12,1,11,7,23,14,9,21.9,13.1,8.8,22,FRA
e8c5dd4d,15,1304,14.5,15,14,0,16,18,33,-15,17.4,22.2,-4.8,22,FRA
e97150c0,9,604,6.7,6,6,3,5,4,8,-4,5.3,9.8,-4.6,22,FRA
ea02beaf,33,1737,19.3,20,2,13,2,26,53,-27,21.1,40.0,-18.9,22,FRA
ea0aa7e0,29,1803,20.0,19,15,10,2,30,29,1,23.0,29.1,-6.1,22,FRA
ea0ff634,34,1970,21.9,22,6,12,0,26,35,-9,24.2,31.8,-7.6,22,FRA
eab85789,24,1012,11.2,10,0,14,9,20,17,3,14.6,19.4,-4.8,22,FRA
eab957a3,15,1350,15.0,15,15,0,0,18,38,-20,20.0,22.9,-2.9,22,FRA
eaf71a5e,7,388,4.3,4,3,3,0,4,6,-2,3.9,5.0,-1.1,22,FRA
eb58eef0,31,1653,18.4,18,6,13,3,51,20,31,34.8,19.8,15.0,22,FRA
ecada4fc,21,1856,20.6,21,19,0,11,43,18,25,38.7,21.3,17.4,22,FRA
ed39121c,30,2632,29.2,29,29,1,0,28,39,-11,29.4,38.4,-9.0,22,FRA
ed45c4a5,32,2194,24.4,25,15,7,3,43,23,20,36.6,25.1,11.5,22,FRA
edbe46dc,27,2313,25.7,27,25,0,7,38,33,5,32.4,30.3,2.1,22,FRA
edd81e2a,30,2545,28.3,28,27,2,0,28,55,-27,21.8,45.9,-24.1,22,FRA
ee158be5,1,90,1.0,1,1,0,1,4,2,2,2.8,0.9,1.9,22,FRA
ee45fd85,17,1120,12.4,12,6,5,0,23,12,11,18.7,13.6,5.0,22,FRA
ee644761,17,1381,15.3,16,13,1,8,16,29,-13,18.7,20.6,-1.9,22,FRA
ee95585f,4,307,3.4,4,2,0,1,4,6,-2,2.9,3.6,-0.7,22,FRA
eef2d8ce,29,2353,26.1,27,20,2,3,44,64,-20,33.7,44.8,-11.1,22,FRA
ef9c1c95,33,2752,30.6,33,21,0,0,35,41,-6,40.5,30.4,10.1,22,FRA
f00de885,34,2982,33.1,34,32,0,0,51,45,6,55.2,46.9,8.3,22,FRA
f066022d,33,2891,32.1,33,31,0,0,29,49,-20,35.1,40.1,-5.0,22,FRA
f20e4cc9,27,1658,18.4,18,12,9,6,42,19,23,35.7,20.5,15.3,22,FRA
f28474a4,18,1105,12.3,12,9,6,17,25,13,12,21.2,16.5,4.7,22,FRA
f3600c02,23,1619,18.0,19,13,4,4,21,18,3,24.1,16.1,7.9,22,FRA
f36d5624,20,699,7.8,7,1,13,17,7,4,3,8.5,8.4,0.1,22,FRA
f4bc42b1,18,953,10.6,11,1,7,7,17,16,1,10.2,15.9,-5.699999999999999,22,FRA
f520049f,14,1179,13.1,14,10,0,0,17,30,-13,14.8,22.5,-7.7,22,FRA
f54d2149,17,801,8.9,11,0,6,9,11,11,0,8.1,10.6,-2.5,22,FRA
f5b6fb78,1,61,0.7,1,0,0,1,0,0,0,0.6,1.7,-1.1,22,FRA
f5c8b425,15,509,5.7,5,0,10,3,8,13,-5,8.1,6.4,1.7,22,FRA
f5dfc256,17,1530,17.0,17,17,0,5,20,20,0,20.9,17.2,3.7,22,FRA
f5efb153,11,933,10.4,11,8,0,1,13,22,-9,9.0,18.7,-9.7,22,FRA
f6496133,25,958,10.6,9,1,16,9,9,21,-12,11.7,13.7,-2.0,22,FRA
f6b94e8d,13,989,11.0,11,9,2,9,13,27,-14,10.6,16.2,-5.6,22,FRA
f7691f63,33,2044,22.7,23,11,10,1,35,28,7,32.3,27.1,5.2,22,FRA
f7d3a773,10,900,10.0,10,10,0,16,13,14,-1,13.9,16.2,-2.3,22,FRA
f81ef10d,31,2335,25.9,26,22,5,0,40,35,5,44.7,35.3,9.4,22,FRA
f83c8d6c,17,226,2.5,1,0,16,8,6,2,4,6.4,5.4,1.0,22,FRA
f8405304,32,1837,20.4,21,0,11,0,27,25,2,26.2,23.8,2.4,22,FRA
f86ca403,30,2311,25.7,27,17,3,0,23,45,-22,18.8,41.9,-23.1,22,FRA
f8ce97ca,26,1414,15.7,17,5,9,2,18,35,-17,15.7,27.6,-11.9,22,FRA
f98b15f0,1,24,0.3,0,0,1,3,0,1,-1,0.3,1.0,-0.7,22,FRA
f9d5908e,29,1621,18.0,21,3,8,5,25,15,10,24.8,23.4,1.4,22,FRA
fb14aa28,30,1717,19.1,20,4,10,0,21,30,-9,19.7,26.5,-6.8,22,FRA
fbf83734,16,1440,16.0,16,16,0,22,17,25,-8,18.7,19.1,-0.4,22,FRA
fc46aab1,29,1832,20.4,21,5,8,0,52,19,33,38.3,18.9,19.3,22,FRA
fc4cf6a7,30,1782,19.8,19,10,11,7,26,16,10,29.3,23.4,5.9,22,FRA
fc62f087,12,877,9.7,10,8,2,10,23,9,14,15.5,9.4,6.1,22,FRA
fcc84a07,24,626,7.0,7,1,17,13,5,18,-13,7.4,13.8,-6.4,22,FRA
fd2bc67d,34,2870,31.9,33,29,1,0,44,30,14,47.9,34.3,13.5,22,FRA
fe6c1add,5,70,0.8,0,0,5,10,2,0,2,1.0,0.7,0.3,22,FRA
feb5d3ab,32,2099,23.3,22,19,10,4,31,27,4,25.9,33.2,-7.3,22,FRA
feb5d972,33,2129,23.7,22,15,11,0,26,49,-23,18.5,41.5,-23.0,22,FRA
ff0ab48c,23,1742,19.4,20,14,3,6,27,26,1,31.0,27.0,4.0,22,FRA
ff20acfe,4,44,0.5,0,0,4,10,0,2,-2,0.4,0.9,-0.5,22,FRA
ff44d058,1,6,0.1,0,0,1,10,0,0,0,0.0,0.1,0.0,22,FRA
ff800ed8,34,1770,19.7,19,8,15,1,30,18,12,30.5,20.4,10.1,22,FRA
ffec9769,12,573,6.4,6,1,6,2,7,9,-2,8.8,8.7,0.2,22,FRA
fffea3e5,14,469,5.2,4,0,10,2,10,4,6,8.9,6.6,2.2,22,FRA
00242b75,31,2141,23.8,25,14,6,2,41,36,5,34.1,40.1,-6.1,23,GER
00963611,28,2286,25.4,26,23,2,0,32,44,-12,35.8,33.3,2.5,23,GER
009a4f60,30,2447,27.2,29,17,1,1,68,34,34,48.7,30.3,18.4,23,GER
00f518d8,15,182,2.0,0,0,15,10,3,4,-1,4.0,2.5,1.4,23,GER
0118c54c,31,2033,22.6,23,14,8,3,38,38,0,32.7,35.8,-3.1,23,GER
01834aa0,26,1928,21.4,23,18,3,7,41,31,10,32.3,33.0,-0.7,23,GER
042e8a49,24,1409,15.7,16,2,8,3,43,11,32,34.3,12.9,21.4,23,GER
048a1cbc,27,2290,25.4,26,19,1,4,58,41,17,53.1,33.3,19.8,23,GER
049751d7,16,860,9.6,10,1,6,1,12,6,6,8.6,8.6,0.0,23,GER
054849d2,22,1600,17.8,19,11,3,0,26,30,-4,19.8,28.9,-9.1,23,GER
056d2d95,25,1811,20.1,20,17,5,8,29,24,5,23.2,23.6,-0.4,23,GER
05ba9d7c,14,326,3.6,0,0,14,8,11,6,5,7.3,4.9,2.5,23,GER
05d548d8,30,2018,22.4,24,16,6,3,53,22,31,47.1,26.7,20.4,23,GER
05e2d5ea,13,244,2.7,0,0,13,11,3,5,-2,3.5,5.1,-1.6,23,GER
05f99a4a,11,533,5.9,7,0,4,0,7,12,-5,8.5,9.8,-1.3,23,GER
061e8e23,18,558,6.2,4,0,14,4,12,10,2,8.6,9.899999999999999,-1.4000000000000001,23,GER
07c7eb0c,31,2720,30.2,31,26,0,0,39,64,-25,35.3,59.3,-24.0,23,GER
07d3bfec,11,315,3.5,3,0,8,10,6,7,-1,5.2,6.2,-1.1,23,GER
08593525,2,34,0.4,1,0,1,4,0,0,0,0.6,0.1,0.5,23,GER
088ca1bd,3,41,0.5,0,0,3,9,0,1,-1,1.0,1.5,-0.4,23,GER
091c86e2,30,1836,20.4,19,11,11,1,34,25,9,31.6,33.3,-1.7,23,GER
099e666f,29,2244,24.9,25,22,4,4,29,44,-15,27.3,45.5,-18.2,23,GER
0a084b35,12,935,10.4,10,10,2,6,12,9,3,11.3,14.5,-3.2,23,GER
0a16eb36,20,749,8.3,8,1,12,7,6,20,-14,8.0,14.3,-6.2,23,GER
0a1cb833,33,2908,32.3,33,32,0,0,49,61,-12,38.8,49.0,-10.2,23,GER
0a3f6cde,29,1981,22.0,22,10,7,2,32,40,-8,29.3,38.3,-9.0,23,GER
0a89e877,30,2188,24.3,23,17,7,3,39,35,4,41.3,29.3,12.1,23,GER
0b45a8d7,3,10,0.1,0,0,3,2,0,0,0,0.1,0.2,-0.1,23,GER
0c61c77c,32,2397,26.6,27,14,5,0,34,55,-21,29.2,47.2,-17.9,23,GER
0c7a48f8,30,2457,27.3,27,16,3,0,46,32,14,38.9,33.3,5.6,23,GER
0c88efca,1,10,0.1,0,0,1,2,0,0,0,0.5,0.0,0.5,23,GER
0cc5f4a5,16,899,10.0,10,5,6,2,13,16,-3,10.2,14.7,-4.4,23,GER
0cf778df,33,1884,20.9,21,1,12,0,27,35,-8,27.8,28.7,-0.9,23,GER
0d55d942,23,2035,22.6,22,22,1,11,24,58,-34,26.5,40.8,-14.3,23,GER
0d8a37c2,6,510,5.7,5,5,1,12,5,12,-7,6.6,8.4,-1.8,23,GER
0e0102eb,33,1476,16.4,15,1,18,1,24,24,0,24.4,23.4,1.0,23,GER
0e6bc38c,19,1112,12.4,14,4,5,1,38,13,25,28.3,14.0,14.4,23,GER
0f59a7bf,30,2070,23.0,22,9,8,1,35,36,-1,31.5,35.0,-3.4,23,GER
0fbecd11,30,2292,25.5,27,21,3,1,39,38,1,34.8,39.1,-4.3,23,GER
1025db8e,32,2795,31.1,32,30,0,0,39,56,-17,31.9,54.2,-22.2,23,GER
10549b49,23,927,10.3,8,3,15,3,13,17,-4,17.8,13.6,4.2,23,GER
10745192,15,533,5.9,4,0,11,3,19,7,12,12.9,8.4,4.4,23,GER
116c35df,26,1706,19.0,22,1,4,2,44,24,20,41.7,21.3,20.4,23,GER
1238a3f9,30,1151,12.799999999999999,15,1,15,2,15,25,-10,14.5,18.7,-4.3,23,GER
13203c45,20,979,10.799999999999999,11,1,9,1,17,13,4,14.2,16.4,-2.3,23,GER
13d23b29,1,13,0.1,0,0,1,9,0,0,0,0.1,0.0,0.1,23,GER
13ddc856,25,1713,19.0,21,4,4,0,24,38,-14,26.8,37.4,-10.6,23,GER
13fe7b69,16,265,2.9,0,0,16,14,7,5,2,4.8,6.0,-1.2,23,GER
14a7af33,26,1886,21.0,23,4,3,2,32,42,-10,26.6,29.7,-3.1,23,GER
15413fa5,26,1576,17.5,17,10,9,5,37,22,15,34.2,23.4,10.8,23,GER
15b287da,32,2265,25.2,25,13,7,1,49,37,12,42.3,31.0,11.3,23,GER
15f24fe7,3,233,2.6,3,1,0,0,3,3,0,2.9,1.4,1.5,23,GER
15f3ec41,14,605,6.7,7,0,7,8,12,13,-1,9.8,8.7,1.0,23,GER
17376543,23,2070,23.0,23,23,0,0,28,41,-13,24.3,38.9,-14.6,23,GER
1866b0f1,1,11,0.1,0,0,1,1,0,1,-1,0.5,0.4,0.1,23,GER
19a967ab,24,1286,14.3,14,5,10,6,20,26,-6,16.6,21.1,-4.4,23,GER
1a4b9094,1,3,0.0,0,0,1,12,0,0,0,0.0,0.1,-0.1,23,GER
1a5d7cb9,2,6,0.1,0,0,2,9,0,2,-2,0.0,1.1,-1.1,23,GER
1ae836b1,31,2524,28.0,30,17,1,0,34,47,-13,27.4,47.8,-20.4,23,GER
1c86aa16,1,4,0.0,0,0,1,10,0,0,0,0.0,0.0,0.0,23,GER
1cbe4984,25,2041,22.7,25,15,0,2,33,26,7,31.7,30.4,1.3,23,GER
1d8e9add,22,1775,19.7,22,16,0,0,29,27,2,30.1,26.4,3.8,23,GER
1df0c0b9,29,2015,22.4,23,17,6,1,30,42,-12,23.1,39.9,-16.8,23,GER
1e274a0a,21,495,5.5,2,1,19,11,8,5,3,6.9,5.3,1.6,23,GER
1e43fad8,12,1025,11.4,12,11,0,15,11,13,-2,13.1,16.4,-3.2,23,GER
1f2c7b55,3,57,0.6,0,0,3,8,1,1,0,1.0,0.9,0.1,23,GER
1f3afdcb,24,1523,16.9,17,13,7,6,35,20,15,28.8,22.1,6.7,23,GER
1fc4f3d1,31,1584,17.6,18,4,13,2,25,37,-12,20.7,32.7,-12.0,23,GER
1fffae99,32,1855,20.6,21,7,11,1,31,37,-6,23.3,29.7,-6.4,23,GER
20030c06,33,2951,32.8,33,32,0,1,62,39,23,60.7,35.4,25.3,23,GER
202b3b68,31,2058,22.9,25,5,6,2,47,27,20,37.6,33.3,4.4,23,GER
204dded0,30,2561,28.5,29,27,1,1,34,43,-9,38.7,36.5,2.3,23,GER
2077ae86,24,1291,14.3,15,3,9,1,26,18,8,23.5,23.7,-0.2,23,GER
220ace7e,27,1520,16.9,15,5,12,1,23,29,-6,20.5,26.0,-5.5,23,GER
22798128,14,871,9.7,11,1,3,2,9,9,0,10.5,13.3,-2.8,23,GER
22919e97,24,644,7.2,4,0,20,4,11,16,-5,11.2,11.7,-0.5,23,GER
231c67ff,9,99,1.1,0,0,9,7,5,4,1,3.8,4.6,-0.8,23,GER
236f02cd,28,2208,24.5,25,15,3,6,39,35,4,35.7,36.7,-1.0,23,GER
25ab9c9c,15,643,7.1,8,5,7,8,6,15,-9,7.5,12.0,-4.5,23,GER
271b8617,28,1314,14.6,16,1,12,2,25,18,7,19.2,19.8,-0.6,23,GER
27270af4,3,93,1.0,0,0,3,10,1,4,-3,1.0,2.6,-1.5,23,GER
2770726a,12,559,6.2,7,0,5,2,7,11,-4,9.0,7.6,1.4,23,GER
277be51d,1,21,0.2,0,0,1,5,0,0,0,0.0,0.1,-0.1,23,GER
277c49ed,24,1627,18.1,18,13,6,6,31,26,5,28.5,26.5,2.0,23,GER
2903a856,31,2680,29.8,30,16,1,0,43,47,-4,46.3,46.6,-0.3,23,GER
2979c05a,23,945,10.5,8,2,15,6,9,25,-16,10.9,24.9,-14.1,23,GER
29ddfb9c,1,15,0.2,0,0,1,2,0,0,0,0.1,0.4,-0.3,23,GER
29f7cfd9,27,1457,16.2,19,4,8,2,17,39,-22,17.0,32.9,-15.9,23,GER
2a29eb9b,22,1639,18.2,19,10,3,6,32,18,14,26.5,25.2,1.3,23,GER
2b114be3,32,2010,22.3,20,11,12,0,59,24,35,45.5,25.3,20.2,23,GER
2b83fa49,2,59,0.7,1,0,1,8,0,2,-2,0.2,1.4,-1.2,23,GER
2c0558b8,33,2198,24.4,26,7,7,0,63,29,34,53.6,28.4,25.2,23,GER
2d61d13a,30,2388,26.5,28,21,2,1,34,41,-7,36.9,39.2,-2.3,23,GER
2e77d607,17,1497,16.6,17,16,0,1,31,26,5,25.3,28.3,-3.0,23,GER
2f3e911a,28,1847,20.5,20,14,8,6,29,34,-5,26.9,34.5,-7.6,23,GER
2f7fec15,10,241,2.7,2,0,8,16,6,6,0,5.7,3.9,1.9,23,GER
302527b2,29,2498,27.8,27,25,2,0,45,30,15,40.7,38.0,2.8,23,GER
30261ba1,9,473,5.3,5,1,4,14,8,8,0,6.8,7.8,-1.0,23,GER
30941e96,33,2617,29.1,30,23,3,0,38,51,-13,39.9,45.6,-5.7,23,GER
30ae134d,33,1535,17.1,17,1,16,0,30,23,7,18.7,21.5,-2.8,23,GER
30c220c3,30,2516,28.0,29,23,1,0,42,56,-14,34.1,43.8,-9.7,23,GER
313254a3,27,1977,22.0,23,18,4,4,29,32,-3,28.9,33.0,-4.2,23,GER
33182cb8,15,868,9.6,10,1,5,4,8,19,-11,10.9,16.7,-5.8,23,GER
33b554b7,20,853,9.5,8,5,12,7,12,28,-16,12.5,18.7,-6.2,23,GER
346d51d9,23,1894,21.0,21,18,2,1,38,35,3,31.8,35.0,-3.2,23,GER
34b0387f,34,1894,21.0,24,2,10,0,36,33,3,28.0,30.5,-2.5,23,GER
34b54da7,8,99,1.1,1,0,7,17,3,4,-1,1.3,2.6,-1.3,23,GER
34e12499,28,2252,25.0,27,23,1,3,57,34,23,44.3,32.5,11.9,23,GER
34e4343c,19,813,9.0,7,3,12,12,13,9,4,15.0,13.3,1.6,23,GER
35d64857,31,2718,30.2,30,29,1,0,53,45,8,44.9,36.0,8.8,23,GER
35f67a30,8,167,1.9,0,0,8,2,1,3,-2,3.2,2.7,0.5,23,GER
36578017,3,28,0.3,0,0,3,10,1,2,-1,0.6,0.7,-0.1,23,GER
36a3ff67,25,1353,15.0,14,5,11,0,32,19,13,29.4,17.1,12.4,23,GER
36a59ba4,23,1405,15.6,16,5,7,2,19,20,-1,25.0,22.0,3.0,23,GER
36d9dabe,17,903,10.0,10,5,7,6,9,27,-18,9.4,19.4,-10.0,23,GER
3745e8bd,19,630,7.0,5,2,14,1,14,22,-8,11.2,16.5,-5.3,23,GER
378825c7,28,2481,27.6,28,22,0,0,44,39,5,42.2,39.0,3.2,23,GER
37998008,5,450,5.0,5,5,0,29,7,11,-4,6.6,7.5,-0.9,23,GER
37dc1a48,27,1679,18.7,22,2,5,0,33,28,5,25.3,26.5,-1.2,23,GER
37f606f0,27,1952,21.7,27,6,0,1,31,36,-5,30.7,33.4,-2.7,23,GER
3b1ed320,20,704,7.8,6,2,14,6,14,14,0,10.8,11.1,-0.4,23,GER
3b61c9ec,9,557,6.2,7,2,2,1,10,7,3,8.8,5.0,3.8,23,GER
3bb625ac,32,2437,27.1,28,17,4,2,47,45,2,39.0,41.4,-2.4,23,GER
3c200e05,1,1,0.0,0,0,1,1,0,0,0,0.1,0.0,0.1,23,GER
3c6089ab,27,1665,18.5,21,8,6,0,50,15,35,43.4,17.0,26.4,23,GER
3eb0f2df,3,31,0.3,0,0,3,7,1,1,0,0.1,0.5,-0.4,23,GER
3eeb80e0,20,924,10.3,8,1,12,3,13,17,-4,11.6,17.7,-6.1,23,GER
3effaa34,31,1738,19.3,20,6,11,3,37,25,12,36.5,23.0,13.5,23,GER
3f6c3ae0,1,90,1.0,1,1,0,30,2,1,1,2.1,3.4,-1.3,23,GER
41bff4fa,17,947,10.5,11,6,6,9,12,20,-8,12.2,18.3,-6.0,23,GER
420c18a1,29,2610,29.0,29,29,0,0,61,39,22,57.2,35.2,22.0,23,GER
437f2b00,33,2567,28.5,33,14,0,0,40,49,-9,42.0,42.8,-0.8,23,GER
441197b8,30,2692,29.9,30,29,0,1,54,44,10,47.7,38.5,9.2,23,GER
442b56fa,33,2580,28.7,29,23,4,0,52,41,11,44.3,42.9,1.4,23,GER
44a20f0c,27,1846,20.5,20,17,7,6,25,41,-16,21.0,36.5,-15.5,23,GER
458e3479,2,8,0.1,0,0,2,13,0,0,0,0.1,0.2,-0.1,23,GER
45a03961,30,2431,27.0,27,24,3,3,76,29,47,61.6,28.4,33.2,23,GER
45e95f21,21,472,5.2,2,0,19,9,15,8,7,10.0,8.9,1.1,23,GER
462475ed,17,1211,13.5,15,3,2,0,23,22,1,18.8,20.7,-1.9,23,GER
463503e2,8,632,7.0,7,7,1,10,13,22,-9,8.9,18.2,-9.2,23,GER
46750e9c,2,34,0.4,0,0,2,11,1,0,1,1.1,0.3,0.8,23,GER
47064058,34,3060,34.0,34,34,0,0,48,57,-9,48.0,51.1,-3.1,23,GER
48035304,32,2826,31.4,32,30,0,0,48,52,-4,49.4,49.9,-0.5,23,GER
48780156,3,66,0.7,1,0,2,23,0,1,-1,0.3,2.9,-2.6,23,GER
49296448,33,2809,31.2,32,27,1,0,85,36,49,68.4,35.1,33.3,23,GER
496aeede,29,2222,24.7,27,17,2,2,38,39,-1,38.7,37.4,1.3,23,GER
49fe9070,27,1937,21.5,23,8,4,0,35,23,12,34.4,21.8,12.5,23,GER
4aea5077,17,817,9.1,9,2,8,12,12,20,-8,15.9,16.4,-0.4,23,GER
4b96c347,16,525,5.8,5,0,11,2,5,11,-6,6.4,10.2,-3.7,23,GER
4c6facae,32,2646,29.4,30,23,2,1,48,43,5,45.8,38.3,7.5,23,GER
4ccd8957,17,231,2.6,0,0,17,9,3,11,-8,2.8,6.4,-3.6,23,GER
4cd41883,7,173,1.9,0,0,7,6,4,0,4,5.4,1.4,4.0,23,GER
4e204552,12,328,3.6,3,0,9,5,5,8,-3,5.8,6.4,-0.6,23,GER
4f16405e,28,2477,27.5,28,26,0,1,41,46,-5,32.3,40.3,-8.0,23,GER
4f627629,7,593,6.6,6,6,1,13,4,13,-9,6.6,7.6,-1.0,23,GER
501055d8,24,1386,15.4,20,2,4,1,41,17,24,32.6,17.4,15.2,23,GER
50871bcc,14,464,5.2,2,1,12,1,6,8,-2,8.2,7.5,0.7,23,GER
5154b2ba,6,276,3.1,3,2,3,17,2,6,-4,2.7,4.2,-1.5,23,GER
526ea7cc,29,1957,21.7,22,15,7,0,29,39,-10,26.4,31.1,-4.7,23,GER
52afb588,8,182,2.0,1,0,7,2,2,6,-4,0.6,4.3,-3.6,23,GER
53070b63,4,82,0.9,1,0,3,4,1,2,-1,0.8,1.6,-0.8,23,GER
5360a956,1,19,0.2,0,0,1,0,1,0,1,0.1,0.3,-0.2,23,GER
5458f670,7,184,2.0,2,0,5,8,5,2,3,3.8,3.0,0.7,23,GER
54b4dc4e,25,1544,17.2,17,7,8,7,25,26,-1,27.2,23.5,3.7,23,GER
54e4866f,33,2408,26.8,30,3,3,0,45,26,19,40.0,33.2,6.8,23,GER
5521f419,29,1286,14.3,16,0,13,3,21,17,4,19.3,18.2,1.1,23,GER
554bcc91,18,1440,16.0,18,11,0,0,18,32,-14,13.8,28.7,-15.0,23,GER
555d5edd,25,977,10.9,9,2,16,4,19,20,-1,14.4,12.8,1.6,23,GER
56413b1f,10,493,5.5,4,0,6,0,7,10,-3,7.4,8.6,-1.2,23,GER
56e6a1c9,1,8,0.1,0,0,1,3,0,0,0,0.4,0.2,0.1,23,GER
5762be5c,29,1962,21.8,22,16,7,3,29,36,-7,28.7,29.5,-0.8,23,GER
57d88cf9,31,2691,29.9,30,28,1,1,73,40,33,60.1,39.0,21.0,23,GER
57ec75bf,4,194,2.2,2,1,2,7,1,6,-5,0.5,5.1,-4.6,23,GER
582a5247,28,1838,20.4,20,12,8,1,26,36,-10,20.3,35.1,-14.7,23,GER
591477c9,15,627,7.0,7,6,8,14,4,14,-10,6.8,12.5,-5.7,23,GER
59e4b92e,33,2882,32.0,33,28,0,0,49,32,17,34.4,39.5,-5.1,23,GER
5ad50391,30,2170,24.1,24,19,6,2,45,32,13,45.2,27.7,17.4,23,GER
5c4bf6ba,26,2340,26.0,26,26,0,1,37,39,-2,33.9,38.4,-4.5,23,GER
5c50fdbc,22,529,5.9,1,0,21,2,13,8,5,10.8,10.4,0.5,23,GER
5c899683,3,64,0.7,0,0,3,20,2,0,2,2.2,1.0,1.2,23,GER
5d4f7d61,14,941,10.5,10,6,4,0,16,21,-5,16.4,17.8,-1.4,23,GER
5d8e331f,32,2816,31.3,32,26,0,0,47,39,8,43.9,43.3,0.5,23,GER
5dc15574,13,206,2.3,0,0,13,7,4,4,0,2.9,2.3,0.6,23,GER
5ddb8f9f,23,1236,13.7,14,5,9,4,21,22,-1,15.9,20.6,-4.7,23,GER
5e080f73,10,318,3.5,0,0,10,2,6,9,-3,4.8,8.4,-3.6,23,GER
5e66fa06,34,2934,32.6,34,27,0,0,44,54,-10,44.6,44.0,0.7,23,GER
603cb947,32,2386,26.5,26,15,6,1,39,45,-6,36.5,39.3,-2.8,23,GER
610aa1e9,16,1123,12.5,13,11,3,6,21,24,-3,20.3,18.3,2.0,23,GER
61590953,19,1286,14.3,14,9,5,4,25,32,-7,22.3,24.3,-2.0,23,GER
6190474d,26,653,7.3,4,0,22,8,12,12,0,11.2,12.7,-1.5,23,GER
626fab5f,3,176,2.0,2,0,1,8,2,6,-4,1.0,3.9,-2.9,23,GER
62ab9184,29,1866,20.7,22,12,7,0,37,25,12,34.3,27.1,7.2,23,GER
62c7067a,2,39,0.4,0,0,2,6,0,1,-1,0.9,1.3,-0.4,23,GER
635f2732,21,1050,11.7,10,3,11,3,13,23,-10,12.4,22.2,-9.9,23,GER
638a4d71,34,2852,31.7,34,19,0,0,41,57,-16,37.8,47.4,-9.6,23,GER
65857fdf,12,493,5.5,6,1,6,4,5,10,-5,7.8,9.299999999999999,-1.6,23,GER
65bf7e2b,1,1,0.0,0,0,1,6,0,0,0,0.0,0.0,0.0,23,GER
66385c46,2,9,0.1,0,0,2,2,4,0,4,1.1,0.2,0.9,23,GER
663e080e,26,2340,26.0,26,26,0,7,48,29,19,49.3,27.0,22.3,23,GER
677da306,19,1450,16.1,16,14,3,1,18,27,-9,17.1,23.3,-6.3,23,GER
689c9cf4,20,1134,12.6,12,7,8,6,19,30,-11,15.3,24.2,-8.9,23,GER
691bef82,4,134,1.5,1,1,3,15,3,5,-2,2.8,3.6,-0.8,23,GER
69374ff5,16,554,6.2,3,3,13,11,11,17,-6,8.4,10.7,-2.4,23,GER
697dc00a,5,227,2.5,3,0,2,10,3,5,-2,2.4,4.0,-1.6,23,GER
699fb8db,11,795,8.8,8,3,3,10,10,19,-9,10.8,19.7,-8.9,23,GER
6a52a6c6,1,25,0.3,0,0,1,4,0,0,0,0.0,0.6,-0.6,23,GER
6b8887c2,30,1596,17.7,17,3,13,1,25,24,1,25.0,19.5,5.6,23,GER
6bd5cd5d,32,2873,31.9,32,31,0,1,49,32,17,35.0,39.1,-4.2,23,GER
6c731625,16,247,2.7,0,0,16,4,3,10,-7,2.2,6.5,-4.3,23,GER
6ce43701,26,1141,12.7,11,4,15,3,32,23,9,28.5,18.4,10.1,23,GER
6e17c802,11,672,7.5,10,1,1,1,7,17,-10,8.3,10.9,-2.6,23,GER
6ec6fde0,28,1950,21.7,21,14,7,3,22,29,-7,26.8,30.6,-3.8,23,GER
6ecbddf6,23,1130,12.6,13,1,10,3,20,20,0,13.4,20.2,-6.8,23,GER
6f8cd6d0,30,2513,27.9,28,21,2,1,42,41,1,42.0,40.8,1.1,23,GER
706a60e1,3,95,1.1,1,0,2,7,1,3,-2,0.6,1.2,-0.7,23,GER
70dcf94d,32,2187,24.3,30,0,2,0,35,26,9,25.4,27.3,-1.9,23,GER
71ec39ef,33,2944,32.7,33,29,0,0,41,65,-24,38.9,58.0,-19.1,23,GER
7242b495,26,1302,14.5,14,7,12,6,23,13,10,15.0,16.6,-1.6,23,GER
72984eee,11,463,5.1,5,0,6,4,4,12,-8,5.1,8.8,-3.7,23,GER
73000a79,12,344,3.8,4,0,8,17,9,9,0,6.0,4.5,1.4,23,GER
74f2e748,34,2708,30.1,32,16,2,0,50,40,10,46.3,36.7,9.6,23,GER
76b2817e,1,61,0.7,1,0,0,1,1,2,-1,1.1,0.8,0.3,23,GER
76fa965f,25,1309,14.5,15,2,10,6,23,28,-5,18.1,23.5,-5.4,23,GER
778ccc44,4,72,0.8,1,0,3,12,0,3,-3,1.1,0.8,0.3,23,GER
779aa25c,1,20,0.2,0,0,1,0,0,0,0,0.5,0.9,-0.4,23,GER
792ffa71,12,132,1.5,0,0,12,6,2,2,0,2.5,1.0,1.5,23,GER
79c90e45,26,1665,18.5,17,12,9,2,22,26,-4,25.2,22.0,3.1,23,GER
79ca3e23,13,689,7.7,9,0,4,2,11,15,-4,11.3,11.5,-0.2,23,GER
79f7302a,10,502,5.6,5,2,5,15,6,8,-2,5.8,8.3,-2.5,23,GER
7aac47fe,9,265,2.9,0,0,9,10,5,11,-6,4.1,8.6,-4.6,23,GER
7bf9400b,9,696,7.7,8,7,1,1,14,19,-5,10.3,15.0,-4.6,23,GER
7c56da38,25,1897,21.1,20,15,5,0,44,28,16,43.4,22.3,21.1,23,GER
7cd6badb,29,1734,19.3,20,1,9,2,33,30,3,29.7,31.1,-1.4,23,GER
7d31f1cb,5,251,2.8,3,0,2,4,4,2,2,4.6,3.5,1.1,23,GER
7d3e7da6,3,270,3.0,3,3,0,30,15,2,13,7.6,3.3,4.4,23,GER
7d450ed3,28,1685,18.7,19,9,9,5,37,21,16,33.9,20.9,13.0,23,GER
7e12a98d,9,663,7.4,7,6,2,10,9,13,-4,9.0,10.6,-1.6,23,GER
7e82a78f,9,410,4.6,4,1,5,3,3,13,-10,5.9,8.5,-2.6,23,GER
7ec723b7,4,88,1.0,1,0,3,7,1,3,-2,1.7,1.3,0.4,23,GER
7ed08d5c,14,579,6.4,4,2,10,16,13,10,3,14.3,7.3,7.1,23,GER
7f609bfc,1,18,0.2,1,0,0,2,0,0,0,0.0,0.0,0.0,23,GER
7f73bdf4,11,483,5.4,5,3,6,1,4,11,-7,4.4,10.9,-6.5,23,GER
7fa4e703,22,625,6.9,4,0,18,6,21,13,8,16.4,11.8,4.6,23,GER
809940aa,27,1366,15.2,16,3,11,0,18,33,-15,17.7,25.8,-8.0,23,GER
80f252f6,1,11,0.1,0,0,1,9,0,0,0,0.9,0.5,0.4,23,GER
80f36c88,22,794,8.8,6,1,16,9,13,13,0,12.5,11.5,1.0,23,GER
815c314f,31,2709,30.1,31,27,0,0,40,62,-22,37.0,52.2,-15.2,23,GER
826e8b63,10,694,7.7,8,3,2,0,11,13,-2,11.7,10.0,1.7,23,GER
829aa60c,22,417,4.6,1,0,21,9,16,8,8,11.5,5.2,6.3,23,GER
834d0be5,20,331,3.7,2,1,18,9,5,9,-4,6.1,3.5,2.6,23,GER
83b9c48f,4,146,1.6,2,0,2,1,0,5,-5,1.0,5.1,-4.1,23,GER
83e1f40e,19,701,7.8,6,0,13,7,11,14,-3,13.7,10.9,2.8,23,GER
857a5abe,30,2395,26.6,26,22,4,2,43,40,3,36.8,41.9,-5.1,23,GER
8593f88c,33,2748,30.5,31,28,2,0,46,40,6,43.2,43.6,-0.4,23,GER
861e0116,19,1043,11.6,11,5,8,3,12,23,-11,12.7,24.0,-11.4,23,GER
863ff1ee,32,1823,20.3,21,8,11,1,21,40,-19,23.0,28.1,-5.1,23,GER
86574238,30,2608,29.0,30,18,0,0,41,49,-8,43.0,45.3,-2.4,23,GER
86adbcc7,14,478,5.3,6,1,8,12,5,9,-4,4.9,6.9,-2.0,23,GER
86c75897,30,2449,27.2,28,24,2,2,39,58,-19,34.0,54.2,-20.2,23,GER
86e119e0,32,2767,30.7,32,24,0,0,53,44,9,46.8,45.3,1.5,23,GER
87436846,34,3060,34.0,34,34,0,0,49,54,-5,47.9,42.6,5.3,23,GER
8778c910,12,1080,12.0,12,12,0,0,36,11,25,27.6,11.4,16.2,23,GER
8779ddf8,11,395,4.4,4,0,7,0,9,10,-1,8.4,6.6,1.9,23,GER
877bc844,34,2631,29.2,31,16,3,0,34,60,-26,34.7,51.9,-17.2,23,GER
8872ed17,20,691,7.7,4,2,16,4,13,11,2,11.8,10.6,1.2,23,GER
88d4144a,17,849,9.4,7,4,10,14,9,15,-6,11.5,17.4,-5.9,23,GER
88e357ef,34,1941,21.6,22,9,12,0,59,21,38,49.0,21.9,27.1,23,GER
89b3bc5e,2,71,0.8,0,0,2,4,2,2,0,1.9,2.4,-0.5,23,GER
8a6ab963,1,90,1.0,1,1,0,10,1,2,-1,2.5,0.4,2.1,23,GER
8b6e0db2,3,94,1.0,1,0,2,0,0,1,-1,2.1,1.3,0.8,23,GER
8bf58a80,1,46,0.5,0,0,1,2,1,2,-1,0.7,0.8,-0.1,23,GER
8ce30c57,6,238,2.6,3,0,3,3,2,3,-1,2.7,4.7,-2.0,23,GER
8e235926,30,2150,23.9,27,2,3,1,37,26,11,38.5,30.6,7.9,23,GER
8eb55dbb,34,2554,28.4,33,4,1,0,41,32,9,29.9,36.1,-6.3,23,GER
8f056768,22,1506,16.7,16,12,6,5,40,17,23,34.8,16.4,18.4,23,GER
8f0f2230,21,976,10.8,10,4,11,5,12,28,-16,12.0,21.4,-9.4,23,GER
8f325097,5,100,1.1,0,0,5,10,2,2,0,2.8,1.9,0.9,23,GER
8fe2a392,33,2970,33.0,33,33,0,0,54,48,6,49.4,49.6,-0.2,23,GER
8ff2354e,31,1557,17.3,17,4,14,1,33,21,12,31.8,17.6,14.2,23,GER
90c1f9a4,2,26,0.3,0,0,2,9,1,0,1,0.5,1.1,-0.6,23,GER
90d88154,1,90,1.0,1,1,0,4,2,1,1,2.1,3.4,-1.3,23,GER
923f4dda,22,1646,18.3,20,11,2,1,24,33,-9,25.2,24.3,1.0,23,GER
92432bc6,31,1430,15.9,15,3,16,2,31,18,13,30.3,16.6,13.7,23,GER
924f9191,18,1454,16.2,17,12,1,0,26,20,6,26.3,23.8,2.5,23,GER
92a16062,29,2019,22.4,23,14,6,4,29,33,-4,30.2,27.3,3.0,23,GER
92d83c27,32,1835,20.4,21,7,11,1,35,35,0,32.2,29.9,2.2,23,GER
934e1968,31,2444,27.2,28,17,3,0,51,32,19,52.5,31.5,21.0,23,GER
93cba339,10,285,3.2,2,0,8,5,4,11,-7,5.1,8.3,-3.2,23,GER
94302c52,29,2559,28.4,28,28,1,0,44,45,-1,40.2,35.3,5.0,23,GER
943b9602,1,1,0.0,0,0,1,2,0,0,0,0.0,0.7,-0.7,23,GER
94c18565,32,2344,26.0,31,5,1,0,37,38,-1,36.3,31.3,5.0,23,GER
95bb6ddc,19,1063,11.8,10,4,9,3,24,19,5,22.3,12.9,9.4,23,GER
9642c929,8,512,5.7,5,4,3,7,6,12,-6,6.7,7.8,-1.1,23,GER
9662c9ec,23,1029,11.4,11,4,12,7,8,19,-11,10.3,19.8,-9.5,23,GER
97d545ae,24,1981,22.0,22,20,2,0,29,30,-1,33.8,32.9,0.9,23,GER
99f7e9aa,12,333,3.7,3,1,9,16,7,8,-1,7.8,4.6,3.2,23,GER
9a2e0ccc,30,1482,16.5,16,2,14,3,28,26,2,26.8,23.7,3.1,23,GER
9a2e3a23,18,1128,12.5,16,2,2,1,18,27,-9,12.2,23.0,-10.8,23,GER
9ab16552,18,1306,14.5,15,10,3,9,17,23,-6,17.1,20.3,-3.2,23,GER
9b688ae1,2,152,1.7,1,1,1,32,2,3,-1,2.4,4.0,-1.6,23,GER
9ceb7642,12,377,4.2,3,0,9,4,3,13,-10,4.2,12.2,-8.0,23,GER
9dff291c,1,45,0.5,0,0,1,10,1,3,-2,0.9,0.7,0.3,23,GER
9ec9c8b6,18,839,9.3,8,4,10,8,11,16,-5,11.9,14.6,-2.8,23,GER
9efa1d25,32,2740,30.4,32,22,0,0,55,43,12,47.8,36.7,11.0,23,GER
9f77012e,32,2514,27.9,31,15,1,0,23,52,-29,31.1,43.1,-12.0,23,GER
9f941969,34,3060,34.0,34,34,0,0,40,72,-32,40.0,65.7,-25.7,23,GER
9ff8ec4a,6,69,0.8,0,0,6,7,1,1,0,1.4,0.3,1.0,23,GER
a1257b5e,1,90,1.0,1,1,0,7,2,3,-1,0.4,1.5,-1.0,23,GER
a167537f,32,2397,26.6,29,12,3,0,67,28,39,55.8,29.0,26.8,23,GER
a2a85828,23,584,6.5,3,0,20,10,12,11,1,10.6,10.7,0.0,23,GER
a2b1ed42,4,95,1.1,1,0,3,0,0,3,-3,0.5,1.7,-1.2,23,GER
a396fb61,29,2178,24.2,23,21,6,1,30,46,-16,29.7,46.2,-16.5,23,GER
a3ddb1b9,3,46,0.5,0,0,3,1,2,7,-5,0.6,1.2,-0.6,23,GER
a45241d5,1,22,0.2,0,0,1,2,0,1,-1,0.0,1.1,-1.1,23,GER
a4effc55,17,1271,14.1,14,11,3,5,18,26,-8,19.8,21.7,-1.9,23,GER
a53b661f,19,1416,15.7,17,6,2,0,21,25,-4,19.5,24.9,-5.4,23,GER
a5ae8f8e,29,2266,25.2,25,23,4,0,42,50,-8,31.4,39.1,-7.7,23,GER
a5ec3ede,19,1132,12.6,14,10,5,11,17,19,-2,16.7,17.9,-1.2,23,GER
a65ce836,27,1900,21.1,20,17,7,5,55,30,25,46.4,26.9,19.5,23,GER
a6c58494,17,1398,15.5,17,6,0,0,17,26,-9,19.5,18.4,1.1,23,GER
a70b8345,29,2610,29.0,29,29,0,0,44,27,17,31.3,35.1,-3.8,23,GER
a73c8f95,33,2871,31.9,32,30,1,0,52,47,5,49.5,39.7,9.7,23,GER
a8567629,28,1659,18.4,19,11,9,4,33,28,5,25.1,22.9,2.2,23,GER
a8ee54ad,24,1460,16.2,17,12,7,4,37,21,16,28.0,17.7,10.2,23,GER
a9142dc3,11,191,2.1,1,0,10,19,5,2,3,3.3,1.9,1.4,23,GER
a92ab7be,34,3060,34.0,34,34,0,0,51,44,7,48.0,48.8,-0.8,23,GER
a93b6f4e,16,1196,13.3,13,10,3,11,19,14,5,14.0,14.0,0.0,23,GER
aad48be9,27,2077,23.1,23,18,4,4,35,42,-7,26.5,38.0,-11.5,23,GER
ab096c6f,1,25,0.3,0,0,1,3,0,0,0,0.0,0.6,-0.6,23,GER
ab3f1bdf,22,1863,20.7,22,17,0,10,27,42,-15,23.8,32.5,-8.7,23,GER
ab5b7dc1,33,2598,28.9,30,20,3,0,29,60,-31,34.6,44.2,-9.6,23,GER
ab700320,30,1960,21.8,24,7,6,3,23,44,-21,18.4,37.1,-18.7,23,GER
ad00b1a8,31,2420,26.9,30,18,1,0,34,38,-4,33.1,33.4,-0.3,23,GER
ad3389d5,33,2969,33.0,33,32,0,0,56,47,9,48.9,42.3,6.6,23,GER
ae44e8e2,23,1282,14.2,15,4,8,0,32,16,16,28.6,11.6,17.0,23,GER
ae7058f9,21,1803,20.0,21,18,0,5,30,24,6,28.7,22.4,6.3,23,GER
ae9b998d,2,4,0.0,0,0,2,4,0,1,-1,0.4,0.7,-0.3,23,GER
aeed5c06,33,2699,30.0,33,16,0,0,49,39,10,44.9,35.8,9.1,23,GER
af0d79a9,25,1955,21.7,22,16,3,0,31,38,-7,31.9,27.7,4.3,23,GER
af104654,33,2970,33.0,33,33,0,1,40,68,-28,37.4,56.6,-19.2,23,GER
af842091,22,1726,19.2,21,14,1,5,22,38,-16,22.0,28.8,-6.7,23,GER
b06a7ae9,1,29,0.3,0,0,1,1,2,0,2,1.2,1.2,0.0,23,GER
b116c6e3,24,791,8.8,7,2,17,5,17,16,1,14.2,10.1,4.1,23,GER
b1cd37e6,1,74,0.8,1,0,0,0,1,5,-4,0.8,3.5,-2.7,23,GER
b3325a30,32,2021,22.5,24,5,8,0,26,44,-18,25.5,39.1,-13.5,23,GER
b3b7f5a6,6,86,1.0,0,0,6,25,1,5,-4,1.2,2.1,-0.9,23,GER
b4705807,18,1318,14.6,15,7,3,1,19,21,-2,21.3,17.9,3.4,23,GER
b492126a,27,1291,14.3,16,2,11,1,21,27,-6,20.2,20.4,-0.1,23,GER
b4c816a9,23,1417,15.7,15,4,8,1,17,24,-7,16.7,24.1,-7.4,23,GER
b56dd813,7,630,7.0,7,7,0,27,15,12,3,12.9,9.9,3.0,23,GER
b684a484,31,1358,15.1,16,1,15,2,20,15,5,17.6,19.2,-1.6,23,GER
b74277a0,19,1075,11.9,11,5,8,7,37,18,19,28.2,16.1,12.1,23,GER
b77f44a4,23,1248,13.9,13,13,10,10,27,29,-2,22.0,25.1,-3.1,23,GER
b825a650,30,1372,15.2,16,5,14,3,28,20,8,28.3,16.2,12.1,23,GER
b8e740fb,24,576,6.4,3,0,21,8,17,10,7,14.3,7.6,6.7,23,GER
b90c4a43,1,90,1.0,1,1,0,33,1,1,0,0.2,1.9,-1.8,23,GER
b9ae8560,24,1087,12.1,11,3,13,9,16,22,-6,15.6,18.0,-2.4,23,GER
ba115a40,19,1225,13.6,15,2,4,0,45,14,31,33.5,16.2,17.3,23,GER
bbd79358,11,213,2.4,0,0,11,3,5,4,1,4.9,6.4,-1.6,23,GER
bbd86530,24,1290,14.3,13,8,11,3,27,21,6,23.8,17.6,6.2,23,GER
bc249af8,18,826,9.2,8,1,10,0,10,21,-11,11.8,17.6,-5.8,23,GER
bc6bd723,29,1774,19.7,20,6,9,1,27,27,0,28.7,25.1,3.6,23,GER
bcb2ccd8,6,540,6.0,6,6,0,0,10,10,0,9.6,8.8,0.8,23,GER
bd142efb,33,2487,27.6,28,24,5,0,44,45,-1,39.6,36.8,2.9,23,GER
bd527260,29,1088,12.1,8,2,21,4,20,22,-2,19.7,16.0,3.7,23,GER
bd6351cd,15,1012,11.2,11,5,4,1,28,16,12,23.1,15.0,8.1,23,GER
bd7d2e6d,8,562,6.2,6,3,2,9,7,10,-3,8.2,8.4,-0.2,23,GER
bdedffac,2,180,2.0,2,2,0,23,6,2,4,3.8,1.4,2.4,23,GER
be42a291,18,449,5.0,4,0,14,8,8,13,-5,6.7,11.0,-4.2,23,GER
beb882a8,31,2451,27.2,27,17,4,1,36,34,2,33.1,40.9,-7.8,23,GER
bee0bab1,8,85,0.9,1,0,7,8,0,1,-1,1.5,2.0,-0.5,23,GER
bf075f6b,19,1002,11.1,10,2,9,4,16,16,0,15.9,17.6,-1.6,23,GER
c05f2f8c,23,1766,19.6,23,13,0,4,26,40,-14,24.9,32.5,-7.6,23,GER
c0b3669f,32,2631,29.2,31,14,1,0,51,39,12,45.4,35.1,10.3,23,GER
c149016b,33,2922,32.5,33,30,0,0,43,54,-11,45.7,41.9,3.8,23,GER
c18d22f5,5,206,2.3,2,1,3,19,3,7,-4,2.5,4.4,-1.9,23,GER
c1b7847c,21,1468,16.3,17,7,4,1,25,20,5,26.8,18.8,8.0,23,GER
c2009df3,32,2824,31.4,32,30,0,0,48,50,-2,46.0,39.2,6.9,23,GER
c2211709,32,2856,31.7,32,31,0,0,46,52,-6,45.3,40.8,4.5,23,GER
c3ee18ef,7,476,5.3,6,2,1,2,19,3,16,16.0,4.2,11.8,23,GER
c455a2b2,27,1710,19.0,20,4,7,0,27,27,0,27.2,22.9,4.2,23,GER
c4987edc,28,2254,25.0,26,24,2,2,40,28,12,27.9,29.2,-1.3,23,GER
c631f952,15,1290,14.3,15,14,0,0,20,18,2,21.5,21.1,0.4,23,GER
c64c01fc,15,1009,11.2,11,4,4,0,17,15,2,16.4,16.1,0.3,23,GER
c6608135,1,27,0.3,0,0,1,0,0,0,0,0.1,1.1,-1.1,23,GER
c68b1b13,1,58,0.6,1,0,0,2,0,1,-1,0.2,1.0,-0.8,23,GER
c68da769,32,1078,12.0,10,2,22,1,13,21,-8,17.7,18.1,-0.5,23,GER
c691bfe2,25,1425,15.8,18,4,7,1,43,19,24,36.3,16.9,19.3,23,GER
c6cf860f,2,17,0.2,0,0,2,3,0,0,0,0.0,0.1,-0.1,23,GER
c8b3a472,7,71,0.8,0,0,7,4,3,1,2,2.0,1.2,0.7,23,GER
c8c60119,7,398,4.4,5,2,2,8,10,12,-2,8.3,9.6,-1.3,23,GER
c967f6b8,9,471,5.2,4,4,5,15,8,5,3,7.7,8.9,-1.1,23,GER
ca618d23,26,1503,16.7,16,4,10,0,22,23,-1,19.7,27.8,-8.1,23,GER
ca8033cb,15,907,10.1,10,8,5,6,14,9,5,17.3,8.7,8.6,23,GER
caffaf5a,29,2553,28.4,28,27,1,2,23,54,-31,31.8,45.5,-13.7,23,GER
cb11b429,26,1648,18.3,23,1,3,0,34,26,8,28.6,25.1,3.4,23,GER
cb64672e,2,25,0.3,0,0,2,8,0,1,-1,0.2,0.2,0.0,23,GER
cb6d81b3,3,49,0.5,0,0,3,9,1,2,-1,0.4,2.4,-2.0,23,GER
cbac6ec9,19,1710,19.0,19,19,0,14,22,34,-12,25.4,24.6,0.8,23,GER
cc83b74d,13,402,4.5,4,1,9,2,6,15,-9,5.1,8.8,-3.7,23,GER
cc86b9a3,27,1728,19.2,22,7,5,1,48,23,25,40.2,24.8,15.4,23,GER
cc971106,1,3,0.0,0,0,1,12,0,0,0,0.0,0.0,0.0,23,GER
cd59b9df,27,2430,27.0,27,27,0,2,68,32,36,58.2,33.3,24.9,23,GER
cd61c7af,1,6,0.1,0,0,1,0,0,0,0,0.1,0.0,0.0,23,GER
cd682b6b,1,17,0.2,0,0,1,8,0,2,-2,0.0,1.0,-1.0,23,GER
cd82452e,7,391,4.3,4,3,3,0,6,6,0,4.7,8.2,-3.5,23,GER
ce17b5eb,33,2970,33.0,33,33,0,0,57,51,6,51.9,41.5,10.4,23,GER
ce81d82d,1,1,0.0,0,0,1,10,0,0,0,0.0,0.0,0.0,23,GER
d01bbb6f,33,2424,26.9,30,5,3,0,45,34,11,41.0,34.7,6.3,23,GER
d1273f09,13,290,3.2,2,1,11,20,2,10,-8,1.7,7.8,-6.1,23,GER
d1b49282,24,833,9.3,8,1,16,3,15,16,-1,10.2,17.8,-7.6,23,GER
d1db4b83,3,63,0.7,0,0,3,1,0,2,-2,0.6,2.5,-1.8,23,GER
d2416c2e,19,411,4.6,3,0,16,5,13,3,10,10.5,5.8,4.7,23,GER
d248cd8f,29,2348,26.1,27,25,2,0,71,29,42,56.2,27.4,28.8,23,GER
d28339cb,15,1350,15.0,15,15,0,18,23,23,0,22.2,20.6,1.6,23,GER
d2c580ce,22,682,7.6,8,2,14,9,13,9,4,11.8,9.5,2.3,23,GER
d3d77413,6,159,1.8,1,0,5,9,2,5,-3,2.9,2.4,0.5,23,GER
d4a2533d,6,271,3.0,3,0,3,6,2,5,-3,2.1,4.5,-2.4,23,GER
d6862409,30,1691,18.799999999999997,21,4,9,2,29,31,-2,24.0,32.3,-8.3,23,GER
d6e53a3a,31,2403,26.7,27,22,4,1,67,27,40,55.4,27.8,27.5,23,GER
d75f3980,11,676,7.5,9,3,2,0,3,17,-14,9.2,13.4,-4.2,23,GER
d781d855,26,2042,22.7,24,17,2,0,59,25,34,47.9,25.0,22.9,23,GER
d82a310a,2,17,0.2,0,0,2,2,0,0,0,1.2,0.0,1.2,23,GER
db401046,34,3060,34.0,34,34,0,0,57,48,9,51.3,51.3,0.0,23,GER
db4ed67b,9,337,3.7,4,1,5,6,10,3,7,7.7,4.0,3.7,23,GER
dc366c36,11,990,11.0,11,11,0,15,14,22,-8,10.5,19.8,-9.4,23,GER
dc62fbee,25,1629,18.1,22,4,3,1,26,27,-1,18.9,23.5,-4.6,23,GER
dcfb17f4,26,1435,15.9,16,1,10,1,29,17,12,26.3,15.7,10.6,23,GER
dd2e62da,13,513,5.7,6,1,7,12,12,8,4,8.7,9.4,-0.7,23,GER
dd5bbe0d,7,166,1.8,0,0,7,5,1,6,-5,2.7,4.4,-1.7,23,GER
dd676a97,18,427,4.7,3,0,15,14,5,6,-1,6.2,7.8,-1.5,23,GER
de4cac2d,30,1992,22.1,23,6,7,0,30,31,-1,28.8,25.4,3.4,23,GER
de838f86,34,2617,29.1,32,11,2,0,37,59,-22,31.6,46.3,-14.7,23,GER
dee3013b,8,720,8.0,8,8,0,26,17,16,1,13.2,15.2,-2.0,23,GER
dfb6490a,21,164,1.8,0,0,21,11,6,8,-2,3.7,4.8,-1.1,23,GER
e0b113a7,29,2406,26.7,28,24,1,0,50,38,12,40.9,34.9,6.0,23,GER
e110ea4b,20,695,7.7,7,1,13,10,8,12,-4,9.2,14.6,-5.3,23,GER
e12b0b5b,27,1414,15.7,19,1,8,1,27,29,-2,20.9,19.9,1.0,23,GER
e162b013,10,585,6.5,7,5,3,6,5,9,-4,11.0,8.8,2.2,23,GER
e18098de,18,993,11.0,12,6,6,7,14,23,-9,12.8,17.1,-4.3,23,GER
e1830c52,1,1,0.0,0,0,1,7,0,0,0,0.0,0.0,0.0,23,GER
e27da244,15,1350,15.0,15,15,0,2,23,28,-5,19.4,23.2,-3.8,23,GER
e280527c,15,628,7.0,7,2,8,3,22,3,19,16.9,3.7,13.2,23,GER
e33c06cf,29,2118,23.5,23,20,6,2,61,33,28,52.6,32.8,19.8,23,GER
e3d3fbeb,4,38,0.4,0,0,4,8,1,2,-1,2.2,1.7,0.5,23,GER
e52d33d0,1,8,0.1,0,0,1,1,0,0,0,0.1,0.3,-0.2,23,GER
e547d3cf,8,271,3.0,2,1,6,7,3,6,-3,4.2,6.2,-2.0,23,GER
e5649a78,32,2599,28.9,29,18,3,0,33,62,-29,35.0,55.6,-20.6,23,GER
e5a35ae9,18,523,5.8,4,0,14,12,11,12,-1,9.9,11.4,-1.5,23,GER
e5d85da8,33,2239,24.9,27,1,6,1,37,36,1,34.6,30.2,4.4,23,GER
e61bdd69,7,398,4.4,6,0,1,3,3,8,-5,3.6,4.5,-1.0,23,GER
e6c43eec,23,1180,13.1,11,9,12,9,15,19,-4,18.2,22.4,-4.2,23,GER
e717705a,29,2357,26.2,26,23,3,3,27,52,-25,28.7,47.1,-18.4,23,GER
e75129bd,1,1,0.0,0,0,1,11,0,0,0,0.0,0.0,0.0,23,GER
e79269bd,20,702,7.8,7,3,13,12,14,16,-2,14.7,15.9,-1.2,23,GER
e7f3e8a7,20,890,9.9,9,1,11,0,9,12,-3,10.1,14.2,-4.1,23,GER
e7fcf289,17,1090,12.1,11,5,6,0,22,15,7,20.0,12.2,7.8,23,GER
e82adcab,25,1654,18.4,19,11,6,1,32,25,7,29.4,20.4,9.0,23,GER
e92cd3f7,1,6,0.1,0,0,1,1,0,0,0,0.2,0.0,0.2,23,GER
ea003d07,1,4,0.0,0,0,1,1,0,0,0,0.2,0.0,0.2,23,GER
ea0893d6,13,353,3.9,3,0,10,2,3,2,1,4.2,5.1,-0.9,23,GER
ea42c03f,20,1426,15.8,14,13,6,4,21,36,-15,16.7,30.1,-13.4,23,GER
eac044ad,21,933,10.4,8,2,13,6,20,16,4,18.0,12.2,5.8,23,GER
eb6e14be,23,1679,18.7,20,9,3,0,24,32,-8,22.1,27.1,-5.0,23,GER
ebb32f3a,1,20,0.2,0,0,1,1,0,0,0,0.2,0.6,-0.4,23,GER
ed79b7d3,30,2366,26.3,30,15,0,0,32,47,-15,27.3,41.0,-13.7,23,GER
ee644761,11,945,10.5,11,10,0,0,14,10,4,12.6,12.8,-0.2,23,GER
f0a37d36,28,2315,25.7,28,18,0,0,22,54,-32,27.8,41.7,-13.9,23,GER
f1bc3876,1,5,0.1,0,0,1,1,0,0,0,0.0,0.1,-0.1,23,GER
f1e855eb,5,379,4.2,5,1,0,0,1,5,-4,4.7,5.3,-0.6,23,GER
f24ea523,22,1246,13.8,15,3,7,10,17,23,-6,17.1,17.9,-0.7,23,GER
f26834c7,31,2539,28.2,28,17,3,0,43,48,-5,38.4,45.5,-7.1,23,GER
f27680d9,19,1477,16.4,17,8,2,3,15,37,-22,17.5,34.8,-17.3,23,GER
f2dd9a21,13,961,10.7,12,7,1,1,15,17,-2,11.7,20.0,-8.3,23,GER
f36c432f,17,892,9.9,8,5,9,2,16,20,-4,13.8,18.4,-4.6,23,GER
f4ec4fd0,16,467,5.2,5,0,11,13,5,12,-7,6.1,7.8,-1.7,23,GER
f503ef6e,7,146,1.6,0,0,7,6,0,3,-3,1.4,4.3,-2.8,23,GER
f521b80a,34,3060,34.0,34,34,0,0,51,44,7,48.0,48.8,-0.8,23,GER
f582d5c1,1,1,0.0,0,0,1,18,0,0,0,0.0,0.0,0.0,23,GER
f5c4fd91,1,14,0.2,0,0,1,4,0,0,0,0.9,0.0,0.9,23,GER
f631c17f,15,268,3.0,1,0,14,3,11,7,4,7.0,8.0,-0.9,23,GER
f67c9d29,25,2216,24.6,25,23,0,4,37,26,11,27.6,34.7,-7.1,23,GER
f68b64fc,26,1688,18.8,19,10,7,0,28,29,-1,27.6,27.1,0.4,23,GER
f6bdc830,15,748,8.399999999999999,8,7,7,16,8,18,-10,9.799999999999999,13.100000000000001,-3.2,23,GER
f76022e7,23,890,9.9,9,2,14,6,14,19,-5,14.7,16.4,-1.7,23,GER
f7aa75bd,31,2402,26.7,29,22,2,1,34,58,-24,29.5,47.3,-17.8,23,GER
f86ad3f5,30,2594,28.8,30,27,0,0,45,54,-9,35.1,42.3,-7.2,23,GER
f86cd5df,1,8,0.1,0,0,1,1,0,0,0,0.1,0.1,0.0,23,GER
f93e6e94,27,277,3.1,0,0,27,7,7,8,-1,4.3,7.5,-3.2,23,GER
f9446dcd,5,272,3.0,2,2,3,0,3,6,-3,2.8,7.4,-4.6,23,GER
f972644c,29,1836,20.4,21,7,8,1,30,51,-21,24.7,38.7,-14.0,23,GER
f9dfb7ae,7,358,4.0,3,3,4,12,2,13,-11,4.0,9.7,-5.7,23,GER
fa4cabd1,4,360,4.0,4,4,0,17,9,11,-2,6.5,11.1,-4.6,23,GER
fa661778,25,1570,17.4,17,11,8,2,48,20,28,37.5,20.9,16.6,23,GER
fb377d11,23,1479,16.4,16,11,7,4,21,23,-2,24.5,19.8,4.6,23,GER
fbbc8e15,2,20,0.2,0,0,2,8,0,0,0,0.2,0.1,0.0,23,GER
fc3697dd,22,1321,14.7,15,2,7,3,18,22,-4,18.5,21.8,-3.3,23,GER
fc62f087,8,478,5.3,5,4,3,12,11,4,7,9.0,5.4,3.6,23,GER
fc8fcbd1,13,639,7.1,7,3,6,2,5,16,-11,4.6,15.4,-10.9,23,GER
fcb27134,24,1454,16.2,18,8,6,5,29,17,12,29.8,15.0,14.8,23,GER
fd53759d,23,869,9.7,6,2,17,0,16,11,5,15.5,10.0,5.4,23,GER
fe46e261,16,567,6.3,3,1,13,9,5,12,-7,8.3,9.7,-1.4,23,GER
fe641c1a,6,298,3.3,4,1,2,4,2,11,-9,2.2,6.3,-4.1,23,GER
ff3d391c,16,418,4.6,3,0,13,15,4,7,-3,7.6,7.3,0.3,23,GER
ff5ea0bf,3,270,3.0,3,3,0,1,3,8,-5,4.3,3.7,0.7,23,GER
ff98492b,23,1349,15.0,16,4,7,2,26,22,4,22.8,22.0,0.8,23,GER
00242715,14,1163,12.9,14,11,0,1,15,21,-6,11.7,23.2,-11.5,23,ENG
007414dd,17,567,6.3,5,0,12,2,5,9,-4,8.1,7.3,0.8,23,ENG
01962d0d,15,212,2.4,1,0,14,2,6,3,3,3.7,2.7,1.0,23,ENG
01c3aff5,19,1437,16.0,16,9,3,0,20,35,-15,17.7,28.3,-10.6,23,ENG
01ce9e70,27,1279,14.2,12,8,15,8,11,34,-23,11.0,25.6,-14.6,23,ENG
01e5f06e,12,349,3.9,2,1,10,20,5,6,-1,6.1,6.7,-0.6,23,ENG
02b29014,25,1533,17.0,17,14,8,4,18,26,-8,24.0,29.5,-5.5,23,ENG
0313a347,38,3322,36.9,37,36,1,0,49,45,4,47.7,51.1,-3.4,23,ENG
0420d84f,23,1656,18.4,20,9,3,7,15,25,-10,22.6,32.6,-10.0,23,ENG
0442183b,22,1640,18.2,19,14,3,8,13,23,-10,15.7,25.7,-10.1,23,ENG
049a888d,15,657,7.3,7,1,8,4,6,10,-4,11.2,11.7,-0.4,23,ENG
0562b7f1,35,1803,20.0,20,2,15,2,23,25,-2,20.6,23.6,-3.0,23,ENG
05e8ca6d,6,49,0.5,0,0,6,8,0,1,-1,0.2,0.4,-0.1,23,ENG
06df8256,11,905,10.1,10,10,1,7,11,9,2,14.0,12.3,1.7,23,ENG
07802f7f,35,1599,17.799999999999997,15,4,20,3,20,26,-6,24.6,26.299999999999997,-1.7000000000000002,23,ENG
089667a5,13,584,6.5,6,3,7,2,5,14,-9,6.7,13.7,-7.0,23,ENG
08eb3b58,12,458,5.1,5,2,7,4,5,10,-5,6.0,7.7,-1.7,23,ENG
0a3d6d2b,9,447,5.0,4,4,5,18,2,11,-9,3.6,10.7,-7.1,23,ENG
0a6cb1b1,12,992,11.0,11,11,1,6,13,19,-6,14.6,18.7,-4.0,23,ENG
0b33f6ad,22,1973,21.9,21,20,1,4,20,41,-21,21.6,28.2,-6.5,23,ENG
0bdda685,1,23,0.3,0,0,1,1,0,1,-1,0.4,0.4,0.0,23,ENG
0bdeb013,1,6,0.1,0,0,1,4,0,2,-2,0.2,1.1,-1.0,23,ENG
0cd31129,38,2934,32.6,33,21,5,0,30,54,-24,31.8,52.8,-20.9,23,ENG
0db5d2c8,18,1103,12.3,11,9,7,15,17,15,2,18.4,20.4,-2.0,23,ENG
0ef89a37,20,788,8.8,7,1,13,2,9,9,0,9.3,8.3,0.9,23,ENG
0f134faf,37,2803,31.1,37,10,0,0,45,40,5,43.7,39.7,4.0,23,ENG
0f7533cd,36,2475,27.5,29,11,7,1,36,40,-4,31.4,45.4,-14.0,23,ENG
10a10454,20,1016,11.3,12,3,8,7,16,15,1,15.3,17.2,-1.9,23,ENG
10d221cd,12,1080,12.0,12,12,0,26,14,22,-8,17.7,20.3,-2.6,23,ENG
10ec4169,1,8,0.1,0,0,1,5,0,0,0,0.0,0.2,-0.2,23,ENG
1137759d,5,77,0.9,0,0,5,7,0,2,-2,0.8,1.7,-1.0,23,ENG
119b9a8e,12,993,11.0,11,10,1,15,21,10,11,20.5,12.4,8.1,23,ENG
11f54bd5,6,110,1.2,0,0,6,9,0,2,-2,1.4,2.4,-1.0,23,ENG
11ff3d56,18,819,9.1,11,4,7,12,5,19,-14,6.2,14.2,-8.0,23,ENG
1265a93a,16,1244,13.8,14,12,2,0,15,17,-2,19.3,14.5,4.8,23,ENG
132a82f1,17,1363,15.1,14,9,3,1,17,24,-7,19.0,22.4,-3.3,23,ENG
1544f145,35,2636,29.3,31,16,4,0,40,33,7,38.9,40.7,-1.9,23,ENG
1598599e,19,757,8.4,7,2,12,14,12,13,-1,14.6,12.9,1.7,23,ENG
15ab5a2b,31,1465,16.3,13,8,18,6,37,16,21,32.3,17.3,15.0,23,ENG
15ea812b,38,3420,38.0,38,38,0,0,34,57,-23,45.2,65.7,-20.5,23,ENG
15f24fe7,1,45,0.5,1,0,0,0,1,0,1,0.6,0.6,0.0,23,ENG
16264a81,37,3139,34.9,34,30,3,0,62,47,15,65.3,44.9,20.4,23,ENG
169fd162,27,1130,12.6,12,1,15,2,12,18,-6,11.9,17.6,-5.7,23,ENG
16e9d0ea,19,1329,14.8,14,5,5,0,23,10,13,19.7,18.6,1.1,23,ENG
172e52d8,12,724,8.0,9,7,3,3,17,14,3,10.6,13.0,-2.5,23,ENG
17695062,12,172,1.9,0,0,12,11,3,5,-2,3.1,2.7,0.4,23,ENG
1780bb4a,26,1916,21.3,23,8,3,2,33,30,3,32.4,27.3,5.1,23,ENG
178ae8f8,22,1131,12.6,12,2,10,0,24,19,5,25.4,17.6,7.8,23,ENG
17acc2ed,2,180,2.0,2,2,0,36,2,2,0,2.7,2.1,0.6,23,ENG
18b999f4,17,764,8.5,9,1,8,3,13,10,3,11.3,11.7,-0.4,23,ENG
1971591f,21,1458,16.2,17,6,4,0,32,19,13,32.9,19.2,13.7,23,ENG
197640fd,37,3254,36.2,36,33,1,1,49,63,-14,48.5,60.1,-11.6,23,ENG
1a4ef233,20,1610,17.9,18,16,2,15,20,27,-7,20.0,27.6,-7.6,23,ENG
1b4f1169,15,734,8.2,8,4,7,20,5,8,-3,8.5,8.0,0.40000000000000013,23,ENG
1b804500,1,1,0.0,0,0,1,10,0,0,0,0.1,0.0,0.1,23,ENG
1b84dbe1,28,1502,16.7,18,10,10,4,22,25,-3,19.9,25.7,-5.8,23,ENG
1bf33a9a,24,821,9.1,8,0,16,5,12,11,1,11.0,14.1,-3.0,23,ENG
1c7012b8,37,3273,36.4,36,36,1,0,42,50,-8,48.7,48.6,0.1,23,ENG
1d5cab82,6,213,2.4,2,0,4,0,5,4,1,4.2,2.8,1.4,23,ENG
1daec722,24,1671,18.6,21,10,3,3,17,20,-3,23.6,26.0,-2.4,23,ENG
1ecb65be,20,1129,12.5,13,2,7,9,15,30,-15,13.7,24.5,-10.8,23,ENG
1f44ac21,35,2769,30.8,33,21,2,1,84,26,58,66.9,24.3,42.6,23,ENG
1fb1c435,31,1935,21.5,23,7,8,0,28,43,-15,26.4,37.5,-11.1,23,ENG
20b104bc,37,2943,32.7,34,25,3,0,34,58,-24,33.5,53.2,-19.8,23,ENG
21166ff4,7,529,5.9,6,5,1,15,9,13,-4,13.2,9.9,3.3,23,ENG
21512407,38,3341,37.1,38,31,0,0,65,31,34,70.5,37.6,32.8,23,ENG
215f3907,26,988,11.0,9,0,17,9,19,14,5,19.0,14.5,4.5,23,ENG
21a66f6a,38,3405,37.8,38,35,0,0,70,62,8,56.8,49.4,7.5,23,ENG
230f0471,19,1279,14.2,14,11,5,2,13,22,-9,16.4,24.8,-8.4,23,ENG
2389cdc2,26,1820,20.2,20,15,6,1,28,29,-1,28.7,27.4,1.3,23,ENG
24f59bb2,19,1368,15.2,14,10,5,11,17,33,-16,17.0,30.9,-13.9,23,ENG
2500cef9,38,1606,17.8,16,1,22,0,30,17,13,28.9,21.2,7.7,23,ENG
254147d4,16,710,7.9,7,2,9,10,7,14,-7,6.9,11.0,-4.1,23,ENG
2628fd2b,36,3240,36.0,36,36,0,2,53,51,2,43.5,61.7,-18.2,23,ENG
26ce2263,32,1834,20.4,22,5,10,6,19,35,-16,21.2,30.8,-9.6,23,ENG
26d3b5be,11,228,2.5,2,0,9,10,3,4,-1,3.2,6.5,-3.3,23,ENG
26f6dca8,10,252,2.8,2,1,8,28,2,5,-3,3.0,5.8,-2.7,23,ENG
27d0a506,15,1131,12.6,13,6,2,2,20,26,-6,19.4,19.9,-0.5,23,ENG
282679b4,14,280,3.1,0,0,14,2,5,5,0,6.3,4.5,1.8,23,ENG
282f75f3,36,3239,36.0,36,35,0,2,70,50,20,69.7,45.4,24.3,23,ENG
28300a16,15,1350,15.0,15,15,0,22,31,23,8,34.4,23.1,11.3,23,ENG
2886c9b5,23,618,6.9,4,0,19,5,12,6,6,9.8,8.1,1.7,23,ENG
288e1e13,18,1595,17.7,17,16,1,3,23,28,-5,24.2,28.6,-4.5,23,ENG
289601e6,35,3088,34.3,35,34,0,0,50,44,6,43.1,54.3,-11.2,23,ENG
28b40c9c,33,2897,32.2,33,31,0,0,45,44,1,38.7,52.8,-14.1,23,ENG
28d596a0,29,2565,28.5,29,28,0,7,27,33,-6,39.2,39.0,0.2,23,ENG
2928dca2,24,2096,23.3,23,22,1,11,16,28,-12,24.2,36.0,-11.8,23,ENG
2944f86f,21,848,9.4,8,0,13,6,12,11,1,12.8,15.2,-2.4,23,ENG
2964fd20,6,181,2.0,2,0,4,3,1,1,0,2.4,2.8,-0.4,23,ENG
2afc7272,28,1720,19.1,18,14,10,5,18,39,-21,15.8,31.7,-16.0,23,ENG
2b09d998,24,2156,24.0,24,23,0,0,28,36,-8,30.2,33.0,-2.9,23,ENG
2b16cb1a,25,1120,12.4,12,2,13,1,19,14,5,22.7,13.1,9.7,23,ENG
2b471f99,19,1299,14.4,17,8,2,0,14,28,-14,13.2,27.0,-13.8,23,ENG
2b622f01,15,153,1.7,0,0,15,7,6,4,2,4.0,2.4,1.7,23,ENG
2bd83368,32,1582,17.6,16,7,16,1,17,18,-1,22.5,24.6,-2.1999999999999997,23,ENG
2c44a35d,19,720,8.0,6,0,13,12,7,17,-10,8.1,13.3,-5.2,23,ENG
2c6835e5,1,15,0.2,0,0,1,3,0,0,0,0.1,0.9,-0.8,23,ENG
2ce2508a,18,512,5.7,5,1,13,16,5,7,-2,4.4,7.7,-3.4,23,ENG
2e4f5f03,34,2583,28.7,29,19,5,1,58,34,24,54.9,36.4,18.5,23,ENG
2f90f6b8,31,913,10.1,7,3,24,3,17,12,5,21.4,13.6,7.9,23,ENG
2f965a72,5,309,3.4,2,2,3,30,5,7,-2,5.3,7.5,-2.2,23,ENG
2f9e4435,19,1241,13.8,15,7,4,0,13,23,-10,17.5,25.5,-8.0,23,ENG
2fba6108,16,426,4.7,5,0,11,11,8,2,6,9.5,4.7,4.8,23,ENG
30d4a2e5,34,2655,29.5,30,27,4,0,28,46,-18,34.6,52.2,-17.6,23,ENG
30db8574,4,21,0.2,0,0,4,3,1,0,1,0.3,0.3,0.0,23,ENG
31c69ef1,26,1998,22.2,22,19,4,6,65,16,49,47.0,17.0,30.0,23,ENG
328f7d51,21,1224,13.6,13,3,8,8,13,24,-11,13.5,16.6,-3.1,23,ENG
32e8417f,11,526,5.8,6,0,5,10,11,4,7,12.5,6.6,6.0,23,ENG
32f60ed8,37,3151,35.0,36,28,1,0,38,61,-23,38.2,57.0,-18.7,23,ENG
3312f911,34,2531,28.1,30,11,4,0,33,38,-5,29.5,36.4,-6.9,23,ENG
33887998,10,855,9.5,9,9,1,13,11,14,-3,10.3,13.4,-3.2,23,ENG
35141f4c,31,2491,27.7,29,22,2,5,28,55,-27,29.6,46.9,-17.3,23,ENG
3515d404,38,3371,37.5,38,36,0,0,36,72,-36,37.5,59.8,-22.3,23,ENG
3544641e,22,555,6.2,4,0,18,11,6,10,-4,4.9,9.4,-4.5,23,ENG
35e413f1,38,3055,33.9,36,21,2,0,80,35,45,63.3,36.7,26.7,23,ENG
36c2ca73,6,540,6.0,6,6,0,21,9,17,-8,7.2,15.0,-7.7,23,ENG
3727dd3c,11,577,6.4,6,2,5,5,5,11,-6,4.5,11.299999999999999,-6.8,23,ENG
384d58d9,7,411,4.6,5,1,2,9,5,5,0,5.3,7.6,-2.3,23,ENG
38c7feef,9,335,3.7,4,0,5,4,5,7,-2,7.0,6.4,0.6,23,ENG
38ceb24a,36,2246,24.9,26,6,10,1,52,38,14,40.6,30.7,9.9,23,ENG
3925dbd6,24,2008,22.3,23,14,1,0,33,30,3,31.2,34.9,-3.7,23,ENG
39769cff,26,1960,21.8,21,17,5,11,29,53,-24,26.9,40.9,-14.0,23,ENG
3a233281,33,1967,21.9,26,4,7,0,27,32,-5,30.7,35.5,-4.8,23,ENG
3a949a25,2,157,1.7,1,1,1,22,1,1,0,3.5,3.2,0.3,23,ENG
3b8674e6,18,1500,16.7,17,10,1,0,33,24,9,26.4,19.6,6.8,23,ENG
3bb7b8b4,35,3150,35.0,35,35,0,3,89,32,57,73.3,28.3,45.1,23,ENG
3e5e4e63,12,957,10.6,11,8,1,7,7,21,-14,10.5,14.9,-4.5,23,ENG
3e9e06cb,25,2134,23.7,25,22,0,2,25,31,-6,24.6,36.0,-11.4,23,ENG
3ea50f67,34,2711,30.1,32,21,2,0,41,51,-10,39.4,50.9,-11.5,23,ENG
3eb22ec9,34,2205,24.5,24,16,10,4,61,24,37,48.0,22.9,25.1,23,ENG
3f847d95,2,180,2.0,2,2,0,12,1,5,-4,1.9,2.2,-0.2,23,ENG
4115ce4e,23,1772,19.700000000000003,21,17,2,13,16,40,-24,19.299999999999997,36.1,-16.9,23,ENG
414184f7,12,136,1.5,0,0,12,5,3,4,-1,1.7,3.8,-2.2,23,ENG
41e7ef1c,3,135,1.5,2,1,1,6,0,4,-4,1.1,4.4,-3.3,23,ENG
41f08ac8,10,321,3.6,3,0,7,9,10,4,6,7.2,4.1,3.2,23,ENG
420d7c7d,29,2054,22.8,22,21,7,4,27,48,-21,27.7,43.5,-15.8,23,ENG
422862ea,4,12,0.1,1,0,3,10,0,0,0,0.1,0.4,-0.3,23,ENG
4468ec10,33,2507,27.9,27,16,6,5,20,39,-19,28.7,44.9,-16.2,23,ENG
44781702,31,2288,25.4,26,20,5,2,44,33,11,35.4,26.3,9.1,23,ENG
44bfb6c5,35,3019,33.5,33,30,2,0,26,48,-22,32.5,51.7,-19.2,23,ENG
4506aec5,2,25,0.3,0,0,2,0,0,1,-1,0.8,0.4,0.4,23,ENG
450ab6fc,7,218,2.4,2,2,5,21,2,5,-3,2.6,4.3,-1.7,23,ENG
45963054,37,1857,20.6,19,6,18,1,24,38,-14,23.9,34.2,-10.3,23,ENG
4596da74,19,950,10.6,10,1,9,2,21,12,9,23.3,13.1,10.2,23,ENG
45db685d,32,2134,23.7,24,14,8,7,36,23,13,31.1,24.9,6.2,23,ENG
466fb2c5,38,3420,38.0,38,38,0,0,88,43,45,71.9,42.0,29.9,23,ENG
468a7a91,13,565,6.3,6,1,7,6,11,12,-1,11.6,11.9,-0.3,23,ENG
47a34c4f,5,113,1.3,1,1,4,4,2,2,0,2.6,1.3,1.4,23,ENG
4806ec67,37,3330,37.0,37,37,0,0,33,57,-24,44.8,64.7,-19.9,23,ENG
48a5a5d6,36,2789,31.0,34,16,2,0,72,33,39,59.9,35.7,24.3,23,ENG
493924a7,6,144,1.6,1,0,5,8,2,7,-5,1.4,6.8,-5.3,23,ENG
4a1a9578,17,996,11.1,11,5,6,0,28,11,17,22.0,11.8,10.2,23,ENG
4abac767,18,1029,11.4,13,2,5,2,15,25,-10,12.2,22.7,-10.5,23,ENG
4b40d9ca,37,3261,36.2,37,36,0,0,67,32,35,68.5,36.4,32.1,23,ENG
4b511457,1,74,0.8,1,0,0,3,1,4,-3,0.3,1.4,-1.1,23,ENG
4b803b3c,16,1266,14.1,14,12,2,1,15,23,-8,15.2,23.5,-8.3,23,ENG
4bcf39f6,27,1118,12.4,11,1,16,6,12,19,-7,14.2,21.2,-7.0,23,ENG
4c370d81,25,1213,13.5,13,3,12,0,28,17,11,24.0,19.6,4.3,23,ENG
4d224fe8,28,2124,23.6,24,18,4,0,37,21,16,45.6,26.0,19.7,23,ENG
4d77b365,29,1695,18.8,19,5,10,0,35,22,13,37.3,27.2,10.1,23,ENG
4d90ce8c,1,5,0.1,0,0,1,2,0,0,0,0.0,0.0,0.0,23,ENG
4d960fc3,1,9,0.1,0,0,1,9,0,1,-1,0.0,0.3,-0.3,23,ENG
4e015693,16,804,8.9,7,6,9,5,12,13,-1,13.3,15.3,-2.1,23,ENG
4e5a4cbc,20,1571,17.5,19,16,1,5,14,32,-18,18.8,28.5,-9.7,23,ENG
4e9a0555,25,818,9.1,9,0,16,1,11,9,2,9.9,11.5,-1.6999999999999997,23,ENG
4f28a6ff,26,2019,22.4,24,14,2,11,45,35,10,36.7,28.6,8.1,23,ENG
4f565d77,12,300,3.3,2,2,10,15,1,3,-2,4.1,5.8,-1.7,23,ENG
4f974391,28,2235,24.8,24,20,4,8,26,32,-6,32.3,32.9,-0.6,23,ENG
4fb9c88f,18,1035,11.5,12,2,6,5,23,15,8,23.2,15.8,7.4,23,ENG
4fd08daa,8,295,3.3,3,2,5,24,3,7,-4,4.6,6.9,-2.3,23,ENG
505486d6,12,892,9.9,11,7,1,2,14,21,-7,13.8,17.3,-3.5,23,ENG
507c7bdf,37,3316,36.8,37,33,0,0,57,39,18,65.9,49.2,16.7,23,ENG
50dc94ce,7,167,1.9,2,0,5,4,3,3,0,2.4,1.5,0.9,23,ENG
50e6dc35,29,770,8.6,6,0,23,8,5,10,-5,10.6,13.5,-3.0,23,ENG
515ebe8d,2,66,0.7,1,0,1,16,1,1,0,2.0,0.5,1.5,23,ENG
51a3c4c8,16,1418,15.8,15,13,1,1,20,32,-12,15.2,31.2,-16.0,23,ENG
51cf8561,27,2118,23.5,26,8,1,0,54,28,26,45.5,26.5,19.0,23,ENG
51dbeea9,27,2230,24.8,25,23,2,8,26,34,-8,31.9,31.6,0.4,23,ENG
529f49ab,33,2483,27.6,28,21,5,0,69,28,41,54.7,31.9,22.8,23,ENG
52afb588,18,732,8.1,7,1,11,2,11,7,4,15.8,7.9,7.9,23,ENG
531a4aa8,1,45,0.5,1,0,0,4,1,2,-1,0.2,1.0,-0.8,23,ENG
53552942,1,19,0.2,0,0,1,4,0,1,-1,0.3,0.2,0.1,23,ENG
53cad200,25,1527,17.0,16,12,9,6,17,21,-4,22.5,27.0,-4.5,23,ENG
5515376c,25,1608,17.9,18,15,7,10,20,24,-4,23.1,31.6,-8.5,23,ENG
558807c0,10,299,3.3,3,2,7,17,1,10,-9,1.1,6.1,-5.0,23,ENG
56628958,1,1,0.0,0,0,1,1,1,0,1,0.3,0.0,0.3,23,ENG
56d838f7,1,8,0.1,0,0,1,12,0,0,0,0.1,0.3,-0.2,23,ENG
56f7a928,31,2344,26.0,27,16,4,0,35,49,-14,33.0,45.0,-12.0,23,ENG
570bb4b9,7,427,4.7,5,1,2,0,3,8,-5,6.7,9.9,-3.2,23,ENG
57c94db2,20,1108,12.3,12,10,8,15,20,12,8,16.8,18.0,-1.2,23,ENG
59878425,1,1,0.0,0,0,1,14,0,0,0,0.0,0.0,0.0,23,ENG
59e6e5bf,17,1165,12.9,15,4,2,0,12,22,-10,16.2,22.7,-6.4,23,ENG
5a04fd92,35,2069,23.0,22,8,13,3,25,32,-7,32.3,32.7,-0.5,23,ENG
5a7301ae,24,911,10.1,9,4,15,8,14,14,0,13.1,14.6,-1.6,23,ENG
5bc43860,36,2372,26.4,28,8,8,2,35,58,-23,33.3,49.8,-16.5,23,ENG
5c0da4a4,23,1743,19.4,19,10,4,0,25,37,-12,19.7,31.8,-12.1,23,ENG
5c2b4f07,24,1943,21.6,22,16,2,0,24,31,-7,22.7,32.7,-10.0,23,ENG
5c74c0f5,31,2306,25.6,28,16,3,2,38,40,-2,30.5,39.2,-8.7,23,ENG
5cbd1eb0,36,2891,32.1,34,27,2,0,36,38,-2,33.5,38.4,-4.8,23,ENG
5cc3ce65,1,28,0.3,0,0,1,1,0,1,-1,0.8,0.7,0.1,23,ENG
5dbefa9d,13,316,3.5,1,0,12,5,5,10,-5,4.7,7.2,-2.6,23,ENG
5ed9b537,18,1552,17.2,17,17,1,3,34,22,12,31.9,23.3,8.6,23,ENG
5eecec3d,23,1846,20.5,21,16,2,6,52,17,35,44.9,13.3,31.6,23,ENG
5ff4ab71,18,1547,17.2,18,14,0,0,16,25,-9,24.8,24.1,0.7,23,ENG
60344e4f,36,1389,15.4,14,0,22,2,28,17,11,24.4,18.0,6.5,23,ENG
6250083a,23,1491,16.6,18,8,5,10,27,28,-1,24.4,22.5,1.8,23,ENG
62d7ef38,1,90,1.0,1,1,0,28,4,4,0,4.0,1.8,2.2,23,ENG
6412cc03,22,514,5.7,3,0,19,14,13,5,8,12.1,5.0,7.2,23,ENG
6434f10d,36,2911,32.3,34,23,2,1,83,26,57,67.4,24.4,43.0,23,ENG
65983e4d,1,7,0.1,0,0,1,1,0,0,0,0.0,0.3,-0.3,23,ENG
65c3efa2,2,25,0.3,0,0,2,5,0,3,-3,0.7,2.0,-1.3,23,ENG
6612cd8c,2,15,0.2,0,0,2,3,0,2,-2,0.1,0.6,-0.5,23,ENG
6613c819,36,2815,31.3,32,24,4,1,38,42,-4,41.4,42.7,-1.3,23,ENG
6622454d,18,661,7.3,6,2,12,13,6,7,-1,8.4,9.3,-0.9,23,ENG
6639e500,33,2692,29.9,33,7,0,0,43,40,3,35.8,46.4,-10.5,23,ENG
66b76d44,38,2412,26.8,27,8,11,0,40,34,6,36.9,37.2,-0.3,23,ENG
6722d4f0,1,1,0.0,0,0,1,6,0,0,0,0.0,0.0,0.0,23,ENG
67ac5bb8,38,3409,37.9,38,36,0,0,88,43,45,71.8,41.4,30.4,23,ENG
68c720b5,30,1335,14.8,14,0,16,4,17,24,-7,13.8,24.0,-10.2,23,ENG
68db6358,2,180,2.0,2,2,0,16,1,3,-2,1.9,5.1,-3.2,23,ENG
68dc0dac,33,2168,24.1,27,9,6,4,22,45,-23,22.3,35.8,-13.5,23,ENG
6992791d,4,61,0.7,0,0,4,5,0,1,-1,0.4,0.7,-0.3,23,ENG
69fdb896,21,762,8.5,7,2,14,16,2,14,-12,7.4,13.5,-6.2,23,ENG
6a713852,23,2070,23.0,23,23,0,10,41,30,11,38.9,27.0,11.9,23,ENG
6aa3e78b,17,813,9.0,9,3,8,4,17,15,2,13.5,10.8,2.7,23,ENG
6ad43f9a,3,26,0.3,0,0,3,5,0,0,0,0.6,0.3,0.4,23,ENG
6adbc307,17,1219,13.5,13,13,4,15,16,24,-8,20.400000000000002,24.700000000000003,-4.4,23,ENG
6afaebf2,38,2906,32.3,36,10,2,0,50,39,11,45.6,41.3,4.3,23,ENG
6b47c5db,27,1679,18.7,19,8,8,4,25,39,-14,22.1,31.6,-9.5,23,ENG
6b625ac2,34,3060,34.0,34,34,0,4,43,67,-24,42.7,57.9,-15.2,23,ENG
6b6c793c,22,1396,15.5,14,10,8,15,22,14,8,29.5,19.2,10.4,23,ENG
6c203af0,23,1010,11.2,10,4,13,2,20,20,0,15.5,13.8,1.7,23,ENG
6ca5ec4b,38,3378,37.5,38,34,0,0,34,56,-22,44.8,64.7,-19.9,23,ENG
6d5701f2,7,594,6.6,7,5,0,17,8,9,-1,9.2,10.1,-0.9,23,ENG
6dfd8f05,29,1835,20.4,22,12,7,2,15,35,-20,19.3,30.2,-10.9,23,ENG
6e7f1353,2,11,0.1,0,0,2,11,0,1,-1,0.0,0.4,-0.4,23,ENG
6f711f67,5,74,0.8,0,0,5,9,0,2,-2,0.2,1.0,-0.8,23,ENG
6f7d826d,37,2927,32.5,33,23,4,1,46,33,13,43.3,41.5,1.7,23,ENG
6fe90922,34,2108,23.4,23,10,11,3,40,44,-4,34.6,34.0,0.6,23,ENG
700783e7,17,1220,13.6,13,11,4,11,29,21,8,26.3,22.3,4.1,23,ENG
7120a04d,13,734,8.2,9,0,4,5,13,15,-2,14.2,13.4,0.8,23,ENG
71ef519e,7,39,0.4,0,0,7,18,1,0,1,1.9,0.7,1.2,23,ENG
72c812f3,33,2577,28.6,32,14,1,0,25,45,-20,32.7,49.0,-16.3,23,ENG
7314bba4,5,20,0.2,0,0,5,25,0,4,-4,0.3,1.5,-1.2,23,ENG
73341ace,1,8,0.1,0,0,1,5,1,0,1,0.3,0.0,0.3,23,ENG
733f1a7d,2,26,0.3,0,0,2,2,0,1,-1,0.1,0.8,-0.6,23,ENG
74618572,33,2318,25.8,24,16,9,2,49,35,14,53.7,34.8,19.0,23,ENG
74b2cd7e,16,1237,13.7,13,11,3,19,15,19,-4,17.6,20.1,-2.5,23,ENG
758dd7f0,4,37,0.4,0,0,4,24,2,1,1,1.0,0.9,0.1,23,ENG
75a72a99,10,454,5.0,5,3,5,2,3,11,-8,6.5,8.3,-1.8,23,ENG
75fdd638,24,1354,15.0,14,7,10,5,17,28,-11,16.3,25.1,-8.7,23,ENG
76eca7e2,4,271,3.0,3,3,1,33,2,5,-3,3.1,5.2,-2.2,23,ENG
77cf6852,1,1,0.0,0,0,1,0,0,0,0,0.0,0.1,-0.1,23,ENG
77d7c96f,31,2569,28.5,29,21,2,1,42,36,6,33.4,46.8,-13.4,23,ENG
77e84962,18,1254,13.9,14,9,4,0,22,23,-1,24.4,20.7,3.7,23,ENG
79300479,37,3127,34.7,37,14,0,0,82,38,44,67.1,37.5,29.6,23,ENG
7956236f,36,3139,34.9,36,34,0,1,47,38,9,46.5,43.9,2.6,23,ENG
79c0821a,27,1707,19.0,17,10,10,2,14,25,-11,24.7,24.1,0.6,23,ENG
79c84d1c,38,3233,35.9,36,30,2,0,40,50,-10,46.7,47.9,-1.2,23,ENG
7a11550b,21,1466,16.3,15,15,6,12,28,16,12,30.4,24.6,5.8,23,ENG
7a1f2c08,6,64,0.7,0,0,6,24,0,0,0,0.5,0.9,-0.4,23,ENG
7a2e46a8,37,3330,37.0,37,37,0,0,71,43,28,68.6,49.1,19.5,23,ENG
7aa8adfe,19,569,6.3,5,0,14,9,16,13,3,16.9,8.2,8.6,23,ENG
7b4de647,1,90,1.0,1,1,0,37,1,0,1,0.4,1.0,-0.7,23,ENG
7b5ab7f2,4,148,1.6,2,0,2,12,5,1,4,2.3,1.0,1.3,23,ENG
7ba2eaa9,18,964,10.7,13,2,5,3,7,15,-8,10.9,14.2,-3.2,23,ENG
7ba6d84e,38,3420,38.0,38,38,0,0,58,43,15,67.7,50.4,17.3,23,ENG
7f3b388c,36,2671,29.7,31,20,5,0,59,34,25,52.7,38.4,14.3,23,ENG
7f94982c,1,1,0.0,0,0,1,0,0,0,0,0.0,0.0,0.0,23,ENG
7fcc71d8,32,1771,19.7,20,8,12,3,13,31,-18,20.7,28.3,-7.6,23,ENG
803ae100,37,2866,31.8,35,17,2,0,48,44,4,38.6,52.2,-13.6,23,ENG
810e3c74,17,923,10.3,12,2,5,12,8,17,-9,10.4,15.2,-4.9,23,ENG
819aa8e7,8,382,4.2,3,1,5,10,4,5,-1,5.7,5.6,0.2,23,ENG
819b3158,31,2353,26.1,27,17,4,7,71,20,51,61.3,19.4,41.9,23,ENG
82518f62,32,2726,30.3,32,23,0,0,61,25,36,59.3,29.8,29.4,23,ENG
828657ff,33,2488,27.6,29,16,4,1,22,37,-15,32.0,46.6,-14.6,23,ENG
82927de4,32,1503,16.7,17,3,15,6,18,28,-10,19.7,24.6,-5.0,23,ENG
8397a50c,35,3150,35.0,35,35,0,1,50,40,10,48.8,48.0,0.8,23,ENG
839c14e1,8,227,2.5,2,1,6,19,2,3,-1,2.3,2.8,-0.6,23,ENG
83d074ff,35,2886,32.1,31,27,4,0,54,45,9,62.0,39.5,22.5,23,ENG
8449d35e,35,2208,24.5,24,13,11,0,34,28,6,38.0,30.3,7.7,23,ENG
85322440,1,7,0.1,0,0,1,1,0,0,0,0.0,0.2,-0.2,23,ENG
862a1c15,34,2491,27.7,29,6,5,0,43,22,21,45.9,27.5,18.3,23,ENG
86695068,22,649,7.2,6,0,16,12,9,10,-1,9.4,11.7,-2.2,23,ENG
86dd77d1,27,1958,21.8,22,18,5,5,54,20,34,44.9,20.4,24.4,23,ENG
86e7deaf,27,2352,26.1,26,25,1,2,27,32,-5,31.6,34.1,-2.5,23,ENG
8790f988,16,926,10.3,11,3,5,4,9,12,-3,13.4,11.4,2.0,23,ENG
87966294,1,9,0.1,0,0,1,0,0,1,-1,0.0,0.3,-0.3,23,ENG
886f9aac,19,572,6.4,4,1,15,3,6,11,-5,5.7,12.1,-6.4,23,ENG
88968486,5,299,3.3,3,3,2,6,0,5,-5,1.9,5.0,-3.2,23,ENG
892d5bb1,30,1920,21.3,22,11,8,8,51,23,28,44.1,18.9,25.2,23,ENG
89ac64a6,29,2287,25.4,24,22,5,1,63,23,40,51.6,21.1,30.6,23,ENG
8a3c1dc7,37,3238,36.0,37,29,0,0,53,46,7,53.9,48.2,5.7,23,ENG
8a7ff278,28,2256,25.1,24,22,4,7,34,35,-1,28.6,31.3,-2.7,23,ENG
8aafd64f,16,941,10.5,11,3,5,1,11,15,-4,17.7,13.4,4.3,23,ENG
8aec0537,37,3239,36.0,37,30,0,0,70,51,19,69.7,47.3,22.4,23,ENG
8b04d6c1,35,3131,34.8,35,33,0,0,64,57,7,51.5,45.4,6.1,23,ENG
8b529245,28,1109,12.3,11,7,17,5,18,20,-2,11.7,23.7,-12.0,23,ENG
8b57ad2c,11,653,7.3,7,4,4,6,10,18,-8,8.5,14.9,-6.4,23,ENG
8b788c01,21,978,10.9,11,0,10,0,16,8,8,21.5,13.7,7.8,23,ENG
8b9ebd03,27,2126,23.6,25,6,2,0,39,22,17,32.3,34.6,-2.2,23,ENG
8c3078cd,3,13,0.1,0,0,3,20,0,1,-1,0.3,1.2,-0.8,23,ENG
8d3c902d,21,882,9.8,10,1,11,1,9,23,-14,9.3,16.7,-7.4,23,ENG
8df7a2fb,37,3269,36.3,37,34,0,1,56,40,16,54.7,46.0,8.6,23,ENG
8e16dd48,19,867,9.6,13,0,6,1,10,23,-13,13.4,15.7,-2.4,23,ENG
8e92be30,22,1522,16.9,17,7,5,0,29,20,9,37.6,17.9,19.7,23,ENG
8f62b6ee,25,2205,24.5,25,24,0,1,44,39,5,35.7,30.8,4.8,23,ENG
903b6e8b,36,3240,36.0,36,36,0,2,30,55,-25,34.9,54.7,-19.8,23,ENG
90f91999,34,2693,29.9,30,22,4,1,36,31,5,39.4,38.0,1.4,23,ENG
9228b07c,19,538,6.0,4,1,15,15,3,9,-6,6.1,11.5,-5.4,23,ENG
92868cb5,3,38,0.4,0,0,3,0,1,0,1,0.8,1.3,-0.4,23,ENG
92e7e919,36,2888,32.1,33,19,3,0,57,55,2,48.9,42.9,6.0,23,ENG
9319781b,17,866,9.6,9,8,8,10,8,13,-5,12.9,15.2,-2.4,23,ENG
9328b835,36,3111,34.6,36,33,0,0,37,48,-11,43.9,45.5,-1.7,23,ENG
935e6b8f,35,2074,23.0,23,10,12,0,48,30,18,44.0,31.6,12.4,23,ENG
93feac6e,28,1515,16.8,18,2,10,0,23,31,-8,21.9,28.1,-6.2,23,ENG
94f8d10c,13,946,10.5,9,7,4,13,8,15,-7,9.2,14.7,-5.6,23,ENG
963a9201,11,497,5.5,4,2,7,7,3,11,-8,4.7,9.7,-5.0,23,ENG
966e28d0,13,347,3.9,4,0,9,18,10,3,7,7.2,4.9,2.3,23,ENG
9674002f,24,1648,18.3,20,7,4,2,18,21,-3,22.3,23.4,-1.1,23,ENG
97220da2,12,294,3.3,2,0,10,1,5,5,0,2.8,4.4,-1.6,23,ENG
972aeb2a,27,2415,26.8,27,26,0,0,61,25,36,51.9,26.2,25.7,23,ENG
97333cf5,32,1408,15.6,14,0,18,3,12,34,-22,16.3,28.9,-12.6,23,ENG
9744ff80,13,765,8.5,9,2,4,5,11,9,2,9.9,13.3,-3.4,23,ENG
980522ec,28,2048,22.8,25,7,3,1,33,25,8,36.6,26.0,10.7,23,ENG
984a5a64,31,2650,29.4,30,26,1,1,31,58,-27,29.7,50.3,-20.6,23,ENG
98d2c2c4,28,2161,24.0,24,16,4,8,17,47,-30,22.9,41.5,-18.5,23,ENG
98ea5115,38,3420,38.0,38,38,0,0,58,46,12,56.7,49.9,6.8,23,ENG
99127249,25,1802,20.0,23,6,2,0,29,21,8,32.5,25.2,7.3,23,ENG
99813635,16,722,8.0,12,0,4,0,16,10,6,12.0,10.7,1.3,23,ENG
999ceb5f,10,411,4.6,4,2,6,1,4,9,-5,3.2,7.6,-4.4,23,ENG
9a28eba4,34,1496,16.6,12,3,22,2,12,30,-18,17.6,30.2,-12.6,23,ENG
9b398aea,21,1076,12.0,9,4,12,7,8,18,-10,11.6,18.7,-7.1,23,ENG
9b5ce51a,37,3252,36.1,37,33,0,0,34,67,-33,35.7,60.5,-24.8,23,ENG
9b6f7fd5,28,2151,23.9,27,7,1,1,32,39,-7,32.2,33.7,-1.5,23,ENG
9bc9a519,4,7,0.1,0,0,4,8,0,0,0,0.3,0.5,-0.2,23,ENG
9c221d14,31,2786,31.0,31,30,0,0,42,51,-9,43.2,52.4,-9.2,23,ENG
9c94165b,31,2552,28.4,30,24,1,4,43,35,8,45.3,38.0,7.3,23,ENG
9cfbad36,20,806,9.0,7,1,13,11,21,12,9,21.4,14.7,6.7,23,ENG
9d8cf204,1,8,0.1,0,0,1,1,1,0,1,0.1,0.1,0.0,23,ENG
9e525177,19,1435,15.9,16,12,3,7,28,10,18,35.0,19.3,15.7,23,ENG
9e5708be,9,810,9.0,9,9,0,21,16,10,6,12.1,8.5,3.6,23,ENG
9eedf0e0,1,4,0.0,0,0,1,0,0,0,0,0.1,0.7,-0.6,23,ENG
9f1938ab,12,479,5.3,5,1,7,4,4,13,-9,4.4,12.2,-7.7,23,ENG
9f7c837d,13,802,8.9,10,6,3,5,10,18,-8,10.0,17.4,-7.4,23,ENG
9f8e9423,24,1911,21.2,22,16,2,6,28,22,6,33.3,26.8,6.5,23,ENG
9fec8860,3,77,0.9,1,0,2,9,1,0,1,2.5,0.8,1.6,23,ENG
a0666d3e,27,842,9.4,7,1,20,6,7,11,-4,11.2,12.8,-1.6,23,ENG
a105d46a,19,940,10.4,9,7,10,10,7,17,-10,9.5,18.7,-9.2,23,ENG
a190d597,23,1241,13.8,16,1,7,2,15,17,-2,11.8,21.1,-9.3,23,ENG
a1d5bd30,35,2879,32.0,32,19,3,0,48,39,9,53.7,43.8,9.9,23,ENG
a2081c6b,1,23,0.3,0,0,1,6,0,1,-1,0.0,0.8,-0.8,23,ENG
a2b105e0,33,2518,28.0,28,24,5,0,48,18,30,50.6,26.6,24.0,23,ENG
a39d11bc,24,1879,20.9,24,18,0,2,18,39,-21,20.1,35.2,-15.1,23,ENG
a3b03921,35,2558,28.4,31,8,4,0,56,26,30,53.4,29.1,24.3,23,ENG
a3d94a58,27,2364,26.3,26,24,1,0,46,41,5,38.1,34.5,3.6,23,ENG
a4ac4b8f,11,685,7.6,9,5,2,9,6,10,-4,6.8,10.2,-3.5,23,ENG
a5212312,30,2224,24.7,21,20,9,8,26,44,-18,26.6,43.6,-16.9,23,ENG
a53649b7,30,1089,12.1,9,8,21,3,26,16,10,24.9,14.2,10.7,23,ENG
a572e291,27,1550,17.2,20,5,7,5,22,24,-2,19.6,28.9,-9.3,23,ENG
a5ca9127,1,1,0.0,0,0,1,10,0,0,0,0.0,0.0,0.0,23,ENG
a62f8bf1,18,966,10.7,10,2,8,0,11,20,-9,12.2,18.2,-6.0,23,ENG
a6b461e7,7,286,3.2,3,1,4,7,1,10,-9,1.3,5.8,-4.6,23,ENG
a6c58494,8,94,1.0,0,0,8,3,0,2,-2,1.1,1.8,-0.7,23,ENG
a712ca2b,25,2012,22.4,21,19,4,12,33,26,7,28.9,35.9,-6.9,23,ENG
a78ff07f,35,3108,34.5,35,30,0,0,51,43,8,42.1,55.7,-13.7,23,ENG
a816dbfb,13,976,10.8,12,5,1,3,17,17,0,11.8,20.1,-8.3,23,ENG
a8748947,33,988,11.0,6,0,27,0,18,13,5,16.0,20.1,-4.1,23,ENG
a8c0acb7,9,763,8.5,9,6,0,10,7,14,-7,9.4,11.1,-1.6,23,ENG
a8c19eb8,26,1814,20.2,19,18,7,9,16,36,-20,21.5,32.4,-10.9,23,ENG
a9dc785c,27,2385,26.5,27,26,0,3,27,39,-12,30.7,44.0,-13.4,23,ENG
aa849a12,36,2708,30.1,34,11,2,1,35,55,-20,37.4,50.5,-13.1,23,ENG
ab13a5aa,27,2430,27.0,27,27,0,5,23,34,-11,25.2,37.4,-12.2,23,ENG
ab651565,1,1,0.0,0,0,1,0,0,0,0,0.0,0.0,0.0,23,ENG
ac05f970,33,1829,20.3,21,2,12,1,23,29,-6,25.9,29.3,-3.4,23,ENG
ac0d576d,9,176,2.0,1,0,8,11,9,2,7,3.9,2.5,1.4,23,ENG
ac7e7b1c,4,64,0.7,0,0,4,19,2,1,1,1.3,1.0,0.3,23,ENG
ac861941,33,2818,31.3,31,30,2,3,62,52,10,48.4,43.3,5.1,23,ENG
ae4fc6a4,38,2636,29.3,30,15,8,0,38,35,3,31.9,31.7,0.2,23,ENG
ae59b359,26,1629,18.1,20,9,6,3,19,30,-11,23.3,33.8,-10.6,23,ENG
aed3a70f,37,3127,34.7,36,26,1,0,47,40,7,44.8,47.1,-2.3,23,ENG
afed6722,2,28,0.3,0,0,2,0,0,0,0,0.1,1.6,-1.5,23,ENG
b017b770,20,323,3.6,1,0,19,16,5,5,0,5.8,8.4,-2.6,23,ENG
b0b4fd3e,28,2055,22.8,23,11,5,5,63,16,47,50.6,14.0,36.6,23,ENG
b217ef29,14,1092,12.1,12,10,2,15,21,20,1,22.5,16.6,5.9,23,ENG
b2626673,3,87,1.0,1,0,2,2,2,2,0,2.2,1.8,0.4,23,ENG
b2856bc0,2,12,0.1,0,0,2,8,0,0,0,0.1,0.7,-0.7,23,ENG
b2bc3b1f,27,2288,25.4,27,21,0,0,22,34,-12,24.9,32.4,-7.5,23,ENG
b2d31e83,38,3111,34.6,35,27,3,0,64,30,34,66.2,35.2,31.0,23,ENG
b2f9c73e,14,354,3.9,2,0,12,7,2,7,-5,6.0,8.2,-2.2,23,ENG
b318a643,7,109,1.2,1,0,6,3,1,2,-1,1.8,2.8,-1.0,23,ENG
b3af9be1,21,663,7.4,6,3,15,2,17,11,6,14.4,9.0,5.3,23,ENG
b400bde0,28,1891,21.0,23,7,5,1,24,27,-3,25.7,27.0,-1.3,23,ENG
b4a014b1,3,205,2.3,2,1,1,11,2,3,-1,3.6,1.9,1.7,23,ENG
b561db50,15,846,9.4,8,5,7,5,7,18,-11,10.6,16.6,-6.0,23,ENG
b57e066e,14,903,10.0,10,6,4,23,18,8,10,20.8,8.9,11.9,23,ENG
b5bf1770,21,1180,13.1,11,9,10,8,14,26,-12,14.8,23.1,-8.3,23,ENG
b66315ae,26,2064,22.9,24,11,2,0,53,23,30,43.2,23.2,20.0,23,ENG
b827d5b3,6,237,2.6,1,0,5,13,4,3,1,4.9,4.3,0.6,23,ENG
b853e0ad,35,1249,13.9,12,6,23,3,24,22,2,27.7,22.2,5.6,23,ENG
b937e490,2,26,0.3,0,0,2,19,0,0,0,0.1,0.3,-0.3,23,ENG
b9403c99,1,33,0.4,0,0,1,2,1,0,1,1.0,0.4,0.6,23,ENG
b9e1436c,32,1613,17.9,18,4,14,5,36,20,16,33.7,25.4,8.3,23,ENG
b9fbae28,7,518,5.8,6,3,1,1,5,7,-2,8.0,4.9,3.1,23,ENG
bac46a10,27,2114,23.5,24,19,3,0,35,33,2,36.3,32.3,4.0,23,ENG
bb5fbd2b,33,2715,30.2,31,19,2,0,58,40,18,59.0,36.2,22.8,23,ENG
bba30585,8,649,7.2,7,7,1,11,11,12,-1,10.9,10.4,0.5,23,ENG
bc7dc64d,38,3181,35.3,37,23,1,0,79,42,37,64.4,39.4,25.0,23,ENG
bc914523,1,14,0.2,0,0,1,2,1,0,1,0.7,0.1,0.6,23,ENG
bd6351cd,17,1274,14.2,16,10,1,3,36,15,21,24.7,11.4,13.4,23,ENG
bd8a5d95,6,175,1.9,1,0,5,11,1,5,-4,2.1,4.2,-2.1,23,ENG
bd9553e6,1,23,0.3,0,0,1,4,0,0,0,0.1,0.6,-0.5,23,ENG
be927d03,29,2036,22.6,23,15,6,9,27,28,-1,25.9,32.0,-6.1,23,ENG
beb391dd,14,245,2.7,2,0,12,6,2,5,-3,3.1,4.4,-1.3,23,ENG
bf34eebd,12,643,7.1,7,0,5,4,6,13,-7,8.1,12.5,-4.4,23,ENG
bfc3b3a0,21,1310,14.6,16,7,5,9,12,29,-17,13.3,23.0,-9.7,23,ENG
c067631c,12,533,5.9,5,1,7,2,11,11,0,6.7,10.0,-3.3,23,ENG
c06d1086,11,407,4.5,4,0,7,4,3,7,-4,4.2,6.1,-1.9,23,ENG
c07b7c5c,5,367,4.1,4,2,1,1,6,12,-6,4.0,9.4,-5.4,23,ENG
c1242d4e,3,270,3.0,3,3,0,35,5,1,4,5.3,3.9,1.4,23,ENG
c17bfb65,32,2661,29.6,30,25,2,1,51,26,25,55.2,31.6,23.6,23,ENG
c1fe2a48,26,1837,20.4,21,14,5,0,22,36,-14,22.1,29.0,-6.9,23,ENG
c2731c10,35,1621,18.0,18,8,17,2,15,22,-7,21.2,26.1,-4.9,23,ENG
c3e39f12,14,1215,13.5,13,13,1,24,26,24,2,21.4,18.8,2.6,23,ENG
c40b6180,27,1985,22.1,23,17,4,4,41,27,14,43.8,24.9,18.8,23,ENG
c4486bac,37,2749,30.5,31,17,6,0,35,38,-3,32.1,36.6,-4.5,23,ENG
c4720845,1,12,0.1,0,0,1,12,0,1,-1,0.1,0.8,-0.7,23,ENG
c47541e0,8,233,2.6,1,0,7,8,6,1,5,5.8,1.8,4.0,23,ENG
c4e87b8b,17,797,8.9,10,3,7,3,11,11,0,15.4,14.7,0.7,23,ENG
c596fcb0,31,1877,20.9,21,2,10,1,44,16,28,41.1,22.0,19.1,23,ENG
c5b7c315,12,985,10.9,10,10,2,20,11,22,-11,14.0,23.2,-9.2,23,ENG
c5bdb6e3,11,212,2.4,0,0,11,11,10,3,7,5.1,2.3,2.8,23,ENG
c6220452,1,11,0.1,0,0,1,7,0,0,0,0.6,0.3,0.3,23,ENG
c64c01fc,11,273,3.0,1,0,10,9,3,9,-6,2.5,5.6,-3.1,23,ENG
c6dc9ecd,29,1100,12.2,13,1,16,1,21,15,6,15.5,21.0,-5.4,23,ENG
c6e8cf1f,12,412,4.6,4,1,8,4,3,10,-7,4.8,9.9,-5.1,23,ENG
c81d773d,25,2085,23.2,23,23,2,13,36,39,-3,26.5,42.8,-16.3,23,ENG
c8aa95da,36,3206,35.6,36,32,0,1,67,28,39,69.8,35.7,34.2,23,ENG
c91441dc,32,2880,32.0,32,32,0,6,27,56,-29,30.5,46.1,-15.6,23,ENG
c92e1a31,28,1127,12.5,11,1,17,7,17,23,-6,22.6,22.5,0.2,23,ENG
c931d9f9,24,819,9.100000000000001,7,1,17,8,14,18,-4,11.2,19.5,-8.299999999999999,23,ENG
ca45605e,30,1187,13.2,13,2,17,7,20,24,-4,18.8,20.4,-1.6,23,ENG
cc77354e,24,1777,19.7,21,14,3,0,28,30,-2,24.2,33.1,-8.9,23,ENG
ccce7025,36,3127,34.7,35,33,1,2,64,30,34,66.8,37.1,29.7,23,ENG
cd1acf9d,37,2923,32.5,34,23,3,1,70,44,26,64.2,42.6,21.6,23,ENG
cda0b317,4,360,4.0,4,4,0,23,5,11,-6,4.6,9.3,-4.7,23,ENG
ce4246f5,25,1989,22.1,24,21,1,3,26,29,-3,29.2,27.8,1.4,23,ENG
ce4f40c7,34,2769,30.8,34,16,0,1,36,41,-5,33.3,38.7,-5.4,23,ENG
ce5143da,31,1854,20.6,21,7,10,1,36,28,8,37.2,26.2,11.0,23,ENG
cea4ee8f,2,40,0.4,0,0,2,1,1,1,0,1.0,1.7,-0.7,23,ENG
cee31595,4,54,0.6,0,0,4,8,0,0,0,0.7,0.4,0.2,23,ENG
cf7fb13a,5,152,1.7,2,0,3,4,1,2,-1,1.4,2.5,-1.1,23,ENG
d0042ab9,8,507,5.6,5,2,3,20,4,9,-5,6.8,8.8,-1.9,23,ENG
d00d45ab,1,1,0.0,0,0,1,3,0,0,0,0.0,0.0,0.0,23,ENG
d04b94db,36,2632,29.2,31,23,5,1,25,42,-17,25.0,49.0,-24.0,23,ENG
d0706b27,37,3329,37.0,37,36,0,0,40,46,-6,38.8,45.5,-6.7,23,ENG
d0f72bf1,37,3307,36.7,37,36,0,1,30,56,-26,35.1,57.1,-22.0,23,ENG
d2424d1b,23,1408,15.6,15,10,8,2,16,19,-3,20.2,18.4,1.7,23,ENG
d328a254,36,2764,30.7,34,11,2,0,32,54,-22,31.5,48.9,-17.3,23,ENG
d38fdf53,35,2675,29.7,31,20,4,1,59,43,16,58.3,40.7,17.6,23,ENG
d3ce0e89,26,2340,26.0,26,26,0,9,37,46,-9,32.9,43.1,-10.1,23,ENG
d557d734,12,667,7.4,7,2,5,9,12,9,3,9.0,8.6,0.4,23,ENG
d56543a0,8,313,3.5,3,0,5,8,3,3,0,5.8,3.3,2.5,23,ENG
d5dd5f1f,15,554,6.2,5,0,10,5,3,8,-5,6.0,8.5,-2.5,23,ENG
d79a8c87,14,566,6.3,6,6,8,24,17,13,4,13.5,11.5,2.0,23,ENG
d8931174,16,767,8.5,8,8,8,15,15,7,8,18.5,10.8,7.7,23,ENG
d93c2511,24,1160,12.9,10,7,14,2,17,20,-3,19.1,22.5,-3.4,23,ENG
d9565625,26,2154,23.9,24,21,2,6,32,34,-2,37.6,34.6,2.9,23,ENG
da011f18,9,654,7.3,8,3,1,5,6,11,-5,10.6,13.1,-2.5,23,ENG
da052c14,38,2714,30.2,31,17,7,0,32,41,-9,29.7,40.2,-10.5,23,ENG
da27e268,32,2315,25.7,29,12,3,3,33,60,-27,31.4,48.1,-16.7,23,ENG
da7b447d,18,858,9.5,8,5,10,20,18,17,1,14.9,12.6,2.3,23,ENG
da974c7b,23,1800,20.0,20,17,3,6,20,22,-2,26.7,22.6,4.2,23,ENG
dad4b285,31,2188,24.3,25,14,6,2,47,29,18,47.5,26.2,21.3,23,ENG
dbf053da,26,1686,18.7,21,4,5,4,30,18,12,37.8,24.8,13.0,23,ENG
dc3e663e,7,427,4.7,5,3,2,11,10,6,4,6.6,6.5,0.1,23,ENG
dc4cae05,6,173,1.9,2,0,4,5,0,4,-4,1.0,4.5,-3.5,23,ENG
dc62b55d,17,965,10.7,12,1,5,3,13,12,1,10.8,17.0,-6.2,23,ENG
dc64b8b3,18,1426,15.8,16,14,2,7,20,32,-12,20.9,26.3,-5.4,23,ENG
dc6f5bdd,14,353,3.9,2,2,12,22,4,4,0,3.5,5.6,-2.1,23,ENG
dc7f8a28,14,370,4.1,2,2,12,17,3,4,-1,5.3,7.9,-2.6,23,ENG
dd323728,31,1882,20.9,20,15,11,2,18,41,-23,22.6,38.8,-16.2,23,ENG
dd549382,22,628,7.0,6,0,16,14,14,9,5,15.0,9.2,5.9,23,ENG
de112b84,36,1251,13.9,14,1,22,1,29,12,17,28.4,16.1,12.2,23,ENG
de31038e,22,410,4.6,3,0,19,12,8,7,1,11.7,5.5,6.2,23,ENG
de40e38c,2,17,0.2,0,0,2,8,0,1,-1,0.3,0.5,-0.3,23,ENG
dea698d9,10,525,5.8,4,3,6,2,6,8,-2,6.0,5.8,0.2,23,ENG
df04eb4b,28,1426,15.8,12,7,16,8,19,38,-19,19.7,29.7,-10.0,23,ENG
df0a4c90,22,1763,19.6,21,12,1,0,31,23,8,29.4,24.7,4.7,23,ENG
df10e27c,14,507,5.6,7,2,7,16,14,8,6,12.5,9.8,2.7,23,ENG
df3cda47,30,2067,23.0,23,5,7,0,42,40,2,32.8,30.5,2.3,23,ENG
df8b52a5,26,1735,19.3,20,12,6,2,34,26,8,27.7,21.1,6.6,23,ENG
e06683ca,32,2835,31.5,32,31,0,1,68,36,32,60.9,40.5,20.4,23,ENG
e09f279b,33,2951,32.8,33,29,0,0,47,42,5,47.2,42.7,4.5,23,ENG
e0bc6fdc,22,1320,14.7,16,9,6,13,15,28,-13,17.3,23.0,-5.7,23,ENG
e0d1510a,1,69,0.8,1,0,0,5,1,3,-2,0.5,1.3,-0.8,23,ENG
e280527c,11,627,7.0,7,2,4,1,11,7,4,12.8,11.4,1.4,23,ENG
e28868f3,18,1261,14.0,14,9,4,8,8,20,-12,16.0,17.2,-1.1,23,ENG
e342ad68,38,3290,36.6,37,29,1,0,74,45,29,70.6,46.8,23.8,23,ENG
e34fc66d,32,2782,30.9,32,30,0,0,35,37,-2,34.0,35.4,-1.3,23,ENG
e3a5814e,22,1407,15.6,13,7,9,5,16,31,-15,17.7,22.2,-4.5,23,ENG
e4238fb1,30,1257,14.0,11,4,19,8,9,29,-20,13.6,26.0,-12.4,23,ENG
e46012d4,32,2417,26.9,28,16,4,3,69,23,46,58.7,19.4,39.2,23,ENG
e514ab62,17,610,6.8,6,3,11,12,9,6,3,11.0,6.9,4.1,23,ENG
e541326e,30,2700,30.0,30,30,0,0,43,34,9,45.3,40.2,5.1,23,ENG
e5478b87,27,1404,15.6,17,0,10,2,19,29,-10,17.9,25.9,-8.1,23,ENG
e5a76dfe,18,1620,18.0,18,18,0,0,15,31,-16,20.5,26.6,-6.1,23,ENG
e61b8aee,37,2993,33.3,36,24,1,0,75,35,40,60.7,36.5,24.3,23,ENG
e6af02e0,34,2467,27.4,30,14,4,0,21,41,-20,23.7,41.7,-18.0,23,ENG
e6bc67d7,13,707,7.9,8,1,5,4,4,12,-8,5.7,11.7,-6.0,23,ENG
e77dc3b2,33,2860,31.8,32,19,1,0,35,52,-17,34.5,51.4,-16.9,23,ENG
e7ca0439,6,338,3.8,3,2,3,16,2,8,-6,2.6,6.5,-3.9,23,ENG
e7ee38c3,4,281,3.1,2,2,2,30,4,8,-4,3.7,8.6,-4.9,23,ENG
e8271ad9,19,1454,16.2,17,12,2,5,14,31,-17,14.0,26.9,-12.9,23,ENG
e82900ef,3,70,0.8,1,0,2,6,1,1,0,1.1,1.6,-0.5,23,ENG
e97fd090,25,1536,17.1,19,6,6,6,22,23,-1,21.7,27.2,-5.5,23,ENG
e98211e7,1,2,0.0,0,0,1,2,0,0,0,0.0,0.4,-0.4,23,ENG
e9971f2d,4,146,1.6,2,0,2,26,2,5,-3,1.4,3.6,-2.2,23,ENG
ea6bc03a,36,3175,35.3,36,33,0,1,46,74,-28,45.0,63.7,-18.7,23,ENG
eaeca114,26,1873,20.8,22,16,4,4,53,15,38,44.8,16.2,28.5,23,ENG
ecad9aa5,29,2221,24.7,26,14,3,0,28,50,-22,25.8,41.0,-15.2,23,ENG
ecada4fc,17,1529,17.0,17,16,0,0,21,32,-11,15.8,32.4,-16.6,23,ENG
ed1e53f3,32,1842,20.5,22,11,10,1,49,16,33,39.6,17.7,21.9,23,ENG
ed8d597c,2,26,0.3,0,0,2,0,0,0,0,0.1,1.2,-1.0,23,ENG
ed9f7cfe,28,2214,24.6,26,16,2,2,29,48,-19,27.0,41.1,-14.1,23,ENG
ee38d9c5,30,2480,27.6,28,21,2,0,41,54,-13,38.1,46.0,-7.9,23,ENG
ee950928,1,7,0.1,0,0,1,3,0,0,0,0.2,0.0,0.2,23,ENG
efb9215a,2,11,0.1,0,0,2,20,0,1,-1,0.1,1.0,-1.0,23,ENG
efd2ec23,11,258,2.9,2,1,9,4,3,6,-3,3.6,6.8,-3.3,23,ENG
f08490a6,9,169,1.9,1,0,8,8,6,5,1,4.3,2.4,1.9,23,ENG
f0caab96,17,984,10.9,10,7,7,11,10,14,-4,10.1,21.3,-11.2,23,ENG
f173303a,3,67,0.7,1,0,2,12,2,2,0,2.7,1.5,1.3,23,ENG
f25c8e3a,8,293,3.3,3,0,5,2,2,4,-2,5.0,3.7,1.2,23,ENG
f2bf1b0f,28,1992,22.1,23,13,5,1,18,41,-23,24.1,33.2,-9.2,23,ENG
f315ca93,20,771,8.6,9,2,11,17,14,11,3,14.9,13.7,1.2,23,ENG
f31def1e,23,2040,22.7,23,22,0,0,19,38,-19,22.2,36.2,-14.1,23,ENG
f3354c07,18,424,4.7,3,1,15,18,10,11,-1,8.5,11.5,-3.0,23,ENG
f4d296e4,29,2200,24.4,26,20,3,5,33,52,-19,31.7,42.7,-11.0,23,ENG
f4e433d4,20,453,5.0,3,1,17,3,6,7,-1,7.5,6.5,1.0,23,ENG
f5a00fa4,31,1780,19.8,20,6,11,2,12,28,-16,20.2,27.3,-7.0,23,ENG
f5deef4c,20,1365,15.2,14,13,6,10,29,16,13,35.3,20.4,14.9,23,ENG
f7b1d4e0,15,139,1.5,0,0,15,19,3,5,-2,2.6,4.4,-1.8,23,ENG
f8fcd2a5,13,1051,11.7,12,10,1,3,17,28,-11,12.0,19.6,-7.6,23,ENG
fa031b34,27,1010,11.2,12,1,15,2,22,18,4,18.2,15.3,2.9,23,ENG
fa9fa773,3,34,0.4,0,0,3,14,0,1,-1,0.3,0.2,0.1,23,ENG
fb614c44,14,1252,13.9,14,12,0,0,23,25,-2,15.9,20.8,-5.0,23,ENG
fc027d02,17,1073,11.9,11,8,6,19,14,20,-6,16.8,23.2,-6.4,23,ENG
fc15fb84,36,2498,27.8,28,19,8,2,26,46,-20,35.1,50.2,-15.1,23,ENG
fce2302c,27,795,8.8,6,3,21,11,16,10,6,15.2,10.8,4.4,23,ENG
fdf3cb77,27,2136,23.7,24,18,3,7,27,35,-8,31.1,30.6,0.5,23,ENG
fe558029,12,1035,11.5,11,11,1,26,10,32,-22,7.9,19.8,-11.9,23,ENG
feb5d972,11,218,2.4,2,0,9,15,6,11,-5,4.5,5.9,-1.5,23,ENG
fed7cb61,35,2569,28.5,30,15,5,1,29,31,-2,40.3,38.1,2.2,23,ENG
fed96827,26,2199,24.4,24,23,2,7,23,52,-29,20.5,41.5,-21.0,23,ENG
0076ab7f,8,779,8.7,8,7,0,0,14,6,8,8.1,12.0,-3.9,23,EL
00844823,1,90,1.0,1,1,0,0,0,2,-2,0.6,1.8,-1.2,23,EL
009a4f60,6,455,5.1,5,4,1,0,4,1,3,5.9,2.3,3.6,23,EL
00b86f5e,6,540,6.0,6,6,0,0,7,10,-3,4.6,8.9,-4.2,23,EL
00c9a283,5,360,4.0,4,2,1,1,1,8,-7,1.8,6.1,-4.2,23,EL
01b8a2b2,8,703,7.8,8,7,0,0,10,5,5,13.5,7.4,6.1,23,EL
02b952ce,2,135,1.5,1,1,1,1,1,5,-4,0.6,3.6,-3.0,23,EL
02caf6e0,3,134,1.5,2,0,1,1,1,0,1,2.5,1.2,1.4,23,EL
031ebd52,2,32,0.4,0,0,2,4,0,1,-1,0.2,1.5,-1.3,23,EL
0362c29e,7,467,5.2,6,5,1,0,6,9,-3,4.3,7.4,-3.1,23,EL
03998238,3,92,1.0,0,0,3,1,2,4,-2,0.7,1.2,-0.6,23,EL
03b6afa9,6,371,4.1,4,3,2,2,9,6,3,7.3,4.2,3.2,23,EL
03e7a498,1,74,0.8,1,0,0,5,0,2,-2,0.7,1.6,-0.9,23,EL
0412b9cd,4,106,1.2,1,0,3,1,0,3,-3,0.5,2.2,-1.7,23,EL
04964f4f,4,221,2.5,1,0,3,3,2,2,0,2.2,3.0,-0.8,23,EL
049751d7,5,215,2.4,2,0,3,0,1,0,1,2.6,1.2,1.4,23,EL
04e17fd5,9,717,8.0,8,4,1,0,14,4,10,7.9,10.3,-2.4,23,EL
04f661ea,1,45,0.5,0,0,1,2,0,2,-2,0.1,0.8,-0.6,23,EL
056d2d95,9,549,6.1,6,4,3,0,7,7,0,8.7,6.0,2.7,23,EL
05e19d6a,2,156,1.7,2,1,0,0,2,4,-2,1.8,3.1,-1.3,23,EL
0670ee51,2,180,2.0,2,2,0,0,1,2,-1,2.1,3.6,-1.5,23,EL
0683f364,5,441,4.9,5,4,0,0,2,8,-6,4.9,4.6,0.4,23,EL
068f4dec,6,145,1.6,1,1,5,2,4,1,3,2.8,1.2,1.6,23,EL
06df8256,5,450,5.0,5,5,0,0,9,4,5,8.6,3.6,5.0,23,EL
06e5b0e4,2,180,2.0,2,2,0,0,2,5,-3,0.9,2.9,-1.9,23,EL
072e68ed,8,720,8.0,8,8,0,0,14,9,5,13.5,6.2,7.3,23,EL
08452314,9,613,6.8,7,1,2,1,17,8,9,11.2,7.5,3.7,23,EL
086d7db3,3,23,0.3,0,0,3,3,0,0,0,0.4,0.5,-0.1,23,EL
0880e10b,2,180,2.0,2,2,0,2,3,4,-1,0.9,2.2,-1.3,23,EL
089c7323,6,208,2.3,1,0,5,4,6,5,1,3.5,5.5,-2.0,23,EL
08eb3b58,4,245,2.7,3,2,1,2,5,2,3,6.0,1.4,4.6,23,EL
0959184b,6,317,3.5,4,1,2,0,3,6,-3,3.3,6.3,-3.0,23,EL
095ec83c,6,159,1.8,1,0,5,0,0,3,-3,1.2,4.9,-3.7,23,EL
0a084b35,4,342,3.8,4,2,0,0,6,6,0,5.3,4.6,0.7,23,EL
0ab1f153,8,592,6.6,6,4,2,0,7,4,3,10.5,7.8,2.7,23,EL
0afff3b7,5,376,4.2,5,1,0,0,6,5,1,3.4,4.5,-1.1,23,EL
0b243559,3,41,0.5,0,0,3,2,2,0,2,1.5,0.7,0.8,23,EL
0b4f388a,8,294,3.3,3,0,5,0,7,6,1,6.1,3.0,3.1,23,EL
0ba976e4,2,40,0.4,0,0,2,0,1,0,1,0.4,0.2,0.2,23,EL
0bfca6a1,4,360,4.0,4,4,0,2,4,8,-4,4.8,5.7,-0.9,23,EL
0c09c984,5,350,3.9,5,2,0,0,2,7,-5,1.6,4.6,-3.0,23,EL
0c3f7197,5,159,1.8,1,0,4,3,4,0,4,3.0,0.8,2.2,23,EL
0c7a48f8,8,741,8.2,8,7,0,0,14,8,6,13.2,7.4,5.8,23,EL
0caa2fd4,4,245,2.7,2,2,2,4,5,2,3,4.2,2.3,1.9,23,EL
0d82903c,5,382,4.2,5,4,0,1,6,3,3,7.9,4.7,3.2,23,EL
0d9b2d31,1,40,0.4,1,0,0,0,0,0,0,0.4,1.1,-0.7,23,EL
0da5076f,6,376,4.2,3,2,3,0,3,7,-4,3.6,7.3,-3.7,23,EL
0e46fa2f,4,141,1.6,2,0,2,2,3,2,1,2.1,2.2,-0.1,23,EL
0e7ccfc4,6,358,4.0,4,3,2,2,3,8,-5,4.9,6.8,-1.9,23,EL
0eb83e1a,6,392,4.4,5,0,1,0,2,8,-6,2.7,9.3,-6.6,23,EL
0ed60738,10,889,9.9,10,9,0,0,19,14,5,11.6,11.5,0.1,23,EL
0f6e3474,6,540,6.0,6,6,0,0,5,16,-11,7.0,10.0,-3.0,23,EL
0f816ae5,2,19,0.2,0,0,2,4,1,0,1,0.8,0.3,0.5,23,EL
10072610,6,540,6.0,6,6,0,2,10,8,2,5.6,7.8,-2.2,23,EL
10161491,6,540,6.0,6,6,0,0,2,13,-11,4.1,13.0,-8.9,23,EL
10549b49,7,272,3.0,3,1,4,1,3,0,3,5.1,1.6,3.5,23,EL
108fe016,3,142,1.6,2,0,1,3,1,3,-2,1.8,1.5,0.4,23,EL
10f1cd17,5,296,3.3,3,3,2,0,2,7,-5,3.7,5.5,-1.8,23,EL
114bbdee,6,526,5.8,6,5,0,1,7,4,3,6.0,8.5,-2.5,23,EL
11c0fa9d,5,252,2.8,3,1,2,0,2,5,-3,1.9,4.0,-2.1,23,EL
12dcbdcc,6,470,5.2,6,2,0,0,5,5,0,9.4,5.8,3.6,23,EL
13203c45,3,251,2.8,3,0,0,0,3,3,0,2.7,3.3,-0.6,23,EL
133faa84,3,119,1.3,2,1,1,0,3,2,1,1.2,2.1,-0.9,23,EL
136958ad,3,74,0.8,0,0,3,1,3,4,-1,0.5,1.1,-0.5,23,EL
13c8e5f6,4,243,2.7,3,0,1,2,2,5,-3,2.2,3.5,-1.2,23,EL
13ea2544,6,220,2.4,2,0,4,9,5,4,1,5.4,1.6,3.8,23,EL
13fe7b69,7,65,0.7,0,0,7,3,2,2,0,1.6,2.4,-0.7,23,EL
1443ca7d,2,101,1.1,1,1,1,4,0,6,-6,0.4,1.4,-1.0,23,EL
1469d291,1,15,0.2,0,0,1,5,0,0,0,0.0,0.2,-0.2,23,EL
149895bf,4,131,1.5,2,0,2,1,1,0,1,3.1,0.9,2.2,23,EL
14a04bea,6,304,3.4,3,1,3,0,6,4,2,4.1,3.4,0.7,23,EL
15317e60,1,45,0.5,0,0,1,0,0,1,-1,0.0,0.0,0.0,23,EL
1581e8db,6,521,5.8,6,5,0,0,4,9,-5,3.8,8.8,-5.0,23,EL
15944afd,3,77,0.9,0,0,3,5,4,0,4,1.3,0.8,0.5,23,EL
15d0c248,5,386,4.3,4,3,1,0,8,7,1,4.0,6.4,-2.5,23,EL
15f3ec41,1,3,0.0,0,0,1,5,0,1,-1,0.3,0.1,0.2,23,EL
15fd5593,2,79,0.9,1,0,1,0,1,3,-2,1.9,1.2,0.7,23,EL
16322a52,6,423,4.7,5,0,1,0,4,8,-4,3.6,8.6,-5.0,23,EL
16657b95,15,1304,14.5,14,10,1,0,19,8,11,25.2,11.7,13.5,23,EL
16839b27,3,129,1.4,1,0,2,2,1,4,-3,1.3,2.4,-1.1,23,EL
16aa3654,7,364,4.0,4,1,3,0,7,2,5,6.4,2.6,3.8,23,EL
16e9d0ea,4,72,0.8,0,0,4,2,2,0,2,0.4,0.7,-0.3,23,EL
16ea3bb1,5,300,3.3,3,3,2,1,2,7,-5,1.5,8.4,-6.9,23,EL
1707d9c6,1,24,0.3,0,0,1,2,1,0,1,1.2,0.1,1.1,23,EL
17370b95,1,90,1.0,1,1,0,1,0,2,-2,1.3,1.9,-0.6,23,EL
173eb3cd,8,546,6.1,6,4,2,0,7,10,-3,6.6,9.2,-2.6,23,EL
17695062,1,20,0.2,0,0,1,1,0,0,0,0.1,0.0,0.0,23,EL
1774c547,1,19,0.2,0,0,1,3,0,0,0,0.2,0.1,0.1,23,EL
17e3e467,1,66,0.7,1,0,0,0,1,1,0,0.4,0.9,-0.6,23,EL
184ad240,5,177,2.0,2,0,3,1,2,1,1,4.9,1.7,3.2,23,EL
184ea16a,1,9,0.1,0,0,1,3,0,1,-1,0.0,0.8,-0.8,23,EL
185a2732,7,128,1.4,0,0,7,3,1,2,-1,2.0,3.2,-1.2,23,EL
18dd3219,5,350,3.9,3,3,2,3,5,2,3,5.6,4.5,1.1,23,EL
18fae4ac,8,615,6.8,8,4,0,0,15,6,9,8.8,8.0,0.8,23,EL
1971591f,5,368,4.1,5,2,0,1,11,2,9,5.0,6.3,-1.3,23,EL
19cae58d,1,90,1.0,1,1,0,0,2,2,0,1.0,2.1,-1.1,23,EL
19cda00b,7,549,6.1,7,2,0,1,7,3,4,10.1,6.1,4.0,23,EL
1a799243,2,180,2.0,2,2,0,0,1,2,-1,2.1,3.6,-1.5,23,EL
1a7fcf39,6,317,3.5,3,1,3,0,8,2,6,6.0,2.4,3.6,23,EL
1ac58ba6,3,250,2.8,3,2,0,1,2,9,-7,3.0,5.6,-2.6,23,EL
1adcf39e,4,390,4.3,4,4,0,0,5,11,-6,3.2,7.7,-4.5,23,EL
1b4f1169,6,475,5.3,6,3,0,0,7,2,5,11.0,3.9,7.1,23,EL
1bacc518,2,180,2.0,2,2,0,0,3,4,-1,2.2,3.2,-1.0,23,EL
1bd5735a,4,63,0.7,0,0,4,2,0,1,-1,0.2,0.6,-0.4,23,EL
1c07b06e,5,368,4.1,5,2,0,1,1,6,-5,2.4,4.3,-1.9,23,EL
1c341b14,2,46,0.5,0,0,2,4,1,1,0,0.5,0.8,-0.3,23,EL
1c59240b,5,392,4.4,5,2,0,0,2,7,-5,4.1,6.2,-2.1,23,EL
1cb49278,2,114,1.3,1,1,1,0,2,2,0,1.6,1.3,0.4,23,EL
1d2c3e5e,9,693,7.7,9,3,0,0,17,14,3,8.7,9.0,-0.3,23,EL
1d2d5cc8,7,621,6.9,7,6,0,1,13,8,5,11.5,6.6,4.8,23,EL
1d438d6c,1,17,0.2,0,0,1,1,0,0,0,0.0,0.5,-0.5,23,EL
1da13ab9,4,257,2.9,3,1,1,1,2,3,-1,3.0,3.9,-0.9,23,EL
1df4a109,7,501,5.6,5,3,2,0,10,9,1,8.9,5.4,3.5,23,EL
1e064bfb,2,180,2.0,2,2,0,1,1,3,-2,1.6,2.0,-0.4,23,EL
1e1378e1,2,126,1.4,1,0,1,0,0,0,0,1.5,1.9,-0.5,23,EL
1e274a0a,6,193,2.1,2,0,4,1,3,1,2,2.6,0.9,1.7,23,EL
1e4319ac,2,42,0.5,0,0,2,2,0,0,0,1.0,0.8,0.2,23,EL
1e8dbb59,2,36,0.4,0,0,2,4,1,1,0,0.4,0.4,0.0,23,EL
1f3afdcb,5,189,2.1,2,1,3,2,4,3,1,3.1,2.5,0.6,23,EL
1fbbfbde,5,450,5.0,5,5,0,0,8,5,3,10.4,4.8,5.6,23,EL
200e89e1,1,13,0.1,0,0,1,2,0,0,0,0.0,0.1,-0.1,23,EL
20e73fac,7,511,5.7,6,2,1,0,10,6,4,8.0,5.9,2.1,23,EL
211589b8,4,184,2.0,2,0,2,2,5,0,5,3.4,0.2,3.3,23,EL
2116f524,1,7,0.1,0,0,1,5,1,0,1,0.4,0.0,0.4,23,EL
218e344d,6,300,3.3,3,2,3,0,1,6,-5,1.4,6.5,-5.1,23,EL
2249e65b,4,156,1.7,2,0,2,2,1,5,-4,1.6,3.9,-2.4,23,EL
22798128,9,588,6.5,7,4,2,0,7,9,-2,5.9,9.6,-3.6,23,EL
228b0d9d,1,90,1.0,1,1,0,5,1,0,1,1.1,0.8,0.2,23,EL
232b3da4,5,282,3.1,4,1,1,1,7,5,2,5.1,4.1,1.1,23,EL
235a646b,6,312,3.5,4,1,2,0,3,2,1,3.7,2.8,0.9,23,EL
23c63b7f,6,283,3.1,3,0,3,0,2,4,-2,3.3,4.2,-0.9,23,EL
242e1043,8,750,8.3,8,8,0,0,15,11,4,10.3,11.1,-0.8,23,EL
244a31b9,6,540,6.0,6,6,0,0,8,9,-1,6.2,8.3,-2.1,23,EL
2475dcc6,2,180,2.0,2,2,0,0,1,3,-2,2.3,2.6,-0.3,23,EL
24baba9d,6,533,5.9,6,3,0,0,8,4,4,8.7,5.6,3.1,23,EL
25146df0,1,90,1.0,1,1,0,0,1,0,1,0.8,1.8,-0.9,23,EL
254b831b,2,180,2.0,2,2,0,4,1,4,-3,1.5,3.3,-1.7,23,EL
25ab9c9c,2,67,0.7,1,0,1,1,0,0,0,0.5,1.1,-0.6,23,EL
27504df8,7,456,5.1,6,0,1,0,7,7,0,6.6,5.1,1.5,23,EL
2770726a,4,224,2.5,3,0,1,0,5,1,4,3.4,3.2,0.2,23,EL
277da414,6,540,6.0,6,6,0,0,9,11,-2,8.5,8.7,-0.2,23,EL
2794a536,1,37,0.4,0,0,1,4,0,1,-1,0.1,1.7,-1.6,23,EL
283699b4,1,34,0.4,0,0,1,9,3,1,2,0.2,0.4,-0.2,23,EL
28c6e925,2,163,1.8,2,1,0,0,1,2,-1,2.0,3.5,-1.6,23,EL
2973d8ff,8,331,3.7,4,0,4,0,9,3,6,7.1,3.3,3.8,23,EL
29b61deb,6,291,3.2,3,2,3,0,5,6,-1,2.1,5.2,-3.1,23,EL
29e298a8,6,265,2.9,2,2,4,2,8,6,2,4.2,4.2,-0.1,23,EL
2a0c8ba4,5,234,2.6,2,2,3,0,5,2,3,2.0,3.2,-1.2,23,EL
2a29eb9b,7,427,4.7,4,4,3,1,5,5,0,4.7,8.8,-4.1,23,EL
2a70dcc9,1,90,1.0,1,1,0,3,0,2,-2,0.7,1.1,-0.4,23,EL
2ab7149e,1,90,1.0,1,1,0,5,2,0,2,1.8,0.6,1.2,23,EL
2acd49b9,8,428,4.8,5,2,3,0,5,7,-2,4.2,6.4,-2.2,23,EL
2b0852db,1,45,0.5,1,0,0,1,0,2,-2,0.5,1.7,-1.2,23,EL
2b1c4abd,5,303,3.4,4,0,1,0,1,4,-3,2.5,4.3,-1.8,23,EL
2b53f7a5,6,536,6.0,6,5,0,0,7,9,-2,5.8,8.3,-2.5,23,EL
2bc17985,6,388,4.3,4,1,2,0,3,7,-4,4.5,6.9,-2.4,23,EL
2bef2bca,2,171,1.9,2,1,0,0,3,4,-1,2.2,3.2,-1.0,23,EL
2bf50b37,1,17,0.2,0,0,1,1,0,0,0,0.1,0.1,0.0,23,EL
2c5f04ba,3,37,0.4,0,0,3,1,2,0,2,0.7,0.0,0.7,23,EL
2ca35213,3,193,2.1,3,2,0,0,0,4,-4,1.0,4.1,-3.2,23,EL
2cb77ec6,6,502,5.6,5,3,1,1,7,10,-3,5.8,8.3,-2.5,23,EL
2dc925d5,2,70,0.8,1,0,1,0,0,1,-1,0.1,1.6,-1.6,23,EL
2edbd8d5,1,90,1.0,1,1,0,4,0,3,-3,0.2,2.2,-2.1,23,EL
2f18d0b8,2,180,2.0,2,2,0,7,9,6,3,3.6,0.8,2.8,23,EL
2f3452eb,6,540,6.0,6,6,0,0,9,11,-2,8.5,8.7,-0.2,23,EL
2f72f79e,4,350,3.9,4,2,0,0,2,6,-4,1.7,4.9,-3.3,23,EL
2f88752d,5,273,3.0,3,1,2,1,3,6,-3,4.0,4.0,0.0,23,EL
2fba6108,5,137,1.5,1,0,4,7,0,3,-3,1.2,1.5,-0.3,23,EL
2ff76adc,7,541,6.0,6,6,1,1,15,3,12,7.8,7.7,0.1,23,EL
2ffa6348,6,344,3.8,5,2,1,2,10,2,8,5.0,5.1,-0.1,23,EL
3010aefb,5,122,1.4,1,0,4,3,3,3,0,1.7,1.8,0.0,23,EL
302527b2,6,502,5.6,6,4,0,1,11,3,8,7.9,7.3,0.6,23,EL
3098c0df,4,187,2.1,3,0,1,2,1,5,-4,1.2,4.1,-2.9,23,EL
30ae134d,9,343,3.8,4,0,5,0,6,4,2,5.2,3.5,1.8,23,EL
30af8b93,8,742,8.2,8,7,0,0,14,13,1,12.1,8.5,3.6,23,EL
30e03a25,6,540,6.0,6,6,0,0,4,10,-6,3.8,9.9,-6.1,23,EL
30fab1ee,3,55,0.6,0,0,3,0,1,0,1,0.5,0.4,0.1,23,EL
31139973,1,90,1.0,1,1,0,5,2,3,-1,1.5,2.1,-0.6,23,EL
313254a3,7,541,6.0,6,5,1,1,9,5,4,7.3,7.7,-0.4,23,EL
31a62dc7,8,422,4.7,5,1,3,5,5,3,2,7.8,3.5,4.3,23,EL
31b7d437,2,69,0.8,0,0,2,0,1,4,-3,0.6,1.3,-0.7,23,EL
31f5b89b,5,356,4.0,5,2,0,1,7,2,5,5.6,2.9,2.6,23,EL
3260690c,1,17,0.2,0,0,1,1,0,0,0,0.1,0.1,0.0,23,EL
32f3d97e,4,109,1.2,1,0,3,1,3,3,0,3.4,2.8,0.5,23,EL
33591ff0,4,128,1.4,1,1,3,0,1,6,-5,0.8,1.6,-0.8,23,EL
335fa267,2,119,1.3,1,0,1,0,3,3,0,1.8,1.8,0.0,23,EL
33651873,6,483,5.4,5,4,1,0,9,5,4,9.4,6.3,3.2,23,EL
3376a776,2,29,0.3,0,0,2,3,0,0,0,0.2,0.4,-0.3,23,EL
3423f250,2,156,1.7,2,0,0,0,3,4,-1,1.9,3.1,-1.2,23,EL
34693494,4,195,2.2,3,0,1,2,1,3,-2,3.5,3.2,0.3,23,EL
34a0f5ff,8,453,5.0,5,3,3,2,10,8,2,6.1,5.1,1.0,23,EL
34abb664,1,90,1.0,1,1,0,1,1,0,1,1.7,0.1,1.6,23,EL
34caa4b3,7,400,4.4,6,1,1,0,14,1,13,6.6,4.5,2.2,23,EL
34e393f2,7,355,3.9,4,1,3,0,5,6,-1,3.1,6.3,-3.3,23,EL
350ad032,4,277,3.1,3,1,1,0,2,6,-4,1.4,4.8,-3.5,23,EL
3543ef90,1,3,0.0,0,0,1,5,0,1,-1,0.0,0.4,-0.4,23,EL
35bd124a,4,290,3.2,3,3,1,0,3,7,-4,4.0,4.4,-0.4,23,EL
35e413f1,7,396,4.4,3,1,4,1,6,3,3,7.8,4.7,3.2,23,EL
3626daea,13,913,10.1,9,5,4,1,15,8,7,19.1,9.6,9.6,23,EL
3642b47f,4,279,3.1,4,0,0,1,2,2,0,4.1,3.8,0.3,23,EL
366be751,6,356,4.0,4,2,2,2,8,1,7,8.0,3.3,4.7,23,EL
36a6f28d,4,285,3.2,3,2,1,2,5,4,1,3.0,3.4,-0.4,23,EL
36a79857,6,336,3.7,4,0,2,0,4,7,-3,3.7,5.8,-2.0,23,EL
3708e9fa,8,606,6.7,8,1,0,0,10,11,-1,9.2,7.3,1.9,23,EL
37143438,1,60,0.7,0,0,1,0,1,0,1,0.7,0.5,0.1,23,EL
37337aea,9,432,4.8,4,0,5,0,13,8,5,7.5,9.4,-1.9,23,EL
3741ca58,6,235,2.6,3,0,3,2,6,1,5,4.6,1.6,3.0,23,EL
374d5158,7,308,3.4,2,0,5,1,1,5,-4,1.0,6.0,-5.0,23,EL
374ee424,8,720,8.0,8,8,0,0,10,4,6,10.6,4.6,6.1,23,EL
37557ec4,3,115,1.3,0,0,3,1,3,6,-3,0.7,2.0,-1.3,23,EL
37998008,1,45,0.5,0,0,1,9,0,0,0,0.3,0.3,0.1,23,EL
37aa57c0,6,540,6.0,6,6,0,0,7,10,-3,4.6,8.9,-4.2,23,EL
37d0048f,5,263,2.9,3,1,2,1,3,3,0,2.8,3.7,-0.9,23,EL
37f341f0,6,421,4.7,5,2,1,0,4,8,-4,4.0,7.8,-3.8,23,EL
38ceb24a,1,75,0.8,0,0,1,0,0,1,-1,1.0,1.0,0.0,23,EL
38fc10d2,1,28,0.3,0,0,1,4,0,1,-1,0.6,0.7,-0.1,23,EL
390eb94b,6,385,4.3,4,1,2,0,3,6,-3,2.7,4.3,-1.6,23,EL
394be156,4,271,3.0,2,2,2,2,2,3,-1,4.5,3.7,0.8,23,EL
39e1138f,6,455,5.1,4,3,2,2,8,8,0,7.1,9.8,-2.7,23,EL
3ae14ed1,6,453,5.0,5,3,1,0,8,9,-1,5.2,6.9,-1.7,23,EL
3b216df2,2,5,0.1,0,0,2,0,0,0,0,0.1,0.2,-0.1,23,EL
3b996663,3,256,2.8,3,2,0,3,3,6,-3,1.5,3.7,-2.3,23,EL
3bd65247,3,123,1.4,1,0,2,1,3,5,-2,1.9,3.4,-1.5,23,EL
3befc2b6,7,539,6.0,6,4,1,1,5,12,-7,4.8,10.2,-5.4,23,EL
3c6bbbab,2,180,2.0,2,2,0,0,1,4,-3,1.1,4.4,-3.4,23,EL
3ca7254a,5,277,3.1,3,1,2,0,3,6,-3,3.6,3.9,-0.3,23,EL
3cd7820a,2,180,2.0,2,2,0,0,1,2,-1,2.1,3.6,-1.5,23,EL
3d3ac5b8,2,97,1.1,1,1,1,4,2,2,0,1.3,2.0,-0.8,23,EL
3d50bcdb,5,233,2.6,3,0,2,2,3,0,3,5.2,2.0,3.2,23,EL
3d62c18b,5,381,4.2,4,4,1,1,4,7,-3,2.0,4.2,-2.1,23,EL
3da8cba0,1,90,1.0,1,1,0,4,1,2,-1,0.7,1.8,-1.2,23,EL
3dd738a1,2,124,1.4,1,0,1,2,2,3,-1,1.5,1.5,0.0,23,EL
3e9bd29d,3,300,3.3,3,3,0,0,4,10,-6,2.9,5.7,-2.8,23,EL
3ead85f9,4,342,3.8,4,3,0,2,7,7,0,5.4,5.2,0.2,23,EL
3ec9f005,3,240,2.7,3,1,0,1,5,5,0,3.4,2.5,0.8,23,EL
3ee0dd59,4,360,4.0,4,4,0,4,1,3,-2,4.6,3.6,1.0,23,EL
3ef0fa48,1,31,0.3,0,0,1,7,0,1,-1,0.3,0.2,0.1,23,EL
3f10bd22,9,689,7.7,7,4,2,0,14,4,10,8.0,10.0,-2.0,23,EL
3f30f12a,5,406,4.5,5,1,0,1,4,9,-5,3.8,7.5,-3.7,23,EL
3f5f38fb,2,99,1.1,1,1,1,3,0,1,-1,0.9,1.2,-0.2,23,EL
3fa66cb2,1,45,0.5,1,0,0,3,1,0,1,0.4,0.8,-0.4,23,EL
3fba18d3,3,107,1.2,1,1,2,3,3,3,0,0.8,0.8,0.1,23,EL
4030c7ae,8,720,8.0,8,8,0,0,8,13,-5,7.8,12.3,-4.6,23,EL
4047c976,4,189,2.1,2,1,2,1,0,3,-3,1.1,2.2,-1.1,23,EL
40dc75f0,1,1,0.0,0,0,1,5,0,0,0,0.0,0.0,0.0,23,EL
41034650,2,180,2.0,2,2,0,0,1,3,-2,2.3,2.6,-0.3,23,EL
4123bc9a,4,174,1.9,1,0,3,1,1,3,-2,1.7,2.3,-0.6,23,EL
415568b5,4,352,3.9,4,2,0,0,4,8,-4,2.8,7.5,-4.7,23,EL
41f0b196,4,390,4.3,4,4,0,0,5,11,-6,3.2,7.7,-4.5,23,EL
41f32541,9,853,9.5,8,7,1,0,14,8,6,8.7,13.5,-4.8,23,EL
42f8775b,5,313,3.5,4,1,1,1,3,6,-3,2.5,4.8,-2.4,23,EL
4315f30d,3,290,3.2,3,2,0,4,2,8,-6,4.0,3.4,0.5,23,EL
43458538,4,264,2.9,3,0,1,1,3,4,-1,3.9,2.3,1.6,23,EL
4352d221,6,512,5.7,6,4,0,0,11,8,3,5.9,8.5,-2.6,23,EL
44150beb,5,450,5.0,5,5,0,3,8,1,7,7.1,2.4,4.7,23,EL
4431aed2,4,312,3.5,4,1,0,0,7,7,0,5.2,5.8,-0.6,23,EL
44400941,6,447,5.0,5,2,1,0,6,9,-3,4.2,5.5,-1.2,23,EL
44ac04e9,6,241,2.7,2,0,4,0,6,5,1,4.3,3.8,0.5,23,EL
44f050bc,1,90,1.0,1,1,0,4,1,2,-1,0.5,1.4,-0.9,23,EL
45191c29,12,858,9.5,8,6,4,2,10,8,2,14.8,8.0,6.8,23,EL
4534a352,2,210,2.3,2,2,0,0,3,3,0,4.2,2.4,1.8,23,EL
45c29ae7,5,137,1.5,1,0,4,1,2,2,0,3.0,2.0,1.1,23,EL
45db685d,2,134,1.5,2,0,0,0,3,3,0,2.5,2.7,-0.1,23,EL
4601e194,1,66,0.7,1,0,0,1,1,2,-1,0.6,2.0,-1.4,23,EL
466824fb,4,266,3.0,3,1,1,0,2,5,-3,2.5,4.6,-2.1,23,EL
466fb2c5,3,300,3.3,3,3,0,5,2,3,-1,4.7,2.5,2.2,23,EL
46a8347f,4,295,3.3,3,2,1,0,0,8,-8,1.8,5.3,-3.5,23,EL
4736039a,6,117,1.3,1,0,5,0,1,2,-1,2.1,1.8,0.3,23,EL
47420f02,3,183,2.0,3,0,0,0,2,4,-2,2.2,4.2,-2.0,23,EL
4760b2f2,1,90,1.0,1,1,0,5,1,1,0,1.6,1.7,-0.1,23,EL
47a34c4f,1,61,0.7,1,0,0,0,1,0,1,1.3,0.2,1.1,23,EL
47aaf574,6,440,4.9,5,2,1,0,2,11,-9,3.3,9.5,-6.2,23,EL
47dbe004,8,719,8.0,8,7,0,0,8,13,-5,7.8,12.1,-4.3,23,EL
47fd5136,1,90,1.0,1,1,0,3,1,1,0,0.3,2.0,-1.8,23,EL
4876c9ab,8,431,4.8,4,3,4,2,13,6,7,7.5,8.4,-1.0,23,EL
489e80e3,8,647,7.2,8,4,0,0,10,12,-2,10.0,7.6,2.5,23,EL
48a5a5d6,7,494,5.5,5,4,2,1,7,6,1,10.0,6.0,4.1,23,EL
49d028db,4,360,4.0,4,4,0,4,7,3,4,5.5,4.2,1.3,23,EL
4a1abff3,6,539,6.0,6,5,0,0,9,5,4,9.0,5.9,3.1,23,EL
4a51ba65,5,450,5.0,5,5,0,1,9,3,6,11.0,5.1,5.9,23,EL
4a5a45c7,14,1160,12.9,14,5,0,0,19,7,12,23.0,10.4,12.6,23,EL
4a7078f9,5,444,4.9,5,4,0,0,4,7,-3,3.8,7.0,-3.2,23,EL
4b00cd47,6,484,5.4,5,4,1,0,4,6,-2,5.9,5.6,0.2,23,EL
4bd00a50,4,234,2.6,3,2,1,0,1,7,-6,1.2,3.8,-2.6,23,EL
4c184730,2,72,0.8,0,0,2,0,0,0,0,0.7,0.9,-0.2,23,EL
4c1e579e,1,13,0.1,0,0,1,2,0,0,0,0.1,0.0,0.1,23,EL
4c2e9442,3,160,1.8,3,1,0,0,3,3,0,2.3,2.3,0.0,23,EL
4c5039bd,2,180,2.0,2,2,0,2,1,1,0,2.3,1.9,0.3,23,EL
4c5b14d2,7,399,4.4,7,0,0,0,7,7,0,4.5,6.6,-2.1,23,EL
4c62d0c8,1,47,0.5,0,0,1,6,1,0,1,0.7,1.2,-0.5,23,EL
4c6e2ab5,1,2,0.0,0,0,1,1,0,1,-1,0.0,0.2,-0.2,23,EL
4c82730b,4,300,3.3,3,3,1,1,7,7,0,5.6,4.1,1.5,23,EL
4d0be953,3,93,1.0,1,1,2,7,1,1,0,0.7,0.8,0.0,23,EL
4d1666ff,2,180,2.0,2,2,0,0,3,4,-1,2.2,3.2,-1.0,23,EL
4d224fe8,12,987,11.0,11,8,1,0,15,11,4,19.8,9.9,9.9,23,EL
4db2157a,6,468,5.2,5,4,1,0,5,12,-7,6.3,8.3,-1.9,23,EL
4dcec659,9,415,4.6,3,2,6,1,10,9,1,5.2,5.9,-0.7,23,EL
4dedd469,6,534,5.9,6,5,0,0,9,10,-1,7.6,7.3,0.4,23,EL
4e219ad2,8,285,3.2,0,0,8,0,7,3,4,3.1,4.9,-1.9,23,EL
4e3f5992,2,88,1.0,1,0,1,3,0,1,-1,0.6,0.4,0.3,23,EL
4e4b59a4,1,2,0.0,0,0,1,4,0,1,-1,0.0,0.4,-0.4,23,EL
4e6dbac4,6,333,3.7,3,2,3,0,4,6,-2,4.0,4.8,-0.9,23,EL
4e7db402,8,720,8.0,8,8,0,0,7,15,-8,7.6,12.8,-5.2,23,EL
4f5a953e,4,360,4.0,4,4,0,1,7,2,5,5.7,3.7,2.0,23,EL
4f9f721c,4,119,1.3,2,0,2,4,1,1,0,0.8,3.4,-2.6,23,EL
4fac8f81,10,930,10.3,10,10,0,0,23,15,8,14.4,14.2,0.2,23,EL
50385760,6,463,5.1,5,4,1,0,4,8,-4,3.5,8.4,-4.9,23,EL
507c7bdf,11,863,9.6,10,7,1,0,19,6,13,20.6,7.1,13.5,23,EL
50871bcc,1,29,0.3,0,0,1,0,0,0,0,0.5,0.2,0.3,23,EL
50c1ff86,3,270,3.0,3,3,0,3,6,7,-1,4.8,4.1,0.8,23,EL
50cddd19,5,196,2.2,2,0,3,1,1,4,-3,0.8,3.1,-2.3,23,EL
50dc94ce,2,69,0.8,1,0,1,0,2,0,2,1.8,0.6,1.2,23,EL
50ff205b,8,720,8.0,8,8,0,0,14,9,5,13.5,6.2,7.3,23,EL
510c6a3f,1,90,1.0,1,1,0,7,2,1,1,1.6,1.0,0.6,23,EL
5148dcc5,6,387,4.3,5,0,1,0,9,4,5,6.0,3.3,2.6,23,EL
51cf8561,3,204,2.3,2,1,1,1,3,3,0,3.3,3.6,-0.3,23,EL
51ffa295,7,266,3.0,3,0,4,0,4,4,0,3.1,5.4,-2.4,23,EL
52061089,7,496,5.5,6,2,1,0,10,7,3,4.8,7.2,-2.3,23,EL
52522325,1,15,0.2,0,0,1,5,2,0,2,0.5,0.0,0.5,23,EL
5294a83f,4,307,3.4,4,2,0,2,6,7,-1,5.6,5.6,0.1,23,EL
529f49ab,6,170,1.9,0,0,6,1,1,1,0,2.5,1.3,1.2,23,EL
52afb588,4,125,1.4,1,0,3,1,4,0,4,2.0,2.4,-0.4,23,EL
52ec54d0,3,137,1.5,1,0,2,3,1,1,0,2.6,2.0,0.7,23,EL
5333d7de,2,58,0.6,0,0,2,4,0,2,-2,0.2,0.4,-0.2,23,EL
53342701,10,828,9.2,10,7,0,0,16,13,3,9.7,10.4,-0.7,23,EL
53d93280,8,750,8.3,8,8,0,0,15,13,2,10.8,13.4,-2.6,23,EL
53de807a,2,67,0.7,1,0,1,4,0,4,-4,0.9,2.7,-1.8,23,EL
53e442e2,5,161,1.8,2,0,3,2,2,3,-1,1.5,5.0,-3.5,23,EL
541127d5,6,246,2.7,2,0,4,0,0,5,-5,1.6,5.2,-3.6,23,EL
54b4dc4e,5,262,2.9,2,2,3,3,5,2,3,4.2,1.6,2.6,23,EL
54bb5c3f,3,225,2.5,3,2,0,0,3,6,-3,1.7,4.6,-2.9,23,EL
54e4866f,8,508,5.6,6,2,2,0,9,5,4,7.6,6.2,1.4,23,EL
5521f419,8,367,4.1,4,0,4,0,11,5,6,7.5,4.6,3.0,23,EL
5529a99a,1,16,0.2,0,0,1,5,1,0,1,0.4,0.0,0.4,23,EL
555d5edd,6,268,3.0,3,1,3,1,6,2,4,3.6,1.8,1.8,23,EL
55e81c76,3,98,1.1,1,0,2,2,1,0,1,1.0,0.5,0.5,23,EL
563cbac0,7,570,6.3,7,5,0,0,10,12,-2,5.8,11.6,-5.8,23,EL
56bcde74,2,180,2.0,2,2,0,3,1,1,0,2.3,1.9,0.3,23,EL
56dd5e10,4,332,3.7,4,3,0,2,2,8,-6,2.8,6.6,-3.7,23,EL
5715bb71,8,689,7.7,8,5,0,0,13,11,2,7.2,11.5,-4.3,23,EL
572498c7,3,206,2.3,2,1,1,1,2,6,-4,1.3,3.4,-2.1,23,EL
57469b2d,2,37,0.4,0,0,2,4,1,2,-1,0.8,0.8,0.0,23,EL
57760e66,6,526,5.8,6,2,0,0,7,6,1,10.5,6.3,4.1,23,EL
57d9707f,3,131,1.5,1,1,2,2,1,2,-1,1.4,2.2,-0.8,23,EL
582beb9d,6,495,5.5,6,5,0,0,2,12,-10,3.7,12.1,-8.4,23,EL
5832ebfe,4,341,3.8,4,3,0,2,9,7,2,3.5,6.6,-3.1,23,EL
5853ac44,4,342,3.8,4,3,0,2,5,4,1,2.6,5.2,-2.6,23,EL
58a3a572,6,485,5.4,6,4,0,0,3,16,-13,5.3,9.8,-4.4,23,EL
58a9a4d9,8,500,5.6,8,0,0,1,5,4,1,4.8,6.9,-2.1,23,EL
595ccab1,6,540,6.0,6,6,0,0,9,5,4,9.0,5.9,3.0,23,EL
595e6f3e,8,619,6.9,7,4,1,0,7,13,-6,6.0,10.2,-4.2,23,EL
59671448,6,465,5.2,6,3,0,0,2,11,-9,3.8,10.9,-7.0,23,EL
596cc50e,7,405,4.5,4,3,3,3,10,10,0,7.6,7.5,0.2,23,EL
59878425,3,146,1.6,2,0,1,2,4,1,3,4.3,1.5,2.8,23,EL
59e4b92e,10,900,10.0,10,10,0,0,10,9,1,12.0,8.5,3.4,23,EL
5aa53281,14,1304,14.5,14,13,0,0,17,9,8,24.2,11.7,12.5,23,EL
5ab0ea87,1,90,1.0,1,1,0,0,1,2,-1,1.2,1.1,0.1,23,EL
5b479568,4,118,1.3,0,0,4,2,1,2,-1,2.2,0.8,1.4,23,EL
5c26ca51,9,772,8.6,9,5,0,1,15,12,3,9.1,8.4,0.6,23,EL
5c46e908,4,316,3.5,4,1,0,2,2,9,-7,4.3,5.4,-1.1,23,EL
5c7845f6,5,369,4.1,4,4,1,2,4,3,1,4.8,2.5,2.3,23,EL
5c78cb9e,1,7,0.1,0,0,1,3,0,0,0,0.3,0.1,0.2,23,EL
5ccc9672,2,114,1.3,1,1,1,0,2,2,0,1.6,1.3,0.4,23,EL
5ce0b5ba,4,241,2.7,3,0,1,4,3,2,1,2.2,1.5,0.7,23,EL
5ceba7fc,2,172,1.9,2,0,0,0,2,2,0,3.3,2.2,1.0,23,EL
5d0e0a1f,8,426,4.7,4,3,4,0,8,8,0,6.6,6.0,0.6,23,EL
5d4e9f31,4,226,2.5,3,0,1,0,3,2,1,2.4,3.9,-1.5,23,EL
5d4f7d61,3,56,0.6,0,0,3,0,0,2,-2,0.7,0.8,-0.2,23,EL
5d873dfb,6,537,6.0,6,5,0,0,5,10,-5,5.3,10.1,-4.8,23,EL
5d8e331f,7,626,7.0,7,6,0,1,11,5,6,8.6,9.5,-0.9,23,EL
5db7ba90,4,130,1.4,1,1,3,2,3,0,3,2.0,0.8,1.2,23,EL
5e22e2a4,3,199,2.2,2,1,1,0,3,1,2,3.1,1.6,1.6,23,EL
5e42afa3,5,203,2.3,1,1,4,0,2,5,-3,1.4,2.2,-0.8,23,EL
5e8936be,6,540,6.0,6,6,0,0,9,11,-2,7.6,7.5,0.1,23,EL
5ef3d210,1,7,0.1,0,0,1,1,0,0,0,0.2,0.3,0.0,23,EL
5f09991f,2,134,1.5,2,0,0,0,0,3,-3,1.1,1.2,-0.1,23,EL
5f3eaaf5,8,393,4.4,5,0,3,0,2,8,-6,1.9,7.6,-5.6,23,EL
5fa714d5,5,176,2.0,2,0,3,1,3,2,1,2.1,1.2,0.9,23,EL
5fcb90ac,3,195,2.2,3,2,0,0,1,4,-3,2.0,3.4,-1.4,23,EL
5fd5ed86,7,640,7.1,7,6,0,0,10,4,6,12.1,6.3,5.8,23,EL
603116a7,3,84,0.9,0,0,3,0,0,5,-5,0.2,2.7,-2.5,23,EL
60713cb3,5,450,5.0,5,5,0,1,4,7,-3,3.6,7.6,-4.0,23,EL
60831426,6,540,6.0,6,6,0,0,5,10,-5,5.7,10.4,-4.7,23,EL
60c07b31,2,179,2.0,2,1,0,1,1,4,-3,2.5,3.5,-1.1,23,EL
6115fddd,6,540,6.0,6,6,0,0,5,16,-11,7.0,10.0,-3.0,23,EL
6190474d,5,253,2.8,2,1,3,2,7,2,5,5.3,2.2,3.2,23,EL
6191093d,8,675,7.5,7,7,1,0,7,15,-8,7.3,12.2,-4.9,23,EL
625c144a,2,180,2.0,2,2,0,0,1,3,-2,2.3,2.6,-0.3,23,EL
62de9d42,6,428,4.8,5,2,1,0,3,8,-5,5.2,4.6,0.5,23,EL
62f7c156,3,270,3.0,3,3,0,5,3,5,-2,1.9,5.3,-3.5,23,EL
63567ebc,6,496,5.5,6,4,0,0,2,11,-9,3.9,11.1,-7.2,23,EL
6358cb11,5,391,4.3,5,3,0,0,4,4,0,3.7,5.2,-1.6,23,EL
6412cc03,8,665,7.4,8,4,0,0,10,6,4,13.8,7.2,6.7,23,EL
6445d6fe,4,70,0.8,0,0,4,2,1,2,-1,0.3,0.9,-0.6,23,EL
6456e745,6,219,2.4,2,0,4,0,4,3,1,2.5,3.0,-0.6,23,EL
64f69877,5,239,2.7,2,0,3,1,5,4,1,3.6,2.3,1.4,23,EL
6510079f,3,110,1.2,1,0,2,1,2,2,0,1.1,1.9,-0.8,23,EL
651fa4db,2,21,0.2,0,0,2,4,0,1,-1,0.2,0.2,0.0,23,EL
6578600f,3,186,2.1,2,0,1,0,3,2,1,1.8,2.7,-0.9,23,EL
65857fdf,2,31,0.3,0,0,2,4,0,0,0,0.2,0.0,0.2,23,EL
65d62814,6,570,6.3,6,6,0,0,9,6,3,11.6,6.4,5.2,23,EL
6603fed7,6,504,5.6,6,3,0,0,9,4,5,6.7,5.2,1.5,23,EL
6637e6a7,6,533,5.9,6,5,0,0,4,10,-6,6.2,6.6,-0.4,23,EL
66c52a77,6,469,5.2,5,5,1,2,8,4,4,9.7,2.9,6.8,23,EL
6747869d,2,16,0.2,0,0,2,0,1,0,1,0.2,0.0,0.2,23,EL
67ac5bb8,7,517,5.7,5,5,2,1,8,2,6,12.0,4.0,8.0,23,EL
67b054d1,5,449,5.0,5,4,0,0,1,11,-10,3.6,11.3,-7.7,23,EL
67f0703d,2,179,2.0,2,1,0,2,1,4,-3,1.6,3.1,-1.5,23,EL
686cbe7d,1,45,0.5,1,0,0,0,0,0,0,0.1,0.2,-0.1,23,EL
6885cc44,2,172,1.9,2,1,0,0,1,2,-1,2.0,3.6,-1.6,23,EL
68a26d51,8,467,5.2,6,1,2,0,6,10,-4,4.7,7.4,-2.7,23,EL
6aafdc27,6,540,6.0,6,6,0,0,7,10,-3,4.6,8.9,-4.2,23,EL
6b658db0,1,19,0.2,0,0,1,2,0,1,-1,0.0,1.1,-1.1,23,EL
6b6c793c,9,662,7.4,8,5,1,3,11,6,5,16.0,4.9,11.1,23,EL
6bd5cd5d,10,891,9.9,10,9,0,0,10,9,1,11.9,8.5,3.4,23,EL
6bd603db,4,231,2.6,3,1,1,1,6,5,1,2.2,4.5,-2.3,23,EL
6c249ea7,5,367,4.1,3,3,2,1,1,7,-6,1.9,6.3,-4.4,23,EL
6c5af908,4,360,4.0,4,4,0,3,7,3,4,8.2,3.4,4.8,23,EL
6caffe81,1,7,0.1,0,0,1,2,1,0,1,0.2,0.1,0.2,23,EL
6cbf8d0d,6,423,4.7,5,2,1,0,8,5,3,5.2,4.7,0.6,23,EL
6d86d9cd,6,530,5.9,6,3,0,0,9,5,4,8.9,5.9,3.0,23,EL
6db16dda,3,43,0.5,0,0,3,0,1,2,-1,0.5,0.2,0.2,23,EL
6e2c94ad,5,235,2.6,2,1,3,1,7,3,4,2.7,4.0,-1.2,23,EL
6e2e6e4e,1,1,0.0,0,0,1,0,0,0,0,0.0,0.0,0.0,23,EL
6e44569a,7,436,4.8,5,3,2,1,9,5,4,6.4,5.3,1.1,23,EL
6e4df551,3,35,0.4,0,0,3,2,1,1,0,0.2,1.5,-1.3,23,EL
6f51e382,2,180,2.0,2,2,0,0,3,4,-1,2.2,3.2,-1.0,23,EL
6f5f82c0,5,309,3.4,4,0,1,2,2,2,0,4.0,2.9,1.2,23,EL
6fd8a334,5,421,4.7,5,3,0,0,8,7,1,6.0,6.1,-0.1,23,EL
6ff91a3a,3,92,1.0,1,0,2,5,3,2,1,1.4,1.5,-0.1,23,EL
706a337d,2,69,0.8,0,0,2,0,1,4,-3,0.6,1.3,-0.7,23,EL
70c52749,7,446,5.0,5,4,2,1,8,6,2,7.8,4.3,3.5,23,EL
70dcf94d,9,642,7.1,8,1,1,0,7,6,1,8.0,6.0,2.1,23,EL
71115017,6,505,5.6,6,5,0,0,3,10,-7,3.0,8.3,-5.3,23,EL
713c144a,2,180,2.0,2,2,0,0,1,3,-2,2.3,2.6,-0.3,23,EL
718a3a5c,6,533,5.9,6,5,0,0,4,10,-6,3.8,9.8,-6.0,23,EL
720ebb4e,1,2,0.0,0,0,1,2,0,0,0,0.0,0.4,-0.4,23,EL
7242b495,7,141,1.6,1,1,6,3,2,3,-1,2.1,3.1,-1.0,23,EL
7287ea6b,5,217,2.4,2,1,3,0,2,6,-4,1.3,2.8,-1.5,23,EL
72c01cfb,5,196,2.2,1,1,4,3,3,2,1,2.1,3.7,-1.6,23,EL
72f87f25,3,127,1.4,1,0,2,11,5,2,3,4.4,1.0,3.3,23,EL
731302dc,6,364,4.0,5,0,1,0,3,6,-3,4.9,3.5,1.4,23,EL
7328bee5,2,180,2.0,2,2,0,0,1,2,-1,2.9,0.8,2.1,23,EL
73b1d487,6,410,4.6,6,2,0,0,2,9,-7,3.1,8.7,-5.6,23,EL
743ffce1,6,286,3.2,3,0,3,0,3,5,-2,2.5,6.0,-3.5,23,EL
746b64a7,5,370,4.1,4,4,1,0,4,8,-4,4.3,4.9,-0.6,23,EL
7483d9f9,7,584,6.5,6,5,1,1,15,6,9,8.2,8.4,-0.3,23,EL
74d4cec6,5,403,4.5,5,2,0,1,6,4,2,4.7,4.8,-0.1,23,EL
74f2e748,8,700,7.8,8,4,0,0,13,7,6,11.7,6.9,4.9,23,EL
75229233,1,90,1.0,1,1,0,1,1,2,-1,0.2,1.1,-0.9,23,EL
75645f0e,6,148,1.6,0,0,6,2,2,1,1,2.3,2.2,0.1,23,EL
756959aa,4,262,2.9,4,0,0,0,2,10,-8,3.7,5.4,-1.7,23,EL
7673e4bc,1,5,0.1,0,0,1,5,0,1,-1,0.0,0.4,-0.4,23,EL
770ebf00,5,450,5.0,5,5,0,0,1,8,-7,2.9,8.1,-5.2,23,EL
7713c72a,3,300,3.3,3,3,0,0,4,10,-6,2.9,5.7,-2.8,23,EL
779847d6,7,537,6.0,7,4,0,1,5,10,-5,5.6,6.9,-1.3,23,EL
77ac1d89,6,224,2.5,2,0,4,0,5,0,5,2.4,2.4,0.0,23,EL
77e39b04,6,396,4.4,4,1,2,0,7,6,1,7.7,5.3,2.4,23,EL
78f13530,5,348,3.9,4,2,1,0,3,6,-3,3.9,6.3,-2.5,23,EL
79300479,7,243,2.7,2,0,5,0,3,1,2,4.9,2.0,2.9,23,EL
79443529,8,463,5.1,5,0,3,0,7,5,2,8.7,6.0,2.7,23,EL
79b0d6a0,14,1320,14.7,14,14,0,1,20,9,11,26.7,11.7,15.0,23,EL
7a2cf111,6,520,5.8,6,3,0,0,9,7,2,6.8,6.1,0.6,23,EL
7a4cea18,3,48,0.5,0,0,3,1,0,2,-2,0.2,1.2,-1.0,23,EL
7aa8adfe,6,215,2.4,2,0,4,3,4,0,4,2.8,1.4,1.4,23,EL
7af31216,6,349,3.9,3,2,3,0,2,9,-7,3.4,8.0,-4.7,23,EL
7b456af7,2,180,2.0,2,2,0,0,1,5,-4,0.6,3.3,-2.6,23,EL
7b5ab7f2,7,434,4.8,6,0,1,2,6,3,3,4.9,5.0,-0.2,23,EL
7b9ecf02,6,495,5.5,6,5,0,0,4,8,-4,6.1,6.3,-0.2,23,EL
7ba6d84e,12,1080,12.0,12,12,0,0,21,12,9,23.9,10.4,13.6,23,EL
7bf8ad6c,6,463,5.1,6,2,0,0,7,8,-1,5.0,7.6,-2.6,23,EL
7c106fcf,2,168,1.9,2,1,0,2,1,2,-1,0.5,3.5,-3.0,23,EL
7ca9f0f0,5,328,3.6,4,0,1,0,6,6,0,5.1,5.4,-0.3,23,EL
7cb9de24,6,539,6.0,6,5,0,0,8,9,-1,6.2,8.3,-2.1,23,EL
7cc5bd9c,3,15,0.2,0,0,3,3,0,1,-1,0.0,1.4,-1.4,23,EL
7cd78926,5,446,5.0,5,4,0,1,7,8,-1,4.6,6.6,-2.0,23,EL
7d31f1cb,1,45,0.5,0,0,1,1,0,1,-1,0.3,0.5,-0.2,23,EL
7d7660da,6,192,2.1,1,0,5,0,3,6,-3,2.2,3.8,-1.5,23,EL
7e6b3664,1,45,0.5,0,0,1,2,0,3,-3,0.1,1.8,-1.7,23,EL
7e82a78f,2,87,1.0,1,0,1,0,0,2,-2,0.2,2.6,-2.3,23,EL
7f8fb807,3,87,1.0,1,0,2,5,1,1,0,0.9,0.3,0.6,23,EL
7f9c5d2d,2,115,1.3,2,1,0,0,1,4,-3,0.7,3.2,-2.6,23,EL
7fdb872a,2,35,0.4,0,0,2,4,0,1,-1,0.6,0.6,0.0,23,EL
803e7aca,6,497,5.5,6,2,0,0,11,9,2,7.7,5.7,2.0,23,EL
80556f08,4,199,2.2,3,0,1,2,2,4,-2,3.1,3.3,-0.1,23,EL
8059806f,7,436,4.8,4,0,3,1,11,6,5,6.0,4.6,1.4,23,EL
808035bd,6,540,6.0,6,6,0,0,9,5,4,9.0,5.9,3.0,23,EL
8104e41e,8,551,6.1,6,2,2,0,12,11,1,9.1,7.4,1.8,23,EL
81069528,5,402,4.5,5,3,0,1,6,8,-2,4.0,7.5,-3.5,23,EL
81255c03,7,263,2.9,3,0,4,1,4,6,-2,3.9,2.7,1.2,23,EL
81442ecb,8,712,7.9,8,4,0,0,13,7,6,7.8,11.1,-3.3,23,EL
819aa8e7,2,121,1.3,2,0,0,0,1,4,-3,1.4,3.2,-1.7,23,EL
822d51d7,8,708,7.9,8,6,0,0,13,13,0,11.2,8.3,3.0,23,EL
826e8b63,5,400,4.4,5,3,0,0,13,1,12,5.8,5.6,0.2,23,EL
82cfae2a,6,540,6.0,6,6,0,0,3,11,-8,3.3,9.2,-5.9,23,EL
82e12fe7,2,104,1.2,1,0,1,0,1,2,-1,1.5,2.8,-1.3,23,EL
82e9b1bb,7,369,4.1,3,3,4,1,5,7,-2,5.0,4.2,0.8,23,EL
82efe6fa,13,1114,12.4,12,11,1,0,13,10,3,20.6,10.6,10.0,23,EL
830a34ec,1,45,0.5,1,0,0,0,0,1,-1,0.0,1.6,-1.6,23,EL
83300259,1,45,0.5,1,0,0,1,0,0,0,0.0,0.5,-0.5,23,EL
8382b207,3,74,0.8,1,0,2,0,0,0,0,0.7,1.1,-0.4,23,EL
839c14e1,1,3,0.0,0,0,1,4,0,0,0,0.2,0.0,0.2,23,EL
83c06f3a,1,11,0.1,0,0,1,1,0,0,0,0.2,0.4,-0.1,23,EL
83e4643e,3,122,1.4,1,0,2,4,3,0,3,2.4,0.1,2.3,23,EL
84399660,3,174,1.9,3,1,0,0,1,4,-3,1.6,4.4,-2.7,23,EL
85613cf0,4,127,1.4,1,0,3,0,1,0,1,1.9,1.3,0.5,23,EL
8593f88c,8,658,7.3,8,6,0,0,13,4,9,10.0,9.6,0.4,23,EL
85bed4ee,6,405,4.5,3,3,3,2,8,2,6,6.5,3.5,3.1,23,EL
85c76f0a,1,32,0.4,0,0,1,3,0,1,-1,0.8,0.5,0.3,23,EL
85f476cc,7,148,1.6,1,1,6,3,4,4,0,2.6,3.8,-1.2,23,EL
8614496d,5,401,4.5,4,4,1,0,3,10,-7,2.4,10.7,-8.3,23,EL
867239d3,3,47,0.5,0,0,3,0,1,0,1,1.1,1.6,-0.5,23,EL
8794e251,8,750,8.3,8,8,0,0,11,5,6,14.1,8.6,5.5,23,EL
88968486,5,427,4.7,5,4,0,0,4,9,-5,3.1,5.6,-2.5,23,EL
890f108d,5,131,1.5,1,0,4,1,1,0,1,2.3,1.3,1.0,23,EL
89c63f8c,2,151,1.7,2,1,0,2,1,3,-2,2.8,2.0,0.8,23,EL
89f951b5,9,862,9.6,9,8,0,0,14,8,6,8.7,13.7,-5.0,23,EL
8a2248b4,7,630,7.0,7,7,0,1,15,6,9,8.7,8.5,0.2,23,EL
8a56c04c,7,545,6.1,6,3,1,1,4,8,-4,5.2,7.8,-2.6,23,EL
8b0d9f35,4,192,2.1,2,1,2,0,1,4,-3,1.5,3.6,-2.1,23,EL
8b3ab7ad,2,179,2.0,2,1,0,0,1,3,-2,2.3,2.6,-0.3,23,EL
8b5504e1,10,739,8.2,8,6,2,0,16,11,5,9.9,9.8,0.1,23,EL
8b788c01,3,144,1.6,2,0,1,0,4,3,1,3.8,2.8,0.9,23,EL
8bc373ea,4,293,3.3,3,2,1,1,1,9,-8,1.8,5.8,-4.0,23,EL
8c3c640c,2,95,1.1,1,0,1,0,0,1,-1,1.7,0.7,1.0,23,EL
8c5506ec,4,303,3.4,4,2,0,0,1,5,-4,2.0,4.3,-2.3,23,EL
8c6239f2,2,180,2.0,2,2,0,0,0,4,-4,1.5,3.4,-1.9,23,EL
8c725b43,6,469,5.2,5,5,1,2,6,8,-2,5.4,8.4,-2.9,23,EL
8cd49575,1,28,0.3,0,0,1,1,0,2,-2,0.0,0.3,-0.3,23,EL
8d62d31a,5,450,5.0,5,5,0,3,10,8,2,6.8,5.6,1.2,23,EL
8d7323e8,6,258,2.9,2,0,4,0,2,9,-7,3.4,4.6,-1.1,23,EL
8d78e732,2,180,2.0,2,2,0,0,3,4,-1,2.2,3.2,-1.0,23,EL
8dcf77c0,5,185,2.1,2,0,3,1,5,5,0,2.6,2.1,0.5,23,EL
8df5b30f,6,206,2.3,2,0,4,0,3,5,-2,1.5,3.6,-2.0,23,EL
8e235926,7,272,3.0,4,0,3,1,6,2,4,4.1,5.0,-1.0,23,EL
8e34b9f5,6,446,5.0,5,4,1,2,8,6,2,8.8,3.3,5.5,23,EL
8e456005,3,216,2.4,2,1,1,3,0,6,-6,1.6,4.3,-2.7,23,EL
8e48dc61,5,378,4.2,4,4,1,3,9,1,8,6.3,1.1,5.2,23,EL
8eb55dbb,10,857,9.5,10,2,0,0,9,9,0,11.3,8.1,3.2,23,EL
8eeb8ba4,6,480,5.3,5,4,1,0,10,6,4,5.4,6.8,-1.4,23,EL
8eef18aa,1,75,0.8,1,0,0,3,3,3,0,1.5,0.9,0.6,23,EL
8f5bfaac,5,328,3.6,4,0,1,0,3,7,-4,2.5,5.7,-3.2,23,EL
90339309,5,434,4.8,5,4,0,0,8,4,4,8.4,4.5,4.0,23,EL
903b3b77,6,504,5.6,6,4,0,0,2,11,-9,3.3,11.5,-8.2,23,EL
9052e98c,2,180,2.0,2,2,0,4,0,5,-5,1.9,3.4,-1.5,23,EL
90b70194,5,279,3.1,4,1,1,0,2,5,-3,2.7,5.5,-2.8,23,EL
90d7dda6,4,232,2.6,4,0,0,1,4,3,1,3.2,3.7,-0.5,23,EL
90def3ab,3,21,0.2,0,0,3,3,2,0,2,1.1,0.1,1.0,23,EL
922dfade,6,433,4.8,5,3,1,2,9,5,4,8.6,2.8,5.7,23,EL
92d6bdc9,1,1,0.0,0,0,1,0,0,0,0,0.0,0.0,0.0,23,EL
92fa5d28,3,113,1.3,1,1,2,3,1,3,-2,2.2,2.9,-0.6,23,EL
939bc634,8,720,8.0,8,8,0,0,13,13,0,7.3,13.3,-6.0,23,EL
942b4f90,8,522,5.8,7,1,1,0,10,8,2,8.2,6.0,2.2,23,EL
94b2001f,8,741,8.2,8,7,0,0,11,5,6,14.1,8.3,5.8,23,EL
951f1739,5,252,2.8,3,0,2,1,7,3,4,4.2,2.6,1.6,23,EL
952afd27,6,451,5.0,5,4,1,0,5,7,-2,5.3,7.3,-2.0,23,EL
958ede06,1,90,1.0,1,1,0,3,1,4,-3,1.3,2.4,-1.1,23,EL
9614b550,6,493,5.5,6,4,0,0,10,8,2,5.7,8.5,-2.8,23,EL
972aeb2a,4,290,3.2,4,3,0,4,4,4,0,4.5,3.6,0.9,23,EL
975eda74,4,189,2.1,2,1,2,2,2,4,-2,1.4,3.7,-2.4,23,EL
97e2aa67,3,127,1.4,1,0,2,2,1,1,0,0.9,1.6,-0.7,23,EL
980522ec,8,532,5.9,6,3,2,0,10,7,3,9.9,4.9,5.0,23,EL
9866afec,5,302,3.4,3,0,2,0,4,4,0,3.7,3.3,0.4,23,EL
988dfee2,7,630,7.0,7,7,0,0,7,12,-5,7.0,11.3,-4.3,23,EL
9907b1c8,3,209,2.3,2,0,1,0,7,2,5,6.5,1.2,5.3,23,EL
99127249,9,632,7.0,8,1,1,0,12,6,6,13.8,5.4,8.4,23,EL
99351886,10,900,10.0,10,10,0,0,19,15,4,11.6,11.9,-0.3,23,EL
9937ce4a,6,492,5.5,6,2,0,0,4,8,-4,3.7,8.1,-4.4,23,EL
9980269a,2,35,0.4,0,0,2,2,1,1,0,0.3,0.4,-0.2,23,EL
9a64e67e,4,360,4.0,4,4,0,1,3,3,0,5.8,2.9,2.9,23,EL
9a71e978,2,112,1.2,1,0,1,4,2,1,1,1.8,1.3,0.5,23,EL
9a794238,3,76,0.8,1,0,2,3,3,2,1,1.9,0.5,1.5,23,EL
9b3ab988,8,450,5.0,6,3,2,2,12,6,6,7.1,4.2,2.9,23,EL
9bc9a519,2,210,2.3,2,2,0,0,3,3,0,4.2,2.4,1.8,23,EL
9bf914b4,10,864,9.6,10,7,0,0,22,13,9,14.1,12.9,1.2,23,EL
9c2b4382,4,104,1.2,2,0,2,1,2,3,-1,0.9,2.8,-1.9,23,EL
9c2e7413,2,4,0.0,0,0,2,4,1,0,1,0.3,0.2,0.0,23,EL
9c435456,5,424,4.7,5,3,0,1,9,10,-1,7.3,7.4,-0.1,23,EL
9c4f39b3,6,478,5.3,6,1,0,0,4,15,-11,6.0,9.0,-3.0,23,EL
9c74fa25,5,380,4.2,5,2,0,0,2,8,-6,5.1,5.5,-0.4,23,EL
9c94165b,9,505,5.6,4,3,5,1,14,7,7,10.8,5.7,5.1,23,EL
9ceb7642,6,388,4.3,4,2,2,0,1,7,-6,2.4,5.6,-3.2,23,EL
9d21da85,10,858,9.5,9,8,1,0,23,14,9,13.0,13.3,-0.2,23,EL
9d689a5b,4,232,2.6,3,0,1,1,2,7,-5,2.8,5.5,-2.7,23,EL
9d7d5334,2,19,0.2,0,0,2,1,0,0,0,0.6,0.2,0.4,23,EL
9d9e69df,5,295,3.3,3,1,2,0,2,6,-4,2.8,6.2,-3.4,23,EL
9e1035f8,2,29,0.3,0,0,2,0,0,1,-1,0.3,0.4,-0.1,23,EL
9e17ccff,2,129,1.4,1,1,1,6,1,3,-2,1.0,1.6,-0.6,23,EL
9e525177,6,410,4.6,5,2,1,2,9,6,3,8.6,4.9,3.7,23,EL
9e7483ff,7,220,2.4,1,0,6,0,3,5,-2,3.7,2.3,1.5,23,EL
9f115e20,5,419,4.7,5,3,0,0,4,6,-2,3.6,6.7,-3.1,23,EL
9f1893b9,6,437,4.9,5,4,1,0,8,10,-2,6.4,7.6,-1.2,23,EL
9f84febe,5,276,3.1,4,2,1,4,6,2,4,5.9,1.9,4.0,23,EL
9f8e9423,5,405,4.5,5,4,0,3,12,4,8,9.0,3.5,5.5,23,EL
a0415710,6,103,1.1,0,0,6,2,4,1,3,2.1,0.9,1.2,23,EL
a04e2dd2,2,180,2.0,2,2,0,4,3,5,-2,1.0,2.9,-1.9,23,EL
a08b974a,9,509,5.7,5,3,4,0,10,6,4,6.9,8.7,-1.9,23,EL
a0b730dc,4,199,2.2,2,2,2,1,1,4,-3,2.1,3.8,-1.7,23,EL
a0c590b9,5,211,2.3,3,0,2,0,2,3,-1,3.5,3.4,0.1,23,EL
a0f9b535,7,428,4.8,4,4,3,1,9,8,1,6.1,5.3,0.8,23,EL
a18c2d65,1,13,0.1,0,0,1,2,0,1,-1,0.0,0.7,-0.7,23,EL
a1c63a01,1,1,0.0,0,0,1,3,0,0,0,0.0,0.2,-0.2,23,EL
a1d5bd30,9,558,6.2,5,2,4,0,14,7,7,14.8,6.1,8.7,23,EL
a29b1131,2,153,1.7,2,0,0,0,1,3,-2,1.8,2.2,-0.3,23,EL
a29e5244,3,52,0.6,0,0,3,1,2,0,2,1.4,0.3,1.2,23,EL
a2d873dd,6,397,4.4,5,2,1,0,1,8,-7,2.6,6.0,-3.4,23,EL
a2f2d806,6,463,5.1,6,3,0,0,8,9,-1,7.1,6.2,0.9,23,EL
a36524bf,2,180,2.0,2,2,0,0,1,3,-2,2.3,2.6,-0.3,23,EL
a372a9f2,5,397,4.4,5,1,0,1,8,3,5,7.1,4.6,2.5,23,EL
a40819d9,3,68,0.8,0,0,3,6,2,0,2,1.6,0.7,0.8,23,EL
a4b1028a,3,262,2.9,3,2,0,1,7,5,2,4.3,3.0,1.3,23,EL
a53649b7,6,518,5.8,6,4,0,0,7,3,4,11.0,3.6,7.4,23,EL
a5549ec1,2,146,1.6,2,1,0,0,2,3,-1,1.7,1.9,-0.2,23,EL
a55ba2f8,3,173,1.9,2,1,1,1,1,4,-3,1.5,5.1,-3.6,23,EL
a55d8df5,8,630,7.0,7,6,1,0,12,6,6,9.0,8.3,0.7,23,EL
a62c16d0,4,330,3.7,4,1,0,0,7,4,3,6.9,3.3,3.6,23,EL
a62f8bf1,4,185,2.1,2,1,2,0,4,3,1,3.1,1.9,1.2,23,EL
a650c75b,4,322,3.6,4,3,0,0,5,4,1,7.5,4.3,3.3,23,EL
a6979b0f,4,279,3.1,3,0,1,0,5,4,1,2.3,2.3,-0.1,23,EL
a6de370d,8,483,5.4,4,2,4,0,9,5,4,5.9,6.5,-0.7,23,EL
a6ee4f55,6,311,3.5,3,1,3,0,4,2,2,5.0,2.8,2.2,23,EL
a70b8345,10,855,9.5,10,9,0,0,10,9,1,11.6,8.2,3.4,23,EL
a73c8f95,8,718,8.0,8,7,0,0,12,7,5,12.1,6.5,5.6,23,EL
a74ea18d,5,230,2.6,2,0,3,1,6,3,3,5.3,3.2,2.1,23,EL
a793f5a8,4,389,4.3,4,3,0,0,5,11,-6,3.2,7.7,-4.6,23,EL
a7d48b00,9,173,1.9,1,0,8,1,5,2,3,2.9,2.6,0.3,23,EL
a81dba8c,6,279,3.1,3,0,3,0,6,3,3,6.9,2.3,4.6,23,EL
a81ed730,6,334,3.7,4,1,2,0,3,9,-6,1.9,5.2,-3.3,23,EL
a83c19cf,2,102,1.1,1,0,1,1,1,1,0,0.8,1.0,-0.2,23,EL
a8567629,6,517,5.7,5,4,1,2,10,5,5,10.2,5.5,4.7,23,EL
a8a874f1,8,640,7.1,7,4,1,0,9,3,6,12.4,6.9,5.6,23,EL
a8f41212,4,159,1.8,2,0,2,1,2,1,1,3.5,1.2,2.3,23,EL
a8fbae1d,6,465,5.2,5,5,1,0,6,4,2,5.9,5.5,0.4,23,EL
a9107589,4,360,4.0,4,4,0,2,0,6,-6,2.2,6.2,-4.0,23,EL
a9142dc3,1,9,0.1,0,0,1,7,0,0,0,0.2,0.0,0.2,23,EL
a919be14,5,190,2.1,2,0,3,1,3,2,1,2.9,2.0,1.0,23,EL
a92ab7be,7,630,7.0,7,7,0,1,12,5,7,9.2,9.7,-0.5,23,EL
a93b6f4e,3,270,3.0,3,3,0,7,1,2,-1,2.7,1.9,0.8,23,EL
a99138af,3,68,0.8,0,0,3,3,1,1,0,2.0,0.5,1.5,23,EL
aa982b0f,6,506,5.6,6,4,0,0,4,9,-5,4.9,9.1,-4.2,23,EL
aad56ca3,7,452,5.0,5,1,2,0,9,8,1,8.2,5.1,3.1,23,EL
ab57e591,2,26,0.3,0,0,2,0,1,0,1,0.3,0.1,0.2,23,EL
abb3bb95,5,256,2.8,3,1,2,0,5,3,2,3.4,2.5,0.9,23,EL
abe66106,8,354,3.9,2,0,6,0,6,3,3,3.7,6.8,-3.1,23,EL
ac295d9e,3,270,3.0,3,3,0,6,2,3,-1,1.4,4.5,-3.1,23,EL
ac4961c8,6,259,2.9,3,1,3,0,3,9,-6,3.6,4.0,-0.5,23,EL
ac7e7b1c,3,109,1.2,1,1,2,7,2,2,0,2.8,1.5,1.3,23,EL
ad3389d5,8,750,8.3,8,8,0,0,14,8,6,13.4,7.4,6.0,23,EL
ad82197c,8,750,8.3,8,8,0,0,14,13,1,12.3,8.5,3.8,23,EL
ad9b2747,2,180,2.0,2,2,0,0,1,3,-2,2.3,2.6,-0.3,23,EL
adfbe1f5,4,339,3.8,4,1,0,0,2,8,-6,2.7,6.9,-4.2,23,EL
ae05689a,6,511,5.7,6,5,0,0,9,5,4,8.8,5.9,2.8,23,EL
ae1159bf,5,298,3.3,3,1,2,1,3,5,-2,6.6,3.5,3.1,23,EL
ae4e2852,3,142,1.6,2,0,1,1,4,1,3,3.2,0.8,2.4,23,EL
ae94a6c5,10,249,2.8,2,1,8,5,3,1,2,2.8,2.6,0.2,23,EL
aee634bf,3,300,3.3,3,3,0,0,4,10,-6,2.9,5.7,-2.8,23,EL
aeed5c06,8,565,6.3,7,2,1,0,9,4,5,8.7,5.0,3.7,23,EL
af0c835b,8,528,5.9,6,2,2,0,3,11,-8,5.4,10.1,-4.6,23,EL
af50141d,6,493,5.5,6,2,0,0,8,10,-2,7.0,6.8,0.2,23,EL
af686bed,6,498,5.5,6,3,0,0,8,8,0,5.8,8.2,-2.4,23,EL
afb0c500,8,750,8.3,8,8,0,0,14,13,1,12.3,8.5,3.8,23,EL
b003239d,1,90,1.0,1,1,0,7,1,0,1,1.4,0.2,1.2,23,EL
b026bbf6,5,299,3.3,3,3,2,1,5,4,1,4.0,2.6,1.4,23,EL
b0f7e36c,7,404,4.5,3,2,4,0,6,4,2,6.6,4.2,2.3,23,EL
b146275b,10,772,8.6,9,1,1,0,18,13,5,10.3,9.6,0.7,23,EL
b1cd37e6,8,409,4.5,5,0,3,0,5,2,3,8.1,4.2,3.9,23,EL
b396a0b1,4,351,3.9,4,2,0,1,5,7,-2,3.3,7.0,-3.6,23,EL
b3af9be1,8,400,4.4,5,2,3,0,6,3,3,9.4,3.3,6.1,23,EL
b3dc6eca,3,225,2.5,3,2,0,4,5,0,5,4.3,1.6,2.7,23,EL
b5f66351,5,375,4.2,5,2,0,1,5,6,-1,2.5,6.8,-4.4,23,EL
b625b241,1,45,0.5,0,0,1,7,0,1,-1,1.1,0.1,1.0,23,EL
b62878a5,2,180,2.0,2,2,0,0,1,3,-2,2.3,2.6,-0.3,23,EL
b66315ae,6,254,2.8,3,0,3,0,4,0,4,5.8,1.4,4.4,23,EL
b682dcf6,1,90,1.0,1,1,0,4,0,0,0,0.2,0.5,-0.3,23,EL
b684a484,8,401,4.5,4,1,4,1,4,5,-1,5.8,5.4,0.4,23,EL
b6964eb6,14,1155,12.8,12,11,2,1,17,10,7,22.6,10.0,12.7,23,EL
b69dfb42,6,540,6.0,6,6,0,0,4,10,-6,6.2,6.7,-0.5,23,EL
b6a1cdf9,6,224,2.5,2,0,4,0,2,6,-4,2.8,4.0,-1.2,23,EL
b73f17f8,8,386,4.3,4,2,4,0,4,9,-5,5.9,6.4,-0.5,23,EL
b742cc0d,6,540,6.0,6,6,0,0,11,9,2,6.0,8.6,-2.6,23,EL
b79d8e93,2,10,0.1,0,0,2,3,0,0,0,0.1,0.1,0.0,23,EL
b7b27de0,8,252,2.8,2,0,6,0,4,5,-1,2.1,3.6,-1.5,23,EL
b7de5bad,2,135,1.5,1,1,1,2,2,3,-1,2.8,1.5,1.3,23,EL
b853e0ad,9,527,5.9,6,3,3,3,9,7,2,13.4,5.5,7.8,23,EL
b8814868,6,504,5.6,6,4,0,0,3,11,-8,3.1,7.0,-3.9,23,EL
b91a6912,6,106,1.2,0,0,6,0,2,2,0,1.8,1.3,0.4,23,EL
b9392438,4,281,3.1,4,0,0,2,5,4,1,3.3,3.5,-0.2,23,EL
b956af7d,6,435,4.8,5,4,1,0,3,8,-5,2.8,7.1,-4.3,23,EL
ba3d3bea,6,366,4.1,4,2,2,0,7,7,0,6.3,6.8,-0.4,23,EL
ba492306,4,160,1.8,1,0,3,1,3,1,2,2.6,1.6,1.1,23,EL
ba6d9ff6,6,326,3.6,3,2,3,0,6,5,1,4.4,5.4,-1.0,23,EL
bac46a10,10,793,8.8,9,6,1,0,17,6,11,18.9,6.9,12.0,23,EL
bb598858,4,186,2.1,2,2,2,2,1,6,-5,0.7,5.3,-4.6,23,EL
bb718263,9,676,7.5,9,3,0,0,11,8,3,9.2,8.9,0.3,23,EL
bba30585,3,132,1.5,2,0,1,3,2,0,2,3.3,1.1,2.3,23,EL
bbf5c11b,3,81,0.9,1,0,2,5,1,3,-2,0.1,2.0,-1.9,23,EL
bc08556f,2,29,0.3,0,0,2,1,0,0,0,0.4,0.1,0.2,23,EL
bc6e544a,2,163,1.8,2,1,0,0,1,2,-1,2.0,3.5,-1.6,23,EL
bc7b4580,2,94,1.0,2,1,0,2,0,3,-3,0.7,1.9,-1.2,23,EL
bc7dc64d,8,405,4.5,3,1,5,0,5,3,2,8.2,4.7,3.6,23,EL
bced0375,6,512,5.7,6,5,0,1,12,6,6,6.4,7.7,-1.3,23,EL
bceda5ff,1,2,0.0,0,0,1,5,0,0,0,0.0,0.0,0.0,23,EL
bcf5058a,1,90,1.0,1,1,0,14,1,2,-1,1.3,1.0,0.3,23,EL
bd142efb,8,745,8.3,8,7,0,0,14,8,6,13.3,7.4,5.9,23,EL
bd2f622a,4,96,1.1,0,0,4,5,2,3,-1,1.5,2.5,-1.0,23,EL
bdf8165d,6,304,3.4,4,0,2,0,1,2,-1,4.3,3.2,1.2,23,EL
be47b750,5,183,2.0,2,1,3,1,2,3,-1,2.6,2.0,0.6,23,EL
be855308,6,540,6.0,6,6,0,0,8,9,-1,6.2,8.3,-2.1,23,EL
beb882a8,7,397,4.4,5,2,2,1,9,3,6,7.4,4.7,2.7,23,EL
bece776f,3,90,1.0,1,0,2,0,2,0,2,1.7,0.5,1.2,23,EL
bee0bab1,1,5,0.1,0,0,1,3,0,0,0,0.4,0.1,0.3,23,EL
bf075f6b,3,116,1.3,1,0,2,0,0,3,-3,0.4,2.2,-1.8,23,EL
bf12926c,3,103,1.1,1,0,2,2,2,3,-1,2.4,1.6,0.9,23,EL
bf25cb29,2,31,0.3,0,0,2,3,0,0,0,0.2,0.8,-0.6,23,EL
bf34eebd,3,106,1.2,1,0,2,0,2,1,1,1.7,1.4,0.3,23,EL
bf4c41f9,6,344,3.8,4,0,2,0,5,3,2,5.9,3.2,2.7,23,EL
bf80db4d,6,540,6.0,6,6,0,0,8,9,-1,6.2,8.9,-2.7,23,EL
bfc5768b,5,268,3.0,3,0,2,1,3,4,-1,1.8,3.4,-1.6,23,EL
c0347e9b,1,90,1.0,1,1,0,2,2,1,1,1.6,1.0,0.6,23,EL
c0a38fb2,1,1,0.0,0,0,1,2,0,0,0,0.0,0.0,0.0,23,EL
c13ddd3e,2,19,0.2,0,0,2,4,1,0,1,0.5,0.0,0.5,23,EL
c1851bfd,5,450,5.0,5,5,0,0,4,8,-4,4.6,8.8,-4.1,23,EL
c1949191,3,259,2.9,3,2,0,3,4,3,1,3.4,2.9,0.5,23,EL
c275947b,6,542,6.0,6,5,0,0,9,6,3,11.6,5.6,6.0,23,EL
c4987edc,9,810,9.0,9,9,0,0,10,8,2,11.5,7.7,3.8,23,EL
c4e87b8b,6,381,4.2,4,3,2,0,7,7,0,8.2,4.2,3.9,23,EL
c4f5eb61,1,29,0.3,0,0,1,5,2,0,2,1.5,0.0,1.5,23,EL
c54638ba,2,17,0.2,0,0,2,1,0,0,0,0.4,0.0,0.4,23,EL
c5bdb6e3,6,298,3.3,4,1,2,1,6,3,3,5.9,3.9,1.9,23,EL
c5cbbcff,2,173,1.9,2,1,0,0,1,3,-2,2.0,2.3,-0.2,23,EL
c63f6e46,4,159,1.8,2,0,2,0,1,1,0,2.8,1.7,1.1,23,EL
c6486b01,6,462,5.1,5,2,1,0,10,6,4,5.4,7.0,-1.6,23,EL
c678ddd7,3,300,3.3,3,3,0,4,4,4,0,5.1,3.3,1.8,23,EL
c68b1b13,1,63,0.7,1,0,0,5,0,0,0,0.6,0.7,-0.1,23,EL
c6cf860f,1,71,0.8,1,0,0,4,1,0,1,0.8,0.7,0.1,23,EL
c707411f,1,90,1.0,1,1,0,1,1,2,-1,0.3,1.2,-0.9,23,EL
c71e97ba,6,540,6.0,6,6,0,0,5,11,-6,3.6,7.1,-3.5,23,EL
c75f04f4,1,17,0.2,0,0,1,1,0,0,0,0.1,0.3,-0.2,23,EL
c7842dab,5,376,4.2,4,3,1,2,8,2,6,4.8,6.1,-1.3,23,EL
c9817014,4,368,4.1,4,1,0,0,5,3,2,6.7,3.5,3.2,23,EL
c997b942,4,198,2.2,1,1,3,4,5,1,4,4.0,0.7,3.3,23,EL
c9e39d91,8,530,5.9,6,1,2,0,7,3,4,7.6,3.1,4.4,23,EL
ca3478f9,1,11,0.1,0,0,1,5,0,1,-1,0.0,1.2,-1.2,23,EL
ca607d59,2,172,1.9,2,1,0,0,0,2,-2,2.0,3.6,-1.7,23,EL
ca618d23,3,231,2.6,3,0,0,3,1,2,-1,1.6,4.1,-2.4,23,EL
ca6edaa0,3,42,0.5,0,0,3,3,0,0,0,1.2,0.1,1.1,23,EL
cac2537b,6,322,3.6,4,0,2,0,7,9,-2,2.8,7.2,-4.4,23,EL
cad3fd4d,2,45,0.5,0,0,2,0,1,1,0,0.9,0.2,0.7,23,EL
cbeed9e6,2,28,0.3,0,0,2,2,0,1,-1,0.4,1.5,-1.0,23,EL
ccd38335,10,554,6.2,6,1,4,0,11,10,1,7.4,7.9,-0.5,23,EL
cd6a1a59,5,418,4.6,5,4,0,0,8,4,4,5.8,4.0,1.9,23,EL
cf1ef7ec,2,71,0.8,1,0,1,0,2,3,-1,1.6,2.2,-0.6,23,EL
cf8ef0a1,5,254,2.8,3,0,2,1,2,6,-4,3.0,3.6,-0.6,23,EL
cf9bdd43,8,720,8.0,8,8,0,1,18,10,8,10.0,8.7,1.2,23,EL
cfd68aa7,4,315,3.5,3,3,1,2,0,6,-6,2.1,8.0,-5.9,23,EL
d01bbb6f,7,467,5.2,6,0,1,1,9,3,6,6.9,5.9,0.9,23,EL
d03380ec,3,118,1.3,1,0,2,1,0,3,-3,0.7,2.1,-1.4,23,EL
d080ed5e,7,541,6.0,7,4,0,1,5,3,2,7.7,3.9,3.7,23,EL
d0a0858e,2,180,2.0,2,2,0,0,1,5,-4,0.6,4.5,-3.9,23,EL
d0a39bdf,1,90,1.0,1,1,0,3,1,1,0,0.3,2.0,-1.8,23,EL
d1b49282,8,357,4.0,4,1,4,1,4,6,-2,5.7,4.4,1.3,23,EL
d2795011,3,210,2.3,3,0,0,3,1,0,1,2.9,1.8,1.1,23,EL
d2800f47,7,304,3.4,3,1,4,1,5,7,-2,4.7,3.6,1.1,23,EL
d29202c2,5,276,3.1,3,1,2,1,5,4,1,3.6,5.3,-1.7,23,EL
d2c580ce,7,292,3.2,3,1,4,1,4,2,2,2.9,5.7,-2.7,23,EL
d2ddff2d,3,136,1.5,1,1,2,4,4,1,3,2.4,1.2,1.2,23,EL
d33c706e,1,45,0.5,1,0,0,0,0,2,-2,0.2,1.5,-1.3,23,EL
d3aaad90,11,523,5.8,4,2,7,2,9,6,3,14.2,3.9,10.3,23,EL
d4133fa1,4,292,3.2,3,3,1,1,1,7,-6,3.7,6.1,-2.4,23,EL
d4535821,6,338,3.8,3,1,3,0,8,7,1,5.1,4.8,0.3,23,EL
d46d048f,5,217,2.4,2,1,3,1,4,6,-2,1.6,2.7,-1.1,23,EL
d4808594,2,30,0.3,0,0,2,0,0,0,0,0.1,0.3,-0.2,23,EL
d4822868,2,12,0.1,0,0,2,1,1,0,1,0.2,0.0,0.2,23,EL
d4aa40b8,2,57,0.6,0,0,2,4,0,2,-2,0.4,1.4,-1.0,23,EL
d5127c3f,6,395,4.4,5,0,1,0,9,9,0,6.1,5.6,0.5,23,EL
d5161564,1,7,0.1,0,0,1,2,0,0,0,0.0,0.0,0.0,23,EL
d5efd527,6,492,5.5,6,4,0,0,2,10,-8,4.0,11.2,-7.1,23,EL
d682f554,5,393,4.4,5,0,0,1,7,5,2,4.4,4.1,0.4,23,EL
d6f866ba,5,247,2.7,3,1,2,1,1,8,-7,1.9,4.6,-2.7,23,EL
d705ba44,14,773,8.6,9,1,5,1,9,4,5,13.9,6.9,7.0,23,EL
d7354a36,6,252,2.8,3,2,3,2,0,5,-5,1.6,5.3,-3.7,23,EL
d79a8c87,7,613,6.8,6,5,1,1,8,4,4,13.0,5.3,7.7,23,EL
d7abc42e,6,539,6.0,6,5,0,0,4,10,-6,3.8,9.9,-6.1,23,EL
d85c238b,5,314,3.5,4,1,1,0,7,3,4,6.4,4.3,2.1,23,EL
d87e2cae,8,515,5.7,6,2,2,0,10,5,5,6.7,6.1,0.6,23,EL
d8931174,7,369,4.1,3,3,4,3,3,6,-3,5.9,4.5,1.4,23,EL
d8bffa70,5,349,3.9,4,2,1,0,3,9,-6,2.1,9.8,-7.7,23,EL
d93c2511,7,138,1.5,1,0,6,2,7,1,6,4.9,1.0,3.8,23,EL
d9565625,10,620,6.9,8,4,2,2,10,6,4,13.8,5.3,8.5,23,EL
d9764034,5,386,4.3,4,4,1,1,9,5,4,5.6,4.9,0.7,23,EL
d99830de,5,52,0.6,0,0,5,1,2,0,2,1.1,0.2,0.9,23,EL
d9ac09e2,4,273,3.0,3,2,1,1,1,5,-4,2.6,7.9,-5.3,23,EL
d9ba39fc,7,609,6.8,7,6,0,0,9,4,5,9.5,3.5,6.1,23,EL
d9d43555,1,59,0.7,1,0,0,0,0,0,0,0.5,0.8,-0.3,23,EL
da4d670f,7,543,6.0,7,3,0,1,13,5,8,7.5,7.8,-0.3,23,EL
da7f2781,6,494,5.5,6,4,0,0,3,9,-6,5.7,5.9,-0.2,23,EL
dbd1b101,1,90,1.0,1,1,0,7,1,1,0,1.1,1.0,0.1,23,EL
dbf053da,10,495,5.5,6,1,4,1,9,5,4,10.3,4.4,5.9,23,EL
dc3e663e,1,70,0.8,1,0,0,1,2,2,0,1.9,2.2,-0.3,23,EL
dc45ac24,6,350,3.9,4,1,2,0,5,7,-2,3.3,6.4,-3.1,23,EL
dc52c72f,3,247,2.7,3,2,0,3,2,5,-3,2.0,3.3,-1.3,23,EL
dcfb17f4,8,283,3.1,2,0,6,0,7,4,3,6.5,2.9,3.6,23,EL
dd676a97,6,144,1.6,1,0,5,1,4,1,3,2.8,3.0,-0.2,23,EL
dd95af65,1,6,0.1,0,0,1,2,0,1,-1,0.0,0.3,-0.3,23,EL
de488e56,2,82,0.9,0,0,2,0,0,1,-1,0.4,2.5,-2.1,23,EL
de4fe7a2,4,149,1.7,1,0,3,2,0,4,-4,0.6,2.6,-2.0,23,EL
de89f3c3,1,30,0.3,0,0,1,5,0,0,0,0.3,0.1,0.3,23,EL
dea698d9,6,530,5.9,6,5,0,0,10,3,7,13.1,3.8,9.3,23,EL
dead55e5,6,463,5.1,5,4,1,0,11,6,5,5.8,6.0,-0.3,23,EL
dee86451,7,331,3.7,4,2,3,0,6,5,1,5.0,5.9,-1.0,23,EL
df4153d2,1,24,0.3,0,0,1,4,0,1,-1,0.0,0.4,-0.4,23,EL
df8d6029,5,450,5.0,5,5,0,3,10,7,3,7.3,4.9,2.4,23,EL
dff153a4,4,157,1.7,1,0,3,4,2,3,-1,2.1,2.7,-0.6,23,EL
e08647d6,4,166,1.8,2,0,2,2,1,1,0,3.0,0.7,2.3,23,EL
e0921a4f,11,665,7.4,8,1,3,1,13,5,8,14.0,6.8,7.2,23,EL
e09436fb,4,13,0.1,0,0,4,2,1,1,0,0.3,0.3,0.0,23,EL
e0b113a7,6,564,6.3,6,4,0,0,12,8,4,11.3,6.8,4.5,23,EL
e0b5ac38,4,72,0.8,0,0,4,4,5,2,3,0.8,1.2,-0.3,23,EL
e0f3a1f6,7,548,6.1,6,5,1,1,5,12,-7,6.0,11.2,-5.2,23,EL
e150254d,5,285,3.2,3,1,2,0,0,4,-4,1.7,5.1,-3.4,23,EL
e1bbb68d,6,164,1.8,0,0,6,0,2,7,-5,2.0,3.9,-1.8,23,EL
e2716bd0,5,350,3.9,5,1,0,1,4,1,3,4.8,2.4,2.4,23,EL
e280527c,3,188,2.1,2,1,1,1,2,4,-2,2.9,2.5,0.5,23,EL
e3d3fbeb,1,90,1.0,1,1,0,6,1,1,0,1.1,1.0,0.1,23,EL
e4114f5d,5,450,5.0,5,5,0,0,4,8,-4,5.0,8.0,-2.9,23,EL
e4d5e2ae,4,99,1.1,1,0,3,2,2,4,-2,1.6,2.0,-0.3,23,EL
e61b8aee,7,569,6.3,6,5,1,0,8,6,2,12.1,6.3,5.8,23,EL
e63c5181,6,454,5.0,5,1,1,0,3,10,-7,2.8,11.2,-8.4,23,EL
e65a7469,4,82,0.9,0,0,4,0,2,1,1,1.4,1.5,-0.1,23,EL
e66e4ddc,1,28,0.3,0,0,1,4,1,0,1,0.5,0.3,0.2,23,EL
e6ad16b2,6,359,4.0,5,0,1,0,7,5,2,4.6,5.2,-0.6,23,EL
e73c9bb2,5,326,3.6,4,2,1,4,1,4,-3,1.6,6.0,-4.4,23,EL
e7aa9d7c,2,57,0.6,0,0,2,0,2,0,2,1.5,0.4,1.1,23,EL
e7fcf289,8,722,8.0,8,5,0,0,13,8,5,12.6,7.1,5.5,23,EL
e82adcab,6,514,5.7,6,4,0,0,7,6,1,9.2,5.4,3.8,23,EL
e8ef59da,6,326,3.6,5,0,1,0,9,5,4,4.0,5.2,-1.2000000000000002,23,EL
e92cd3f7,7,425,4.7,5,0,2,0,5,3,2,5.7,3.4,2.3,23,EL
ea39a081,3,178,2.0,2,0,1,3,0,5,-5,1.0,2.9,-2.0,23,EL
ea770abf,6,540,6.0,6,6,0,0,9,11,-2,7.6,7.5,0.1,23,EL
ea83bfa6,2,180,2.0,2,2,0,6,3,1,2,4.0,2.4,1.6,23,EL
eab85789,5,349,3.9,4,2,1,0,3,7,-4,4.6,4.7,-0.2,23,EL
ead61f73,7,539,6.0,6,3,1,1,10,5,5,8.5,6.7,1.8,23,EL
eb2b33aa,2,180,2.0,2,2,0,0,1,4,-3,1.1,2.9,-1.8,23,EL
eb58eef0,9,325,3.6,2,1,7,0,1,2,-1,3.4,4.6,-1.2,23,EL
eb7822d7,13,1139,12.7,13,9,0,0,15,9,6,23.5,9.7,13.8,23,EL
ec48abb1,4,74,0.8,1,0,3,2,1,2,-1,0.7,1.9,-1.2,23,EL
ec61b68f,6,261,2.9,3,0,3,0,0,5,-5,1.5,4.4,-2.9,23,EL
eca2b6b8,2,71,0.8,1,0,1,3,2,1,1,0.4,0.7,-0.4,23,EL
ed1cc44a,5,450,5.0,5,5,0,0,7,7,0,5.6,5.8,-0.2,23,EL
ed45a7d7,3,59,0.7,0,0,3,1,2,4,-2,0.5,1.0,-0.5,23,EL
eda8506a,4,172,1.9,1,1,3,1,1,2,-1,1.4,3.6,-2.2,23,EL
ee3519f5,4,332,3.7,4,2,0,0,3,7,-4,2.7,6.7,-4.0,23,EL
ee45fd85,6,345,3.8,5,2,1,0,6,4,2,6.3,2.4,4.0,23,EL
ef2ad14e,3,131,1.5,1,1,2,3,2,5,-3,1.7,2.5,-0.8,23,EL
ef322658,7,325,3.6,3,1,4,0,6,5,1,3.9,5.0,-1.0,23,EL
ef3909cd,6,540,6.0,6,6,0,0,9,7,2,7.4,6.4,1.0,23,EL
ef491564,1,38,0.4,0,0,1,3,2,0,2,0.2,0.3,-0.2,23,EL
ef83dfcc,3,188,2.1,2,2,1,2,2,2,0,1.6,2.3,-0.7,23,EL
efc33b33,1,4,0.0,0,0,1,5,1,0,1,0.4,0.1,0.3,23,EL
f0f64209,1,6,0.1,0,0,1,5,0,0,0,0.0,0.1,-0.1,23,EL
f24ea523,6,218,2.4,3,0,3,0,1,2,-1,1.4,1.4,0.0,23,EL
f28876e5,3,60,0.7,0,0,3,0,1,0,1,1.6,0.3,1.3,23,EL
f2c1300a,5,292,3.2,3,2,2,1,6,6,0,3.4,4.0,-0.6,23,EL
f32a988d,5,71,0.8,0,0,5,1,0,4,-4,0.1,3.2,-3.1,23,EL
f360f047,2,50,0.6,0,0,2,4,0,0,0,0.3,0.5,-0.3,23,EL
f38a247a,1,59,0.7,1,0,0,1,0,0,0,0.6,0.3,0.3,23,EL
f3fa599d,8,592,6.6,8,2,0,0,10,9,1,5.3,11.2,-6.0,23,EL
f40dd3c7,9,801,8.9,9,7,0,0,14,13,1,9.9,11.5,-1.6,23,EL
f4290206,2,75,0.8,1,0,1,0,1,2,-1,0.6,2.0,-1.4,23,EL
f47a530a,4,313,3.5,4,2,0,2,5,6,-1,4.5,2.7,1.8,23,EL
f50a668a,5,346,3.8,4,3,1,1,2,6,-4,3.1,9.3,-6.2,23,EL
f512a009,4,279,3.1,4,2,0,0,2,5,-3,1.7,3.9,-2.3,23,EL
f521b80a,8,649,7.2,7,7,1,0,12,6,6,9.5,10.0,-0.4,23,EL
f54d2149,5,332,3.7,5,1,0,0,0,4,-4,1.8,7.4,-5.6,23,EL
f586779e,14,868,9.6,10,5,4,0,13,7,6,17.2,6.8,10.4,23,EL
f5c8b425,4,170,1.9,2,0,2,1,2,3,-1,2.3,2.8,-0.5,23,EL
f5deef4c,7,523,5.8,6,5,1,5,8,6,2,12.6,5.2,7.4,23,EL
f5e7fdf9,5,394,4.4,5,3,0,0,7,4,3,4.6,4.9,-0.3,23,EL
f620b04f,4,270,3.0,4,0,0,0,2,6,-4,2.5,5.7,-3.3,23,EL
f63a8347,5,450,5.0,5,5,0,1,9,6,3,4.5,6.6,-2.0,23,EL
f6798fc3,6,600,6.7,6,6,0,2,12,5,7,7.3,9.3,-2.0,23,EL
f67c9d29,8,711,7.9,8,7,0,1,9,8,1,9.6,7.4,2.2,23,EL
f6af14b0,6,387,4.3,5,4,1,0,5,7,-2,4.5,8.2,-3.7,23,EL
f6bdc830,2,94,1.0,1,1,1,4,2,1,1,1.7,1.2,0.5,23,EL
f7223718,4,215,2.4,2,2,2,1,2,4,-2,3.5,3.7,-0.2,23,EL
f7dc2ae5,6,466,5.2,5,4,1,0,9,1,8,6.6,1.9,4.7,23,EL
f7e87032,6,530,5.9,6,4,0,0,5,10,-5,3.6,6.7,-3.1,23,EL
f833a830,4,150,1.7,2,0,2,4,1,1,0,1.9,1.3,0.6,23,EL
f8405304,4,114,1.3,1,0,3,0,1,1,0,1.3,0.9,0.4,23,EL
f874dd44,3,85,0.9,0,0,3,1,4,1,3,2.2,0.6,1.6,23,EL
f8766ef9,10,855,9.5,10,9,0,0,17,15,2,10.8,10.9,-0.1,23,EL
f893dba4,6,506,5.6,6,5,0,0,4,16,-12,6.4,9.6,-3.2,23,EL
f91e81c9,5,428,4.8,5,4,0,1,7,8,-1,4.9,7.4,-2.5,23,EL
f91fa277,1,5,0.1,0,0,1,1,0,1,-1,0.0,1.0,-1.0,23,EL
f93e6e94,7,354,3.9,3,1,4,1,7,3,4,6.2,3.8,2.4,23,EL
f99360b9,6,494,5.5,6,3,0,0,2,13,-11,3.8,12.2,-8.4,23,EL
f9de9c23,1,8,0.1,0,0,1,1,0,0,0,0.1,0.0,0.1,23,EL
f9edc384,7,626,7.0,7,6,0,0,8,12,-4,7.3,11.1,-3.8,23,EL
fa066690,5,420,4.7,5,4,0,0,9,7,2,8.4,4.8,3.7,23,EL
fa73ccc7,7,574,6.4,6,6,1,0,12,10,2,6.5,10.0,-3.6,23,EL
fa94d227,3,18,0.2,0,0,3,3,0,1,-1,0.0,1.0,-1.0,23,EL
faed84db,5,220,2.4,2,1,3,1,1,3,-2,2.8,3.3,-0.5,23,EL
fb485406,8,413,4.6,4,2,4,0,10,4,6,9.4,2.6,6.8,23,EL
fbbb9269,3,225,2.5,3,2,0,3,3,5,-2,2.7,5.3,-2.6,23,EL
fc46aab1,8,527,5.9,7,1,1,0,10,4,6,8.5,4.3,4.2,23,EL
fc9b373e,5,213,2.4,2,0,3,0,2,4,-2,2.2,3.4,-1.2,23,EL
fce2302c,6,480,5.3,6,3,0,1,7,3,4,10.3,3.6,6.8,23,EL
fcea4f04,1,14,0.2,0,0,1,0,1,1,0,0.1,0.6,-0.5,23,EL
fd9c4805,5,273,3.0,3,0,2,1,5,6,-1,2.9,6.5,-3.6,23,EL
fe6e7156,2,57,0.6,0,0,2,3,2,0,2,1.0,0.6,0.4,23,EL
feb5d3ab,6,287,3.2,2,1,4,0,5,3,2,2.9,2.5,0.5,23,EL
fef20ac5,6,82,0.9,0,0,6,0,4,1,3,2.9,0.6,2.3,23,EL
ff711ca2,3,270,3.0,3,3,0,3,1,4,-3,1.8,6.7,-4.9,23,EL
ff74841d,2,180,2.0,2,2,0,0,1,2,-1,2.1,3.6,-1.5,23,EL
ffa90327,5,194,2.2,1,0,4,1,4,2,2,2.6,2.9,-0.3,23,EL
fffea3e5,4,238,2.6,2,1,2,1,3,5,-2,4.8,3.4,1.4,23,EL
004d185e,32,2068,23.0,23,11,9,4,20,33,-13,23.3,38.5,-15.2,23,SPA
0076ab7f,34,2779,30.9,31,28,3,2,36,46,-10,37.3,42.6,-5.3,23,SPA
00b28772,29,2053,22.8,26,9,3,7,19,26,-7,19.1,26.9,-7.8,23,SPA
00eba9c9,7,267,3.0,3,0,4,2,6,4,2,4.0,5.4,-1.5,23,SPA
0107757e,2,180,2.0,2,2,0,24,2,3,-1,2.4,2.8,-0.4,23,SPA
014aa7bd,34,1888,21.0,18,11,16,4,19,36,-17,21.7,36.1,-14.4,23,SPA
01a49bd2,14,902,10.0,11,7,3,6,14,11,3,15.9,20.3,-4.4,23,SPA
01eb744d,35,1455,16.2,13,1,22,1,29,15,14,30.9,19.4,11.5,23,SPA
02319ad7,18,437,4.9,5,1,13,15,8,5,3,7.8,4.4,3.4,23,SPA
02c15616,22,1703,18.9,21,11,1,2,28,11,17,31.6,16.1,15.5,23,SPA
02d2c436,35,3149,35.0,35,34,0,1,28,46,-18,39.6,55.7,-16.1,23,SPA
02ef8778,19,805,8.9,9,0,10,2,7,13,-6,10.4,10.5,-0.1,23,SPA
03049c8c,18,503,5.6,4,0,14,7,5,12,-7,6.2,10.4,-4.2,23,SPA
036bba5f,31,2043,22.7,22,10,9,0,18,26,-8,24.5,34.4,-9.8,23,SPA
04965583,25,1025,11.4,10,1,15,6,18,19,-1,17.5,15.5,2.0,23,SPA
04e17fd5,31,1661,18.5,17,6,14,6,26,22,4,25.6,23.3,2.3,23,SPA
04e531b6,8,144,1.6,1,0,7,23,3,2,1,3.3,2.7,0.6,23,SPA
05439de2,23,1838,20.4,21,16,2,3,49,18,31,43.8,21.5,22.3,23,SPA
056269d7,21,1284,14.3,13,8,8,6,15,20,-5,17.2,16.0,1.2,23,SPA
05e19d6a,28,990,11.0,7,1,21,7,16,7,9,18.3,12.1,6.2,23,SPA
068f4dec,6,106,1.2,1,0,5,26,1,2,-1,0.9,2.3,-1.4,23,SPA
06efa9dc,29,2297,25.5,27,23,2,4,31,45,-14,29.6,42.8,-13.3,23,SPA
070a3904,38,3320,36.9,38,31,0,0,51,64,-13,47.8,56.6,-8.8,23,SPA
075fe5a3,34,2998,33.3,33,32,1,3,42,56,-14,39.5,51.7,-12.2,23,SPA
0959c2a2,34,2502,27.8,29,17,5,4,51,25,26,52.7,26.7,26.0,23,SPA
0a0cc13c,29,1334,14.8,14,3,15,7,14,28,-14,14.2,27.3,-13.1,23,SPA
0a69de7b,6,368,4.1,4,2,2,10,6,5,1,4.3,7.2,-2.9,23,SPA
0abc51f2,10,506,5.6,5,4,5,28,5,7,-2,6.8,8.8,-2.0,23,SPA
0ae4e09a,26,1294,14.399999999999999,16,1,10,7,8,21,-13,12.9,23.7,-10.8,23,SPA
0b2c8585,28,1117,12.4,12,3,16,9,11,25,-14,10.2,24.6,-14.4,23,SPA
0ba976e4,36,1393,15.5,12,1,24,1,36,5,31,31.8,13.1,18.7,23,SPA
0bc4e720,7,206,2.3,2,0,5,8,8,5,3,5.7,2.5,3.2,23,SPA
0cadc46d,35,2937,32.6,34,16,1,0,32,35,-3,29.2,39.1,-9.9,23,SPA
0d9b2d31,26,1976,22.0,22,12,4,0,47,9,38,48.6,17.6,31.0,23,SPA
0da6a13e,31,1938,21.5,24,4,7,5,18,25,-7,23.0,32.2,-9.2,23,SPA
0e4fef6e,33,2477,27.5,31,17,2,1,24,25,-1,29.3,30.1,-0.8,23,SPA
0e5ddc7c,8,88,1.0,0,0,8,18,2,1,1,2.8,1.6,1.1,23,SPA
0f26ffd7,28,2206,24.5,27,16,1,6,22,26,-4,22.0,31.4,-9.4,23,SPA
10072610,12,1080,12.0,12,12,0,21,13,9,4,16.8,14.9,1.9,23,SPA
106c142c,10,310,3.4,3,1,7,27,1,5,-4,3.6,5.6,-2.0,23,SPA
112521d1,7,229,2.5,2,0,5,2,4,3,1,5.3,2.6,2.7,23,SPA
114bbdee,19,1449,16.1,16,15,3,1,24,16,8,21.9,19.1,2.8,23,SPA
11b9265b,24,1296,14.4,14,3,10,6,24,15,9,26.7,15.6,11.1,23,SPA
11fd2b75,28,2447,27.2,28,25,0,0,18,52,-34,24.7,47.4,-22.7,23,SPA
129af0db,36,1900,21.1,23,3,13,1,40,10,30,34.2,19.5,14.7,23,SPA
12c50af5,18,945,10.5,11,2,7,1,16,23,-7,14.1,20.6,-6.6,23,SPA
130a7a3f,25,1362,15.1,17,3,8,4,14,15,-1,17.8,14.0,3.8,23,SPA
132ac341,23,1793,19.9,20,19,3,12,17,25,-8,18.4,27.3,-9.0,23,SPA
133faa84,5,375,4.2,4,4,1,3,3,5,-2,2.9,6.1,-3.2,23,SPA
139560df,5,92,1.0,1,0,4,14,2,2,0,0.9,1.6,-0.7,23,SPA
13e0eb29,8,240,2.7,1,0,7,4,5,5,0,3.9,4.3,-0.4,23,SPA
14d5b7ac,1,1,0.0,0,0,1,5,0,0,0,0.0,0.0,0.0,23,SPA
1545cf15,14,886,9.8,11,4,3,20,12,28,-16,10.8,21.9,-11.1,23,SPA
15937e17,23,1672,18.6,19,15,4,12,22,22,0,24.6,24.7,0.0,23,SPA
15d0c248,23,1763,19.6,22,16,1,3,23,23,0,27.6,25.3,2.3,23,SPA
162efffd,30,1923,21.4,24,5,6,3,40,20,20,33.1,23.3,9.8,23,SPA
1633fc8a,19,1426,15.8,17,13,2,11,29,25,4,18.5,23.9,-5.4,23,SPA
1657f448,17,872,9.7,9,2,8,6,9,16,-7,11.0,18.0,-7.0,23,SPA
16aa3654,35,2439,27.1,29,7,6,2,38,21,17,37.4,20.6,16.9,23,SPA
16e9d0ea,15,1350,15.0,15,15,0,1,19,13,6,18.4,17.6,0.8,23,SPA
175ece4c,8,254,2.8,2,1,6,5,1,4,-3,3.2,6.3,-3.2,23,SPA
18017beb,1,17,0.2,0,0,1,15,0,1,-1,0.0,0.0,0.0,23,SPA
1840e36d,31,2790,31.0,31,31,0,1,61,29,32,61.5,32.3,29.2,23,SPA
184fe4b2,4,55,0.6,0,0,4,34,0,0,0,0.7,0.2,0.5,23,SPA
18abe173,35,3119,34.7,35,33,0,0,40,48,-8,40.1,40.6,-0.5,23,SPA
18b896d6,33,2415,26.8,26,25,7,2,44,25,19,51.1,27.2,23.8,23,SPA
192c89a6,5,220,2.4,2,2,3,13,2,2,0,4.1,1.1,3.0,23,SPA
1944818c,25,1158,12.9,12,5,13,4,20,15,5,15.5,16.7,-1.2,23,SPA
19709006,33,1775,19.7,19,10,14,3,25,31,-6,19.8,25.3,-5.5,23,SPA
19b776e9,33,2465,27.4,28,18,5,1,22,27,-5,32.5,39.7,-7.2,23,SPA
19c36442,27,1856,20.6,22,12,5,3,15,21,-6,14.0,23.2,-9.2,23,SPA
19cae58d,36,2531,28.1,30,13,6,0,52,11,41,53.9,21.9,32.0,23,SPA
1bacc518,33,2534,28.2,29,20,4,1,56,20,36,58.4,24.3,34.2,23,SPA
1bda5842,34,1770,19.7,17,8,17,1,18,24,-6,19.8,27.8,-8.0,23,SPA
1c2c55fc,16,703,7.8,9,3,7,15,4,12,-8,5.1,11.8,-6.6,23,SPA
1cb49278,23,1760,19.6,22,15,1,4,33,13,20,34.9,19.5,15.4,23,SPA
1d1691ad,3,39,0.4,0,0,3,29,2,0,2,1.7,0.2,1.5,23,SPA
1e465e70,2,19,0.2,0,0,2,1,0,1,-1,0.9,0.1,0.8,23,SPA
1f079188,20,1277,14.2,14,5,6,2,22,17,5,18.3,17.8,0.4,23,SPA
1fc474ae,15,926,10.3,9,7,6,15,13,8,5,10.3,8.8,1.6,23,SPA
1fda2b14,2,15,0.2,0,0,2,3,0,1,-1,0.3,0.7,-0.4,23,SPA
1fe67e86,3,115,1.3,1,0,2,27,1,3,-2,0.8,1.5,-0.6,23,SPA
200e89e1,23,878,9.8,9,0,14,5,14,5,9,14.7,8.3,6.4,23,SPA
211589b8,6,93,1.0,0,0,6,11,0,3,-3,1.5,1.8,-0.3,23,SPA
220c11f1,32,1090,12.1,8,3,24,1,22,16,6,19.9,17.2,2.6,23,SPA
22721b88,5,200,2.2,1,0,4,23,2,2,0,0.6,1.5,-0.9,23,SPA
228b0d9d,23,1756,19.5,20,17,3,10,26,21,5,28.5,17.4,11.1,23,SPA
23610943,33,2867,31.9,33,28,0,1,58,28,30,51.2,35.1,16.1,23,SPA
237a3851,36,2307,25.6,28,10,8,1,17,44,-27,25.6,42.8,-17.3,23,SPA
240d3a0b,25,1485,16.5,18,6,7,6,24,19,5,23.6,18.2,5.5,23,SPA
2475cf9b,21,1489,16.5,15,13,6,9,20,30,-10,20.3,31.7,-11.4,23,SPA
253a06b9,29,1709,19.0,23,1,6,3,18,17,1,19.6,20.2,-0.6,23,SPA
2683eda7,37,2340,26.0,25,5,12,0,37,44,-7,35.8,42.3,-6.5,23,SPA
274ab13c,35,3103,34.5,35,32,0,0,41,48,-7,41.0,44.7,-3.7,23,SPA
2784f898,33,2703,30.0,30,28,3,2,60,29,31,60.7,33.0,27.6,23,SPA
283c7121,28,1160,12.9,13,0,15,9,21,26,-5,16.7,19.3,-2.6,23,SPA
28e957d7,20,1590,17.7,18,17,2,0,26,40,-14,23.0,32.8,-9.8,23,SPA
2946f9a1,27,1637,18.2,18,14,9,9,29,14,15,32.5,16.8,15.8,23,SPA
29d0f2ac,22,1743,19.4,18,15,4,12,20,34,-14,19.9,35.8,-15.9,23,SPA
2a0c8ba4,23,1592,17.7,19,11,4,4,18,28,-10,21.4,28.3,-6.9,23,SPA
2a295d33,38,2887,32.1,33,17,5,0,39,38,1,42.8,36.0,6.7,23,SPA
2ae30661,9,205,2.3,3,0,6,15,2,1,1,2.2,2.4,-0.3,23,SPA
2bea832e,18,448,5.0,2,1,16,17,5,1,4,5.8,6.4,-0.5,23,SPA
2bed3eab,24,1417,15.7,15,10,9,14,30,10,20,30.6,14.0,16.7,23,SPA
2bef2bca,22,1800,20.0,21,16,1,2,42,5,37,44.4,14.0,30.4,23,SPA
2c56a792,26,1405,15.6,18,3,8,0,22,21,1,23.4,18.2,5.2,23,SPA
2dce876a,19,1116,12.4,13,3,6,5,11,21,-10,12.8,23.299999999999997,-10.5,23,SPA
2dd7e29d,3,100,1.1,1,0,2,4,0,2,-2,1.3,1.7,-0.4,23,SPA
2e3995cd,18,1119,12.4,15,2,3,1,10,17,-7,10.2,19.3,-9.1,23,SPA
2f456b86,1,4,0.0,0,0,1,1,0,0,0,0.0,0.1,-0.1,23,SPA
2fa2a875,10,899,10.0,10,9,0,4,10,14,-4,11.2,11.2,0.0,23,SPA
2fbe6af0,1,11,0.1,0,0,1,0,0,0,0,0.0,0.0,0.0,23,SPA
30061f53,1,90,1.0,1,1,0,24,0,3,-3,0.1,3.6,-3.5,23,SPA
3061e1ec,7,630,7.0,7,7,0,30,14,7,7,14.0,6.7,7.4,23,SPA
31f5b89b,12,447,5.0,3,2,9,19,2,6,-4,3.5,8.9,-5.4,23,SPA
32974271,31,1667,18.5,22,2,9,3,15,16,-1,21.8,28.4,-6.6000000000000005,23,SPA
335039a2,31,1843,20.5,21,8,10,0,18,45,-27,21.0,36.6,-15.6,23,SPA
3353737a,11,309,3.4,2,0,9,10,5,2,3,7.2,3.7,3.5,23,SPA
335fa267,23,1308,14.5,15,5,8,6,24,10,14,25.0,11.8,13.2,23,SPA
3376a776,16,1181,13.1,15,10,1,7,18,16,2,17.5,15.2,2.3,23,SPA
33a61a52,32,2639,29.3,31,21,1,5,24,50,-26,29.1,50.7,-21.7,23,SPA
3409de86,18,514,5.7,3,1,15,12,5,10,-5,6.4,12.3,-5.8,23,SPA
3423f250,36,2072,23.0,25,2,11,1,34,9,25,44.9,18.1,26.8,23,SPA
34269bdf,28,1451,16.1,16,6,12,5,10,28,-18,15.5,21.4,-5.9,23,SPA
34e393f2,34,2872,31.9,33,27,1,1,38,32,6,41.4,41.2,0.1,23,SPA
3521abfe,3,108,1.2,1,1,2,35,2,1,1,0.8,1.3,-0.5,23,SPA
35440884,1,19,0.2,0,0,1,2,1,1,0,0.7,1.3,-0.6,23,SPA
35a6e5c7,36,2294,25.5,28,3,8,0,29,30,-1,28.6,28.5,0.1,23,SPA
35d4f151,18,888,9.9,9,2,9,5,10,25,-15,9.4,16.6,-7.2,23,SPA
35f6db55,28,1726,19.2,24,1,4,1,28,30,-2,20.6,28.7,-8.2,23,SPA
360d70f8,5,52,0.6,0,0,5,9,0,2,-2,1.0,1.3,-0.3,23,SPA
3701906c,25,1064,11.8,12,3,13,13,12,14,-2,8.8,15.0,-6.2,23,SPA
374d5158,28,1524,16.9,17,8,11,6,18,28,-10,21.0,26.7,-5.7,23,SPA
374ee424,38,3420,38.0,38,38,0,0,51,35,16,52.9,33.0,19.8,23,SPA
379dc075,15,747,8.3,6,1,9,1,5,13,-8,6.0,14.9,-8.9,23,SPA
37e103f8,30,1385,15.4,12,6,18,5,16,20,-4,21.1,18.8,2.3,23,SPA
37f1cf47,7,109,1.2,1,0,6,27,2,0,2,2.3,1.2,1.1,23,SPA
37f827ec,22,1652,18.4,19,11,3,12,16,36,-20,18.4,36.4,-18.1,23,SPA
381dbcfc,7,385,4.3,2,1,5,21,3,8,-5,6.6,9.4,-2.8,23,SPA
3828f130,10,605,6.7,6,5,4,7,7,6,1,9.6,5.2,4.3,23,SPA
38699c72,28,1443,16.0,14,5,14,5,14,19,-5,14.9,23.6,-8.7,23,SPA
38b0cf42,1,17,0.2,0,0,1,7,0,0,0,0.0,0.2,-0.2,23,SPA
3902e91b,27,1855,20.6,24,1,3,2,34,28,6,26.6,29.5,-2.9,23,SPA
39352da2,22,763,8.5,7,0,15,16,11,18,-7,9.4,15.8,-6.5,23,SPA
3a9c4b7b,20,1247,13.9,15,8,5,4,10,15,-5,14.1,12.6,1.5,23,SPA
3aa4a3be,2,15,0.2,0,0,2,15,0,0,0,0.3,0.0,0.3,23,SPA
3aa74860,1,17,0.2,0,0,1,7,0,0,0,0.2,0.0,0.1,23,SPA
3c16d927,30,1880,20.9,20,14,10,3,27,26,1,27.1,30.4,-3.3,23,SPA
3ca6106c,12,262,2.9,3,0,9,19,5,3,2,3.3,2.3,1.0,23,SPA
3cefcaef,18,1351,15.0,17,6,1,5,26,17,9,26.7,17.0,9.6,23,SPA
3d79a68c,7,141,1.6,0,0,7,22,1,3,-2,1.3,2.3,-1.0,23,SPA
3d7e48ce,31,1311,14.6,13,2,18,2,8,26,-18,17.1,25.8,-8.7,23,SPA
3d99999d,3,65,0.7,0,0,3,2,0,0,0,0.8,1.0,-0.2,23,SPA
3e42f707,32,2680,29.8,31,27,1,1,32,35,-3,32.1,33.3,-1.2,23,SPA
3e93f8cf,25,967,10.7,10,4,15,11,11,19,-8,11.1,19.8,-8.6,23,SPA
3ecc11d8,28,2332,25.9,27,21,1,2,33,30,3,33.0,25.1,7.9,23,SPA
3ee0dd59,36,3101,34.5,35,33,1,0,45,34,11,46.7,31.1,15.6,23,SPA
3f034750,12,922,10.2,10,9,2,25,28,13,15,17.9,14.9,3.0,23,SPA
3f10bd22,32,1981,22.0,21,12,11,4,32,27,5,25.4,27.8,-2.3,23,SPA
3f79a1c8,14,1121,12.5,13,8,1,1,13,13,0,16.6,17.2,-0.6,23,SPA
3fc45c73,15,1338,14.9,15,14,0,4,25,16,9,22.7,12.6,10.1,23,SPA
405f267a,24,490,5.4,4,0,20,10,4,15,-11,6.4,11.1,-4.7,23,SPA
4112ace5,10,193,2.1,0,0,10,27,2,7,-5,2.3,3.8,-1.5,23,SPA
41b3069f,27,1611,17.9,20,7,7,9,21,29,-8,21.8,25.7,-3.8,23,SPA
41f32541,22,1577,17.5,19,11,3,2,28,21,7,20.5,21.6,-1.0,23,SPA
41fb0f4e,10,275,3.1,2,1,8,3,2,8,-6,2.9,7.8,-4.9,23,SPA
4242011c,20,1225,13.6,14,10,6,16,14,26,-12,18.9,22.4,-3.5,23,SPA
436a9dd0,17,697,7.7,9,0,8,5,10,10,0,12.9,7.4,5.5,23,SPA
44150beb,17,1193,13.3,12,12,5,16,21,13,8,18.9,10.3,8.6,23,SPA
44330c36,5,86,1.0,0,0,5,6,2,0,2,1.2,0.3,0.9,23,SPA
44e07fac,15,710,7.9,7,3,8,2,6,10,-4,13.0,12.7,0.2,23,SPA
44e8521b,2,12,0.1,0,0,2,6,1,0,1,0.8,0.3,0.5,23,SPA
455c26a4,4,25,0.3,0,0,4,10,0,0,0,0.0,0.0,0.0,23,SPA
45736cec,21,724,8.0,6,1,15,5,13,9,4,13.7,10.4,3.4,23,SPA
45af8a54,31,1442,16.0,15,7,16,6,34,16,18,38.7,16.0,22.7,23,SPA
45d96179,25,1632,18.1,19,11,6,11,20,23,-3,0.0,0.0,0.0,23,SPA
45e17712,30,1738,19.3,17,15,13,8,17,24,-7,19.8,25.3,-5.5,23,SPA
4601e194,24,1419,15.8,14,6,10,12,27,8,19,30.7,13.3,17.5,23,SPA
4737cebe,2,47,0.5,1,0,1,12,0,0,0,0.0,0.4,-0.4,23,SPA
475a738b,1,36,0.4,0,0,1,2,0,2,-2,1.0,0.1,0.9,23,SPA
47c609d5,21,1264,14.0,15,1,6,3,23,23,0,17.3,18.6,-1.4,23,SPA
485e4939,5,148,1.6,1,0,4,10,1,4,-3,1.4,2.7,-1.3,23,SPA
4958bfb2,27,1784,19.8,20,8,7,5,38,22,16,38.4,21.3,17.1,23,SPA
49a6ecbb,6,79,0.9,0,0,6,3,4,2,2,2.1,0.3,1.8,23,SPA
49d028db,25,1772,19.7,18,16,7,10,28,20,8,27.8,26.2,1.6,23,SPA
49dbab27,37,2965,32.9,36,11,1,0,40,45,-5,36.8,40.1,-3.3,23,SPA
4a478107,29,1211,13.5,11,4,18,1,20,11,9,20.2,17.3,2.8,23,SPA
4a5f2032,2,98,1.1,1,1,1,19,0,2,-2,0.0,2.3,-2.3,23,SPA
4a633cfe,21,1713,19.0,20,15,1,15,19,19,0,21.4,18.9,2.5,23,SPA
4ac7608e,16,958,10.6,8,5,8,16,8,23,-15,8.9,24.4,-15.6,23,SPA
4accb7e0,25,1041,11.6,9,3,16,2,11,14,-3,11.9,14.5,-2.6,23,SPA
4acd733a,25,967,10.7,7,1,18,9,14,14,0,14.8,18.1,-3.2,23,SPA
4b511457,33,2950,32.8,33,31,0,0,52,47,5,45.9,46.6,-0.7,23,SPA
4bd414c1,25,2119,23.5,24,22,1,2,29,23,6,33.8,27.7,6.0,23,SPA
4c2e9442,3,108,1.2,0,0,3,0,0,1,-1,0.8,1.0,-0.1,23,SPA
4c3a6744,26,1447,16.1,15,3,11,1,22,21,1,26.6,19.0,7.6,23,SPA
4c5b14d2,22,496,5.5,2,0,20,11,10,3,7,12.0,6.5,5.5,23,SPA
4cee5954,23,1494,16.6,16,10,7,10,13,27,-14,15.0,28.8,-13.8,23,SPA
4d1666ff,29,2426,27.0,28,24,1,2,51,12,39,53.0,21.6,31.4,23,SPA
4d224fe8,1,8,0.1,0,0,1,0,0,0,0,0.0,0.3,-0.3,23,SPA
4dbd0916,27,1252,13.9,17,0,10,2,27,10,17,21.3,11.5,9.9,23,SPA
4e219ad2,25,1065,11.8,10,1,15,9,18,15,3,17.5,12.6,4.9,23,SPA
4f255115,33,2119,23.5,24,14,9,1,51,27,24,46.3,25.3,21.0,23,SPA
5083a734,20,963,10.7,12,2,8,1,12,19,-7,11.9,17.6,-5.7,23,SPA
50cbc806,4,176,2.0,2,0,2,5,2,0,2,0.9,3.2,-2.3,23,SPA
5132b92c,17,931,10.3,11,6,6,15,9,17,-8,11.8,17.4,-5.6,23,SPA
518f2234,35,1947,21.6,19,9,16,0,32,23,9,36.3,30.3,6.0,23,SPA
51a3c4c8,3,194,2.2,2,2,1,11,1,3,-2,2.4,2.3,0.0,23,SPA
527f063d,25,1449,16.1,20,4,5,1,18,15,3,19.3,17.9,1.5,23,SPA
532e1e4f,34,3054,33.9,34,33,0,1,55,35,20,56.8,43.5,13.3,23,SPA
540ec57b,36,2447,27.2,31,8,5,1,42,31,11,44.9,35.7,9.2,23,SPA
5487adcd,16,922,10.2,9,9,7,18,13,17,-4,11.1,13.5,-2.3,23,SPA
5496cc91,1,45,0.5,1,0,0,0,0,1,-1,0.2,0.6,-0.4,23,SPA
54bcdeb0,34,2302,25.6,26,11,8,0,26,37,-11,30.1,42.5,-12.4,23,SPA
55126f3b,33,2545,28.3,30,12,3,1,53,24,29,46.3,28.3,18.1,23,SPA
555f3a0b,26,2110,23.4,24,21,2,10,52,19,33,41.7,25.5,16.2,23,SPA
55634fb8,13,581,6.5,7,3,6,13,6,13,-7,6.7,13.5,-6.8,23,SPA
56545648,2,54,0.6,0,0,2,1,1,0,1,2.2,0.3,1.9,23,SPA
56bcaaa0,1,10,0.1,0,0,1,7,0,1,-1,0.1,0.2,-0.1,23,SPA
5757adc3,1,7,0.1,0,0,1,2,0,0,0,0.1,0.5,-0.4,23,SPA
57be54ec,5,97,1.1,1,0,4,13,2,0,2,3.0,0.7,2.3,23,SPA
5853ac44,19,1366,15.2,16,11,3,8,17,27,-10,16.8,23.7,-6.9,23,SPA
58a9a4d9,32,2137,23.7,27,7,5,6,32,31,1,29.0,32.5,-3.6,23,SPA
58ad9383,36,3240,36.0,36,36,0,2,34,40,-6,32.9,41.7,-8.8,23,SPA
58afe001,13,992,11.0,13,5,0,0,11,18,-7,11.5,13.2,-1.7,23,SPA
592f3158,34,2555,28.4,29,13,5,0,34,33,1,30.8,33.9,-3.1,23,SPA
59b7d823,20,1321,14.7,14,8,6,11,26,15,11,24.8,13.4,11.4,23,SPA
5a626448,33,2453,27.3,28,17,5,1,21,27,-6,27.4,29.1,-1.7,23,SPA
5ab0ea87,30,2339,26.0,28,17,2,4,41,11,30,49.4,22.6,26.8,23,SPA
5acc4a10,28,1955,21.7,22,12,6,1,33,26,7,35.1,26.5,8.6,23,SPA
5ae499d0,35,2451,27.2,29,7,6,0,36,33,3,33.2,34.9,-1.7,23,SPA
5b28b2f6,26,1078,12.0,9,4,17,10,13,18,-5,13.5,28.2,-14.7,23,SPA
5b93209a,11,179,2.0,0,0,11,24,7,3,4,3.5,2.1,1.5,23,SPA
5c4dc0ff,9,157,1.7,1,0,8,20,3,1,2,4.9,2.0,2.8,23,SPA
5c7845f6,31,2542,28.2,29,24,2,4,35,26,9,38.8,24.8,14.0,23,SPA
5c96b017,29,1159,12.9,11,0,18,4,9,13,-4,12.1,14.6,-2.5,23,SPA
5ca20b7a,10,639,7.1,7,5,3,0,3,17,-14,4.2,13.9,-9.7,23,SPA
5ccc9672,33,2471,27.5,30,21,3,4,48,15,33,53.8,25.9,27.9,23,SPA
5ce0b5ba,24,1076,12.0,13,2,11,13,15,5,10,14.1,9.3,4.8,23,SPA
5cec2487,6,453,5.0,6,3,0,28,6,10,-4,6.2,7.2,-1.0,23,SPA
5d133e96,7,133,1.5,0,0,7,19,2,2,0,2.6,3.0,-0.5,23,SPA
5db04597,35,2975,33.1,34,30,1,0,31,40,-9,29.4,42.1,-12.7,23,SPA
5dcf3e90,31,2745,30.5,31,30,0,4,42,37,5,44.0,29.9,14.1,23,SPA
5dfc6ad5,33,2258,25.1,25,21,8,4,59,27,32,45.1,28.8,16.2,23,SPA
5e1028e5,36,1894,21.0,21,6,15,1,19,37,-18,23.9,26.1,-2.3,23,SPA
5e95c000,14,1092,12.1,13,10,1,10,11,14,-3,13.9,19.7,-5.9,23,SPA
5eebbfdf,12,275,3.1,2,0,10,5,2,9,-7,4.1,7.7,-3.5,23,SPA
5f21b94c,5,84,0.9,0,0,5,15,0,0,0,1.2,1.0,0.2,23,SPA
5fa714d5,10,349,3.9,3,1,7,16,7,5,2,5.3,3.2,2.2,23,SPA
6025fab1,33,1744,19.4,19,4,14,1,41,20,21,34.1,20.4,13.7,23,SPA
60359288,32,2392,26.6,28,20,4,2,21,43,-22,25.9,45.5,-19.6,23,SPA
608f2092,20,912,10.1,8,7,12,18,10,17,-7,9.7,18.7,-9.0,23,SPA
6091cf45,1,15,0.2,0,0,1,3,0,1,-1,0.0,0.8,-0.8,23,SPA
60abea75,25,1673,18.6,18,12,7,8,25,30,-5,24.5,27.3,-2.7,23,SPA
625c144a,14,1260,14.0,14,14,0,1,15,10,5,17.1,14.1,3.1,23,SPA
6265208f,34,2990,33.2,33,33,1,1,43,61,-18,42.5,53.2,-10.7,23,SPA
62a583ee,2,46,0.5,0,0,2,4,1,1,0,1.1,0.7,0.4,23,SPA
636eae97,26,986,10.9,13,0,13,3,16,13,3,17.9,13.1,4.800000000000001,23,SPA
63b0ca6b,21,757,8.4,9,1,12,13,6,17,-11,9.7,17.1,-7.4,23,SPA
63c5e56b,16,366,4.1,2,0,14,18,7,7,0,5.6,4.6,1.0,23,SPA
63d17038,28,2520,28.0,28,28,0,7,44,37,7,37.2,42.1,-4.9,23,SPA
63f04c6c,26,1633,18.1,20,11,6,2,28,15,13,28.4,23.3,5.1,23,SPA
64035864,4,28,0.3,0,0,4,8,1,1,0,0.6,0.7,-0.1,23,SPA
647d39d2,6,310,3.4,4,0,2,17,3,3,0,3.7,5.1,-1.4,23,SPA
64ba07c0,8,236,2.6,2,0,6,9,3,5,-2,2.5,3.1,-0.6,23,SPA
64e8ed6d,35,2759,30.7,33,14,2,3,26,40,-14,27.0,36.5,-9.5,23,SPA
65154df0,34,2179,24.2,25,6,9,1,37,41,-4,31.1,39.3,-8.3,23,SPA
66116290,27,616,6.8,3,1,24,5,6,9,-3,8.3,10.5,-2.2,23,SPA
661e2822,1,25,0.3,0,0,1,8,1,0,1,0.5,1.0,-0.4,23,SPA
6652cf96,33,2559,28.4,31,17,2,0,34,48,-14,35.5,44.5,-9.0,23,SPA
686cbe7d,5,322,3.6,4,1,1,0,5,3,2,3.9,5.5,-1.6,23,SPA
688b96e3,10,900,10.0,10,10,0,28,14,18,-4,13.5,12.8,0.7,23,SPA
697295b1,28,2020,22.4,25,17,3,4,11,41,-30,18.1,37.9,-19.8,23,SPA
69cbc8b6,32,2669,29.7,31,27,1,2,40,54,-14,38.5,45.0,-6.5,23,SPA
6a8a7af8,34,2428,27.0,27,14,7,2,34,47,-13,30.8,39.5,-8.7,23,SPA
6a99e0b1,36,2836,31.5,34,15,2,0,37,35,2,44.2,28.7,15.5,23,SPA
6b21b7b5,18,647,7.2,5,1,13,3,8,9,-1,7.4,11.3,-3.9,23,SPA
6b5ea2f4,30,1421,15.8,17,2,13,8,16,16,0,22.5,14.5,8.0,23,SPA
6c4776b1,34,3060,34.0,34,34,0,0,27,48,-21,35.5,53.5,-18.0,23,SPA
6c7762c3,24,1958,21.8,22,17,2,3,41,24,17,36.7,30.1,6.6,23,SPA
6c811eb7,35,2119,23.5,26,7,9,0,17,27,-10,21.3,25.1,-3.8,23,SPA
6ce1f46f,30,2155,23.9,25,12,5,3,48,23,25,43.8,26.7,17.1,23,SPA
6db116ec,4,36,0.4,0,0,4,6,0,1,-1,0.5,0.7,-0.2,23,SPA
6e4df551,19,1065,11.8,11,5,8,4,10,15,-5,17.1,18.3,-1.2,23,SPA
6eaed4eb,31,2565,28.5,31,26,0,4,32,37,-5,32.6,39.0,-6.5,23,SPA
6f4c734d,18,397,4.4,2,0,16,10,8,9,-1,4.8,9.4,-4.6,23,SPA
6f51e382,38,3347,37.2,38,36,0,0,68,18,50,74.3,31.7,42.5,23,SPA
6f5f82c0,27,1708,19.0,19,9,8,5,23,19,4,28.6,16.7,11.9,23,SPA
70107d4d,25,1154,12.8,13,1,12,11,11,19,-8,11.0,16.3,-5.2,23,SPA
70d74ece,24,2038,22.6,24,18,0,0,46,17,29,47.5,23.9,23.6,23,SPA
70f8e0bd,35,2100,23.3,26,3,9,0,23,26,-3,19.5,31.6,-12.1,23,SPA
7106f0a0,2,12,0.1,0,0,2,31,1,3,-2,0.1,0.7,-0.7,23,SPA
7111d552,33,2823,31.4,32,21,1,0,58,32,26,58.9,32.2,26.8,23,SPA
7155e3e1,16,1171,13.0,15,8,1,0,16,21,-5,17.6,18.6,-1.0,23,SPA
7226539b,38,3407,37.9,38,36,0,0,45,53,-8,43.4,50.2,-6.8,23,SPA
72a84002,25,1714,19.0,22,11,3,6,17,25,-8,20.3,27.9,-7.6,23,SPA
733aab44,1,11,0.1,0,0,1,4,0,1,-1,0.2,0.5,-0.3,23,SPA
73683fa9,2,96,1.1,1,1,1,30,1,4,-3,0.9,1.8,-0.9,23,SPA
7460ca0d,37,3285,36.5,37,33,0,0,57,39,18,58.9,48.3,10.6,23,SPA
75645f0e,35,2365,26.3,29,6,6,0,36,24,12,37.0,30.6,6.4,23,SPA
759d8dd7,12,483,5.4,5,3,7,26,1,15,-14,3.7,12.2,-8.5,23,SPA
76c2a023,32,1989,22.1,22,15,10,6,23,47,-24,23.8,41.5,-17.7,23,SPA
79f2a5f5,1,1,0.0,0,0,1,28,0,4,-4,0.0,0.2,-0.2,23,SPA
7b5ab7f2,17,918,10.2,10,1,7,2,13,13,0,13.8,11.2,2.6,23,SPA
7b9c2d84,37,2010,22.3,21,11,16,0,51,16,35,47.6,20.8,26.8,23,SPA
7c363088,31,2013,22.4,23,7,8,2,29,24,5,27.3,25.7,1.6,23,SPA
7c388b20,33,2038,22.6,22,6,11,5,18,33,-15,20.9,35.3,-14.4,23,SPA
7c4243d4,29,1617,18.0,20,3,9,6,15,25,-10,16.6,28.7,-12.1,23,SPA
7d08063d,15,542,6.0,5,0,10,11,8,7,1,5.9,6.8,-0.9,23,SPA
7dcf86f6,37,2868,31.9,31,27,6,0,36,46,-10,37.7,37.4,0.3,23,SPA
7e98cff1,34,2390,26.6,27,12,7,2,36,36,0,35.1,34.4,0.7,23,SPA
7f271d74,7,148,1.6,0,0,7,15,5,6,-1,1.8,4.4,-2.6,23,SPA
7f9c5d2d,13,607,6.7,7,3,6,8,7,10,-3,10.3,10.9,-0.6,23,SPA
80211dc5,2,66,0.7,1,0,1,2,0,1,-1,0.7,1.9,-1.2,23,SPA
8059806f,33,1807,20.1,21,3,12,2,13,25,-12,20.2,29.3,-9.0,23,SPA
805a2a11,1,30,0.3,0,0,1,0,1,0,1,1.8,0.2,1.6,23,SPA
808d48f3,32,2599,28.9,30,19,2,1,31,32,-1,25.0,36.8,-11.8,23,SPA
81442ecb,30,1912,21.2,21,10,9,0,27,34,-7,27.1,29.5,-2.5,23,SPA
819aa8e7,19,1386,15.4,17,5,2,0,18,17,1,21.1,20.2,0.9,23,SPA
81d5c497,3,22,0.2,0,0,3,2,0,0,0,0.3,0.1,0.2,23,SPA
81f0781e,21,1230,13.7,14,7,7,1,21,9,12,23.0,17.9,5.1,23,SPA
82cfae2a,8,614,6.8,7,5,1,8,9,12,-3,6.8,10.7,-3.9,23,SPA
82ec26c1,1,8,0.1,0,0,1,3,0,0,0,0.5,0.0,0.5,23,SPA
84399660,22,925,10.3,9,3,13,3,18,18,0,18.1,16.8,1.3,23,SPA
8455ad90,36,2823,31.4,33,12,3,0,32,32,0,29.5,34.1,-4.6,23,SPA
84a85b48,1,5,0.1,0,0,1,1,0,0,0,0.0,0.0,0.0,23,SPA
852ddfb8,22,1501,16.7,16,10,6,14,17,15,2,20.6,19.7,0.9,23,SPA
853b7c48,19,1710,19.0,19,19,0,0,18,29,-11,21.2,19.7,1.6,23,SPA
85bed4ee,30,1601,17.8,19,3,11,7,20,15,5,21.9,22.7,-0.8,23,SPA
85dace26,16,729,8.1,8,2,8,11,6,17,-11,6.9,13.4,-6.5,23,SPA
8696bc90,28,1150,12.8,10,0,18,3,15,14,1,16.6,18.2,-1.7,23,SPA
86ff856b,19,716,8.0,7,2,12,16,13,13,0,11.9,12.1,-0.3,23,SPA
873619c6,38,2401,26.7,27,4,11,0,36,38,-2,31.7,36.7,-4.9,23,SPA
873ce3a2,2,37,0.4,0,0,2,10,2,1,1,0.2,0.9,-0.8,23,SPA
87b498b0,1,90,1.0,1,1,0,35,3,3,0,0.6,1.8,-1.2,23,SPA
88050721,34,1254,13.9,12,1,22,4,15,20,-5,16.2,18.4,-2.1,23,SPA
881ef58c,1,5,0.1,0,0,1,6,0,0,0,0.0,0.1,-0.1,23,SPA
89151b16,8,375,4.2,4,2,4,5,5,7,-2,3.4,9.2,-5.9,23,SPA
89f951b5,31,1788,19.9,21,10,10,5,23,25,-2,25.5,30.2,-4.7,23,SPA
8aae94b9,14,760,8.4,7,6,7,14,5,17,-12,8.6,15.1,-6.5,23,SPA
8aafd64f,14,650,7.2,7,1,7,1,11,8,3,8.7,8.6,0.1,23,SPA
8ac501f5,33,2031,22.6,23,13,10,3,17,40,-23,23.4,39.3,-15.9,23,SPA
8b298f56,21,718,8.0,6,1,15,14,9,11,-2,7.2,13.1,-5.9,23,SPA
8c3c640c,23,1214,13.5,14,3,9,1,17,12,5,18.5,12.1,6.4,23,SPA
8c725b43,31,2511,27.9,29,22,2,2,33,28,5,36.2,36.5,-0.3,23,SPA
8cfc2f69,17,394,4.4,2,0,15,17,5,5,0,6.3,6.2,0.1,23,SPA
8d78e732,34,2847,31.6,33,27,1,0,62,20,42,66.5,26.1,40.3,23,SPA
8e010ff4,27,722,8.0,4,1,23,11,10,16,-6,10.8,15.6,-4.8,23,SPA
8e088e04,24,914,10.2,9,0,15,9,12,11,1,11.2,12.2,-1.0,23,SPA
8e48dc61,8,221,2.5,2,0,6,23,5,1,4,5.1,1.5,3.6,23,SPA
8e92be30,2,152,1.7,2,0,0,0,2,3,-1,1.9,1.9,0.0,23,SPA
8f3565b3,31,1798,20.0,22,3,9,6,22,19,3,22.6,22.0,0.6,23,SPA
8f5e92a6,34,2379,26.4,25,15,9,0,54,27,27,56.8,26.6,30.2,23,SPA
8f696594,10,384,4.3,5,0,5,8,13,1,12,9.3,2.4,6.9,23,SPA
8f8c6934,38,3420,38.0,38,38,0,0,34,45,-11,36.7,46.0,-9.4,23,SPA
8fae77ea,28,2507,27.9,28,27,0,6,26,42,-16,29.5,46.6,-17.1,23,SPA
90162357,3,103,1.1,1,0,2,34,2,3,-1,3.8,1.9,1.9,23,SPA
90bbd822,35,2870,31.9,34,15,1,0,35,41,-6,37.0,40.4,-3.4,23,SPA
91f7631f,30,2449,27.2,28,19,2,0,29,25,4,27.6,25.5,2.0,23,SPA
922da988,5,165,1.8,1,0,4,8,1,6,-5,0.9,5.2,-4.3,23,SPA
924ff27e,1,90,1.0,1,1,0,30,3,0,3,2.2,1.1,1.1,23,SPA
93090f69,31,2657,29.5,30,28,1,5,26,40,-14,24.9,38.4,-13.6,23,SPA
937c6ae6,1,7,0.1,0,0,1,5,0,1,-1,0.1,0.2,-0.1,23,SPA
958d67bb,7,252,2.8,3,0,4,13,5,4,1,1.8,3.6,-1.8,23,SPA
962e54cb,25,662,7.4,5,0,20,9,7,7,0,10.0,8.6,1.4,23,SPA
963829d0,23,828,9.2,8,2,15,7,17,8,9,13.9,14.6,-0.7,23,SPA
968a1c2f,26,852,9.5,6,0,20,11,3,13,-10,11.8,8.4,3.4,23,SPA
974322dc,32,2146,23.8,21,16,11,3,18,32,-14,19.9,28.7,-8.8,23,SPA
97852360,17,1530,17.0,17,17,0,13,24,35,-11,24.1,32.4,-8.3,23,SPA
9939e168,37,2448,27.2,25,16,12,0,24,36,-12,28.9,33.2,-4.3,23,SPA
99ea2ddd,4,223,2.5,2,1,2,4,0,7,-7,1.2,5.3,-4.1,23,SPA
9a0408b6,32,1282,14.2,12,6,20,6,9,27,-18,15.3,21.8,-6.5,23,SPA
9a26fa06,1,90,1.0,1,1,0,3,0,0,0,0.5,0.4,0.0,23,SPA
9a64e67e,33,2796,31.1,31,30,2,1,37,25,12,42.8,27.5,15.3,23,SPA
9a76c2e9,25,1116,12.4,13,3,12,9,23,19,4,16.6,19.7,-3.1,23,SPA
9a93efc9,17,1365,15.2,14,13,3,19,13,18,-5,19.3,18.0,1.3,23,SPA
9c36ed83,26,1598,17.8,16,5,10,3,35,18,17,31.8,21.1,10.7,23,SPA
9d33c71a,1,45,0.5,1,0,0,2,0,1,-1,0.1,1.3,-1.2,23,SPA
9e1035f8,33,1392,15.5,14,5,19,3,25,11,14,28.4,15.5,12.8,23,SPA
9f0ea33f,10,900,10.0,10,10,0,20,7,21,-14,8.7,18.4,-9.7,23,SPA
9f323c71,37,2819,31.3,32,22,5,0,41,34,7,45.1,27.9,17.2,23,SPA
9f979eb2,10,601,6.7,6,4,4,6,6,10,-4,9.9,12.4,-2.6,23,SPA
9fec8860,4,132,1.5,1,0,3,6,1,4,-3,1.2,2.6,-1.5,23,SPA
a01c3d54,21,1890,21.0,21,21,0,17,23,19,4,20.6,24.3,-3.6,23,SPA
a0255c67,16,864,9.6,11,0,5,17,13,14,-1,10.200000000000001,12.399999999999999,-2.2,23,SPA
a08b974a,19,1165,12.9,11,6,8,3,20,20,0,18.2,15.9,2.2,23,SPA
a0b4bb3e,12,799,8.9,10,4,2,0,9,14,-5,8.3,15.4,-7.1,23,SPA
a10361d2,30,2337,26.0,26,18,4,0,39,37,2,35.9,32.4,3.5,23,SPA
a21417e2,11,638,7.1,7,4,4,7,6,9,-3,5.7,10.8,-5.1,23,SPA
a254bbe0,32,1076,12.0,11,1,21,5,7,19,-12,11.9,14.4,-2.5,23,SPA
a2c1a8d3,8,675,7.5,7,7,1,26,5,6,-1,10.2,6.9,3.3,23,SPA
a2d9cf74,2,10,0.1,0,0,2,8,1,0,1,0.2,0.5,-0.3,23,SPA
a300ac7e,14,628,7.0,5,2,9,1,7,14,-7,6.4,15.1,-8.7,23,SPA
a39bb753,6,196,2.2,2,0,4,27,5,1,4,4.4,1.8,2.6,23,SPA
a3e4bf46,30,2403,26.7,29,18,1,1,37,44,-7,34.2,39.6,-5.5,23,SPA
a45eac1f,18,887,9.9,10,0,8,1,14,11,3,11.4,15.5,-4.1,23,SPA
a461f098,8,84,0.9,0,0,8,7,1,3,-2,2.5,1.9,0.5,23,SPA
a4971d84,33,2840,31.6,33,29,0,0,27,39,-12,30.8,35.5,-4.7,23,SPA
a4995f48,17,1530,17.0,17,17,0,19,14,23,-9,19.2,21.4,-2.2,23,SPA
a4b00319,37,3160,35.1,36,32,1,0,42,49,-7,40.0,41.3,-1.2,23,SPA
a55d8df5,26,1454,16.2,15,8,11,10,15,13,2,20.6,22.0,-1.4,23,SPA
a56da3ba,27,2062,22.9,21,20,6,9,21,27,-6,25.7,28.1,-2.4,23,SPA
a6103274,24,842,9.4,10,0,14,5,7,11,-4,11.399999999999999,16.3,-5.0,23,SPA
a62b4888,16,326,3.6,2,0,14,22,2,8,-6,2.9,5.2,-2.3,23,SPA
a6951bf8,16,748,8.3,9,1,7,1,10,6,4,11.0,11.2,-0.2,23,SPA
a6de370d,31,2402,26.7,28,14,3,0,31,28,3,32.6,34.7,-2.1,23,SPA
a83c19cf,10,360,4.0,3,0,7,5,2,4,-2,6.6,3.4,3.2,23,SPA
a8981944,37,2843,31.6,34,12,3,0,44,47,-3,37.3,47.7,-10.3,23,SPA
a8f21b9f,35,2144,23.8,23,8,12,1,26,26,0,25.3,28.2,-2.9,23,SPA
aa677a35,28,1576,17.5,17,9,11,3,12,26,-14,17.2,29.6,-12.4,23,SPA
aad53e64,27,1312,14.6,15,1,12,11,19,18,1,15.0,18.6,-3.6,23,SPA
ab7bf91d,29,2376,26.4,26,25,3,4,28,24,4,35.4,24.7,10.7,23,SPA
abe66106,32,1844,20.5,20,9,12,2,22,29,-7,23.1,32.1,-9.0,23,SPA
ac295d9e,15,1269,14.1,13,13,2,21,20,13,7,18.2,16.4,1.8,23,SPA
ac454a4f,35,2737,30.4,31,20,4,0,24,54,-30,31.4,56.7,-25.3,23,SPA
ac8b2421,24,1915,21.3,23,16,1,2,15,41,-26,19.4,40.7,-21.3,23,SPA
acc1aefa,26,1138,12.6,11,3,15,10,17,15,2,15.6,14.6,1.1,23,SPA
adfc9123,6,384,4.3,4,3,2,7,9,1,8,11.4,3.7,7.8,23,SPA
ae48c5cb,24,1586,17.6,18,5,6,7,27,25,2,23.1,26.3,-3.2,23,SPA
ae852b7d,15,1123,12.5,11,9,4,12,19,21,-2,15.9,19.7,-3.8,23,SPA
ae86d473,17,447,5.0,3,0,14,5,9,7,2,7.3,7.6,-0.3,23,SPA
af34f10d,6,120,1.3,0,0,6,7,1,0,1,1.2,2.1,-0.9,23,SPA
afdc14d7,36,2656,29.5,32,9,4,0,43,30,13,42.6,26.7,15.9,23,SPA
b05e2dbd,31,2709,30.1,31,25,0,1,32,37,-5,39.4,33.6,5.9,23,SPA
b0616e3d,23,1439,16.0,17,8,6,10,15,21,-6,16.9,23.1,-6.2,23,SPA
b0fce72c,36,2575,28.6,28,21,8,0,32,30,2,40.2,26.5,13.6,23,SPA
b151a3f2,1,1,0.0,0,0,1,5,0,0,0,0.0,0.0,0.0,23,SPA
b19db005,25,1410,15.7,16,3,9,0,32,11,21,32.1,15.5,16.6,23,SPA
b3b9b8b8,1,2,0.0,0,0,1,3,0,0,0,0.0,0.1,0.0,23,SPA
b3dc6eca,10,560,6.2,5,5,5,14,8,8,0,10.8,8.2,2.6,23,SPA
b3f62bfc,2,6,0.1,0,0,2,1,1,0,1,1.6,0.1,1.5,23,SPA
b418dbd4,35,967,10.7,6,1,29,3,12,13,-1,16.1,11.9,4.2,23,SPA
b51b1b9c,33,2110,23.4,26,8,7,1,26,26,0,27.7,28.1,-0.4,23,SPA
b6e50615,29,2406,26.7,27,24,2,1,23,32,-9,35.7,27.8,7.9,23,SPA
b75ac54b,3,145,1.6,2,0,1,13,0,2,-2,0.7,2.2,-1.5,23,SPA
b7c04927,18,1213,13.5,15,10,3,6,9,29,-20,14.1,25.8,-11.7,23,SPA
b7ca5c51,21,1504,16.7,18,13,3,8,20,24,-4,21.5,19.6,2.0,23,SPA
b7d7f3bf,10,76,0.8,0,0,10,9,1,1,0,1.1,0.7,0.4,23,SPA
b857bd29,31,2766,30.7,31,30,0,0,31,31,0,29.8,32.3,-2.5,23,SPA
b85bf253,16,1306,14.5,15,9,1,0,15,25,-10,15.0,25.5,-10.4,23,SPA
b86a64b2,27,2156,24.0,24,21,3,6,26,42,-16,25.9,38.2,-12.3,23,SPA
b8a642fc,37,2339,26.0,27,9,10,1,41,33,8,42.0,34.9,7.2,23,SPA
b906757a,16,859,9.5,9,8,7,22,9,18,-9,16.9,12.6,4.3,23,SPA
b907d169,1,15,0.2,0,0,1,1,0,0,0,0.0,0.4,-0.4,23,SPA
ba5004e1,28,1946,21.6,26,12,2,5,21,20,1,22.9,22.7,0.2,23,SPA
bb08bce9,25,2047,22.7,23,19,2,6,19,24,-5,23.2,27.7,-4.5,23,SPA
bbc19252,5,69,0.8,0,0,5,9,0,2,-2,0.7,2.1,-1.5,23,SPA
bbf5c11b,26,1298,14.4,16,7,10,12,18,24,-6,19.2,21.7,-2.5,23,SPA
bc6f5f06,29,2339,26.0,26,18,3,4,35,46,-11,31.6,40.8,-9.2,23,SPA
bdb624a3,36,2532,28.1,32,6,4,0,38,29,9,39.3,28.0,11.2,23,SPA
bdc74a8f,16,457,5.1,3,0,13,5,4,5,-1,6.7,7.8,-1.1,23,SPA
be170419,36,3151,35.0,35,35,1,1,41,48,-7,37.8,41.9,-4.1,23,SPA
be6faae0,1,13,0.1,0,0,1,13,0,0,0,0.3,0.2,0.1,23,SPA
bece776f,15,961,10.7,12,5,3,0,19,10,9,19.9,10.1,9.7,23,SPA
bed68338,28,1504,16.7,19,2,9,0,20,15,5,16.8,19.5,-2.7,23,SPA
bfd381b3,29,1705,18.9,20,10,9,6,14,24,-10,16.6,25.5,-8.9,23,SPA
c05dfb74,30,1689,18.8,19,5,11,2,29,18,11,28.1,17.2,10.8,23,SPA
c0617e2b,30,1564,17.4,19,5,11,3,26,14,12,30.8,16.6,14.1,23,SPA
c0b1a6da,2,180,2.0,2,2,0,36,1,4,-3,1.7,3.0,-1.3,23,SPA
c14bc029,31,1100,12.2,11,5,20,6,28,14,14,19.0,17.5,1.5,23,SPA
c20bdcd7,22,1857,20.6,22,18,0,1,29,17,12,27.1,21.9,5.2,23,SPA
c2111b45,1,22,0.2,0,0,1,35,2,0,2,1.2,0.1,1.1,23,SPA
c3e66ffe,33,2732,30.4,32,25,1,3,46,49,-3,40.6,45.8,-5.2,23,SPA
c487901c,10,447,5.0,5,0,5,0,6,6,0,8.5,3.5,5.0,23,SPA
c4b888df,27,2199,24.4,25,18,2,2,20,23,-3,29.6,34.6,-4.9,23,SPA
c5642098,2,149,1.7,2,1,0,9,1,3,-2,1.4,2.1,-0.7,23,SPA
c78b352d,27,2009,22.3,24,14,3,0,27,26,1,33.4,23.2,10.3,23,SPA
c93231dc,3,210,2.3,3,1,0,3,2,5,-3,1.5,4.6,-3.1,23,SPA
c997b942,17,351,3.9,1,0,16,21,0,6,-6,6.2,5.0,1.2,23,SPA
c9e39d91,34,2407,26.7,28,12,6,1,40,25,15,36.4,21.4,15.0,23,SPA
cb574619,26,2163,24.0,26,17,0,7,27,34,-7,28.5,28.0,0.5,23,SPA
cc1c5035,2,73,0.8,0,0,2,36,2,2,0,1.2,1.4,-0.2,23,SPA
cc2dd8a5,6,178,2.0,1,0,5,12,5,2,3,3.6,1.6,2.0,23,SPA
cc83b74d,4,197,2.2,2,1,2,7,2,2,0,1.7,4.1,-2.4,23,SPA
cc9256ef,33,1403,15.6,13,2,20,4,14,31,-17,18.8,31.3,-12.5,23,SPA
ccbbe661,33,1122,12.5,8,1,25,3,14,17,-3,16.2,24.4,-8.2,23,SPA
cce181df,20,1006,11.2,10,6,10,13,15,11,4,14.4,12.6,1.7,23,SPA
cde52ef5,19,1710,19.0,19,19,0,19,25,24,1,21.4,25.8,-4.4,23,SPA
ce8039aa,32,1248,13.9,16,2,16,6,23,28,-5,19.0,25.1,-6.0,23,SPA
cee88597,37,3232,35.9,37,31,0,0,43,47,-4,38.7,46.1,-7.4,23,SPA
d080ed5e,33,2494,27.7,28,18,5,0,37,31,6,39.0,26.0,13.0,23,SPA
d1b060e2,26,416,4.6,2,0,24,12,6,7,-1,5.4,6.8,-1.5,23,SPA
d2110326,29,2446,27.2,28,24,1,4,32,29,3,35.5,27.7,7.8,23,SPA
d4808594,2,65,0.7,0,0,2,2,0,2,-2,0.5,1.5,-1.0,23,SPA
d49f3e6b,35,2462,27.4,29,14,6,0,24,47,-23,27.5,44.8,-17.3,23,SPA
d4b73232,38,3420,38.0,38,38,0,0,42,45,-3,49.3,43.5,5.8,23,SPA
d557d734,2,18,0.2,0,0,2,17,1,0,1,0.2,0.1,0.2,23,SPA
d5dd5f1f,1,9,0.1,0,0,1,2,0,0,0,0.4,0.1,0.3,23,SPA
d61759ec,5,98,1.1,1,0,4,15,0,5,-5,1.6,3.2,-1.6,23,SPA
d637fc22,15,686,7.6,8,2,7,9,5,7,-2,4.6,11.2,-6.7,23,SPA
d733aa38,2,11,0.1,0,0,2,13,0,0,0,0.6,0.1,0.5,23,SPA
d7553721,22,1126,12.5,14,2,8,1,21,12,9,25.4,14.1,11.4,23,SPA
d854c9d0,1,13,0.1,0,0,1,8,0,0,0,0.1,0.0,0.0,23,SPA
d8712bf9,4,60,0.7,0,0,4,13,1,1,0,1.0,0.1,1.0,23,SPA
d87e2cae,28,731,8.1,6,2,22,7,8,11,-3,10.5,12.3,-1.8,23,SPA
d9235a45,1,45,0.5,0,0,1,17,0,2,-2,0.3,1.2,-0.9,23,SPA
d9ba39fc,20,1646,18.3,18,15,2,11,25,14,11,24.2,15.2,9.0,23,SPA
da76bab4,35,2597,28.9,33,8,2,0,43,41,2,35.6,38.5,-2.8,23,SPA
dabb2827,37,3285,36.5,37,36,0,1,48,61,-13,44.2,60.3,-16.1,23,SPA
db001fa9,36,3122,34.7,35,33,1,1,29,43,-14,39.6,53.6,-14.0,23,SPA
db8f0eba,30,1507,16.799999999999997,18,1,12,5,25,28,-3,23.0,22.599999999999998,0.4,23,SPA
dc1c2fce,37,2297,25.5,26,10,11,1,30,33,-3,33.7,25.4,8.4,23,SPA
dc1ce4f5,3,145,1.6,1,1,2,28,0,2,-2,1.7,1.6,0.1,23,SPA
dc62b55d,11,377,4.2,2,0,9,2,10,6,4,8.1,5.9,2.2,23,SPA
de39485a,35,2317,25.7,26,7,9,1,43,25,18,42.1,31.3,10.9,23,SPA
dee86451,33,2438,27.1,31,14,2,0,34,24,10,37.9,32.0,5.9,23,SPA
df69b544,38,2859,31.8,31,23,7,0,61,29,32,54.9,34.0,20.9,23,SPA
dfe5caa2,1,21,0.2,0,0,1,0,0,0,0,1.1,0.1,1.0,23,SPA
e08647d6,24,631,7.0,8,0,16,4,7,8,-1,7.7,7.2,0.5,23,SPA
e0979e74,2,52,0.6,0,0,2,13,1,0,1,0.5,1.0,-0.5,23,SPA
e19c989c,1,25,0.3,1,0,0,8,0,0,0,0.0,0.7,-0.7,23,SPA
e1e75690,3,41,0.5,0,0,3,7,0,0,0,1.0,0.5,0.5,23,SPA
e2716bd0,28,1937,21.5,25,1,3,1,37,21,16,31.5,17.2,14.3,23,SPA
e2dcc60e,1,10,0.1,0,0,1,2,0,0,0,0.1,0.3,-0.3,23,SPA
e358587b,22,1980,22.0,22,22,0,12,42,27,15,42.1,33.0,9.1,23,SPA
e4346678,36,3240,36.0,36,36,0,0,29,63,-34,35.8,67.0,-31.2,23,SPA
e4738e91,20,527,5.9,3,0,17,14,4,6,-2,7.7,9.6,-1.9,23,SPA
e5d01ecf,20,1133,12.6,13,6,7,9,13,14,-1,17.9,16.0,1.9,23,SPA
e6697917,34,2539,28.2,29,14,5,2,30,32,-2,37.4,32.4,5.0,23,SPA
e6777e6b,22,1680,18.7,18,16,4,16,16,17,-1,16.5,19.6,-3.1,23,SPA
e73c9bb2,27,1427,15.9,15,6,12,3,17,24,-7,17.3,24.7,-7.4,23,SPA
e7af9060,19,1469,16.3,16,13,3,1,20,26,-6,19.4,27.4,-8.0,23,SPA
e7d2a50b,1,12,0.1,0,0,1,3,0,0,0,0.3,0.0,0.3,23,SPA
e7f4603c,11,679,7.5,10,2,1,6,16,12,4,10.2,11.2,-1.1,23,SPA
e897d8ba,35,1021,11.3,7,2,28,2,8,18,-10,12.2,17.6,-5.4,23,SPA
e8deefd6,3,158,1.8,2,0,1,9,1,6,-5,0.0,0.0,0.0,23,SPA
e9241b40,28,1481,16.5,16,2,12,6,22,17,5,18.1,19.4,-1.3,23,SPA
e92cd3f7,34,2386,26.5,28,8,6,0,38,20,18,37.3,20.3,17.0,23,SPA
e96b2583,1,3,0.0,0,0,1,2,1,0,1,0.8,0.0,0.8,23,SPA
ea610f00,4,17,0.2,0,0,4,7,0,1,-1,0.1,0.9,-0.8,23,SPA
ea83bfa6,26,2340,26.0,26,26,0,11,33,32,1,34.5,35.1,-0.6,23,SPA
ead61f73,21,1472,16.4,16,11,5,16,20,18,2,23.0,21.5,1.5,23,SPA
eb82b6f1,27,1714,19.0,21,4,6,1,14,29,-15,20.1,32.2,-12.0,23,SPA
ec1a731e,14,965,10.7,10,8,4,4,7,20,-13,8.7,20.3,-11.6,23,SPA
ed5c5fa3,36,2855,31.7,33,22,3,0,35,44,-9,37.3,35.8,1.5,23,SPA
ed6ea4d9,11,599,6.7,7,2,4,2,5,3,2,7.2,9.6,-2.3,23,SPA
edc98fac,34,3010,33.4,34,32,0,0,55,48,7,45.5,45.9,-0.3,23,SPA
ee45d138,9,460,5.1,5,1,4,3,3,6,-3,4.1,6.8,-2.7,23,SPA
ee8508c0,28,2492,27.7,28,26,0,0,42,20,22,44.0,26.1,18.0,23,SPA
ee923664,10,441,4.9,6,2,4,28,4,8,-4,5.4,7.0,-1.6,23,SPA
eeba07f8,21,1490,16.6,18,8,3,0,22,28,-6,19.7,28.3,-8.6,23,SPA
ef322658,26,1373,15.3,16,6,10,9,22,23,-1,20.3,21.5,-1.2,23,SPA
efecd633,33,1844,20.5,24,3,9,0,16,23,-7,21.7,31.5,-9.9,23,SPA
f03f284b,20,1652,18.4,19,14,1,7,26,24,2,22.6,25.7,-3.1,23,SPA
f08490a6,10,479,5.3,6,2,4,2,4,7,-3,5.6,6.0,-0.5,23,SPA
f0da930c,28,2423,26.9,26,26,2,3,52,21,31,46.2,28.0,18.2,23,SPA
f0f4671c,1,6,0.1,0,0,1,22,0,1,-1,0.0,0.2,-0.2,23,SPA
f127d782,11,990,11.0,11,11,0,23,17,18,-1,13.5,15.3,-1.8,23,SPA
f25b010f,1,90,1.0,1,1,0,4,1,2,-1,1.1,0.9,0.3,23,SPA
f2c6ac01,30,2656,29.5,30,27,0,2,29,33,-4,27.5,36.4,-8.9,23,SPA
f35430a4,14,906,10.1,10,8,4,9,9,13,-4,6.9,13.2,-6.3,23,SPA
f36016a5,24,1028,11.5,13,0,11,8,11,12,-1,16.0,15.100000000000001,0.8999999999999999,23,SPA
f3b1d9a2,28,1227,13.6,12,3,16,3,13,14,-1,14.7,15.1,-0.4,23,SPA
f4290206,24,1172,13.0,11,8,13,10,22,11,11,23.2,14.0,9.2,23,SPA
f4c69aa6,24,1011,11.2,10,3,14,5,10,16,-6,14.5,14.3,0.2,23,SPA
f553b2b3,32,1705,18.9,20,3,12,2,25,32,-7,21.8,20.4,1.4,23,SPA
f6798fc3,25,2151,23.9,25,23,0,12,27,42,-15,28.1,37.8,-9.7,23,SPA
f6ac68c1,22,1943,21.6,22,19,0,1,33,17,16,31.2,22.8,8.4,23,SPA
f6f6b6e8,25,1608,17.9,19,13,6,5,14,33,-19,16.4,33.1,-16.7,23,SPA
f7dc2ae5,25,1449,16.1,16,8,9,4,26,14,12,21.9,13.9,8.0,23,SPA
f7e87032,19,1489,16.5,17,10,2,2,29,19,10,22.1,25.1,-3.0,23,SPA
f8405304,19,587,6.5,5,0,14,5,11,9,2,10.1,6.6,3.5,23,SPA
f874dd44,3,143,1.6,1,1,2,8,4,0,4,5.4,0.6,4.7,23,SPA
f8eca1b6,35,2970,33.0,35,19,0,0,29,42,-13,31.1,40.8,-9.6,23,SPA
f9358b61,1,1,0.0,0,0,1,1,0,0,0,0.0,0.0,0.0,23,SPA
f9a225f5,2,43,0.5,0,0,2,1,0,2,-2,0.4,0.6,-0.3,23,SPA
fb938d24,4,111,1.2,1,0,3,9,3,2,1,1.5,1.3,0.2,23,SPA
fbbb9269,23,1680,18.7,19,14,4,4,26,18,8,25.4,23.3,2.0,23,SPA
fbd6378b,21,1461,16.2,16,13,5,17,34,17,17,31.8,23.6,8.2,23,SPA
fc076f78,4,59,0.7,0,0,4,6,3,1,2,1.9,1.2,0.8,23,SPA
fc647b34,34,2145,23.8,28,2,6,0,34,32,2,25.9,32.1,-6.2,23,SPA
fc70e345,37,3324,36.9,37,36,0,1,44,49,-5,43.0,48.5,-5.5,23,SPA
fc8b614b,8,88,1.0,1,0,7,23,1,3,-2,0.8,3.1,-2.3,23,SPA
fd47b4f2,36,3155,35.1,36,33,0,0,45,61,-16,38.8,57.8,-18.9,23,SPA
fd51b456,23,1144,12.7,12,6,11,9,28,12,16,28.7,12.3,16.4,23,SPA
fd771f95,31,2456,27.3,29,14,2,0,35,46,-11,32.4,40.5,-8.1,23,SPA
fdd26d71,15,585,6.5,7,2,8,15,7,15,-8,5.2,10.1,-4.9,23,SPA
fe05804b,3,137,1.5,1,0,2,9,0,3,-3,0.8,2.5,-1.7,23,SPA
fe641c1a,8,309,3.4,2,0,6,6,2,7,-5,2.9,8.1,-5.2,23,SPA
fea23125,4,360,4.0,4,4,0,23,3,5,-2,6.1,8.2,-2.1,23,SPA
fed17f5a,3,242,2.7,3,2,0,0,1,2,-1,2.7,2.6,0.1,23,SPA
ff800ed8,12,628,7.0,7,3,5,19,5,17,-12,5.2,11.6,-6.3,23,SPA
ffacd3d5,31,2124,23.6,22,21,9,7,22,26,-4,23.4,30.5,-7.1,23,SPA
0076ab7f,6,496,5.5,5,5,1,0,5,12,-7,5.2,9.5,-4.3,23,CL
009a4f60,1,18,0.2,0,0,1,0,0,0,0,0.0,0.6,-0.6,23,CL
00f518d8,5,73,0.8,0,0,5,3,1,1,0,0.8,2.0,-1.2,23,CL
01b8a2b2,4,360,4.0,4,4,0,0,7,9,-2,6.8,6.7,0.1,23,CL
01c3aff5,5,360,4.0,4,3,1,0,8,9,-1,6.4,9.5,-3.2,23,CL
01e5f06e,5,305,3.4,4,2,1,7,11,1,10,10.3,1.2,9.1,23,CL
01eb744d,6,315,3.5,3,1,3,0,3,9,-6,4.2,6.8,-2.6,23,CL
02c15616,3,212,2.4,3,2,0,0,2,3,-1,2.3,3.8,-1.5,23,CL
032f894e,3,141,1.6,1,0,2,1,7,3,4,2.5,2.2,0.3,23,CL
03998238,4,104,1.2,0,0,4,2,1,3,-2,0.6,2.9,-2.3,23,CL
03df04ff,10,900,10.0,10,10,0,0,26,13,13,19.0,10.9,8.1,23,CL
042e8a49,7,533,5.9,7,2,0,1,11,4,7,11.0,6.1,4.9,23,CL
048a1cbc,6,479,5.3,5,3,1,0,9,5,4,7.8,7.8,0.0,23,CL
049a888d,8,610,6.7,7,3,1,2,8,11,-3,5.4,12.9,-7.3,23,CL
04e17fd5,4,245,2.7,3,1,1,1,3,5,-2,3.2,3.9,-0.7,23,CL
04e531b6,3,95,1.1,1,0,2,2,4,3,1,2.4,2.7,-0.4,23,CL
05439de2,11,711,7.9,9,5,2,0,16,9,7,15.3,12.5,2.8,23,CL
05d548d8,4,315,3.5,4,3,0,3,3,4,-1,2.6,4.1,-1.5,23,CL
05e19d6a,6,274,3.0,3,1,3,0,10,7,3,5.6,6.1,-0.5,23,CL
0670ee51,4,266,3.0,4,2,0,0,3,3,0,5.1,3.1,2.1,23,CL
06a1d642,6,443,4.9,6,2,0,0,1,10,-9,4.0,9.2,-5.3,23,CL
08511d65,8,720,8.0,8,8,0,0,16,10,6,10.8,10.0,0.8,23,CL
08990838,4,360,4.0,4,4,0,0,1,9,-8,3.4,8.5,-5.1,23,CL
08f5afaa,8,720,8.0,8,8,0,0,16,10,6,10.8,10.0,0.8,23,CL
08fe932d,2,100,1.1,1,1,1,1,0,1,-1,0.3,1.7,-1.4,23,CL
0959c2a2,11,967,10.7,11,10,0,0,23,10,13,19.7,13.6,6.2,23,CL
0a084b35,6,540,6.0,6,6,0,0,4,15,-11,9.2,10.9,-1.7,23,CL
0a69de7b,2,180,2.0,2,2,0,4,1,4,-3,2.8,3.1,-0.3,23,CL
0a6dbbf7,8,720,8.0,8,8,0,0,8,11,-3,8.0,16.9,-8.9,23,CL
0a89e877,7,202,2.2,1,0,6,1,3,11,-8,2.3,7.4,-5.1,23,CL
0ab1f153,6,431,4.8,6,1,0,0,6,12,-6,6.3,6.8,-0.5,23,CL
0b5a292a,6,386,4.3,5,2,1,4,7,1,6,8.6,5.2,3.3,23,CL
0ba976e4,6,244,2.7,2,1,4,0,9,5,4,5.6,4.8,0.7,23,CL
0c7a48f8,5,450,5.0,5,5,0,0,4,8,-4,7.9,7.0,0.9,23,CL
0ca476cc,4,121,1.3,1,0,3,0,2,2,0,2.3,1.5,0.7,23,CL
0d267745,9,793,8.8,9,8,0,0,25,10,15,17.2,9.3,8.0,23,CL
0d4fd3a0,6,540,6.0,6,6,0,0,7,21,-14,6.4,9.6,-3.3,23,CL
0d82903c,4,239,2.7,2,1,2,1,5,5,0,4.2,4.5,-0.4,23,CL
0d9b2d31,5,401,4.5,5,3,0,1,8,9,-1,7.2,6.1,1.1,23,CL
0db169ae,12,1051,11.7,12,10,0,0,14,11,3,15.9,14.5,1.4,23,CL
0df2b165,5,450,5.0,5,5,0,0,1,19,-18,3.1,12.5,-9.4,23,CL
0e6bc38c,7,435,4.8,5,0,2,2,8,3,5,8.4,4.4,3.9,23,CL
0f41e2ee,2,107,1.2,1,1,1,2,1,3,-2,1.8,1.6,0.2,23,CL
0fdcef0e,5,129,1.4,1,1,4,8,2,3,-1,2.7,1.8,0.9,23,CL
10549b49,2,7,0.1,0,0,2,1,0,0,0,0.2,0.0,0.2,23,CL
10745192,2,39,0.4,0,0,2,0,0,0,0,0.4,0.4,-0.1,23,CL
116c35df,6,248,2.8,2,1,4,1,3,4,-1,2.4,3.7,-1.3,23,CL
119b9a8e,4,292,3.2,3,2,1,6,8,2,6,7.8,2.3,5.5,23,CL
121101a4,6,540,6.0,6,6,0,0,4,11,-7,4.2,12.5,-8.3,23,CL
1265a93a,8,691,7.7,8,7,0,0,8,7,1,11.7,8.1,3.6,23,CL
129af0db,5,294,3.3,4,0,1,1,2,4,-2,4.1,4.4,-0.3,23,CL
12dcbdcc,3,109,1.2,2,1,1,2,2,4,-2,0.5,2.5,-2.0,23,CL
12e7ac0a,6,47,0.5,0,0,6,0,0,3,-3,0.4,1.4,-1.0,23,CL
132a82f1,5,397,4.4,5,4,0,2,3,5,-2,6.0,5.5,0.5,23,CL
1338e42b,5,201,2.2,2,1,3,5,3,4,-1,3.8,2.1,1.7,23,CL
1339039e,5,217,2.4,4,0,1,0,1,5,-4,4.0,5.3,-1.2,23,CL
133faa84,3,223,2.5,3,1,0,0,5,1,4,2.1,2.2,-0.1,23,CL
13d23b29,2,10,0.1,0,0,2,3,0,0,0,0.0,0.4,-0.4,23,CL
141b0bd2,4,324,3.6,4,3,0,0,4,6,-2,3.8,4.7,-0.9,23,CL
1467af0d,7,623,6.9,7,5,0,0,9,8,1,7.8,9.2,-1.5,23,CL
148af9a8,1,7,0.1,0,0,1,5,0,0,0,0.0,0.0,0.0,23,CL
14b8fcdf,1,90,1.0,1,1,0,5,0,2,-2,0.5,0.8,-0.3,23,CL
15413fa5,7,541,6.0,7,2,0,0,10,7,3,7.9,9.3,-1.3,23,CL
15ab5a2b,10,474,5.3,4,4,6,3,15,1,14,12.2,3.0,9.2,23,CL
15b287da,8,696,7.7,8,5,0,0,6,13,-7,7.4,12.0,-4.6,23,CL
15ea94de,6,95,1.1,0,0,6,0,0,2,-2,1.0,4.2,-3.2,23,CL
15f3ec41,6,461,5.1,6,0,0,0,4,7,-3,8.1,5.2,2.9,23,CL
15fd5593,5,212,2.4,2,1,3,1,3,9,-6,3.3,7.3,-4.0,23,CL
162efffd,5,256,2.8,1,1,4,1,4,5,-1,4.8,6.5,-1.7,23,CL
163bbd4a,6,361,4.0,5,0,1,0,3,19,-16,4.0,10.7,-6.6,23,CL
16ceb862,12,932,10.4,12,5,0,0,14,10,4,14.2,12.6,1.6,23,CL
17370b95,4,274,3.0,2,2,2,2,2,6,-4,3.2,3.9,-0.7,23,CL
178ae8f8,6,263,2.9,3,0,3,0,7,2,5,5.6,2.5,3.1,23,CL
1840e36d,10,900,10.0,10,10,0,0,23,11,12,17.8,14.5,3.3,23,CL
184ad240,3,111,1.2,1,1,2,3,2,3,-1,1.0,2.3,-1.3,23,CL
1880614f,6,173,1.9,1,0,5,0,3,2,1,3.9,1.6,2.4,23,CL
18b896d6,10,678,7.5,6,6,4,2,18,9,9,11.8,9.7,2.1,23,CL
18dd3219,2,180,2.0,2,2,0,4,4,6,-2,3.9,3.9,0.1,23,CL
1971591f,2,152,1.7,2,0,0,0,2,5,-3,2.3,3.0,-0.7,23,CL
19a967ab,6,293,3.3,3,2,3,0,2,2,0,3.8,5.0,-1.1,23,CL
19cae58d,5,329,3.7,4,1,1,1,6,7,-1,6.1,5.1,1.0,23,CL
19cda00b,3,146,1.6,2,1,1,0,3,2,1,2.9,2.8,0.2,23,CL
1a799243,6,375,4.2,4,3,2,0,4,4,0,5.3,3.7,1.6,23,CL
1a992676,3,32,0.4,0,0,3,2,0,0,0,0.7,0.5,0.2,23,CL
1adcf39e,6,540,6.0,6,6,0,0,8,10,-2,3.7,10.9,-7.1,23,CL
1b82f8df,6,450,5.0,5,4,1,0,1,12,-11,4.2,10.3,-6.1,23,CL
1bacc518,4,237,2.6,2,2,2,1,7,5,2,4.3,4.3,0.0,23,CL
1bf33a9a,5,113,1.3,1,0,4,4,2,1,1,3.2,1.8,1.3,23,CL
1cb49278,3,216,2.4,3,1,0,0,5,4,1,4.3,2.6,1.7,23,CL
1daec722,8,414,4.6,4,3,4,2,5,4,1,7.5,4.1,3.4,23,CL
1e1378e1,5,398,4.4,5,2,0,0,3,7,-4,6.4,5.4,0.9,23,CL
1e4319ac,1,28,0.3,0,0,1,1,0,1,-1,0.2,0.3,-0.1,23,CL
1f3afdcb,5,428,4.8,5,4,0,1,4,6,-2,7.4,6.3,1.1,23,CL
1f44ac21,11,841,9.3,11,4,0,1,24,4,20,18.2,8.7,9.5,23,CL
1f994616,2,155,1.7,1,1,1,4,0,4,-4,0.3,4.4,-4.1,23,CL
1fbbfbde,5,394,4.4,5,4,0,0,7,5,2,3.1,6.1,-3.1,23,CL
20030c06,8,720,8.0,8,8,0,0,14,17,-3,11.7,12.4,-0.8,23,CL
20730eae,11,907,10.1,11,4,0,0,14,8,6,14.1,11.2,2.9,23,CL
20b9f052,6,540,6.0,6,6,0,0,8,8,0,8.6,5.1,3.5,23,CL
213f0daf,4,192,2.1,2,1,2,2,0,2,-2,1.3,2.3,-1.1,23,CL
2146785a,6,497,5.5,6,4,0,2,6,6,0,7.2,8.0,-0.8,23,CL
2180c761,1,45,0.5,0,0,1,6,0,2,-2,0.4,1.5,-1.1,23,CL
21a66f6a,8,720,8.0,8,8,0,0,8,7,1,10.0,8.8,1.2,23,CL
230a2fac,10,888,9.9,10,8,0,0,26,8,18,24.8,12.8,12.0,23,CL
23610943,6,467,5.2,6,4,0,0,3,6,-3,8.8,7.2,1.6,23,CL
23a10591,1,45,0.5,1,0,0,3,0,3,-3,0.0,2.2,-2.2,23,CL
24051310,8,585,6.5,7,3,1,0,12,6,6,12.8,8.1,4.8,23,CL
24228180,6,490,5.4,6,2,0,0,4,9,-5,3.7,9.8,-6.1,23,CL
2475dcc6,5,432,4.8,5,4,0,0,9,11,-2,6.7,8.2,-1.5,23,CL
25146df0,6,540,6.0,6,6,0,0,5,9,-4,8.3,6.9,1.4,23,CL
25b74470,6,408,4.5,5,2,1,0,3,9,-6,3.3,10.0,-6.7,23,CL
262e5a82,9,404,4.5,4,2,5,1,11,5,6,8.2,4.2,4.0,23,CL
2784f898,9,747,8.3,9,7,0,0,20,11,9,17.9,12.9,5.1,23,CL
27d0a506,6,430,4.800000000000001,4,4,2,1,7,3,4,3.5,6.4,-2.9,23,CL
28b1f3ce,7,526,5.8,6,2,1,0,11,3,8,12.2,6.9,5.3,23,CL
28c6e925,6,540,6.0,6,6,0,0,5,9,-4,8.3,6.9,1.4,23,CL
28d596a0,9,810,9.0,9,9,0,0,10,8,2,13.5,9.8,3.7,23,CL
292a652a,2,6,0.1,0,0,2,4,0,0,0,0.0,0.4,-0.4,23,CL
2946f9a1,8,440,4.9,4,3,4,4,10,4,6,7.1,3.3,3.9,23,CL
29b7b767,5,134,1.5,1,0,4,1,0,5,-5,0.8,3.3,-2.6,23,CL
29c91632,6,492,5.5,6,3,0,1,7,9,-2,6.0,12.3,-6.3,23,CL
29fbdc88,6,524,5.8,6,4,0,0,4,11,-7,3.9,12.0,-8.1,23,CL
2a0c8ba4,6,260,2.9,2,1,4,0,4,9,-5,3.3,6.5,-3.2,23,CL
2a9f6b4d,8,511,5.7,6,1,2,0,7,7,0,5.9,10.6,-4.8,23,CL
2b0852db,6,495,5.5,6,5,0,0,4,8,-4,8.0,6.4,1.7,23,CL
2b114be3,8,552,6.1,7,1,1,0,14,5,9,12.1,8.0,4.0,23,CL
2b622f01,3,175,1.9,2,0,1,2,2,3,-1,2.1,2.4,-0.4,23,CL
2bed3eab,4,225,2.5,2,2,2,1,3,5,-2,3.2,2.8,0.5,23,CL
2bef2bca,1,90,1.0,1,1,0,1,0,2,-2,2.0,1.7,0.3,23,CL
2c0558b8,9,528,5.9,7,0,2,0,10,2,8,9.3,6.9,2.4,23,CL
2c0f8e9e,5,418,4.6,5,4,0,0,8,6,2,7.5,3.0,4.5,23,CL
2ccd89a3,4,109,1.2,1,0,3,1,1,0,1,1.5,1.6,-0.1,23,CL
2d65a822,1,2,0.0,0,0,1,1,0,0,0,0.0,0.2,-0.2,23,CL
2d970560,11,426,4.7,3,3,8,1,7,8,-1,8.4,6.3,2.1,23,CL
2dce876a,5,450,5.0,5,5,0,1,3,12,-9,4.4,9.1,-4.8,23,CL
2e4f5f03,5,378,4.2,4,2,1,1,10,10,0,5.9,8.8,-2.9,23,CL
2ef08833,1,24,0.3,0,0,1,2,1,0,1,0.4,0.3,0.1,23,CL
2ef7c612,6,234,2.6,3,0,3,5,5,4,1,3.8,3.2,0.6,23,CL
2f33776f,1,8,0.1,0,0,1,7,0,0,0,0.0,0.2,-0.2,23,CL
2f90f6b8,8,242,2.7,3,0,5,0,4,4,0,2.0,5.6,-3.6,23,CL
3061e1ec,2,180,2.0,2,2,0,10,3,2,1,4.5,1.3,3.2,23,CL
307877be,6,481,5.3,6,0,0,0,6,17,-11,4.7,8.1,-3.4,23,CL
30d75bfb,6,540,6.0,6,6,0,0,4,15,-11,9.2,10.9,-1.7,23,CL
30f5ffa9,8,536,6.0,6,4,2,1,10,5,5,9.0,8.0,1.0,23,CL
316de854,6,507,5.6,6,3,0,0,1,18,-17,3.0,13.2,-10.2,23,CL
31c69ef1,12,1049,11.7,11,11,1,1,30,4,26,24.5,9.7,14.9,23,CL
3235182a,5,364,4.0,4,3,1,0,4,15,-11,3.2,10.2,-7.0,23,CL
3260690c,6,330,3.7,3,1,3,0,2,4,-2,4.6,3.1,1.5,23,CL
32e8417f,4,109,1.2,1,0,3,3,3,5,-2,2.8,1.9,0.9,23,CL
32feb0cf,1,11,0.1,0,0,1,3,0,0,0,0.4,0.1,0.3,23,CL
33144cc5,5,97,1.1,0,0,5,1,1,7,-6,2.0,2.8,-0.8,23,CL
335fa267,3,206,2.3,3,1,0,0,4,4,0,3.9,1.5,2.4,23,CL
33651873,6,540,6.0,6,6,0,0,8,9,-1,3.8,9.8,-6.0,23,CL
3376a776,1,90,1.0,1,1,0,3,1,3,-2,0.4,2.0,-1.6,23,CL
33887998,1,90,1.0,1,1,0,6,2,1,1,2.7,0.9,1.8,23,CL
3392603d,6,540,6.0,6,6,0,0,11,16,-5,8.3,12.2,-3.9,23,CL
33a6a650,6,540,6.0,6,6,0,0,4,11,-7,4.2,12.5,-8.3,23,CL
33b8d077,9,549,6.1,5,4,4,0,9,6,3,8.6,7.5,1.0,23,CL
3423f250,5,294,3.3,4,0,1,1,5,8,-3,5.8,5.3,0.6,23,CL
343c0d52,7,263,2.9,2,1,5,1,7,2,5,7.3,3.6,3.7,23,CL
34693494,5,212,2.4,3,0,2,1,4,6,-2,3.2,4.3,-1.0,23,CL
34e12499,8,561,6.2,6,6,2,0,9,6,3,9.5,10.2,-0.7,23,CL
34e4343c,7,339,3.8,4,1,3,1,5,2,3,4.0,4.0,0.0,23,CL
353eb529,1,9,0.1,0,0,1,4,2,0,2,0.4,0.0,0.4,23,CL
35d64857,7,599,6.7,7,6,0,0,4,12,-8,6.5,11.3,-4.8,23,CL
366be751,2,108,1.2,1,0,1,4,1,2,-1,2.1,0.6,1.5,23,CL
36a3ff67,3,262,2.9,3,1,0,1,4,4,0,3.7,3.3,0.4,23,CL
374d5158,4,226,2.5,2,2,2,1,5,4,1,2.3,4.0,-1.7,23,CL
37557ec4,5,91,1.0,0,0,5,1,2,3,-1,1.0,3.2,-2.1,23,CL
37d39918,5,450,5.0,5,5,0,0,6,15,-9,4.7,8.2,-3.5,23,CL
37dc1a48,7,508,5.6,7,1,0,0,5,9,-4,4.9,9.2,-4.3,23,CL
384d58d9,2,74,0.8,1,0,1,8,2,1,1,1.2,1.0,0.2,23,CL
38c7feef,1,18,0.2,0,0,1,1,0,1,-1,0.0,0.8,-0.7,23,CL
38f8ce7f,2,83,0.9,1,0,1,2,1,3,-2,1.4,1.8,-0.4,23,CL
392a7aea,8,703,7.8,8,7,0,0,7,10,-3,7.8,16.8,-9.0,23,CL
3935e52e,4,151,1.7,1,0,3,0,0,4,-4,1.9,2.0,-0.1,23,CL
395451fc,6,330,3.7,3,0,3,0,1,10,-9,6.3,7.7,-1.5,23,CL
3aca6420,6,520,5.8,6,4,0,0,3,11,-8,4.8,13.7,-9.0,23,CL
3b0108d6,1,90,1.0,1,1,0,4,0,4,-4,0.1,2.1,-2.0,23,CL
3b029691,8,584,6.5,7,1,1,0,14,8,6,8.6,7.9,0.7,23,CL
3b12b11f,2,12,0.1,0,0,2,4,0,0,0,0.4,0.2,0.2,23,CL
3b387cc7,3,31,0.3,0,0,3,7,3,0,3,1.7,0.2,1.5,23,CL
3b61c9ec,4,201,2.2,1,1,3,0,2,4,-2,1.9,1.7,0.2,23,CL
3b8674e6,6,503,5.6,6,3,0,0,7,5,2,8.0,4.6,3.4,23,CL
3bb7b8b4,11,990,11.0,11,11,0,2,29,4,25,23.3,9.0,14.3,23,CL
3bb7f478,13,824,9.2,11,1,2,0,12,5,7,10.8,10.4,0.4,23,CL
3c6089ab,8,367,4.1,4,2,4,0,10,0,10,8.3,4.7,3.5,23,CL
3cd7820a,6,315,3.5,3,2,3,0,3,7,-4,4.1,4.6,-0.4,23,CL
3ce20eda,5,450,5.0,5,5,0,2,10,6,4,9.2,8.5,0.7,23,CL
3cefcaef,5,347,3.9,4,3,1,3,11,3,8,9.9,4.7,5.1,23,CL
3d50bcdb,5,111,1.2,1,0,4,0,2,4,-2,2.7,3.6,-0.9,23,CL
3e9bd29d,4,360,4.0,4,4,0,2,3,8,-5,2.4,8.0,-5.6,23,CL
3eb22ec9,13,911,10.1,9,8,4,0,30,3,27,22.2,8.2,14.0,23,CL
3effaa34,8,533,5.9,6,3,2,0,12,9,3,9.2,5.4,3.8,23,CL
3f034750,1,90,1.0,1,1,0,5,0,2,-2,0.9,1.8,-0.8,23,CL
3f10bd22,3,224,2.5,3,1,0,3,1,8,-7,2.3,5.5,-3.2,23,CL
407feb71,10,602,6.7,8,0,2,2,6,6,0,8.3,6.5,1.8,23,CL
40d08dcd,3,211,2.3,2,2,1,0,2,6,-4,2.9,3.3,-0.4,23,CL
40f65c01,6,237,2.6,3,0,3,0,4,6,-2,3.7,3.4,0.3,23,CL
41034650,6,529,5.9,6,5,0,0,11,15,-4,8.3,11.7,-3.4,23,CL
415568b5,6,484,5.4,6,3,0,0,6,10,-4,2.8,9.7,-6.9,23,CL
41c12f75,8,514,5.7,5,4,3,2,19,7,12,16.6,7.8,8.8,23,CL
41eebdf5,5,249,2.8,2,0,3,0,3,5,-2,3.3,2.7,0.6,23,CL
41f0b196,6,540,6.0,6,6,0,0,8,10,-2,3.7,10.9,-7.1,23,CL
41f32541,1,90,1.0,1,1,0,1,0,0,0,0.8,0.7,0.1,23,CL
420c18a1,4,360,4.0,4,4,0,0,4,4,0,6.2,5.0,1.1,23,CL
4288f249,3,121,1.3,0,0,3,3,2,1,1,0.6,2.5,-1.9,23,CL
42fd9c7f,8,651,7.2,7,5,1,0,15,9,6,10.1,9.4,0.7,23,CL
433dc9a2,5,275,3.1,3,1,2,3,9,5,4,4.5,4.5,0.0,23,CL
43a166b4,8,154,1.7,0,0,8,3,0,1,-1,2.2,2.2,-0.1,23,CL
441197b8,8,720,8.0,8,8,0,0,7,13,-6,8.0,12.9,-4.9,23,CL
44781702,7,392,4.4,4,3,3,1,5,4,1,3.7,4.7,-1.0,23,CL
44eb9093,6,161,1.8,1,1,5,6,1,4,-3,2.1,4.4,-2.2,23,CL
4535e4bb,2,180,2.0,2,2,0,3,0,3,-3,1.2,3.1,-1.9,23,CL
4567a0b4,5,129,1.4,0,0,5,5,9,0,9,2.5,0.8,1.6,23,CL
45736cec,1,6,0.1,0,0,1,1,1,0,1,0.5,0.0,0.5,23,CL
45a03961,9,592,6.6,7,4,2,0,10,6,4,11.4,8.0,3.4,23,CL
45af8a54,12,324,3.6,2,2,10,0,11,6,5,8.7,6.3,2.4,23,CL
45b9b619,9,304,3.4,3,0,6,2,6,4,2,4.8,3.2,1.5,23,CL
45db685d,6,418,4.6,4,4,2,0,7,3,4,8.1,3.4,4.7,23,CL
4601e194,2,146,1.6,2,1,0,4,8,2,6,4.1,2.5,1.6,23,CL
46152b69,6,519,5.8,6,4,0,0,4,11,-7,3.8,11.7,-7.9,23,CL
4737cebe,3,52,0.6,0,0,3,3,0,1,-1,0.6,0.8,-0.3,23,CL
47420f02,1,10,0.1,0,0,1,5,0,0,0,0.1,0.0,0.1,23,CL
47b7e3af,5,153,1.7,1,0,4,0,0,7,-7,3.7,4.9,-1.2,23,CL
481c9ece,12,885,9.8,10,7,2,1,18,9,9,15.4,10.7,4.7,23,CL
48b3dd60,1,14,0.2,0,0,1,1,0,0,0,0.1,0.3,-0.2,23,CL
49296448,9,810,9.0,9,9,0,0,17,6,11,16.9,10.4,6.5,23,CL
4958bfb2,11,869,9.7,10,6,1,1,23,8,15,19.4,13.1,6.4,23,CL
49fe9070,8,500,5.6,7,2,1,0,8,12,-4,7.7,10.5,-2.8,23,CL
4a1a9578,3,269,3.0,3,2,0,0,5,5,0,6.1,4.7,1.4,23,CL
4a56052c,6,485,5.4,6,2,0,0,7,7,0,6.4,4.7,1.7,23,CL
4a5839fa,4,360,4.0,4,4,0,4,9,1,8,9.5,5.0,4.5,23,CL
4ab12002,4,57,0.6,0,0,4,4,2,1,1,1.5,0.8,0.7,23,CL
4b3e1a38,7,613,6.8,7,6,0,0,18,4,14,18.5,8.2,10.3,23,CL
4b803b3c,3,165,1.8,2,0,1,1,1,5,-4,3.0,3.3,-0.2,23,CL
4c184730,5,116,1.3,1,0,4,1,1,6,-5,1.7,4.4,-2.7,23,CL
4c2a5d34,7,611,6.8,7,4,0,0,11,1,10,13.3,7.4,5.9,23,CL
4c370d81,8,417,4.6,4,1,4,0,9,7,2,6.5,7.7,-1.2,23,CL
4c62d0c8,2,180,2.0,2,2,0,4,2,4,-2,1.8,3.9,-2.1,23,CL
4c6facae,8,720,8.0,8,8,0,0,7,13,-6,8.0,12.9,-4.9,23,CL
4d1666ff,3,246,2.7,3,2,0,0,5,5,0,4.6,4.0,0.6,23,CL
4d1c4a5d,4,39,0.4,0,0,4,3,0,2,-2,0.3,1.3,-1.1,23,CL
4d77b365,8,399,4.4,5,0,3,0,13,5,8,10.7,4.2,6.4,23,CL
4da9191b,4,127,1.4,1,0,3,0,1,6,-5,2.0,3.6,-1.6,23,CL
4dbd0916,2,104,1.2,1,0,1,1,2,1,1,1.6,2.1,-0.5,23,CL
4e219ad2,6,237,2.6,3,0,3,0,1,8,-7,2.0,4.2,-2.2,23,CL
4f1e6a0b,9,444,4.9,4,0,5,0,14,7,7,8.4,5.5,2.9,23,CL
4f255115,10,432,4.8,5,2,5,0,9,6,3,9.1,5.9,3.2,23,CL
4f28a6ff,7,508,5.6,6,3,1,1,5,4,1,7.4,6.8,0.6,23,CL
4f565d77,3,41,0.5,0,0,3,6,2,0,2,0.8,0.1,0.7,23,CL
4fb9c88f,2,100,1.1,1,0,1,2,0,0,0,0.6,0.7,-0.1,23,CL
501055d8,6,376,4.2,5,1,1,0,6,3,3,6.2,7.2,-1.0,23,CL
505486d6,6,483,5.4,5,5,1,0,0,11,-11,3.6,10.4,-6.8,23,CL
50871bcc,5,200,2.2,3,0,2,1,1,1,0,2.6,3.2,-0.6,23,CL
51a3c4c8,1,90,1.0,1,1,0,2,0,2,-2,0.9,1.8,-0.8,23,CL
51a56075,6,495,5.5,5,5,1,0,5,20,-15,5.1,13.2,-8.1,23,CL
5219ab4a,6,410,4.6,6,1,0,0,7,5,2,5.2,4.0,1.3,23,CL
52ec54d0,6,444,4.9,5,4,1,0,5,13,-8,5.9,8.5,-2.6,23,CL
53070b63,2,49,0.5,0,0,2,3,0,1,-1,0.8,2.1,-1.3,23,CL
536cebe5,7,249,2.8,2,2,5,3,8,0,8,5.7,3.0,2.7,23,CL
53cad200,5,260,2.9,3,1,2,4,3,3,0,4.1,2.1,2.0,23,CL
5458f670,1,3,0.0,0,0,1,5,0,0,0,0.0,0.0,0.0,23,CL
54b4dc4e,5,268,3.0,2,2,3,0,2,4,-2,4.6,3.9,0.7,23,CL
55126f3b,4,329,3.7,4,3,0,0,2,5,-3,4.9,5.5,-0.6,23,CL
5515376c,6,439,4.9,4,4,2,4,8,5,3,8.9,5.4,3.6,23,CL
5521f419,6,275,3.1,3,0,3,0,2,3,-1,4.1,2.9,1.3,23,CL
555d5edd,5,123,1.4,1,1,4,1,2,3,-1,1.7,3.4,-1.7,23,CL
555f3a0b,3,158,1.8,2,1,1,3,3,5,-2,2.1,3.8,-1.8,23,CL
55a1cac2,8,163,1.8,0,0,8,4,2,0,2,2.1,1.1,1.0,23,CL
55abe554,3,158,1.8,2,1,1,1,0,5,-5,0.9,5.9,-5.0,23,CL
56413b1f,4,215,2.4,3,1,1,0,0,5,-5,4.3,2.4,1.9,23,CL
56f6f826,4,314,3.5,4,3,0,0,1,10,-9,2.3,8.8,-6.4,23,CL
57760e66,6,352,3.9,6,0,0,0,6,5,1,2.3,5.3,-3.1,23,CL
577efaec,7,594,6.6,7,4,0,1,12,7,5,12.6,9.2,3.4,23,CL
57d88cf9,7,630,7.0,7,7,0,1,10,6,4,9.3,9.6,-0.4,23,CL
5853ac44,2,180,2.0,2,2,0,2,1,5,-4,1.1,4.0,-2.9,23,CL
58ae47b2,2,77,0.9,1,0,1,4,0,1,-1,0.6,0.6,0.1,23,CL
58c6b67c,2,8,0.1,0,0,2,4,0,1,-1,0.0,0.4,-0.4,23,CL
58f077c0,6,540,6.0,6,6,0,0,4,11,-7,4.2,12.5,-8.3,23,CL
5976f83e,4,191,2.1,1,1,3,0,0,3,-3,1.2,2.3,-1.1,23,CL
5ab0ea87,4,289,3.2,4,1,0,1,1,7,-6,4.1,4.3,-0.2,23,CL
5ad50391,6,540,6.0,6,6,0,2,13,11,2,9.6,10.6,-1.0,23,CL
5b3d1a7a,8,563,6.3,7,1,1,0,11,3,8,12.5,6.8,5.7,23,CL
5b92d896,4,62,0.7,0,0,4,4,2,1,1,1.0,0.9,0.1,23,CL
5c4dc0ff,1,6,0.1,0,0,1,9,1,0,1,0.1,0.1,0.0,23,CL
5c899683,1,90,1.0,1,1,0,6,1,1,0,1.2,1.8,-0.6,23,CL
5ccc9672,4,171,1.9,1,1,3,2,3,5,-2,1.7,4.0,-2.2,23,CL
5cdddffa,9,373,4.1,3,1,6,1,10,3,7,8.8,5.7,3.1,23,CL
5cfec13d,1,90,1.0,1,1,0,0,1,5,-4,2.1,3.8,-1.8,23,CL
5d4f7d61,5,446,5.0,5,3,0,1,2,6,-4,7.5,4.9,2.6,23,CL
5db20508,2,15,0.2,0,0,2,3,0,0,0,0.1,0.1,0.0,23,CL
5dfc6ad5,6,462,5.1,5,5,1,0,5,9,-4,8.1,9.3,-1.2,23,CL
5e861944,9,403,4.5,6,0,3,1,11,2,9,13.1,6.0,7.1,23,CL
5ea8ef20,6,418,4.6,5,3,1,0,8,7,1,7.4,4.4,3.0,23,CL
5eae500a,8,185,2.1,0,0,8,0,5,3,2,5.2,2.8,2.4,23,CL
5eaf85b5,2,6,0.1,0,0,2,4,1,0,1,0.1,0.1,0.1,23,CL
5ed9b537,3,258,2.9,3,2,0,2,6,2,4,4.8,3.1,1.7,23,CL
5eecec3d,8,684,7.6,8,6,0,1,18,3,15,13.7,7.6,6.1,23,CL
5ef3d210,3,17,0.2,0,0,3,2,1,1,0,0.6,1.6,-1.0,23,CL
5fd5ed86,3,270,3.0,3,3,0,1,5,5,0,4.2,5.9,-1.8,23,CL
5ff4ab71,9,759,8.4,9,5,0,0,12,10,2,14.7,10.2,4.4,23,CL
6025fab1,10,743,8.3,9,1,1,1,20,5,15,14.8,10.5,4.3,23,CL
61f63784,6,512,5.7,6,5,0,0,5,24,-19,5.4,14.6,-9.2,23,CL
62182b1d,4,360,4.0,4,4,0,0,1,9,-8,3.6,8.1,-4.5,23,CL
6250083a,4,211,2.3,2,2,2,4,1,2,-1,1.9,3.9,-2.0,23,CL
6434f10d,12,995,11.1,11,9,1,1,25,4,21,20.6,9.8,10.8,23,CL
64b08de7,1,9,0.1,0,0,1,4,0,0,0,0.0,0.3,-0.3,23,CL
65d62814,5,382,4.2,5,4,0,0,8,5,3,3.4,5.4,-2.0,23,CL
6622454d,4,148,1.6,1,1,3,5,0,1,-1,3.3,1.7,1.6,23,CL
663e080e,6,528,5.9,5,5,1,2,13,11,2,9.5,10.5,-1.0,23,CL
6747869d,2,20,0.2,0,0,2,1,0,1,-1,0.4,0.3,0.1,23,CL
67b09a18,1,11,0.1,0,0,1,5,0,1,-1,0.4,0.2,0.2,23,CL
6800f515,3,216,2.4,3,2,0,0,1,5,-4,3.3,2.5,0.8,23,CL
6885cc44,3,270,3.0,3,3,0,0,3,2,1,3.9,2.7,1.2,23,CL
688fcea2,6,167,1.9,1,0,5,0,1,4,-3,1.4,4.8,-3.4,23,CL
690d1049,3,269,3.0,3,2,0,2,0,5,-5,1.4,6.7,-5.3,23,CL
691bef82,5,407,4.5,5,3,0,1,8,15,-7,6.1,10.3,-4.2,23,CL
6928979a,12,991,11.0,12,6,0,1,17,5,12,15.4,10.8,4.6,23,CL
69384e5d,6,539,6.0,6,5,0,0,14,7,7,9.0,6.8,2.3,23,CL
6aa3e78b,3,155,1.7,2,1,1,3,3,3,0,3.1,2.0,1.2,23,CL
6b994195,1,75,0.8,1,0,0,5,0,1,-1,0.5,1.8,-1.3,23,CL
6b9960cf,3,83,0.9,1,0,2,4,1,2,-1,0.8,1.2,-0.4,23,CL
6bb2c084,8,650,7.2,8,5,0,1,20,6,14,17.9,8.8,9.1,23,CL
6bc49da7,3,47,0.5,0,0,3,3,1,3,-2,1.3,1.9,-0.6,23,CL
6c203af0,3,92,1.0,0,0,3,3,2,2,0,1.6,1.8,-0.2,23,CL
6caffe81,1,3,0.0,0,0,1,0,0,0,0,0.0,0.0,0.0,23,CL
6ce1f46f,12,842,9.4,10,4,2,0,18,8,10,16.8,11.0,5.7,23,CL
6ce43701,6,242,2.7,2,0,4,0,5,1,4,4.5,3.9,0.6,23,CL
6db16dda,6,180,2.0,1,1,5,0,2,5,-3,1.2,4.8,-3.6,23,CL
6e058f06,7,250,2.8,3,0,4,1,13,3,10,7.0,3.9,3.1,23,CL
6e4df551,5,246,2.7,3,0,2,1,2,4,-2,1.7,4.6,-2.9,23,CL
6f1d7aa8,1,3,0.0,0,0,1,1,0,0,0,0.0,0.0,0.0,23,CL
6f3cc2fe,8,513,5.7,6,0,2,0,9,2,7,11.4,6.3,5.0,23,CL
6f51e382,5,450,5.0,5,5,0,1,8,10,-2,7.6,6.8,0.8,23,CL
6f639ec7,2,81,0.9,2,0,0,0,0,7,-7,0.5,2.6,-2.1,23,CL
6fe90922,7,572,6.4,7,5,0,1,5,5,0,6.5,6.4,0.1,23,CL
6fee9966,2,5,0.1,0,0,2,6,0,1,-1,0.0,0.5,-0.5,23,CL
707b98f1,1,15,0.2,0,0,1,6,0,0,0,0.3,0.2,0.0,23,CL
70cf63ca,10,819,9.1,10,3,0,0,21,13,8,17.1,10.3,6.8,23,CL
70d74ece,10,744,8.3,9,5,1,0,14,10,4,12.9,10.0,2.9,23,CL
71031a25,6,540,6.0,6,6,0,0,7,21,-14,6.4,9.6,-3.3,23,CL
7111d552,12,972,10.8,11,7,1,0,24,11,13,20.8,14.6,6.2,23,CL
712dd708,6,465,5.2,5,5,1,0,2,20,-18,4.4,12.8,-8.4,23,CL
713c144a,6,462,5.1,6,1,0,0,10,13,-3,7.4,8.2,-0.7,23,CL
7155e3e1,3,37,0.4,0,0,3,1,1,0,1,1.5,0.2,1.3,23,CL
733e7ad8,1,17,0.2,0,0,1,1,1,1,0,0.2,0.1,0.1,23,CL
736157b7,5,431,4.8,5,3,0,0,3,20,-17,2.9,12.7,-9.7,23,CL
73b9fa8a,3,39,0.4,0,0,3,3,0,0,0,0.6,1.4,-0.8,23,CL
74b7375f,7,591,6.6,7,3,0,0,7,5,2,6.4,12.3,-5.9,23,CL
74f2e748,5,374,4.2,4,2,1,0,4,5,-1,5.7,4.6,1.1,23,CL
751a0fb5,7,567,6.3,6,4,1,0,8,9,-1,6.9,14.2,-7.3,23,CL
75b86fb3,12,983,10.9,12,5,0,1,17,6,11,14.5,11.1,3.4,23,CL
75c2e240,6,540,6.0,6,6,0,0,7,21,-14,6.4,9.6,-3.3,23,CL
762179d9,3,189,2.1,2,1,1,0,0,3,-3,1.5,3.2,-1.7,23,CL
7713c72a,6,540,6.0,6,6,0,0,8,10,-2,3.7,10.9,-7.1,23,CL
77e39b04,6,386,4.3,5,1,1,0,4,7,-3,2.1,6.4,-4.3,23,CL
77e84962,5,306,3.4,3,0,2,0,9,1,8,7.6,1.3,6.2,23,CL
78f21137,8,654,7.3,8,5,0,0,21,7,14,14.7,7.8,6.9,23,CL
78f85621,6,448,5.0,6,0,0,0,3,12,-9,6.9,9.1,-2.1,23,CL
79083382,3,205,2.3,2,2,1,7,5,3,2,5.4,3.7,1.7,23,CL
79443529,5,411,4.6,5,3,0,0,5,10,-5,5.6,7.6,-2.0,23,CL
79c0821a,8,621,6.9,8,3,0,1,10,7,3,10.4,7.6,2.8,23,CL
7a11550b,5,298,3.3,4,2,1,3,12,9,3,6.3,6.4,-0.1,23,CL
7a20d90a,3,270,3.0,3,3,0,4,2,2,0,6.0,2.9,3.2,23,CL
7a2e46a8,8,720,8.0,8,8,0,0,19,12,7,14.7,10.6,4.1,23,CL
7b4c1f6e,3,73,0.8,1,0,2,3,1,2,-1,1.2,2.2,-1.1,23,CL
7b5ab7f2,4,40,0.4,0,0,4,2,2,1,1,2.2,0.9,1.3,23,CL
7b9c2d84,11,721,8.0,8,5,3,1,14,9,5,13.0,10.9,2.1,23,CL
7be09c86,1,21,0.2,0,0,1,5,0,0,0,0.2,1.5,-1.3,23,CL
7c3ed041,6,491,5.5,5,5,1,0,8,8,0,8.5,4.7,3.8,23,CL
7c473e12,3,136,1.5,1,1,2,3,1,0,1,1.8,1.5,0.3,23,CL
7c56da38,7,562,6.2,6,5,1,0,14,9,5,10.6,7.5,3.1,23,CL
7d3e7da6,3,270,3.0,3,3,0,7,9,2,7,6.6,2.7,3.9,23,CL
7d450ed3,8,531,5.9,6,3,2,0,11,14,-3,9.0,9.7,-0.7,23,CL
7e56d3db,5,370,4.1,5,1,0,0,4,9,-5,2.7,6.6,-3.9,23,CL
7ed08d5c,8,349,3.9,3,3,5,2,12,2,10,9.1,3.3,5.8,23,CL
7edfbb8a,10,827,9.2,10,9,0,0,10,9,1,11.2,11.2,-0.1,23,CL
7f3b388c,8,632,7.0,7,6,1,0,17,12,5,12.1,10.2,1.9,23,CL
7fa4e703,6,383,4.3,3,0,3,1,5,3,2,5.2,5.3,-0.1,23,CL
81442ecb,4,219,2.4,3,1,1,1,4,5,-1,1.9,5.1,-3.3,23,CL
817c6964,11,823,9.1,9,7,2,0,8,9,-1,12.0,12.2,-0.2,23,CL
819b3158,13,994,11.0,12,8,1,0,23,5,18,21.7,9.8,11.9,23,CL
826e8b63,2,113,1.3,1,0,1,0,0,2,-2,0.6,2.7,-2.1,23,CL
829aa60c,5,145,1.6,0,0,5,5,3,2,1,4.2,1.6,2.6,23,CL
82a39b66,5,270,3.0,4,0,1,1,2,4,-2,4.3,6.1,-1.8,23,CL
82c615f8,6,374,4.2,3,2,3,0,1,17,-16,2.9,10.8,-7.9,23,CL
82e12fe7,6,204,2.3,2,0,4,0,2,5,-3,3.9,3.6,0.3,23,CL
83300259,2,76,0.8,1,0,1,2,2,0,2,1.1,0.2,0.9,23,CL
834d0be5,2,20,0.2,0,0,2,6,0,1,-1,0.4,0.4,0.0,23,CL
8454388c,6,424,4.7,5,3,1,0,2,21,-19,3.1,12.1,-9.1,23,CL
85613cf0,5,338,3.8,3,1,2,1,5,8,-3,4.0,6.0,-2.0,23,CL
85f7d1be,10,751,8.3,8,7,2,2,12,8,4,12.2,8.6,3.6,23,CL
862fa9fb,5,428,4.8,5,2,0,0,0,10,-10,3.0,9.7,-6.7,23,CL
86dd77d1,5,282,3.1,3,3,2,2,6,2,4,4.5,2.7,1.8,23,CL
86df4d6b,1,21,0.2,0,0,1,6,0,0,0,0.9,0.2,0.6,23,CL
86e7deaf,8,640,7.1,7,6,1,0,8,7,1,12.0,8.3,3.7,23,CL
8778c910,3,270,3.0,3,3,0,0,9,0,9,6.6,3.2,3.4,23,CL
8794e251,5,446,5.0,5,4,0,0,8,11,-3,7.7,8.0,-0.3,23,CL
881cd6be,10,859,9.5,10,8,0,0,26,12,14,18.3,9.8,8.5,23,CL
8827bf46,3,121,1.3,2,0,1,3,1,1,0,1.4,1.0,0.4,23,CL
88ce7ddc,2,98,1.1,1,0,1,4,1,3,-2,1.9,1.5,0.4,23,CL
88ced02c,4,360,4.0,4,4,0,0,2,7,-5,6.2,4.9,1.3,23,CL
88e357ef,8,343,3.8,3,2,5,1,10,3,7,6.7,4.1,2.6,23,CL
892d5bb1,9,506,5.6,6,3,3,4,13,3,10,11.6,3.9,7.7,23,CL
89ac64a6,11,945,10.5,10,10,1,1,24,4,20,20.0,8.8,11.2,23,CL
89f951b5,6,418,4.6,6,2,0,0,6,6,0,4.4,6.6,-2.3,23,CL
8aafd64f,9,461,5.1,6,1,3,1,2,5,-3,7.5,9.3,-1.8,23,CL
8b04d6c1,7,624,6.9,7,6,0,0,8,5,3,8.8,6.8,2.0,23,CL
8b3ab7ad,6,531,5.9,6,4,0,0,11,16,-5,8.3,12.2,-3.8,23,CL
8b8a56ce,6,508,5.6,6,5,0,4,11,3,8,10.4,8.1,2.3,23,CL
8b8e759d,4,278,3.1,3,3,1,3,3,2,1,6.7,2.9,3.9,23,CL
8b929ec2,1,15,0.2,0,0,1,5,0,0,0,0.0,0.5,-0.5,23,CL
8c5f1522,4,285,3.2,3,1,1,0,3,8,-5,3.9,4.8,-1.0,23,CL
8c90fd7a,6,421,4.7,5,1,1,1,10,3,7,12.9,6.3,6.6,23,CL
8ce30c57,4,50,0.6,0,0,4,1,0,0,0,0.5,1.8,-1.3,23,CL
8d3d3b0a,6,246,2.7,2,1,4,0,2,6,-4,4.4,3.5,0.9,23,CL
8d78e732,5,441,4.9,5,4,0,0,8,9,-1,7.5,6.3,1.2,23,CL
8e034340,4,290,3.2,4,2,0,2,0,8,-8,2.3,8.5,-6.2,23,CL
8e50599a,1,8,0.1,0,0,1,1,1,1,0,1.6,0.5,1.0,23,CL
8f0435c7,10,894,9.9,10,8,0,0,25,13,12,18.9,10.8,8.1,23,CL
8f056768,7,583,6.5,7,4,0,0,14,8,6,10.5,7.3,3.2,23,CL
8f5cdf66,2,63,0.7,0,0,2,3,2,2,0,0.6,2.3,-1.7,23,CL
8f5e92a6,12,819,9.1,10,2,2,0,19,12,7,16.3,13.2,3.2,23,CL
8f62b6ee,6,540,6.0,6,6,0,0,8,6,2,9.1,5.7,3.4,23,CL
8f696594,1,16,0.2,0,0,1,1,0,0,0,0.0,0.1,-0.1,23,CL
8fd9996f,7,450,5.0,5,4,2,0,5,6,-1,6.0,6.8,-0.7,23,CL
8ff2354e,4,167,1.9,2,0,2,2,2,2,0,1.5,1.5,0.0,23,CL
90339309,4,189,2.1,3,0,1,0,2,6,-4,1.2,3.9,-2.7,23,CL
90c1f9a4,3,61,0.7,1,0,2,4,1,1,0,0.4,0.7,-0.3,23,CL
92432bc6,7,339,3.8,4,0,3,1,5,8,-3,5.9,8.2,-2.3,23,CL
92e7e919,8,618,6.9,8,3,0,0,6,3,3,8.3,6.8,1.5,23,CL
92fffd91,6,308,3.4,3,0,3,0,6,14,-8,4.4,5.2,-0.8,23,CL
934e1968,8,653,7.3,8,4,0,0,12,16,-4,11.0,11.3,-0.3,23,CL
935e6b8f,4,277,3.1,4,0,0,0,10,6,4,7.3,3.2,4.1,23,CL
93fffbcf,8,720,8.0,8,8,0,0,12,8,4,15.2,11.4,3.9,23,CL
9413b19f,10,900,10.0,10,10,0,0,26,8,18,25.2,13.0,12.2,23,CL
94721522,1,90,1.0,1,1,0,4,0,3,-3,0.7,1.8,-1.1,23,CL
94b2001f,5,427,4.7,5,4,0,0,8,11,-3,6.9,9.9,-3.1,23,CL
953597a1,1,39,0.4,0,0,1,0,3,0,3,0.8,0.4,0.4,23,CL
95bb6ddc,6,239,2.7,3,0,3,0,4,3,1,3.0,2.2,0.8,23,CL
95f5aae8,8,572,6.4,6,4,2,0,7,7,0,5.7,12.4,-6.7,23,CL
9606f0b2,1,3,0.0,0,0,1,0,0,0,0,0.3,0.0,0.3,23,CL
966e28d0,4,115,1.3,1,1,3,3,8,1,7,3.2,1.0,2.3,23,CL
9674002f,9,441,4.9,5,3,4,0,8,4,4,8.0,3.7,4.3,23,CL
96e0490d,11,821,9.1,9,6,2,2,11,8,3,10.6,9.9,0.7,23,CL
970b8574,11,728,8.1,10,1,1,2,12,3,9,10.0,8.0,2.0,23,CL
97220da2,5,116,1.3,0,0,5,1,0,1,-1,2.5,0.7,1.8,23,CL
9744ff80,3,91,1.0,1,0,2,3,2,1,1,1.6,1.1,0.5,23,CL
99a8ddc9,6,540,6.0,6,6,0,0,4,11,-7,4.2,12.5,-8.3,23,CL
9a2e0ccc,8,402,4.5,4,0,4,0,7,11,-4,5.7,8.3,-2.6,23,CL
9ab16552,4,257,2.9,3,2,1,2,2,3,-1,3.2,4.6,-1.4,23,CL
9dff291c,1,19,0.2,0,0,1,7,0,0,0,0.3,0.3,-0.1,23,CL
9e1035f8,5,188,2.1,1,1,4,1,7,4,3,3.7,4.6,-0.9,23,CL
9efa1d25,7,522,5.8,6,3,1,0,6,10,-4,5.3,8.8,-3.6,23,CL
a04e47f0,1,14,0.2,0,0,1,4,0,0,0,0.1,0.5,-0.4,23,CL
a086ae11,2,18,0.2,0,0,2,4,0,0,0,0.2,0.2,0.0,23,CL
a08b974a,2,17,0.2,0,0,2,4,0,1,-1,0.1,1.6,-1.5,23,CL
a0b4bb3e,6,399,4.4,5,1,1,0,5,7,-2,4.4,7.9,-3.5,23,CL
a1232f4e,5,302,3.4,5,1,0,0,5,4,1,4.0,2.7,1.3,23,CL
a167537f,7,476,5.3,6,4,1,1,9,2,7,8.2,6.7,1.5,23,CL
a29b1131,6,519,5.8,6,3,0,0,10,15,-5,7.7,10.6,-2.9,23,CL
a2ea941d,2,22,0.2,0,0,2,4,0,3,-3,0.2,0.7,-0.6,23,CL
a30e23de,4,59,0.7,0,0,4,2,0,3,-3,0.1,1.6,-1.5,23,CL
a33a0dc0,3,32,0.4,0,0,3,3,0,0,0,0.4,0.0,0.4,23,CL
a36524bf,6,540,6.0,6,6,0,0,11,16,-5,8.3,12.2,-3.9,23,CL
a39bb753,3,132,1.5,1,0,2,8,4,2,2,3.6,2.4,1.3,23,CL
a3d94a58,7,598,6.6,7,5,0,0,4,6,-2,8.6,6.6,2.0,23,CL
a427724f,1,2,0.0,0,0,1,3,1,0,1,0.1,0.0,0.1,23,CL
a5296e55,10,619,6.9,8,1,2,0,16,8,8,17.8,11.0,6.7,23,CL
a5420709,5,244,2.7,4,0,1,1,0,11,-11,0.8,7.4,-6.7,23,CL
a62c16d0,5,236,2.6,2,1,3,1,5,3,2,1.5,3.3,-1.8,23,CL
a650c75b,5,331,3.7,5,2,0,0,5,5,0,2.3,5.3,-3.1,23,CL
a65c844b,6,540,6.0,6,6,0,0,8,8,0,8.6,5.1,3.5,23,CL
a65ce836,7,565,6.3,6,6,1,1,8,6,2,8.3,10.1,-1.8,23,CL
a69e4806,9,467,5.2,4,1,5,0,13,6,7,11.0,6.5,4.5,23,CL
a6ee4f55,6,295,3.3,5,0,1,0,4,5,-1,2.2,4.7,-2.5,23,CL
a73c8f95,5,349,3.9,4,2,1,1,4,4,0,5.4,3.6,1.8,23,CL
a793f5a8,6,480,5.3,6,1,0,0,8,7,1,3.4,8.3,-4.9,23,CL
a8567629,5,338,3.8,4,3,1,1,2,6,-4,5.6,5.3,0.3,23,CL
a8a874f1,5,222,2.5,2,1,3,0,5,7,-2,5.0,6.1,-1.1,23,CL
a8b8af8d,1,90,1.0,1,1,0,4,1,3,-2,0.9,2.2,-1.3,23,CL
a8ee54ad,8,616,6.8,7,4,1,0,7,10,-3,6.6,9.9,-3.3,23,CL
a9142dc3,3,10,0.1,0,0,3,3,0,1,-1,0.0,1.7,-1.7,23,CL
aa34ed38,5,103,1.1,0,0,5,0,1,4,-3,2.6,1.8,0.8,23,CL
ab708880,1,17,0.2,0,0,1,1,0,0,0,0.2,0.1,0.1,23,CL
abe66106,5,278,3.1,2,1,3,0,5,4,1,3.3,3.6,-0.3,23,CL
ac295d9e,2,180,2.0,2,2,0,4,3,0,3,1.8,1.8,0.0,23,CL
ac73ec79,4,111,1.2,1,0,3,3,2,1,1,2.3,1.3,1.0,23,CL
ac861941,7,617,6.9,7,6,0,0,8,6,2,8.7,7.1,1.7,23,CL
ad3389d5,6,540,6.0,6,6,0,0,4,8,-4,9.0,7.5,1.5,23,CL
ad9b2747,6,417,4.6,5,1,1,0,9,10,-1,6.1,7.7,-1.6,23,CL
adfbe1f5,5,365,4.1,5,1,0,0,6,5,1,2.6,6.2,-3.6,23,CL
adfc9123,4,258,2.9,2,2,2,2,9,5,4,5.2,5.0,0.2,23,CL
ae1159bf,6,509,5.7,5,5,1,0,8,9,-1,3.7,9.8,-6.1,23,CL
ae44e8e2,3,65,0.7,0,0,3,0,2,2,0,1.4,1.6,-0.3,23,CL
ae4e2852,3,95,1.1,1,0,2,0,1,0,1,1.9,1.1,0.8,23,CL
aed44b64,6,458,5.1,6,1,0,0,5,21,-16,5.3,13.0,-7.8,23,CL
aee634bf,5,418,4.6,5,4,0,1,7,7,0,2.7,8.4,-5.8,23,CL
aeed5c06,6,505,5.6,6,2,0,0,4,8,-4,8.6,6.1,2.5,23,CL
aef6e670,3,147,1.6,1,1,2,0,3,2,1,3.0,1.8,1.1,23,CL
b056e3da,5,450,5.0,5,5,0,0,9,5,4,7.6,6.0,1.5,23,CL
b0b4fd3e,13,933,10.4,12,7,1,0,23,5,18,21.3,8.7,12.6,23,CL
b0f7e36c,1,17,0.2,0,0,1,0,0,0,0,0.1,0.0,0.1,23,CL
b1313ec4,4,267,3.0,3,1,1,2,1,11,-10,2.2,6.1,-3.9,23,CL
b19db005,6,413,4.6,5,2,1,0,8,9,-1,7.0,6.4,0.7,23,CL
b1cd37e6,6,428,4.8,5,2,1,0,6,10,-4,6.4,7.5,-1.1,23,CL
b1f4086c,10,900,10.0,10,10,0,0,26,13,13,19.0,10.9,8.1,23,CL
b217ef29,4,243,2.7,2,2,2,1,5,2,3,5.5,1.7,3.9,23,CL
b244e804,6,361,4.0,4,1,2,0,2,18,-16,3.4,10.3,-6.9,23,CL
b35a7399,3,197,2.2,2,2,1,7,4,2,2,3.5,3.2,0.3,23,CL
b3a712de,6,482,5.4,6,3,0,0,1,11,-10,4.0,9.7,-5.8,23,CL
b3b7f5a6,1,12,0.1,0,0,1,7,0,0,0,0.4,0.0,0.3,23,CL
b400bde0,9,630,7.0,8,0,1,0,12,6,6,10.3,7.3,3.0,23,CL
b4705807,2,158,1.8,2,1,0,0,0,5,-5,1.3,5.2,-3.9,23,CL
b4ecc6b6,2,101,1.1,0,0,2,4,0,1,-1,0.3,2.4,-2.1,23,CL
b56dd813,5,405,4.5,4,4,1,3,8,5,3,7.0,6.1,0.9,23,CL
b57e066e,2,119,1.3,1,0,1,11,4,1,3,3.0,0.8,2.2,23,CL
b5b2e1ba,5,123,1.4,1,0,4,1,2,5,-3,2.4,3.3,-0.9,23,CL
b62878a5,6,448,5.0,5,2,1,0,10,11,-1,6.6,8.7,-2.0,23,CL
b74277a0,5,392,4.4,4,2,1,4,14,2,12,9.7,3.9,5.8,23,CL
b7c19c48,3,168,1.9,2,1,1,2,2,6,-4,1.5,5.4,-4.0,23,CL
b825a650,5,273,3.0,3,2,2,3,6,11,-5,4.3,6.3,-2.0,23,CL
b8e740fb,6,254,2.8,2,2,4,4,8,2,6,5.1,2.5,2.5,23,CL
b96b595c,12,921,10.2,10,10,2,1,16,7,9,16.0,10.2,5.8,23,CL
b997c3de,7,610,6.8,7,4,0,0,9,7,2,11.0,10.5,0.5,23,CL
b9beb6c5,2,170,1.9,2,1,0,1,1,2,-1,2.4,1.7,0.7,23,CL
b9e1436c,8,395,4.4,4,1,4,0,14,7,7,8.6,7.0,1.6,23,CL
b9fbae28,2,164,1.8,2,1,0,0,0,4,-4,2.4,3.9,-1.5,23,CL
ba115a40,2,143,1.6,2,0,0,0,1,2,-1,2.0,3.5,-1.5,23,CL
ba492306,1,21,0.2,0,0,1,0,2,0,2,0.9,1.0,-0.1,23,CL
bbd86530,5,225,2.5,4,0,1,1,3,7,-4,3.2,5.5,-2.3,23,CL
bbf5c11b,3,156,1.7,1,1,2,3,3,6,-3,1.2,4.9,-3.6,23,CL
bc6e544a,6,540,6.0,6,6,0,0,5,9,-4,8.3,6.9,1.4,23,CL
bcb2ccd8,3,192,2.1,3,2,0,0,1,6,-5,2.2,2.0,0.2,23,CL
bceda5ff,2,89,1.0,0,0,2,4,0,2,-2,0.8,3.1,-2.4,23,CL
bd142efb,6,481,5.3,5,5,1,0,2,6,-4,8.1,6.5,1.6,23,CL
bd6351cd,10,499,5.6,7,3,3,0,11,2,9,11.799999999999999,3.8000000000000003,7.9,23,CL
be6a794c,4,235,2.6,2,1,2,2,2,8,-6,3.1,4.9,-1.8,23,CL
be765073,6,486,5.4,6,4,0,0,2,19,-17,4.8,12.7,-7.9,23,CL
bfde3de5,6,284,3.2,3,1,3,0,1,13,-12,1.3,6.7,-5.4,23,CL
c0617e2b,7,86,1.0,0,0,7,2,3,2,1,2.1,1.2,0.9,23,CL
c066d1a5,4,113,1.3,0,0,4,2,1,1,0,3.2,0.6,2.6,23,CL
c0b3669f,7,515,5.7,7,1,0,0,6,9,-3,5.8,8.6,-2.8,23,CL
c0c7ff58,7,238,2.6,3,0,4,1,8,3,5,4.5,2.9,1.7,23,CL
c1242d4e,2,180,2.0,2,2,0,11,3,1,2,3.2,1.6,1.6,23,CL
c13ddd3e,3,44,0.5,0,0,3,3,2,0,2,1.1,1.1,0.0,23,CL
c14bc029,5,281,3.1,4,0,1,1,1,2,-1,4.3,3.6,0.7,23,CL
c16c4e3b,5,290,3.2,3,1,2,1,0,6,-6,2.1,6.1,-3.9,23,CL
c19a2df1,2,46,0.5,0,0,2,4,3,0,3,1.8,0.5,1.3,23,CL
c1b7847c,3,261,2.9,3,2,0,0,2,11,-9,2.3,6.0,-3.6,23,CL
c20bdcd7,6,511,5.7,6,5,0,0,5,7,-2,9.4,8.9,0.4,23,CL
c2111b45,1,18,0.2,0,0,1,10,0,1,-1,0.4,0.2,0.2,23,CL
c235e803,4,211,2.3,2,2,2,8,5,2,3,3.8,3.0,0.8,23,CL
c2731c10,8,301,3.3,2,0,6,2,2,2,0,5.9,3.3,2.6,23,CL
c275947b,5,363,4.0,5,2,0,0,6,7,-1,2.5,5.7,-3.3,23,CL
c2a15a27,3,29,0.3,0,0,3,1,3,1,2,0.5,0.2,0.3,23,CL
c2a30c01,1,45,0.5,0,0,1,1,2,0,2,0.8,1.1,-0.3,23,CL
c3e39f12,2,180,2.0,2,2,0,6,0,1,-1,0.9,3.1,-2.2,23,CL
c3ee18ef,2,173,1.9,2,1,0,0,4,0,4,4.2,2.7,1.4,23,CL
c50cee19,5,295,3.3,4,0,1,0,4,4,0,3.6,5.7,-2.0,23,CL
c5cbbcff,4,287,3.2,3,1,1,1,7,8,-1,4.7,6.5,-1.8,23,CL
c68da769,8,228,2.5,1,1,7,0,1,5,-4,2.8,4.8,-2.0,23,CL
c691bfe2,9,552,6.1,6,4,3,0,19,4,15,14.5,6.2,8.3,23,CL
c693347d,2,109,1.2,1,1,1,1,0,5,-5,1.0,2.8,-1.8,23,CL
c738a5ec,1,18,0.2,0,0,1,5,1,0,1,0.4,0.3,0.1,23,CL
c8829a58,5,102,1.1,1,0,4,1,1,4,-3,1.7,2.0,-0.3,23,CL
c8d1c3a5,5,269,3.0,3,2,2,0,4,8,-4,3.8,5.4,-1.6,23,CL
c9009a1f,3,260,2.9,3,2,0,2,1,12,-11,1.4,6.8,-5.4,23,CL
c906ce0f,4,360,4.0,4,4,0,0,3,7,-4,5.7,6.4,-0.7,23,CL
c967f6b8,3,122,1.4,1,1,2,5,3,1,2,1.5,1.7,-0.2,23,CL
c9817014,6,467,5.2,6,4,0,0,8,7,1,3.5,8.2,-4.7,23,CL
ca002b1a,3,44,0.5,0,0,3,1,1,1,0,0.9,2.1,-1.2,23,CL
ca607d59,6,465,5.2,6,0,0,0,5,8,-3,6.5,6.1,0.4,23,CL
ca8033cb,2,56,0.6,1,0,1,0,0,2,-2,0.1,0.7,-0.7,23,CL
cb4f24c6,6,540,6.0,6,6,0,0,4,15,-11,9.2,10.9,-1.7,23,CL
cb641b9d,4,112,1.2,1,0,3,4,1,3,-2,1.8,2.5,-0.7,23,CL
cb64672e,2,36,0.4,0,0,2,1,0,1,-1,0.8,0.4,0.3,23,CL
cc1c5035,1,90,1.0,1,1,0,5,4,2,2,2.3,2.6,-0.2,23,CL
cc83b74d,4,110,1.2,1,0,3,2,0,3,-3,1.0,2.0,-1.1,23,CL
cc86b9a3,9,606,6.7,7,4,2,1,18,4,14,13.9,6.9,7.0,23,CL
cce181df,3,225,2.5,2,2,1,3,2,3,-1,6.4,2.4,4.0,23,CL
cd0fa27b,12,804,8.9,9,3,3,0,11,7,4,10.5,11.0,-0.5,23,CL
cd1629bc,4,304,3.4,3,2,1,1,1,4,-3,3.1,5.4,-2.3,23,CL
cd1acf9d,7,625,6.9,7,5,0,0,11,11,0,11.5,10.1,1.4,23,CL
cd59b9df,4,315,3.5,4,3,0,2,3,2,1,3.5,5.3,-1.8,23,CL
ce17b5eb,8,720,8.0,8,8,0,0,7,13,-6,8.0,12.9,-4.9,23,CL
ce30bfc8,6,116,1.3,1,0,5,7,1,1,0,1.8,1.4,0.4,23,CL
cf007308,10,285,3.2,2,1,8,0,6,4,2,7.9,4.6,3.3,23,CL
cf15bbb1,5,249,2.8,3,0,2,1,0,11,-11,1.7,7.6,-5.9,23,CL
cfdacb90,5,356,4.0,5,0,0,1,6,13,-7,4.9,6.1,-1.2,23,CL
d00fd50a,4,182,2.0,2,1,2,2,1,9,-8,2.2,5.2,-2.9,23,CL
d0a39bdf,5,312,3.5,3,3,2,1,6,6,0,2.4,5.7,-3.3,23,CL
d0b8e745,2,22,0.2,0,0,2,1,0,2,-2,0.8,0.7,0.1,23,CL
d0d8dd44,7,299,3.3,3,1,4,6,4,5,-1,3.2,5.4,-2.2,23,CL
d19ef4ef,3,56,0.6,0,0,3,3,2,0,2,1.6,0.6,1.0,23,CL
d1eda5f0,5,60,0.7,0,0,5,1,0,2,-2,0.6,2.5,-1.8,23,CL
d2416c2e,5,72,0.8,0,0,5,1,1,2,-1,0.6,1.1,-0.4,23,CL
d2424d1b,7,556,6.2,7,3,0,2,9,4,5,10.3,6.4,3.8,23,CL
d248cd8f,10,713,7.9,9,5,1,0,18,5,13,14.8,9.5,5.3,23,CL
d2fd7c14,6,229,2.5,3,0,3,0,3,4,-1,3.6,3.5,0.1,23,CL
d3dc62d1,1,90,1.0,1,1,0,5,0,5,-5,0.5,2.4,-1.9,23,CL
d436eb94,8,720,8.0,8,8,0,0,8,11,-3,8.0,16.9,-8.9,23,CL
d4c9725f,11,945,10.5,11,8,0,0,14,8,6,15.1,12.6,2.5,23,CL
d557d734,2,76,0.8,1,0,1,4,0,1,-1,0.7,0.6,0.1,23,CL
d5dd5f1f,6,403,4.5,6,0,0,0,10,3,7,6.8,3.4,3.4,23,CL
d5f2f82b,8,653,7.3,8,6,0,0,15,8,7,9.6,8.4,1.2,23,CL
d697a2d0,1,12,0.1,0,0,1,0,0,0,0,0.0,0.1,-0.1,23,CL
d6e53a3a,7,614,6.8,7,6,0,1,14,4,10,13.0,6.7,6.3,23,CL
d70ce98e,7,613,6.8,7,5,0,0,15,9,6,9.1,8.8,0.2,23,CL
d720e834,1,4,0.0,0,0,1,2,1,0,1,1.0,0.0,1.0,23,CL
d781d855,9,602,6.7,6,4,3,0,15,3,12,12.8,7.6,5.2,23,CL
d820a7c8,2,148,1.6,2,0,0,0,1,7,-6,1.0,4.0,-2.9,23,CL
d92ab59f,6,290,3.2,2,2,4,0,4,11,-7,4.0,7.1,-3.1,23,CL
d97cccc9,4,191,2.1,2,0,2,0,1,3,-2,2.2,3.6,-1.5,23,CL
d9d43555,1,64,0.7,1,0,0,0,1,1,0,1.3,0.6,0.6,23,CL
da7b447d,2,21,0.2,0,0,2,6,0,1,-1,0.8,0.9,-0.1,23,CL
da9018ca,6,469,5.2,5,5,1,0,7,19,-12,5.8,7.9,-2.1,23,CL
da974c7b,7,568,6.3,7,5,0,1,9,4,5,10.0,6.4,3.6,23,CL
db092d3b,10,585,6.5,9,1,1,0,13,10,3,10.7,10.2,0.5,23,CL
dbfbdf06,3,44,0.5,0,0,3,3,0,1,-1,0.5,1.2,-0.7,23,CL
dc62b55d,5,122,1.4,0,0,5,0,1,2,-1,4.7,2.2,2.5,23,CL
dc7f8a28,4,138,1.5,1,0,3,9,4,1,3,4.3,0.8,3.5,23,CL
dccd127f,4,324,3.6,4,3,0,1,1,10,-9,3.9,6.4,-2.5,23,CL
dcfb17f4,4,121,1.3,1,0,3,0,0,3,-3,2.5,3.5,-1.0,23,CL
dd0daf32,13,906,10.1,11,6,2,0,16,9,7,13.9,12.5,1.4,23,CL
de39485a,6,274,3.0,3,1,3,0,3,6,-3,6.7,5.0,1.7,23,CL
dea88efd,9,692,7.7,9,1,0,1,20,5,15,19.2,9.3,9.9,23,CL
df064106,6,492,5.5,6,3,0,0,5,23,-18,5.1,14.2,-9.0,23,CL
df3cda47,4,200,2.2,2,0,2,0,2,3,-1,1.8,2.3,-0.5,23,CL
df525574,1,25,0.3,0,0,1,3,0,1,-1,0.4,1.1,-0.7,23,CL
df69b544,6,406,4.5,4,3,2,0,5,9,-4,7.7,8.5,-0.8,23,CL
df8b52a5,8,543,6.0,6,4,2,0,5,5,0,8.1,6.5,1.6,23,CL
dff153a4,4,354,3.9,4,3,0,0,5,7,-2,4.0,6.4,-2.4,23,CL
e06683ca,8,720,8.0,8,8,0,0,19,12,7,14.7,10.6,4.1,23,CL
e0b113a7,5,407,4.5,5,3,0,0,4,4,0,6.5,4.7,1.8,23,CL
e0f8151c,9,785,8.7,9,8,0,0,25,7,18,23.0,10.9,12.1,23,CL
e12b0b5b,6,299,3.3,3,0,3,1,3,6,-3,4.5,6.5,-2.1,23,CL
e162b013,4,352,3.9,4,3,0,2,9,4,5,5.8,4.3,1.5,23,CL
e1cbb531,10,873,9.7,10,7,0,0,25,6,19,24.5,11.2,13.3,23,CL
e280527c,6,280,3.1,3,1,3,0,4,1,3,5.4,3.4,2.0,23,CL
e2ae54db,6,298,3.3,3,1,3,0,1,4,-3,3.2,4.8,-1.7,23,CL
e33c06cf,8,675,7.5,7,7,1,0,10,6,4,10.1,10.3,-0.2,23,CL
e342ad68,8,624,6.9,7,6,1,0,16,11,5,13.2,9.7,3.5,23,CL
e34e086c,1,13,0.1,0,0,1,1,0,0,0,0.2,0.0,0.2,23,CL
e3756e72,3,120,1.3,1,1,2,10,1,4,-3,2.4,2.2,0.2,23,CL
e42d61c7,8,580,6.4,7,5,1,0,14,8,6,8.2,8.0,0.2,23,CL
e46012d4,10,716,8.0,9,3,1,2,20,3,17,15.8,5.9,9.9,23,CL
e6bc67d7,2,43,0.5,0,0,2,2,3,1,2,0.9,0.1,0.8,23,CL
e7281ea9,3,120,1.3,0,0,3,2,0,2,-2,0.8,3.6,-2.8,23,CL
e73659d3,3,90,1.0,0,0,3,3,0,3,-3,1.4,2.1,-0.8,23,CL
e73c9bb2,6,391,4.3,4,3,2,0,4,8,-4,4.2,7.4,-3.3,23,CL
e76cb9cc,5,406,4.5,5,4,0,0,8,5,3,7.5,2.8,4.8,23,CL
e7af9060,1,12,0.1,0,0,1,4,0,0,0,0.0,0.0,0.0,23,CL
e7d59f4f,6,380,4.2,4,2,2,0,7,7,0,6.8,3.8,3.0,23,CL
e82adcab,2,90,1.0,1,0,1,0,0,0,0,1.1,0.6,0.6,23,CL
e97fd090,7,285,3.2,2,2,5,3,3,2,1,5.6,3.0,2.6,23,CL
e9971f2d,1,18,0.2,0,0,1,5,2,0,2,0.7,0.2,0.5,23,CL
e9b0ccaf,4,136,1.5,2,0,2,2,1,9,-8,2.0,3.7,-1.7,23,CL
e9c0c1b2,13,1170,13.0,13,13,0,0,19,11,8,17.9,15.1,2.8,23,CL
e9fda01d,3,52,0.6,0,0,3,5,0,3,-3,1.2,1.6,-0.3,23,CL
eaeca114,8,608,6.8,7,6,1,3,15,2,13,11.7,6.7,5.0,23,CL
eaeefc50,3,29,0.3,0,0,3,3,0,0,0,0.5,1.8,-1.2,23,CL
eaefa2d0,1,14,0.2,0,0,1,0,0,0,0,0.0,0.3,-0.3,23,CL
eca17cf2,5,450,5.0,5,5,0,1,5,19,-14,5.1,12.6,-7.6,23,CL
ed1e53f3,8,384,4.3,3,1,5,4,12,1,11,8.4,3.5,4.8,23,CL
ed45c4a5,6,471,5.2,5,4,1,0,5,6,-1,6.9,4.5,2.3,23,CL
edeb21ff,5,371,4.1,5,0,0,1,6,15,-9,4.3,6.5,-2.2,23,CL
ee251371,8,371,4.1,4,0,4,0,5,5,0,5.8,5.3,0.5,23,CL
ee3519f5,6,532,5.9,6,4,0,0,8,10,-2,3.7,9.9,-6.2,23,CL
ee644761,6,540,6.0,6,6,0,0,4,15,-11,9.2,10.9,-1.7,23,CL
ee8508c0,5,450,5.0,5,5,0,0,5,7,-2,8.6,8.1,0.5,23,CL
ee926a02,6,471,5.2,6,2,0,0,4,9,-5,3.4,8.7,-5.3,23,CL
ee950928,6,490,5.4,6,1,0,0,4,11,-7,3.6,10.2,-6.6,23,CL
eeba07f8,4,114,1.3,1,0,3,2,0,1,-1,1.4,1.6,-0.2,23,CL
ef491564,1,30,0.3,0,0,1,1,0,1,-1,0.5,1.2,-0.7,23,CL
ef88f778,5,256,2.8,3,0,2,1,1,9,-8,3.6,7.6,-4.0,23,CL
f0021247,10,861,9.6,10,3,0,0,24,12,12,18.6,10.3,8.3,23,CL
f0677ed7,10,620,6.9,7,6,3,0,16,11,5,14.5,9.1,5.3,23,CL
f07a0fe5,6,397,4.4,4,3,2,0,4,20,-16,4.8,8.1,-3.3,23,CL
f08490a6,1,10,0.1,0,0,1,1,0,0,0,0.1,0.0,0.1,23,CL
f0da930c,5,401,4.5,5,3,0,0,5,6,-1,6.1,7.6,-1.5,23,CL
f15b778f,2,161,1.8,2,1,0,0,0,2,-2,1.2,2.6,-1.4,23,CL
f179ee11,6,335,3.7,4,1,2,0,1,9,-8,3.1,7.8,-4.7,23,CL
f20e4cc9,6,439,4.9,5,3,1,1,7,5,2,6.3,5.6,0.7,23,CL
f315ca93,6,342,3.8,4,3,2,2,9,2,7,8.8,1.8,7.0,23,CL
f3945e07,7,113,1.3,0,0,7,1,2,6,-4,3.2,3.0,0.2,23,CL
f3a97d02,5,450,5.0,5,5,0,1,2,18,-16,4.8,12.2,-7.5,23,CL
f417a1fa,6,400,4.4,4,2,2,0,4,19,-15,4.2,7.5,-3.3,23,CL
f4290206,5,403,4.5,5,3,0,0,5,10,-5,7.1,7.5,-0.4,23,CL
f449640d,4,135,1.5,1,1,3,8,1,3,-2,1.4,1.9,-0.6,23,CL
f49c4ae9,9,316,3.5,2,0,7,2,1,2,-1,3.8,4.2,-0.4,23,CL
f4b52308,4,40,0.4,0,0,4,2,2,0,2,0.7,0.5,0.2,23,CL
f4d8ce5a,4,93,1.0,1,0,3,2,0,6,-6,0.5,2.6,-2.1,23,CL
f620b04f,6,244,2.7,3,0,3,0,3,3,0,2.0,4.4,-2.4,23,CL
f63cda26,10,712,7.9,10,2,0,0,16,12,4,15.3,9.8,5.5,23,CL
f6798fc3,4,360,4.0,4,4,0,2,3,12,-9,3.6,8.4,-4.9,23,CL
f6a90edd,8,645,7.2,7,6,1,0,8,10,-2,7.4,14.4,-7.0,23,CL
f6ac68c1,3,270,3.0,3,3,0,1,1,4,-3,5.2,4.6,0.7,23,CL
f7036e1c,13,997,11.1,12,6,1,0,14,8,6,13.8,13.2,0.6,23,CL
f7750aa0,7,523,5.8,6,4,1,0,8,7,1,6.4,12.9,-6.5,23,CL
f874dd44,2,180,2.0,2,2,0,1,4,5,-1,3.0,4.6,-1.6,23,CL
f9acca3a,6,143,1.6,1,0,5,2,0,3,-3,2.4,4.0,-1.6,23,CL
f9bd541e,6,266,3.0,2,1,4,0,4,8,-4,3.9,7.2,-3.3,23,CL
fa031b34,6,365,4.1,4,2,2,0,5,3,2,6.1,4.5,1.6,23,CL
fa661778,4,176,2.0,2,1,2,2,1,2,-1,2.3,3.5,-1.2,23,CL
fb495bb8,6,481,5.3,6,3,0,0,4,13,-9,8.1,9.4,-1.2,23,CL
fc4e7637,8,685,7.6,8,4,0,0,11,5,6,13.6,10.3,3.3,23,CL
fc62f087,5,227,2.5,2,2,3,1,3,7,-4,3.5,3.6,-0.1,23,CL
fcb27134,7,511,5.7,6,2,1,1,11,7,4,9.9,5.2,4.7,23,CL
fcb38f57,7,630,7.0,7,7,0,0,6,6,0,9.0,8.5,0.4,23,CL
fcea4f04,3,187,2.1,3,0,0,0,4,4,0,1.2,4.1,-2.9,23,CL
fd4d5f81,6,359,4.0,5,0,1,0,3,10,-7,5.9,8.1,-2.3,23,CL
fd51b456,5,202,2.2,2,1,3,6,3,5,-2,2.8,2.7,0.1,23,CL
fe641c1a,4,230,2.6,3,1,1,2,1,5,-4,1.5,4.2,-2.8,23,CL
feb5d972,1,90,1.0,1,1,0,6,0,1,-1,0.4,1.7,-1.3,23,CL
fed17f5a,6,155,1.7,2,0,4,2,2,2,0,2.1,2.0,0.1,23,CL
fed7cb61,10,619,6.9,7,4,3,0,7,6,1,10.6,6.7,3.9,23,CL
ff5ea0bf,4,275,3.1,3,2,1,2,1,0,1,3.8,1.4,2.4,23,CL
ff74841d,6,540,6.0,6,6,0,0,5,9,-4,8.3,6.9,1.4,23,CL
ffbbc83b,5,59,0.7,0,0,5,1,2,3,-1,1.4,2.7,-1.3,23,CL
ffed43e3,1,90,1.0,1,1,0,0,0,2,-2,0.2,2.9,-2.7,23,CL
0000acda,17,1091,12.1,12,7,5,3,11,23,-12,11.6,18.1,-6.3999999999999995,23,ITA
00459419,21,1530,17.0,18,10,3,2,22,24,-2,19.8,21.2,-1.4,23,ITA
00a17eba,7,630,7.0,7,7,0,29,3,9,-6,6.8,9.5,-2.7,23,ITA
0154d290,23,817,9.1,7,1,16,11,9,13,-4,8.1,12.9,-4.8,23,ITA
016ff750,23,1373,15.3,15,6,8,3,17,17,0,16.1,18.5,-2.4,23,ITA
01b8a2b2,28,2472,27.5,28,27,0,6,40,26,14,40.4,29.1,11.3,23,ITA
01c3aff5,15,1052,11.7,13,6,2,1,15,13,2,16.0,14.5,1.4,23,ITA
01efac19,31,1824,20.3,21,6,10,4,25,27,-2,28.3,24.700000000000003,3.5999999999999996,23,ITA
023937a9,10,671,7.5,7,4,3,3,9,13,-4,7.5,13.0,-5.4,23,ITA
028e70b9,19,822,9.1,5,4,14,10,17,11,6,14.8,12.7,2.0,23,ITA
02caf6e0,28,1879,20.9,22,10,6,7,31,16,15,26.2,23.1,3.1,23,ITA
0375723e,24,1096,12.2,12,2,12,6,10,20,-10,13.0,16.2,-3.2,23,ITA
039a4fb6,8,139,1.5,0,0,8,12,0,3,-3,1.6,3.0,-1.4,23,ITA
03f946ed,31,1663,18.5,19,2,12,2,23,32,-9,22.4,27.2,-4.8,23,ITA
04df29a5,33,1515,16.8,18,0,15,4,20,18,2,18.8,19.3,-0.5,23,ITA
0588a092,20,1051,11.7,14,2,6,13,10,27,-17,9.1,21.6,-12.5,23,ITA
060606ec,8,290,3.2,3,1,5,24,3,7,-4,4.2,4.6,-0.4,23,ITA
0630eb63,28,1461,16.2,16,4,12,2,18,18,0,18.0,17.6,0.4,23,ITA
06b08c45,21,825,9.2,8,1,13,16,6,9,-3,10.5,14.4,-3.9,23,ITA
0728bebe,15,718,8.0,7,2,8,5,17,8,9,13.7,8.1,5.6,23,ITA
07f8bcc8,34,1812,20.1,20,4,14,3,13,27,-14,16.6,22.4,-5.7,23,ITA
085e71a7,34,2946,32.7,34,32,0,3,24,54,-30,32.4,50.9,-18.5,23,ITA
08aa9cd1,32,2161,24.0,25,8,7,0,29,32,-3,34.8,28.8,6.0,23,ITA
08eb3b58,3,55,0.6,1,0,2,17,1,1,0,1.3,0.3,1.0,23,ITA
09538fdb,26,1572,17.5,17,7,9,0,13,26,-13,16.6,21.9,-5.3,23,ITA
0967845b,33,2830,31.4,33,28,0,2,31,37,-6,32.5,45.0,-12.5,23,ITA
09899de8,7,167,1.9,1,1,6,11,1,4,-3,2.9,3.1,-0.3,23,ITA
0a447501,33,2433,27.0,28,12,5,2,29,31,-2,31.2,27.2,4.0,23,ITA
0a483542,24,1470,16.3,17,5,7,8,21,20,1,18.6,21.2,-2.7,23,ITA
0ab1f153,31,2078,23.1,24,10,7,0,35,15,20,33.1,23.5,9.7,23,ITA
0acda699,1,90,1.0,1,1,0,36,3,0,3,0.7,0.8,-0.1,23,ITA
0b5a292a,22,1749,19.4,21,7,1,8,47,16,31,39.4,16.1,23.3,23,ITA
0be276c6,27,1740,19.3,23,9,4,3,25,19,6,19.4,27.9,-8.5,23,ITA
0d077b88,37,2771,30.8,36,12,1,1,28,50,-22,33.6,49.2,-15.5,23,ITA
0d422df7,38,3420,38.0,38,38,0,0,47,48,-1,46.9,51.8,-4.9,23,ITA
0d82903c,25,1787,19.9,21,16,4,8,35,20,15,31.6,23.8,7.8,23,ITA
0db169ae,34,2713,30.1,30,23,4,2,49,36,13,47.0,33.1,13.9,23,ITA
0def2376,4,60,0.7,0,0,4,15,2,2,0,0.9,1.1,-0.2,23,ITA
0e0d6c53,1,3,0.0,0,0,1,25,0,1,-1,0.0,1.1,-1.0,23,ITA
0fdcef0e,20,592,6.6,5,1,15,18,9,10,-1,10.7,7.8,2.9,23,ITA
0fee6bda,28,2330,25.9,26,22,2,8,35,36,-1,36.8,32.0,4.7,23,ITA
102e2599,26,1772,19.7,24,6,2,5,17,23,-6,18.9,26.2,-7.3,23,ITA
108fe016,16,594,6.6,6,1,10,21,7,6,1,8.2,7.3,0.9,23,ITA
10b9fa99,31,2639,29.3,31,22,0,0,22,42,-20,32.6,43.9,-11.3,23,ITA
10dc46f0,1,90,1.0,1,1,0,7,2,0,2,1.7,1.8,-0.1,23,ITA
10e7f486,36,2996,33.3,34,29,2,1,41,55,-14,46.2,44.6,1.6,23,ITA
12806697,32,2607,29.0,28,26,4,0,24,42,-18,28.2,37.9,-9.8,23,ITA
1295552e,2,13,0.1,1,0,1,6,0,0,0,0.0,0.0,0.0,23,ITA
13b44b02,27,1530,17.0,16,11,11,10,14,28,-14,15.4,28.3,-12.9,23,ITA
13ea2544,15,696,7.7,8,1,7,18,5,10,-5,8.2,6.3,1.9,23,ITA
149c5f5d,16,918,10.2,10,5,6,18,10,18,-8,10.1,14.7,-4.5,23,ITA
14ae023f,4,360,4.0,4,4,0,16,7,9,-2,4.8,9.0,-4.2,23,ITA
14b8fcdf,9,564,6.3,6,5,3,29,9,2,7,8.6,6.3,2.3,23,ITA
16463a79,19,519,5.8,6,0,13,17,2,5,-3,5.3,6.5,-1.2,23,ITA
16657b95,36,2938,32.6,34,26,2,0,36,27,9,45.6,24.6,20.9,23,ITA
16bb656a,23,1632,18.1,20,14,3,6,16,27,-11,16.8,20.9,-4.1,23,ITA
16ceb862,33,2139,23.8,25,9,8,2,42,25,17,36.5,23.4,13.1,23,ITA
17f3620a,33,2140,23.8,23,13,10,1,33,44,-11,24.5,43.9,-19.4,23,ITA
18dd3219,18,1448,16.1,16,16,2,20,16,13,3,22.1,16.7,5.4,23,ITA
19cda00b,26,1363,15.1,15,3,11,1,25,21,4,22.6,18.2,4.5,23,ITA
19e4eab9,28,2484,27.6,28,25,0,0,38,31,7,35.2,37.7,-2.5,23,ITA
1ac232b8,19,1189,13.2,15,3,4,3,12,22,-10,14.2,17.3,-3.0,23,ITA
1b9c7401,20,699,7.8,6,1,14,13,6,17,-11,7.5,17.6,-10.1,23,ITA
1bfe5ac9,14,1003,11.1,11,11,3,5,9,20,-11,13.9,14.2,-0.3,23,ITA
1cadaf34,20,708,7.800000000000001,8,0,12,9,7,10,-3,7.9,12.9,-5.1,23,ITA
1d4e63b6,4,54,0.6,0,0,4,14,0,0,0,0.6,0.8,-0.1,23,ITA
1e9aa637,32,2335,25.9,29,15,3,4,46,35,11,36.8,29.9,6.9,23,ITA
1e9bde92,20,1800,20.0,20,20,0,3,26,33,-7,17.9,33.7,-15.8,23,ITA
1f2d714c,6,226,2.5,3,0,3,5,2,5,-3,2.6,4.3,-1.8,23,ITA
1faa06d5,1,32,0.4,0,0,1,1,0,1,-1,0.4,0.6,-0.2,23,ITA
1fca9171,36,2031,22.6,23,4,13,0,19,24,-5,22.0,23.0,-1.0,23,ITA
20094685,30,2296,25.5,25,18,5,2,29,36,-7,34.6,33.3,1.3,23,ITA
204ac005,31,1400,15.6,14,4,17,6,17,25,-8,18.9,25.1,-6.1,23,ITA
20730eae,35,2421,26.9,28,13,7,0,53,31,22,44.5,27.9,16.6,23,ITA
20b3a502,31,2300,25.6,26,13,5,1,34,31,3,31.1,32.0,-0.9,23,ITA
2146785a,25,1690,18.8,21,10,4,3,35,25,10,28.4,19.6,8.8,23,ITA
217875a4,11,603,6.7,6,5,5,21,8,9,-1,8.0,11.9,-3.9,23,ITA
217c93a1,37,1848,20.5,19,3,18,1,29,27,2,26.7,26.8,-0.1,23,ITA
2200181e,10,545,6.1,5,5,5,8,6,11,-5,5.7,7.3,-1.6,23,ITA
22051fbe,8,422,4.7,4,2,4,16,3,7,-4,4.6,5.1,-0.5,23,ITA
226008f1,31,2353,26.1,27,17,4,4,36,32,4,32.1,33.7,-1.5,23,ITA
22ae86f9,19,1177,13.1,11,9,8,10,8,16,-8,13.2,16.1,-2.9,23,ITA
22bfb57e,16,805,8.9,11,0,5,1,13,11,2,11.3,12.9,-1.6,23,ITA
22cd43d2,7,296,3.3,4,0,3,3,1,3,-2,2.0,5.3,-3.3,23,ITA
230a2fac,37,3257,36.2,36,35,1,1,75,24,51,62.7,28.6,34.1,23,ITA
230c3f3a,16,651,7.2,6,2,10,13,6,15,-9,6.6,10.9,-4.4,23,ITA
2374aaca,24,1354,15.0,13,7,11,5,23,16,7,22.7,16.6,6.2,23,ITA
244bc2c8,33,2518,28.0,27,16,6,1,40,46,-6,26.9,47.3,-20.4,23,ITA
246d153b,19,876,9.7,9,4,10,3,10,7,3,13.7,10.5,3.2,23,ITA
247ed022,32,2170,24.1,25,17,7,2,30,28,2,28.3,29.3,-1.0,23,ITA
24eb7ed6,22,697,7.7,7,1,15,16,8,10,-2,7.7,14.3,-6.6,23,ITA
26777636,6,144,1.6,1,0,5,32,2,4,-2,2.4,2.9,-0.5,23,ITA
26c54058,7,509,5.7,6,4,1,29,2,6,-4,3.1,7.0,-3.9,23,ITA
26db8853,37,3190,35.4,37,28,0,0,42,44,-2,43.1,49.4,-6.3,23,ITA
277da414,38,3413,37.9,37,37,1,0,60,30,30,51.1,41.3,9.8,23,ITA
28f66c2e,16,733,8.1,9,2,7,18,12,13,-1,11.9,7.2,4.7,23,ITA
2990c466,1,34,0.4,0,0,1,5,0,1,-1,0.1,1.1,-1.0,23,ITA
2a1beb34,35,2964,32.9,34,31,1,0,57,40,17,48.3,35.9,12.4,23,ITA
2a6cd437,9,790,8.8,9,8,0,10,9,9,0,7.6,8.0,-0.4,23,ITA
2a7d27c1,36,2873,31.9,35,15,1,1,40,47,-7,43.4,40.3,3.2,23,ITA
2a82aa85,28,1286,14.3,13,5,15,9,20,24,-4,13.1,27.7,-14.6,23,ITA
2b8360f1,14,745,8.3,9,2,5,4,8,9,-1,8.3,10.4,-2.1,23,ITA
2b9fdeea,16,546,6.1,5,0,11,2,6,9,-3,7.5,6.5,1.0,23,ITA
2bffcbf2,6,109,1.2,0,0,6,18,0,5,-5,0.7,4.2,-3.5,23,ITA
2c38b327,17,525,5.8,5,0,12,15,7,8,-1,5.1,11.7,-6.6,23,ITA
2cb9486d,7,169,1.9,1,0,6,11,2,5,-3,2.2,4.8,-2.6,23,ITA
2ce215f2,1,16,0.2,0,0,1,8,0,0,0,0.3,0.5,-0.2,23,ITA
2cfae697,33,2509,27.9,29,17,4,1,35,37,-2,32.4,36.0,-3.6,23,ITA
2d22cea7,28,2175,24.2,27,9,1,0,33,33,0,33.0,28.3,4.6,23,ITA
2d3d7c0d,3,181,2.0,2,2,1,2,1,2,-1,2.5,2.7,-0.1,23,ITA
2d970560,32,1184,13.2,11,2,21,3,17,15,2,23.0,13.1,9.9,23,ITA
2df7cc43,27,2144,23.8,26,17,1,9,19,44,-25,22.599999999999998,41.5,-18.8,23,ITA
2e7dafe5,1,14,0.2,0,0,1,5,1,0,1,0.4,0.0,0.4,23,ITA
2ef7c612,32,1116,12.4,9,0,23,5,19,19,0,20.3,16.1,4.2,23,ITA
2f3452eb,34,1998,22.2,22,14,12,3,38,17,21,31.4,22.9,8.5,23,ITA
2f45300d,3,20,0.2,0,0,3,28,0,1,-1,0.2,1.0,-0.8,23,ITA
2f69d881,22,1354,15.0,15,7,7,8,13,22,-9,13.4,15.7,-2.2,23,ITA
2f7acede,20,1716,19.1,19,15,1,1,16,36,-20,19.3,35.8,-16.5,23,ITA
30223b33,1,2,0.0,0,0,1,37,1,0,1,1.1,0.0,1.1,23,ITA
30f5ffa9,21,1769,19.7,20,17,1,2,37,23,14,32.8,17.6,15.2,23,ITA
31a62dc7,24,1504,16.7,16,10,8,8,22,17,5,24.3,13.7,10.6,23,ITA
32ebfe1e,9,338,3.8,3,2,6,27,4,9,-5,4.6,6.0,-1.4,23,ITA
3318286e,1,5,0.1,1,0,0,36,0,0,0,0.1,0.0,0.1,23,ITA
33b8d077,28,1770,19.7,19,11,9,0,35,27,8,35.2,20.9,14.3,23,ITA
33ecf462,18,677,7.5,6,0,12,0,3,12,-9,6.7,13.1,-6.3,23,ITA
343c0d52,25,406,4.5,1,0,24,10,9,7,2,7.4,7.3,0.1,23,ITA
343f753a,17,1530,17.0,17,17,0,16,19,27,-8,17.6,31.1,-13.6,23,ITA
34693494,27,1234,13.7,14,1,13,7,14,9,5,18.6,15.2,3.4,23,ITA
356c9002,35,2726,30.3,32,18,3,0,41,46,-5,30.3,50.1,-19.8,23,ITA
3626daea,26,1654,18.4,18,12,8,4,20,21,-1,28.4,15.5,12.9,23,ITA
366be751,26,1520,16.9,17,8,9,8,31,16,15,26.1,17.4,8.7,23,ITA
384d58d9,2,123,1.4,1,1,1,2,3,1,2,2.1,1.8,0.2,23,ITA
38d9ce53,2,52,0.6,0,0,2,13,2,1,1,1.0,1.0,0.0,23,ITA
3945ac70,1,90,1.0,1,1,0,33,1,3,-2,1.1,1.6,-0.5,23,ITA
39583cfd,16,1211,13.5,15,8,1,0,19,15,4,17.5,16.2,1.3,23,ITA
3b12b11f,23,1552,17.200000000000003,16,12,7,15,13,34,-21,16.3,34.9,-18.599999999999998,23,ITA
3b333ac3,17,1397,15.5,17,11,0,4,22,16,6,21.3,17.4,3.9,23,ITA
3b387cc7,8,76,0.8,0,0,8,25,4,0,4,2.1,0.5,1.6,23,ITA
3b61c9ec,7,180,2.0,1,1,6,10,4,1,3,5.0,2.3,2.7,23,ITA
3b9858f5,6,220,2.4,3,0,3,9,1,6,-5,2.6,4.3,-1.7,23,ITA
3bb7af3b,29,1208,13.4,14,0,15,8,21,17,4,18.8,18.9,-0.1,23,ITA
3bb7f478,33,1732,19.2,18,9,15,5,44,20,24,36.8,17.3,19.5,23,ITA
3ca7254a,36,1898,21.1,17,2,19,0,33,20,13,28.4,20.1,8.3,23,ITA
3cb132e6,1,21,0.2,0,0,1,1,0,1,-1,0.6,1.0,-0.4,23,ITA
3cd3b384,37,3061,34.0,35,28,2,1,23,64,-41,31.0,59.4,-28.4,23,ITA
3d13d9e4,28,866,9.6,9,2,19,10,13,17,-4,9.2,17.6,-8.4,23,ITA
3d50bcdb,28,995,11.1,11,0,17,2,11,8,3,14.2,10.8,3.4,23,ITA
3d6cee81,12,284,3.2,1,0,11,11,1,7,-6,2.4,8.7,-6.4,23,ITA
3ead85f9,34,2922,32.5,33,30,1,2,49,28,21,40.3,36.1,4.2,23,ITA
3ec3c1c9,27,2171,24.1,25,20,2,8,33,31,2,33.4,28.3,5.1,23,ITA
3eed9821,25,2113,23.5,24,20,1,9,22,28,-6,25.2,23.9,1.4,23,ITA
3ef0a2d7,22,935,10.4,8,5,14,13,16,8,8,17.5,9.4,8.1,23,ITA
3f5f38fb,29,2437,27.1,27,25,2,6,38,24,14,36.3,28.5,7.7,23,ITA
3f79a1c8,9,555,6.2,7,3,2,5,3,13,-10,3.8,11.6,-7.7,23,ITA
405f6586,28,1366,15.2,14,6,14,4,15,23,-8,13.1,19.9,-6.9,23,ITA
407feb71,33,1925,21.4,27,1,6,4,36,21,15,34.2,19.8,14.5,23,ITA
41c12f75,30,1643,18.3,17,14,13,6,29,11,18,24.8,15.5,9.3,23,ITA
4295f19c,4,32,0.4,0,0,4,11,0,2,-2,0.3,0.4,-0.1,23,ITA
42eaa028,33,2007,22.3,24,10,9,5,30,23,7,33.5,24.5,9.0,23,ITA
43a166b4,27,1027,11.4,10,2,17,4,14,13,1,15.5,13.2,2.3,23,ITA
4431aed2,31,2219,24.7,27,17,4,2,42,19,23,32.9,28.6,4.2,23,ITA
44ac04e9,32,1691,18.8,17,9,15,2,26,16,10,23.3,21.7,1.6,23,ITA
44eb9093,15,733,8.1,8,3,7,17,19,12,7,15.6,10.5,5.1,23,ITA
45191c29,33,2197,24.4,26,10,7,3,29,24,5,31.9,18.9,13.0,23,ITA
45b9b619,26,950,10.6,12,0,14,3,13,12,1,16.5,11.8,4.7,23,ITA
46fa7204,34,2131,23.7,23,6,11,2,20,39,-19,24.4,38.7,-14.3,23,ITA
481c9ece,34,2218,24.6,25,11,9,4,54,26,28,49.2,23.4,25.8,23,ITA
4830e0af,18,1069,11.9,12,6,6,4,6,20,-14,10.8,18.0,-7.2,23,ITA
48329ff8,1,4,0.0,0,0,1,0,0,0,0,0.1,0.1,0.0,23,ITA
48d5bd33,15,553,6.1,5,0,10,1,9,8,1,8.4,7.0,1.4,23,ITA
49136c42,7,312,3.5,4,0,3,11,3,5,-2,3.0,4.6,-1.7,23,ITA
491a433d,32,1834,20.4,20,5,12,3,45,29,16,34.5,23.1,11.4,23,ITA
4a537185,11,210,2.3,1,0,10,5,2,8,-6,2.0,4.9,-2.9,23,ITA
4a5a45c7,32,2545,28.3,29,14,3,3,35,26,9,44.3,20.6,23.7,23,ITA
4ae67f27,34,2721,30.2,30,24,4,2,35,30,5,32.3,30.1,2.2,23,ITA
4b3e1a38,29,2448,27.2,27,25,2,3,56,22,34,45.6,22.3,23.3,23,ITA
4b520f96,1,1,0.0,0,0,1,21,0,0,0,0.0,0.0,0.0,23,ITA
4b7a9fcc,2,63,0.7,1,0,1,33,0,0,0,0.4,0.7,-0.3,23,ITA
4bd00a50,2,122,1.4,1,1,1,1,1,3,-2,2.0,1.5,0.5,23,ITA
4c62d0c8,11,948,10.5,10,10,1,26,16,7,9,14.8,12.4,2.4,23,ITA
4c8845f7,24,971,10.8,11,0,13,10,9,20,-11,13.3,14.1,-0.8,23,ITA
4cde5509,4,146,1.6,1,0,3,3,3,4,-1,2.9,2.6,0.4,23,ITA
4d1efb48,2,43,0.5,0,0,2,16,1,1,0,0.8,1.0,-0.3,23,ITA
4d8cd038,31,1534,17.0,16,8,15,4,24,23,1,24.0,21.2,2.8,23,ITA
4e0c8d66,37,3330,37.0,37,37,0,1,48,49,-1,44.6,48.9,-4.3,23,ITA
4e1d5e59,12,459,5.1000000000000005,3,1,9,10,6,6,0,7.0,7.7,-0.6000000000000001,23,ITA
4e358a2d,14,1074,11.9,12,10,2,1,19,19,0,15.0,22.9,-7.9,23,ITA
4e6dbac4,36,3022,33.6,34,25,2,1,54,27,27,43.9,38.2,5.6,23,ITA
50841bef,10,688,7.6,7,6,3,27,5,10,-5,6.8,11.7,-4.9,23,ITA
5128bde4,30,2242,24.9,27,12,3,0,23,36,-13,24.1,31.4,-7.3,23,ITA
528492ea,25,1103,12.3,13,2,12,8,17,10,7,16.6,13.2,3.3,23,ITA
5294a83f,35,2442,27.1,27,16,8,2,49,19,30,39.6,27.7,11.9,23,ITA
52ec54d0,16,879,9.8,9,7,7,9,20,10,10,16.5,11.3,5.2,23,ITA
536cebe5,23,980,10.9,10,2,13,5,17,11,6,15.4,13.0,2.4,23,ITA
539230cf,1,47,0.5,1,0,0,1,0,2,-2,0.1,1.0,-0.9,23,ITA
53a0e358,26,1866,20.7,22,11,4,1,30,32,-2,34.3,25.5,8.8,23,ITA
53de807a,1,1,0.0,0,0,1,31,1,0,1,0.0,0.0,0.0,23,ITA
548bd0de,3,136,1.5,2,1,1,20,0,1,-1,0.7,1.5,-0.8,23,ITA
54ab971f,5,229,2.5,1,0,4,2,1,6,-5,2.4,4.3,-1.8,23,ITA
54e53b7e,37,2441,27.1,32,5,5,0,33,42,-9,31.0,35.1,-4.1,23,ITA
54f6afe3,1,74,0.8,0,0,1,27,1,2,-1,0.9,2.0,-1.1,23,ITA
55a1cac2,19,883,9.8,9,5,10,16,17,13,4,14.7,10.8,4.0,23,ITA
563a68ad,29,1478,16.4,17,6,12,5,24,25,-1,18.4,20.4,-2.0,23,ITA
570bb4b9,11,591,6.6,6,1,5,0,10,10,0,9.6,9.4,0.2,23,ITA
5722eced,12,618,6.9,9,0,3,2,5,6,-1,4.8,8.9,-4.1,23,ITA
57469b2d,21,928,10.3,10,6,11,16,8,17,-9,13.8,13.5,0.30000000000000004,23,ITA
58a2e9f6,1,10,0.1,0,0,1,14,0,1,-1,0.2,0.3,-0.1,23,ITA
58e933d2,28,1866,20.7,22,10,6,10,27,27,0,30.6,22.0,8.6,23,ITA
5976f83e,8,329,3.7,2,1,6,7,10,7,3,6.1,5.7,0.4,23,ITA
599d91d0,9,264,2.9,3,0,6,29,3,3,0,2.9,3.8,-0.9,23,ITA
59bf127b,3,41,0.5,0,0,3,30,1,1,0,0.8,1.0,-0.2,23,ITA
5a08ee41,37,3330,37.0,37,37,0,0,33,44,-11,35.5,41.3,-5.8,23,ITA
5a2cb25d,29,1998,22.2,24,11,5,4,29,27,2,30.5,25.7,4.8,23,ITA
5aa53281,35,2858,31.8,33,23,2,2,35,28,7,43.9,25.3,18.6,23,ITA
5bd72174,36,2802,31.2,33,13,3,0,28,42,-14,29.0,42.4,-13.4,23,ITA
5cbb5ad6,20,821,9.1,7,1,13,17,5,9,-4,8.8,10.0,-1.1,23,ITA
5cdddffa,30,807,9.0,8,0,22,6,10,7,3,12.2,6.7,5.5,23,ITA
5cec2c74,31,2366,26.3,28,19,3,1,24,47,-23,26.0,45.8,-19.8,23,ITA
5cf5c9ad,15,971,10.8,10,6,5,5,7,19,-12,13.2,14.7,-1.5,23,ITA
5de3866c,36,2753,30.6,31,21,5,2,42,35,7,38.5,40.0,-1.5,23,ITA
5e834dce,15,746,8.3,9,1,6,4,9,17,-8,10.0,16.7,-6.8,23,ITA
5e861944,27,1166,13.0,14,0,13,6,22,12,10,23.8,11.3,12.6,23,ITA
5eae500a,25,1660,18.4,19,10,6,1,27,16,11,33.9,18.3,15.6,23,ITA
5eaed77a,25,1813,20.1,19,18,6,9,19,36,-17,19.9,35.0,-15.1,23,ITA
5efc5389,21,1108,12.3,11,5,10,17,16,19,-3,13.6,15.4,-1.7,23,ITA
5fa57166,17,814,9.0,8,4,9,9,11,22,-11,8.3,19.3,-11.1,23,ITA
5fd5ed86,30,2634,29.3,30,24,0,3,41,31,10,39.6,33.3,6.3,23,ITA
60e3603d,2,44,0.5,0,0,2,7,0,1,-1,0.6,0.8,-0.2,23,ITA
61b3978f,18,1364,15.100000000000001,17,11,1,19,11,24,-13,11.299999999999999,22.1,-10.799999999999999,23,ITA
6213fd82,30,2173,24.1,24,17,6,1,21,38,-17,25.5,35.3,-9.8,23,ITA
62437b4f,5,152,1.7,1,0,4,3,0,2,-2,0.7,3.5,-2.8,23,ITA
6499048c,27,948,10.5,10,0,17,8,16,12,4,13.5,14.2,-0.7,23,ITA
649b01d8,25,2250,25.0,25,25,0,0,11,39,-28,21.4,37.7,-16.3,23,ITA
65fd099c,23,647,7.2,5,1,18,14,5,9,-4,7.6,9.3,-1.7,23,ITA
67f649be,9,810,9.0,9,9,0,0,7,19,-12,8.6,19.1,-10.5,23,ITA
6928979a,35,2613,29.0,31,17,4,2,51,31,20,53.1,27.3,25.7,23,ITA
6af30900,26,1923,21.4,22,14,4,7,24,24,0,23.8,31.5,-7.7,23,ITA
6b635f5c,25,2094,23.3,22,22,3,2,24,27,-3,25.2,30.2,-4.9,23,ITA
6bb2c084,36,3050,33.9,36,24,0,0,69,26,43,56.4,28.7,27.7,23,ITA
6c4307ee,1,13,0.1,0,0,1,19,0,0,0,0.1,0.4,-0.4,23,ITA
6caffe81,3,158,1.8,3,0,0,7,4,4,0,1.5,2.0,-0.5,23,ITA
6cc97b6a,25,1194,13.3,14,5,11,2,17,16,1,14.9,22.1,-7.1,23,ITA
6e058f06,26,956,10.6,10,1,16,7,17,9,8,16.9,9.6,7.3,23,ITA
6eee05f1,24,1797,20.0,20,16,4,5,27,23,4,26.1,21.6,4.5,23,ITA
6f1d7aa8,3,109,1.2,2,0,1,8,0,2,-2,2.1,2.1,0.0,23,ITA
6fdac234,32,2728,30.3,32,28,0,3,34,38,-4,35.7,41.9,-6.2,23,ITA
707b98f1,5,25,0.3,0,0,5,23,1,1,0,1.2,1.2,0.0,23,ITA
71005acd,12,231,2.6,0,0,12,17,1,4,-3,2.1,6.0,-3.9,23,ITA
71c620d7,1,4,0.0,0,0,1,1,0,0,0,0.1,0.1,0.0,23,ITA
71dc23da,15,711,7.9,8,3,7,20,9,14,-5,7.7,14.7,-7.1,23,ITA
72f87f25,7,227,2.5,2,0,5,27,3,0,3,3.0,1.8,1.2,23,ITA
74419746,14,1234,13.7,14,13,0,21,32,18,14,25.2,13.8,11.4,23,ITA
75b86fb3,29,2157,24.0,26,16,3,8,42,25,17,42.5,21.9,20.6,23,ITA
75e60d75,18,831,9.299999999999999,8,2,10,10,3,16,-13,7.4,16.200000000000003,-8.8,23,ITA
75f2c59f,34,2820,31.3,33,20,1,2,41,42,-1,37.7,42.7,-5.0,23,ITA
76b2817e,27,1535,17.1,16,7,11,2,24,24,0,22.4,24.0,-1.6,23,ITA
76ff8d0d,31,1136,12.6,13,1,18,6,15,27,-12,16.5,20.0,-3.5,23,ITA
771a2cfe,1,15,0.2,0,0,1,25,0,1,-1,0.0,0.1,-0.1,23,ITA
77d6fd4d,31,2783,30.9,31,30,0,0,34,39,-5,31.9,48.7,-16.7,23,ITA
780e3631,35,2932,32.6,34,25,1,1,44,43,1,40.3,43.4,-3.1,23,ITA
78e6bf2c,2,64,0.7,1,0,1,35,0,2,-2,0.2,0.7,-0.5,23,ITA
78f13530,14,502,5.6,7,0,7,6,7,4,3,6.9,3.9,2.9,23,ITA
79083382,15,933,10.4,10,9,5,22,20,8,12,17.6,9.6,8.0,23,ITA
79370f8c,11,461,5.1,5,0,6,5,4,5,-1,3.1,4.2,-1.1,23,ITA
79443529,27,1925,21.4,22,11,5,1,34,20,14,31.0,24.9,6.1,23,ITA
79b0d6a0,35,3150,35.0,35,35,0,1,47,35,12,52.8,28.4,24.4,23,ITA
79ca3e23,15,1061,11.8,11,7,4,1,8,15,-7,10.1,13.2,-3.1,23,ITA
7ae36711,7,342,3.8,4,1,3,5,3,7,-4,3.9,6.8,-2.9,23,ITA
7afb1573,25,1123,12.5,11,3,14,12,12,19,-7,15.8,19.2,-3.3,23,ITA
7b075c75,23,1867,20.7,22,18,1,4,28,25,3,22.6,26.0,-3.5,23,ITA
7b5f516f,1,4,0.0,0,0,1,36,1,0,1,0.3,0.0,0.3,23,ITA
7c104bb7,31,1729,19.2,20,3,11,1,38,23,15,34.7,20.9,13.8,23,ITA
7cd520e8,33,2704,30.0,31,20,2,0,35,33,2,39.0,39.7,-0.7,23,ITA
7d3cbc67,32,2460,27.3,29,20,3,1,20,48,-28,26.7,48.0,-21.3,23,ITA
7eb97a8e,18,740,8.2,8,2,10,8,16,9,7,10.6,8.5,2.2,23,ITA
7ed4921e,9,444,4.9,4,3,5,6,6,8,-2,4.2,8.7,-4.5,23,ITA
7edfbb8a,33,2760,30.7,32,26,1,1,57,29,28,50.8,31.6,19.2,23,ITA
7ef972c3,27,2195,24.4,23,19,4,4,29,39,-10,22.4,43.4,-21.0,23,ITA
7f609bfc,30,2532,28.1,30,21,0,3,42,34,8,33.8,34.4,-0.7,23,ITA
7f78ad23,35,2670,29.7,30,21,5,2,33,31,2,32.2,29.9,2.3,23,ITA
7f9d956a,1,4,0.0,0,0,1,2,1,0,1,0.3,0.0,0.3,23,ITA
7fac99d4,33,2538,28.2,28,21,5,1,25,39,-14,26.8,40.9,-14.1,23,ITA
7fe90ccd,21,1471,16.3,18,9,3,1,34,22,12,25.6,17.0,8.7,23,ITA
801831fe,18,628,7.0,4,0,14,10,5,11,-6,8.1,12.1,-4.0,23,ITA
80490d7f,33,2900,32.2,33,31,0,1,51,39,12,39.0,40.2,-1.2,23,ITA
80556f08,25,513,5.7,4,0,21,13,5,6,-1,7.8,5.2,2.6,23,ITA
817c6964,23,1657,18.4,18,10,5,5,34,17,17,29.3,20.1,9.2,23,ITA
822ed0ec,37,3101,34.5,35,29,2,1,30,42,-12,32.2,38.2,-6.0,23,ITA
82598b71,19,879,9.8,8,6,11,16,16,14,2,13.4,12.8,0.5,23,ITA
82efe6fa,33,2796,31.1,32,30,1,3,36,35,1,45.1,27.0,18.1,23,ITA
84594618,2,46,0.5,0,0,2,17,1,3,-2,0.9,1.3,-0.4,23,ITA
854ee61a,27,1167,13.0,13,0,14,0,13,24,-11,14.4,17.1,-2.7,23,ITA
85613cf0,27,1586,17.6,17,6,10,1,28,13,15,28.0,18.2,9.8,23,ITA
85a44ecc,35,2892,32.1,34,24,1,0,42,57,-15,30.6,57.2,-26.5,23,ITA
85f7d1be,34,2548,28.3,26,25,8,2,46,41,5,42.7,34.3,8.4,23,ITA
86383d0e,31,1705,18.9,20,5,11,6,15,27,-12,19.0,27.8,-8.8,23,ITA
8650af85,33,2223,24.7,24,21,9,4,27,40,-13,35.5,35.3,0.2,23,ITA
867239d3,6,111,1.2,1,0,5,3,3,0,3,2.1,1.0,1.1,23,ITA
875d65d1,2,27,0.3,0,0,2,25,1,0,1,0.5,0.1,0.5,23,ITA
8794e251,32,2748,30.5,31,27,1,0,47,27,20,44.6,30.2,14.4,23,ITA
88f53b75,6,110,1.2,0,0,6,17,3,1,2,2.1,0.9,1.3,23,ITA
89976232,30,2466,27.4,29,19,1,0,39,25,14,33.1,32.8,0.3,23,ITA
8a6de8c7,36,1636,18.2,19,3,17,1,14,20,-6,15.9,21.4,-5.5,23,ITA
8abd0c03,7,353,3.9,4,1,3,5,4,6,-2,4.4,3.8,0.7,23,ITA
8b609c34,31,2046,22.7,24,9,7,3,26,27,-1,22.6,23.6,-1.0,23,ITA
8b66d9cc,21,716,8.0,7,0,14,9,9,8,1,11.8,6.9,4.9,23,ITA
8b8a56ce,17,1007,11.2,12,4,5,16,12,7,5,13.0,12.3,0.7,23,ITA
8b95acda,16,1384,15.4,15,14,1,0,6,25,-19,13.4,22.8,-9.4,23,ITA
8bbe2df5,31,2250,25.0,24,19,7,5,31,44,-13,22.8,44.3,-21.5,23,ITA
8c63fae5,9,508,5.6,5,4,4,27,14,5,9,8.6,5.0,3.6,23,ITA
8c65eb5f,3,63,0.7,0,0,3,12,2,0,2,0.8,0.2,0.6,23,ITA
8c90fd7a,32,2566,28.5,30,13,2,0,59,17,42,49.0,20.0,29.1,23,ITA
8cabdc1e,35,3150,35.0,35,35,0,1,45,55,-10,48.4,44.0,4.4,23,ITA
8cc29864,1,19,0.2,0,0,1,11,1,2,-1,0.5,0.5,0.1,23,ITA
8d3cd59d,35,3083,34.3,35,31,0,0,45,46,-1,42.9,44.5,-1.6,23,ITA
8da74c05,37,3031,33.7,35,25,2,1,27,54,-27,30.1,45.4,-15.3,23,ITA
8daee720,8,85,0.9,0,0,8,15,1,2,-1,1.3,1.7,-0.3,23,ITA
8dfed6e9,16,726,8.1,8,1,8,2,7,13,-6,8.5,9.7,-1.2,23,ITA
8ec109e6,17,960,10.7,9,8,8,19,19,10,9,17.3,9.7,7.6,23,ITA
8ec56e62,27,2430,27.0,27,27,0,4,25,47,-22,28.1,44.3,-16.2,23,ITA
8f5cdf66,13,592,6.6,6,5,7,5,2,11,-9,4.9,9.3,-4.4,23,ITA
8f68aa41,9,306,3.4,2,1,7,28,6,8,-2,3.7,4.0,-0.3,23,ITA
8f866fe8,35,2354,26.2,27,11,8,2,19,49,-30,26.1,47.2,-21.1,23,ITA
8fef5412,1,23,0.3,0,0,1,7,0,1,-1,0.0,0.2,-0.2,23,ITA
9142b22f,1,4,0.0,0,0,1,5,0,0,0,0.1,0.1,0.0,23,ITA
91d0fabf,10,283,3.1,3,0,7,28,6,9,-3,3.4,4.1,-0.8,23,ITA
91ff775f,28,1285,14.3,12,2,16,3,20,12,8,17.5,19.7,-2.2,23,ITA
921f6058,15,759,8.4,8,6,7,2,25,15,10,17.2,10.4,6.8,23,ITA
9250bcff,22,559,6.2,3,1,19,16,9,7,2,11.1,8.0,3.1,23,ITA
93088fbb,1,9,0.1,0,0,1,4,0,0,0,0.1,0.2,-0.1,23,ITA
933d3b51,34,2424,26.9,26,19,8,3,27,30,-3,28.2,28.9,-0.7,23,ITA
9413b19f,34,3060,34.0,34,34,0,4,72,24,48,58.9,27.2,31.7,23,ITA
94816803,18,833,9.3,9,1,9,5,12,6,6,11.9,8.5,3.4,23,ITA
94b2001f,37,3184,35.4,35,35,2,0,53,25,28,51.4,36.1,15.3,23,ITA
957e4c87,16,894,9.9,11,4,5,7,15,14,1,12.3,14.8,-2.5,23,ITA
963a328b,36,1211,13.5,12,0,24,0,12,16,-4,16.7,17.7,-1.1,23,ITA
96640846,1,7,0.1,0,0,1,34,0,1,-1,0.0,0.1,-0.1,23,ITA
966eea58,37,2335,25.9,28,6,9,0,29,34,-5,30.5,36.7,-6.1,23,ITA
96e0490d,31,2025,22.5,24,10,7,5,30,22,8,37.5,19.3,18.3,23,ITA
970b8574,33,2069,23.0,26,3,7,1,50,24,26,42.2,21.1,21.2,23,ITA
9823be92,28,2070,23.0,23,15,5,3,28,22,6,24.3,23.5,0.8,23,ITA
983ff2c7,17,924,10.3,9,3,8,20,12,13,-1,13.1,12.7,0.4,23,ITA
98a84572,19,515,5.7,5,0,14,17,8,9,-1,9.1,10.5,-1.4,23,ITA
9907b1c8,13,890,9.9,12,4,1,1,7,8,-1,14.2,6.5,7.7,23,ITA
997fff07,36,3135,34.8,36,32,0,0,34,44,-10,34.9,53.5,-18.6,23,ITA
9ba7b4fa,20,930,10.3,9,7,11,4,15,14,1,13.0,13.5,-0.4,23,ITA
9c435456,4,90,1.0,0,0,4,29,3,2,1,1.7,1.7,0.1,23,ITA
9d4c45d6,27,1326,14.7,15,3,12,2,20,13,7,15.8,17.6,-1.8,23,ITA
9d60028d,18,548,6.1,7,0,11,9,4,10,-6,5.1,7.6,-2.5,23,ITA
9e1577aa,33,2551,28.3,30,21,3,5,37,35,2,39.2,34.4,4.8,23,ITA
9ef42479,16,1030,11.4,13,3,3,3,10,17,-7,10.9,15.5,-4.6,23,ITA
9f1893b9,38,2958,32.9,35,23,3,0,48,24,24,44.1,35.7,8.3,23,ITA
9f5a610b,38,3420,38.0,38,38,0,0,33,46,-13,36.1,42.1,-6.1,23,ITA
9f84febe,13,711,7.9,8,2,5,3,10,8,2,12.3,7.3,5.0,23,ITA
9fa26bc2,38,3420,38.0,38,38,0,0,42,41,1,41.8,40.0,1.8,23,ITA
a0aee24e,4,58,0.6,0,0,4,1,0,2,-2,0.1,1.4,-1.3,23,ITA
a111cf41,24,2077,23.1,24,23,0,10,41,27,14,36.5,23.5,13.1,23,ITA
a14d0ab0,5,62,0.7,0,0,5,27,1,1,0,2.7,1.1,1.6,23,ITA
a2565f79,1,90,1.0,1,1,0,32,3,2,1,1.2,2.3,-1.1,23,ITA
a26fb8aa,33,2858,31.8,32,29,1,0,57,36,21,47.3,33.3,14.0,23,ITA
a2d9f138,30,1947,21.6,21,9,9,8,27,39,-12,29.1,26.7,2.3,23,ITA
a3695ac2,5,77,0.9,0,0,5,13,0,1,-1,0.4,1.8,-1.4,23,ITA
a378a02a,23,1711,19.0,21,12,2,12,25,31,-6,24.6,23.0,1.6,23,ITA
a40819d9,7,259,2.9,5,1,2,19,4,3,1,2.5,2.6,-0.1,23,ITA
a44d3a3c,18,465,5.2,4,0,14,8,8,5,3,6.7,5.8,0.9,23,ITA
a47c6309,12,200,2.3,1,0,11,19,3,5,-2,3.2,5.699999999999999,-2.5,23,ITA
a4948e67,31,2653,29.5,29,26,2,0,26,43,-17,32.0,47.4,-15.3,23,ITA
a4e85758,27,2057,22.9,23,18,4,7,26,24,2,33.0,26.7,6.3,23,ITA
a5296e55,37,2287,25.4,27,3,10,1,57,21,36,46.6,22.8,23.8,23,ITA
a69cc629,21,728,8.1,7,0,14,15,9,10,-1,8.6,10.7,-2.1,23,ITA
a69e4806,32,1605,17.8,20,1,12,1,39,8,31,29.3,11.9,17.4,23,ITA
a820e429,28,1432,15.9,15,5,13,6,25,17,8,24.6,18.1,6.5,23,ITA
a8a874f1,32,2446,27.2,29,16,3,2,40,19,21,40.5,27.8,12.7,23,ITA
a9202def,35,2215,24.6,25,10,10,1,37,31,6,36.8,27.3,9.5,23,ITA
a96e5dc0,31,2672,29.7,29,27,2,2,32,48,-16,39.9,39.4,0.5,23,ITA
a9aa0d1d,29,2089,23.2,24,12,5,1,29,24,5,23.1,22.6,0.5,23,ITA
aa54ec6f,30,2487,27.6,28,25,2,1,37,37,0,33.6,38.6,-5.0,23,ITA
aa8e289e,34,2728,30.3,29,23,5,0,33,30,3,33.6,33.7,-0.2,23,ITA
aae9d04a,23,1485,16.5,19,8,4,3,12,36,-24,16.4,26.4,-10.0,23,ITA
ab1ca213,22,1163,12.9,14,3,8,5,11,16,-5,13.3,16.0,-2.6,23,ITA
ab4449d6,37,3330,37.0,37,37,0,0,50,49,1,43.2,47.9,-4.7,23,ITA
ab472696,22,368,4.1,1,0,21,13,6,9,-3,4.8,6.3,-1.5,23,ITA
ac4003af,15,1339,14.9,14,13,1,22,24,21,3,20.8,17.9,2.9,23,ITA
ac4a4508,35,2442,27.1,30,4,5,0,25,35,-10,24.7,30.0,-5.3,23,ITA
ac7e640b,20,1253,13.9,13,11,7,15,10,22,-12,12.2,27.5,-15.3,23,ITA
acf7e795,9,406,4.5,4,3,5,10,6,5,1,4.9,6.6,-1.7,23,ITA
ad92526f,27,1412,15.7,14,5,13,6,19,29,-10,18.1,26.3,-8.1,23,ITA
ae4e2852,17,1042,11.6,11,4,6,2,17,8,9,13.4,12.4,0.9,23,ITA
ae94a6c5,22,992,11.0,10,4,12,16,12,13,-1,13.0,12.7,0.3,23,ITA
ae9898c5,15,829,9.2,8,8,7,13,19,13,6,16.2,9.5,6.8,23,ITA
b033f803,3,66,0.7,0,0,3,15,1,0,1,0.5,1.2,-0.7,23,ITA
b056e3da,16,1440,16.0,16,16,0,22,26,22,4,23.4,19.0,4.4,23,ITA
b09a3ecc,32,1060,11.8,10,0,22,4,18,20,-2,14.5,18.3,-3.8,23,ITA
b0f7e36c,21,852,9.5,6,1,15,0,14,10,4,14.9,10.0,4.9,23,ITA
b1236c63,21,638,7.1,5,4,16,12,13,8,5,8.1,8.0,0.1,23,ITA
b136c945,12,586,6.5,6,3,6,10,6,17,-11,6.2,12.8,-6.7,23,ITA
b1cd37e6,37,2564,28.5,33,12,4,1,38,32,6,38.7,34.4,4.4,23,ITA
b233e8e4,20,1057,11.7,12,5,8,12,7,23,-16,8.1,19.2,-11.0,23,ITA
b2561711,2,27,0.3,0,0,2,18,0,1,-1,0.2,0.9,-0.7,23,ITA
b35a7399,7,419,4.7,4,4,3,31,8,3,5,9.7,3.9,5.8,23,ITA
b3a20f18,25,2132,23.7,22,20,3,9,26,47,-21,25.9,42.9,-17.0,23,ITA
b3ef6517,9,99,1.1,0,0,9,22,0,2,-2,1.2,1.1,0.0,23,ITA
b4101c2e,4,36,0.4,0,0,4,15,0,1,-1,0.4,0.9,-0.5,23,ITA
b5f7d10b,33,2331,25.9,28,16,5,2,38,28,10,38.6,29.3,9.2,23,ITA
b6964eb6,32,2808,31.2,31,30,1,2,45,27,18,50.9,25.0,25.9,23,ITA
b6a1cdf9,20,256,2.8,1,0,19,18,6,2,4,5.9,3.3,2.6,23,ITA
b6baba31,5,36,0.4,0,0,5,8,0,1,-1,0.5,0.8,-0.3,23,ITA
b70bde8f,28,1618,18.0,21,4,7,5,17,25,-8,19.3,22.4,-3.1,23,ITA
b804c280,1,18,0.2,0,0,1,3,0,0,0,0.1,0.5,-0.4,23,ITA
b85bf253,9,523,5.8,6,2,3,6,4,11,-7,5.5,9.2,-3.7,23,ITA
b959a0d1,2,180,2.0,2,2,0,31,4,3,1,2.0,2.6,-0.6,23,ITA
b96b595c,31,2425,26.9,25,24,6,3,53,30,23,49.5,26.6,22.9,23,ITA
b9e11c1d,1,90,1.0,1,1,0,35,0,0,0,1.2,1.2,0.0,23,ITA
ba1e04b3,17,876,9.7,11,4,6,21,17,17,0,14.7,12.3,2.4,23,ITA
ba3d3bea,29,1921,21.3,26,4,3,2,37,15,22,30.1,22.4,7.7,23,ITA
ba492306,12,318,3.5,1,0,11,15,7,0,7,6.8,2.8,4.0,23,ITA
bb376bed,25,2028,22.6,23,16,2,3,28,26,2,23.8,20.0,3.7,23,ITA
bba30585,9,573,6.4,5,5,4,6,12,7,5,11.9,6.4,5.5,23,ITA
bcc81786,30,2372,26.4,26,22,4,0,21,42,-21,32.0,41.6,-9.6,23,ITA
bcf5058a,3,270,3.0,3,3,0,35,3,3,0,4.6,3.7,0.9,23,ITA
bdc74a8f,15,696,7.7,8,1,7,2,5,14,-9,6.5,12.1,-5.6,23,ITA
be2706c0,29,1719,19.1,18,12,11,6,24,21,3,23.1,18.8,4.3,23,ITA
bee704fc,27,2137,23.7,23,21,4,9,34,27,7,35.4,27.0,8.5,23,ITA
bf57eaab,24,1119,12.4,12,3,12,14,9,14,-5,10.6,22.4,-11.7,23,ITA
bfc359ed,1,6,0.1,0,0,1,8,0,0,0,0.1,0.2,-0.1,23,ITA
c13ddd3e,13,420,4.7,4,0,9,21,6,0,6,7.5,3.3,4.2,23,ITA
c1d95617,37,3330,37.0,37,37,0,0,31,59,-28,34.7,48.8,-14.1,23,ITA
c20892ee,2,20,0.2,0,0,2,17,1,1,0,0.4,0.5,-0.2,23,ITA
c2357b65,20,1393,15.5,17,9,3,3,14,24,-10,16.0,23.3,-7.3,23,ITA
c235e803,12,613,6.8,6,5,6,24,11,14,-3,10.3,10.4,-0.1,23,ITA
c283ddef,33,1983,22.0,23,7,10,1,14,35,-21,20.2,38.2,-18.1,23,ITA
c316607a,16,983,10.9,14,7,2,3,5,20,-15,7.2,18.0,-10.9,23,ITA
c39babc1,1,1,0.0,0,0,1,1,0,0,0,0.1,0.2,-0.1,23,ITA
c414df9d,16,453,5.0,4,0,12,21,5,7,-2,5.4,7.9,-2.6,23,ITA
c459a650,34,2209,24.5,25,12,9,2,39,33,6,36.7,30.4,6.3,23,ITA
c55967eb,11,171,1.9,1,0,10,6,0,6,-6,1.2,4.3,-3.1,23,ITA
c56dc39e,32,2784,30.9,32,25,0,1,54,36,18,45.0,33.2,11.8,23,ITA
c609e90e,6,288,3.2,2,0,4,14,2,4,-2,2.7,5.0,-2.3,23,ITA
c69ef855,35,2376,26.4,26,13,9,2,22,29,-7,24.6,28.8,-4.2,23,ITA
c6e8cf1f,16,1195,13.3,13,12,3,0,13,18,-5,13.7,17.4,-3.7,23,ITA
c7069d87,33,2265,25.2,27,9,6,4,28,44,-16,22.9,45.8,-22.8,23,ITA
c7259b83,29,1950,21.7,22,11,7,5,29,22,7,32.8,23.3,9.5,23,ITA
c730da00,1,20,0.2,1,0,0,9,0,1,-1,0.0,0.7,-0.6,23,ITA
c74d63ac,32,2486,27.6,28,23,4,4,24,28,-4,26.4,27.1,-0.7,23,ITA
c83c203f,24,832,9.2,9,0,15,5,15,13,2,9.1,18.2,-9.2,23,ITA
c84dcc88,1,1,0.0,0,0,1,1,0,0,0,0.1,0.0,0.1,23,ITA
c8ad0857,25,1839,20.4,22,9,3,7,21,33,-12,21.1,32.2,-11.1,23,ITA
ca6edaa0,6,151,1.7,1,0,5,28,1,2,-1,2.6,1.4,1.2,23,ITA
ca73910d,6,231,2.6,3,1,3,3,0,4,-4,1.7,2.1,-0.5,23,ITA
caec77da,26,1941,21.6,23,12,3,11,25,38,-13,17.2,35.2,-18.0,23,ITA
cc1a0c57,5,334,3.7,4,3,1,24,6,4,2,7.0,5.7,1.3,23,ITA
cce9f582,24,1532,17.0,19,10,5,5,14,24,-10,16.1,23.1,-7.0,23,ITA
cd0fa27b,33,2363,26.3,28,12,5,2,56,25,31,47.1,22.0,25.1,23,ITA
cdf65d12,28,1592,17.7,18,10,10,5,15,26,-11,20.2,25.1,-4.9,23,ITA
ce1a6c7e,2,15,0.2,0,0,2,6,1,0,1,0.2,0.0,0.2,23,ITA
ce30bfc8,19,783,8.7,7,5,12,16,16,9,7,11.8,10.2,1.5,23,ITA
cf007308,36,1627,18.1,14,4,22,1,35,10,25,29.3,14.5,14.8,23,ITA
cf961d8d,36,2958,32.9,34,27,2,0,28,53,-25,35.4,50.4,-15.0,23,ITA
d023d70f,32,1886,21.0,22,10,10,5,22,26,-4,24.9,23.4,1.5,23,ITA
d0d8dd44,27,1945,21.6,22,18,5,11,41,25,16,37.8,20.5,17.3,23,ITA
d0dbca9f,28,1875,20.799999999999997,23,12,5,7,14,39,-25,17.9,32.9,-14.8,23,ITA
d125f22f,33,2266,25.2,25,9,8,2,23,41,-18,27.3,43.8,-16.5,23,ITA
d183e9d6,20,784,8.7,5,4,15,15,4,17,-13,7.6,19.0,-11.4,23,ITA
d19ef4ef,10,198,2.2,2,0,8,28,5,3,2,2.9,3.9,-1.0,23,ITA
d3298c99,25,998,11.1,11,0,14,7,8,20,-12,14.5,18.8,-4.3,23,ITA
d3aaad90,29,1523,16.9,14,5,15,5,35,16,19,32.2,16.0,16.2,23,ITA
d3de9af0,25,1390,15.4,16,5,9,0,18,20,-2,17.7,18.2,-0.5,23,ITA
d44360be,35,2263,25.1,28,3,7,1,24,27,-3,24.9,34.7,-9.8,23,ITA
d4456fb3,35,2962,32.9,34,30,1,1,31,44,-13,32.3,36.2,-3.9,23,ITA
d4535821,33,2760,30.7,31,23,2,1,47,25,22,39.6,33.8,5.8,23,ITA
d4a2533d,6,229,2.5,1,1,5,11,4,1,3,5.1,2.0,3.1,23,ITA
d4c9725f,32,2771,30.8,32,27,0,2,56,31,25,48.9,30.5,18.4,23,ITA
d65cf468,7,153,1.7,2,0,5,30,3,1,2,2.6,1.8,0.9,23,ITA
d705ba44,31,1146,12.7,11,2,20,2,19,17,2,21.9,10.0,11.9,23,ITA
d7918b13,25,1007,11.2,11,0,14,12,10,19,-9,11.2,20.4,-9.2,23,ITA
d7a35008,9,810,9.0,9,9,0,20,6,23,-17,7.9,19.5,-11.6,23,ITA
d7d32194,17,572,6.4,6,1,11,5,5,11,-6,6.5,10.8,-4.3,23,ITA
d810c13b,23,1653,18.4,17,14,6,13,13,30,-17,17.4,33.9,-16.5,23,ITA
d85c238b,35,2770,30.8,33,17,2,0,50,23,27,39.5,34.6,4.9,23,ITA
d8800a46,9,365,4.1,4,2,5,8,5,10,-5,3.5,7.0,-3.5,23,ITA
d9624b51,22,1417,15.7,18,6,4,8,15,23,-8,11.8,18.0,-6.2,23,ITA
d97f2e8d,34,2309,25.6,25,19,9,3,20,44,-24,24.5,35.5,-11.0,23,ITA
d995ed27,30,1911,21.2,21,9,9,3,28,25,3,27.9,26.2,1.7,23,ITA
d9ebed1c,14,530,5.9,5,1,9,20,6,9,-3,6.3,7.8,-1.5,23,ITA
da5a981b,6,112,1.2,1,0,5,22,0,4,-4,0.1,3.1,-3.0,23,ITA
daa4c94c,1,5,0.1,0,0,1,30,1,0,1,0.9,0.0,0.9,23,ITA
db092d3b,28,2007,22.3,24,13,4,1,38,21,17,34.8,23.1,11.7,23,ITA
dbfa4f16,17,411,4.6,4,0,13,18,3,5,-2,4.4,5.6,-1.2,23,ITA
dc3e663e,17,1443,16.0,17,13,0,1,16,27,-11,15.3,26.6,-11.3,23,ITA
dc3fa3b5,7,146,1.6,2,0,5,24,1,0,1,1.3,1.0,0.3,23,ITA
dc765618,12,222,2.5,2,0,10,24,1,4,-3,2.0,3.7,-1.7,23,ITA
dcb38abe,26,1587,17.6,19,7,7,2,15,36,-21,18.4,33.3,-14.9,23,ITA
dd0daf32,31,1986,22.1,24,6,7,1,44,18,26,41.9,18.0,23.9,23,ITA
dd403465,13,734,8.2,10,2,3,5,9,12,-3,6.7,14.1,-7.4,23,ITA
dd7febd8,32,2317,25.7,27,18,5,4,25,50,-25,27.7,45.5,-17.8,23,ITA
dd86e8e4,12,587,6.5,5,4,7,26,6,9,-3,6.4,12.8,-6.4,23,ITA
de0f152c,14,789,8.8,8,5,6,6,12,14,-2,11.6,14.8,-3.1,23,ITA
dea88efd,34,2518,28.0,30,8,4,0,58,21,37,49.9,23.1,26.8,23,ITA
dee3d535,2,16,0.2,0,0,2,17,0,1,-1,0.3,0.9,-0.6,23,ITA
dfd24c07,2,96,1.1,1,0,1,13,0,2,-2,0.6,1.5,-0.9,23,ITA
dff153a4,25,977,10.9,8,3,17,4,15,12,3,17.4,15.4,2.0,23,ITA
e04dca4a,1,79,0.9,1,0,0,15,0,1,-1,0.5,1.2,-0.7,23,ITA
e0921a4f,25,1739,19.3,21,7,4,1,35,21,14,32.8,14.7,18.0,23,ITA
e0f8151c,35,3050,33.9,35,30,0,2,70,24,46,57.0,27.9,29.1,23,ITA
e14ec482,32,2124,23.6,22,12,10,2,31,31,0,28.1,30.3,-2.1,23,ITA
e1b0a70d,29,2610,29.0,29,29,0,8,35,38,-3,41.6,34.2,7.4,23,ITA
e1cbb531,38,3101,34.5,34,20,4,0,75,27,48,60.1,29.1,31.0,23,ITA
e26fcca3,13,727,8.1,7,3,6,3,6,11,-5,10.4,14.4,-4.0,23,ITA
e288d4b3,6,203,2.3,2,1,4,8,3,1,2,4.1,1.9,2.2,23,ITA
e33f36d5,25,1883,20.900000000000002,22,14,3,8,19,37,-18,21.6,37.2,-15.6,23,ITA
e3756e72,18,496,5.5,3,0,15,20,10,8,2,7.1,6.9,0.3,23,ITA
e3cceee6,28,1536,17.1,14,12,14,6,24,23,1,26.5,17.9,8.5,23,ITA
e58cbfd5,28,1767,19.6,21,9,7,1,31,20,11,24.5,23.2,1.3,23,ITA
e599253a,32,1769,19.7,24,1,8,2,33,24,9,30.9,22.3,8.6,23,ITA
e5bf73f3,32,1960,21.8,26,9,6,2,26,31,-5,21.6,31.0,-9.4,23,ITA
e613313c,30,2326,25.8,28,21,2,4,26,29,-3,28.6,25.1,3.4,23,ITA
e66ebabb,1,26,0.3,0,0,1,34,0,0,0,0.3,0.8,-0.5,23,ITA
e74f0e59,15,672,7.5,6,3,9,17,10,11,-1,7.8,8.9,-1.0,23,ITA
e892c325,1,10,0.1,0,0,1,23,0,1,-1,0.2,0.2,0.0,23,ITA
e9c0c1b2,24,2160,24.0,24,24,0,14,39,24,15,42.5,21.8,20.7,23,ITA
ea02beaf,31,1321,14.7,12,4,19,3,12,15,-3,17.2,14.0,3.3,23,ITA
ea468ea8,2,135,1.5,2,1,0,6,1,4,-3,1.7,2.6,-0.9,23,ITA
eb0ec070,27,1958,21.8,23,10,4,1,28,34,-6,21.9,34.7,-12.8,23,ITA
eb2fe5b6,29,1073,11.9,10,0,19,2,20,15,5,17.9,11.9,6.0,23,ITA
eb3022c3,11,355,3.9,4,1,7,17,7,5,2,6.7,4.2,2.5,23,ITA
eb58eef0,14,769,8.5,10,4,4,2,14,9,5,14.2,8.3,6.0,23,ITA
eb76987d,5,136,1.5,0,0,5,27,1,3,-2,1.7,3.2,-1.5,23,ITA
eb7822d7,35,1852,20.6,16,11,19,1,34,23,11,33.8,20.2,13.7,23,ITA
ec52b661,37,2785,30.9,31,21,6,0,32,53,-21,33.0,52.2,-19.2,23,ITA
ec5dae45,13,299,3.3000000000000003,2,0,11,20,4,6,-2,5.3,5.6,-0.19999999999999998,23,ITA
eccbe56a,32,2171,24.1,27,6,5,1,16,47,-31,21.4,39.3,-17.9,23,ITA
ed5c0319,33,2129,23.7,23,11,10,0,25,31,-6,31.2,32.7,-1.5,23,ITA
ed90babd,2,15,0.2,0,0,2,0,1,0,1,0.3,0.0,0.3,23,ITA
edd81e2a,24,1683,18.7,19,14,5,8,24,30,-6,19.2,34.7,-15.5,23,ITA
ee251371,30,1403,15.6,14,0,16,1,21,16,5,23.3,16.4,6.9,23,ITA
ee4f2f3b,23,800,8.9,7,0,16,10,6,21,-15,8.7,18.8,-10.0,23,ITA
ee64a822,32,2314,25.7,27,15,5,4,40,30,10,30.5,32.8,-2.3,23,ITA
ee9040b4,5,198,2.2,2,0,3,24,1,5,-4,2.2,1.7,0.6,23,ITA
ef6eef89,11,444,4.9,3,1,8,25,3,11,-8,4.7,9.0,-4.3,23,ITA
ef94dc2f,2,28,0.3,0,0,2,2,1,2,-1,0.4,1.2,-0.8,23,ITA
efc9e31f,29,1912,21.2,21,6,8,2,28,22,6,23.0,28.4,-5.4,23,ITA
efdeaff3,5,450,5.0,5,5,0,33,13,3,10,8.5,4.1,4.4,23,ITA
f025eade,35,2197,24.4,26,5,9,2,21,29,-8,20.4,25.1,-4.6,23,ITA
f052fb01,3,24,0.3,0,0,3,5,1,1,0,0.6,0.4,0.2,23,ITA
f058ed1f,2,180,2.0,2,2,0,36,1,3,-2,2.1,4.1,-2.0,23,ITA
f0f7f62f,7,630,7.0,7,7,0,25,8,6,2,9.2,7.8999999999999995,1.3,23,ITA
f1cfc209,34,2555,28.4,30,17,4,2,18,56,-38,24.9,48.9,-23.9,23,ITA
f1f1f238,23,1779,19.7,19,17,4,6,17,42,-25,19.8,34.7,-15.0,23,ITA
f3a9fa26,29,980,10.9,7,1,22,7,10,23,-13,12.3,19.4,-7.1,23,ITA
f42d6c13,37,1759,19.5,15,5,22,1,17,33,-16,20.6,30.5,-9.899999999999999,23,ITA
f449640d,10,523,5.8,5,5,5,24,6,8,-2,8.4,7.6,0.9,23,ITA
f4797849,14,1024,11.4,12,10,2,13,9,17,-8,9.8,22.1,-12.3,23,ITA
f49c4ae9,25,1498,16.6,19,3,6,4,32,19,13,23.4,16.1,7.4,23,ITA
f503ea63,31,1734,19.3,18,8,13,1,14,29,-15,26.0,28.1,-2.1,23,ITA
f554e29b,1,90,1.0,1,1,0,37,0,3,-3,1.4,2.4,-1.1,23,ITA
f573a8bf,30,1815,20.2,21,4,9,0,28,22,6,26.6,28.8,-2.2,23,ITA
f586779e,38,2189,24.3,24,7,14,0,32,25,7,37.7,22.9,14.8,23,ITA
f61c7c4e,1,37,0.4,0,0,1,0,0,0,0,0.2,0.8,-0.7,23,ITA
f7036e1c,38,2576,28.6,27,18,11,0,59,37,22,53.1,27.0,26.1,23,ITA
f71ad8cb,33,2483,27.6,30,16,3,2,26,46,-20,28.6,44.3,-15.7,23,ITA
f7223718,18,1413,15.7,16,13,2,17,30,7,23,24.1,16.9,7.2,23,ITA
f778fe3f,5,316,3.5,5,0,0,16,2,4,-2,1.9,4.1,-2.2,23,ITA
f794b426,1,66,0.7,0,0,1,16,0,2,-2,1.2,0.9,0.3,23,ITA
f7c491f1,34,2818,31.3,33,24,1,0,38,39,-1,37.9,43.2,-5.3,23,ITA
f7e2af2c,4,167,1.9,1,1,3,15,2,7,-5,1.9,4.1,-2.1,23,ITA
f86cd5df,9,240,2.7,2,1,7,24,4,3,1,4.2,3.1,1.1,23,ITA
f95f49d2,22,860,9.6,8,0,14,14,8,14,-6,10.6,11.8,-1.1,23,ITA
f9758dae,35,2810,31.2,35,11,0,0,26,45,-19,32.1,45.1,-13.0,23,ITA
f9c927de,32,1542,17.1,18,5,14,6,23,26,-3,16.9,21.6,-4.8,23,ITA
fa449bba,24,1156,12.8,12,2,12,11,9,17,-8,10.6,21.0,-10.4,23,ITA
fb77bfef,13,902,10.0,9,7,4,12,16,17,-1,12.0,13.5,-1.5,23,ITA
fcb38f57,22,1978,22.0,22,21,0,0,37,21,16,34.3,22.1,12.2,23,ITA
fdf4b948,24,1356,15.1,16,2,8,0,17,20,-3,17.3,22.2,-5.0,23,ITA
fe012aca,23,782,8.7,5,1,18,10,19,14,5,14.9,9.0,5.9,23,ITA
ff579c7e,26,1226,13.6,12,5,14,9,23,16,7,17.1,19.5,-2.5,23,ITA
ff5ea0bf,20,1362,15.1,15,11,5,13,21,12,9,24.7,13.8,11.0,23,ITA
ffed43e3,4,220,2.4,2,2,2,6,2,5,-3,3.4,4.7,-1.2,23,ITA
00891164,36,3095,34.4,35,32,1,0,31,73,-42,39.1,55.9,-16.8,23,FRA
00a8d210,37,2833,31.5,31,18,6,0,57,21,36,52.8,35.6,17.1,23,FRA
01870104,27,651,7.2,6,1,21,8,15,8,7,14.1,8.5,5.6,23,FRA
01becd60,15,258,2.9,1,0,14,12,5,6,-1,6.5,2.9,3.6,23,FRA
01fd01e8,24,1656,18.400000000000002,18,15,6,8,15,24,-9,24.0,27.6,-3.5,23,FRA
02bcaf8e,26,800,8.9,5,1,21,10,11,8,3,14.5,11.5,3.0,23,FRA
032f894e,23,717,8.0,6,1,17,1,18,9,9,16.7,10.5,6.2,23,FRA
03e91055,2,23,0.3,0,0,2,2,0,0,0,0.1,0.6,-0.5,23,FRA
0400dd2f,19,863,9.6,9,1,10,3,12,7,5,15.5,10.8,4.7,23,FRA
04ac78d2,17,1503,16.7,16,15,1,9,20,23,-3,19.0,24.9,-5.8,23,FRA
04bb2b06,37,1577,17.5,15,5,22,1,24,23,1,19.0,25.1,-6.2,23,FRA
0512a60a,28,2297,25.5,25,20,3,9,33,34,-1,30.5,29.9,0.6,23,FRA
061266cd,14,781,8.7,8,5,6,23,8,13,-5,9.6,12.4,-2.8,23,FRA
065dc209,34,2714,30.200000000000003,32,15,2,0,47,40,7,42.9,44.5,-1.5999999999999996,23,FRA
06c48679,33,2823,31.4,33,26,0,0,61,27,34,56.4,34.7,21.7,23,FRA
06df8256,11,839,9.3,9,8,2,2,20,15,5,14.5,15.2,-0.7,23,FRA
07ace8c3,4,64,0.7,0,0,4,0,2,1,1,0.9,1.6,-0.7,23,FRA
0810b6df,7,630,7.0,7,7,0,12,10,14,-4,11.4,11.2,0.2,23,FRA
08511d65,33,2704,30.0,31,26,2,0,72,32,40,59.5,38.7,20.8,23,FRA
08f5afaa,38,3409,37.9,38,37,0,0,89,40,49,78.1,48.3,29.8,23,FRA
095e4199,23,1000,11.1,12,0,11,14,12,7,5,17.2,15.2,2.0,23,FRA
0a63446f,26,1361,15.1,14,9,12,6,7,30,-23,12.0,20.8,-8.8,23,FRA
0af4dcf0,3,59,0.7,0,0,3,2,1,1,0,1.5,1.6,-0.1,23,FRA
0b2c9aec,28,905,10.1,6,2,22,2,13,15,-2,18.4,13.0,5.4,23,FRA
0b4d8274,19,1079,12.0,14,1,5,1,12,25,-13,16.9,16.2,0.7,23,FRA
0b4f388a,32,1859,20.7,19,11,13,0,39,32,7,33.0,29.7,3.3,23,FRA
0be95d34,27,1422,15.8,16,0,11,0,24,23,1,23.1,24.6,-1.5,23,FRA
0bfca6a1,24,1791,19.9,22,8,2,1,19,28,-9,24.3,26.7,-2.3,23,FRA
0cbc8baa,34,2515,27.9,27,22,7,4,34,39,-5,33.8,38.4,-4.6,23,FRA
0d7b6576,33,2513,27.9,29,9,4,0,46,43,3,36.3,41.9,-5.6,23,FRA
0e12089d,38,3420,38.0,38,38,0,0,51,57,-6,52.5,57.0,-4.5,23,FRA
0e46fa2f,30,913,10.2,8,1,22,5,12,14,-2,14.6,14.600000000000001,0.0,23,FRA
0e7ccfc4,22,786,8.7,6,2,16,12,10,16,-6,7.3,14.0,-6.7,23,FRA
0e8d7b6c,5,96,1.1,0,0,5,7,2,2,0,3.1,1.5,1.6,23,FRA
0ed063d6,30,1797,20.0,21,9,9,6,21,45,-24,21.7,42.5,-20.7,23,FRA
0f8418aa,26,1310,14.6,13,5,13,2,18,21,-3,17.6,20.4,-2.8,23,FRA
0f86995c,2,15,0.2,0,0,2,2,0,0,0,0.3,0.1,0.2,23,FRA
0ff630d0,28,1953,21.7,23,17,5,8,27,30,-3,27.5,32.199999999999996,-4.7,23,FRA
102c9665,21,1612,17.9,16,15,5,15,31,25,6,33.0,19.4,13.6,23,FRA
104b4ad3,10,257,2.9,2,0,8,6,1,6,-5,3.6,6.1,-2.4,23,FRA
10dd88f9,37,1391,15.5,15,0,22,0,15,25,-10,17.2,26.3,-9.1,23,FRA
10f0fdd3,30,2419,26.9,29,18,1,0,37,45,-8,33.5,38.7,-5.2,23,FRA
114bbdee,1,90,1.0,1,1,0,4,2,1,1,1.2,1.4,-0.2,23,FRA
11f54bd5,12,372,4.1,4,0,8,3,3,4,-1,6.0,7.5,-1.5,23,FRA
1237c049,6,193,2.1,1,0,5,1,1,5,-4,1.1,2.5,-1.3,23,FRA
1361e5bc,9,572,6.4,6,5,3,7,5,10,-5,8.2,11.3,-3.1,23,FRA
1467af0d,29,2194,24.4,27,14,2,0,59,26,33,55.0,31.1,23.9,23,FRA
148e136f,32,2525,28.1,28,15,4,1,45,25,20,52.5,25.0,27.5,23,FRA
15944afd,23,1175,13.1,13,7,10,11,20,21,-1,19.6,19.5,0.1,23,FRA
16aa7d4c,30,2491,27.7,27,27,3,2,31,37,-6,33.6,36.0,-2.4,23,FRA
17e25e72,3,24,0.3,0,0,3,6,0,2,-2,0.3,1.3,-1.0,23,FRA
1880614f,37,2490,27.7,28,14,9,1,51,27,24,46.8,27.0,19.9,23,FRA
18ebca4b,6,254,2.8,3,1,3,0,3,9,-6,2.8,5.8,-3.0,23,FRA
19053e31,23,1293,14.299999999999999,15,3,8,2,23,11,12,24.8,17.2,7.5,23,FRA
1956b948,36,2244,24.9,25,11,11,0,24,33,-9,30.4,38.0,-7.6,23,FRA
1961b2aa,26,1629,18.1,18,11,8,0,35,20,15,33.2,17.6,15.6,23,FRA
19ba6c6d,23,1655,18.4,20,10,3,1,26,18,8,23.1,24.5,-1.3,23,FRA
1a066e69,23,1646,18.3,18,15,5,4,24,29,-5,23.0,34.8,-11.8,23,FRA
1a248246,23,1506,16.8,19,2,4,1,18,33,-15,21.8,24.2,-2.4000000000000004,23,FRA
1a2935f6,17,1459,16.2,17,14,0,0,27,20,7,25.3,23.3,2.1,23,FRA
1a6b7ea4,31,1767,19.6,17,11,14,6,22,26,-4,28.2,23.5,4.7,23,FRA
1a85bcdb,30,2459,27.3,27,25,3,4,15,57,-42,23.9,40.7,-16.8,23,FRA
1b5b32d2,2,20,0.2,0,0,2,7,0,1,-1,0.0,0.4,-0.4,23,FRA
1b729a98,1,82,0.9,0,0,1,5,1,0,1,0.5,0.5,0.0,23,FRA
1bd5bdc4,3,19,0.2,0,0,3,1,0,0,0,0.0,0.1,-0.1,23,FRA
1bfb6fef,33,2653,29.5,29,25,4,1,48,33,15,52.9,32.7,20.2,23,FRA
1d2d5cc8,34,3014,33.5,34,32,0,1,62,31,31,55.3,38.1,17.2,23,FRA
1d383c10,1,9,0.1,0,0,1,1,0,0,0,0.2,0.4,-0.2,23,FRA
1d5c96f8,27,2257,25.1,26,18,1,2,36,35,1,36.1,35.1,1.0,23,FRA
1ddbc7ca,33,2456,27.3,28,19,5,2,31,32,-1,39.5,35.8,3.7,23,FRA
1df4a109,26,1330,14.8,14,5,12,11,23,17,6,22.4,19.5,2.9,23,FRA
1e52971c,31,1933,21.5,21,11,10,6,30,25,5,32.4,28.0,4.4,23,FRA
1e7aea56,32,2798,31.1,32,31,0,3,19,60,-41,30.1,43.7,-13.6,23,FRA
1e93fc5d,2,36,0.4,0,0,2,6,1,0,1,0.8,0.0,0.7,23,FRA
1ec7e1c5,7,338,3.8,3,2,4,11,6,6,0,7.4,4.1,3.3,23,FRA
1f6298f2,1,4,0.0,0,0,1,3,0,0,0,0.4,0.0,0.4,23,FRA
2054d037,30,1482,16.5,17,2,13,0,11,31,-20,19.2,27.6,-8.4,23,FRA
20b9f052,33,2925,32.5,32,32,1,2,59,34,25,56.9,36.8,20.1,23,FRA
20e0dd86,33,2009,22.3,25,7,8,1,8,42,-34,18.4,31.5,-13.1,23,FRA
20e73fac,37,3065,34.1,37,16,0,0,64,35,29,55.3,39.1,16.1,23,FRA
2180c761,13,583,6.5,6,2,7,19,9,12,-3,10.3,12.0,-1.7,23,FRA
22396615,1,20,0.2,0,0,1,2,0,0,0,0.1,0.6,-0.6,23,FRA
22bfb57e,15,1064,11.8,12,7,3,0,9,14,-5,12.6,16.0,-3.4,23,FRA
2321ea6e,37,3330,37.0,37,37,0,1,52,52,0,43.4,57.2,-13.8,23,FRA
23c63b7f,32,1579,17.599999999999998,16,5,16,1,21,30,-9,21.1,23.299999999999997,-2.2,23,FRA
2434f24a,19,1710,19.0,19,19,0,0,16,41,-25,18.6,31.0,-12.4,23,FRA
25749008,32,2162,24.0,26,7,6,0,33,31,2,32.7,32.8,0.0,23,FRA
2677a1de,27,1635,18.2,20,5,7,2,30,28,2,23.6,28.1,-4.4,23,FRA
279ddf6a,34,2426,27.0,25,23,9,3,28,57,-29,25.4,59.8,-34.4,23,FRA
28dabd43,27,2430,27.0,27,27,0,11,21,62,-41,28.1,46.3,-18.2,23,FRA
29939a1d,28,1066,11.8,14,0,14,9,21,22,-1,14.3,20.8,-6.4,23,FRA
29c02c9f,21,958,10.6,12,0,9,6,10,13,-3,13.5,13.3,0.3,23,FRA
2acd49b9,30,1918,21.3,22,9,8,2,21,35,-14,20.5,30.5,-10.0,23,FRA
2acf0cd7,34,2700,30.0,31,21,3,0,35,39,-4,46.3,43.3,3.1,23,FRA
2b1bed19,38,2656,29.5,30,20,8,0,31,43,-12,30.2,45.0,-14.8,23,FRA
2b471f99,14,838,9.3,11,2,3,0,15,9,6,13.8,9.4,4.4,23,FRA
2c0f8e9e,35,2679,29.8,32,11,3,2,51,27,24,51.8,32.3,19.5,23,FRA
2c70d915,2,98,1.1,1,1,1,5,1,6,-5,1.8,2.6,-0.8,23,FRA
2c8a91b9,1,32,0.4,0,0,1,4,0,1,-1,0.2,1.7,-1.5,23,FRA
2ccd89a3,15,870,9.7,9,5,6,1,16,14,2,14.0,11.0,3.0,23,FRA
2d22cea7,3,266,3.0,3,0,0,0,5,3,2,6.3,4.0,2.3,23,FRA
2db2fd7b,8,428,4.8,6,1,2,14,8,6,2,7.1,7.2,-0.1,23,FRA
2f9e4435,18,1548,17.2,18,13,0,0,27,25,2,21.1,26.6,-5.4,23,FRA
2fa2a875,19,1710,19.0,19,19,0,0,37,22,15,29.8,29.8,0.0,23,FRA
300ec91c,2,13,0.1,0,0,2,12,0,0,0,0.3,0.8,-0.4,23,FRA
3010aefb,26,641,7.1,6,0,20,10,8,7,1,9.9,10.8,-0.9,23,FRA
30144daa,26,1288,14.3,14,2,12,1,23,24,-1,20.5,25.0,-4.4,23,FRA
30af8b93,35,2896,32.2,32,27,3,1,60,44,16,53.2,44.1,9.1,23,FRA
31626657,29,2342,26.0,28,19,1,0,38,35,3,31.6,39.7,-8.1,23,FRA
31822f8c,37,2999,33.3,34,19,3,0,42,37,5,56.9,45.2,11.7,23,FRA
3189f61a,30,2489,27.7,29,23,1,0,24,64,-40,26.8,47.4,-20.5,23,FRA
321a71a7,26,2015,22.4,23,18,3,1,27,31,-4,28.1,34.6,-6.5,23,FRA
32c2d95f,37,3330,37.0,37,37,0,0,45,42,3,60.5,50.1,10.4,23,FRA
32e2163d,7,546,6.1,7,3,0,0,8,14,-6,5.7,12.2,-6.5,23,FRA
32f3d97e,4,78,0.9,1,0,3,9,3,1,2,0.7,0.4,0.3,23,FRA
331c5a98,2,21,0.2,0,0,2,0,0,1,-1,0.2,1.4,-1.2,23,FRA
3322e296,11,518,5.8,7,2,4,14,10,5,5,8.9,6.4,2.5,23,FRA
34a88e3e,22,1056,11.7,11,3,11,8,27,10,17,23.5,11.9,11.6,23,FRA
35516eac,32,1764,19.6,19,6,13,3,24,48,-24,21.0,45.6,-24.6,23,FRA
357103bd,36,2340,26.0,24,8,12,0,39,30,9,36.8,37.5,-0.7,23,FRA
3670aa71,2,10,0.1,0,0,2,8,0,1,-1,0.1,0.1,0.0,23,FRA
3681cfff,16,1060,11.8,12,9,4,17,10,14,-4,10.8,21.5,-10.7,23,FRA
3708e9fa,34,2464,27.4,29,7,5,0,55,35,20,45.0,33.0,12.0,23,FRA
37143438,7,223,2.5,1,0,6,7,6,5,1,6.6,5.9,0.7,23,FRA
374fbf7d,33,1693,18.8,16,2,17,3,17,38,-21,19.8,28.8,-9.0,23,FRA
375622c5,34,2738,30.4,32,20,2,0,52,50,2,42.3,45.5,-3.2,23,FRA
3814120d,5,408,4.5,4,4,1,24,5,11,-6,5.0,10.3,-5.3,23,FRA
3916b09c,7,630,7.0,7,7,0,10,8,12,-4,6.1,10.7,-4.6,23,FRA
3935e52e,33,2214,24.6,26,14,7,0,49,22,27,45.7,24.8,20.9,23,FRA
3975195f,31,2153,23.9,25,13,6,1,28,52,-24,22.7,45.6,-22.9,23,FRA
397ba086,37,2232,24.8,26,5,11,0,33,27,6,35.0,31.9,3.1,23,FRA
39b326ed,18,1259,14.0,14,12,4,0,17,18,-1,22.0,20.2,1.8,23,FRA
3a24769f,27,960,10.7,9,3,18,4,12,14,-2,16.1,15.0,1.1,23,FRA
3b029691,36,2446,27.2,29,8,7,1,58,28,30,54.0,34.2,19.8,23,FRA
3b676989,8,101,1.1,0,0,8,4,0,0,0,1.0,2.5,-1.6,23,FRA
3bd65247,19,1052,11.7,13,0,6,2,21,18,3,16.6,12.3,4.3,23,FRA
3befc2b6,36,3149,35.0,36,30,0,1,34,50,-16,39.1,48.3,-9.2,23,FRA
3c6bbbab,23,1689,18.8,19,14,4,3,17,22,-5,20.9,22.7,-1.8,23,FRA
3cdfc63e,24,1979,22.0,22,20,2,9,15,40,-25,23.3,32.5,-9.3,23,FRA
3d214e5f,37,3330,37.0,37,37,0,0,44,54,-10,41.9,55.0,-13.1,23,FRA
3dd738a1,20,1172,13.0,14,7,6,5,16,21,-5,19.5,18.7,0.8,23,FRA
3eaf8817,19,435,4.8,3,0,16,14,11,9,2,6.8,8.7,-1.9,23,FRA
3ecc8c5f,35,3117,34.6,35,32,0,0,40,47,-7,42.5,53.9,-11.4,23,FRA
3ef0fa48,11,345,3.8,3,0,8,8,9,6,3,6.7,6.7,-0.1,23,FRA
3f319bb9,34,2995,33.3,34,32,0,1,48,47,1,46.9,46.7,0.2,23,FRA
40221fa7,22,1329,14.8,15,10,7,11,17,21,-4,20.900000000000002,21.7,-0.7,23,FRA
40774c6b,25,941,10.5,10,0,15,1,13,10,3,16.0,13.200000000000001,2.8000000000000003,23,FRA
40ef7347,30,1851,20.6,25,1,5,1,34,33,1,31.5,28.7,2.8,23,FRA
41eebdf5,26,1879,20.9,24,14,2,1,38,20,18,38.3,21.9,16.4,23,FRA
42276181,34,2098,23.3,23,8,11,1,29,34,-5,29.1,37.3,-8.2,23,FRA
42f0113f,5,66,0.7,0,0,5,0,1,1,0,1.3,1.3,0.0,23,FRA
42fd9c7f,34,2818,31.3,32,26,2,0,73,33,40,65.2,42.1,23.0,23,FRA
4315f30d,13,716,8.0,8,6,5,12,10,14,-4,11.7,10.8,0.9,23,FRA
433dc9a2,28,1648,18.3,18,10,10,7,40,19,21,36.3,23.4,12.8,23,FRA
43e7a164,31,2677,29.7,31,27,0,2,40,44,-4,38.4,43.7,-5.3,23,FRA
4534a352,16,1363,15.1,15,14,1,4,25,13,12,25.2,18.0,7.3,23,FRA
45cce300,9,446,5.0,4,2,5,4,13,7,6,11.4,7.3,4.0,23,FRA
462475ed,13,771,8.6,9,4,4,1,12,18,-6,10.8,13.6,-2.8,23,FRA
46359159,11,511,5.7,5,3,6,0,8,6,2,11.2,6.7,4.5,23,FRA
46750e9c,6,66,0.7,0,0,6,7,1,2,-1,1.7,1.6,0.2,23,FRA
468fdbad,12,277,3.1,2,0,10,23,2,5,-3,4.9,3.1,1.9,23,FRA
46faabfa,16,1136,12.6,15,4,1,0,11,26,-15,11.4,22.0,-10.6,23,FRA
477e50ce,1,90,1.0,1,1,0,31,2,2,0,1.7,0.7,1.1,23,FRA
47c609d5,3,91,1.0,1,0,2,2,0,4,-4,0.8,0.8,0.1,23,FRA
489e80e3,29,2194,24.4,25,16,4,1,50,40,10,39.8,33.6,6.2,23,FRA
48b28bfd,30,1300,14.4,16,1,14,5,17,22,-5,19.8,19.5,0.3,23,FRA
48d5bd33,20,1227,13.6,13,3,7,0,22,17,5,23.5,14.4,9.0,23,FRA
49070d66,26,1765,19.6,18,16,8,6,31,27,4,26.8,29.6,-2.8,23,FRA
49136c42,13,1038,11.5,12,9,1,4,11,18,-7,15.3,16.0,-0.7,23,FRA
4a021593,1,1,0.0,0,0,1,0,0,0,0,0.0,0.0,0.0,23,FRA
4a0c6555,1,10,0.1,0,0,1,10,0,0,0,0.1,0.0,0.1,23,FRA
4a56052c,38,2863,31.8,31,24,7,0,55,31,24,54.5,34.1,20.4,23,FRA
4a5e83ad,14,545,6.1,7,0,7,19,5,9,-4,7.5,8.8,-1.2,23,FRA
4a987ffa,2,25,0.3,0,0,2,10,0,0,0,0.3,0.3,-0.1,23,FRA
4b792f35,2,37,0.4,0,0,2,1,1,2,-1,0.3,2.8,-2.5,23,FRA
4b96c347,17,858,9.5,12,0,5,0,22,6,16,16.9,7.9,9.0,23,FRA
4be0b467,11,506,5.6,5,2,6,0,5,12,-7,7.0,7.6,-0.5,23,FRA
4ca4f263,3,138,1.5,1,1,2,1,1,4,-3,0.3,2.9,-2.6,23,FRA
4ca4f601,30,1809,20.1,25,0,5,3,33,29,4,29.4,29.5,0.0,23,FRA
4db5915d,23,1090,12.1,11,4,12,6,13,16,-3,12.0,18.1,-6.0,23,FRA
4e0afc5d,12,361,4.0,3,0,9,5,6,9,-3,6.1,8.7,-2.6,23,FRA
4e47507a,11,447,5.0,5,0,6,0,2,7,-5,4.0,6.1,-2.1,23,FRA
4e7db402,37,3329,37.0,37,36,0,0,36,54,-18,41.0,51.7,-10.7,23,FRA
4fb18ca4,2,76,0.8,0,0,2,11,2,1,1,1.1,2.4,-1.3,23,FRA
5065d67d,2,126,1.4,1,1,1,14,2,3,-1,1.8,1.5,0.3,23,FRA
5069b796,18,1317,14.6,15,12,3,15,20,30,-10,15.8,22.6,-6.8,23,FRA
508a9011,1,2,0.0,0,0,1,7,1,0,1,0.6,0.0,0.6,23,FRA
50ac8941,2,47,0.5,0,0,2,1,2,0,2,1.9,0.4,1.5,23,FRA
5148dcc5,16,1319,14.7,16,7,0,0,29,17,12,25.0,16.0,9.1,23,FRA
5167c97e,36,1671,18.6,17,12,19,0,24,9,15,32.3,21.7,10.7,23,FRA
51c30111,29,1633,18.1,17,6,12,7,29,37,-8,20.4,34.4,-14.0,23,FRA
51c83a90,2,180,2.0,2,2,0,34,3,2,1,4.1,3.2,0.9,23,FRA
5219ab4a,34,2590,28.8,32,16,2,0,52,27,25,48.3,32.1,16.2,23,FRA
52cd0e88,6,104,1.2,0,0,6,4,1,3,-2,0.8,3.8,-3.0,23,FRA
5313ed43,35,3073,34.1,34,28,1,1,58,25,33,57.5,36.5,21.0,23,FRA
531a4aa8,30,2497,27.7,30,22,0,0,22,57,-35,29.2,45.1,-15.9,23,FRA
53af52f3,36,3240,36.0,36,36,0,2,47,35,12,54.6,42.3,12.4,23,FRA
546bb36e,25,1182,13.1,14,2,11,7,18,19,-1,11.3,22.4,-11.1,23,FRA
547a72ad,8,165,1.8,2,0,6,12,2,2,0,4.0,3.3,0.7,23,FRA
562a4799,15,1256,14.0,15,12,0,1,25,13,12,21.8,20.1,1.7,23,FRA
563fcd6b,35,1874,20.8,23,1,12,0,18,35,-17,21.1,32.2,-11.2,23,FRA
5680bf3f,19,743,8.3,7,2,12,9,8,10,-2,7.3,12.9,-5.6,23,FRA
56ae428b,37,3217,35.7,35,35,2,1,35,58,-23,40.4,55.0,-14.6,23,FRA
574aa9ec,1,7,0.1,0,0,1,10,2,0,2,0.4,0.0,0.4,23,FRA
576817b7,13,805,8.9,8,3,5,4,8,11,-3,9.3,10.8,-1.6,23,FRA
57e3f0c7,18,1495,16.6,17,10,1,1,17,16,1,22.8,19.2,3.6,23,FRA
58ae47b2,24,835,9.3,9,1,15,8,27,13,14,16.8,10.9,5.8,23,FRA
595e6f3e,36,1939,21.5,18,6,18,1,27,33,-6,24.6,32.7,-8.1,23,FRA
59948ef7,31,1407,15.6,16,1,15,4,24,8,16,30.8,15.9,14.9,23,FRA
5a6b06cd,3,24,0.3,0,0,3,1,0,0,0,1.2,0.0,1.1,23,FRA
5b146df3,36,3093,34.4,35,33,1,2,43,49,-6,40.9,51.5,-10.5,23,FRA
5b1bf5e3,2,22,0.2,0,0,2,4,1,0,1,0.5,0.4,0.0,23,FRA
5b3cfa12,6,58,0.6,0,0,6,20,0,0,0,0.7,1.1,-0.4,23,FRA
5b479568,12,295,3.3,3,1,9,13,6,6,0,7.0,4.5,2.5,23,FRA
5b4bc323,10,867,9.6,10,9,0,6,9,20,-11,9.7,15.1,-5.4,23,FRA
5b92d896,25,1155,12.8,12,0,13,12,31,18,13,25.5,16.0,9.5,23,FRA
5b9512c5,34,2986,33.2,33,32,1,1,56,41,15,53.1,43.6,9.5,23,FRA
5bf26efc,1,55,0.6,0,0,1,7,0,1,-1,0.1,0.3,-0.2,23,FRA
5c42e7ce,2,180,2.0,2,2,0,7,2,6,-4,1.4,5.0,-3.6,23,FRA
5cb215fc,22,1760,19.6,20,16,2,7,18,35,-17,20.2,30.6,-10.4,23,FRA
5ceba7fc,36,2325,25.8,26,10,10,0,46,25,21,42.6,31.200000000000003,11.2,23,FRA
5d0e0a1f,28,1954,21.7,24,13,4,0,35,25,10,33.6,28.2,5.3,23,FRA
5d8d7454,18,1461,16.2,17,13,1,0,23,25,-2,21.3,17.4,3.9,23,FRA
5d9577aa,7,329,3.7,3,3,4,15,3,12,-9,1.9,5.7,-3.8,23,FRA
5e080f73,10,233,2.6,1,0,9,4,1,8,-7,2.3,5.4,-3.1,23,FRA
5e22e2a4,25,1813,20.1,20,16,5,1,36,21,15,32.1,22.8,9.3,23,FRA
5e5249c8,33,1570,17.4,16,3,17,4,15,30,-15,20.2,26.0,-5.8,23,FRA
5e6355f8,3,65,0.7,1,0,2,11,1,4,-3,0.3,2.2,-1.9,23,FRA
5ea8ef20,33,2108,23.4,25,12,8,3,36,24,12,38.1,27.9,10.2,23,FRA
5f3eaaf5,34,2346,26.1,28,10,6,0,24,38,-14,28.5,36.8,-8.3,23,FRA
5fdcb075,22,1758,19.5,20,14,2,4,26,14,12,34.8,27.0,7.7,23,FRA
6043997c,20,1578,17.5,19,16,1,1,24,34,-10,22.3,28.5,-6.2,23,FRA
60d90c55,37,3330,37.0,37,37,0,1,65,28,37,64.0,40.2,23.7,23,FRA
6191093d,37,2813,31.3,30,20,7,1,32,36,-4,38.6,39.7,-1.1,23,FRA
61b77d0a,8,194,2.2,2,1,6,4,1,4,-3,1.6,4.8,-3.2,23,FRA
61f80c89,1,8,0.1,0,0,1,6,0,0,0,1.2,0.0,1.2,23,FRA
62124972,1,90,1.0,1,1,0,30,1,2,-1,0.5,1.3,-0.8,23,FRA
627b570a,6,136,1.5,1,0,5,1,0,3,-3,0.6,2.4,-1.8,23,FRA
62e02107,9,93,1.0,0,0,9,21,5,2,3,2.6,3.3,-0.7,23,FRA
636247ca,25,444,4.9,2,0,23,7,5,10,-5,6.0,9.9,-4.0,23,FRA
6388e356,35,2580,28.7,29,23,6,3,57,45,12,41.7,49.6,-7.9,23,FRA
645a3363,36,2816,31.3,34,11,2,0,52,36,16,55.0,34.0,21.1,23,FRA
64ba07c0,14,653,7.3,7,2,7,2,7,16,-9,8.6,13.0,-4.5,23,FRA
64c14d49,29,1379,15.3,16,4,13,3,15,16,-1,23.1,18.7,4.3,23,FRA
64f69877,17,639,7.1,7,0,10,5,12,12,0,11.1,9.6,1.5,23,FRA
652d4c37,30,2036,22.6,25,11,5,0,45,31,14,37.9,32.0,5.9,23,FRA
654f49ca,8,198,2.2,1,0,7,6,3,3,0,3.0,3.7,-0.8,23,FRA
65c55288,10,568,6.3,6,4,4,1,11,6,5,9.8,7.4,2.4,23,FRA
65fcf987,8,229,2.5,2,0,6,6,1,5,-4,3.0,5.1,-2.1,23,FRA
6605d143,37,2879,32.0,32,25,5,0,43,49,-6,42.2,48.0,-5.8,23,FRA
6690ef25,1,13,0.1,0,0,1,7,1,1,0,0.2,1.3,-1.1,23,FRA
6751b938,1,3,0.0,0,0,1,14,0,0,0,0.0,0.9,-0.9,23,FRA
6763f716,13,769,8.5,8,6,5,19,21,12,9,16.8,10.4,6.4,23,FRA
67f649be,17,1530,17.0,17,17,0,0,16,20,-4,20.3,24.6,-4.3,23,FRA
68a26d51,26,2028,22.5,25,10,1,2,20,29,-9,25.7,30.5,-4.7,23,FRA
69384e5d,20,1545,17.2,18,9,2,0,42,14,28,36.0,20.4,15.5,23,FRA
698f11e3,23,1225,13.6,12,8,11,13,18,20,-2,15.8,22.6,-6.8,23,FRA
6993927b,26,1701,18.9,18,17,8,11,19,28,-9,22.3,33.2,-11.0,23,FRA
6a827d8e,18,779,8.7,8,2,10,2,10,6,4,13.8,8.9,4.9,23,FRA
6a9e4913,1,90,1.0,1,1,0,33,0,0,0,1.5,1.0,0.4,23,FRA
6b4436ba,4,51,0.6,0,0,4,5,0,2,-2,0.9,0.9,0.1,23,FRA
6b5edd5d,7,174,1.9,2,0,5,5,0,5,-5,1.9,4.0,-2.1,23,FRA
6b9960cf,26,929,10.3,8,5,18,9,19,17,2,20.4,16.4,4.0,23,FRA
6bde367b,30,2546,28.3,30,19,0,0,40,48,-8,37.4,48.5,-11.2,23,FRA
6d0fe035,29,1626,18.1,18,6,11,6,27,27,0,24.1,22.2,1.9,23,FRA
6d7ede84,11,113,1.3,0,0,11,11,5,2,3,3.8,2.7,1.1,23,FRA
6de23ab0,24,1957,21.7,22,18,2,6,38,29,9,33.1,32.1,1.0,23,FRA
6e33125f,37,3232,35.9,37,35,0,0,62,26,36,63.0,38.4,24.6,23,FRA
6e7f1353,18,1419,15.8,18,6,0,0,25,22,3,22.1,14.8,7.4,23,FRA
6ea05ca7,6,60,0.7,0,0,6,13,1,0,1,1.9,1.6,0.4,23,FRA
6f5ec8bb,32,2779,30.9,32,27,0,2,52,25,27,52.8,33.8,19.0,23,FRA
6f806d99,35,3028,33.6,35,22,0,0,49,47,2,40.2,51.7,-11.5,23,FRA
705a1642,4,182,2.0,1,1,3,14,0,2,-2,1.4,2.5,-1.1,23,FRA
706a60e1,9,232,2.6,2,0,7,1,5,1,4,6.4,3.3,3.1,23,FRA
7091324a,1,3,0.0,0,0,1,7,0,0,0,0.0,0.0,0.0,23,FRA
70c52749,27,1209,13.4,10,6,17,4,25,14,11,20.1,14.8,5.3,23,FRA
70d4c949,10,270,3.0,2,0,8,10,3,5,-2,5.0,4.6,0.5,23,FRA
7120a04d,17,1107,12.3,14,2,3,2,18,14,4,18.1,15.4,2.6,23,FRA
7155e3e1,14,492,5.5,4,2,10,3,13,5,8,11.3,5.9,5.4,23,FRA
71d10572,17,698,7.8,7,0,10,1,4,11,-7,8.3,11.2,-2.9,23,FRA
72d4922b,5,146,1.6,1,0,4,8,0,5,-5,1.3,3.7,-2.3,23,FRA
7304f3b1,15,179,2.0,0,0,15,16,1,4,-3,2.1,2.3,-0.2,23,FRA
740f00ac,31,2452,27.2,29,17,2,0,18,46,-28,29.6,36.6,-6.9,23,FRA
741418c3,22,668,7.4,6,0,16,8,13,9,4,12.8,8.4,4.5,23,FRA
745ca0a3,26,1546,17.1,17,7,9,5,23,20,3,22.799999999999997,21.1,1.6999999999999997,23,FRA
7495aba7,8,279,3.1,3,1,5,4,3,2,1,4.3,2.5,1.8,23,FRA
74d4cec6,14,464,5.2,5,1,9,3,7,8,-1,11.2,4.3,7.0,23,FRA
75438a9a,9,634,7.0,7,6,2,18,7,11,-4,9.2,7.4,1.8,23,FRA
7587446d,5,107,1.2,0,0,5,10,3,5,-2,2.1,2.7,-0.7,23,FRA
75f1ed80,29,2388,26.5,27,24,2,0,33,33,0,43.5,37.0,6.6,23,FRA
770d7eb8,17,1417,15.7,16,13,1,1,21,14,7,18.5,22.4,-4.0,23,FRA
779847d6,26,2213,24.6,26,22,0,3,24,40,-16,29.3,33.7,-4.4,23,FRA
7909ffa4,35,2461,27.3,26,17,9,2,51,44,7,39.6,45.4,-5.8,23,FRA
796b1c41,34,2027,22.5,23,5,11,1,23,25,-2,26.6,33.0,-6.4,23,FRA
7978cbf0,30,2137,23.7,24,14,6,6,21,49,-28,23.8,40.7,-17.0,23,FRA
79a793b7,7,173,1.9,0,0,7,4,2,4,-2,1.9,3.0,-1.1,23,FRA
79b2399c,26,1428,15.9,15,8,11,3,8,26,-18,14.6,24.0,-9.4,23,FRA
7a3f8712,1,1,0.0,0,0,1,1,0,0,0,0.0,0.0,0.0,23,FRA
7a42d0df,38,3054,33.9,34,20,4,0,65,22,43,60.6,35.9,24.7,23,FRA
7af655fe,1,11,0.1,0,0,1,11,0,1,-1,0.2,0.1,0.2,23,FRA
7b082ec2,21,1043,11.6,11,4,10,9,13,18,-5,17.9,16.3,1.6,23,FRA
7b9a9e25,36,2401,26.7,30,7,6,1,50,41,9,36.9,38.8,-1.9,23,FRA
7be7c08b,4,47,0.5,0,0,4,1,1,1,0,0.3,0.8,-0.5,23,FRA
7c2965bb,32,2346,26.1,29,13,3,1,29,52,-23,22.8,53.3,-30.4,23,FRA
7c3ed041,35,2639,29.3,30,24,5,1,51,31,20,48.4,33.6,14.8,23,FRA
7cdda3bf,37,2755,30.6,31,19,6,0,42,31,11,46.4,37.0,9.4,23,FRA
7d3dfdfd,9,521,5.8,6,3,3,15,5,20,-15,7.5,11.7,-4.2,23,FRA
7d704e92,22,1617,18.0,17,15,5,12,26,40,-14,21.8,36.9,-15.1,23,FRA
7d937aa1,3,18,0.2,0,0,3,3,0,0,0,0.4,0.3,0.1,23,FRA
7d9397f8,35,2547,28.3,30,15,5,0,33,24,9,40.3,31.1,9.2,23,FRA
7dfbba27,23,1290,14.3,16,0,7,12,15,26,-11,15.1,20.5,-5.4,23,FRA
7e3e825e,7,51,0.6,0,0,7,8,2,2,0,0.8,1.6,-0.7,23,FRA
7e82a78f,19,1089,12.1,11,5,8,0,9,21,-12,12.5,16.9,-4.4,23,FRA
7ef972c3,2,91,1.0,1,1,1,0,0,1,-1,1.4,0.9,0.5,23,FRA
7f41ee30,7,601,6.7,6,6,1,31,11,8,3,11.1,8.6,2.5,23,FRA
7f783431,21,1096,12.2,11,6,10,11,12,26,-14,13.0,19.6,-6.6,23,FRA
7fecbcdb,21,1364,15.2,12,12,9,14,17,36,-19,16.9,23.5,-6.6,23,FRA
8104e41e,31,2072,23.0,22,8,9,3,44,36,8,39.3,29.1,10.2,23,FRA
810edef9,1,16,0.2,0,0,1,7,0,0,0,0.0,0.5,-0.5,23,FRA
822d51d7,36,3086,34.3,35,32,1,0,65,48,17,56.5,45.3,11.2,23,FRA
82464ce3,33,2894,32.2,33,30,0,0,59,22,37,57.7,35.9,21.8,23,FRA
8299e363,15,638,7.1,8,2,7,8,8,14,-6,7.0,9.8,-2.8,23,FRA
83299cc0,22,1250,13.8,14,6,8,1,14,31,-17,17.0,23.4,-6.3999999999999995,23,FRA
8332db56,17,1069,11.9,13,2,4,4,18,19,-1,15.5,17.7,-2.2,23,FRA
834b5c4c,38,3420,38.0,38,38,0,0,51,59,-8,48.5,55.4,-6.8,23,FRA
836dc4a8,6,213,2.4,2,0,4,2,2,4,-2,1.2,4.2,-3.0,23,FRA
83f03b07,21,1308,14.5,16,7,5,2,14,23,-9,16.6,22.5,-5.9,23,FRA
8499c713,2,13,0.1,0,0,2,6,0,1,-1,0.5,1.3,-0.8,23,FRA
85613cf0,2,129,1.4,2,0,0,1,3,1,2,1.2,1.8,-0.6,23,FRA
8577e60a,31,1820,20.2,20,4,11,2,21,28,-7,24.8,29.4,-4.6,23,FRA
8608f269,2,136,1.5,1,1,1,5,2,3,-1,1.6,2.2,-0.6,23,FRA
8652a85c,38,2517,28.0,29,4,9,0,52,21,31,49.3,31.3,18.0,23,FRA
868eaba0,31,2603,28.9,29,23,2,0,40,37,3,38.6,44.9,-6.3,23,FRA
86a2ba20,32,2661,29.6,31,22,1,5,38,61,-23,31.2,54.3,-23.1,23,FRA
86a49468,14,495,5.5,5,0,9,5,4,14,-10,4.1,7.9,-3.7,23,FRA
87935cf3,15,763,8.5,7,1,8,17,16,20,-4,11.1,13.2,-2.1,23,FRA
87d31635,10,501,5.6,6,0,4,9,4,10,-6,7.5,11.3,-3.8,23,FRA
87e9c7cd,14,568,6.3,6,2,8,8,9,12,-3,8.3,11.9,-3.6,23,FRA
8827bf46,10,417,4.6,6,0,4,3,9,5,4,6.2,4.3,1.9,23,FRA
8846a40f,24,1264,14.0,16,2,8,3,17,25,-8,14.2,20.1,-5.9,23,FRA
88c4d190,32,2071,23.0,24,7,8,0,26,29,-3,26.3,30.3,-4.0,23,FRA
88f130ed,34,2870,31.9,33,30,1,0,43,29,14,47.5,37.1,10.4,23,FRA
890bc029,2,25,0.3,0,0,2,4,0,2,-2,0.3,0.6,-0.3,23,FRA
8a53d24b,25,895,9.9,9,2,16,9,16,14,2,11.5,19.6,-8.2,23,FRA
8ac64b4e,3,23,0.3,0,0,3,1,0,0,0,0.5,0.5,0.0,23,FRA
8bc8829a,15,1094,12.2,14,8,1,6,9,29,-20,11.9,26.0,-14.1,23,FRA
8ca9415f,13,288,3.2,2,0,11,3,3,5,-2,3.2,4.2,-0.9,23,FRA
8d62d31a,16,1417,15.7,16,14,0,17,32,17,15,25.4,17.5,7.9,23,FRA
8dbff17c,20,1596,17.7,18,12,2,6,14,33,-19,15.4,40.3,-24.9,23,FRA
8eec784d,29,1748,19.4,18,9,11,1,30,18,12,33.8,17.1,16.6,23,FRA
8f325097,17,1277,14.2,14,13,3,1,21,29,-8,17.4,25.7,-8.4,23,FRA
8f7e6783,4,212,2.4,3,0,1,0,1,3,-2,3.1,2.3,0.8,23,FRA
8fd9996f,33,2410,26.8,27,19,6,3,57,27,30,52.9,33.0,19.9,23,FRA
906baf89,1,7,0.1,0,0,1,12,1,0,1,0.7,0.0,0.7,23,FRA
909222de,33,2003,22.3,23,1,10,0,23,32,-9,24.2,29.0,-4.7,23,FRA
90a9cc01,1,62,0.7,1,0,0,8,0,1,-1,0.1,2.2,-2.1,23,FRA
90eb507d,24,1976,22.0,23,16,1,0,28,25,3,34.8,30.8,4.0,23,FRA
90f87966,31,2592,28.8,30,28,1,2,41,30,11,50.6,32.7,17.9,23,FRA
90fcf472,21,644,7.2,6,0,15,1,11,6,5,11.9,11.8,0.2,23,FRA
910e3cad,1,11,0.1,0,0,1,13,0,0,0,0.0,0.4,-0.4,23,FRA
9226aa22,26,1155,12.8,13,0,13,9,17,12,5,23.6,16.5,7.1,23,FRA
923f4dda,1,23,0.3,0,0,1,0,0,0,0,0.4,0.9,-0.5,23,FRA
9260926b,7,424,4.7,4,4,3,4,5,9,-4,5.9,9.8,-3.9,23,FRA
928a4a61,31,1530,17.0,14,2,17,0,16,19,-3,26.5,24.9,1.6,23,FRA
92b56413,8,99,1.1,0,0,8,8,2,2,0,2.1,2.1,0.0,23,FRA
92d90c8f,12,136,1.5,0,0,12,16,4,1,3,4.0,2.3,1.7,23,FRA
92ffb8f9,15,665,7.4,7,3,8,1,6,8,-2,11.3,10.2,1.1,23,FRA
93c942fb,9,534,5.9,7,3,2,2,18,14,4,10.7,11.2,-0.5,23,FRA
942b4f90,32,2114,23.5,28,9,4,4,48,38,10,38.5,33.4,5.1,23,FRA
94f8d10c,1,8,0.1,0,0,1,3,0,0,0,0.0,0.1,0.0,23,FRA
95192fe4,11,189,2.1,1,0,10,16,2,5,-3,2.3,3.3,-1.0,23,FRA
967f34d3,6,495,5.5,6,5,0,32,8,6,2,8.3,5.6,2.7,23,FRA
96f4ebc0,1,28,0.3,0,0,1,1,0,0,0,0.7,0.4,0.3,23,FRA
96fcd380,1,11,0.1,0,0,1,15,0,0,0,0.1,0.0,0.1,23,FRA
9744ff80,14,370,4.1,3,0,11,3,12,2,10,11.2,3.6,7.5,23,FRA
97fb4608,2,99,1.1,1,0,1,4,1,2,-1,0.6,2.8,-2.2,23,FRA
99d660b2,35,2888,32.1,32,25,3,0,44,54,-10,44.4,49.6,-5.2,23,FRA
9b545925,37,3314,36.8,37,35,0,1,51,55,-4,51.7,54.0,-2.4,23,FRA
9b6f7fd5,2,159,1.8,2,0,0,0,6,2,4,3.5,2.4,1.0,23,FRA
9bc9a519,8,573,6.4,7,4,1,3,7,5,2,8.9,9.8,-0.9,23,FRA
9bdd8118,26,2262,25.1,26,24,0,2,18,45,-27,30.1,38.5,-8.4,23,FRA
9c221d14,3,270,3.0,3,3,0,0,3,6,-3,3.4,4.4,-1.1,23,FRA
9c2b1f11,14,218,2.4,1,0,13,7,4,1,3,3.7,1.8,1.9,23,FRA
9cd28348,1,64,0.7,0,0,1,4,0,2,-2,0.1,0.9,-0.8,23,FRA
9d420dad,11,990,11.0,11,11,0,16,12,19,-7,12.8,15.4,-2.6,23,FRA
9d498560,6,207,2.3,2,0,4,13,1,7,-6,3.2,5.3,-2.2,23,FRA
9daeac61,24,1790,19.9,21,15,3,0,14,42,-28,22.6,29.4,-6.7,23,FRA
9dbb75ca,35,2929,32.5,34,26,1,0,58,40,18,54.8,42.5,12.3,23,FRA
9e17ccff,6,406,4.5,4,4,2,32,7,8,-1,6.1,6.1,0.1,23,FRA
9e7483ff,26,1115,12.4,11,0,15,3,22,14,8,17.8,15.5,2.3,23,FRA
9f0f4b49,5,223,2.5,1,1,4,9,2,3,-1,1.5,4.4,-2.9,23,FRA
9f4a940f,7,68,0.8,0,0,7,9,1,0,1,0.7,1.0,-0.3,23,FRA
9f936061,33,2833,31.5,33,28,0,0,38,43,-5,40.3,48.5,-8.2,23,FRA
a0415710,32,1119,12.4,9,7,23,3,18,29,-11,19.9,22.3,-2.4,23,FRA
a08985b8,36,3120,34.7,35,31,1,1,48,53,-5,48.0,50.7,-2.8,23,FRA
a0d55a09,26,1440,16.0,15,8,11,5,34,18,16,25.2,24.2,1.0,23,FRA
a0f9b535,30,1680,18.7,19,7,11,5,37,20,17,32.5,18.2,14.3,23,FRA
a1232f4e,17,543,6.0,5,1,12,7,8,10,-2,10.5,8.1,2.4,23,FRA
a1390d2f,19,478,5.3,5,0,14,13,9,4,5,9.0,4.8,4.2,23,FRA
a17a94d6,30,2484,27.6,29,19,1,0,34,29,5,48.3,36.7,11.6,23,FRA
a1dbfcb1,9,258,2.9,2,0,7,8,5,3,2,4.7,5.6,-0.9,23,FRA
a3e1d20d,1,23,0.3,0,0,1,3,0,0,0,0.0,0.5,-0.5,23,FRA
a426a912,11,665,7.4,7,6,4,10,8,9,-1,10.8,13.5,-2.7,23,FRA
a45a5d95,22,1063,11.8,13,2,9,7,3,25,-22,7.4,16.8,-9.5,23,FRA
a4a44eb0,38,3420,38.0,38,38,0,0,52,53,-1,44.5,58.2,-13.6,23,FRA
a4b1028a,31,2528,28.1,28,22,3,0,55,29,26,47.2,31.0,16.2,23,FRA
a4b798a9,38,3400,37.8,38,34,0,0,34,61,-27,42.2,58.2,-16.0,23,FRA
a5db0bec,16,526,5.8,6,0,10,10,8,6,2,7.9,7.4,0.4,23,FRA
a62f8bf1,14,326,3.6,2,0,12,4,7,2,5,8.0,3.7,4.3,23,FRA
a65c844b,31,2349,26.1,23,18,8,1,42,31,11,42.3,31.6,10.7,23,FRA
a94571f6,2,69,0.8,0,0,2,3,0,4,-4,0.5,2.0,-1.5,23,FRA
a94d93be,24,1794,19.9,19,18,5,11,11,40,-29,19.0,28.4,-9.4,23,FRA
a99138af,6,291,3.2,3,2,3,6,4,5,-1,6.0,6.2,-0.2,23,FRA
a9d4c241,30,2578,28.6,29,26,1,2,15,58,-43,26.1,40.2,-14.1,23,FRA
aad56ca3,36,2749,30.5,32,18,4,1,56,32,24,49.5,31.3,18.2,23,FRA
ac73ec79,19,1137,12.6,12,9,7,2,33,11,22,24.9,12.7,12.2,23,FRA
ad82197c,38,3330,37.0,37,36,1,0,67,56,11,60.0,52.1,7.9,23,FRA
ae11ba3d,7,294,3.3,3,2,4,4,5,3,2,6.4,2.9,3.6,23,FRA
aef6e670,11,730,8.1,9,7,2,0,30,9,21,21.6,9.6,12.0,23,FRA
aefa3050,8,511,5.7,5,4,3,18,5,13,-8,4.8,15.9,-11.0,23,FRA
af0c835b,35,2399,26.7,27,17,8,0,25,39,-14,29.3,36.6,-7.3,23,FRA
af3ddb2e,34,1446,16.1,16,2,18,0,14,26,-12,16.7,30.4,-13.7,23,FRA
af69e7f0,6,177,2.0,2,0,4,12,3,1,2,3.2,1.5,1.7,23,FRA
afb0c500,38,3420,38.0,38,38,0,0,70,58,12,62.1,53.2,8.9,23,FRA
afe39ca8,27,1452,16.1,15,7,12,1,22,23,-1,17.8,25.3,-7.5,23,FRA
b003239d,14,1010,11.2,12,10,2,15,20,12,8,16.1,14.0,2.1,23,FRA
b026bbf6,12,261,2.9,2,1,10,9,5,3,2,4.6,1.5,3.1,23,FRA
b088d5d3,27,1628,18.1,18,10,9,4,20,38,-18,18.4,40.7,-22.3,23,FRA
b0c71810,13,834,9.3,9,2,4,0,12,23,-11,13.5,15.6,-2.1,23,FRA
b20cc590,11,707,7.9,8,5,3,9,5,18,-13,6.9,13.8,-6.9,23,FRA
b2336681,25,2017,22.4,24,18,1,0,41,24,17,41.6,22.2,19.4,23,FRA
b2791a55,26,1901,21.1,21,17,5,8,11,47,-36,17.8,32.8,-15.0,23,FRA
b2bd0f6c,34,2783,30.9,32,23,2,0,54,41,13,54.6,34.6,20.0,23,FRA
b2fe86e5,1,8,0.1,0,0,1,2,0,0,0,0.0,0.1,0.0,23,FRA
b3244eeb,28,2176,24.2,25,17,3,1,18,43,-25,28.1,32.7,-4.6,23,FRA
b34c63a5,34,1872,20.8,21,9,13,4,38,22,16,36.4,28.0,8.3,23,FRA
b3d76d84,32,2880,32.0,32,32,0,6,52,31,21,58.4,31.8,26.5,23,FRA
b3f8bdef,33,2184,24.3,26,1,7,2,44,23,21,42.7,26.8,15.9,23,FRA
b4ef3fb5,2,12,0.1,0,0,2,15,0,0,0,0.4,0.1,0.3,23,FRA
b5bb8188,21,810,9.0,9,1,12,12,14,8,6,14.3,14.3,0.1,23,FRA
b625b241,11,402,4.5,5,0,6,16,6,4,2,8.6,5.7,2.9,23,FRA
b70afb45,36,2353,26.1,28,5,8,1,32,36,-4,35.6,36.6,-1.0,23,FRA
b73f17f8,30,1260,14.0,15,2,15,2,12,21,-9,15.2,18.8,-3.6,23,FRA
b8c1de25,25,1449,16.1,19,2,6,0,22,21,1,19.2,26.7,-7.5,23,FRA
b94b8be1,11,250,2.8,1,0,10,14,3,5,-2,3.5,2.9,0.5,23,FRA
b99bec05,32,2677,29.7,31,25,1,1,51,35,16,43.400000000000006,37.2,6.1000000000000005,23,FRA
badcdcae,20,657,7.3,7,0,13,10,5,6,-1,8.8,9.8,-1.0,23,FRA
bc7b4580,6,224,2.5,3,0,3,1,3,3,0,3.2,2.5,0.7,23,FRA
bc7cc472,25,1249,13.9,12,4,13,2,10,28,-18,17.5,20.7,-3.2,23,FRA
be98f358,10,260,2.9,3,0,7,27,6,2,4,5.8,3.5,2.3,23,FRA
beae3a73,26,1320,14.7,15,4,11,2,19,28,-9,15.8,24.1,-8.3,23,FRA
bf4c41f9,30,1849,20.5,24,3,6,0,32,24,8,31.0,26.0,5.0,23,FRA
bfb2056e,6,415,4.6,4,4,2,30,3,6,-3,5.8,10.0,-4.3,23,FRA
c03b7266,2,180,2.0,2,2,0,14,5,1,4,2.1,2.1,-0.1,23,FRA
c066d1a5,22,1028,11.4,9,5,13,13,20,11,9,21.6,9.6,12.1,23,FRA
c0c7ff58,27,1892,21.0,21,10,6,0,45,21,24,40.5,27.0,13.6,23,FRA
c25a7a2a,3,36,0.4,0,0,3,14,1,1,0,0.4,0.2,0.2,23,FRA
c2a6033c,37,2473,27.5,28,12,9,0,38,45,-7,38.9,42.3,-3.3,23,FRA
c3725db2,32,2646,29.4,31,25,1,2,39,65,-26,32.0,55.7,-23.7,23,FRA
c385bf49,20,1320,14.7,14,11,6,5,29,17,12,23.7,21.8,1.9,23,FRA
c4065f40,7,586,6.5,6,6,1,6,6,14,-8,7.0,11.3,-4.3,23,FRA
c4173f1a,18,1608,17.9,17,17,1,9,19,24,-5,17.6,28.7,-11.0,23,FRA
c43a8336,11,362,4.0,4,2,7,8,1,8,-7,2.9,6.8,-3.9,23,FRA
c5908bc4,7,101,1.1,0,0,7,4,2,1,1,1.7,2.0,-0.3,23,FRA
c5adc293,7,479,5.3,6,1,1,0,4,7,-3,4.3,8.7,-4.5,23,FRA
c5e6c017,4,128,1.4,1,0,3,17,2,2,0,0.9,2.2,-1.3,23,FRA
c631f952,14,1166,13.0,14,12,0,0,21,26,-5,15.8,19.9,-4.1,23,FRA
c678ddd7,8,506,5.6,6,2,2,20,16,3,13,12.0,5.1,6.9,23,FRA
c6e5d20f,31,2063,22.9,22,14,9,6,32,25,7,32.4,29.5,2.9,23,FRA
c76b7567,35,2215,24.6,26,9,9,0,38,32,6,35.8,35.900000000000006,-0.10000000000000053,23,FRA
c7eebddf,4,209,2.3,2,0,2,1,0,4,-4,0.6,4.0,-3.4,23,FRA
c801616a,26,1332,14.8,14,6,12,3,8,36,-28,12.1,24.1,-12.1,23,FRA
c8c02ac7,18,658,7.3,7,0,11,2,12,6,6,11.1,11.0,0.1,23,FRA
c90f380c,10,123,1.4,0,0,10,11,2,0,2,2.6,2.8,-0.3,23,FRA
c9151d66,27,1658,18.4,18,8,9,7,16,40,-24,21.6,25.7,-4.0,23,FRA
c92c24f0,26,2222,24.7,25,22,1,0,33,25,8,31.3,31.5,-0.2,23,FRA
c9f2f83a,9,682,7.6,8,2,1,13,9,6,3,13.5,9.2,4.3,23,FRA
c9f49454,4,148,1.6,2,0,2,8,2,4,-2,1.9,1.8,0.2,23,FRA
ca6f4846,3,74,0.8,0,0,3,4,0,2,-2,0.5,1.3,-0.9,23,FRA
caa7aaea,38,2399,26.7,25,20,13,0,26,35,-9,30.0,39.0,-9.1,23,FRA
cad3fd4d,13,227,2.5,1,0,12,3,3,3,0,4.4,4.9,-0.5,23,FRA
caef7840,33,1978,22.0,28,4,5,3,28,23,5,37.4,29.3,8.0,23,FRA
cd9b37a3,2,31,0.3,0,0,2,11,2,0,2,1.1,0.6,0.5,23,FRA
ce50fd99,37,3166,35.2,36,22,1,0,61,42,19,63.5,37.0,26.5,23,FRA
cea59f02,28,2458,27.3,28,23,0,0,37,33,4,35.8,39.4,-3.6,23,FRA
cf182add,23,1779,19.8,21,14,2,3,27,23,4,32.2,23.3,8.9,23,FRA
cf1ef7ec,14,673,7.5,7,5,7,16,8,15,-7,8.8,12.2,-3.4,23,FRA
cfa49cc1,19,1315,14.6,15,9,4,1,21,26,-5,13.3,30.1,-16.8,23,FRA
d14229f3,34,2234,24.8,28,7,6,4,22,53,-31,27.3,40.1,-12.8,23,FRA
d21e361a,17,806,9.0,9,1,8,3,5,15,-10,7.8,12.9,-5.1,23,FRA
d33c706e,26,1250,13.899999999999999,15,4,11,0,14,18,-4,21.2,15.9,5.2,23,FRA
d4d35152,32,1688,18.8,19,6,13,5,20,31,-11,19.4,28.6,-9.2,23,FRA
d504b3e1,20,569,6.300000000000001,4,0,16,7,8,13,-5,9.5,11.5,-1.9,23,FRA
d5326924,13,537,6.0,6,1,7,3,10,10,0,9.2,10.1,-0.9,23,FRA
d56b9520,21,1595,17.7,19,12,2,3,28,26,2,31.7,21.5,10.2,23,FRA
d5d22a58,18,838,9.3,9,5,9,6,18,16,2,17.0,11.4,5.6,23,FRA
d5f2f82b,33,2717,30.2,30,26,3,0,71,28,43,62.7,36.1,26.6,23,FRA
d60cf08d,13,842,9.4,9,7,4,4,9,16,-7,10.3,16.5,-6.2,23,FRA
d70ce98e,32,2837,31.5,32,27,0,0,77,31,46,64.7,38.9,25.9,23,FRA
d7547531,2,23,0.3,0,0,2,2,1,0,1,0.5,0.4,0.2,23,FRA
d75f3980,6,300,3.3,3,2,3,6,2,7,-5,2.2,6.2,-4.1,23,FRA
d8c19a60,3,131,1.5,1,0,2,10,0,2,-2,1.9,3.1,-1.2,23,FRA
d9764034,26,2157,24.0,25,21,1,5,48,32,16,40.8,33.5,7.2,23,FRA
db3164e1,30,2667,29.6,30,29,0,5,35,65,-30,33.4,61.8,-28.4,23,FRA
db7849ca,33,2535,28.2,29,16,4,0,33,34,-1,32.4,41.8,-9.4,23,FRA
db87a2c4,2,180,2.0,2,2,0,20,1,2,-1,2.6,2.3,0.2,23,FRA
dbd3a428,35,2916,32.4,34,19,1,0,39,36,3,52.4,42.3,10.1,23,FRA
dc29b608,21,1812,20.1,21,20,0,1,33,29,4,26.9,29.5,-2.6,23,FRA
dd211559,29,2438,27.1,28,23,1,0,41,40,1,32.1,45.9,-13.8,23,FRA
de488e56,12,482,5.4,6,2,6,3,4,6,-2,5.0,7.6,-2.6,23,FRA
df8d6029,35,3127,34.7,35,33,0,1,59,38,21,55.4,41.3,14.1,23,FRA
dfc5d4fa,2,82,0.9,0,0,2,8,1,1,0,1.9,2.0,-0.1,23,FRA
dff0c299,9,91,1.0,0,0,9,12,2,0,2,1.1,1.3,-0.2,23,FRA
dff153a4,3,52,0.6,0,0,3,1,4,1,3,2.2,0.3,1.8,23,FRA
e05082d1,26,1081,12.0,11,3,15,8,12,23,-11,13.4,20.1,-6.7,23,FRA
e0f3a1f6,32,2568,28.5,30,27,2,2,27,41,-14,31.0,38.9,-7.9,23,FRA
e110ea4b,1,90,1.0,1,1,0,0,1,1,0,0.9,1.2,-0.3,23,FRA
e3844ecb,20,1325,14.7,15,8,5,2,6,34,-28,8.3,20.7,-12.4,23,FRA
e3e32fbb,7,456,5.1,5,2,2,9,4,5,-1,5.4,6.3,-0.8,23,FRA
e4114f5d,3,25,0.3,0,0,3,1,0,2,-2,0.3,1.2,-0.9,23,FRA
e42d61c7,28,2053,22.8,23,19,5,1,57,19,38,48.9,27.2,21.7,23,FRA
e4448c8c,3,20,0.2,0,0,3,7,2,1,1,1.7,0.7,0.9,23,FRA
e472a6f6,35,2859,31.8,35,22,0,0,25,71,-46,32.9,51.5,-18.6,23,FRA
e546b2e3,31,1655,18.4,20,3,11,6,29,29,0,22.1,29.1,-7.0,23,FRA
e54a9890,33,1923,21.4,23,4,10,0,39,37,2,28.9,36.9,-8.0,23,FRA
e5c1e0ca,38,3191,35.5,36,32,2,0,42,78,-36,35.9,70.6,-34.7,23,FRA
e6eadfb8,13,916,10.2,12,6,1,4,10,15,-5,11.0,12.7,-1.7,23,FRA
e76cb9cc,36,2849,31.7,32,27,4,1,55,33,22,52.8,36.3,16.5,23,FRA
e76f6fbe,1,2,0.0,0,0,1,12,0,0,0,0.0,0.0,0.0,23,FRA
e7986081,23,877,9.7,8,3,15,10,11,11,0,14.7,11.7,3.0,23,FRA
e7d59f4f,10,515,5.7,6,1,4,0,6,5,1,9.8,8.0,1.8,23,FRA
ea0ff634,31,688,7.6,5,0,26,5,14,13,1,10.7,13.3,-2.6,23,FRA
eb0db257,9,212,2.4,2,1,7,3,1,4,-3,2.6,3.9,-1.2,23,FRA
eba1e557,14,1116,12.4,13,8,1,0,11,13,-2,14.5,18.5,-4.0,23,FRA
ed39121c,15,1009,11.2,11,7,4,1,17,26,-9,14.2,21.4,-7.2,23,FRA
ed45c4a5,36,3032,33.7,34,29,2,0,56,37,19,55.8,39.3,16.4,23,FRA
ed8cecc9,1,1,0.0,0,0,1,10,1,0,1,0.1,0.5,-0.3,23,FRA
ed90babd,21,1064,11.8,12,2,9,0,18,14,4,21.6,12.3,9.4,23,FRA
edbe46dc,1,90,1.0,1,1,0,36,3,1,2,2.8,3.3,-0.5,23,FRA
ee45fd85,31,2214,24.6,24,14,7,1,52,35,17,39.1,34.6,4.4,23,FRA
eeba07f8,7,293,3.3,2,0,5,8,8,2,6,5.7,4.4,1.3,23,FRA
eedea60b,31,2790,31.0,31,31,0,4,35,31,4,50.1,41.5,8.6,23,FRA
ef619b0b,27,1584,17.6,18,6,9,0,25,10,15,28.2,17.2,11.0,23,FRA
ef8ae23b,27,1947,21.6,22,14,5,3,14,36,-22,22.3,30.0,-7.7,23,FRA
ef9c1c95,34,2916,32.4,33,28,1,0,55,35,20,58.6,32.6,26.0,23,FRA
f00de885,32,2816,31.3,32,31,0,0,54,39,15,50.1,43.1,7.0,23,FRA
f066022d,20,1654,18.4,19,17,1,2,29,26,3,23.3,27.4,-4.1,23,FRA
f0661424,34,2991,33.2,34,30,0,0,53,39,14,51.4,43.8,7.6,23,FRA
f19f32b1,6,540,6.0,6,6,0,28,3,15,-12,5.5,9.6,-4.2,23,FRA
f20e4cc9,23,1548,17.2,18,8,5,1,45,16,29,38.0,19.5,18.5,23,FRA
f28474a4,7,356,4.0,3,3,4,25,10,5,5,6.7,7.0,-0.3,23,FRA
f29131b5,1,1,0.0,0,0,1,1,0,0,0,0.0,0.0,0.0,23,FRA
f323d995,30,2695,29.9,30,29,0,3,51,45,6,41.4,47.6,-6.2,23,FRA
f3600c02,8,552,6.1,6,4,2,0,11,6,5,9.2,6.8,2.3,23,FRA
f41a69e6,37,3330,37.0,37,37,0,0,44,47,-3,46.9,56.9,-10.0,23,FRA
f4bc42b1,27,1060,11.8,11,2,16,10,15,27,-12,13.3,20.1,-6.8,23,FRA
f5044e54,32,2767,30.7,32,26,0,0,39,41,-2,36.3,44.3,-8.0,23,FRA
f527a32c,38,1968,21.9,23,3,15,0,27,32,-5,27.9,33.9,-6.0,23,FRA
f5c8b425,4,200,2.2,3,0,1,1,5,7,-2,3.1,5.5,-2.3,23,FRA
f5dfc256,6,540,6.0,6,6,0,12,13,13,0,10.4,8.7,1.7,23,FRA
f6496133,5,184,2.0,1,0,4,7,2,0,2,2.6,1.6,0.9,23,FRA
f6857b4f,5,24,0.3,0,0,5,9,1,0,1,0.7,0.6,0.1,23,FRA
f7691f63,28,1543,17.1,18,8,10,3,17,24,-7,19.6,28.5,-9.0,23,FRA
f81ef10d,36,2767,30.7,32,18,4,1,52,39,13,45.6,43.1,2.5,23,FRA
f833a830,18,724,8.0,10,0,8,19,13,9,4,13.0,11.2,1.8,23,FRA
f8ce97ca,5,263,2.9,4,0,1,8,5,8,-3,5.4,5.5,-0.1,23,FRA
f9d5908e,27,1875,20.8,22,11,5,2,27,14,13,34.9,25.4,9.5,23,FRA
faf00ab8,24,718,8.0,7,2,17,8,17,15,2,10.4,14.3,-3.9,23,FRA
fb0ee44e,32,2497,27.7,30,14,2,1,19,46,-27,30.4,33.6,-3.2,23,FRA
fb14aa28,34,2665,29.6,30,20,4,0,36,68,-32,31.9,62.4,-30.5,23,FRA
fb3236a7,34,2431,27.0,27,23,7,2,22,40,-18,30.8,44.3,-13.6,23,FRA
fb4c5b6e,1,59,0.7,1,0,0,2,1,0,1,0.1,0.8,-0.7,23,FRA
fb55f63a,6,89,1.0,0,0,6,13,1,1,0,1.5,1.7,-0.2,23,FRA
fc46aab1,32,1668,18.5,18,6,14,1,34,16,18,30.4,20.4,10.0,23,FRA
fc4cf6a7,33,2453,27.3,27,18,6,1,37,26,11,41.0,33.3,7.6,23,FRA
fcc84a07,27,1192,13.2,14,2,13,6,20,19,1,17.6,22.3,-4.7,23,FRA
fd2bc67d,37,3299,36.7,37,36,0,0,47,36,11,55.4,43.4,12.0,23,FRA
fd78b105,9,751,8.3,8,8,1,21,10,16,-6,5.7,16.2,-10.5,23,FRA
fdbde523,34,1836,20.4,19,9,15,0,20,44,-24,21.9,32.3,-10.4,23,FRA
feb5d3ab,15,795,8.8,9,3,6,0,8,16,-8,10.0,12.5,-2.4,23,FRA
fed17f5a,26,1187,13.2,14,3,12,5,31,16,15,25.4,17.4,8.1,23,FRA
ff4d0258,2,36,0.4,0,0,2,18,0,1,-1,0.2,1.2,-1.0,23,FRA
ff4df82e,34,1082,12.0,9,0,25,4,12,21,-9,14.5,18.1,-3.5,23,FRA
ffec9769,16,986,11.0,11,4,5,0,11,15,-4,10.6,15.8,-5.2,23,FRA
fffea3e5,29,1291,14.3,13,3,16,1,24,13,11,23.3,17.5,5.8,23,FRA
00242b75,24,2027,22.5,22,21,2,0,19,33,-14,26.1,28.0,-1.9,24,GER
009a4f60,16,1409,15.7,16,13,0,2,30,19,11,25.1,24.7,0.4,24,GER
00c9a283,23,1745,19.4,20,13,3,1,34,27,7,27.8,31.5,-3.7,24,GER
00e36323,18,283,3.1,1,1,17,9,1,8,-7,3.4,6.3,-2.9,24,GER
00f518d8,19,850,9.4,8,0,11,2,9,20,-11,10.0,18.5,-8.5,24,GER
0118c54c,24,2005,22.3,23,19,1,0,20,42,-22,25.4,33.3,-7.9,24,GER
017018d1,21,1681,18.7,21,11,0,0,21,45,-24,20.0,35.5,-15.5,24,GER
0174ba21,23,954,10.6,10,1,13,3,16,19,-3,15.1,15.5,-0.4,24,GER
01834aa0,14,891,9.9,10,6,4,7,12,18,-6,10.1,14.9,-4.8,24,GER
042e8a49,16,1064,11.8,14,2,2,1,30,11,19,31.2,7.0,24.2,24,GER
048a1cbc,16,1010,11.2,10,5,6,1,30,16,14,28.1,11.9,16.2,24,GER
049751d7,13,738,8.2,8,2,5,0,9,11,-2,10.0,10.7,-0.7,24,GER
054849d2,21,1442,16.0,16,10,5,0,28,17,11,21.1,21.3,-0.2,24,GER
056a8552,3,24,0.3,0,0,3,1,0,1,-1,0.1,1.3,-1.2,24,GER
056d2d95,20,1296,14.4,14,7,6,5,11,26,-15,18.0,20.1,-2.1,24,GER
05d548d8,20,1240,13.8,16,10,4,4,28,19,9,24.3,21.2,3.1,24,GER
05f99a4a,14,909,10.1,11,4,3,0,7,15,-8,11.5,14.1,-2.6,24,GER
061e8e23,13,289,3.2,1,0,12,4,6,6,0,4.7,7.0,-2.3,24,GER
07c7eb0c,25,2103,23.4,25,16,0,0,27,45,-18,25.9,42.8,-16.9,24,GER
07d3bfec,11,157,1.7,1,0,10,13,6,4,2,5.2,5.0,0.2,24,GER
08391d76,9,154,1.7,1,1,8,16,4,3,1,4.0,1.4,2.6,24,GER
08593525,1,1,0.0,0,0,1,10,0,0,0,0.0,0.0,0.0,24,GER
0911b4fc,3,199,2.2,2,2,1,1,1,5,-4,1.4,7.2,-5.8,24,GER
091c86e2,13,715,7.9,7,3,6,0,17,8,9,14.6,12.7,1.9,24,GER
0a084b35,15,956,10.6,11,7,4,3,13,15,-2,12.8,16.2,-3.4,24,GER
0a1cb833,7,630,7.0,7,7,0,15,12,17,-5,11.8,13.5,-1.7,24,GER
0a3f6cde,21,1128,12.5,11,1,10,1,16,22,-6,16.0,23.6,-7.6,24,GER
0a89e877,26,1984,22.0,22,15,4,0,52,25,27,43.2,24.5,18.6,24,GER
0c7a48f8,20,1140,12.7,13,9,7,4,28,6,22,25.8,7.5,18.3,24,GER
0cbe584d,6,154,1.7,0,0,6,2,0,4,-4,2.1,4.7,-2.6,24,GER
0cbf4c54,20,1043,11.6,12,2,8,7,17,18,-1,13.4,25.0,-11.5,24,GER
0cc5f4a5,3,42,0.5,0,0,3,0,1,1,0,0.5,0.5,0.0,24,GER
0cf778df,27,2113,23.5,27,5,0,0,53,28,25,50.1,24.1,25.9,24,GER
0d55d942,1,90,1.0,1,1,0,21,0,2,-2,0.5,1.1,-0.6,24,GER
0e0102eb,23,1761,19.6,21,9,2,0,35,27,8,28.7,27.6,1.1,24,GER
0e6bc38c,23,452,5.0,4,1,19,4,19,14,5,17.9,6.4,11.5,24,GER
0ed60738,26,1303,14.5,14,6,12,1,20,19,1,19.7,20.7,-1.0,24,GER
0ee6ea6a,9,49,0.5,0,0,9,10,1,0,1,1.5,0.8,0.7,24,GER
0f59a7bf,26,2055,22.799999999999997,23,15,3,0,35,49,-14,33.2,42.3,-9.1,24,GER
0fbecd11,24,1591,17.7,20,10,4,0,10,29,-19,17.2,19.6,-2.4,24,GER
1025db8e,23,1963,21.8,22,20,1,0,34,29,5,30.9,31.6,-0.7,24,GER
10745192,18,693,7.7,10,0,8,9,16,6,10,13.7,7.8,5.8,24,GER
10876d02,17,1237,13.7,16,4,1,1,16,27,-11,15.0,24.9,-9.9,24,GER
10e7f486,13,906,10.1,10,7,3,2,10,15,-5,9.6,13.7,-4.1,24,GER
11407d95,24,1169,13.0,14,1,10,0,21,19,2,16.5,25.1,-8.6,24,GER
116c35df,23,1607,17.9,19,10,4,2,37,21,16,35.3,24.2,11.1,24,GER
1238a3f9,18,1198,13.3,15,5,3,1,9,23,-14,14.9,30.0,-15.2,24,GER
12c35abe,10,147,1.6,0,0,10,4,5,2,3,3.3,4.0,-0.7,24,GER
13203c45,22,693,7.7,7,2,15,2,8,11,-3,7.3,12.8,-5.5,24,GER
13210854,23,1303,14.5,14,7,9,1,24,24,0,20.0,21.9,-1.9,24,GER
13d23b29,1,27,0.3,0,0,1,2,0,1,-1,0.2,1.3,-1.0,24,GER
13ddc856,23,1776,19.7,23,5,0,0,24,45,-21,25.2,38.7,-13.5,24,GER
13fe7b69,27,993,11.0,10,1,17,0,24,12,12,22.6,11.3,11.3,24,GER
144e8717,23,1724,19.2,21,15,2,1,22,46,-24,18.8,41.8,-23.0,24,GER
14a7af33,15,667,7.4,7,1,8,10,10,17,-7,12.6,14.9,-2.3,24,GER
14b09c41,13,811,9.0,9,4,4,7,12,13,-1,11.9,12.0,-0.1,24,GER
15413fa5,18,951,10.6,10,7,8,7,23,13,10,21.2,19.1,2.1,24,GER
15f24fe7,5,325,3.6,5,1,0,0,4,2,2,4.3,4.6,-0.3,24,GER
17370b95,26,2339,26.0,26,25,0,0,31,53,-22,33.9,48.8,-14.9,24,GER
178018f9,17,1197,13.3,13,8,4,0,13,31,-18,15.2,26.6,-11.4,24,GER
19a967ab,25,1760,19.6,20,2,5,1,30,27,3,25.3,30.2,-4.9,24,GER
1a4b9094,2,106,1.2,1,1,1,8,4,2,2,2.0,1.5,0.5,24,GER
1ae836b1,25,1985,22.1,24,14,1,1,29,40,-11,27.1,35.1,-8.0,24,GER
1b4be8eb,26,2228,24.8,25,23,1,0,35,45,-10,28.4,46.0,-17.7,24,GER
1c59240b,6,159,1.8,0,0,6,2,3,0,3,2.7,2.4,0.3,24,GER
1d8e9add,27,2282,25.4,25,23,2,0,39,38,1,37.599999999999994,38.6,-0.8999999999999999,24,GER
1df0c0b9,13,481,5.3,6,2,7,10,9,9,0,8.2,10.0,-1.8,24,GER
1e2057aa,11,281,3.1,2,0,9,6,3,8,-5,7.8,8.8,-1.0,24,GER
1e274a0a,17,491,5.5,5,0,12,6,11,13,-2,10.6,10.3,0.3,24,GER
1e37c986,1,7,0.1,0,0,1,3,0,1,-1,0.0,0.2,-0.2,24,GER
1f2c7b55,21,1312,14.6,16,3,5,3,20,25,-5,21.4,23.4,-2.0,24,GER
1f3afdcb,16,1298,14.4,15,13,1,6,41,10,31,29.1,13.4,15.6,24,GER
1fc08838,4,56,0.6,0,0,4,16,6,0,6,3.2,0.1,3.1,24,GER
1fc4f3d1,1,4,0.0,0,0,1,1,0,1,-1,0.2,0.2,-0.1,24,GER
1fffae99,27,2244,24.9,26,15,1,0,29,37,-8,31.8,38.9,-7.2,24,GER
20030c06,12,952,10.6,11,9,1,0,28,10,18,19.7,9.7,10.0,24,GER
202b3b68,13,296,3.3,3,0,10,9,2,6,-4,2.7,4.3,-1.6,24,GER
204dded0,19,1609,17.9,18,14,1,0,45,22,23,41.0,19.1,22.0,24,GER
2077ae86,27,2173,24.1,25,16,2,0,31,39,-8,30.8,32.0,-1.2,24,GER
2180c761,3,14,0.2,0,0,3,10,0,0,0,0.1,0.2,-0.1,24,GER
21a66f6a,27,2389,26.5,27,22,0,0,73,31,42,70.6,22.6,48.0,24,GER
220ace7e,27,2063,22.9,24,9,3,0,31,38,-7,28.9,37.2,-8.3,24,GER
2244908c,9,286,3.2,1,0,8,8,3,5,-2,2.6,6.3,-3.8,24,GER
226ddf9d,24,2160,24.0,24,24,0,3,42,43,-1,34.5,37.1,-2.6,24,GER
22798128,19,983,10.9,10,4,9,5,11,21,-10,11.2,16.7,-5.5,24,GER
22919e97,14,502,5.6,4,0,10,4,7,15,-8,7.1,11.5,-4.4,24,GER
231c67ff,3,104,1.2,1,0,2,0,1,3,-2,1.8,2.0,-0.2,24,GER
236f02cd,26,1941,21.6,22,16,4,1,37,46,-9,27.6,37.3,-9.8,24,GER
253bd2b3,1,1,0.0,0,0,1,8,0,0,0,0.0,0.0,0.0,24,GER
258a6f4d,27,2336,26.0,27,19,0,0,38,45,-7,31.0,49.2,-18.2,24,GER
25ab9c9c,21,1541,17.1,17,13,4,5,28,32,-4,26.0,26.1,0.0,24,GER
2658c82f,13,782,8.7,9,4,4,6,23,12,11,19.8,9.5,10.3,24,GER
277c49ed,23,1912,21.2,22,18,1,0,26,34,-8,28.0,28.3,-0.3,24,GER
285c7011,2,2,0.0,0,0,2,4,0,0,0,0.0,0.0,0.0,24,GER
28c6e925,14,452,5.0,4,1,10,13,10,10,0,8.8,8.0,0.8,24,GER
2903a856,26,1752,19.5,21,4,5,0,51,15,36,38.7,16.9,21.8,24,GER
2979c05a,5,258,2.9,2,0,3,1,2,7,-5,2.6,7.2,-4.6,24,GER
298c8aa1,14,670,7.4,6,1,8,0,15,19,-4,11.3,16.9,-5.6,24,GER
29aee77c,7,217,2.4,1,0,6,1,1,6,-5,3.7,4.7,-1.1,24,GER
29f7cfd9,1,45,0.5,0,0,1,0,0,3,-3,0.2,1.8,-1.6,24,GER
2a158218,21,966,10.7,12,0,9,5,9,15,-6,11.2,15.0,-3.7,24,GER
2a29eb9b,20,1352,15.0,16,9,4,3,21,29,-8,23.1,22.0,1.1,24,GER
2b114be3,26,2118,23.5,25,16,1,0,67,24,43,63.4,19.1,44.3,24,GER
2bab583c,17,1248,13.9,14,11,3,10,17,25,-8,19.4,21.6,-2.2,24,GER
2be28a0c,10,567,6.3,7,2,3,10,8,22,-14,4.6,16.2,-11.6,24,GER
2c0558b8,22,1639,18.2,19,4,3,1,50,19,31,46.6,17.7,28.9,24,GER
2c08cab0,5,27,0.3,0,0,5,17,1,0,1,0.9,0.1,0.8,24,GER
2d5f03bf,15,965,10.7,9,6,6,3,7,28,-21,8.3,24.0,-15.7,24,GER
2d61d13a,21,1756,19.5,21,14,0,1,29,40,-11,28.2,33.8,-5.5,24,GER
2d970560,24,1789,19.9,21,5,3,0,19,32,-13,24.0,26.1,-2.1,24,GER
2e77d607,8,368,4.1,5,0,3,0,2,5,-3,5.1,7.0,-1.9,24,GER
2f7fec15,5,106,1.2,1,0,4,7,2,4,-2,3.9,1.6,2.3,24,GER
2ff76adc,18,1553,17.3,18,13,0,2,11,23,-12,21.2,23.3,-2.1,24,GER
302527b2,15,1265,14.1,14,13,1,1,17,23,-6,19.1,22.0,-2.9,24,GER
30ae134d,25,1732,19.2,20,7,5,1,20,31,-11,25.400000000000002,25.1,0.40000000000000013,24,GER
30c220c3,24,2096,23.3,24,20,0,1,31,35,-4,31.6,36.4,-4.8,24,GER
313254a3,24,1697,18.9,19,17,5,3,24,32,-8,25.3,29.9,-4.6,24,GER
319fa018,3,18,0.2,0,0,3,7,0,2,-2,0.0,1.4,-1.3,24,GER
324ff0da,5,50,0.6,0,0,5,10,0,2,-2,0.9,2.0,-1.1,24,GER
3260690c,24,1029,11.4,11,2,13,2,20,18,2,17.7,13.9,3.8,24,GER
3397e7b5,27,1873,20.8,24,3,3,0,36,30,6,27.9,29.9,-1.9,24,GER
33b38f49,6,47,0.5,0,0,6,3,1,1,0,0.5,1.4,-0.9,24,GER
346d51d9,25,2241,24.9,25,24,0,0,43,49,-6,35.2,39.9,-4.8,24,GER
3489184e,20,1476,16.4,17,10,3,0,20,34,-14,17.1,31.5,-14.4,24,GER
34b0387f,23,1599,17.8,18,4,5,0,18,28,-10,21.9,22.2,-0.3,24,GER
34b54da7,3,21,0.2,0,0,3,8,1,1,0,0.6,0.5,0.1,24,GER
34e12499,26,2291,25.5,26,23,0,1,53,31,22,47.6,37.7,9.9,24,GER
357103bd,23,1489,16.5,16,4,7,1,30,26,4,24.1,26.9,-2.8,24,GER
35d64857,26,2240,24.9,26,18,0,1,38,32,6,31.9,36.8,-4.9,24,GER
36578017,3,18,0.2,0,0,3,4,1,0,1,0.9,0.4,0.5,24,GER
36a3ff67,20,1290,14.3,15,1,5,5,28,21,7,23.5,22.8,0.6,24,GER
36a59ba4,23,1202,13.4,15,2,8,3,21,24,-3,19.4,21.2,-1.8,24,GER
36cf2caf,20,1215,13.5,15,8,5,1,14,27,-13,15.2,25.1,-9.9,24,GER
3745e8bd,8,430,4.8,4,1,4,0,4,10,-6,5.0,10.9,-5.9,24,GER
378825c7,17,1033,11.5,11,7,6,3,21,17,4,23.0,19.5,3.5,24,GER
37dc1a48,1,83,0.9,1,0,0,1,1,0,1,1.4,0.5,0.9,24,GER
37f606f0,3,64,0.7,0,0,3,0,0,2,-2,0.5,2.8,-2.3,24,GER
395bbb60,14,140,1.6,0,0,14,13,2,2,0,3.4,2.8,0.6,24,GER
3b1ed320,26,2239,24.799999999999997,25,21,1,0,57,30,27,53.2,27.8,25.4,24,GER
3bb625ac,16,1131,12.6,12,10,4,3,13,30,-17,13.3,20.9,-7.5,24,GER
3c151571,1,18,0.2,0,0,1,2,0,0,0,0.5,0.1,0.4,24,GER
3c6089ab,25,1128,12.5,14,0,11,2,36,14,22,33.0,11.2,21.8,24,GER
3dbdbb6a,16,750,8.3,8,1,8,0,7,26,-19,5.8,19.5,-13.7,24,GER
3eeb80e0,22,1338,14.9,18,0,4,2,26,22,4,19.0,20.8,-1.8,24,GER
431c837b,18,1102,12.2,14,9,4,5,15,26,-11,13.2,25.1,-11.9,24,GER
437f2b00,25,984,10.9,10,0,15,2,19,13,6,25.6,9.2,16.4,24,GER
442b56fa,26,1493,16.6,15,9,11,0,21,25,-4,20.9,23.0,-2.1,24,GER
44a20f0c,11,602,6.7,6,6,5,11,12,15,-3,11.6,11.7,-0.1,24,GER
462475ed,21,1261,14.0,14,9,7,4,11,24,-13,18.7,19.1,-0.3,24,GER
4658e309,2,29,0.3,0,0,2,4,2,0,2,1.0,1.1,-0.2,24,GER
46750e9c,1,5,0.1,0,0,1,5,0,0,0,0.1,0.2,-0.1,24,GER
47064058,27,2430,27.0,27,27,0,0,45,52,-7,41.3,50.2,-8.9,24,GER
48035304,24,1948,21.6,22,19,2,0,34,38,-4,29.2,31.7,-2.5,24,GER
48780156,5,62,0.7,0,0,5,13,2,4,-2,1.8,3.1,-1.3,24,GER
489d4867,2,47,0.5,0,0,2,2,0,0,0,1.6,0.8,0.9,24,GER
49296448,21,1615,17.9,20,13,1,0,46,22,24,47.5,13.5,34.1,24,GER
493924a7,21,1687,18.7,18,14,3,1,26,25,1,25.2,27.1,-1.9,24,GER
496aeede,14,249,2.8,1,0,13,6,3,10,-7,3.4,8.0,-4.6,24,GER
49fe9070,8,207,2.3,2,0,6,4,6,4,2,4.8,3.3,1.5,24,GER
4aea5077,9,355,3.9,3,0,6,1,7,8,-1,5.3,6.2,-0.9,24,GER
4b803b3c,22,1812,20.1,21,15,1,0,38,39,-1,30.0,31.2,-1.2,24,GER
4ccd8957,26,2091,23.2,26,6,0,0,33,39,-6,26.1,39.6,-13.5,24,GER
4cd41883,7,101,1.1,1,0,6,7,2,2,0,1.1,2.6,-1.5,24,GER
4f16405e,27,2071,23.0,25,10,2,0,43,30,13,37.9,37.900000000000006,0.0,24,GER
4f96ed39,1,12,0.1,0,0,1,5,0,1,-1,0.0,0.0,0.0,24,GER
501055d8,16,636,7.1,6,0,10,3,13,11,2,12.2,13.4,-1.2,24,GER
50871bcc,1,7,0.1,0,0,1,1,1,0,1,0.3,0.0,0.2,24,GER
50dc94ce,6,318,3.5,4,0,2,6,4,3,1,4.4,4.9,-0.5,24,GER
50ff205b,7,391,4.300000000000001,4,2,3,19,7,10,-3,5.4,9.7,-4.199999999999999,24,GER
51d29173,4,76,0.8,0,0,4,2,2,2,0,0.9,2.0,-1.0,24,GER
526ea7cc,7,590,6.6,7,6,0,5,10,14,-4,11.6,12.3,-0.7,24,GER
52ec54d0,7,460,5.1,6,2,1,5,3,13,-10,7.1,7.0,0.1,24,GER
54d2b378,4,28,0.3,0,0,4,1,1,0,1,0.3,1.1,-0.8,24,GER
54e4866f,25,1841,20.5,23,4,2,2,26,37,-11,29.0,28.5,0.5,24,GER
5521f419,21,337,3.7,3,0,18,6,8,2,6,9.9,2.8,7.1,24,GER
554bcc91,25,1055,11.7,9,2,16,0,21,17,4,19.3,20.4,-1.1,24,GER
555d5edd,17,868,9.7,10,7,7,11,8,16,-8,13.8,16.7,-2.9,24,GER
57382429,24,1996,22.2,24,3,0,0,32,38,-6,25.0,41.5,-16.5,24,GER
5762be5c,26,2149,23.9,25,18,1,0,53,29,24,48.3,25.3,23.0,24,GER
57d9f511,17,562,6.2,5,0,12,8,10,10,0,9.4,10.9,-1.5,24,GER
57ec75bf,12,536,6.0,7,3,5,1,10,6,4,8.0,10.5,-2.5,24,GER
582a5247,21,1246,13.8,13,8,8,2,23,27,-4,23.2,23.7,-0.5,24,GER
58468842,5,60,0.7,0,0,5,3,2,0,2,1.7,0.6,1.0,24,GER
59e4b92e,15,985,10.9,13,7,2,0,11,12,-1,11.7,12.3,-0.6,24,GER
5b92d896,8,268,3.0,2,0,6,0,2,6,-4,3.6,5.1,-1.5,24,GER
5b9512c5,25,1561,17.3,17,15,8,2,38,21,17,35.0,21.6,13.4,24,GER
5bc43860,23,759,8.4,8,0,15,2,10,13,-3,8.1,12.6,-4.5,24,GER
5c4bf6ba,23,2070,23.0,23,23,0,0,21,43,-22,24.7,34.8,-10.1,24,GER
5c50fdbc,23,1157,12.9,12,6,11,2,15,24,-9,17.1,15.5,1.6,24,GER
5c899683,9,522,5.8,7,3,2,11,6,16,-10,7.6,10.9,-3.3,24,GER
5d4f7d61,14,797,8.9,9,3,5,3,17,4,13,19.9,5.6,14.3,24,GER
5d8e331f,22,1798,20.0,20,17,2,0,32,37,-5,30.6,31.9,-1.2,24,GER
5db45ee5,26,1866,20.7,22,8,4,0,35,38,-3,32.7,35.5,-2.8,24,GER
5dbfd101,10,346,3.8,2,2,8,11,3,9,-6,3.8,7.7,-3.9,24,GER
5dc15574,1,15,0.2,0,0,1,0,1,0,1,0.8,0.8,0.0,24,GER
5ddb8f9f,17,797,8.9,9,4,8,7,10,18,-8,8.7,11.5,-2.8,24,GER
5e080f73,3,54,0.6,0,0,3,1,2,1,1,1.1,1.4,-0.3,24,GER
5e66fa06,27,2346,26.1,26,24,1,0,62,33,29,58.1,27.5,30.5,24,GER
5fa2e0cf,26,2340,26.0,26,26,0,0,27,66,-39,26.6,56.4,-29.8,24,GER
5fd5e542,1,3,0.0,0,0,1,10,0,0,0,0.4,0.0,0.4,24,GER
603cb947,23,1592,17.7,18,7,5,1,33,31,2,28.2,31.4,-3.1,24,GER
610aa1e9,13,635,7.1,6,4,7,12,4,14,-10,5.0,17.3,-12.4,24,GER
61590953,11,631,7.0,7,4,4,3,7,14,-7,9.8,13.2,-3.4,24,GER
616c09f5,21,927,10.3,10,1,11,3,16,18,-2,11.3,19.3,-8.0,24,GER
6190474d,19,506,5.6,5,1,14,0,15,8,7,11.5,6.2,5.4,24,GER
62ab9184,20,1180,13.1,13,3,7,5,16,16,0,17.4,15.3,2.2,24,GER
638a4d71,27,2172,24.1,26,13,1,0,30,40,-10,30.7,38.6,-7.9,24,GER
63b9cc6d,2,32,0.4,0,0,2,3,2,0,2,0.7,0.8,-0.1,24,GER
640134d6,6,76,0.8,0,0,6,0,1,2,-1,1.0,2.5,-1.5,24,GER
64d7f629,22,1623,18.0,18,11,4,3,13,39,-26,17.3,41.6,-24.3,24,GER
64f69877,20,1036,11.5,13,3,7,1,9,11,-2,12.6,15.4,-2.8,24,GER
65857fdf,24,1920,21.3,23,10,1,0,21,52,-31,18.0,44.9,-26.9,24,GER
663e080e,20,1800,20.0,20,20,0,7,43,28,15,38.4,25.3,13.1,24,GER
677da306,26,2291,25.5,26,24,0,0,43,42,1,34.0,39.4,-5.3,24,GER
697dc00a,19,1139,12.7,13,6,6,6,6,41,-35,10.1,31.1,-21.0,24,GER
699fb8db,8,413,4.6,5,3,3,16,3,5,-2,5.5,9.9,-4.4,24,GER
6b8887c2,18,441,4.9,4,0,14,4,4,3,1,5.6,8.1,-2.4,24,GER
6bd5cd5d,19,1671,18.6,18,16,1,5,20,27,-7,19.0,27.3,-8.3,24,GER
6c8ddd52,2,109,1.2,1,0,1,2,2,2,0,1.2,1.2,-0.1,24,GER
6ce43701,15,355,3.9,2,0,13,8,11,5,6,10.6,5.0,5.7,24,GER
6e269dd3,14,340,3.8,3,0,11,5,4,4,0,4.3,5.6,-1.2,24,GER
6ec6fde0,14,827,9.2,8,6,6,7,15,18,-3,13.5,17.1,-3.6,24,GER
6ecbddf6,25,1614,17.9,19,3,6,0,28,31,-3,22.4,27.3,-4.9,24,GER
70d4c949,5,81,0.9,0,0,5,1,2,2,0,2.1,1.2,0.9,24,GER
70dcf94d,18,1123,12.5,14,6,4,4,8,26,-18,11.5,19.8,-8.3,24,GER
71ec39ef,17,1136,12.6,13,6,4,3,8,16,-8,15.0,15.6,-0.6,24,GER
74f2e748,25,1932,21.5,24,6,1,1,52,17,35,43.0,19.3,23.7,24,GER
75402e99,24,1936,21.5,23,14,1,0,27,39,-12,24.4,43.2,-18.8,24,GER
75645f0e,5,168,1.9,1,1,4,3,7,1,6,5.6,1.0,4.6,24,GER
76abb354,1,45,0.5,0,0,1,4,3,0,3,2.6,1.0,1.6,24,GER
76fa965f,12,381,4.2,3,0,9,9,6,8,-2,6.6,7.8,-1.2,24,GER
77cfae67,11,559,6.2,7,5,4,6,7,17,-10,5.8,13.5,-7.7,24,GER
796a5f30,12,849,9.4,10,7,2,9,11,22,-11,10.1,16.2,-6.1,24,GER
79c90e45,22,1791,19.9,21,12,1,0,34,36,-2,31.3,38.9,-7.6,24,GER
79f7302a,2,17,0.2,0,0,2,15,1,0,1,1.4,0.0,1.4,24,GER
7bbb0ac4,20,1346,15.0,13,11,7,2,14,41,-27,12.5,35.7,-23.3,24,GER
7bf9400b,26,2209,24.5,24,23,2,0,19,41,-22,28.3,35.1,-6.7,24,GER
7c24eaf8,2,11,0.1,0,0,2,16,0,0,0,0.0,0.1,-0.1,24,GER
7c254c75,1,7,0.1,0,0,1,2,0,0,0,0.0,0.0,0.0,24,GER
7ca196eb,24,738,8.2,6,1,18,3,12,11,1,13.8,13.1,0.7,24,GER
7d31f1cb,5,68,0.8,0,0,5,7,1,4,-3,0.5,2.3,-1.8,24,GER
7d3e7da6,9,810,9.0,9,9,0,16,26,9,17,22.9,6.6,16.4,24,GER
7d450ed3,27,2379,26.4,27,21,0,0,58,32,26,52.5,30.2,22.3,24,GER
7e12a98d,7,379,4.2,4,3,3,1,5,2,3,3.5,3.0,0.5,24,GER
7ebd0896,18,1216,13.5,12,7,6,2,11,25,-14,12.9,25.8,-12.9,24,GER
7ed08d5c,16,1070,11.9,11,10,5,9,28,8,20,25.8,9.2,16.6,24,GER
7f73bdf4,17,1179,13.1,14,8,3,4,19,26,-7,17.3,22.7,-5.4,24,GER
7fa4e703,11,280,3.1,1,0,10,4,9,4,5,11.4,5.0,6.5,24,GER
7fe12375,1,90,1.0,1,1,0,4,1,4,-3,0.8,2.1,-1.3,24,GER
80f252f6,3,31,0.3,0,0,3,4,0,0,0,1.1,0.1,1.0,24,GER
822b83e8,1,32,0.4,0,0,1,2,0,0,0,0.2,0.4,-0.2,24,GER
826e8b63,21,1256,14.0,16,3,5,7,20,21,-1,19.0,19.2,-0.2,24,GER
829aa60c,23,583,6.5,1,1,22,4,25,12,13,19.3,9.1,10.2,24,GER
82bfc14d,16,1046,11.6,11,9,5,6,10,30,-20,13.5,23.1,-9.6,24,GER
82e12fe7,13,96,1.1,0,0,13,8,1,5,-4,0.9,3.4,-2.4,24,GER
83e1f40e,22,1506,16.7,19,8,3,3,20,36,-16,19.0,30.4,-11.4,24,GER
8575037f,7,213,2.4,2,0,5,11,1,5,-4,2.6,5.8,-3.2,24,GER
857a5abe,10,666,7.4,8,4,2,4,6,21,-15,6.1,12.6,-6.4,24,GER
8593f88c,8,543,6.0,6,3,2,1,12,9,3,10.2,10.0,0.2,24,GER
85b6462d,11,349,3.9,3,1,8,2,6,9,-3,3.4,8.6,-5.2,24,GER
8652a85c,27,2089,23.2,26,9,1,0,52,27,25,47.1,25.7,21.5,24,GER
86574238,18,1311,14.6,15,6,3,1,24,24,0,19.6,20.7,-1.1,24,GER
86adbcc7,6,112,1.2,0,0,6,2,0,3,-3,1.9,1.6,0.3,24,GER
86c75897,19,1506,16.7,17,16,2,0,17,41,-24,19.9,40.0,-20.1,24,GER
86e119e0,23,1877,20.9,20,20,3,0,24,37,-13,24.6,29.0,-4.4,24,GER
87436846,27,2430,27.0,27,27,0,0,21,48,-27,27.6,55.0,-27.4,24,GER
8778c910,18,1620,18.0,18,18,0,0,52,24,28,49.9,17.6,32.2,24,GER
8779ddf8,4,55,0.6,0,0,4,5,0,1,-1,0.5,1.1,-0.6,24,GER
877bc844,22,1019,11.3,11,2,11,2,15,28,-13,15.5,20.1,-4.6,24,GER
88d4144a,25,1563,17.4,17,10,8,2,41,20,21,39.7,17.3,22.4,24,GER
88e357ef,8,303,3.4,3,0,5,3,12,3,9,10.0,2.1,7.9,24,GER
8a958856,2,34,0.4,0,0,2,1,0,0,0,0.5,0.3,0.2,24,GER
8b84b707,9,511,5.7,5,3,4,2,6,8,-2,9.6,6.9,2.7,24,GER
8e235926,25,1193,13.3,13,5,12,0,24,18,6,25.2,18.9,6.3,24,GER
8eb55dbb,11,645,7.2,7,1,4,0,6,17,-11,9.6,12.1,-2.5,24,GER
8eb5c94c,1,64,0.7,1,0,0,3,0,1,-1,1.1,1.5,-0.4,24,GER
8f056768,24,2120,23.6,24,20,0,0,52,29,23,47.7,25.8,21.9,24,GER
8f325097,6,276,3.1,3,0,3,8,4,7,-3,3.4,2.5,0.9,24,GER
923f4dda,21,1585,17.6,18,10,3,0,44,19,25,38.5,17.6,20.9,24,GER
92432bc6,14,950,10.6,12,4,2,2,28,11,17,25.6,10.9,14.7,24,GER
924f9191,21,1626,18.1,20,13,1,0,31,34,-3,30.1,31.1,-1.0,24,GER
92a16062,24,2015,22.4,23,18,1,0,18,38,-20,22.1,47.2,-25.2,24,GER
92d83c27,21,1568,17.4,19,5,2,4,22,28,-6,22.4,25.0,-2.7,24,GER
932bfcac,19,1470,16.3,17,12,2,8,22,25,-3,17.7,27.2,-9.4,24,GER
93a50d2c,1,5,0.1,0,0,1,7,0,0,0,0.0,0.3,-0.3,24,GER
93a8c4f9,15,450,5.0,3,0,12,11,7,12,-5,10.5,9.6,0.9,24,GER
94302c52,24,2148,23.9,24,23,0,0,17,41,-24,25.2,48.2,-22.9,24,GER
94c18565,26,1811,20.1,24,5,2,1,16,34,-18,19.5,38.3,-18.8,24,GER
95bb6ddc,26,1657,18.4,21,4,5,0,26,20,6,21.8,24.8,-3.0,24,GER
962e54cb,17,628,7.0,6,0,11,6,12,11,1,11.7,13.1,-1.4,24,GER
9662c9ec,18,1378,15.3,15,12,3,3,17,23,-6,18.1,25.2,-7.1,24,GER
966e28d0,9,165,1.8,1,0,8,7,2,0,2,1.9,1.2,0.6,24,GER
96cfb5e2,1,7,0.1,0,0,1,7,0,1,-1,0.0,0.2,-0.2,24,GER
97d545ae,13,988,11.0,11,8,2,0,14,22,-8,16.8,16.9,-0.1,24,GER
99219195,1,90,1.0,1,1,0,20,2,3,-1,0.4,1.6,-1.3,24,GER
99f7e9aa,18,982,10.9,14,1,4,7,28,11,17,22.6,12.5,10.1,24,GER
9a2e0ccc,14,464,5.2,5,0,9,2,12,5,7,8.9,9.1,-0.3,24,GER
9a2e3a23,21,515,5.7,3,1,18,3,10,12,-2,9.1,12.1,-2.9,24,GER
9ab16552,6,133,1.5,1,1,5,20,3,4,-1,1.9,3.7,-1.7,24,GER
9b545925,18,911,10.1,10,5,8,3,25,13,12,18.9,9.9,9.0,24,GER
9b5d89b3,8,133,1.5,1,0,7,4,2,4,-2,1.1,3.8,-2.7,24,GER
9b688ae1,21,1890,21.0,21,21,0,7,24,27,-3,25.4,31.6,-6.3,24,GER
9efa1d25,25,1635,18.2,18,5,7,1,25,19,6,23.6,26.2,-2.6,24,GER
9f77012e,24,1255,13.9,13,3,11,2,14,25,-11,15.7,20.0,-4.3,24,GER
9f941969,26,2340,26.0,26,26,0,0,31,52,-21,33.6,49.6,-16.0,24,GER
a167537f,25,1817,20.2,22,11,3,0,38,23,15,35.9,30.4,5.5,24,GER
a2a85828,13,321,3.6,1,0,12,0,7,7,0,5.7,6.2,-0.5,24,GER
a396fb61,23,1889,21.0,21,18,2,2,23,46,-23,24.9,39.5,-14.7,24,GER
a3ddb1b9,7,258,2.9,3,0,4,2,2,7,-5,4.0,8.6,-4.7,24,GER
a45241d5,24,1016,11.3,10,1,14,2,18,16,2,16.7,16.3,0.4,24,GER
a4effc55,19,1453,16.1,16,14,3,0,37,22,15,34.7,16.7,18.0,24,GER
a53b661f,25,1310,14.6,13,5,12,2,21,31,-10,20.2,29.4,-9.2,24,GER
a5ae8f8e,17,1393,15.5,15,14,2,1,21,30,-9,18.7,27.9,-9.2,24,GER
a65ce836,22,1704,18.9,19,14,3,1,37,21,16,33.6,25.2,8.4,24,GER
a70b8345,26,2340,26.0,26,26,0,0,25,40,-15,30.4,37.3,-6.9,24,GER
a73c8f95,22,1547,17.2,17,14,5,1,42,14,28,33.4,17.4,16.0,24,GER
a8ee54ad,14,1000,11.100000000000001,10,7,4,2,18,11,7,15.5,15.4,0.09999999999999998,24,GER
a93b6f4e,5,227,2.5,2,2,3,16,1,5,-4,2.3,4.6,-2.3,24,GER
a96103b2,2,44,0.5,0,0,2,4,2,1,1,2.4,1.1,1.3,24,GER
aad48be9,14,1059,11.8,12,10,2,2,20,15,5,19.4,16.7,2.7,24,GER
ab1a72b4,13,771,8.5,8,6,5,2,8,22,-14,9.0,19.1,-10.100000000000001,24,GER
ab5b7dc1,24,1047,11.6,12,4,12,0,16,23,-7,18.8,22.2,-3.4,24,GER
ab700320,15,458,5.1,4,1,11,5,14,4,10,10.2,7.0,3.2,24,GER
ac861941,10,761,8.5,8,7,2,1,24,14,10,21.2,10.4,10.9,24,GER
ad00b1a8,16,875,9.7,10,5,6,8,8,14,-6,9.2,16.3,-7.1,24,GER
ad3389d5,26,2340,26.0,26,26,0,1,68,19,49,52.8,23.0,29.8,24,GER
add37c13,6,123,1.4,1,0,5,2,1,1,0,2.0,1.7,0.3,24,GER
ae44e8e2,16,1029,11.4,12,5,4,0,27,17,10,18.8,12.7,6.1,24,GER
ae7058f9,25,2107,23.4,25,21,0,0,21,40,-19,24.5,46.3,-21.8,24,GER
ae961785,6,75,0.8,0,0,6,3,2,1,1,1.9,3.2,-1.3,24,GER
ae9b998d,22,1161,12.9,13,2,9,1,9,25,-16,16.7,21.1,-4.5,24,GER
af0d79a9,2,46,0.5,0,0,2,0,0,4,-4,0.4,0.8,-0.4,24,GER
afb0c500,24,2160,24.0,24,24,0,0,57,31,26,53.1,24.7,28.5,24,GER
b06a7ae9,1,4,0.0,0,0,1,3,0,0,0,0.1,0.0,0.1,24,GER
b116c6e3,21,1324,14.7,15,8,6,6,13,32,-19,13.2,30.1,-16.9,24,GER
b146275b,16,1276,14.2,15,4,1,0,42,12,30,29.9,14.3,15.6,24,GER
b1f4086c,27,2422,26.9,27,24,0,0,67,19,48,55.6,23.2,32.4,24,GER
b3b7f5a6,5,15,0.2,0,0,5,7,1,1,0,1.0,0.9,0.1,24,GER
b4705807,24,1373,15.3,16,6,8,2,25,24,1,20.4,25.1,-4.7,24,GER
b492126a,20,841,9.3,8,0,12,2,8,17,-9,11.1,15.3,-4.2,24,GER
b4b08774,11,257,2.9,3,0,8,14,1,7,-6,3.1,3.6,-0.4,24,GER
b56dd813,7,605,6.7,6,6,1,20,15,6,9,11.5,7.4,4.1,24,GER
b5e0af76,17,1197,13.3,15,8,2,0,15,32,-17,13.9,27.9,-14.1,24,GER
b684a484,21,1340,14.9,17,6,4,1,27,28,-1,25.2,20.700000000000003,4.5,24,GER
b74277a0,15,1021,11.3,13,8,2,1,38,12,26,31.7,8.8,22.9,24,GER
b77f44a4,17,977,10.9,10,9,7,9,16,26,-10,14.1,23.4,-9.3,24,GER
b825a650,22,1318,14.6,14,7,8,4,30,14,16,25.1,16.8,8.3,24,GER
b8e17ca3,2,2,0.0,0,0,2,2,0,0,0,0.0,0.0,0.0,24,GER
b8e740fb,1,10,0.1,0,0,1,1,0,1,-1,0.6,0.3,0.3,24,GER
b9ac6e0e,14,353,3.9,3,0,11,5,6,10,-4,6.2,9.0,-2.8,24,GER
ba115a40,12,378,4.2,4,0,8,3,6,5,1,7.8,4.9,2.9,24,GER
bb1cf301,18,867,9.6,12,0,6,7,12,15,-3,11.0,12.4,-1.4,24,GER
bbd79358,20,931,10.3,10,2,10,3,12,19,-7,11.6,19.0,-7.3,24,GER
bbd86530,5,46,0.5,0,0,5,19,3,0,3,1.5,0.4,1.1,24,GER
bc249af8,21,461,5.1,4,0,17,3,5,6,-1,6.3,9.5,-3.1,24,GER
bc67a0e1,1,90,1.0,1,1,0,25,0,0,0,2.9,0.3,2.6,24,GER
bc6bd723,20,1399,15.5,17,3,3,0,29,30,-1,19.4,25.8,-6.4,24,GER
bcb2ccd8,7,630,7.0,7,7,0,15,17,4,13,15.3,5.5,9.8,24,GER
bd142efb,24,2117,23.5,24,22,0,2,62,19,43,47.8,22.3,25.4,24,GER
be5e1c4c,16,317,3.5,3,0,13,10,5,6,-1,6.6,6.5,0.1,24,GER
beb882a8,26,2285,25.4,26,22,0,0,35,43,-8,38.5,38.6,-0.1,24,GER
bf075f6b,21,1422,15.8,17,4,4,0,23,30,-7,23.9,21.6,2.3,24,GER
c05f2f8c,5,351,3.9,3,2,2,11,3,6,-3,3.7,6.9,-3.3,24,GER
c0b3669f,2,153,1.7,2,0,0,0,1,1,0,1.9,1.3,0.6,24,GER
c1b7847c,23,1516,16.8,15,10,8,0,55,16,39,50.7,12.0,38.7,24,GER
c2211709,22,1770,19.7,19,17,3,0,28,23,5,27.8,27.9,-0.1,24,GER
c38767ab,14,549,6.1,5,2,9,5,6,11,-5,5.8,8.5,-2.7,24,GER
c455a2b2,23,1778,19.8,21,12,2,0,14,33,-19,19.3,37.2,-17.9,24,GER
c459a650,25,2112,23.5,24,19,1,0,28,37,-9,29.5,30.5,-1.0,24,GER
c4987edc,25,2133,23.7,24,20,1,0,21,36,-15,27.5,34.5,-7.0,24,GER
c4e87b8b,22,1663,18.5,20,10,2,1,32,28,4,28.5,30.7,-2.2,24,GER
c631f952,3,270,3.0,3,3,0,0,4,10,-6,4.2,6.8,-2.6,24,GER
c68da769,19,991,11.0,11,2,8,1,13,18,-5,12.8,17.4,-4.6,24,GER
c89e8aae,6,540,6.0,6,6,0,21,8,11,-3,9.3,6.3,3.1,24,GER
c8b3a472,2,76,0.8,1,0,1,9,1,2,-1,0.8,1.4,-0.6,24,GER
c967f6b8,10,345,3.8,3,2,7,15,3,6,-3,4.1,6.2,-2.0,24,GER
ca618d23,27,1966,21.8,22,9,5,0,29,43,-14,28.8,31.6,-2.7,24,GER
ca8033cb,19,1253,13.9,14,12,5,3,30,19,11,30.9,14.8,16.1,24,GER
cab9634e,11,958,10.6,11,7,0,0,24,7,17,19.5,12.3,7.2,24,GER
cb11b429,9,345,3.8,5,0,4,3,9,4,5,5.9,3.4,2.6,24,GER
cb6d81b3,18,1125,12.5,13,1,5,5,10,15,-5,13.8,19.4,-5.6,24,GER
cc86b9a3,23,1750,19.4,20,15,3,0,49,28,21,49.2,19.0,30.2,24,GER
cc971106,27,1683,18.7,19,5,8,0,35,35,0,27.7,29.6,-1.9,24,GER
cd59b9df,21,1825,20.3,21,20,0,0,40,26,14,39.2,33.2,6.0,24,GER
ce17b5eb,26,2340,26.0,26,26,0,0,39,34,5,32.8,39.4,-6.6,24,GER
cf007308,9,141,1.6,1,0,8,2,4,2,2,4.0,1.9,2.1,24,GER
d01bbb6f,23,1617,18.0,19,7,4,0,26,29,-3,26.4,28.0,-1.6,24,GER
d07d0aeb,6,371,4.1,4,2,2,10,2,9,-7,4.3,5.7,-1.5,24,GER
d2416c2e,26,1158,12.9,11,2,15,1,34,13,21,28.9,16.3,12.6,24,GER
d248cd8f,19,1385,15.4,16,11,3,3,32,18,14,37.7,10.9,26.8,24,GER
d28339cb,3,270,3.0,3,3,0,20,6,3,3,5.8,3.8,2.0,24,GER
d2c580ce,8,295,3.3,4,1,4,10,7,3,4,5.5,4.4,1.1,24,GER
d5326924,11,272,3.0,1,0,10,5,2,5,-3,3.4,3.7,-0.3,24,GER
d646c218,2,21,0.2,0,0,2,1,0,1,-1,0.1,0.4,-0.3,24,GER
d6e53a3a,18,1179,13.1,13,11,5,2,45,16,29,38.9,14.0,24.8,24,GER
d781d855,22,1564,17.4,19,11,3,2,51,19,32,46.6,15.6,31.0,24,GER
d7a03bf3,6,268,3.0,2,2,4,3,4,6,-2,2.6,8.6,-6.0,24,GER
d7cdfd81,19,1040,11.6,11,4,8,4,18,29,-11,15.1,28.4,-13.3,24,GER
d82a310a,6,161,1.8,1,0,5,0,0,3,-3,1.0,4.0,-2.9,24,GER
da4d670f,26,2146,23.8,26,8,0,0,54,23,31,48.5,25.6,22.8,24,GER
db401046,21,1890,21.0,21,21,0,0,25,33,-8,23.8,30.1,-6.2,24,GER
db4ed67b,8,147,1.6,1,0,7,0,3,3,0,4.6,1.5,3.2,24,GER
db7849ca,27,2030,22.6,24,9,3,0,42,44,-2,33.2,33.6,-0.4,24,GER
dbd1b101,27,2430,27.0,27,27,0,0,39,48,-9,40.2,41.6,-1.4,24,GER
dbf053da,9,581,6.5,7,0,2,1,15,6,9,12.8,9.2,3.5,24,GER
dc62fbee,23,1099,12.2,13,1,10,3,15,17,-2,14.9,19.5,-4.7,24,GER
dcfb17f4,18,621,6.9,5,0,13,3,19,6,13,15.1,7.4,7.7,24,GER
dd2e62da,18,531,5.9,5,0,13,7,10,16,-6,7.9,11.4,-3.5,24,GER
dd549382,23,1498,16.6,16,6,7,0,39,23,16,39.8,19.5,20.3,24,GER
dd676a97,21,713,7.9,6,3,15,2,12,14,-2,14.5,13.6,0.9,24,GER
dd9caa07,27,2430,27.0,27,27,0,0,38,47,-9,31.6,51.0,-19.4,24,GER
de4cac2d,20,791,8.8,8,0,12,1,25,9,16,23.7,9.4,14.3,24,GER
de838f86,26,2144,23.8,25,20,1,1,29,32,-3,29.7,35.4,-5.7,24,GER
dee3013b,27,2430,27.0,27,27,0,0,44,43,1,38.0,41.9,-3.9,24,GER
df1665d7,2,29,0.3,0,0,2,4,0,2,-2,1.4,1.4,0.0,24,GER
dfb6490a,5,65,0.7,0,0,5,17,2,1,1,1.1,0.9,0.2,24,GER
e0b113a7,21,1068,11.9,11,10,10,6,27,4,23,23.6,8.0,15.6,24,GER
e0f8151c,20,1613,17.9,18,16,2,2,52,22,30,47.8,14.9,32.9,24,GER
e110ea4b,26,1122,12.5,11,0,15,1,21,25,-4,18.3,21.4,-3.1,24,GER
e12b0b5b,7,60,0.7,1,0,6,0,1,3,-2,0.5,1.2,-0.7,24,GER
e162b013,8,586,6.5,7,4,1,2,13,5,8,14.3,8.5,5.8,24,GER
e27da244,18,1461,16.2,18,14,0,6,34,28,6,28.0,29.3,-1.3,24,GER
e280527c,20,1602,17.8,19,15,1,1,37,23,14,33.5,27.7,5.8,24,GER
e33c06cf,19,1205,13.4,11,10,8,6,23,13,10,25.2,21.8,3.4,24,GER
e547d3cf,14,754,8.4,10,1,4,6,13,10,3,13.0,12.6,0.4,24,GER
e5649a78,25,2052,22.8,25,15,0,0,28,49,-21,28.9,42.0,-13.1,24,GER
e5a35ae9,16,857,9.5,10,2,6,0,9,13,-4,12.6,19.8,-7.2,24,GER
e5d85da8,24,1471,16.3,17,4,7,0,13,27,-14,16.4,35.1,-18.7,24,GER
e5f76710,17,1414,15.7,17,12,0,5,20,23,-3,15.6,25.3,-9.7,24,GER
e61b8aee,27,2394,26.6,27,22,0,0,67,19,48,54.5,23.1,31.4,24,GER
e6c43eec,9,402,4.5,5,2,4,7,5,8,-3,5.2,8.7,-3.5,24,GER
e717705a,21,1231,13.7,12,8,9,4,14,20,-6,15.7,20.2,-4.5,24,GER
e75129bd,3,16,0.2,0,0,3,11,1,0,1,1.0,0.0,1.0,24,GER
e79269bd,24,1823,20.3,21,13,3,0,33,33,0,30.3,30.3,-0.1,24,GER
e7f4869a,19,879,9.8,9,3,10,2,10,23,-13,11.0,20.3,-9.3,24,GER
e7fcf289,27,2171,24.1,25,8,2,0,62,18,44,49.7,20.9,28.8,24,GER
e82900ef,12,682,7.6,8,1,4,0,6,16,-10,9.9,10.8,-0.9,24,GER
e82adcab,20,1568,17.4,18,8,2,0,44,15,29,33.4,16.2,17.2,24,GER
e8ef59da,8,364,4.0,4,0,4,1,3,6,-3,5.0,4.6,0.4,24,GER
e9a97974,3,126,1.4,2,0,1,0,1,5,-4,1.4,2.7,-1.3,24,GER
ea6bc03a,25,2198,24.4,25,23,0,0,37,29,8,32.8,34.9,-2.0,24,GER
eb6e14be,8,266,3.0,2,0,6,2,4,7,-3,3.9,5.4,-1.5,24,GER
ec11ecf8,4,47,0.5,0,0,4,6,0,1,-1,0.5,1.1,-0.6,24,GER
ec759ba1,4,360,4.0,4,4,0,12,1,3,-2,6.2,2.9,3.3,24,GER
ecbe2839,27,2430,27.0,27,27,0,0,43,34,9,36.9,41.0,-4.2,24,GER
ed79b7d3,26,2244,24.9,26,17,0,0,41,39,2,34.8,36.8,-2.0,24,GER
ed98c321,10,259,2.9,2,0,8,12,2,7,-5,3.9,6.2,-2.3,24,GER
edb2712b,14,717,8.0,9,5,5,11,7,25,-18,8.9,18.7,-9.8,24,GER
ee644761,18,1463,16.3,17,14,1,4,19,26,-7,16.6,21.2,-4.6,24,GER
f1e94cd6,18,459,5.1,3,1,15,7,14,1,13,11.9,3.4,8.5,24,GER
f24ea523,1,21,0.2,0,0,1,18,0,2,-2,0.1,0.5,-0.4,24,GER
f256f213,27,2430,27.0,27,27,0,0,38,47,-9,31.6,51.0,-19.4,24,GER
f25c8e3a,5,109,1.2,1,0,4,7,3,3,0,1.8,2.3,-0.4,24,GER
f26834c7,21,1406,15.6,16,6,5,1,11,21,-10,13.6,17.4,-3.8,24,GER
f26dee6b,2,180,2.0,2,2,0,26,4,2,2,4.8,2.9,1.9,24,GER
f27680d9,18,1165,12.9,12,6,6,8,15,23,-8,18.1,23.5,-5.4,24,GER
f44e8a73,25,1932,21.5,23,13,2,1,31,38,-7,25.0,43.8,-18.7,24,GER
f521b80a,23,1913,21.3,22,18,1,0,30,39,-9,32.9,31.3,1.6,24,GER
f5b281e7,23,1117,12.4,11,6,12,2,18,12,6,15.6,18.8,-3.2,24,GER
f631c17f,1,32,0.4,0,0,1,0,0,3,-3,0.1,1.7,-1.6,24,GER
f67c9d29,17,1530,17.0,17,17,0,3,18,27,-9,20.1,22.3,-2.2,24,GER
f68b64fc,13,953,10.6,10,4,3,5,7,16,-9,13.6,15.4,-1.8,24,GER
f6bdc830,20,1555,17.3,17,16,3,2,23,30,-7,23.9,30.7,-6.8,24,GER
f76022e7,25,1840,20.4,22,7,3,1,47,23,24,46.0,20.1,25.9,24,GER
f761c901,14,910,10.1,10,9,4,13,13,23,-10,12.7,24.4,-11.7,24,GER
f86ad3f5,20,1747,19.4,20,18,0,0,21,27,-6,22.3,33.6,-11.3,24,GER
f86cd5df,20,903,10.0,9,7,11,3,12,20,-8,10.6,16.6,-6.0,24,GER
f972644c,18,712,7.9,7,1,11,7,3,12,-9,9.2,10.0,-0.8,24,GER
fa661778,16,771,8.6,8,6,8,9,21,12,9,17.6,12.5,5.1,24,GER
fb377d11,17,1138,12.6,11,7,6,0,25,19,6,24.8,14.1,10.8,24,GER
fb6316d5,1,2,0.0,0,0,1,0,0,0,0,0.0,0.1,-0.1,24,GER
fc46aab1,27,1767,19.6,22,2,5,0,29,29,0,25.1,26.3,-1.3,24,GER
fc62fdf4,5,84,0.9,0,0,5,7,1,2,-1,1.3,0.8,0.5,24,GER
fcb27134,26,1869,20.8,20,12,6,0,42,27,15,41.1,25.7,15.4,24,GER
fd53759d,16,1160,12.9,14,6,2,0,8,10,-2,11.3,20.8,-9.6,24,GER
fd82af8c,23,528,5.9,1,0,22,2,12,11,1,9.2,11.7,-2.5,24,GER
fdbe14c8,5,28,0.3,0,0,5,10,0,0,0,0.5,0.0,0.5,24,GER
ff98492b,22,1107,12.3,12,2,10,2,25,26,-1,20.0,20.9,-0.9,24,GER
ffa90327,3,54,0.6,0,0,3,0,1,1,0,0.6,1.9,-1.3,24,GER
ffbbc83b,23,1665,18.5,18,13,5,0,29,39,-10,27.6,36.9,-9.3,24,GER
00242715,16,1160,12.9,12,11,4,10,18,28,-10,17.3,22.4,-5.2,24,ENG
003cf4d1,2,9,0.1,0,0,2,2,2,0,2,0.6,0.1,0.5,24,ENG
00963611,16,1261,14.0,13,13,3,10,24,22,2,21.4,24.3,-2.9,24,ENG
00b77ecf,5,182,2.0,1,0,4,7,4,3,1,2.7,3.3,-0.5,24,ENG
01ce9e70,8,108,1.2,0,0,8,8,3,2,1,4.7,2.5,2.2,24,ENG
01e5f06e,4,31,0.3,0,0,4,22,1,1,0,0.7,1.0,-0.4,24,ENG
02b29014,24,1969,21.9,24,12,0,0,24,27,-3,31.8,30.9,0.9,24,ENG
0313a347,28,2440,27.1,28,24,0,0,55,39,16,45.2,39.0,6.2,24,ENG
03df04ff,5,450,5.0,5,5,0,14,6,12,-6,4.9,7.5,-2.6,24,ENG
0420d84f,7,326,3.6,3,2,4,6,2,4,-2,5.7,4.6,1.1,24,ENG
0442183b,11,719,8.0,7,5,4,18,9,12,-3,8.2,13.2,-5.0,24,ENG
0480ebc7,23,1162,12.9,13,4,10,0,25,28,-3,19.3,23.2,-3.9,24,ENG
049a888d,23,1071,11.9,11,2,12,4,25,20,5,24.4,16.0,8.4,24,ENG
0562b7f1,23,1432,15.9,17,5,6,2,11,23,-12,17.3,19.6,-2.2,24,ENG
05e8ca6d,22,1455,16.200000000000003,16,9,6,1,17,36,-19,17.0,30.6,-13.6,24,ENG
06df8256,10,740,8.2,8,7,2,6,17,20,-3,18.0,13.4,4.6,24,ENG
077faf72,10,232,2.6,1,0,9,9,7,7,0,4.3,3.5,0.8,24,ENG
07802f7f,15,265,2.9,2,0,13,16,4,7,-3,4.8,6.2,-1.4,24,ENG
07d65234,6,152,1.7,1,0,5,7,2,4,-2,1.8,2.8,-1.1,24,ENG
0a3d6d2b,20,1554,17.3,17,17,3,9,23,34,-11,20.0,26.9,-6.9,24,ENG
0ad53bdc,23,1537,17.1,17,8,6,3,19,29,-10,21.8,29.4,-7.6,24,ENG
0ba976e4,15,476,5.3,3,0,12,1,11,10,1,9.4,6.2,3.2,24,ENG
0cd31129,27,1647,18.3,19,3,8,0,41,27,14,31.099999999999998,28.8,2.3000000000000003,24,ENG
0cf321c8,14,1177,13.1,13,13,1,12,27,25,2,27.1,19.6,7.4,24,ENG
0db169ae,8,438,4.9,5,1,3,1,11,5,6,10.1,6.3,3.8,24,ENG
0db5d2c8,11,817,9.1,9,8,2,19,9,17,-8,11.1,14.0,-2.9,24,ENG
0ed063d6,9,421,4.7,4,0,5,17,5,10,-5,3.2,11.0,-7.8,24,ENG
0ef89a37,2,25,0.3,0,0,2,0,1,1,0,0.9,0.6,0.3,24,ENG
0f134faf,26,1768,19.6,22,4,4,0,26,37,-11,27.7,30.7,-3.0,24,ENG
0f7533cd,27,1196,13.3,14,1,13,4,20,26,-6,16.3,24.7,-8.5,24,ENG
104d0bb8,16,737,8.2,8,2,8,1,13,19,-6,11.8,10.7,1.1,24,ENG
10a10454,11,386,4.3,3,1,8,8,4,12,-8,4.0,11.2,-7.2,24,ENG
10cb48b7,5,269,3.0,2,1,3,1,6,8,-2,3.9,5.3,-1.5,24,ENG
10f0fdd3,19,806,9.0,9,1,10,0,5,18,-13,8.2,16.6,-8.3,24,ENG
119b9a8e,1,12,0.1,0,0,1,0,0,0,0,0.1,0.1,0.1,24,ENG
1265a93a,8,388,4.3,5,0,3,0,6,11,-5,7.6,9.5,-1.9,24,ENG
1544f145,16,853,9.5,8,5,8,0,22,12,10,18.5,13.2,5.3,24,ENG
15ab5a2b,29,2287,25.4,27,13,2,1,59,22,37,51.6,22.3,29.3,24,ENG
15ea812b,30,2699,30.0,30,29,0,0,31,42,-11,44.8,43.1,1.7,24,ENG
15f24fe7,11,166,1.8,1,0,10,9,6,2,4,5.5,2.7,2.8,24,ENG
15f3ec41,22,1244,13.8,13,6,9,1,22,27,-5,21.5,19.6,1.8,24,ENG
16264a81,26,2083,23.1,24,15,2,0,43,37,6,44.0,32.3,11.7,24,ENG
169fd162,22,1620,18.0,19,11,3,0,30,24,6,24.6,26.0,-1.3,24,ENG
16e9d0ea,18,1018,11.3,11,5,7,4,22,20,2,19.8,18.1,1.6,24,ENG
1704b0b8,25,2176,24.2,25,22,0,0,31,42,-11,30.9,34.1,-3.2,24,ENG
17695062,11,319,3.5,3,0,8,12,11,1,10,6.2,1.5,4.7,24,ENG
1780bb4a,9,713,7.9,9,2,0,0,10,12,-2,10.3,10.3,0.1,24,ENG
178ae8f8,19,1047,11.6,13,3,6,0,31,9,22,25.9,12.9,13.0,24,ENG
1961b2aa,7,249,2.8,1,0,6,2,4,5,-1,4.4,4.8,-0.4,24,ENG
1971591f,28,1183,13.1,12,1,16,0,37,14,23,31.8,17.3,14.5,24,ENG
197640fd,27,2093,23.3,23,19,4,1,37,31,6,33.0,33.0,0.0,24,ENG
19a9cb70,1,1,0.0,0,0,1,1,0,0,0,0.0,0.4,-0.4,24,ENG
19f4d211,1,4,0.0,0,0,1,0,0,1,-1,0.3,0.6,-0.3,24,ENG
1a066e69,9,725,8.1,8,6,1,0,10,17,-7,10.9,15.9,-4.9,24,ENG
1aa84968,8,321,3.6,3,1,5,0,2,6,-4,3.4,7.3,-4.0,24,ENG
1b4f1169,12,873,9.7,11,4,1,0,17,17,0,16.2,15.9,0.2,24,ENG
1b84dbe1,26,1782,19.8,20,13,6,0,41,26,15,33.7,28.7,5.0,24,ENG
1b9728b0,3,66,0.7,1,0,2,4,1,2,-1,1.3,0.9,0.4,24,ENG
1c7012b8,30,2505,27.8,29,21,1,0,65,23,42,53.5,19.3,34.1,24,ENG
1caa93a5,31,2790,31.0,31,31,0,0,43,64,-21,36.2,63.4,-27.2,24,ENG
1d042188,27,2376,26.4,26,24,1,1,28,60,-32,27.3,49.1,-21.8,24,ENG
1daec722,12,973,10.8,11,8,1,6,26,21,5,22.6,17.1,5.4,24,ENG
1df4a109,10,273,3.0,3,1,7,4,3,6,-3,6.4,6.5,-0.2,24,ENG
1f44ac21,24,2012,22.4,23,18,1,1,45,21,24,44.2,22.2,22.0,24,ENG
20b104bc,21,1599,17.8,18,12,3,5,31,26,5,29.7,23.0,6.7,24,ENG
20b3a502,21,1362,15.1,18,3,3,6,16,25,-9,17.2,20.2,-3.0,24,ENG
21512407,25,2163,24.0,25,21,0,0,48,41,7,43.9,38.3,5.6,24,ENG
215f3907,16,409,4.5,2,0,14,3,8,5,3,8.2,5.8,2.4,24,ENG
21945a9e,1,1,0.0,0,0,1,3,0,0,0,0.0,0.0,0.0,24,ENG
230f0471,19,961,10.7,9,8,10,11,12,19,-7,17.2,18.4,-1.2,24,ENG
2389cdc2,26,1898,21.1,21,15,5,1,44,32,12,37.7,31.0,6.8,24,ENG
246d153b,16,1154,12.8,14,4,2,3,19,26,-7,14.0,21.1,-7.1,24,ENG
24fae784,14,823,9.1,8,6,6,5,7,22,-15,8.4,19.0,-10.7,24,ENG
2500cef9,27,2040,22.7,24,9,3,0,28,31,-3,35.7,30.4,5.3,24,ENG
259fea27,28,2520,28.0,28,28,0,2,27,62,-35,25.6,49.4,-23.8,24,ENG
2628fd2b,31,2790,31.0,31,31,0,0,47,50,-3,41.9,53.2,-11.2,24,ENG
2696b6a9,26,1387,15.4,13,2,13,5,19,31,-12,17.5,33.4,-15.9,24,ENG
26ce2263,29,2279,25.3,28,13,1,0,37,45,-8,37.4,38.2,-0.8,24,ENG
27d0a506,27,2426,27.0,27,25,0,1,54,39,15,48.1,44.0,4.2,24,ENG
27f4f772,1,4,0.0,0,0,1,20,0,1,-1,0.3,0.1,0.2,24,ENG
282f75f3,26,2284,25.4,26,23,0,0,46,39,7,39.0,34.9,4.1,24,ENG
28300a16,15,1350,15.0,15,15,0,15,24,28,-4,26.1,22.3,3.8,24,ENG
2886c9b5,10,229,2.5,2,0,8,9,3,5,-2,4.8,3.0,1.8,24,ENG
288e1e13,20,1767,19.6,20,18,0,3,26,42,-16,24.0,34.9,-10.9,24,ENG
289601e6,30,2648,29.4,30,26,0,0,44,49,-5,39.5,51.5,-12.0,24,ENG
28b40c9c,17,1413,15.7,16,14,1,8,20,27,-7,19.8,25.9,-6.1,24,ENG
2944f86f,23,1146,12.7,11,3,12,2,16,27,-11,22.4,21.3,1.1,24,ENG
2aaadf33,11,140,1.6,1,0,10,15,4,2,2,2.3,3.8,-1.4,24,ENG
2afc7272,25,2070,23.0,24,19,1,0,33,37,-4,35.1,34.2,0.9,24,ENG
2b09d998,2,110,1.2,1,1,1,2,3,1,2,1.9,1.0,0.9,24,ENG
2b471f99,27,2359,26.2,27,21,0,0,37,41,-4,34.2,43.8,-9.6,24,ENG
2bd83368,28,2276,25.3,27,12,1,0,54,41,13,47.8,42.3,5.5,24,ENG
2c6835e5,17,1202,13.4,14,6,3,1,26,29,-3,22.5,30.1,-7.6,24,ENG
2da834f1,31,2232,24.8,25,15,6,0,31,51,-20,28.8,51.7,-22.9,24,ENG
2e4f5f03,16,1097,12.2,11,9,5,0,30,14,16,27.5,16.9,10.6,24,ENG
2e5915f1,6,275,3.1,3,1,3,3,3,7,-4,2.6,7.6,-5.0,24,ENG
2ee5b0c9,28,1823,20.3,26,2,2,3,17,38,-21,16.7,33.2,-16.4,24,ENG
2f90f6b8,15,773,8.6,11,1,4,2,10,12,-2,14.4,12.1,2.2,24,ENG
2f965a72,27,2339,26.0,27,24,0,1,43,42,1,36.6,46.3,-9.7,24,ENG
2f9e4435,22,752,8.4,7,2,15,2,14,14,0,12.5,10.5,2.1,24,ENG
2fba6108,30,2060,22.9,21,14,9,0,33,37,-4,32.4,33.4,-1.1,24,ENG
30d4a2e5,24,2154,23.9,24,22,0,4,26,31,-5,35.2,34.1,1.0,24,ENG
30e81a88,11,307,3.4,3,0,8,0,0,7,-7,1.5,5.7,-4.2,24,ENG
31c69ef1,25,2109,23.4,23,23,2,3,47,24,23,48.6,21.6,26.9,24,ENG
32163807,1,25,0.3,0,0,1,5,0,1,-1,0.2,1.7,-1.5,24,ENG
32e7ce92,1,90,1.0,1,1,0,17,1,4,-3,0.2,2.8,-2.7,24,ENG
32f60ed8,30,2549,28.3,28,21,2,0,36,45,-9,36.4,40.5,-4.2,24,ENG
3312f911,22,1269,14.1,17,2,5,2,9,22,-13,13.4,20.3,-6.9,24,ENG
3353737a,18,945,10.5,11,3,7,5,11,20,-9,12.9,17.2,-4.3,24,ENG
339fe0e8,2,135,1.5,1,1,1,28,3,2,1,1.4,1.6,-0.2,24,ENG
34721c11,3,33,0.4,0,0,3,12,0,1,-1,0.3,0.2,0.1,24,ENG
35141f4c,23,1658,18.4,19,15,4,1,28,33,-5,28.6,30.2,-1.6,24,ENG
3515d404,30,2511,27.9,29,24,1,0,43,52,-9,37.2,52.4,-15.2,24,ENG
35516eac,22,1481,16.5,18,6,4,4,16,36,-20,16.8,32.2,-15.4,24,ENG
35e413f1,29,2314,25.7,27,21,2,0,63,23,40,50.8,18.1,32.7,24,ENG
37118440,14,1169,13.0,14,10,0,0,12,23,-11,12.7,27.0,-14.3,24,ENG
374d5158,9,498,5.5,5,1,4,8,7,7,0,7.2,6.1,1.1,24,ENG
387d06b2,2,91,1.0,1,0,1,0,0,3,-3,0.1,1.6,-1.5,24,ENG
38ceb24a,26,1129,12.5,11,3,15,3,31,9,22,24.5,8.7,15.8,24,ENG
3925dbd6,1,33,0.4,0,0,1,0,1,0,1,1.2,0.6,0.7,24,ENG
394854c4,13,969,10.8,11,9,2,1,11,21,-10,9.3,21.8,-12.5,24,ENG
399e9474,21,1720,19.1,21,18,0,0,30,41,-11,24.6,38.1,-13.5,24,ENG
3a233281,29,1609,17.9,17,1,12,1,40,23,17,34.6,27.4,7.2,24,ENG
3a24769f,26,2143,23.8,24,20,2,0,37,52,-15,27.5,48.4,-20.9,24,ENG
3a949a25,16,1355,15.1,15,15,1,13,31,34,-3,29.3,35.2,-5.9,24,ENG
3b8674e6,15,626,7.0,8,1,7,0,11,13,-2,12.6,11.5,1.1,24,ENG
3bb7b8b4,27,2312,25.7,27,25,0,1,58,25,33,52.5,24.2,28.3,24,ENG
3d554589,6,325,3.6,4,0,2,8,1,7,-6,2.9,5.1,-2.2,24,ENG
3e9e06cb,25,2209,24.5,25,23,0,0,33,38,-5,32.4,39.4,-7.0,24,ENG
3ea50f67,13,474,5.3,4,1,9,0,14,6,8,11.7,6.8,4.9,24,ENG
3eb22ec9,26,2061,22.9,23,18,3,1,52,24,28,48.5,22.8,25.7,24,ENG
3f034750,6,501,5.6,6,5,0,1,8,17,-9,4.7,10.9,-6.3,24,ENG
3f7bafbe,8,50,0.6,0,0,8,5,3,2,1,2.1,1.8,0.2,24,ENG
3fe6bd8c,2,17,0.2,0,0,2,19,0,1,-1,0.1,0.9,-0.8,24,ENG
41034650,1,49,0.5,1,0,0,0,2,0,2,0.3,0.3,0.0,24,ENG
4125cb98,10,623,6.9,7,5,3,16,15,5,10,16.3,6.6,9.7,24,ENG
414184f7,17,345,3.8,2,0,15,4,13,6,7,6.9,6.7,0.2,24,ENG
41f08ac8,24,1194,13.3,12,2,12,2,19,28,-9,22.2,18.9,3.3,24,ENG
43439614,25,1414,15.7,16,12,9,4,12,45,-33,12.0,34.5,-22.6,24,ENG
43a166b4,17,552,6.1,6,0,11,3,4,6,-2,9.2,9.2,0.0,24,ENG
44781702,16,1003,11.1,11,10,5,11,23,18,5,19.8,20.7,-0.9,24,ENG
4506aec5,1,1,0.0,0,0,1,2,0,0,0,0.0,0.2,-0.2,24,ENG
450ab6fc,16,1080,12.0,13,9,3,10,23,15,8,24.5,17.5,7.1,24,ENG
45685411,6,136,1.5,0,0,6,4,1,3,-2,2.4,3.1,-0.7,24,ENG
4596da74,27,1367,15.2,15,4,12,1,24,28,-4,21.5,21.1,0.4,24,ENG
45db685d,20,799,8.9,9,2,11,9,22,9,13,17.2,7.1,10.0,24,ENG
466fb2c5,6,540,6.0,6,6,0,23,11,5,6,11.1,5.8,5.3,24,ENG
468a7a91,21,1037,11.5,13,0,8,4,16,12,4,19.2,15.0,4.1,24,ENG
47369df8,28,2074,23.0,22,18,6,2,25,48,-23,23.0,39.7,-16.7,24,ENG
47a34c4f,3,28,0.3,0,0,3,13,1,0,1,0.8,0.1,0.7,24,ENG
4806ec67,30,2700,30.0,30,30,0,0,31,42,-11,44.8,43.5,1.3,24,ENG
484a3eae,1,1,0.0,0,0,1,6,0,0,0,0.0,0.0,0.0,24,ENG
48a5a5d6,27,1778,19.8,23,3,4,0,47,18,29,38.7,11.9,26.8,24,ENG
491a433d,22,1620,18.0,19,6,3,0,25,23,2,26.6,30.6,-4.0,24,ENG
49fe9070,10,614,6.8,7,1,3,0,15,9,6,14.7,7.0,7.7,24,ENG
4a1a9578,29,2014,22.4,24,9,5,0,51,23,28,48.8,27.0,21.7,24,ENG
4a51ba65,17,1530,17.0,17,17,0,13,24,29,-5,20.5,25.5,-4.9,24,ENG
4ab53cdb,18,770,8.6,7,4,11,10,10,17,-7,8.8,13.2,-4.4,24,ENG
4b40d9ca,14,1255,13.9,14,13,0,0,32,14,18,28.1,14.0,14.1,24,ENG
4b542852,8,619,6.9,7,1,1,0,6,9,-3,6.3,7.8,-1.4,24,ENG
4bcf39f6,27,1323,14.7,13,5,14,2,22,35,-13,25.5,24.6,1.0,24,ENG
4c3a6744,24,1325,14.7,18,0,6,6,20,15,5,24.2,19.7,4.5,24,ENG
4c5835e6,4,16,0.2,0,0,4,8,1,1,0,0.7,0.5,0.2,24,ENG
4d224fe8,17,1262,14.0,16,10,1,1,22,20,2,22.0,25.1,-3.1,24,ENG
4d77b365,28,1743,19.4,19,8,9,1,47,17,30,45.8,21.4,24.4,24,ENG
4dcec659,23,1601,17.8,18,8,5,1,31,27,4,24.8,24.1,0.7,24,ENG
4e015693,29,2431,27.0,27,24,2,0,28,40,-12,40.1,38.8,1.3,24,ENG
4e204552,25,781,8.7,9,0,16,5,10,13,-3,12.8,12.8,0.0,24,ENG
4e5a4cbc,5,416,4.6,5,4,0,1,7,6,1,5.0,5.7,-0.7,24,ENG
4e9a0555,24,1218,13.5,13,9,11,0,18,20,-2,18.7,18.1,0.6,24,ENG
4f28a6ff,13,1063,11.8,13,10,0,15,22,22,0,19.6,20.9,-1.3,24,ENG
4f565d77,11,386,4.3,3,0,8,18,6,12,-6,5.3,8.3,-2.9,24,ENG
4f974391,6,242,2.7,3,1,3,19,2,6,-4,4.1,2.6,1.5,24,ENG
4fb9c88f,18,974,10.8,12,4,6,1,30,11,19,25.7,11.6,14.1,24,ENG
4fd08daa,25,2099,23.3,23,23,2,4,39,30,9,36.7,30.8,5.9,24,ENG
507c7bdf,29,2610,29.0,29,29,0,0,43,44,-1,44.6,51.4,-6.8,24,ENG
50dc94ce,1,3,0.0,0,0,1,11,0,0,0,0.2,0.0,0.2,24,ENG
50e6dc35,27,1685,18.7,17,12,10,2,26,37,-11,21.7,29.7,-8.1,24,ENG
51a3c4c8,7,375,4.2,4,2,3,5,4,11,-7,5.7,6.3,-0.6,24,ENG
51cf8561,23,1514,16.8,18,7,5,1,35,13,22,31.6,10.7,20.9,24,ENG
51dbeea9,4,22,0.2,0,0,4,14,0,1,-1,0.5,0.5,0.1,24,ENG
529f49ab,8,369,4.1,4,2,4,1,6,2,4,5.2,2.9,2.3,24,ENG
52afb588,5,257,2.9,3,0,2,0,4,2,2,4.4,2.4,2.0,24,ENG
532e1e4f,23,1924,21.4,21,19,2,4,44,27,17,37.4,29.2,8.1,24,ENG
5515376c,4,216,2.4,2,2,2,1,7,5,2,4.4,3.3,1.2,24,ENG
5526deb1,20,883,9.8,7,3,13,5,15,17,-2,14.5,16.3,-1.8,24,ENG
56f7a928,27,1263,14.0,12,4,15,0,30,20,10,25.9,24.1,1.8,24,ENG
570bb4b9,3,47,0.5,0,0,3,7,0,1,-1,1.3,0.8,0.5,24,ENG
57827369,6,406,4.5,6,1,0,1,9,13,-4,5.8,8.2,-2.4,24,ENG
57c94db2,27,1647,18.3,19,6,8,3,23,32,-9,27.4,30.8,-3.4,24,ENG
59e6e5bf,26,1703,18.9,20,4,6,0,19,25,-6,26.1,25.2,0.9,24,ENG
5a04fd92,13,620,6.9,5,1,8,7,12,8,4,10.1,13.0,-2.9,24,ENG
5a2cb25d,14,640,7.1,7,5,7,7,5,9,-4,11.1,11.4,-0.3,24,ENG
5a7301ae,8,119,1.3,1,0,7,10,3,3,0,2.6,1.7,1.0,24,ENG
5ad50391,20,1653,18.4,18,15,2,7,42,19,23,38.8,18.7,20.1,24,ENG
5c0da4a4,27,1978,22.0,23,7,4,0,34,34,0,32.7,30.3,2.5,24,ENG
5c2b4f07,12,833,9.3,10,6,2,1,9,15,-6,10.1,14.1,-4.0,24,ENG
5cbd1eb0,29,2526,28.1,29,26,0,0,32,47,-15,32.1,39.4,-7.3,24,ENG
5e4d9b48,3,3,0.0,0,0,3,9,0,1,-1,0.0,0.5,-0.5,24,ENG
5ed9b537,20,1422,15.8,15,13,5,5,38,15,23,37.0,19.0,18.0,24,ENG
5eecec3d,14,952,10.6,11,8,3,6,20,7,13,19.7,11.3,8.5,24,ENG
5f346071,14,663,7.4,8,0,6,9,2,19,-17,5.3,10.6,-5.2,24,ENG
5ff4ab71,26,2053,22.8,24,17,2,0,39,41,-2,41.8,35.6,6.2,24,ENG
60344e4f,3,24,0.3,0,0,3,1,0,0,0,0.2,0.1,0.1,24,ENG
620922ed,6,233,2.6,2,2,4,4,6,5,1,6.8,4.9,1.9,24,ENG
6250083a,17,582,6.5,4,1,13,9,12,15,-3,10.7,14.6,-4.0,24,ENG
62d7ef38,9,810,9.0,9,9,0,20,24,9,15,22.0,9.6,12.4,24,ENG
6412cc03,9,286,3.2,2,0,7,7,11,2,9,7.3,1.7,5.7,24,ENG
6434f10d,27,2330,25.9,27,22,0,0,63,23,40,56.9,23.5,33.4,24,ENG
6613c819,30,2415,26.8,28,22,2,0,45,47,-2,39.3,49.5,-10.3,24,ENG
6639e500,31,2155,23.9,28,4,3,0,35,34,1,31.6,36.2,-4.6,24,ENG
67ac5bb8,28,2356,26.2,26,25,2,2,60,21,39,48.7,18.6,30.0,24,ENG
67f649be,2,180,2.0,2,2,0,11,3,7,-4,2.0,2.8,-0.8,24,ENG
68db6358,4,293,3.3,2,2,2,26,2,4,-2,2.7,5.0,-2.3,24,ENG
69942fb3,3,71,0.8,1,0,2,4,1,1,0,1.5,1.1,0.4,24,ENG
6a713852,16,1433,15.9,16,15,0,2,26,25,1,30.2,23.7,6.5,24,ENG
6a7353d7,5,134,1.5,1,0,4,6,1,6,-5,1.3,2.8,-1.5,24,ENG
6a8a7af8,29,2341,26.0,27,19,2,1,24,69,-45,23.1,51.4,-28.3,24,ENG
6afaebf2,18,1336,14.8,15,13,3,0,24,21,3,27.2,19.4,7.8,24,ENG
6c203af0,22,1714,19.0,21,7,1,0,39,25,14,31.2,28.7,2.5,24,ENG
6ca5ec4b,25,1726,19.200000000000003,20,6,5,0,30,30,0,29.4,27.5,1.9999999999999998,24,ENG
6f7d826d,30,2570,28.6,30,23,0,0,59,44,15,50.6,43.4,7.2,24,ENG
6fe90922,5,103,1.1,0,0,5,0,4,1,3,2.1,1.5,0.7,24,ENG
700783e7,23,1797,20.0,20,15,3,0,29,26,3,35.9,27.8,8.1,24,ENG
71ef519e,8,109,1.2,0,0,8,15,3,4,-1,2.4,4.0,-1.6,24,ENG
72c812f3,19,1384,15.4,18,9,1,3,15,22,-7,24.2,21.2,3.0,24,ENG
73341ace,5,89,1.0,1,0,4,5,2,0,2,1.7,1.7,-0.1,24,ENG
733f1a7d,1,14,0.2,0,0,1,8,0,0,0,0.0,0.0,0.0,24,ENG
7399c7a8,29,2502,27.8,27,24,2,0,28,73,-45,26.3,54.4,-28.2,24,ENG
73b1d65b,11,503,5.6,5,2,6,9,5,14,-9,5.3,13.3,-8.1,24,ENG
745ca0a3,3,18,0.2,0,0,3,6,0,0,0,0.5,0.0,0.4,24,ENG
74618572,19,1486,16.5,15,12,4,0,32,27,5,29.2,23.8,5.4,24,ENG
74b2cd7e,7,321,3.6,3,3,4,24,6,2,4,7.0,7.6,-0.6,24,ENG
74e12f1e,3,19,0.2,0,0,3,17,1,0,1,0.6,0.1,0.5,24,ENG
767d9605,1,10,0.1,0,0,1,1,0,0,0,0.2,0.1,0.1,24,ENG
774cf58b,15,1086,12.1,12,9,3,2,10,29,-19,11.8,24.4,-12.5,24,ENG
77816c91,8,387,4.3,3,1,5,11,2,13,-11,3.1,11.5,-8.4,24,ENG
778ef829,8,720,8.0,8,8,0,0,9,14,-5,8.4,9.3,-1.0,24,ENG
77cf6852,9,238,2.6,1,1,8,11,6,6,0,7.2,4.7,2.5,24,ENG
77d6fd4d,30,2700,30.0,30,30,0,0,62,44,18,53.2,48.5,4.7,24,ENG
77d7c96f,13,777,8.6,9,4,4,10,10,19,-9,8.4,19.8,-11.4,24,ENG
77e84962,1,6,0.1,0,0,1,0,0,1,-1,0.0,0.0,0.0,24,ENG
788c0277,28,1902,21.1,19,14,9,0,33,42,-9,28.8,43.7,-14.9,24,ENG
78b8ac63,18,1023,11.4,12,4,6,2,17,32,-15,13.7,22.9,-9.2,24,ENG
79300479,27,2388,26.5,27,18,0,1,62,20,42,50.6,18.5,32.1,24,ENG
7956236f,29,2610,29.0,29,29,0,0,59,41,18,50.2,42.6,7.6,24,ENG
79bc4c45,17,823,9.1,7,4,10,5,12,20,-8,9.1,17.4,-8.3,24,ENG
79c0821a,22,1047,11.6,11,3,11,4,25,11,14,20.9,10.3,10.7,24,ENG
79c84d1c,30,2696,30.0,30,28,0,0,48,54,-6,43.0,54.5,-11.5,24,ENG
7a11550b,26,1614,17.9,16,11,10,2,43,13,30,42.5,22.2,20.3,24,ENG
7a1f2c08,4,176,2.0,2,0,2,19,1,2,-1,2.0,2.8,-0.8,24,ENG
7a2e46a8,21,1890,21.0,21,21,0,0,46,19,27,45.1,25.9,19.2,24,ENG
7aa8adfe,28,1910,21.2,22,7,6,2,32,27,5,31.9,37.4,-5.5,24,ENG
7af88b33,8,399,4.4,3,1,5,3,6,9,-3,5.6,8.5,-2.9,24,ENG
7b355808,19,758,8.4,9,1,10,4,4,22,-18,4.9,19.4,-14.5,24,ENG
7b5ab7f2,10,196,2.2,2,0,8,7,4,11,-7,4.7,7.2,-2.5,24,ENG
7ba2eaa9,19,1503,16.7,18,12,1,1,22,27,-5,21.7,29.0,-7.3,24,ENG
7c56da38,7,319,3.5,2,0,5,1,8,10,-2,6.6,6.2,0.4,24,ENG
7c5fa6cf,17,861,9.6,9,3,8,3,17,23,-6,13.7,20.0,-6.2,24,ENG
7cd520e8,26,2211,24.6,26,19,0,0,53,35,18,46.0,38.0,8.0,24,ENG
7f94982c,1,14,0.2,0,0,1,1,0,0,0,0.0,0.1,-0.1,24,ENG
7fa4e703,5,86,1.0,0,0,5,2,1,0,1,1.3,0.7,0.5,24,ENG
803ae100,24,1166,13.0,13,6,11,7,17,21,-4,16.8,22.2,-5.4,24,ENG
82518f62,29,2544,28.3,29,24,0,0,60,50,10,55.6,48.0,7.6,24,ENG
828657ff,24,1801,20.0,20,14,4,0,19,32,-13,28.6,30.6,-1.9,24,ENG
82927de4,15,426,4.7,4,2,11,6,6,9,-3,6.7,9.6,-2.8,24,ENG
834b5c4c,9,810,9.0,9,9,0,0,12,13,-1,13.5,11.5,2.0,24,ENG
8397a50c,1,30,0.3,1,0,0,0,1,2,-1,0.3,1.1,-0.8,24,ENG
839c14e1,3,62,0.7,0,0,3,15,1,0,1,0.9,0.5,0.4,24,ENG
83d074ff,25,1989,22.1,24,12,1,0,49,23,26,47.5,25.7,21.9,24,ENG
8449d35e,31,2497,27.7,30,13,1,0,38,44,-6,42.2,40.1,2.2,24,ENG
84c5ceea,7,125,1.4,1,0,6,11,2,5,-3,1.7,4.4,-2.8,24,ENG
861e9b3b,1,1,0.0,0,0,1,6,0,0,0,0.0,0.0,0.0,24,ENG
862a1c15,29,1848,20.5,23,5,6,0,38,37,1,36.7,36.5,0.3,24,ENG
86dd77d1,26,2260,25.1,25,23,1,2,59,27,32,52.3,24.8,27.6,24,ENG
86e7deaf,23,1983,22.0,22,21,1,5,38,37,1,42.4,32.9,9.6,24,ENG
886f9aac,5,199,2.2,2,0,3,2,6,2,4,4.7,1.8,2.9,24,ENG
88968486,30,2700,30.0,30,30,0,0,44,53,-9,45.0,46.0,-1.1,24,ENG
890f108d,12,78,0.9,0,0,12,16,2,3,-1,3.6,2.5,1.2,24,ENG
89ac64a6,22,1856,20.6,21,19,1,4,44,19,25,38.8,20.8,18.0,24,ENG
8a3c1dc7,5,401,4.5,5,4,0,0,8,5,3,9.8,5.1,4.7,24,ENG
8a7ff278,22,1872,20.8,22,18,0,1,21,30,-9,24.9,27.2,-2.4,24,ENG
8aec0537,28,2394,26.6,26,24,2,0,46,34,12,42.4,36.9,5.4,24,ENG
8aff2b51,1,1,0.0,0,0,1,0,0,0,0,0.0,0.0,0.0,24,ENG
8b04d6c1,29,1029,11.4,6,4,23,1,29,22,7,22.6,21.4,1.2,24,ENG
8b3ab7ad,25,1968,21.9,23,15,2,0,35,32,3,31.1,38.2,-7.1,24,ENG
8b529245,13,315,3.5,2,0,11,7,6,5,1,6.5,4.3,2.2,24,ENG
8b57ad2c,26,1988,22.1,24,12,2,1,32,33,-1,27.4,36.1,-8.7,24,ENG
8b788c01,13,448,5.0,5,0,8,3,11,6,5,7.5,8.0,-0.4,24,ENG
8b9ebd03,26,1769,19.7,20,9,6,1,32,26,6,28.7,31.6,-3.0,24,ENG
8c3078cd,1,75,0.8,0,0,1,4,1,5,-4,1.4,2.2,-0.8,24,ENG
8d3c902d,11,209,2.3,2,0,9,16,1,6,-5,1.4,5.9,-4.5,24,ENG
8df7a2fb,16,1272,14.1,15,11,1,2,16,26,-10,18.6,23.8,-5.2,24,ENG
8e16dd48,19,661,7.3,6,0,13,4,10,17,-7,13.2,11.1,2.1,24,ENG
8e92be30,22,1582,17.6,19,8,3,1,30,32,-2,33.4,34.4,-0.9,24,ENG
8fe2a392,19,1619,18.0,19,15,0,1,35,21,14,28.8,23.4,5.4,24,ENG
903b6e8b,28,2407,26.7,28,26,0,0,41,43,-2,37.3,45.2,-7.9,24,ENG
907a5d7c,20,604,6.7,6,0,14,11,9,7,2,12.5,8.1,4.4,24,ENG
90f91999,28,2373,26.4,28,18,0,0,55,37,18,46.7,35.3,11.3,24,ENG
91748070,24,2003,22.3,22,20,2,3,31,47,-16,23.1,45.3,-22.3,24,ENG
9228b07c,9,221,2.5,2,0,7,1,2,11,-9,3.0,7.1,-4.1,24,ENG
92868cb5,5,80,0.9,0,0,5,20,2,2,0,1.3,2.6,-1.3,24,ENG
9295dc1c,25,1874,20.8,21,14,4,2,24,37,-13,22.5,34.9,-12.4,24,ENG
92e7e919,27,2250,25.0,26,13,1,0,51,35,16,44.6,39.4,5.2,24,ENG
9319781b,11,432,4.8,4,4,7,7,2,14,-12,6.2,10.7,-4.5,24,ENG
9328b835,7,451,5.0,4,4,3,23,7,13,-6,7.3,9.7,-2.4,24,ENG
934e1968,25,1893,21.0,23,12,2,0,41,18,23,43.3,22.8,20.5,24,ENG
938fa024,1,5,0.1,0,0,1,3,0,0,0,0.0,0.0,0.0,24,ENG
93e08bce,13,1056,11.7,12,11,1,2,10,26,-16,10.8,20.3,-9.5,24,ENG
95bd120d,1,10,0.1,0,0,1,12,0,1,-1,0.7,1.6,-0.9,24,ENG
96593e89,26,1634,18.1,19,6,7,2,17,57,-40,18.1,36.3,-18.2,24,ENG
9674002f,10,416,4.6,4,0,6,0,3,9,-6,6.2,8.4,-2.2,24,ENG
96cf7b61,25,2199,24.4,24,24,1,5,20,63,-43,22.9,49.3,-26.3,24,ENG
97220da2,17,505,5.6,6,0,11,2,10,6,4,12.6,6.7,6.0,24,ENG
972aeb2a,30,2700,30.0,30,30,0,0,72,24,48,58.0,20.8,37.2,24,ENG
9744ff80,23,1445,16.1,17,5,6,7,27,19,8,23.1,23.9,-0.8,24,ENG
980522ec,16,887,9.9,9,4,7,9,16,20,-4,14.2,16.5,-2.3,24,ENG
98ea5115,24,2160,24.0,24,24,0,3,61,19,42,46.9,15.0,31.9,24,ENG
9907b1c8,22,724,8.0,8,0,14,5,16,13,3,11.7,12.9,-1.2,24,ENG
99127249,24,1075,11.9,12,2,12,2,17,19,-2,20.7,19.7,0.9,24,ENG
99813635,22,735,8.2,11,0,11,4,11,10,1,9.0,10.4,-1.5,24,ENG
999ceb5f,16,418,4.6,3,2,13,9,6,12,-6,6.6,11.0,-4.4,24,ENG
99aa1a84,3,270,3.0,3,3,0,25,5,4,1,5.7,6.2,-0.5,24,ENG
9a28eba4,11,194,2.2,0,0,11,1,7,7,0,5.1,7.3,-2.2,24,ENG
9ade9ce1,12,370,4.1,4,0,8,9,2,13,-11,1.8,9.1,-7.3,24,ENG
9af1f9ff,15,1234,13.7,15,10,0,0,14,23,-9,10.7,20.5,-9.8,24,ENG
9b066938,1,1,0.0,0,0,1,9,0,0,0,0.0,0.1,-0.1,24,ENG
9b398aea,26,1858,20.6,23,8,3,0,32,31,1,28.4,32.9,-4.5,24,ENG
9b5ce51a,25,2205,24.5,25,20,0,0,29,42,-13,28.5,32.9,-4.5,24,ENG
9b6f7fd5,24,2019,22.4,24,11,0,0,42,34,8,31.9,36.1,-4.2,24,ENG
9c36ed83,26,1995,22.2,22,12,4,0,42,37,5,47.2,33.0,14.2,24,ENG
9c94165b,12,959,10.7,12,7,0,0,16,13,3,19.8,19.3,0.4,24,ENG
9cfbad36,6,174,1.9,2,0,4,0,6,4,2,4.2,2.6,1.6,24,ENG
9dc96f10,2,48,0.5,0,0,2,7,2,3,-1,1.7,0.6,1.1,24,ENG
9e525177,14,1064,11.8,12,9,2,3,16,20,-4,14.1,22.7,-8.6,24,ENG
9e5708be,20,1796,20.0,20,19,0,4,21,27,-6,25.2,26.3,-1.1,24,ENG
9f7c837d,11,849,9.4,10,7,1,19,8,12,-4,13.9,14.6,-0.7,24,ENG
9f8e9423,21,1353,15.0,16,12,5,4,23,23,0,24.5,27.4,-2.9,24,ENG
a011a1e9,1,8,0.1,0,0,1,0,1,0,1,0.3,0.9,-0.6,24,ENG
a0666d3e,23,1393,15.5,16,6,7,1,15,32,-17,14.9,22.4,-7.5,24,ENG
a105d46a,20,1342,14.9,14,11,6,5,15,26,-11,18.8,22.1,-3.3,24,ENG
a1390d2f,19,944,10.5,11,4,8,7,12,19,-7,11.7,15.9,-4.2,24,ENG
a1d5bd30,29,2092,23.2,24,11,5,0,31,33,-2,32.5,43.6,-11.1,24,ENG
a2852b4f,2,158,1.8,2,0,0,1,1,3,-2,2.1,2.1,0.0,24,ENG
a2b105e0,27,2079,23.1,22,21,5,0,54,42,12,44.5,41.9,2.6,24,ENG
a36524bf,22,1673,18.6,18,17,4,4,36,31,5,27.5,29.8,-2.3,24,ENG
a3b03921,8,380,4.2,4,0,4,0,6,9,-3,5.6,6.9,-1.3,24,ENG
a3d94a58,25,2070,23.0,25,22,0,0,51,25,26,43.2,30.4,12.7,24,ENG
a4ac4b8f,16,1085,12.1,14,8,2,3,10,16,-6,14.1,17.4,-3.3,24,ENG
a4e85758,17,1091,12.1,12,7,5,9,18,17,1,17.5,15.5,2.0,24,ENG
a5212312,7,439,4.9,5,3,2,7,7,8,-1,5.1,7.2,-2.1,24,ENG
a53649b7,25,1076,12.0,10,3,15,5,24,10,14,22.1,10.1,12.0,24,ENG
a572e291,20,1563,17.4,19,10,1,1,16,31,-15,17.3,24.7,-7.4,24,ENG
a65c844b,7,455,5.1,5,4,2,5,8,9,-1,6.7,5.2,1.5,24,ENG
a681b7b7,16,1169,13.0,14,8,2,3,18,23,-5,17.8,25.3,-7.4,24,ENG
a6c58494,16,235,2.6,0,0,16,11,7,12,-5,6.5,7.0,-0.5,24,ENG
a712ca2b,15,1155,12.8,13,11,2,2,11,21,-10,14.2,26.3,-12.1,24,ENG
a755db8c,19,1116,12.4,12,6,7,7,20,21,-1,18.4,20.2,-1.8,24,ENG
a7588cdc,2,13,0.1,0,0,2,0,0,1,-1,0.0,0.1,-0.1,24,ENG
a78ff07f,26,2120,23.6,24,16,2,0,35,37,-2,28.8,39.6,-10.8,24,ENG
a816dbfb,22,1213,13.5,13,5,9,2,21,28,-7,19.7,19.8,-0.1,24,ENG
a8748947,28,1321,14.7,13,6,15,3,29,22,7,23.7,25.9,-2.3,24,ENG
a8c0acb7,23,1478,16.4,16,12,7,1,21,29,-8,26.6,26.4,0.3,24,ENG
a8c19eb8,26,2112,23.5,23,22,3,1,35,45,-10,39.3,36.2,3.1,24,ENG
a92ab7be,30,2655,29.5,30,29,0,0,39,53,-14,47.4,45.2,2.2,24,ENG
a9b1c319,24,1056,11.7,11,3,13,7,11,26,-15,10.0,26.9,-16.9,24,ENG
a9dc785c,28,2520,28.0,28,28,0,0,41,46,-5,43.0,43.3,-0.3,24,ENG
aa849a12,23,1801,20.0,21,13,2,1,21,23,-2,28.4,27.4,1.0,24,ENG
aa888da7,1,14,0.2,0,0,1,5,0,0,0,0.1,0.6,-0.5,24,ENG
ab651565,12,142,1.6,0,0,12,3,2,5,-3,2.7,3.8,-1.1,24,ENG
ac05f970,19,1182,13.1,15,1,4,0,25,17,8,20.1,22.7,-2.6,24,ENG
ac7e7b1c,9,172,1.9,1,0,8,11,2,2,0,3.2,3.7,-0.5,24,ENG
ac861941,4,201,2.2,1,1,3,8,1,8,-7,2.6,6.9,-4.3,24,ENG
ad82197c,27,2390,26.6,27,25,0,2,48,43,5,53.7,38.4,15.3,24,ENG
ae4fc6a4,20,1496,16.6,17,12,3,0,21,24,-3,20.1,23.3,-3.2,24,ENG
ae5019e6,26,2096,23.3,24,17,2,1,22,58,-36,21.9,42.8,-20.9,24,ENG
aed3a70f,30,2610,29.0,30,21,0,0,59,42,17,50.7,42.1,8.6,24,ENG
aeed5c06,31,1720,19.1,20,3,11,0,34,29,5,29.0,26.4,2.6,24,ENG
afe1a491,4,280,3.1,3,1,1,2,6,5,1,3.7,5.3,-1.5,24,ENG
afed6722,22,1031,11.5,9,5,13,6,20,24,-4,20.8,24.6,-3.8,24,ENG
b026bbf6,8,656,7.3,8,5,0,0,6,18,-12,8.6,14.5,-5.9,24,ENG
b0b4fd3e,16,827,9.2,8,6,8,6,20,11,9,20.2,9.5,10.6,24,ENG
b217ef29,10,781,8.7,9,6,1,4,20,9,11,16.6,11.3,5.3,24,ENG
b28bbd58,22,1045,11.6,12,1,10,1,15,24,-9,9.6,21.7,-12.1,24,ENG
b2a81fc6,14,405,4.5,3,0,11,6,4,9,-5,3.5,9.5,-6.0,24,ENG
b2d31e83,25,2006,22.3,24,16,1,0,53,35,18,44.5,35.5,9.0,24,ENG
b2f9c73e,7,191,2.1,2,0,5,2,6,4,2,5.1,3.8,1.3,24,ENG
b3af9be1,15,675,7.5,5,3,10,1,15,5,10,12.5,6.0,6.5,24,ENG
b400bde0,27,1851,20.6,21,9,6,1,37,34,3,39.4,29.7,9.6,24,ENG
b4a014b1,20,1346,15.0,15,13,5,5,27,23,4,24.7,23.1,1.6,24,ENG
b561db50,21,1273,14.1,17,4,4,2,21,24,-3,15.6,26.4,-10.7,24,ENG
b57e066e,12,608,6.8,6,2,6,18,16,6,10,12.0,7.1,5.0,24,ENG
b62878a5,26,1860,20.7,20,12,6,0,33,42,-9,27.7,33.9,-6.2,24,ENG
b63e789d,4,92,1.0,1,0,3,5,1,5,-4,1.0,3.0,-2.0,24,ENG
b66315ae,20,1212,13.5,14,4,6,2,24,11,13,24.3,10.5,13.8,24,ENG
b737f944,12,589,6.5,5,4,7,9,6,25,-19,6.3,16.1,-9.8,24,ENG
b8e740fb,21,905,10.1,10,0,11,2,23,11,12,22.8,12.8,10.0,24,ENG
b9e1436c,26,877,9.7,6,2,20,4,26,7,19,23.9,12.3,11.6,24,ENG
b9f282ec,1,1,0.0,0,0,1,2,0,0,0,0.0,0.0,0.0,24,ENG
bac46a10,9,580,6.4,7,2,2,0,11,11,0,10.5,9.7,0.8,24,ENG
bb5fbd2b,7,554,6.2,7,2,0,1,13,11,2,11.3,10.0,1.2,24,ENG
bbd67769,8,621,6.9,8,2,0,6,17,5,12,15.4,5.7,9.8,24,ENG
bc7dc64d,28,2339,26.0,28,14,0,0,63,23,40,52.6,18.7,34.0,24,ENG
bced0375,14,985,10.9,13,4,1,3,12,15,-3,13.4,14.5,-1.0,24,ENG
be927d03,23,1637,18.2,20,9,3,1,20,23,-3,28.4,23.2,5.1,24,ENG
beb391dd,5,105,1.2,1,0,4,16,1,3,-2,1.3,3.0,-1.7,24,ENG
bf33b257,30,2302,25.6,27,13,3,0,37,53,-16,31.9,52.1,-20.3,24,ENG
bf34eebd,14,380,4.2,4,0,10,10,8,9,-1,8.8,6.8,2.0,24,ENG
bf973eeb,3,4,0.0,0,0,3,15,1,0,1,0.2,0.0,0.2,24,ENG
bfc3b3a0,16,526,5.8,5,0,11,9,5,10,-5,6.5,8.7,-2.2,24,ENG
c066d1a5,22,1605,17.8,19,12,3,4,21,37,-16,16.5,35.7,-19.2,24,ENG
c1242d4e,5,388,4.3,3,3,2,25,9,4,5,8.5,4.8,3.7,24,ENG
c149016b,21,1184,13.2,13,9,8,4,27,9,18,31.3,15.7,15.7,24,ENG
c17bfb65,16,1133,12.6,14,8,2,0,21,19,2,21.5,22.8,-1.3,24,ENG
c1949191,27,2430,27.0,27,27,0,2,29,37,-8,40.1,38.4,1.7,24,ENG
c1fe2a48,28,1601,17.8,16,13,12,2,22,31,-9,20.4,25.5,-5.1,24,ENG
c2731c10,28,2331,25.9,28,21,0,0,47,42,5,51.1,35.3,15.7,24,ENG
c393a6c4,8,586,6.5,6,6,2,5,9,10,-1,7.3,9.2,-1.9,24,ENG
c40b6180,10,767,8.5,9,7,1,11,13,16,-3,15.1,12.1,3.0,24,ENG
c4486bac,11,755,8.4,8,7,3,0,13,16,-3,10.9,11.7,-0.8,24,ENG
c47541e0,2,11,0.1,0,0,2,6,0,0,0,0.0,0.7,-0.7,24,ENG
c596fcb0,16,862,9.6,8,5,8,0,25,14,11,20.0,11.2,8.8,24,ENG
c5b7c315,7,404,4.5,4,3,3,20,2,11,-9,5.4,9.2,-3.8,24,ENG
c5bdb6e3,15,268,3.0,1,0,14,14,10,1,9,7.0,2.2,4.8,24,ENG
c6220452,16,1275,14.2,16,5,0,5,22,19,3,18.7,28.8,-10.1,24,ENG
c6dc9ecd,28,1443,16.0,15,4,13,1,17,24,-7,18.5,28.1,-9.6,24,ENG
c6e8cf1f,19,819,9.1,10,3,9,9,11,15,-4,11.2,18.9,-7.7,24,ENG
c81d773d,17,1347,15.0,15,14,2,2,25,21,4,22.3,25.1,-2.8,24,ENG
c8aa95da,30,2623,29.1,30,29,0,0,61,52,9,54.1,51.8,2.4,24,ENG
ca18c8f1,19,1019,11.3,12,4,7,2,16,26,-10,11.1,26.4,-15.3,24,ENG
ca22ccb0,5,133,1.5,1,1,4,9,2,1,1,1.4,3.0,-1.6,24,ENG
ca76b087,5,110,1.2,2,0,3,1,1,6,-5,1.7,2.5,-0.7,24,ENG
caa1a7f0,2,20,0.2,0,0,2,4,1,0,1,0.4,0.0,0.4,24,ENG
cab9634e,12,209,2.3,1,0,11,8,2,5,-3,4.5,5.2,-0.6,24,ENG
cc2d7ad5,23,1949,21.7,21,20,2,0,24,39,-15,22.0,36.3,-14.4,24,ENG
cc77354e,20,1652,18.4,20,10,0,0,36,22,14,31.1,24.7,6.4,24,ENG
ccce7025,17,1377,15.3,15,12,2,0,37,29,8,26.3,31.0,-4.7,24,ENG
cd1acf9d,21,1622,18.0,19,12,2,0,39,18,21,38.9,20.6,18.3,24,ENG
cd889153,16,1396,15.5,16,14,0,1,25,32,-7,18.8,33.5,-14.7,24,ENG
cdd70dc0,8,59,0.7,0,0,8,9,1,0,1,2.0,0.8,1.3,24,ENG
cddf767b,24,1856,20.6,20,17,4,6,16,57,-41,17.3,37.5,-20.2,24,ENG
ce4246f5,26,2267,25.2,26,23,0,1,43,45,-2,35.7,45.8,-10.1,24,ENG
ce4f40c7,11,919,10.2,11,8,0,1,9,12,-3,11.1,13.1,-2.0,24,ENG
ce5143da,21,1135,12.6,15,2,6,1,22,16,6,22.9,17.5,5.4,24,ENG
cf134113,15,1350,15.0,15,15,0,15,27,18,9,20.9,19.7,1.2,24,ENG
d0042ab9,5,368,4.1,5,3,0,0,7,11,-4,5.6,6.9,-1.4,24,ENG
d00d45ab,9,156,1.7,0,0,9,9,2,5,-3,2.7,3.0,-0.3,24,ENG
d04b94db,29,2520,28.0,29,22,0,0,38,46,-8,35.7,48.8,-13.1,24,ENG
d0706b27,22,1912,21.2,22,19,0,0,24,32,-8,24.9,29.1,-4.2,24,ENG
d0b6129f,30,2375,26.4,27,21,3,0,27,57,-30,26.8,48.7,-22.0,24,ENG
d0f72bf1,30,2700,30.0,30,30,0,0,43,47,-4,40.0,50.2,-10.3,24,ENG
d2424d1b,12,745,8.3,9,3,3,0,12,14,-2,14.6,12.2,2.4,24,ENG
d3085b49,18,319,3.5,2,0,16,7,7,7,0,5.8,7.7,-2.0,24,ENG
d328a254,25,1318,14.6,13,6,12,1,18,32,-14,17.5,26.4,-9.0,24,ENG
d38fdf53,17,1141,12.7,13,8,4,1,23,23,0,21.0,22.4,-1.3,24,ENG
d4aa4582,1,8,0.1,0,0,1,3,0,2,-2,0.0,1.2,-1.2,24,ENG
d557d734,23,690,7.7,4,3,19,7,12,12,0,11.3,15.9,-4.6,24,ENG
d56b9520,22,1528,17.0,17,8,5,1,29,26,3,34.4,20.4,14.0,24,ENG
d60c03a9,2,11,0.1,0,0,2,4,2,0,2,0.8,0.1,0.7,24,ENG
d7553721,15,448,5.0,4,0,11,6,11,10,1,10.8,10.5,0.3,24,ENG
d7f99582,7,97,1.1,1,0,6,8,0,4,-4,0.5,3.1,-2.6,24,ENG
d86a1f3e,1,1,0.0,0,0,1,4,0,0,0,0.0,0.0,0.0,24,ENG
d8931174,18,1293,14.4,14,13,4,3,24,22,2,23.1,28.0,-4.9,24,ENG
d91f104d,7,40,0.4,0,0,7,11,5,1,4,2.3,1.6,0.6,24,ENG
d93c2511,27,1579,17.5,15,13,12,2,23,26,-3,27.2,33.0,-5.9,24,ENG
d9565625,28,2454,27.3,27,26,1,1,42,41,1,40.4,49.0,-8.7,24,ENG
da011f18,10,223,2.5,2,0,8,15,6,3,3,6.9,4.9,2.0,24,ENG
da052c14,28,2268,25.2,27,17,1,0,31,31,0,28.9,30.8,-1.9,24,ENG
da7b447d,1,77,0.9,0,0,1,3,1,2,-1,0.7,2.2,-1.5,24,ENG
dab84ad2,2,9,0.1,0,0,2,1,0,1,-1,0.1,0.9,-0.8,24,ENG
dad4b285,22,1307,14.5,13,11,9,1,25,27,-2,19.3,22.0,-2.7,24,ENG
db4ed67b,9,452,5.0,6,0,3,8,10,5,5,7.9,4.1,3.8,24,ENG
dbf053da,3,79,0.9,0,0,3,0,2,1,1,2.6,1.9,0.8,24,ENG
dc3e663e,17,853,9.5,10,6,7,13,37,8,29,23.6,5.1,18.5,24,ENG
dc4cae05,13,282,3.1,2,0,11,7,5,7,-2,5.6,6.1,-0.5,24,ENG
dc62b55d,25,1976,22.0,24,11,1,0,34,33,1,29.0,35.8,-6.8,24,ENG
dc6f5bdd,2,73,0.8,0,0,2,22,1,2,-1,1.7,2.5,-0.8,24,ENG
dc7f8a28,26,1931,21.400000000000002,21,11,5,2,43,39,4,43.4,35.300000000000004,8.2,24,ENG
dd323728,22,1337,14.9,14,12,8,5,20,25,-5,21.0,19.8,1.2,24,ENG
dd745366,1,8,0.1,0,0,1,5,0,0,0,0.3,0.0,0.3,24,ENG
de0abf23,1,4,0.0,0,0,1,13,1,0,1,0.2,0.3,-0.1,24,ENG
de112b84,13,656,7.3,6,5,7,5,24,15,9,18.2,10.5,7.7,24,ENG
de31038e,13,538,6.0,5,2,8,0,18,6,12,15.2,6.0,9.3,24,ENG
de5b5570,13,1130,12.6,13,10,0,0,10,24,-14,12.8,25.7,-12.9,24,ENG
debe38a0,6,482,5.4,6,4,0,0,4,17,-13,3.5,14.6,-11.1,24,ENG
df0a4c90,26,2175,24.2,26,19,0,0,33,45,-12,36.5,37.3,-0.7,24,ENG
df10e27c,25,1778,19.8,20,12,5,1,38,30,8,34.7,28.7,6.0,24,ENG
df3cda47,28,2274,25.3,26,18,2,0,51,34,17,45.0,40.0,5.1,24,ENG
df8b52a5,18,959,10.7,9,8,9,12,22,23,-1,16.1,22.6,-6.5,24,ENG
e06683ca,28,2457,27.3,28,27,0,0,62,27,35,61.5,32.8,28.7,24,ENG
e09f279b,12,1080,12.0,12,12,0,0,16,24,-8,16.3,21.6,-5.4,24,ENG
e0bc6fdc,29,2534,28.2,28,24,1,0,48,48,0,39.7,52.6,-12.9,24,ENG
e1618c22,14,527,5.9,5,0,9,3,4,17,-13,5.4,11.5,-6.1,24,ENG
e28868f3,1,5,0.1,0,0,1,7,0,0,0,0.0,0.1,-0.1,24,ENG
e31708b2,1,1,0.0,0,0,1,4,0,0,0,0.0,0.0,0.0,24,ENG
e342ad68,24,1965,21.8,22,16,2,0,48,20,28,49.7,23.5,26.2,24,ENG
e34fc66d,30,2699,30.0,30,29,0,0,34,50,-16,34.4,41.9,-7.5,24,ENG
e4238fb1,3,152,1.7,2,0,1,0,1,5,-4,0.6,4.4,-3.8,24,ENG
e46012d4,10,583,6.5,7,4,3,3,16,4,12,14.9,6.3,8.6,24,ENG
e514ab62,3,78,0.9,1,0,2,8,0,4,-4,1.1,1.6,-0.5,24,ENG
e541326e,23,2070,23.0,23,23,0,0,34,39,-5,38.3,32.5,5.8,24,ENG
e5478b87,17,1024,11.4,12,1,5,0,17,21,-4,13.1,15.9,-2.9,24,ENG
e5a76dfe,10,900,10.0,10,10,0,7,13,22,-9,8.9,15.6,-6.6,24,ENG
e6af02e0,14,700,7.8,8,3,6,13,13,11,2,14.2,9.9,4.300000000000001,24,ENG
e77dc3b2,30,2667,29.6,30,22,0,0,42,49,-7,43.0,43.9,-0.9,24,ENG
e7aa9d7c,8,264,2.9,3,0,5,9,2,8,-6,3.5,7.5,-4.0,24,ENG
e7ca0439,3,6,0.1,0,0,3,19,0,2,-2,0.1,0.8,-0.7,24,ENG
e7ee38c3,2,180,2.0,2,2,0,22,4,5,-1,3.3,4.1,-0.8,24,ENG
e814e1cf,11,210,2.3,1,0,10,14,2,3,-1,5.4,3.7,1.7,24,ENG
e82900ef,9,686,7.6,7,5,2,0,9,17,-8,10.2,13.6,-3.4,24,ENG
e8832875,24,1482,16.5,13,5,11,0,29,25,4,28.2,23.5,4.7,24,ENG
e98211e7,12,869,9.7,8,3,4,4,15,17,-2,16.4,14.5,1.9,24,ENG
e9c0c1b2,30,2700,30.0,30,30,0,0,43,44,-1,45.3,53.7,-8.4,24,ENG
ea1a5662,3,13,0.1,0,0,3,6,0,0,0,0.7,0.1,0.6,24,ENG
eab957a3,24,2020,22.4,22,21,2,0,21,66,-45,21.8,47.4,-25.6,24,ENG
eaeca114,24,1753,19.5,20,17,4,4,44,19,25,38.2,18.7,19.5,24,ENG
eba1e557,3,16,0.2,0,0,3,3,2,0,2,1.1,0.7,0.4,24,ENG
ecad9aa5,1,33,0.4,0,0,1,1,1,0,1,1.6,0.3,1.3,24,ENG
ed1e53f3,30,2448,27.2,28,18,2,0,59,25,34,54.5,26.1,28.4,24,ENG
ed383e43,1,1,0.0,0,0,1,12,0,0,0,0.0,0.0,0.0,24,ENG
ed5c0319,25,818,9.1,8,1,17,1,15,14,1,15.9,14.4,1.5,24,ENG
edc98fac,6,404,4.5,4,4,2,17,9,8,1,6.5,9.6,-3.1,24,ENG
ee38d9c5,20,1596,17.7,20,4,0,0,36,20,16,29.3,23.0,6.3,24,ENG
eebacc07,28,2215,24.6,26,12,2,0,24,59,-35,23.5,46.7,-23.2,24,ENG
eed2427e,10,191,2.1,1,0,9,18,5,2,3,5.6,1.8,3.8,24,ENG
efd2ec23,26,1559,17.3,19,5,7,3,34,25,9,30.4,24.3,6.0,24,ENG
f08490a6,14,595,6.6,5,2,9,8,3,10,-7,8.6,9.8,-1.2,24,ENG
f098c03e,8,400,4.4,4,2,4,4,2,6,-4,3.5,7.3,-3.8,24,ENG
f0caab96,27,2054,22.8,23,17,4,3,35,31,4,30.4,35.7,-5.3,24,ENG
f1c42eb3,1,4,0.0,0,0,1,10,0,0,0,0.0,0.0,0.0,24,ENG
f230bc30,11,308,3.4,2,0,9,8,6,5,1,4.6,6.0,-1.4,24,ENG
f315ca93,12,672,7.5,8,6,4,13,16,7,9,14.1,8.4,5.8,24,ENG
f31def1e,16,1130,12.6,13,8,3,0,16,24,-8,17.9,17.9,0.0,24,ENG
f449640d,5,58,0.6,0,0,5,16,2,1,1,1.5,0.8,0.7,24,ENG
f4e433d4,15,679,7.5,8,0,7,0,12,13,-1,9.2,8.1,1.1,24,ENG
f5deef4c,19,1328,14.8,14,7,5,2,18,16,2,24.7,26.0,-1.3,24,ENG
f6d7d690,18,1438,16.0,16,13,2,8,16,36,-20,16.6,30.9,-14.3,24,ENG
f72293fc,21,1071,11.9,12,1,9,3,16,24,-8,12.0,19.1,-7.1,24,ENG
f7b1d4e0,18,711,7.9,7,5,11,7,9,19,-10,13.7,12.1,1.6,24,ENG
f84a807c,17,1285,14.3,15,6,2,0,14,31,-17,13.4,27.0,-13.6,24,ENG
f8eca1b6,8,109,1.2,0,0,8,0,7,2,5,3.9,1.3,2.6,24,ENG
f8fcd2a5,19,1106,12.3,12,7,7,3,16,17,-1,14.8,22.2,-7.4,24,ENG
fa031b34,25,1372,15.2,17,6,8,1,33,17,16,27.1,23.0,4.1,24,ENG
fb920f3a,3,20,0.2,0,0,3,5,0,2,-2,0.1,0.5,-0.4,24,ENG
fc027d02,12,917,10.2,11,7,1,4,5,29,-24,7.9,21.8,-13.9,24,ENG
fc076f78,15,974,10.8,13,0,2,0,11,23,-12,9.0,15.4,-6.5,24,ENG
fc15fb84,27,2194,24.4,25,17,2,0,28,30,-2,34.4,33.1,1.3,24,ENG
fdf3cb77,29,2569,28.5,29,23,0,0,49,51,-2,41.1,50.2,-9.0,24,ENG
feb5d972,26,1573,17.5,21,4,5,0,31,18,13,27.6,25.2,2.4,24,ENG
fed7cb61,29,1935,21.5,22,12,7,0,58,17,41,43.4,13.6,29.8,24,ENG
fed96827,10,617,6.9,6,5,4,14,13,16,-3,11.9,9.7,2.3,24,ENG
fffea3e5,22,1308,14.5,15,5,7,1,38,17,21,30.6,13.0,17.6,24,ENG
0033fb1b,6,169,1.9,1,1,5,0,3,4,-1,3.7,5.2,-1.5,24,EL
00963611,8,720,8.0,8,8,0,0,15,5,10,11.6,6.5,5.1,24,EL
00a8d210,2,163,1.8,2,1,0,0,2,1,1,1.0,3.3,-2.3,24,EL
0107757e,1,90,1.0,1,1,0,7,3,1,2,1.9,1.6,0.3,24,EL
010857ca,1,3,0.0,0,0,1,2,0,0,0,0.0,0.1,0.0,24,EL
01a08323,7,398,4.4,5,1,2,1,15,6,9,8.8,4.4,4.4,24,EL
01d00f38,5,347,3.9,3,2,2,0,3,6,-3,5.5,7.8,-2.3,24,EL
01ecd78a,3,81,0.9,1,0,2,2,2,4,-2,0.0,0.0,0.0,24,EL
032f894e,4,111,1.2,2,0,2,3,2,0,2,2.4,1.0,1.5,24,EL
0341a8ec,5,450,5.0,5,5,0,1,3,6,-3,5.4,8.1,-2.7,24,EL
03998238,2,157,1.7,2,0,0,0,2,4,-2,2.2,2.5,-0.3,24,EL
03b2ae29,6,366,4.1,4,3,2,0,5,9,-4,0.0,0.0,0.0,24,EL
04ac78d2,7,305,3.4,3,3,4,3,4,6,-2,4.6,5.1,-0.4,24,EL
05160902,6,540,6.0,6,6,0,0,6,12,-6,7.5,11.6,-4.1,24,EL
05b00fef,5,349,3.9,5,1,0,1,2,13,-11,3.7,6.6,-2.9,24,EL
061e8e23,5,103,1.1,1,0,4,1,1,3,-2,1.1,1.7,-0.6,24,EL
0683f364,6,534,5.9,6,4,0,0,4,9,-5,5.6,9.4,-3.8,24,EL
06c48679,2,192,2.1,2,1,0,0,2,3,-1,1.2,4.8,-3.6,24,EL
06f33dc8,4,186,2.1,2,0,2,0,3,4,-1,3.4,2.6,0.8,24,EL
07802f7f,6,181,2.0,2,0,4,2,3,3,0,3.1,1.2,1.9,24,EL
080ac8d8,4,204,2.3,2,1,2,0,3,4,-1,3.8,4.9,-1.1,24,EL
08452314,1,1,0.0,0,0,1,0,0,0,0,0.0,0.1,-0.1,24,EL
089c7323,2,136,1.5,2,0,0,0,2,2,0,1.7,1.9,-0.2,24,EL
08d37c53,5,192,2.1,2,1,3,1,3,4,-1,1.8,3.3,-1.5,24,EL
0a26ec79,1,90,1.0,1,1,0,5,1,3,-2,0.5,2.2,-1.7,24,EL
0a7fa520,5,360,4.0,5,0,0,0,7,8,-1,4.2,7.0,-2.7,24,EL
0a8fd9cb,3,48,0.5,0,0,3,2,1,0,1,1.4,0.7,0.6,24,EL
0abc51f2,5,365,4.1,4,4,1,2,6,7,-1,4.4,7.2,-2.8,24,EL
0ba976e4,6,365,4.1,4,1,2,0,7,7,0,7.5,4.2,3.3,24,EL
0bf814ff,1,9,0.1,0,0,1,0,0,0,0,0.0,0.0,0.0,24,EL
0bfca6a1,4,354,3.9,4,3,0,0,10,6,4,7.4,4.6,2.7,24,EL
0c152537,9,492,5.5,5,3,4,0,10,6,4,11.8,4.3,7.6,24,EL
0c7a48f8,7,528,5.9,6,5,1,1,15,4,11,11.4,5.3,6.1,24,EL
0cb35466,6,534,5.9,6,4,0,0,5,7,-2,9.5,7.9,1.6,24,EL
0cbe2ba8,2,158,1.8,2,1,0,1,1,6,-5,0.0,0.0,0.0,24,EL
0d267745,4,360,4.0,4,4,0,0,5,3,2,8.8,4.4,4.4,24,EL
0d274394,1,1,0.0,0,0,1,5,0,0,0,0.0,0.1,-0.1,24,EL
0d4fd3a0,1,71,0.8,1,0,0,2,0,3,-3,0.2,1.4,-1.2,24,EL
0d7b6576,2,144,1.6,2,0,0,0,2,1,1,0.9,3.3,-2.4,24,EL
0da3d7ab,1,8,0.1,0,0,1,2,0,0,0,0.2,0.0,0.2,24,EL
0dad7403,5,328,3.6,4,3,1,3,6,9,-3,4.7,5.5,-0.8,24,EL
0df2b165,8,720,8.0,8,8,0,0,10,9,1,9.6,12.2,-2.5,24,EL
0e09dd0d,2,180,2.0,2,2,0,0,3,5,-2,2.5,2.8,-0.3,24,EL
0e100630,1,21,0.2,0,0,1,1,0,0,0,0.1,0.2,-0.1,24,EL
0eb8ee41,8,662,7.4,8,6,0,0,19,11,8,10.7,7.4,3.4,24,EL
0f41e2ee,1,45,0.5,1,0,0,3,0,0,0,1.4,0.4,1.0,24,EL
10072610,2,180,2.0,2,2,0,2,4,2,2,3.1,2.9,0.1,24,EL
102e2599,4,124,1.4,1,0,3,0,0,1,-1,0.4,1.7,-1.3,24,EL
10549b49,2,92,1.0,1,0,1,2,0,1,-1,0.4,1.2,-0.8,24,EL
10cff752,8,619,6.9,8,2,0,0,8,7,1,7.3,12.7,-5.4,24,EL
11b9265b,4,280,3.1,3,2,1,2,6,4,2,5.5,5.2,0.3,24,EL
1227a22d,2,180,2.0,2,2,0,0,2,4,-2,1.4,5.2,-3.7,24,EL
123d2733,1,5,0.1,0,0,1,1,0,0,0,0.2,0.0,0.2,24,EL
12806697,2,135,1.5,2,1,0,0,3,2,1,1.9,1.3,0.6,24,EL
1295b5e3,2,15,0.2,0,0,2,4,0,1,-1,0.5,0.1,0.4,24,EL
12ba7959,5,350,3.9,4,2,1,0,5,10,-5,7.3,6.7,0.6,24,EL
12c50af5,1,29,0.3,1,0,0,0,0,0,0,0.1,0.1,0.0,24,EL
12dcbdcc,9,525,5.8,7,2,2,1,10,6,4,10.4,6.0,4.4,24,EL
12dfd92a,5,450,5.0,5,5,0,1,11,7,4,8.0,7.9,0.1,24,EL
13b736e9,1,17,0.2,0,0,1,2,0,0,0,1.0,0.2,0.8,24,EL
13ca5337,5,100,1.1,1,0,4,1,2,1,1,1.1,1.9,-0.8,24,EL
13ea2544,6,535,5.9,6,5,0,0,11,14,-3,7.6,8.0,-0.4,24,EL
141b0bd2,5,375,4.2,5,3,0,1,2,5,-3,4.5,7.0,-2.5,24,EL
1443ca7d,1,71,0.8,1,0,0,4,0,0,0,1.1,1.2,0.0,24,EL
14b09c41,5,319,3.5,4,2,1,5,7,4,3,5.3,3.3,2.0,24,EL
15e1f59b,3,192,2.1,2,1,1,2,1,3,-2,3.3,5.7,-2.5,24,EL
16657b95,10,799,8.9,8,8,2,0,17,6,11,13.5,7.4,6.1,24,EL
16ceb862,3,260,2.9,3,2,0,1,9,3,6,5.9,1.5,4.3,24,EL
16daec92,4,282,3.1,4,0,0,0,3,5,-2,4.4,5.9,-1.5,24,EL
178ae8f8,3,190,2.1,2,2,1,1,8,1,7,6.2,2.2,4.0,24,EL
17c602ca,5,410,4.6,4,4,1,1,12,9,3,8.0,6.9,1.2,24,EL
17e1261b,2,210,2.3,2,2,0,0,2,3,-1,1.4,4.8,-3.4,24,EL
185a2732,6,517,5.7,6,4,0,0,5,7,-2,9.8,7.1,2.8,24,EL
189fb038,6,239,2.7,2,0,4,0,1,3,-2,3.1,3.1,0.0,24,EL
1971591f,6,457,5.1,5,4,1,1,17,6,11,10.8,5.3,5.4,24,EL
1994703a,5,330,3.7,4,1,1,1,9,4,5,4.9,2.2,2.7,24,EL
19a9cb70,1,74,0.8,1,0,0,4,1,2,-1,0.2,2.3,-2.1,24,EL
19b3caf7,1,90,1.0,1,1,0,5,1,1,0,1.3,1.4,-0.2,24,EL
19cda00b,4,353,3.9,4,2,0,0,5,3,2,8.8,4.3,4.5,24,EL
1adcf39e,2,180,2.0,2,2,0,0,3,5,-2,2.5,2.8,-0.3,24,EL
1b6862e8,6,342,3.8,4,1,2,0,3,9,-6,3.8,4.7,-0.9,24,EL
1ba6c2b3,1,13,0.1,0,0,1,1,0,0,0,0.1,0.0,0.1,24,EL
1bf33a9a,4,292,3.2,4,1,0,0,12,4,8,8.4,3.5,4.9,24,EL
1c341b14,3,265,2.9,3,2,0,2,0,5,-5,1.7,5.0,-3.3,24,EL
1c358b2e,3,173,1.9,2,1,1,0,1,3,-2,2.1,1.7,0.4,24,EL
1c59240b,3,73,0.8,1,0,2,3,2,2,0,2.3,1.2,1.0,24,EL
1d2c3e5e,6,440,4.9,5,2,1,0,3,7,-4,7.0,7.4,-0.4,24,EL
1d2d5cc8,7,630,7.0,7,7,0,0,13,10,3,11.1,9.6,1.5,24,EL
1d3ba8a5,6,492,5.5,6,4,0,0,5,14,-9,3.0,10.8,-7.8,24,EL
1d42db4a,6,517,5.7,6,4,0,0,11,12,-1,8.1,9.3,-1.2,24,EL
1d54e8f8,4,69,0.8,0,0,4,3,0,2,-2,0.7,1.4,-0.7,24,EL
1d5c96f8,7,551,6.1,7,5,0,0,7,9,-2,5.8,12.0,-6.1,24,EL
1e159d70,2,130,1.4,1,1,1,0,2,5,-3,1.2,4.2,-3.0,24,EL
1e37c986,1,4,0.0,0,0,1,1,0,0,0,0.2,0.2,0.1,24,EL
1e4319ac,1,35,0.4,0,0,1,5,2,0,2,1.0,0.0,1.0,24,EL
1e9aa637,5,310,3.4,3,1,2,1,5,2,3,7.6,4.7,2.9,24,EL
1f1828dd,1,7,0.1,0,0,1,0,1,0,1,0.5,0.6,-0.1,24,EL
1f2c7b55,8,330,3.7,3,0,5,2,4,4,0,6.7,3.4,3.3,24,EL
1f3afdcb,5,259,2.9,3,1,2,3,7,5,2,6.0,4.0,2.0,24,EL
1f8c7aa9,1,7,0.1,0,0,1,0,0,0,0,0.0,0.3,-0.3,24,EL
1f994616,4,360,4.0,4,4,0,6,6,4,2,3.4,5.0,-1.6,24,EL
1fbbfbde,7,505,5.6,5,5,2,2,10,4,6,8.5,4.6,4.0,24,EL
20730eae,4,301,3.3,4,2,0,0,12,5,7,8.1,3.1,4.9,24,EL
20b9f052,9,810,9.0,9,9,0,0,21,15,6,16.7,14.1,2.6,24,EL
20e73fac,7,469,5.2,7,2,0,1,9,8,1,6.9,7.7,-0.8,24,EL
2146785a,2,90,1.0,1,0,1,0,4,1,3,2.9,0.5,2.4,24,EL
21a260a8,5,230,2.6,2,1,3,1,2,5,-3,4.7,4.5,0.3,24,EL
2200181e,2,123,1.4,2,0,0,0,2,2,0,1.8,2.4,-0.6,24,EL
226673c2,2,3,0.0,0,0,2,4,0,0,0,0.2,0.1,0.1,24,EL
2319ebe3,3,162,1.8,2,1,1,2,1,4,-3,1.9,3.1,-1.2,24,EL
235a646b,9,746,8.3,9,6,0,0,12,10,2,9.7,13.7,-4.0,24,EL
242e1043,1,120,1.3,1,1,0,0,1,1,0,0.8,1.2,-0.5,24,EL
24baba9d,6,510,5.7,6,2,0,1,9,7,2,6.1,9.6,-3.5,24,EL
24fc70d3,1,87,1.0,1,0,0,0,1,3,-2,0.5,1.7,-1.2,24,EL
25ab9c9c,8,621,6.9,7,5,1,1,11,8,3,11.7,6.9,4.8,24,EL
25cde772,6,458,5.1,5,1,1,0,6,11,-5,6.6,8.7,-2.1,24,EL
25e6f8cb,6,311,3.5,2,0,4,3,4,4,0,5.2,3.9,1.3,24,EL
25ef5b47,2,26,0.3,0,0,2,1,2,0,2,0.7,0.6,0.1,24,EL
26777636,3,190,2.1,2,2,1,1,7,3,4,4.7,0.8,3.8,24,EL
26952edc,2,8,0.1,0,0,2,5,0,0,0,0.0,0.6,-0.6,24,EL
27610955,2,174,1.9,2,1,0,1,0,3,-3,1.4,5.3,-3.9,24,EL
27b030b6,6,489,5.4,6,4,0,0,5,12,-7,6.4,9.0,-2.6,24,EL
27d902c8,4,326,3.6,4,3,0,0,5,5,0,5.9,6.8,-0.8,24,EL
27d95698,2,55,0.6,1,0,1,0,0,0,0,0.9,0.8,0.1,24,EL
27e6fbbc,4,199,2.2,2,1,2,0,2,5,-3,1.3,3.3,-2.0,24,EL
282f75f3,7,585,6.5,7,6,0,0,8,6,2,9.2,6.8,2.4,24,EL
28300a16,5,450,5.0,5,5,0,3,7,9,-2,8.6,6.1,2.5,24,EL
288e1e13,4,360,4.0,4,4,0,3,6,1,5,4.8,3.3,1.5,24,EL
28cb9f21,7,335,3.7,2,1,5,1,4,3,1,5.7,4.3,1.3,24,EL
2903a856,6,177,2.0,2,0,4,2,6,1,5,5.4,2.0,3.5,24,EL
2964fd20,2,16,0.2,0,0,2,1,0,0,0,0.4,0.4,0.0,24,EL
2973a975,5,435,4.8,5,4,0,0,2,14,-12,5.6,7.8,-2.2,24,EL
29d0f2ac,4,122,1.4,1,0,3,3,1,3,-2,1.5,2.5,-1.1,24,EL
29fbdc88,2,81,0.9,0,0,2,0,0,0,0,0.3,0.3,0.0,24,EL
2a1beb34,7,601,6.7,7,6,0,0,10,6,4,11.2,6.9,4.3,24,EL
2a29eb9b,9,434,4.8,4,2,5,0,9,8,1,8.9,5.2,3.7,24,EL
2a57edd2,6,482,5.4,6,3,0,0,5,17,-12,3.8,10.2,-6.4,24,EL
2b3efa4a,4,201,2.2,2,2,2,2,5,3,2,4.5,2.0,2.5,24,EL
2c08cab0,3,188,2.1,2,1,1,5,7,1,6,3.3,1.3,2.1,24,EL
2c70d915,2,109,1.2,1,0,1,4,3,1,2,1.5,1.8,-0.3,24,EL
2e4f5f03,2,180,2.0,2,2,0,2,11,2,9,6.4,1.3,5.1,24,EL
2e820983,3,93,1.0,1,0,2,2,0,2,-2,1.5,0.5,1.1,24,EL
2e9ddbfb,3,204,2.3,2,2,1,1,3,7,-4,3.5,4.3,-0.8,24,EL
2ef7c612,6,305,3.4,3,1,3,0,8,1,7,9.2,5.3,3.9,24,EL
2f18d0b8,2,210,2.3,2,2,0,0,2,2,0,2.0,2.1,-0.1,24,EL
2f90f6b8,5,176,2.0,3,0,2,0,4,2,2,2.7,0.8,1.9,24,EL
2f965a72,1,90,1.0,1,1,0,7,1,2,-1,1.0,0.9,0.1,24,EL
302527b2,5,412,4.6,5,3,0,1,14,5,9,9.0,4.5,4.6,24,EL
307877be,6,355,3.9,4,1,2,0,3,6,-3,3.8,7.3,-3.5,24,EL
30941e96,1,15,0.2,0,0,1,3,0,0,0,0.1,0.0,0.1,24,EL
312d7b42,4,360,4.0,4,4,0,3,3,4,-1,4.1,7.4,-3.3,24,EL
313254a3,9,600,6.7,7,4,2,1,13,10,3,10.0,7.4,2.6,24,EL
315e74cf,4,134,1.5,1,0,3,0,2,3,-1,1.5,2.3,-0.8,24,EL
3170788d,5,352,3.9,4,2,1,3,5,11,-6,5.1,6.7,-1.6,24,EL
31a62dc7,9,694,7.7,7,7,2,1,14,4,10,11.6,6.7,4.8,24,EL
32bb1138,6,484,5.4,5,4,1,0,5,15,-10,3.0,11.1,-8.1,24,EL
32e8417f,1,60,0.7,1,0,0,0,1,1,0,1.3,0.2,1.0,24,EL
33144cc5,4,146,1.6,1,1,3,0,2,0,2,2.9,1.3,1.6,24,EL
33591ff0,6,427,4.7,5,2,1,0,2,7,-5,3.5,7.5,-3.9,24,EL
33651873,9,685,7.6,8,6,1,0,14,8,6,12.5,7.6,4.9,24,EL
33a68b9b,3,110,1.2,1,0,2,1,0,0,0,1.7,1.8,-0.1,24,EL
33a6a650,5,450,5.0,5,5,0,0,7,9,-2,8.0,7.6,0.4,24,EL
349cae8f,5,137,1.5,1,1,4,1,4,3,1,3.6,3.7,-0.1,24,EL
34e393f2,5,392,4.4,4,4,1,0,6,4,2,6.5,5.1,1.4,24,EL
3515d404,8,629,7.0,7,4,1,0,11,5,6,9.8,5.7,4.1,24,EL
3626daea,6,413,4.6,4,2,2,1,7,3,4,6.2,4.7,1.5,24,EL
3642b47f,5,255,2.8,3,1,2,0,3,5,-2,3.0,4.4,-1.4,24,EL
364f602a,2,59,0.7,0,0,2,1,2,1,1,2.0,1.3,0.7,24,EL
3694fad1,6,447,5.0,6,2,0,0,9,12,-3,5.5,6.8,-1.3,24,EL
36b76751,2,25,0.3,0,0,2,3,0,0,0,0.4,0.0,0.4,24,EL
37268799,6,438,4.9,5,4,1,0,2,10,-8,6.3,10.0,-3.6,24,EL
37337aea,2,105,1.2,1,0,1,0,1,2,-1,0.7,1.2,-0.5,24,EL
374c0932,3,47,0.5,0,0,3,6,0,1,-1,0.8,1.3,-0.5,24,EL
37739c71,2,53,0.6,0,0,2,1,1,0,1,0.4,0.6,-0.2,24,EL
38bf8baa,1,14,0.2,0,0,1,2,0,0,0,0.1,0.1,-0.1,24,EL
3935e52e,6,535,5.9,6,5,0,1,9,6,3,9.4,6.7,2.7,24,EL
3945764e,1,90,1.0,1,1,0,0,0,4,-4,0.0,0.0,0.0,24,EL
394be156,8,606,6.7,7,6,1,1,8,10,-2,10.9,8.7,2.1,24,EL
39b326ed,8,576,6.4,7,3,1,0,8,9,-1,7.6,12.8,-5.3,24,EL
39e1138f,2,210,2.3,2,2,0,0,2,2,0,2.0,2.1,-0.1,24,EL
3a58d075,3,80,0.9,1,0,2,1,1,2,-1,1.8,1.3,0.5,24,EL
3a770838,5,353,3.9,5,1,0,1,8,7,1,6.6,6.6,0.0,24,EL
3ad56bf8,3,270,3.0,3,3,0,2,3,4,-1,3.6,3.0,0.6,24,EL
3af19679,6,539,6.0,6,5,0,0,5,17,-12,3.2,12.6,-9.4,24,EL
3b333ac3,4,253,2.8,2,2,2,4,6,2,4,5.7,5.0,0.6,24,EL
3b88609d,2,82,0.9,0,0,2,0,4,2,2,2.5,0.5,1.9,24,EL
3c0aacd2,6,59,0.7,0,0,6,3,2,4,-2,1.2,2.9,-1.7,24,EL
3c70fb81,3,133,1.5,1,0,2,0,2,4,-2,1.7,2.7,-1.0,24,EL
3c776f8f,3,220,2.4,3,1,0,3,1,9,-8,1.4,5.2,-3.7,24,EL
3c7bc9bd,3,244,2.7,3,1,0,3,4,6,-2,4.0,3.8,0.2,24,EL
3dd738a1,2,109,1.2,1,0,1,0,0,2,-2,0.8,3.1,-2.3,24,EL
3ef68782,4,64,0.7,0,0,4,1,0,2,-2,0.6,1.2,-0.6,24,EL
3f319bb9,8,720,8.0,8,8,0,0,9,11,-2,8.9,15.0,-6.2,24,EL
3f359b33,5,450,5.0,5,5,0,0,3,10,-7,7.4,11.2,-3.7,24,EL
3f47ebce,3,75,0.8,1,0,2,1,2,0,2,1.8,0.3,1.6,24,EL
40e57039,6,540,6.0,6,6,0,0,3,17,-14,7.4,9.8,-2.4,24,EL
40f65c01,6,391,4.3,5,2,1,0,1,7,-6,3.6,5.5,-1.9,24,EL
411fabd7,5,378,4.2,5,1,0,0,3,8,-5,4.9,9.0,-4.1,24,EL
4125cb98,7,539,6.0,6,5,1,1,21,7,14,13.2,6.6,6.6,24,EL
414b2ce4,2,180,2.0,2,2,0,0,4,6,-2,2.2,4.0,-1.8,24,EL
415568b5,2,172,1.9,2,0,0,0,2,5,-3,2.2,2.8,-0.6,24,EL
418befe0,6,540,6.0,6,6,0,0,7,13,-6,7.0,10.4,-3.3,24,EL
41eebdf5,5,361,4.0,4,4,1,2,12,9,3,8.1,6.5,1.7,24,EL
41f0b196,4,360,4.0,4,4,0,0,5,3,2,8.8,4.4,4.4,24,EL
4253363a,5,425,4.7,4,4,1,0,5,12,-7,5.1,9.5,-4.3,24,EL
4256a876,4,57,0.6,0,0,4,2,2,2,0,1.2,1.7,-0.5,24,EL
4288f249,5,239,2.7,3,0,2,1,2,6,-4,1.9,3.5,-1.6,24,EL
42fdb11d,8,200,2.2,0,0,8,0,3,5,-2,3.1,4.5,-1.4,24,EL
43521f09,6,480,5.3,6,1,0,0,4,11,-7,5.3,8.7,-3.5,24,EL
4353dd07,5,377,4.2,4,4,1,0,7,10,-3,6.5,6.5,0.0,24,EL
43b78598,2,180,2.0,2,2,0,0,4,6,-2,2.2,4.0,-1.8,24,EL
441197b8,8,666,7.4,7,7,1,0,13,5,8,9.5,7.0,2.5,24,EL
443a4bb2,8,348,3.9,4,1,4,0,13,3,10,8.1,3.1,5.0,24,EL
45191c29,8,408,4.5,5,0,3,1,5,3,2,5.8,3.4,2.4,24,EL
4534a352,6,540,6.0,6,6,0,2,11,7,4,10.5,7.3,3.2,24,EL
45922f6d,1,90,1.0,1,1,0,5,0,3,-3,0.2,1.8,-1.5,24,EL
4596da74,7,210,2.3,1,0,6,0,3,0,3,4.0,2.4,1.7,24,EL
45b9b619,5,198,2.2,3,0,2,3,6,4,2,4.0,3.7,0.2,24,EL
45c29ae7,2,130,1.4,1,0,1,0,4,4,0,3.2,2.5,0.8,24,EL
466f9e5b,2,172,1.9,2,1,0,0,3,6,-3,0.8,3.5,-2.7,24,EL
468a7a91,5,217,2.4,2,0,3,3,0,4,-4,3.3,3.6,-0.3,24,EL
47420f02,1,7,0.1,0,0,1,1,0,0,0,0.0,0.0,0.0,24,EL
4788cb6b,2,18,0.2,0,0,2,3,0,0,0,0.7,0.2,0.5,24,EL
478f023e,1,7,0.1,0,0,1,0,0,0,0,0.1,0.7,-0.6,24,EL
47c609d5,2,15,0.2,0,0,2,0,0,0,0,0.1,0.6,-0.5,24,EL
47f82561,3,8,0.1,0,0,3,7,0,0,0,0.1,0.1,0.0,24,EL
47fd5136,1,90,1.0,1,1,0,1,1,3,-2,1.7,1.7,0.0,24,EL
4876c9ab,2,209,2.3,2,1,0,0,2,2,0,2.0,2.0,0.0,24,EL
4a1a9578,5,343,3.8,4,1,1,3,12,5,7,8.6,2.8,5.8,24,EL
4a1abff3,10,913,10.1,10,4,0,0,16,15,1,12.5,17.6,-5.1,24,EL
4a396ae9,6,80,0.9,0,0,6,4,3,3,0,1.7,2.5,-0.9,24,EL
4a478107,6,247,2.7,2,0,4,2,5,4,1,2.2,4.4,-2.2,24,EL
4a56052c,9,605,6.7,7,1,2,0,18,7,11,14.2,8.9,5.3,24,EL
4a5a45c7,6,387,4.3,4,3,2,1,8,3,5,6.3,4.6,1.7,24,EL
4adc7b42,6,465,5.2,6,2,0,0,15,8,7,8.0,4.3,3.6,24,EL
4b00cd47,6,528,5.9,6,5,0,0,4,9,-5,5.6,8.9,-3.3,24,EL
4b49ed54,2,38,0.4,0,0,2,3,0,0,0,0.5,1.7,-1.2,24,EL
4b96c347,2,59,0.7,0,0,2,0,0,2,-2,0.5,1.4,-0.9,24,EL
4bce9c16,10,760,8.4,10,2,0,0,15,18,-3,11.1,12.6,-1.4,24,EL
4bd00a50,6,540,6.0,6,6,0,0,11,14,-3,7.7,8.0,-0.3,24,EL
4bd414c1,3,141,1.6,2,1,1,3,5,2,3,3.2,1.6,1.6,24,EL
4c184730,6,455,5.1,6,1,0,0,9,12,-3,7.3,8.7,-1.4,24,EL
4c5039bd,6,540,6.0,6,6,0,0,11,14,-3,7.7,8.0,-0.3,24,EL
4c5b714f,4,291,3.2,4,2,0,2,3,6,-3,4.6,7.5,-2.9,24,EL
4d0be953,1,5,0.1,0,0,1,5,0,1,-1,0.6,0.4,0.2,24,EL
4d2d7ea5,5,221,2.5,1,1,4,1,2,5,-3,4.5,3.3,1.2,24,EL
4d5a9185,9,620,6.9,8,5,1,0,10,8,2,12.3,7.5,4.8,24,EL
4d77b365,8,376,4.2,5,1,3,0,18,5,13,12.6,4.0,8.6,24,EL
4d8cd038,2,115,1.3,1,1,1,2,3,3,0,3.0,3.2,-0.2,24,EL
4dcec659,8,533,5.9,6,5,2,0,7,4,3,8.5,6.0,2.5,24,EL
4e6e69b3,3,178,2.0,2,1,1,3,2,0,2,1.8,2.0,-0.1,24,EL
4f1e6a0b,4,245,2.7,3,0,1,0,4,3,1,6.4,4.0,2.4,24,EL
4f565d77,2,15,0.2,0,0,2,0,0,0,0,0.3,0.0,0.3,24,EL
4f5a953e,9,570,6.3,6,5,3,1,13,14,-1,8.9,13.4,-4.4,24,EL
4f974391,4,236,2.6,3,1,1,3,5,1,4,3.5,2.0,1.5,24,EL
4fac8f81,2,210,2.3,2,2,0,0,2,2,0,2.0,2.1,-0.1,24,EL
4fb9c88f,4,258,2.9,2,1,2,1,7,3,4,4.3,4.7,-0.4,24,EL
4fd08daa,7,624,6.9,7,6,0,0,10,9,1,11.0,7.1,3.9,24,EL
50e73475,4,299,3.3,3,3,1,2,1,5,-4,2.8,5.7,-2.9,24,EL
50f9bec6,1,14,0.2,0,0,1,1,1,1,0,0.3,0.2,0.0,24,EL
5148dcc5,7,407,4.5,5,2,2,0,9,9,0,6.8,8.0,-1.2,24,EL
5167c97e,2,128,1.4,1,0,1,0,0,2,-2,0.9,3.0,-2.1,24,EL
518f2234,8,412,4.6,5,2,3,0,10,8,2,5.9,6.2,-0.2,24,EL
51dbeea9,5,265,2.9,3,2,2,1,7,4,3,4.4,2.7,1.6,24,EL
5219ab4a,10,866,9.6,10,7,0,0,24,16,8,18.8,15.0,3.9,24,EL
524ed774,7,463,5.1,5,2,2,0,16,4,12,10.1,2.9,7.2,24,EL
52611641,2,171,1.9,2,0,0,0,3,5,-2,2.1,3.6,-1.5,24,EL
526541e5,1,90,1.0,1,1,0,0,2,0,2,0.9,0.3,0.6,24,EL
52d7f819,6,464,5.2,6,3,0,0,10,11,-1,7.8,7.9,-0.1,24,EL
530e7d85,2,210,2.3,2,2,0,0,2,2,0,2.0,2.1,-0.1,24,EL
53520a67,4,212,2.4,2,2,2,0,5,5,0,3.7,6.9,-3.2,24,EL
53a13f51,4,225,2.5,2,1,2,1,4,7,-3,2.6,4.3,-1.6,24,EL
540ec57b,3,143,1.6,1,0,2,0,3,2,1,1.6,1.9,-0.3,24,EL
543b9811,2,93,1.0,1,0,1,0,2,3,-1,1.2,2.5,-1.3,24,EL
54b4dc4e,2,157,1.7,2,0,0,0,3,4,-1,2.0,2.8,-0.8,24,EL
54d608cc,5,436,4.8,5,4,0,1,9,11,-2,6.8,6.7,0.2,24,EL
54dd7308,3,123,1.4,1,0,2,3,3,2,1,2.1,3.2,-1.1,24,EL
54e4866f,10,622,6.9,8,0,2,0,16,9,7,11.0,8.6,2.4,24,EL
54fcc20c,2,4,0.0,0,0,2,4,1,0,1,0.4,0.0,0.4,24,EL
5521f419,7,350,3.9,4,1,3,1,9,3,6,5.1,4.0,1.0,24,EL
55b93ae0,3,212,2.4,2,2,1,3,1,7,-6,2.8,7.0,-4.3,24,EL
55bf8287,6,540,6.0,6,6,0,0,4,13,-9,6.1,9.3,-3.2,24,EL
56bcde74,3,250,2.8,3,2,0,2,7,8,-1,3.7,3.4,0.3,24,EL
56f6f826,7,630,7.0,7,7,0,0,9,8,1,8.1,10.5,-2.4,24,EL
576817b7,2,150,1.7,2,1,0,0,1,4,-3,0.5,3.5,-3.0,24,EL
576c084f,2,112,1.2,1,0,1,0,0,1,-1,1.3,1.8,-0.5,24,EL
57760e66,10,591,6.6,6,3,4,0,14,5,9,13.2,4.5,8.7,24,EL
57827369,5,218,2.4,3,0,2,1,0,3,-3,3.6,3.1,0.5,24,EL
585fe6ab,6,294,3.3,3,0,3,0,1,5,-4,5.2,6.2,-1.0,24,EL
5885dc48,3,90,1.0,0,0,3,5,3,0,3,2.0,0.4,1.5,24,EL
58a05c2e,2,100,1.1,1,1,1,0,1,1,0,1.0,3.5,-2.5,24,EL
58aae0a9,3,158,1.8,2,0,1,1,3,2,1,2.4,2.0,0.4,24,EL
5944af8f,6,229,2.5,2,1,4,0,3,10,-7,2.1,7.2,-5.2,24,EL
59948ef7,2,151,1.7,2,0,0,0,2,1,1,0.9,3.4,-2.5,24,EL
599d91d0,1,89,1.0,1,0,0,7,3,0,3,2.6,1.7,0.9,24,EL
59f0c185,1,90,1.0,1,1,0,5,1,2,-1,1.7,1.9,-0.2,24,EL
5a04fd92,5,307,3.4,4,1,1,1,4,3,1,4.6,2.0,2.6,24,EL
5a9dab86,3,211,2.3,3,0,0,0,3,6,-3,2.0,4.5,-2.6,24,EL
5aa1a2a7,1,2,0.0,0,0,1,3,0,0,0,0.0,0.0,0.0,24,EL
5aa53281,8,723,8.0,8,7,0,1,14,6,8,9.5,7.9,1.6,24,EL
5acc4a10,7,472,5.2,5,3,2,1,8,4,4,5.7,5.3,0.4,24,EL
5ada5385,6,421,4.7,5,2,1,0,4,15,-11,3.3,7.8,-4.4,24,EL
5add6a3e,4,259,2.9,4,0,0,2,2,7,-5,2.1,5.4,-3.3,24,EL
5ae499d0,7,320,3.6,5,1,2,0,4,8,-4,4.2,7.4,-3.2,24,EL
5b5c2228,7,630,7.0,7,7,0,0,12,19,-7,8.9,12.1,-3.2,24,EL
5c1663e9,6,217,2.4,2,0,4,0,2,1,1,3.2,4.0,-0.9,24,EL
5c397195,9,522,5.8,6,0,3,0,13,9,4,7.2,9.0,-1.8,24,EL
5c550ee1,4,360,4.0,4,4,0,2,7,9,-2,3.8,6.6,-2.7,24,EL
5caa62a7,1,58,0.6,0,0,1,0,3,2,1,1.6,0.5,1.0,24,EL
5cbb5ad6,2,23,0.3,0,0,2,2,0,0,0,0.1,0.3,-0.2,24,EL
5cdddffa,1,1,0.0,0,0,1,0,1,0,1,0.0,0.0,0.0,24,EL
5d0e0a1f,8,562,6.2,6,3,2,0,13,8,5,12.2,7.5,4.6,24,EL
5d4f7d61,5,157,1.7,1,0,4,0,8,1,7,5.0,1.7,3.3,24,EL
5d51b074,2,96,1.1,1,0,1,0,0,1,-1,0.3,2.5,-2.2,24,EL
5d8e331f,10,888,9.9,10,8,0,0,21,12,9,17.0,10.4,6.7,24,EL
5d9cff53,2,126,1.4,1,1,1,0,3,5,-2,1.5,2.9,-1.4,24,EL
5e22e2a4,7,358,4.0,3,1,4,1,6,6,0,7.0,6.0,1.0,24,EL
5e42afa3,5,446,5.0,5,4,0,1,5,9,-4,7.2,9.2,-2.0,24,EL
5e5273eb,4,224,2.5,2,2,2,1,1,6,-5,1.4,4.4,-2.9,24,EL
5e6355f8,3,34,0.4,0,0,3,3,0,1,-1,1.1,0.4,0.7,24,EL
5eae500a,9,791,8.8,9,5,0,0,18,6,12,13.0,7.5,5.5,24,EL
5ed97752,10,510,5.7,6,1,4,0,14,9,5,11.7,7.9,3.8,24,EL
5ed9b537,5,320,3.6,5,1,0,1,11,4,7,9.7,4.0,5.7,24,EL
5f26e0c5,5,442,4.9,5,4,0,0,3,10,-7,7.2,10.2,-3.0,24,EL
5f3a46fb,6,475,5.3,6,4,0,0,2,16,-14,0.0,0.0,0.0,24,EL
5f3d00d1,5,166,1.8,1,0,4,2,3,0,3,3.2,1.5,1.7,24,EL
5f5ebdae,1,1,0.0,0,0,1,5,0,0,0,0.0,0.2,-0.2,24,EL
60713cb3,6,540,6.0,6,6,0,0,5,17,-12,3.2,12.8,-9.6,24,EL
60d90c55,2,210,2.3,2,2,0,0,2,3,-1,1.4,4.8,-3.4,24,EL
611f4f60,5,450,5.0,5,5,0,0,11,7,4,8.0,7.9,0.1,24,EL
6191093d,8,371,4.1,3,2,5,0,9,4,5,7.8,4.3,3.4,24,EL
6224214f,1,3,0.0,0,0,1,3,0,0,0,0.1,0.0,0.1,24,EL
62cf5c04,5,137,1.5,0,0,5,1,2,3,-1,3.2,1.8,1.4,24,EL
62d7ef38,7,630,7.0,7,7,0,0,26,9,17,16.3,6.7,9.6,24,EL
62de9d42,5,220,2.4,2,0,3,1,1,5,-4,2.5,4.3,-1.9,24,EL
6358cb11,5,414,4.6,4,3,1,0,3,11,-8,2.7,7.8,-5.1,24,EL
636247ca,9,636,7.1,8,1,1,0,11,16,-5,9.2,10.1,-0.9,24,EL
638ddf68,6,360,4.0,4,1,2,0,1,8,-7,3.1,7.5,-4.5,24,EL
63f04c6c,4,171,1.9,1,1,3,0,0,3,-3,1.3,3.1,-1.9,24,EL
640d17d5,1,16,0.2,0,0,1,5,0,1,-1,0.1,0.8,-0.6,24,EL
6445d6fe,5,137,1.5,1,0,4,0,2,3,-1,1.8,3.4,-1.6,24,EL
645481cc,6,260,2.9,2,2,4,0,5,4,1,6.2,2.9,3.2,24,EL
649b57e9,2,108,1.2,1,0,1,0,2,1,1,0.6,1.8,-1.2,24,EL
64aadf6b,1,7,0.1,0,0,1,1,0,0,0,0.0,0.0,0.0,24,EL
652c4865,5,194,2.2,3,0,2,1,1,4,-3,4.3,4.6,-0.3,24,EL
653222cd,1,90,1.0,1,1,0,0,2,3,-1,2.3,1.6,0.7,24,EL
6597f8b6,6,438,4.9,5,3,1,0,5,6,-1,9.0,6.5,2.5,24,EL
65d62814,6,540,6.0,6,6,0,2,10,7,3,13.1,5.4,7.8,24,EL
65e4dede,5,349,3.9,4,3,1,1,1,4,-3,3.5,6.5,-3.0,24,EL
6613c819,8,496,5.5,5,5,3,0,10,3,7,8.0,4.5,3.4,24,EL
663629ae,2,167,1.9,2,0,0,0,2,3,-1,1.8,3.9,-2.1,24,EL
6637e6a7,6,513,5.7,6,3,0,0,3,9,-6,4.2,9.1,-4.9,24,EL
66a7effe,1,28,0.3,0,0,1,1,0,1,-1,0.2,0.2,-0.1,24,EL
689c9cf4,1,60,0.7,1,0,0,0,0,1,-1,0.0,1.8,-1.8,24,EL
68cf59f0,2,8,0.1,0,0,2,2,0,0,0,0.1,0.1,0.1,24,EL
6989550f,5,450,5.0,5,5,0,1,6,8,-2,7.8,7.0,0.8,24,EL
698f11e3,8,550,6.1,7,5,1,0,7,9,-2,5.7,11.3,-5.5,24,EL
6a54638e,5,405,4.5,5,2,0,1,5,7,-2,6.1,7.9,-1.9,24,EL
6a829019,2,167,1.9,2,1,0,0,1,4,-3,0.6,4.3,-3.7,24,EL
6b91b999,8,720,8.0,8,8,0,0,9,11,-2,8.9,15.0,-6.2,24,EL
6be41a31,2,164,1.8,2,0,0,0,1,1,0,2.4,3.9,-1.4,24,EL
6c731625,2,60,0.7,0,0,2,0,1,0,1,1.2,1.7,-0.5,24,EL
6c7762c3,3,180,2.0,3,0,0,1,4,2,2,2.5,1.5,1.0,24,EL
6cbf8d0d,2,210,2.3,2,2,0,0,5,6,-1,4.2,3.5,0.8,24,EL
6d445ffc,8,647,7.2,8,6,0,0,14,12,2,11.5,8.9,2.6,24,EL
6e33125f,1,90,1.0,1,1,0,0,0,0,0,0.6,1.6,-1.0,24,EL
6ea23758,6,465,5.2,5,5,1,0,5,12,-7,6.5,10.0,-3.5,24,EL
6eac907b,4,73,0.8,0,0,4,2,1,5,-4,0.5,2.3,-1.8,24,EL
6eee05f1,7,593,6.6,7,6,0,0,11,5,6,13.2,5.9,7.3,24,EL
6f5ec8bb,1,120,1.3,1,1,0,0,2,3,-1,0.8,3.2,-2.3,24,EL
6f7d7bc2,5,355,3.9,4,3,1,1,6,11,-5,5.7,7.8,-2.1,24,EL
6f806d99,6,322,3.6,4,2,2,0,8,4,4,6.2,4.8,1.4,24,EL
6fbde63a,10,717,8.0,9,0,1,0,12,4,8,9.0,9.1,-0.1,24,EL
708d068c,3,51,0.6,0,0,3,2,0,5,-5,0.2,2.6,-2.5,24,EL
70a9cba5,5,217,2.4,3,0,2,3,3,4,-1,3.0,1.4,1.5,24,EL
70cf63ca,4,359,4.0,4,3,0,0,5,3,2,8.8,4.4,4.5,24,EL
71031a25,4,264,2.9,3,0,1,0,2,5,-3,2.8,4.2,-1.4,24,EL
7120a04d,2,23,0.3,0,0,2,0,1,2,-1,0.2,1.2,-1.0,24,EL
712dd708,5,450,5.0,5,5,0,2,8,6,2,7.1,6.4,0.7,24,EL
713c144a,5,385,4.3,5,2,0,0,6,11,-5,6.1,8.5,-2.4,24,EL
715e5b0e,6,490,5.4,6,2,0,0,11,12,-1,7.1,7.3,-0.2,24,EL
718a3a5c,4,359,4.0,4,3,0,0,3,11,-8,2.4,7.6,-5.2,24,EL
72603d10,3,132,1.5,1,0,2,0,1,3,-2,1.4,1.7,-0.4,24,EL
7271a7d4,6,291,3.2,3,1,3,0,1,4,-3,5.9,6.4,-0.5,24,EL
731302dc,6,293,3.3,3,0,3,0,3,6,-3,3.6,4.5,-0.9,24,EL
73341ace,2,98,1.1,1,0,1,0,7,1,6,3.5,0.5,3.1,24,EL
733f1a7d,3,167,1.9,3,0,0,2,2,4,-2,1.7,2.6,-0.9,24,EL
73c56892,4,319,3.5,4,0,0,0,3,10,-7,2.1,7.3,-5.2,24,EL
73d430c6,6,508,5.6,6,4,0,0,4,13,-9,5.9,9.0,-3.1,24,EL
740a0e28,4,90,1.0,0,0,4,2,2,3,-1,2.4,4.2,-1.8,24,EL
7410d325,5,277,3.1,4,0,1,2,6,3,3,3.7,2.8,1.0,24,EL
742a4995,6,465,5.2,6,3,0,0,3,7,-4,7.2,7.5,-0.2,24,EL
742ea558,3,73,0.8,0,0,3,2,1,0,1,0.8,0.9,-0.2,24,EL
743ffce1,9,270,3.0,3,0,6,1,4,7,-3,3.6,4.7,-1.1,24,EL
7460ca0d,7,460,5.1,4,4,3,0,12,7,5,7.5,8.3,-0.8,24,EL
74618572,6,513,5.7,6,4,0,0,10,5,5,9.2,5.1,4.1,24,EL
74b2cd7e,2,180,2.0,2,2,0,6,4,3,1,3.2,1.5,1.7,24,EL
74d4cec6,6,274,3.0,3,1,3,0,7,2,5,6.5,5.5,1.0,24,EL
74f2e748,5,273,3.0,2,1,3,3,8,3,5,8.1,3.3,4.7,24,EL
75645f0e,8,511,5.7,7,1,1,0,5,8,-3,7.4,6.300000000000001,1.1,24,EL
756ff73f,4,35,0.4,0,0,4,0,0,0,0,0.3,0.7,-0.4,24,EL
757a3431,4,283,3.1,3,3,1,3,5,4,1,6.9,3.2,3.7,24,EL
75b74432,6,392,4.4,3,3,3,0,1,9,-8,3.4,6.8,-3.3,24,EL
760fd987,1,30,0.3,0,0,1,1,1,2,-1,1.2,0.3,0.8,24,EL
7664c2e8,4,132,1.5,1,0,3,2,1,3,-2,1.0,2.8,-1.8,24,EL
7696cc85,6,517,5.7,6,4,0,0,11,13,-2,7.4,7.7,-0.4,24,EL
76d0e227,2,53,0.6,0,0,2,4,3,1,2,2.1,1.3,0.8,24,EL
7713c72a,1,90,1.0,1,1,0,0,2,2,0,0.8,1.1,-0.3,24,EL
774b7f08,6,365,4.1,5,0,1,0,4,8,-4,5.1,7.9,-2.8,24,EL
77e39b04,8,529,5.9,7,3,1,1,8,6,2,8.1,4.2,3.9,24,EL
78f13530,3,48,0.5,0,0,3,3,0,4,-4,0.3,1.3,-1.1,24,EL
78f21137,4,295,3.3,3,2,1,0,5,3,2,7.3,4.2,3.0,24,EL
794364d7,2,180,2.0,2,2,0,0,4,6,-2,2.2,4.0,-1.8,24,EL
79b51257,1,47,0.5,0,0,1,1,0,2,-2,0.3,1.5,-1.1,24,EL
79c84d1c,6,459,5.1,5,3,1,0,11,2,9,7.8,4.8,3.0,24,EL
79ccb6eb,8,414,4.6,4,2,4,1,9,11,-2,6.9,10.1,-3.2,24,EL
7a11550b,8,463,5.1,5,3,3,0,21,5,16,13.1,4.9,8.1,24,EL
7a2e46a8,1,90,1.0,1,1,0,3,2,0,2,2.9,1.1,1.8,24,EL
7a391b75,5,450,5.0,5,5,0,0,6,11,-5,5.8,10.3,-4.5,24,EL
7a42d0df,2,210,2.3,2,2,0,0,2,3,-1,1.4,4.8,-3.4,24,EL
7a538238,4,127,1.4,1,1,3,2,2,4,-2,1.1,1.6,-0.4,24,EL
7a6c48f8,5,450,5.0,5,5,0,0,3,6,-3,5.6,9.9,-4.4,24,EL
7af655fe,1,11,0.1,0,0,1,2,0,0,0,0.2,0.2,0.0,24,EL
7b04c5cb,3,132,1.5,2,0,1,0,1,3,-2,1.0,2.1,-1.1,24,EL
7b433ed0,10,900,10.0,10,10,0,0,17,22,-5,13.3,15.2,-1.9,24,EL
7b536033,6,67,0.7,0,0,6,0,2,1,1,1.5,1.8,-0.3,24,EL
7b5f516f,1,7,0.1,0,0,1,6,1,0,1,0.5,0.6,-0.1,24,EL
7b9ecf02,4,331,3.7,4,3,0,1,3,5,-2,2.9,5.9,-3.0,24,EL
7c104bb7,7,507,5.6,7,1,0,0,11,5,6,9.5,5.1,4.4,24,EL
7c2965bb,1,53,0.6,0,0,1,1,3,2,1,1.5,0.5,1.0,24,EL
7c2a398c,6,460,5.1,6,2,0,0,6,11,-5,7.3,10.4,-3.1,24,EL
7c3ed041,8,639,7.1,7,6,1,1,14,9,5,12.8,9.6,3.2,24,EL
7c41b738,6,459,5.1,5,4,1,0,2,11,-9,4.6,8.2,-3.6,24,EL
7d0b3e46,1,20,0.2,0,0,1,3,1,0,1,0.3,0.2,0.1,24,EL
7d31f1cb,1,54,0.6,1,0,0,3,2,1,1,1.4,1.4,0.0,24,EL
7d6af698,3,137,1.5,2,0,1,2,6,3,3,3.0,3.2,-0.3,24,EL
7d704e92,3,197,2.2,2,2,1,1,2,3,-1,1.6,2.9,-1.3,24,EL
7da05fff,6,264,2.9,2,1,4,0,2,8,-6,4.1,6.6,-2.5,24,EL
7e277e7c,5,258,2.9,3,1,2,1,11,3,8,5.6,2.7,2.9,24,EL
7e2f45f4,5,248,2.8,3,0,2,0,2,3,-1,3.8,4.7,-0.9,24,EL
7ec723b7,4,275,3.1,3,2,1,6,5,2,3,5.2,1.8,3.4,24,EL
7ed08d5c,8,493,5.5,5,5,3,0,17,2,15,12.0,4.7,7.4,24,EL
7edfbb8a,2,90,1.0,1,0,1,0,4,1,3,2.9,0.5,2.4,24,EL
7f8fb807,4,76,0.8,1,0,3,1,2,2,0,2.6,1.7,0.8,24,EL
7f9111ea,5,450,5.0,5,5,0,1,5,10,-5,6.0,8.7,-2.7,24,EL
7f9c5d2d,5,398,4.4,4,3,1,1,6,3,3,6.7,4.7,2.0,24,EL
7f9d956a,1,2,0.0,0,0,1,0,1,0,1,0.1,0.6,-0.6,24,EL
7fcc71d8,6,405,4.5,5,1,1,0,10,8,2,5.5,5.0,0.5,24,EL
7fe90ccd,6,307,3.4,4,0,2,0,8,1,7,7.5,2.6,4.9,24,EL
7ff1c729,5,223,2.5,2,0,3,1,2,10,-8,2.2,4.3,-2.0,24,EL
7fff395a,6,434,4.8,5,3,1,0,6,7,-1,8.8,7.6,1.1,24,EL
803e7aca,1,120,1.3,1,1,0,0,1,1,0,0.8,1.2,-0.5,24,EL
8059806f,5,240,2.7,3,0,2,0,2,1,1,2.7,2.6,0.1,24,EL
808035bd,8,750,8.3,8,8,0,1,15,19,-4,10.1,18.4,-8.3,24,EL
819aa8e7,6,285,3.2,2,1,4,0,7,4,3,6.2,3.4,2.7,24,EL
81f0781e,6,317,3.5,3,1,3,0,6,9,-3,5.2,5.8,-0.6,24,EL
82464ce3,2,129,1.4,1,0,1,0,2,3,-1,0.8,3.2,-2.4,24,EL
82598b71,1,90,1.0,1,1,0,3,4,0,4,2.7,2.3,0.3,24,EL
827651b8,2,6,0.1,0,0,2,3,0,0,0,0.0,0.1,0.0,24,EL
82927de4,5,314,3.5,4,1,1,1,3,4,-1,3.0,3.0,0.0,24,EL
82e12fe7,6,129,1.4,1,0,5,4,3,1,2,1.7,0.8,0.9,24,EL
83299cc0,8,485,5.4,5,3,3,1,7,11,-4,7.4,9.2,-1.8,24,EL
8382b207,10,783,8.7,10,0,0,0,13,11,2,10.3,13.6,-3.3,24,EL
83d074ff,4,229,2.5,2,1,2,3,9,4,5,5.0,2.4,2.6,24,EL
841beda7,1,13,0.1,1,0,0,1,0,0,0,0.0,0.0,0.0,24,EL
8530dd74,6,430,4.8,6,1,0,0,2,7,-5,4.5,8.6,-4.1,24,EL
856eefa6,4,148,1.6,1,0,3,2,1,4,-3,0.0,0.0,0.0,24,EL
857411ed,3,270,3.0,3,3,0,2,6,8,-2,5.1,4.6,0.5,24,EL
8593f88c,3,200,2.2,2,2,1,1,1,5,-4,1.8,3.7,-2.0,24,EL
85bed4ee,3,79,0.9,1,0,2,2,1,0,1,1.3,0.2,1.1,24,EL
85f7d1be,1,45,0.5,0,0,1,1,0,1,-1,0.3,0.1,0.2,24,EL
878f0921,6,137,1.5,1,0,5,0,2,3,-1,1.7,1.8,-0.1,24,EL
8790f988,6,333,3.7,4,0,2,0,5,5,0,4.3,4.5,-0.2,24,EL
88015937,6,259,2.9,3,0,3,0,2,3,-1,3.1,4.1,-1.0,24,EL
881cd6be,2,180,2.0,2,2,0,2,3,2,1,4.0,1.9,2.1,24,EL
8830d81d,1,30,0.3,0,0,1,1,1,0,1,0.9,1.7,-0.7,24,EL
88a9ea33,6,345,3.8,4,2,2,0,4,7,-3,6.8,7.8,-1.0,24,EL
88d56da3,4,271,3.0,3,3,1,1,1,9,-8,2.4,6.3,-3.8,24,EL
89333def,5,401,4.5,4,3,1,0,5,15,-10,4.1,7.4,-3.3,24,EL
894e0084,3,50,0.6,0,0,3,2,0,0,0,0.4,1.6,-1.2,24,EL
89b2c8a9,2,150,1.7,2,0,0,0,3,3,0,2.1,3.1,-1.0,24,EL
89c63f8c,6,441,4.9,5,4,1,3,4,8,-4,4.7,7.8,-3.1,24,EL
8a310070,6,357,4.0,5,0,1,0,9,8,1,7.2,7.0,0.3,24,EL
8a6ab963,10,924,10.3,10,9,0,0,17,18,-1,12.7,18.5,-5.8,24,EL
8ae7d0ec,5,250,2.8,3,0,2,1,5,4,1,4.8,2.0,2.8,24,EL
8aec0537,8,720,8.0,8,8,0,0,11,9,2,12.3,8.7,3.6,24,EL
8af1b3a2,7,630,7.0,7,7,0,1,18,7,11,11.9,5.1,6.8,24,EL
8b3ab7ad,6,416,4.6,5,2,1,0,11,2,9,7.6,4.0,3.6,24,EL
8b529245,2,9,0.1,0,0,2,0,1,1,0,0.1,0.4,-0.3,24,EL
8b5504e1,6,470,5.2,5,4,1,0,5,7,-2,9.5,5.5,4.0,24,EL
8b8a56ce,3,241,2.7,3,2,0,1,9,5,4,6.1,3.8,2.3,24,EL
8b8a9bde,5,450,5.0,5,5,0,0,3,8,-5,7.1,8.7,-1.6,24,EL
8bb174fc,6,465,5.2,5,5,1,0,3,13,-10,7.1,6.9,0.1,24,EL
8bf49cd8,6,540,6.0,6,6,0,0,6,19,-13,4.6,11.7,-7.1,24,EL
8bfbf257,3,113,1.3,1,0,2,2,2,2,0,0.8,2.4,-1.6,24,EL
8c4b95af,6,401,4.5,4,2,2,0,4,11,-7,0.0,0.0,0.0,24,EL
8c725b43,6,533,5.9,6,5,0,0,8,6,2,8.8,5.9,2.9,24,EL
8c8c07a7,5,239,2.7,3,1,2,0,5,3,2,4.5,3.0,1.5,24,EL
8d4baac4,1,45,0.5,1,0,0,0,1,2,-1,0.2,1.2,-1.1,24,EL
8d5d4b89,5,153,1.7,1,0,4,0,3,0,3,3.3,1.7,1.5,24,EL
8dfdc6c3,6,304,3.4,4,0,2,0,1,6,-5,1.7,6.7,-5.0,24,EL
8e235926,8,346,3.8,2,0,6,0,14,5,9,7.3,3.9,3.4,24,EL
8e3cf6ce,5,450,5.0,5,5,0,1,5,16,-11,4.1,9.5,-5.4,24,EL
8ec56e62,1,83,0.9,1,0,0,7,3,0,3,2.1,1.7,0.4,24,EL
8eef18aa,2,210,2.3,2,2,0,0,5,6,-1,4.2,3.5,0.8,24,EL
8f0435c7,4,360,4.0,4,4,0,0,5,3,2,8.8,4.4,4.4,24,EL
8f21b7bd,7,413,4.6,4,2,3,0,8,8,0,6.2,4.6,1.5,24,EL
8f4e359f,5,78,0.9,1,0,4,1,0,2,-2,0.1,2.7,-2.6,24,EL
8f7e6783,2,129,1.4,2,0,0,0,2,2,0,1.7,1.8,-0.2,24,EL
90339309,4,268,3.0,3,0,1,1,4,3,1,4.4,3.1,1.3,24,EL
90f8796d,1,1,0.0,0,0,1,0,0,0,0,0.0,0.2,-0.2,24,EL
90fcf472,2,37,0.4,0,0,2,0,0,0,0,0.3,0.0,0.3,24,EL
921f6058,1,11,0.1,0,0,1,1,0,0,0,0.1,0.0,0.0,24,EL
925fe145,5,175,1.9,1,0,4,3,4,0,4,1.9,0.7,1.2,24,EL
92725c75,2,112,1.2,1,1,1,4,2,7,-5,1.4,3.1,-1.7,24,EL
92868cb5,4,88,1.0,1,0,3,4,0,0,0,0.1,1.1,-0.9,24,EL
92904961,5,138,1.5,1,0,4,1,1,3,-2,2.5,4.2,-1.7,24,EL
92ffb8f9,8,720,8.0,8,8,0,0,9,11,-2,8.9,15.0,-6.2,24,EL
9319781b,2,90,1.0,1,0,1,5,1,0,1,0.4,0.7,-0.3,24,EL
9321b8ed,1,90,1.0,1,1,0,7,5,1,4,1.6,0.5,1.2,24,EL
9328b835,7,630,7.0,7,7,0,0,14,3,11,10.6,5.6,5.0,24,EL
934e1968,5,217,2.4,1,1,4,3,13,3,10,6.5,1.6,4.9,24,EL
93508980,1,14,0.2,0,0,1,1,1,1,0,0.3,0.2,0.0,24,EL
938d8a55,1,90,1.0,1,1,0,3,4,0,4,2.7,2.3,0.3,24,EL
939c6319,1,90,1.0,1,1,0,5,3,2,1,1.3,2.7,-1.4,24,EL
93c8e934,3,127,1.4,1,0,2,1,3,1,2,2.1,1.6,0.5,24,EL
944ae938,2,169,1.9,2,1,0,3,2,4,-2,1.2,5.0,-3.8,24,EL
94721522,2,180,2.0,2,2,0,0,2,3,-1,1.9,4.0,-2.1,24,EL
947e036f,1,29,0.3,0,0,1,1,0,3,-3,0.0,0.9,-0.9,24,EL
953597a1,2,101,1.1,1,1,1,8,3,1,2,2.5,1.1,1.4,24,EL
9574709a,1,6,0.1,0,0,1,1,0,0,0,0.1,0.1,0.0,24,EL
958ede06,5,450,5.0,5,5,0,0,4,7,-3,8.8,6.9,1.9,24,EL
96094cbc,2,69,0.8,1,0,1,0,1,1,0,1.0,0.8,0.2,24,EL
963829d0,5,371,4.1,5,0,0,3,4,3,1,4.6,4.0,0.6,24,EL
967f34d3,1,90,1.0,1,1,0,9,3,1,2,3.0,1.0,2.1,24,EL
97e996a7,5,405,4.5,4,4,1,2,6,5,1,5.8,5.6,0.3,24,EL
9866afec,10,901,10.0,10,8,0,0,17,18,-1,12.7,19.3,-6.6,24,EL
98e0d76c,1,1,0.0,0,0,1,1,0,0,0,0.0,0.1,-0.1,24,EL
99351886,6,540,6.0,6,6,0,0,5,8,-3,10.0,8.3,1.7,24,EL
99549c4b,5,129,1.4,1,0,4,1,0,2,-2,1.9,2.1,-0.2,24,EL
99813635,2,69,0.8,1,0,1,4,2,0,2,0.6,0.2,0.4,24,EL
99d660b2,3,44,0.5,0,0,3,0,0,0,0,0.3,1.0,-0.7,24,EL
9a36ffe4,5,392,4.4,5,1,0,1,5,7,-2,6.9,7.1,-0.2,24,EL
9b5237b1,2,81,0.9,1,0,1,0,0,0,0,0.6,1.6,-1.0,24,EL
9b6f7fd5,8,608,6.8,7,2,1,0,13,3,10,9.8,5.7,4.0,24,EL
9bdb6d1b,5,166,1.8,1,0,4,1,6,6,0,3.0,3.7,-0.7,24,EL
9bf914b4,3,123,1.4,1,1,2,1,3,1,2,4.1,0.7,3.4,24,EL
9c145144,4,195,2.2,2,0,2,0,2,2,0,2.6,1.9,0.6,24,EL
9c74fa25,6,540,6.0,6,6,0,0,4,9,-5,5.6,9.4,-3.9,24,EL
9cfbad36,2,97,1.1,2,0,0,0,1,2,-1,0.8,1.9,-1.1,24,EL
9d152938,6,197,2.2,2,1,4,0,3,9,-6,1.5,7.6,-6.2,24,EL
9d689a5b,6,247,2.7,3,0,3,0,7,6,1,4.3,3.8,0.5,24,EL
9d7d5334,2,157,1.7,2,1,0,0,2,4,-2,2.8,3.0,-0.2,24,EL
9dc0fa97,3,150,1.7,2,1,1,1,0,3,-3,1.6,2.5,-0.9,24,EL
9e675199,2,11,0.1,0,0,2,4,0,0,0,0.4,0.3,0.2,24,EL
9e7483ff,6,346,3.8,4,1,2,2,7,6,1,6.4,5.0,1.4,24,EL
9f69eb8f,3,23,0.3,0,0,3,3,1,0,1,0.0,0.0,0.0,24,EL
9f84febe,7,419,4.7,4,2,3,3,7,5,2,7.1,4.6,2.4,24,EL
a08985b8,2,166,1.8,2,1,0,0,1,1,0,2.5,3.8,-1.3,24,EL
a09829d7,1,5,0.1,0,0,1,2,1,0,1,0.2,0.0,0.1,24,EL
a0b4bb3e,6,363,4.0,3,2,3,0,8,7,1,6.4,6.1,0.3,24,EL
a111cf41,7,630,7.0,7,7,0,0,11,6,5,13.3,7.5,5.8,24,EL
a1232f4e,2,140,1.6,2,1,0,0,1,4,-3,1.2,3.5,-2.3,24,EL
a1390d2f,6,61,0.7,0,0,6,2,0,0,0,0.4,0.6,-0.2,24,EL
a1507cc7,5,357,4.0,5,1,0,0,2,5,-3,6.1,6.3,-0.2,24,EL
a17a94d6,2,108,1.2,1,0,1,0,1,4,-3,1.5,3.3,-1.8,24,EL
a1932f00,6,333,3.7,3,1,3,0,1,5,-4,2.8,4.0,-1.2,24,EL
a26fb8aa,7,469,5.2,5,3,2,0,8,4,4,10.9,6.4,4.5,24,EL
a29b1131,5,433,4.8,5,3,0,0,7,12,-5,6.7,9.6,-3.0,24,EL
a2abe631,2,180,2.0,2,2,0,0,4,6,-2,2.2,4.0,-1.8,24,EL
a2d9cf74,2,52,0.6,0,0,2,1,2,0,2,2.2,1.1,1.1,24,EL
a31f54ca,3,209,2.3,2,2,1,2,0,3,-3,0.4,2.5,-2.1,24,EL
a3eabee0,6,370,4.1,4,3,2,0,7,8,-1,7.4,4.9,2.5,24,EL
a426a912,6,122,1.4,0,0,6,2,0,3,-3,2.4,2.5,-0.1,24,EL
a4564423,1,21,0.2,0,0,1,1,0,1,-1,0.5,0.4,0.1,24,EL
a4e85758,6,419,4.7,4,3,2,2,5,7,-2,7.3,6.9,0.4,24,EL
a55d8df5,5,369,4.1,4,4,1,1,7,3,4,6.8,3.3,3.5,24,EL
a5db0bec,8,396,4.4,6,0,2,2,7,2,5,5.3,3.1,2.2,24,EL
a62c16d0,7,432,4.8,5,3,2,1,8,6,2,6.9,5.5,1.4,24,EL
a63a995f,1,90,1.0,1,1,0,1,1,1,0,0.9,3.5,-2.5,24,EL
a650c75b,7,444,4.9,4,3,3,1,7,5,2,5.3,6.2,-1.0,24,EL
a6951bf8,4,185,2.1,2,0,2,0,3,5,-2,1.6,3.2,-1.6,24,EL
a6ee4f55,9,411,4.6,4,1,5,1,10,5,5,9.9,4.5,5.3,24,EL
a73c8f95,7,556,6.2,7,3,0,0,23,6,17,14.8,6.5,8.3,24,EL
a74ea18d,10,335,3.7,2,2,8,0,8,18,-10,5.8,10.3,-4.5,24,EL
a793f5a8,2,180,2.0,2,2,0,0,3,5,-2,2.5,2.8,-0.3,24,EL
a7bc6c2a,6,456,5.1,5,4,1,0,6,16,-10,4.5,9.0,-4.5,24,EL
a7d48b00,4,229,2.5,3,0,1,0,2,3,-1,4.4,3.5,0.9,24,EL
a8102ed1,2,135,1.5,2,1,0,0,1,5,-4,1.0,1.7,-0.7,24,EL
a820e429,3,195,2.2,2,0,1,1,2,3,-1,4.4,3.4,1.0,24,EL
a8327abd,3,34,0.4,0,0,3,2,0,1,-1,1.0,2.2,-1.2,24,EL
a8567629,5,152,1.7,2,0,3,2,1,2,-1,3.0,1.6,1.4,24,EL
a88c2e88,6,540,6.0,6,6,0,0,4,13,-9,6.1,9.3,-3.2,24,EL
a8fbae1d,2,180,2.0,2,1,0,0,4,4,0,3.1,3.2,-0.1,24,EL
a9202def,7,517,5.7,6,4,1,0,10,5,5,11.3,5.1,6.2,24,EL
a9aa0d1d,6,290,3.2,3,0,3,2,7,2,5,7.1,3.3,3.7,24,EL
aa04bee3,1,8,0.1,0,0,1,5,0,0,0,0.2,0.1,0.1,24,EL
aad56ca3,7,327,3.6,3,0,4,1,8,4,4,8.2,5.1,3.2,24,EL
aafb3d5b,2,143,1.6,2,1,0,2,0,5,-5,1.2,3.2,-2.0,24,EL
ab4b3e35,6,446,5.0,6,2,0,0,4,10,-6,6.2,7.3,-1.1,24,EL
abddf25d,1,66,0.7,1,0,0,4,1,1,0,0.6,0.7,-0.1,24,EL
ac05f970,4,142,1.6,1,0,3,1,8,0,8,3.6,1.0,2.6,24,EL
ac4003af,1,70,0.8,0,0,1,3,3,1,2,2.1,0.1,2.0,24,EL
aca0a525,6,359,4.0,5,1,1,0,4,6,-2,5.5,5.9,-0.4,24,EL
acf7e795,2,180,2.0,2,2,0,0,3,7,-4,0.8,4.5,-3.7,24,EL
ad1ffcfd,2,112,1.2,0,0,2,2,2,3,-1,2.2,1.5,0.7,24,EL
ad9b2747,6,481,5.3,6,4,0,0,9,11,-2,8.5,9.2,-0.7,24,EL
adc77724,2,128,1.4,1,0,1,0,4,6,-2,3.2,3.1,0.0,24,EL
adfbe1f5,2,171,1.9,2,1,0,0,3,5,-2,2.5,2.8,-0.3,24,EL
ae1159bf,10,739,8.2,9,4,1,0,10,11,-1,11.6,9.9,1.8,24,EL
ae3e6d85,2,57,0.6,0,0,2,2,1,0,1,1.6,0.2,1.4,24,EL
ae94a6c5,9,606,6.7,7,3,2,0,12,5,7,8.9,6.4,2.5,24,EL
ae961785,3,54,0.6,0,0,3,1,0,2,-2,0.1,1.0,-0.9,24,EL
ae9898c5,5,422,4.7,5,4,0,1,8,4,4,9.3,5.1,4.2,24,EL
aee634bf,2,166,1.8,2,1,0,0,2,4,-2,2.2,2.5,-0.3,24,EL
af0d79a9,5,380,4.2,4,3,1,1,8,9,-1,7.2,6.6,0.6,24,EL
afb61630,4,275,3.1,3,2,1,0,8,6,2,5.8,4.3,1.5,24,EL
afcac9da,5,396,4.4,5,3,0,0,4,10,-6,2.1,8.8,-6.6,24,EL
b003239d,3,270,3.0,3,3,0,5,8,4,4,4.3,4.1,0.2,24,EL
b026bbf6,5,361,4.0,4,4,1,1,10,4,6,5.4,5.0,0.5,24,EL
b05f4787,1,13,0.1,0,0,1,1,0,0,0,0.1,0.0,0.1,24,EL
b060e3b8,6,446,5.0,6,3,0,0,3,9,-6,6.1,9.9,-3.8,24,EL
b146275b,5,274,3.0,4,1,1,1,11,2,9,8.1,2.9,5.2,24,EL
b1bfd1d4,6,433,4.8,5,1,1,0,10,13,-3,6.3,6.9,-0.6,24,EL
b1e61f23,6,530,5.9,6,5,0,0,3,16,-13,7.2,9.3,-2.1,24,EL
b1f4086c,7,433,4.8,4,3,3,1,17,6,11,11.3,5.4,5.9,24,EL
b217ef29,3,189,2.1,2,2,1,2,8,4,4,4.3,2.1,2.2,24,EL
b2bc3b1f,2,36,0.4,0,0,2,0,1,3,-2,0.2,1.4,-1.2,24,EL
b330c3b5,3,194,2.2,3,1,0,0,4,4,0,2.9,2.5,0.4,24,EL
b3dcc2cf,10,821,9.1,10,7,0,0,16,20,-4,12.1,14.6,-2.5,24,EL
b494cc0e,4,244,2.7,3,1,1,2,3,2,1,0.0,0.0,0.0,24,EL
b4ef3fb5,4,302,3.4,4,2,0,4,5,6,-1,6.4,4.4,2.0,24,EL
b51b1b9c,3,259,2.9,3,2,0,1,8,4,4,6.4,4.1,2.3,24,EL
b558534d,3,67,0.7,0,0,3,1,3,1,2,1.0,1.6,-0.6,24,EL
b582ff63,6,471,5.2,6,2,0,0,6,9,-3,5.9,7.7,-1.8,24,EL
b5b9bde7,3,71,0.8,0,0,3,4,2,0,2,1.7,0.3,1.4,24,EL
b62878a5,7,590,6.6,7,2,0,0,13,5,8,10.3,5.3,5.0,24,EL
b686f4c0,5,271,3.0,3,0,2,0,7,7,0,3.8,5.2,-1.5,24,EL
b6a6e0a7,5,302,3.4,3,2,2,0,3,8,-5,4.7,9.1,-4.4,24,EL
b6b6bfc4,9,810,9.0,9,9,0,1,16,20,-4,12.1,13.7,-1.6,24,EL
b6ca3ab3,6,427,4.7,5,2,1,0,4,8,-4,5.4,6.5,-1.1,24,EL
b70afb45,8,653,7.3,8,1,0,0,8,8,0,7.2,12.8,-5.6,24,EL
b742cc0d,1,90,1.0,1,1,0,0,0,1,-1,0.8,2.0,-1.2,24,EL
b79d8e93,5,417,4.6,4,3,1,1,1,8,-7,5.5,11.4,-5.9,24,EL
b7b27de0,6,460,5.1,6,1,0,0,3,15,-12,6.3,8.6,-2.3,24,EL
b7bf9318,7,67,0.7,0,0,7,3,1,6,-5,0.5,4.2,-3.7,24,EL
b7d8cbb9,6,385,4.3,5,2,1,0,4,9,-5,2.0,8.4,-6.4,24,EL
b7de5bad,2,137,1.5,2,0,0,0,1,4,-3,1.9,2.9,-1.1,24,EL
b8103669,6,437,4.9,5,3,1,0,3,9,-6,6.8,9.4,-2.6,24,EL
b8a642fc,2,58,0.6,0,0,2,1,0,2,-2,0.3,1.1,-0.8,24,EL
b8bd60fe,5,406,4.5,5,3,0,3,5,8,-3,6.9,6.8,0.2,24,EL
b8e740fb,5,346,3.8,4,0,1,0,10,2,8,10.2,2.5,7.6,24,EL
b90c4a43,4,360,4.0,4,4,0,2,6,9,-3,5.0,6.0,-1.0,24,EL
b9392438,6,413,4.6,6,1,0,0,3,7,-4,4.7,8.1,-3.3,24,EL
b9ae8560,5,415,4.6,5,2,0,1,5,6,-1,5.0,7.8,-2.8,24,EL
b9e1436c,8,675,7.5,7,7,1,0,24,8,16,16.9,7.4,9.5,24,EL
ba26440f,5,149,1.7,1,0,4,2,3,3,0,2.6,2.2,0.4,24,EL
badcdcae,4,63,0.7,0,0,4,1,1,1,0,1.3,1.0,0.3,24,EL
baeac12a,1,3,0.0,0,0,1,2,0,0,0,0.0,0.5,-0.5,24,EL
bafcf742,4,274,3.0,4,0,0,2,4,4,0,3.4,5.0,-1.6,24,EL
bb5fbd2b,2,165,1.8,2,1,0,0,3,5,-2,3.8,2.6,1.3,24,EL
bba30585,9,607,6.7,7,4,2,0,9,6,3,7.9,6.4,1.4,24,EL
bbd67769,4,234,2.6,2,2,2,0,10,4,6,4.9,3.4,1.4,24,EL
bc647827,7,559,6.2,6,6,1,1,13,16,-3,7.2,10.9,-3.7,24,EL
bc67a0e1,7,630,7.0,7,7,0,1,19,6,13,15.9,7.7,8.2,24,EL
bcf5058a,10,930,10.3,10,10,0,0,18,7,11,14.4,9.2,5.2,24,EL
bd142efb,6,497,5.5,6,4,0,2,14,3,11,10.6,5.3,5.3,24,EL
bd2f622a,5,145,1.6,1,0,4,1,2,2,0,3.4,3.6,-0.2,24,EL
bd5eb2e5,1,25,0.3,1,0,0,0,0,0,0,0.1,0.1,0.1,24,EL
bde35051,6,540,6.0,6,6,0,0,10,13,-3,9.4,10.6,-1.2,24,EL
be47b750,2,210,2.3,2,2,0,0,5,6,-1,4.2,3.5,0.8,24,EL
be692b64,3,270,3.0,3,3,0,3,2,4,-2,2.2,3.8,-1.6,24,EL
be765073,8,720,8.0,8,8,0,0,10,9,1,9.6,12.2,-2.5,24,EL
be837003,7,268,3.0,3,0,4,1,8,3,5,6.5,2.6,3.9,24,EL
beb391dd,5,58,0.6,0,0,5,1,2,0,2,1.1,0.7,0.4,24,EL
beb882a8,10,869,9.7,10,7,0,0,21,14,7,16.6,11.2,5.4,24,EL
bece776f,2,61,0.7,1,0,1,0,2,1,1,1.8,0.9,0.9,24,EL
bed68338,6,384,4.3,5,1,1,0,6,5,1,6.4,5.2,1.2,24,EL
bf075f6b,9,610,6.8,8,2,1,0,7,14,-7,10.3,9.8,0.4,24,EL
bf356094,1,60,0.7,1,0,0,1,1,3,-2,0.2,1.6,-1.4,24,EL
bf4c41f9,6,303,3.4,4,1,2,1,6,7,-1,6.2,6.6,-0.5,24,EL
bf973eeb,3,63,0.7,0,0,3,2,3,0,3,1.9,0.1,1.8,24,EL
bfb2056e,7,629,7.0,7,6,0,0,8,11,-3,7.6,13.3,-5.7,24,EL
bfdb33aa,8,341,3.8,3,2,5,0,11,6,5,8.9,5.5,3.5,24,EL
c0295327,2,105,1.2,1,0,1,0,1,0,1,1.2,0.9,0.4,24,EL
c0eeaa39,5,290,3.2,4,0,1,0,1,10,-9,2.4,6.1,-3.8,24,EL
c149016b,8,510,5.7,8,3,0,0,21,7,14,15.1,6.0,9.1,24,EL
c2357b65,7,309,3.4,3,1,4,1,6,3,3,6.3,4.7,1.6,24,EL
c235e803,10,810,9.0,9,8,1,0,18,12,6,15.3,11.7,3.6999999999999997,24,EL
c24014d7,1,18,0.2,0,0,1,1,0,0,0,0.6,0.0,0.6,24,EL
c275947b,9,473,5.3,6,2,3,0,11,5,6,11.2,4.9,6.3,24,EL
c283ddef,6,422,4.7,5,2,1,0,7,6,1,5.5,7.2,-1.7,24,EL
c2a15a27,4,360,4.0,4,4,0,0,5,3,2,8.8,4.4,4.4,24,EL
c2a6033c,1,39,0.4,1,0,0,0,0,0,0,0.0,0.4,-0.4,24,EL
c2bd8585,4,153,1.7,1,0,3,2,3,2,1,1.8,2.7,-0.8,24,EL
c3cf087d,2,112,1.2,1,0,1,0,1,0,1,1.2,0.9,0.4,24,EL
c402fb6a,6,540,6.0,6,6,0,0,6,12,-6,7.5,11.6,-4.1,24,EL
c40b6180,1,6,0.1,0,0,1,5,0,0,0,0.0,0.0,0.0,24,EL
c43a8336,2,69,0.8,0,0,2,5,0,0,0,1.9,1.5,0.4,24,EL
c4a5b4f6,1,45,0.5,1,0,0,5,0,2,-2,0.2,1.0,-0.8,24,EL
c56dc39e,4,297,3.3,3,2,1,2,5,3,2,7.7,3.8,3.8,24,EL
c5cbbcff,4,330,3.7,4,2,0,1,7,8,-1,5.2,6.7,-1.4,24,EL
c63f6e46,2,34,0.4,0,0,2,4,1,0,1,1.0,0.0,1.0,24,EL
c678ddd7,3,190,2.1,3,1,0,4,4,3,1,1.8,4.6,-2.9,24,EL
c6f0d5d4,7,379,4.3,4,1,3,1,5,8,-3,4.1000000000000005,7.2,-3.0999999999999996,24,EL
c7069d87,6,316,3.5,3,2,3,0,3,4,-1,5.1,6.0,-0.9,24,EL
c75f04f4,1,7,0.1,0,0,1,5,1,1,0,0.3,0.8,-0.5,24,EL
c762b1a6,2,151,1.7,1,1,1,0,1,1,0,1.4,1.1,0.3,24,EL
c84dcc88,1,18,0.2,0,0,1,6,1,0,1,0.6,0.0,0.6,24,EL
c8ccc39e,2,120,1.3,1,1,1,0,2,3,-1,1.4,3.4,-1.9,24,EL
c9009a1f,6,540,6.0,6,6,0,2,8,6,2,7.7,8.2,-0.4,24,EL
ca607d59,3,69,0.8,0,0,3,1,1,1,0,1.7,1.5,0.2,24,EL
ca618d23,10,743,8.3,8,1,2,0,17,9,8,14.1,7.6,6.5,24,EL
cad3fd4d,6,220,2.4,2,0,4,2,6,2,4,4.6,1.2,3.4,24,EL
caf6cc9b,6,120,1.3,0,0,6,0,3,5,-2,1.8,4.1,-2.3,24,EL
cc704d9c,2,84,0.9,1,0,1,0,2,3,-1,0.0,0.0,0.0,24,EL
cc70a1d5,8,720,8.0,8,8,0,0,10,9,1,9.6,12.2,-2.5,24,EL
ccbbe661,5,181,2.0,1,0,4,0,2,4,-2,3.7,6.0,-2.3,24,EL
ccd38335,3,191,2.1,2,1,1,0,3,2,1,3.3,2.1,1.3,24,EL
cce181df,9,707,7.9,8,7,1,0,21,14,7,17.5,11.0,6.5,24,EL
cd1acf9d,4,207,2.3,2,0,2,0,8,3,5,6.5,2.5,3.9,24,EL
ce129ae6,1,14,0.2,0,0,1,0,0,0,0,0.2,0.2,0.0,24,EL
ce4246f5,2,180,2.0,2,2,0,5,5,1,4,3.6,1.8,1.8,24,EL
ce5143da,4,255,2.8,3,1,1,0,2,7,-5,4.1,5.4,-1.3,24,EL
cea59f02,2,58,0.6,0,0,2,0,1,1,0,1.5,1.8,-0.4,24,EL
cf043a33,2,33,0.4,0,0,2,2,0,1,-1,0.0,0.8,-0.7,24,EL
cf134113,3,270,3.0,3,3,0,5,4,0,4,3.7,2.6,1.1,24,EL
cfdacb90,5,215,2.4,3,1,2,1,2,2,0,3.1,4.6,-1.5,24,EL
d01bbb6f,10,795,8.8,8,5,2,0,18,13,5,14.4,10.9,3.5,24,EL
d1046335,5,419,4.7,5,3,0,1,3,12,-9,2.8,8.2,-5.4,24,EL
d1562e2e,5,434,4.8,5,3,0,0,1,12,-11,4.0,7.5,-3.5,24,EL
d17ce930,2,122,1.4,1,1,1,0,2,3,-1,0.8,3.2,-2.3,24,EL
d1fea02e,5,450,5.0,5,5,0,1,3,16,-13,6.6,8.9,-2.3,24,EL
d27a449b,6,399,4.4,4,4,2,0,3,16,-13,2.6,10.3,-7.7,24,EL
d2c580ce,2,91,1.0,1,1,1,3,0,0,0,1.6,0.6,1.1,24,EL
d38fdf53,4,178,2.0,2,1,2,0,3,3,0,3.4,1.6,1.8,24,EL
d3aaad90,9,587,6.5,7,1,2,1,15,3,12,9.7,4.4,5.3,24,EL
d4232ba9,2,64,0.7,1,0,1,2,1,0,1,0.9,0.1,0.8,24,EL
d4456fb3,10,622,6.9,8,1,2,0,9,9,0,9.5,8.4,1.1,24,EL
d4c9725f,4,360,4.0,4,4,0,0,12,6,6,8.8,4.6,4.2,24,EL
d51bd6c5,10,786,8.7,10,1,0,0,14,10,4,10.8,12.8,-2.0,24,EL
d52b2a9f,2,6,0.1,0,0,2,2,0,2,-2,0.0,0.0,0.0,24,EL
d5dd5f1f,9,636,7.1,7,1,2,0,19,12,7,14.2,9.6,4.6,24,EL
d68e3575,1,10,0.1,0,0,1,3,0,1,-1,0.2,0.5,-0.3,24,EL
d697a2d0,4,101,1.1,1,0,3,2,0,4,-4,0.8,2.2,-1.4,24,EL
d705ba44,6,271,3.0,3,1,3,0,6,1,5,5.7,2.6,3.1,24,EL
d7547531,2,20,0.2,0,0,2,2,1,1,0,0.6,1.4,-0.8,24,EL
d7556379,3,200,2.2,3,1,0,0,1,8,-7,1.4,4.7,-3.3,24,EL
d7abc42e,5,400,4.4,4,3,1,0,4,11,-7,2.2,10.9,-8.7,24,EL
d874b374,2,180,2.0,2,2,0,0,3,5,-2,2.5,2.8,-0.3,24,EL
d87e2cae,5,134,1.5,1,0,4,1,1,1,0,1.9,1.7,0.3,24,EL
d97cccc9,3,114,1.3,1,1,2,1,2,1,1,1.4,1.1,0.4,24,EL
da27e268,6,540,6.0,6,6,0,0,9,7,2,9.1,6.7,2.3,24,EL
da7b447d,2,180,2.0,2,2,0,0,4,6,-2,2.2,4.0,-1.8,24,EL
da7f2781,4,275,3.1,3,3,1,2,4,4,0,3.9,4.4,-0.5,24,EL
da84230f,1,31,0.3,0,0,1,4,0,0,0,0.1,0.1,0.0,24,EL
da887ea1,1,14,0.2,0,0,1,6,0,0,0,0.0,0.3,-0.3,24,EL
dac2bed8,1,1,0.0,0,0,1,1,1,0,1,0.1,0.6,-0.5,24,EL
dacd983e,2,25,0.3,0,0,2,1,1,0,1,0.9,0.3,0.6,24,EL
dad4b285,6,377,4.2,4,4,2,2,7,2,5,6.3,3.7,2.5,24,EL
db092d3b,3,86,1.0,1,0,2,1,3,2,1,3.1,2.3,0.7,24,EL
db3164e1,1,90,1.0,1,1,0,7,3,1,2,2.1,1.6,0.5,24,EL
db4ed67b,4,158,1.8,2,0,2,2,3,2,1,2.2,1.7,0.5,24,EL
dba1f190,4,170,1.9,2,1,2,0,0,2,-2,1.1,3.5,-2.4,24,EL
dbd1b101,10,930,10.3,10,10,0,0,21,14,7,17.3,11.5,5.7,24,EL
dcb38abe,7,386,4.3,5,1,2,1,5,7,-2,3.4,8.7,-5.3,24,EL
dcef222b,1,25,0.3,0,0,1,3,1,0,1,0.0,0.0,0.0,24,EL
dcfb17f4,8,625,6.9,7,5,1,0,20,6,14,14.3,7.2,7.1,24,EL
dd676a97,8,321,3.6,2,1,6,0,11,1,10,8.7,2.5,6.2,24,EL
dd95af65,2,173,1.9,2,1,0,0,3,5,-2,2.5,2.8,-0.3,24,EL
de8f6250,2,155,1.7,1,1,1,0,4,4,0,2.6,1.6,1.1,24,EL
dee86451,4,308,3.4,4,1,0,0,8,5,3,6.5,3.5,3.1,24,EL
df10e27c,8,595,6.6,6,0,2,0,10,7,3,10.3,7.3,3.1,24,EL
df8d6029,8,641,7.1,7,7,1,0,14,10,4,12.0,9.2,2.8,24,EL
dff153a4,9,682,7.6,6,4,3,1,14,6,8,11.6,6.5,5.1,24,EL
e03c2d97,7,559,6.2,7,6,0,0,16,6,10,10.1,5.0,5.1,24,EL
e06683ca,3,156,1.7,1,1,2,3,5,1,4,4.0,0.4,3.6,24,EL
e0921a4f,6,391,4.3,4,0,2,2,8,4,4,6.7,3.7,2.9,24,EL
e095928e,1,9,0.1,0,0,1,1,0,0,0,0.0,0.0,0.0,24,EL
e0b113a7,8,643,7.1,7,7,1,0,20,7,13,14.5,7.8,6.7,24,EL
e0bc6fdc,7,414,4.6,4,3,3,0,8,3,5,7.4,3.3,4.1,24,EL
e0ee850b,2,180,2.0,2,2,0,0,4,4,0,4.4,4.6,-0.2,24,EL
e0fbd23c,1,90,1.0,1,1,0,1,4,0,4,2.7,2.3,0.3,24,EL
e134351a,1,9,0.1,0,0,1,3,1,0,1,0.2,0.0,0.1,24,EL
e134b9f9,6,373,4.1,4,1,2,0,1,12,-11,5.4,7.5,-2.1,24,EL
e1ba3d5a,2,57,0.6,0,0,2,4,0,3,-3,0.8,3.2,-2.4,24,EL
e1ceafce,6,540,6.0,6,6,0,0,7,10,-3,9.5,8.9,0.6,24,EL
e288d4b3,3,202,2.2,3,0,0,0,8,4,4,5.5,3.7,1.8,24,EL
e2b384d2,6,188,2.1,1,1,5,0,4,4,0,4.0,3.5,0.5,24,EL
e342ad68,7,290,3.2,3,1,4,0,15,3,12,10.4,1.7,8.7,24,EL
e358587b,7,630,7.0,7,7,0,0,9,11,-2,8.8,10.5,-1.7,24,EL
e4a47bec,6,387,4.3,5,0,1,0,6,9,-3,6.8,5.1,1.7,24,EL
e53b5534,1,61,0.7,1,0,0,0,2,1,1,0.8,1.2,-0.3,24,EL
e599253a,6,201,2.2,1,1,5,2,4,1,3,5.5,5.2,0.3,24,EL
e5d01ecf,4,289,3.2,3,2,1,4,3,2,1,2.0,4.3,-2.3,24,EL
e5d553a8,6,494,5.5,6,3,0,0,6,15,-9,0.0,0.0,0.0,24,EL
e61b8aee,6,441,4.9,5,3,1,2,17,4,13,13.8,4.6,9.2,24,EL
e6679c22,1,6,0.1,0,0,1,1,0,0,0,0.0,0.1,-0.1,24,EL
e66c698a,9,250,2.8,2,2,7,1,5,9,-4,3.6,7.2,-3.7,24,EL
e66e4ddc,3,113,1.3,1,0,2,7,2,1,1,1.9,1.8,0.1,24,EL
e6bc67d7,2,180,2.0,2,2,0,0,3,5,-2,2.1,4.6,-2.5,24,EL
e75129bd,2,77,0.9,0,0,2,3,3,1,2,1.2,0.9,0.3,24,EL
e76cb9cc,9,810,9.0,9,9,0,1,22,14,8,18.6,14.3,4.4,24,EL
e7aa9d7c,2,179,2.0,2,1,0,0,2,3,-1,1.9,4.0,-2.1,24,EL
e7d59f4f,10,809,9.0,9,3,1,0,23,14,9,17.9,13.4,4.5,24,EL
e7fcf289,6,360,4.0,4,1,2,1,15,4,11,12.4,3.6,8.9,24,EL
e82adcab,4,239,2.7,2,1,2,2,7,4,3,6.2,3.2,3.0,24,EL
e83d5f45,2,120,1.3,1,1,1,0,1,1,0,1.2,3.5,-2.3,24,EL
e8832875,6,435,4.8,5,1,1,0,9,2,7,8.1,3.1,5.0,24,EL
e92cd3f7,5,366,4.1,4,2,1,1,8,4,4,7.9,6.1,1.9,24,EL
e935dbbf,6,513,5.7,6,3,0,0,6,11,-5,7.7,12.2,-4.5,24,EL
e95b4604,8,654,7.3,8,3,0,0,18,11,7,11.3,7.2,4.0,24,EL
e97fd090,4,244,2.7,3,0,1,0,9,3,6,5.7,2.0,3.6,24,EL
e98211e7,2,163,1.8,2,1,0,4,1,0,1,2.0,2.0,0.1,24,EL
e9a12436,3,170,1.9,2,0,1,0,0,2,-2,2.1,4.0,-1.9,24,EL
e9b0ccaf,3,182,2.0,2,0,1,1,1,3,-2,1.7,3.2,-1.5,24,EL
e9e41fd0,5,421,4.7,5,4,0,0,1,14,-13,4.8,8.9,-4.0,24,EL
ea83bfa6,4,360,4.0,4,4,0,0,5,5,0,6.0,3.8,2.2,24,EL
ead61f73,3,142,1.6,2,1,1,3,3,4,-1,2.3,2.0,0.3,24,EL
eadc8e4f,10,705,7.8,9,6,1,0,15,19,-4,9.8,12.9,-3.1,24,EL
eb0db257,10,674,7.5,8,3,2,0,16,13,3,10.6,9.6,1.0,24,EL
eb2fe5b6,5,268,3.0,3,0,2,1,6,1,5,7.3,3.0,4.2,24,EL
eb3022c3,6,384,4.3,5,1,1,0,9,10,-1,7.9,7.9,0.0,24,EL
eb49bd3f,3,225,2.5,2,2,1,2,6,4,2,2.5,3.6,-1.2,24,EL
eb6fac77,2,130,1.4,2,1,0,0,0,3,-3,0.5,2.7,-2.2,24,EL
eb7822d7,6,436,4.8,5,2,1,0,12,5,7,8.3,6.5,1.8,24,EL
ebadcb80,5,145,1.6,1,0,4,1,3,3,0,3.7,2.9,0.8,24,EL
ec11ecf8,6,397,4.4,5,1,1,0,3,13,-10,4.0,8.3,-4.3,24,EL
eca17cf2,2,180,2.0,2,2,0,0,3,7,-4,0.8,4.5,-3.7,24,EL
eccbe56a,5,187,2.1,1,0,4,0,4,4,0,4.9,4.0,1.0,24,EL
eccf6574,4,231,2.6,2,0,2,1,4,6,-2,3.1,2.9,0.2,24,EL
ed45a7d7,1,19,0.2,0,0,1,1,1,1,0,0.3,0.2,0.1,24,EL
ed45c4a5,3,270,3.0,3,3,0,0,8,6,2,6.7,5.9,0.8,24,EL
ed55b838,6,197,2.2,2,0,4,2,2,4,-2,2.0,3.8,-1.9,24,EL
ed9f7cfe,6,411,4.6,5,2,1,0,11,8,3,9.5,8.1,1.4,24,EL
edeb21ff,5,379,4.2,4,3,1,1,3,6,-3,5.3,7.5,-2.2,24,EL
ee3519f5,2,152,1.7,2,0,0,0,2,4,-2,2.2,2.5,-0.4,24,EL
ee3c4b3f,1,1,0.0,0,0,1,1,1,0,1,0.1,0.6,-0.6,24,EL
ef233486,2,120,1.3,2,0,0,0,1,4,-3,0.3,3.5,-3.2,24,EL
ef322658,5,274,3.0,3,1,2,1,4,4,0,4.0,2.8,1.2,24,EL
ef3909cd,2,210,2.3,2,2,0,0,5,6,-1,4.2,3.5,0.8,24,EL
f0021247,3,149,1.7,2,1,1,1,0,0,0,2.9,2.2,0.7,24,EL
f05b0000,1,6,0.1,0,0,1,9,0,1,-1,0.0,0.9,-0.9,24,EL
f0677ed7,4,293,3.3,3,3,1,0,5,3,2,7.4,2.5,5.0,24,EL
f07a0fe5,5,450,5.0,5,5,0,1,3,9,-6,5.4,9.3,-3.8,24,EL
f0e4c69e,6,540,6.0,6,6,0,0,4,9,-5,5.6,9.4,-3.9,24,EL
f0e59e3a,5,87,1.0,0,0,5,0,2,0,2,1.8,2.7,-0.9,24,EL
f17aa65c,6,540,6.0,6,6,0,0,12,12,0,8.5,9.5,-1.0,24,EL
f1e94cd6,7,476,5.3,7,2,0,1,15,4,11,8.7,4.9,3.8,24,EL
f28659fb,2,144,1.6,2,0,0,0,3,3,0,2.0,2.6,-0.6,24,EL
f2e3b81c,6,540,6.0,6,6,0,0,6,12,-6,7.5,11.6,-4.1,24,EL
f315ca93,5,351,3.9,4,2,1,3,10,2,8,10.0,2.2,7.8,24,EL
f3187250,1,16,0.2,0,0,1,1,0,1,-1,0.0,0.1,-0.1,24,EL
f36016a5,3,114,1.3,1,0,2,2,2,2,0,3.3,2.5,0.8,24,EL
f360f047,2,15,0.2,0,0,2,4,0,0,0,0.0,0.6,-0.6,24,EL
f36c432f,4,114,1.3,1,0,3,1,1,3,-2,1.3,1.9,-0.6,24,EL
f36d5624,3,102,1.1,1,0,2,1,2,2,0,2.1,1.0,1.2,24,EL
f3e2f544,5,371,4.1,5,4,0,0,1,8,-7,5.9,8.6,-2.8,24,EL
f3e82e37,6,540,6.0,6,6,0,2,17,4,13,11.6,3.0,8.6,24,EL
f40dd3c7,2,147,1.6,2,0,0,0,2,2,0,1.7,1.9,-0.2,24,EL
f47a530a,6,386,4.3,4,4,2,0,5,7,-2,7.6,6.8,0.8,24,EL
f4e433d4,4,276,3.1,3,2,1,0,4,7,-3,5.6,5.4,0.2,24,EL
f521b80a,9,755,8.4,8,8,1,0,20,12,8,13.8,10.4,3.4,24,EL
f582d5c1,2,5,0.1,0,0,2,4,0,0,0,0.0,0.5,-0.5,24,EL
f5a00fa4,2,157,1.7,2,1,0,0,2,4,-2,2.8,3.0,-0.2,24,EL
f620b04f,2,10,0.1,0,0,2,0,1,0,1,0.3,0.0,0.3,24,EL
f63d8a4b,4,184,2.0,3,0,1,0,2,1,1,1.3,3.2,-1.9,24,EL
f648b2e1,2,91,1.0,1,1,1,4,1,1,0,1.9,2.5,-0.6,24,EL
f6d6a31a,2,149,1.7,2,0,0,2,0,5,-5,0.0,0.0,0.0,24,EL
f6e8ee38,5,142,1.6,2,0,3,1,1,6,-5,1.6,2.4,-0.8,24,EL
f754c59e,5,234,2.6,2,1,3,0,2,2,0,2.2,4.5,-2.4,24,EL
f7b10c66,2,180,2.0,2,2,0,0,2,4,-2,1.4,5.2,-3.7,24,EL
f80d03ca,6,207,2.3,2,0,4,4,2,5,-3,5.0,2.0,3.0,24,EL
f820504e,4,360,4.0,4,4,0,2,3,7,-4,6.4,6.9,-0.5,24,EL
f86fe8c1,7,484,5.4,6,3,1,1,7,8,-1,5.0,9.9,-4.9,24,EL
f874dd44,3,177,2.0,2,1,1,3,2,4,-2,2.3,4.0,-1.7,24,EL
f8766ef9,6,540,6.0,6,6,0,0,5,8,-3,10.0,8.3,1.7,24,EL
f882b0a1,1,15,0.2,0,0,1,1,1,0,1,0.8,0.0,0.8,24,EL
f9b1b7bf,1,5,0.1,0,0,1,0,0,0,0,0.1,0.0,0.1,24,EL
fa18b6cc,8,219,2.4,1,0,7,2,2,5,-3,2.8,3.4,-0.6,24,EL
fa462ff0,6,540,6.0,6,6,0,0,3,10,-7,0.0,0.0,0.0,24,EL
fb140eb4,5,390,4.3,5,1,0,0,4,11,-7,4.7,7.4,-2.7,24,EL
fbc471e8,3,75,0.8,0,0,3,3,0,2,-2,0.6,1.2,-0.6,24,EL
fbd6378b,5,405,4.5,5,4,0,0,6,7,-1,5.9,8.1,-2.2,24,EL
fc3697dd,2,119,1.3,2,0,0,0,1,3,-2,1.8,2.4,-0.7,24,EL
fc9b373e,5,297,3.3,4,0,1,0,3,6,-3,2.9,5.0,-2.1,24,EL
fcb38f57,4,290,3.2,4,3,0,0,9,5,4,6.7,4.5,2.2,24,EL
fcea4f04,1,9,0.1,0,0,1,1,0,0,0,0.0,0.0,0.0,24,EL
fceadb9b,6,496,5.5,6,3,0,0,5,15,-10,2.8,10.9,-8.0,24,EL
fd0a98c8,6,359,4.0,4,2,2,0,2,11,-9,5.5,5.0,0.5,24,EL
fd7383b8,6,540,6.0,6,6,0,0,7,13,-6,7.0,10.4,-3.3,24,EL
fdbde523,6,520,5.8,6,3,0,0,8,6,2,7.6,7.8,-0.2,24,EL
fde5fc24,2,37,0.4,0,0,2,4,1,1,0,0.9,0.5,0.4,24,EL
fdf3cb77,5,447,5.0,5,4,0,1,10,2,8,7.7,4.4,3.4,24,EL
fe0f9f6a,3,181,2.0,2,1,1,1,2,12,-10,1.7,6.0,-4.2,24,EL
fe192f45,6,358,4.0,5,1,1,0,6,7,-1,6.3,4.4,2.0,24,EL
fe784367,5,232,2.6,3,1,2,0,1,9,-8,0.7,5.5,-4.8,24,EL
fe91e603,2,75,0.8,0,0,2,2,1,1,0,0.9,1.3,-0.4,24,EL
fec5accc,5,288,3.2,3,1,2,0,4,10,-6,4.6,6.5,-1.9,24,EL
fef20ac5,8,732,8.1,8,6,0,0,12,13,-1,9.5,13.4,-3.9,24,EL
ff20acfe,2,135,1.5,1,1,1,0,1,2,-1,1.3,3.9,-2.7,24,EL
ff2fb007,2,90,1.0,1,0,1,2,1,0,1,2.5,0.7,1.8,24,EL
ff5ea0bf,3,85,0.9,0,0,3,1,0,1,-1,1.0,0.7,0.3,24,EL
0076ab7f,19,1560,17.3,18,15,1,2,25,24,1,18.0,24.9,-6.9,24,SPA
00b28772,29,2557,28.4,29,23,0,0,33,41,-8,33.2,40.5,-7.3,24,SPA
00eba9c9,17,592,6.6,7,1,10,3,4,6,-2,4.1,6.0,-1.9,24,SPA
0107757e,29,2610,29.0,29,29,0,1,43,52,-9,40.8,45.5,-4.7,24,SPA
0127419a,18,612,6.8,6,0,12,9,2,8,-6,8.4,7.9,0.5,24,SPA
0166a73e,30,2633,29.3,30,29,0,0,29,32,-3,25.6,41.5,-15.9,24,SPA
01bb93d5,4,23,0.3,0,0,4,8,1,1,0,0.4,0.8,-0.4,24,SPA
01da7812,29,2166,24.1,25,11,4,1,26,48,-22,25.7,37.9,-12.2,24,SPA
01eb744d,24,943,10.5,6,2,18,3,25,13,12,20.3,7.6,12.8,24,SPA
02319ad7,27,1325,14.7,17,4,10,1,22,23,-1,18.3,23.2,-4.8,24,SPA
02c15616,30,2015,22.4,23,13,7,0,39,28,11,35.0,25.3,9.8,24,SPA
02d2c436,9,723,8.0,8,8,1,0,6,13,-7,8.3,13.1,-4.8,24,SPA
02ef8778,22,1193,13.3,15,1,7,6,11,14,-3,12.2,14.8,-2.7,24,SPA
0302f7b4,2,15,0.2,0,0,2,4,0,0,0,0.6,0.7,-0.1,24,SPA
036bba5f,28,2414,26.8,28,21,0,0,21,33,-12,24.7,35.0,-10.4,24,SPA
047759a0,2,9,0.1,0,0,2,15,0,0,0,0.1,0.3,-0.2,24,SPA
04bb2b06,8,262,2.9,2,0,6,0,4,11,-7,4.2,6.2,-2.1,24,SPA
04e17fd5,25,1860,20.7,20,13,5,0,29,24,5,23.7,28.5,-4.8,24,SPA
04e531b6,21,592,6.6,4,0,17,8,10,9,1,9.5,10.9,-1.5,24,SPA
05439de2,14,1154,12.8,14,12,0,1,23,10,13,21.0,12.9,8.1,24,SPA
056269d7,30,2323,25.8,26,19,4,0,27,36,-9,32.5,37.7,-5.2,24,SPA
0630eb63,5,132,1.5,1,0,4,2,2,0,2,2.4,1.1,1.4,24,SPA
068f4dec,21,1091,12.1,12,2,9,8,17,13,4,14.9,11.6,3.3,24,SPA
06efa9dc,19,1675,18.6,19,18,0,1,17,36,-19,24.7,33.0,-8.3,24,SPA
070a3904,28,1727,19.2,17,8,11,0,15,23,-8,21.0,24.8,-3.8,24,SPA
075fe5a3,1,90,1.0,1,1,0,0,0,2,-2,1.4,2.1,-0.7,24,SPA
08511d65,20,1797,20.0,20,19,0,3,20,29,-9,21.6,28.4,-6.8,24,SPA
08593525,2,50,0.6,0,0,2,4,0,1,-1,0.1,1.8,-1.7,24,SPA
09507ffa,7,494,5.5,7,4,0,2,6,8,-2,5.2,8.8,-3.6,24,SPA
0959c2a2,30,2460,27.3,28,19,2,0,62,16,46,50.4,24.8,25.7,24,SPA
0a69de7b,16,1090,12.1,13,9,3,6,16,21,-5,11.2,17.3,-6.2,24,SPA
0abc51f2,23,1647,18.3,17,16,6,4,25,34,-9,25.7,29.9,-4.2,24,SPA
0ae4e09a,16,1045,11.6,14,2,2,1,12,11,1,11.2,14.8,-3.7,24,SPA
0af4dcf0,1,25,0.3,0,0,1,0,0,0,0,0.1,0.3,-0.2,24,SPA
0ba976e4,3,50,0.6,0,0,3,0,2,0,2,2.4,0.3,2.1,24,SPA
0c61c77c,15,792,8.8,9,3,6,1,14,12,2,11.9,12.4,-0.5,24,SPA
0cadc46d,22,1776,19.7,19,16,3,0,17,25,-8,21.7,26.9,-5.2,24,SPA
0cb29e91,10,157,1.7,0,0,10,10,0,3,-3,2.1,5.4,-3.3,24,SPA
0d9b2d31,16,1091,12.1,13,2,3,0,22,16,6,27.0,12.7,14.2,24,SPA
0e4fef6e,21,1461,16.2,18,8,3,8,15,23,-8,16.7,23.7,-7.0,24,SPA
0f26ffd7,15,1070,11.9,14,6,1,14,7,16,-9,13.6,15.2,-1.6,24,SPA
10072610,7,630,7.0,7,7,0,6,11,5,6,9.9,6.5,3.4,24,SPA
106c142c,16,381,4.2,2,0,14,7,7,4,3,4.5,5.5,-1.0,24,SPA
112521d1,26,1497,16.6,13,7,13,4,22,26,-4,18.4,24.6,-6.2,24,SPA
1137759d,20,870,9.7,12,0,8,0,17,11,6,13.0,11.9,1.0,24,SPA
114bbdee,21,1684,18.7,20,14,1,2,24,22,2,21.7,27.7,-6.0,24,SPA
11b9265b,22,1181,13.1,13,3,9,1,29,19,10,19.7,18.9,0.8,24,SPA
11fd2b75,21,1175,13.1,14,4,7,5,6,16,-10,14.6,13.4,1.2,24,SPA
1282939a,15,293,3.3,1,0,14,11,6,3,3,6.4,5.9,0.5,24,SPA
129af0db,27,1735,19.3,21,5,6,0,35,22,13,30.7,21.8,8.9,24,SPA
12c50af5,4,133,1.5,1,1,3,1,1,5,-4,0.9,4.4,-3.5,24,SPA
12c6cbef,15,1340,14.9,14,14,1,6,12,29,-17,15.9,24.6,-8.7,24,SPA
132ac341,18,1600,17.8,18,17,0,8,17,25,-8,22.4,21.6,0.8,24,SPA
133faa84,6,310,3.4,3,2,3,6,5,7,-2,4.8,5.8,-1.1,24,SPA
1545cf15,7,396,4.4,4,2,3,6,4,11,-7,3.8,9.1,-5.3,24,SPA
15d0c248,4,360,4.0,4,4,0,0,5,5,0,3.3,5.8,-2.5,24,SPA
162efffd,26,1580,17.6,19,3,7,0,29,19,10,29.7,18.5,11.2,24,SPA
1633fc8a,15,691,7.7,6,5,9,14,10,13,-3,11.6,12.5,-0.9,24,SPA
16aa3654,23,1791,19.9,21,11,2,3,31,19,12,25.7,20.5,5.2,24,SPA
174f09a6,29,2542,28.2,28,27,1,0,26,59,-33,28.7,47.4,-18.7,24,SPA
175ece4c,20,1184,13.2,12,8,8,10,19,16,3,15.1,15.1,0.1,24,SPA
184fe4b2,10,133,1.5,0,0,10,14,3,6,-3,2.8,4.9,-2.1,24,SPA
18abe173,6,407,4.5,4,4,2,3,3,6,-3,5.3,7.0,-1.7,24,SPA
18b896d6,26,2246,25.0,25,24,1,0,52,17,35,46.3,22.1,24.2,24,SPA
18f0a9f0,27,817,9.1,7,0,20,2,11,14,-3,11.1,14.7,-3.6,24,SPA
1944818c,28,1902,21.1,21,14,7,1,43,26,17,36.5,25.8,10.7,24,SPA
19709006,17,529,5.9,4,0,13,8,9,4,5,7.4,6.3,1.2,24,SPA
19b776e9,25,1263,14.0,13,1,12,2,6,17,-11,10.0,19.6,-9.6,24,SPA
19c36442,19,1528,17.0,17,13,2,0,21,27,-6,24.1,24.7,-0.6,24,SPA
19cae58d,12,944,10.5,10,9,2,0,22,11,11,22.7,10.9,11.9,24,SPA
1bacc518,19,1590,17.7,19,17,0,0,40,24,16,40.8,18.5,22.3,24,SPA
1bda5842,28,1051,11.7,9,1,19,2,27,13,14,21.6,11.600000000000001,10.0,24,SPA
1cb49278,22,1579,17.5,21,6,1,6,28,19,9,33.2,17.0,16.2,24,SPA
1ccd3dae,7,232,2.6,1,0,6,1,1,4,-3,2.5,3.9,-1.4,24,SPA
1d1691ad,4,110,1.2,3,0,1,11,0,0,0,0.3,1.2,-1.0,24,SPA
1e159d70,8,554,6.2,6,6,2,1,15,6,9,9.2,7.6,1.6,24,SPA
1e465e70,29,1796,20.0,20,4,9,1,19,39,-20,25.7,31.5,-5.8,24,SPA
1f079188,21,1520,16.9,19,4,2,2,18,23,-5,17.1,19.8,-2.7,24,SPA
1f423a54,27,1889,21.0,22,10,5,1,22,41,-19,22.6,29.9,-7.2,24,SPA
1f60244a,20,1008,11.2,11,2,9,10,18,10,8,16.6,11.1,5.5,24,SPA
1fc474ae,28,2006,22.3,22,16,6,1,16,24,-8,24.6,26.4,-1.8,24,SPA
1fda2b14,11,308,3.4,2,0,9,10,3,7,-4,3.7,5.0,-1.3,24,SPA
1fe0492d,22,1436,16.0,16,11,6,6,15,22,-7,18.5,20.6,-2.1,24,SPA
200e89e1,21,1057,11.7,15,0,6,1,20,13,7,14.2,13.0,1.2,24,SPA
20a65cdf,9,285,3.2,2,0,7,13,4,4,0,0.0,0.0,0.0,24,SPA
211589b8,2,16,0.2,0,0,2,13,0,1,-1,0.0,1.2,-1.1,24,SPA
21166ff4,6,114,1.3,1,0,5,8,5,1,4,1.9,2.7,-0.8,24,SPA
220c11f1,28,749,8.3,5,0,23,1,21,9,12,16.8,13.3,3.5,24,SPA
22371dee,1,15,0.2,0,0,1,2,1,0,1,0.6,0.0,0.5,24,SPA
228b0d9d,21,1127,12.5,11,10,10,0,22,14,8,18.9,15.5,3.4,24,SPA
23610943,26,1572,17.5,16,7,10,2,34,18,16,30.2,17.3,12.9,24,SPA
237a3851,22,819,9.1,9,0,13,4,6,13,-7,10.3,11.1,-0.8,24,SPA
23cbf863,7,262,2.9,2,0,5,7,3,8,-5,3.9,6.0,-2.2,24,SPA
240d3a0b,13,545,6.1,5,2,8,7,5,8,-3,6.7,7.3,-0.5,24,SPA
2475cf9b,23,1714,19.0,18,16,5,6,19,40,-21,25.0,32.6,-7.6,24,SPA
253a06b9,23,1162,12.899999999999999,14,1,9,0,17,19,-2,14.6,16.0,-1.4,24,SPA
25b82f9a,6,132,1.5,1,0,5,2,1,3,-2,1.0,2.4,-1.5,24,SPA
274ab13c,23,1934,21.5,22,19,1,5,25,33,-8,21.8,29.9,-8.1,24,SPA
2784f898,2,50,0.6,1,0,1,0,2,0,2,0.7,0.1,0.7,24,SPA
27dc1378,30,2672,29.7,30,27,0,0,32,31,1,30.6,35.0,-4.3,24,SPA
28d596a0,12,1080,12.0,12,12,0,15,22,9,13,22.0,12.0,10.0,24,SPA
28e957d7,16,1349,15.0,16,13,0,6,12,31,-19,19.2,22.6,-3.4,24,SPA
2946f9a1,22,1272,14.1,13,9,9,4,31,8,23,26.6,14.0,12.6,24,SPA
2973a975,3,205,2.3,2,2,1,5,2,2,0,2.6,3.0,-0.4,24,SPA
2a0c8ba4,6,363,4.0,4,3,2,16,5,13,-8,3.1,8.4,-5.3,24,SPA
2a295d33,26,1547,17.2,18,4,8,2,37,16,21,30.7,17.4,13.3,24,SPA
2ae958ab,3,225,2.5,2,2,1,24,2,4,-2,3.4,2.3,1.1,24,SPA
2bc7f211,21,1817,20.2,21,18,0,3,15,23,-8,20.2,23.9,-3.8,24,SPA
2bea832e,25,1239,13.8,13,4,12,4,15,17,-2,17.2,18.7,-1.5,24,SPA
2bed3eab,24,1997,22.200000000000003,22,19,2,2,51,32,19,45.0,31.5,13.399999999999999,24,SPA
2bef2bca,21,1698,18.9,18,17,3,4,40,22,18,41.1,19.7,21.4,24,SPA
2cf496fb,5,351,3.9,5,3,0,4,1,7,-6,3.1,6.8,-3.7,24,SPA
2cfb6e88,7,54,0.6,0,0,7,14,1,1,0,1.0,1.2,-0.2,24,SPA
2dce876a,22,772,8.6,9,2,13,1,14,15,-1,11.4,13.4,-2.0,24,SPA
2e31f3a6,4,178,2.0,2,0,2,12,6,2,4,3.2,1.2,2.1,24,SPA
2e3995cd,10,144,1.6,0,0,10,6,0,2,-2,1.0,3.2,-2.2,24,SPA
2ef08833,1,9,0.1,0,0,1,17,0,0,0,0.1,0.3,-0.2,24,SPA
2f5c78ca,4,63,0.7,0,0,4,6,2,0,2,0.0,0.0,0.0,24,SPA
30061f53,1,90,1.0,1,1,0,29,0,0,0,0.9,1.5,-0.6,24,SPA
3061e1ec,18,1620,18.0,18,18,0,12,44,11,33,34.2,15.2,19.0,24,SPA
31d45cc8,3,194,2.2,2,1,1,12,3,2,1,2.7,3.3,-0.6,24,SPA
31f5b89b,2,27,0.3,0,0,2,1,1,1,0,0.5,0.7,-0.2,24,SPA
3239a8ed,27,2001,22.2,23,22,4,3,17,26,-9,25.2,26.5,-1.4,24,SPA
32974271,18,379,4.2,1,0,17,7,4,7,-3,4.4,6.4,-2.0,24,SPA
3318286e,27,2430,27.0,27,27,0,2,25,51,-26,34.5,44.7,-10.3,24,SPA
335fa267,8,513,5.7,6,2,2,12,16,6,10,13.8,5.7,8.1,24,SPA
33a68b9b,13,475,5.3,5,0,8,2,10,11,-1,8.7,7.3,1.4,24,SPA
3423f250,22,1055,11.7,13,3,9,0,24,10,14,26.6,9.1,17.5,24,SPA
34269bdf,19,1266,14.1,14,10,5,7,14,15,-1,14.8,17.9,-3.1,24,SPA
34e393f2,18,1377,15.3,16,10,2,0,20,18,2,17.2,18.2,-1.0,24,SPA
34e39a18,1,90,1.0,1,1,0,14,0,2,-2,0.7,1.7,-1.0,24,SPA
3521abfe,16,1164,12.9,13,9,3,13,16,20,-4,15.5,18.7,-3.3,24,SPA
35a6e5c7,1,18,0.2,0,0,1,1,0,1,-1,0.1,0.3,-0.2,24,SPA
35f6db55,24,1331,14.8,15,7,9,1,15,26,-11,18.5,22.4,-3.8,24,SPA
3624ce4c,4,162,1.8,2,0,2,14,1,8,-7,0.6,3.5,-2.9,24,SPA
365113c0,16,1275,14.2,15,10,1,0,13,23,-10,16.2,20.0,-3.8,24,SPA
3701906c,26,739,8.2,7,1,19,4,11,14,-3,11.2,10.3,0.9,24,SPA
3741ca58,5,36,0.4,0,0,5,8,2,1,1,2.1,0.3,1.9,24,SPA
374ee424,29,2555,28.4,29,28,0,0,41,28,13,36.2,28.9,7.3,24,SPA
375ed9d7,1,5,0.1,0,0,1,2,0,1,-1,0.2,0.5,-0.3,24,SPA
379652be,22,1035,11.5,14,0,8,8,11,21,-10,11.5,18.4,-6.9,24,SPA
379dc075,5,82,0.9,0,0,5,6,1,0,1,2.2,1.2,1.0,24,SPA
37db6cae,20,575,6.4,6,0,14,9,11,8,3,8.3,6.8,1.5,24,SPA
37e103f8,30,2506,27.8,29,11,1,0,31,27,4,29.4,29.4,0.0,24,SPA
3828f130,28,1943,21.6,21,14,7,0,24,26,-2,22.1,25.7,-3.7,24,SPA
38699c72,12,463,5.1,5,0,7,14,5,6,-1,4.0,9.100000000000001,-5.1,24,SPA
38b0cf42,14,173,1.9,0,0,14,16,3,2,1,4.7,2.5,2.1,24,SPA
38ce1150,28,1042,11.6,8,1,20,1,11,14,-3,12.7,11.6,1.2,24,SPA
3902e91b,23,963,10.7,9,3,14,3,10,26,-16,17.7,16.8,0.8,24,SPA
39352da2,11,255,2.8,3,0,8,8,4,4,0,4.3,6.4,-2.1,24,SPA
39a938cb,6,43,0.5,0,0,6,6,0,3,-3,0.2,1.4,-1.2,24,SPA
3a18abe2,3,202,2.2,2,2,1,15,5,1,4,1.5,3.8,-2.3,24,SPA
3a9c4b7b,12,340,3.8000000000000003,3,0,9,17,2,4,-2,4.8,6.199999999999999,-1.2,24,SPA
3aa74860,13,466,5.2,5,0,8,16,3,12,-9,7.8,6.7,1.0,24,SPA
3c16d927,17,845,9.4,8,3,9,11,6,22,-16,10.5,17.8,-7.4,24,SPA
3cefcaef,20,1450,16.1,18,9,2,1,38,9,29,29.7,13.7,16.0,24,SPA
3d79a68c,30,1926,21.4,25,2,5,0,23,15,8,23.6,20.6,3.1,24,SPA
3d7e48ce,26,1578,17.5,20,3,6,1,13,23,-10,16.2,22.6,-6.4,24,SPA
3d99999d,12,313,3.5,2,0,10,17,6,7,-1,7.1,4.2,2.9,24,SPA
3e42f707,25,2226,24.7,25,24,0,2,28,34,-6,28.5,31.2,-2.6,24,SPA
3ecc11d8,13,761,8.5,9,6,4,3,13,8,5,10.0,9.1,0.9,24,SPA
3ee0dd59,29,2474,27.5,27,25,2,0,39,29,10,35.8,29.8,6.0,24,SPA
3effaa34,14,561,6.2,7,0,7,6,5,6,-1,7.5,5.4,2.0,24,SPA
3f10bd22,22,1529,17.0,19,7,3,1,22,26,-4,19.7,27.2,-7.5,24,SPA
3f79a1c8,19,1229,13.7,13,4,6,3,7,22,-15,9.9,16.1,-6.2,24,SPA
3f7bafbe,3,26,0.3,0,0,3,2,0,2,-2,0.1,0.5,-0.4,24,SPA
3fc45c73,15,891,9.9,9,8,6,5,15,10,5,16.2,8.6,7.6,24,SPA
405f267a,1,28,0.3,0,0,1,0,0,0,0,0.1,0.2,-0.1,24,SPA
407feb71,25,1159,12.9,13,0,12,5,30,5,25,27.2,9.6,17.5,24,SPA
41f32541,8,459,5.1,5,1,3,3,8,10,-2,5.4,7.3,-1.9,24,SPA
4242011c,2,2,0.0,0,0,2,11,0,0,0,0.2,0.3,-0.1,24,SPA
436a9dd0,17,788,8.8,8,3,9,4,13,6,7,11.9,7.6,4.3,24,SPA
44150beb,16,1005,11.2,10,9,6,12,13,12,1,13.1,12.0,1.1,24,SPA
44330c36,9,74,0.8,0,0,9,5,2,2,0,1.6,2.4,-0.9,24,SPA
44e07fac,30,2120,23.6,24,9,6,0,18,30,-12,21.1,32.9,-11.8,24,SPA
452c3055,1,8,0.1,0,0,1,1,0,1,-1,0.1,0.6,-0.5,24,SPA
45736cec,19,1311,14.6,14,7,5,0,27,16,11,26.5,11.5,15.0,24,SPA
45e17712,26,1473,16.4,15,11,11,0,17,17,0,17.7,20.8,-3.2,24,SPA
45f771db,1,6,0.1,0,0,1,8,0,0,0,0.1,0.0,0.1,24,SPA
46e07328,20,702,7.8,7,0,13,6,10,12,-2,9.1,11.8,-2.7,24,SPA
4737cebe,8,193,2.1,0,0,8,11,1,3,-2,1.8,3.9,-2.1,24,SPA
484ebdb0,9,241,2.7,2,1,7,3,1,5,-4,3.4,5.0,-1.6,24,SPA
4958bfb2,23,1823,20.3,21,15,2,2,46,13,33,38.5,18.2,20.3,24,SPA
49a6ecbb,1,1,0.0,0,0,1,0,0,0,0,0.0,0.0,0.0,24,SPA
49d028db,25,2080,23.1,25,20,0,1,18,42,-24,27.4,38.2,-10.8,24,SPA
49dbab27,29,2258,25.1,28,11,1,0,23,24,-1,28.2,28.7,-0.5,24,SPA
4a478107,23,919,10.2,8,0,15,7,11,23,-12,13.8,18.7,-5.0,24,SPA
4a633cfe,7,529,5.9,6,4,1,15,6,9,-3,4.5,9.2,-4.7,24,SPA
4accb7e0,2,48,0.5,0,0,2,10,1,1,0,0.9,1.4,-0.5,24,SPA
4acd733a,22,453,5.0,2,0,20,7,11,8,3,9.6,9.6,0.0,24,SPA
4b511457,23,780,8.7,10,0,13,6,10,11,-1,15.0,10.1,4.9,24,SPA
4bd414c1,22,1716,19.1,21,15,1,2,25,32,-7,25.5,31.7,-6.2,24,SPA
4c0a6a48,29,2138,23.8,28,8,1,0,21,27,-6,27.7,26.1,1.5,24,SPA
4c2e9442,24,985,10.9,11,0,13,3,5,18,-13,8.5,14.7,-6.2,24,SPA
4c6facae,24,1460,16.2,18,4,6,3,18,21,-3,20.1,24.0,-3.9,24,SPA
4d1666ff,27,2240,24.9,25,23,2,2,52,28,24,54.4,26.3,28.2,24,SPA
4d753a3f,14,1035,11.5,11,10,3,11,11,21,-10,13.9,17.2,-3.3,24,SPA
4dbd0916,3,164,1.8,3,0,0,0,1,2,-1,1.5,1.9,-0.4,24,SPA
4e219ad2,24,1250,13.9,13,5,11,1,24,31,-7,16.4,20.4,-4.0,24,SPA
4f255115,24,1717,19.1,19,15,5,0,43,11,32,35.8,16.3,19.5,24,SPA
506daeac,27,1932,21.5,23,12,4,1,15,23,-8,23.3,24.5,-1.2,24,SPA
5083a734,21,1522,16.9,19,7,2,1,36,18,18,29.8,19.1,10.7,24,SPA
518f2234,27,1978,22.0,26,7,1,0,37,37,0,34.3,31.5,2.9,24,SPA
53552942,24,1320,14.7,16,5,8,2,16,18,-2,12.1,23.9,-11.8,24,SPA
53cad200,17,976,10.8,9,5,8,4,19,13,6,17.9,11.2,6.7,24,SPA
540ec57b,7,475,5.3,7,1,0,1,6,8,-2,5.9,8.4,-2.5,24,SPA
5418d47c,2,2,0.0,0,0,2,8,1,0,1,1.0,0.0,1.0,24,SPA
5487adcd,13,1064,11.8,12,10,1,15,7,12,-5,10.3,15.8,-5.4,24,SPA
5496cc91,2,2,0.0,0,0,2,12,0,0,0,0.3,0.9,-0.6,24,SPA
55126f3b,27,1793,19.9,24,11,3,0,37,26,11,36.9,22.9,14.0,24,SPA
5556d20b,9,473,5.3,5,0,4,9,10,4,6,9.0,6.3,2.6,24,SPA
555f3a0b,23,2031,22.6,23,21,0,4,42,27,15,38.7,25.9,12.7,24,SPA
55634fb8,8,523,5.8,5,5,3,14,11,19,-8,9.5,11.8,-2.3,24,SPA
56cafd0a,12,931,10.3,10,9,2,11,14,20,-6,12.6,18.6,-6.1,24,SPA
57827369,14,270,3.0,2,0,12,5,3,3,0,3.3,3.5,-0.1,24,SPA
57be54ec,13,339,3.8,2,0,11,17,6,5,1,6.2,4.3,1.9,24,SPA
57d88cf9,23,1957,21.7,23,14,0,1,46,14,32,38.5,19.8,18.7,24,SPA
5853ac44,6,211,2.3,2,1,4,9,1,7,-6,2.6,4.3,-1.7,24,SPA
58a9a4d9,25,1449,16.1,16,2,9,3,17,16,1,18.0,21.9,-4.0,24,SPA
58ad9383,29,2610,29.0,29,29,0,1,25,35,-10,31.5,35.7,-4.2,24,SPA
58afe001,7,339,3.8,3,1,4,0,4,6,-2,3.2,4.6,-1.4,24,SPA
58eee997,25,1942,21.6,22,14,3,0,31,31,0,28.7,30.6,-1.9,24,SPA
592f3158,27,2239,24.9,26,18,1,2,21,26,-5,28.8,30.3,-1.4,24,SPA
59b7d823,21,1531,17.0,17,13,4,7,27,16,11,27.0,17.7,9.4,24,SPA
59c29820,1,8,0.1,0,0,1,10,0,0,0,0.2,0.0,0.1,24,SPA
5a626448,23,1695,18.8,20,9,3,4,25,25,0,20.3,21.5,-1.2,24,SPA
5acc4a10,28,1406,15.6,15,9,13,1,27,33,-6,23.3,26.7,-3.4,24,SPA
5ae499d0,21,1242,13.8,14,6,7,6,23,20,3,20.9,19.8,1.1,24,SPA
5b847bb0,28,1913,21.3,24,6,4,0,44,27,17,38.1,26.9,11.2,24,SPA
5c4dc0ff,6,219,2.4,2,0,4,2,4,6,-2,3.4,4.0,-0.6,24,SPA
5c7845f6,28,2343,26.0,27,22,1,1,36,26,10,32.9,27.1,5.8,24,SPA
5c96b017,23,1044,11.6,12,1,11,6,13,16,-3,11.1,16.9,-5.8,24,SPA
5ca20b7a,8,327,3.6,4,0,4,19,3,6,-3,2.8,6.1,-3.3,24,SPA
5ccc9672,18,1378,15.3,15,12,3,2,29,17,12,34.9,14.9,20.0,24,SPA
5cfec13d,23,1863,20.7,22,18,1,4,20,34,-14,24.5,32.5,-8.0,24,SPA
5d68f5b2,22,1272,14.1,12,11,10,7,5,20,-15,11.9,19.1,-7.2,24,SPA
5db04597,17,1122,12.5,13,10,4,2,14,16,-2,14.9,15.6,-0.7,24,SPA
5dcf3e90,29,2610,29.0,29,29,0,1,50,26,24,44.5,29.0,15.6,24,SPA
5dfc6ad5,29,2288,25.4,25,22,4,0,41,30,11,40.4,29.8,10.7,24,SPA
5e1028e5,14,496,5.5,5,1,9,9,6,11,-5,7.2,8.2,-1.0,24,SPA
5fa714d5,25,1081,12.0,12,3,13,5,6,17,-11,14.5,17.1,-2.6,24,SPA
6025fab1,25,1173,13.0,12,2,13,4,27,10,17,24.5,11.3,13.2,24,SPA
608f2092,22,1533,17.0,17,12,5,3,19,26,-7,16.4,23.1,-6.7,24,SPA
61220da2,4,120,1.3,1,0,3,1,0,1,-1,0.9,2.1,-1.2,24,SPA
6265208f,28,1228,13.6,10,5,18,0,37,6,31,31.6,12.4,19.1,24,SPA
63787ec5,1,5,0.1,0,0,1,7,0,0,0,0.2,0.1,0.1,24,SPA
63b0ca6b,7,54,0.6,0,0,7,15,0,2,-2,0.7,2.6,-1.9,24,SPA
63c5e56b,15,687,7.6,7,4,8,12,5,9,-4,6.9,4.5,2.4,24,SPA
63d17038,30,2700,30.0,30,30,0,0,62,36,26,52.2,39.8,12.4,24,SPA
63f04c6c,15,967,10.7,13,6,2,0,13,24,-11,16.4,16.9,-0.5,24,SPA
64c14d49,27,1731,19.2,20,12,7,1,17,40,-23,24.9,35.0,-10.2,24,SPA
64e8ed6d,27,2153,23.9,25,10,2,0,34,34,0,29.2,32.3,-3.1,24,SPA
65154df0,26,1156,12.8,14,3,12,4,21,22,-1,20.6,16.2,4.4,24,SPA
66017b9d,10,793,8.8,9,5,1,0,6,10,-4,8.9,11.5,-2.7,24,SPA
66116290,16,235,2.6,0,0,16,11,3,4,-1,4.4,3.6,0.8,24,SPA
66654daa,18,571,6.3,5,3,13,9,6,13,-7,8.7,9.8,-1.2,24,SPA
6763373d,3,65,0.7,1,0,2,0,0,2,-2,0.3,1.0,-0.7,24,SPA
67669ce7,1,63,0.7,0,0,1,26,1,2,-1,0.2,1.7,-1.5,24,SPA
686cbe7d,25,1054,11.7,12,2,13,4,16,15,1,14.9,13.9,0.9,24,SPA
691bef82,26,2252,25.0,25,24,1,1,55,27,28,44.6,31.1,13.5,24,SPA
6a99e0b1,27,2303,25.6,26,16,1,0,43,22,21,39.2,25.5,13.7,24,SPA
6b5ea2f4,29,1994,22.2,27,4,2,0,40,17,23,33.8,20.0,13.9,24,SPA
6bca20fe,29,1490,16.6,15,4,14,1,12,14,-2,14.3,20.3,-6.0,24,SPA
6c4776b1,27,2418,26.9,27,26,0,0,19,38,-19,24.8,36.7,-11.9,24,SPA
6c7762c3,12,1062,11.8,12,11,0,0,15,20,-5,16.3,17.4,-1.2,24,SPA
6c811eb7,24,894,9.9,9,0,15,5,12,18,-6,13.3,16.1,-2.7,24,SPA
6ce1f46f,29,1876,20.8,21,10,8,1,48,17,31,37.4,21.0,16.4,24,SPA
6eaed4eb,29,2607,29.0,29,28,0,0,25,38,-13,31.6,36.3,-4.7,24,SPA
6f392eb8,5,198,2.2,2,0,3,3,2,1,1,3.6,2.6,1.0,24,SPA
6f4c734d,3,14,0.2,0,0,3,14,2,3,-1,0.2,0.5,-0.2,24,SPA
6f51e382,20,1800,20.0,20,20,0,0,40,17,23,39.7,18.2,21.5,24,SPA
6f5f82c0,29,2470,27.4,28,19,1,0,24,30,-6,32.3,32.2,0.2,24,SPA
6fb59070,4,280,3.1,4,3,0,7,8,11,-3,3.8,7.7,-3.9,24,SPA
7016332f,2,76,0.8,0,0,2,6,0,0,0,0.0,0.0,0.0,24,SPA
70f8e0bd,28,2066,23.0,24,8,4,1,23,28,-5,23.1,27.4,-4.4,24,SPA
7111d552,20,1534,17.0,19,5,1,1,40,10,30,31.2,15.2,16.0,24,SPA
722494dc,3,85,0.9,1,0,2,7,2,1,1,1.5,0.8,0.7,24,SPA
7226539b,20,1033,11.5,11,6,9,10,20,11,9,20.4,11.0,9.3,24,SPA
72947847,5,280,3.1,3,2,2,2,3,3,0,2.5,4.7,-2.2,24,SPA
72a84002,24,2007,22.3,24,19,0,2,16,29,-13,18.7,31.5,-12.8,24,SPA
73000a79,8,259,2.9,4,1,4,16,4,3,1,2.0,5.2,-3.3,24,SPA
736c14ec,2,127,1.4,1,0,1,4,1,1,0,1.6,0.8,0.8,24,SPA
7426f085,9,677,7.5,8,5,1,2,10,7,3,6.8,9.7,-2.8,24,SPA
7460ca0d,25,2017,22.4,22,16,3,1,35,44,-9,32.0,35.7,-3.7,24,SPA
74c2d562,2,19,0.2,0,0,2,4,0,0,0,0.3,0.3,0.0,24,SPA
74e90475,29,2403,26.7,26,22,3,0,27,30,-3,23.5,37.5,-14.0,24,SPA
75645f0e,11,408,4.5,4,1,7,9,7,6,1,4.7,7.8,-3.1,24,SPA
757a3431,11,775,8.6,10,4,1,7,11,22,-11,12.8,18.7,-5.9,24,SPA
758dd7f0,6,439,4.9,6,2,0,1,7,8,-1,4.7,8.4,-3.6,24,SPA
75a66bed,6,248,2.8,2,0,4,2,6,5,1,3.6,3.5,0.1,24,SPA
76c2a023,28,1936,21.5,21,15,7,1,17,25,-8,20.5,28.9,-8.5,24,SPA
7868c973,1,5,0.1,0,0,1,1,0,0,0,0.6,0.0,0.6,24,SPA
78841da9,20,641,7.1,7,0,13,10,6,14,-8,7.8,15.1,-7.2,24,SPA
7b9c2d84,23,1371,15.2,16,4,7,0,37,12,25,30.6,14.6,16.0,24,SPA
7c363088,29,2112,23.5,24,8,5,0,24,30,-6,22.5,28.6,-6.0,24,SPA
7dcf86f6,27,2061,22.9,24,13,3,1,25,32,-7,29.7,31.5,-1.9,24,SPA
7e98cff1,28,2491,27.7,28,27,0,1,57,32,25,46.7,36.4,10.3,24,SPA
7f14ec2a,21,880,9.8,11,0,10,2,11,12,-1,13.4,10.3,3.1,24,SPA
7f9c5d2d,18,1240,13.8,14,11,4,7,17,17,0,14.8,23.1,-8.3,24,SPA
8059806f,14,616,6.8,6,2,8,2,8,10,-2,9.0,10.9,-1.9,24,SPA
808d48f3,25,1329,14.8,15,5,10,3,14,21,-7,15.4,18.4,-2.9,24,SPA
81442ecb,15,908,10.1,13,3,2,2,14,16,-2,11.0,14.4,-3.3,24,SPA
819aa8e7,23,1645,18.3,21,8,2,1,18,20,-2,21.5,21.5,0.0,24,SPA
819b3158,30,2455,27.3,27,21,3,0,55,32,23,59.0,27.8,31.3,24,SPA
81f0781e,27,2018,22.4,25,9,2,0,34,40,-6,30.8,33.4,-2.6,24,SPA
82927de4,8,621,6.9,7,4,1,0,10,11,-1,5.6,9.6,-4.0,24,SPA
82ec26c1,29,1578,17.5,15,7,14,1,40,23,17,40.2,20.5,19.7,24,SPA
833fb62e,19,1361,15.1,16,4,3,3,12,17,-5,10.7,21.3,-10.6,24,SPA
84399660,8,553,6.1,6,3,2,0,5,7,-2,7.2,6.4,0.7,24,SPA
852ddfb8,27,2073,23.0,24,19,3,1,23,33,-10,27.8,33.6,-5.8,24,SPA
853ca71c,25,687,7.6,5,2,20,2,7,18,-11,10.2,15.4,-5.2,24,SPA
857cb4f3,2,10,0.1,0,0,2,12,0,0,0,0.0,0.1,-0.1,24,SPA
85bed4ee,22,882,9.8,8,2,14,7,10,12,-2,10.7,15.6,-4.9,24,SPA
86087757,2,10,0.1,0,0,2,15,0,1,-1,0.0,0.4,-0.4,24,SPA
8696bc90,30,2133,23.7,28,3,2,0,21,20,1,18.1,31.6,-13.5,24,SPA
86a2ba20,16,821,9.1,9,3,7,5,10,13,-3,10.2,12.1,-1.9,24,SPA
86ff856b,14,285,3.2,2,0,12,9,1,10,-9,3.5,8.8,-5.3,24,SPA
873619c6,25,1224,13.6,14,0,11,4,11,22,-11,16.2,17.5,-1.2,24,SPA
88050721,27,1690,18.8,22,5,5,2,18,24,-6,22.0,24.2,-2.3,24,SPA
89f951b5,18,1425,15.8,16,13,2,2,14,23,-9,16.7,22.3,-5.6,24,SPA
8aae94b9,4,288,3.2,2,2,2,20,2,5,-3,1.6,5.7,-4.2,24,SPA
8aafd64f,23,1317,14.6,17,3,6,0,28,14,14,31.3,13.5,17.8,24,SPA
8ae7d0ec,18,1048,11.6,13,2,5,7,14,9,5,15.7,14.1,1.6,24,SPA
8bc8829a,4,179,2.0,2,0,2,1,3,3,0,2.0,3.4,-1.5,24,SPA
8c3c640c,25,1590,17.7,17,4,8,1,22,14,8,20.4,17.1,3.4,24,SPA
8c4e56cb,15,487,5.4,6,0,9,12,4,5,-1,6.1,7.5,-1.4,24,SPA
8c725b43,28,2436,27.1,28,25,0,1,34,28,6,31.6,34.2,-2.5,24,SPA
8ca358c5,2,3,0.0,0,0,2,8,0,0,0,0.0,0.1,-0.1,24,SPA
8d47bb39,29,2517,28.0,29,21,0,1,26,54,-28,30.4,46.1,-15.8,24,SPA
8d78e732,28,2237,24.9,25,19,3,0,52,27,25,51.6,25.7,25.9,24,SPA
8e088e04,23,1260,14.0,13,2,10,4,10,13,-3,15.6,16.7,-1.2,24,SPA
8e48dc61,29,2513,27.9,29,20,0,0,26,33,-7,33.0,32.9,0.0,24,SPA
8eb55dbb,7,270,3.0,2,0,5,1,7,1,6,5.3,1.6,3.7,24,SPA
8f3565b3,30,2281,25.3,27,9,3,0,32,38,-6,27.6,30.4,-2.8,24,SPA
8f4541c2,22,1298,14.4,13,9,9,1,11,17,-6,12.7,22.1,-9.4,24,SPA
8f5e92a6,30,2104,23.4,25,8,5,0,46,18,28,40.1,20.6,19.6,24,SPA
8f696594,20,842,9.4,9,1,11,2,15,12,3,15.4,9.2,6.2,24,SPA
8f8c6934,30,2700,30.0,30,30,0,0,37,43,-6,36.5,43.3,-6.8,24,SPA
90bbd822,26,2042,22.7,25,10,1,0,20,31,-11,26.4,30.0,-3.6,24,SPA
90df343e,11,649,7.2,6,1,5,0,10,8,2,9.2,8.4,0.8,24,SPA
91f7631f,24,1753,19.5,21,7,3,0,39,16,23,31.5,20.4,11.1,24,SPA
922dfade,7,243,2.7,2,0,5,2,0,2,-2,1.6,3.4,-1.8,24,SPA
93090f69,15,907,10.1,11,7,4,12,14,18,-4,12.2,15.5,-3.3,24,SPA
94acdd4e,12,504,5.6,6,2,6,15,6,11,-5,7.3,9.8,-2.5,24,SPA
94e01ec6,29,2038,22.6,22,16,7,1,27,33,-6,23.6,30.6,-7.0,24,SPA
958d67bb,11,190,2.1,1,0,10,16,1,3,-2,2.1,2.7,-0.6,24,SPA
963829d0,11,211,2.3,1,0,10,19,2,4,-2,3.1,2.5,0.7,24,SPA
974322dc,22,1367,15.2,15,5,7,7,13,19,-6,16.7,20.4,-3.7,24,SPA
9939e168,26,1489,16.5,17,6,9,2,22,24,-2,16.8,25.4,-8.6,24,SPA
9970da54,30,2700,30.0,30,30,0,0,26,36,-10,35.6,35.7,-0.1,24,SPA
9a0408b6,24,1323,14.7,13,6,11,3,9,22,-13,12.2,17.7,-5.5,24,SPA
9a64e67e,23,1938,21.5,22,19,1,5,31,24,7,27.3,21.7,5.7,24,SPA
9a76c2e9,23,1930,21.4,22,19,1,2,20,32,-12,20.2,30.0,-9.8,24,SPA
9a796115,20,650,7.2,6,0,14,10,5,5,0,6.8,6.3,0.5,24,SPA
9a93efc9,16,1141,12.7,13,11,3,12,9,13,-4,12.0,13.5,-1.5,24,SPA
9b130479,29,2491,27.7,28,21,1,0,29,30,-1,23.9,36.6,-12.7,24,SPA
9c137b36,24,1965,21.8,23,18,1,5,22,22,0,17.8,26.5,-8.7,24,SPA
9d33c71a,1,37,0.4,0,0,1,2,0,0,0,0.6,1.1,-0.5,24,SPA
9e095d72,6,394,4.4,4,2,2,22,8,5,3,6.5,4.2,2.3,24,SPA
9e1035f8,22,956,10.6,10,3,12,1,26,16,10,24.7,10.5,14.1,24,SPA
9f323c71,23,1808,20.1,21,16,2,2,38,23,15,30.2,22.5,7.6,24,SPA
9f979eb2,10,673,7.5,8,3,2,14,6,12,-6,5.6,9.5,-3.8,24,SPA
9fb45456,23,716,8.0,5,2,18,3,11,11,0,10.2,11.8,-1.6,24,SPA
a01c3d54,5,371,4.1,4,4,1,24,4,11,-7,4.9,6.9,-2.1,24,SPA
a0255c67,27,1265,14.1,13,3,14,2,10,18,-8,14.9,19.7,-4.8,24,SPA
a08b974a,27,2212,24.6,26,15,1,1,27,35,-8,27.1,35.1,-8.0,24,SPA
a0b4bb3e,24,1973,21.9,23,13,1,0,25,26,-1,25.5,28.6,-3.1,24,SPA
a10361d2,29,2551,28.3,29,26,0,0,57,35,22,48.6,37.4,11.3,24,SPA
a1232f4e,7,569,6.3,6,5,1,1,16,12,4,10.3,8.0,2.2,24,SPA
a254bbe0,23,1214,13.5,18,0,5,7,14,14,0,13.2,14.8,-1.6,24,SPA
a2c1a8d3,1,90,1.0,1,1,0,29,0,2,-2,0.3,1.1,-0.8,24,SPA
a2d9cf74,1,14,0.2,0,0,1,2,2,0,2,0.2,0.2,0.0,24,SPA
a35134ae,11,946,10.5,11,8,0,1,10,14,-4,14.8,12.0,2.9,24,SPA
a461f098,10,189,2.1,1,0,9,19,1,3,-2,1.0,2.9,-1.9,24,SPA
a4971d84,26,1960,21.8,24,15,2,0,23,28,-5,23.0,29.8,-6.8,24,SPA
a4995f48,26,2329,25.9,26,25,0,4,34,36,-2,27.5,33.0,-5.5,24,SPA
a4b00319,14,725,8.1,8,6,6,15,9,8,1,9.7,5.2,4.4,24,SPA
a4b1028a,25,1898,21.1,22,16,3,1,38,21,17,30.0,22.0,8.0,24,SPA
a55d8df5,16,951,10.6,10,6,6,8,12,14,-2,12.5,17.1,-4.6,24,SPA
a56da3ba,20,1406,15.6,15,13,5,7,21,23,-2,18.8,20.0,-1.1,24,SPA
a6103274,11,468,5.2,3,0,8,10,3,8,-5,6.0,7.9,-2.0,24,SPA
a6536561,7,106,1.2,0,0,7,5,1,2,-1,2.3,1.2,1.1,24,SPA
a6951bf8,12,676,7.5,8,1,4,1,12,6,6,10.1,8.1,2.1,24,SPA
a8981944,26,1844,20.5,23,8,3,0,19,33,-14,25.1,28.0,-2.9,24,SPA
a8f21b9f,11,529,5.9,4,0,7,13,7,7,0,9.6,7.1,2.5,24,SPA
a96103b2,21,1638,18.2,18,13,3,0,19,37,-18,22.0,32.2,-10.2,24,SPA
aa677a35,21,947,10.5,9,5,12,8,4,12,-8,8.5,17.5,-9.1,24,SPA
aad53e64,16,303,3.4,3,0,13,5,8,8,0,6.8,5.8,1.0,24,SPA
ab13a5aa,21,1863,20.7,20,20,1,5,22,29,-7,23.5,30.5,-7.0,24,SPA
ab7bf91d,27,2383,26.5,26,24,1,1,46,27,19,41.5,27.8,13.7,24,SPA
abe66106,10,383,4.3,4,2,6,6,8,6,2,5.1,8.5,-3.4,24,SPA
ac295d9e,13,1170,13.0,13,13,0,16,14,25,-11,13.0,18.6,-5.6,24,SPA
ac454a4f,27,2014,22.4,23,13,4,0,22,48,-26,23.2,37.5,-14.4,24,SPA
ac7e7b1c,8,648,7.2,7,3,1,0,7,15,-8,6.7,10.1,-3.4,24,SPA
ae14af56,2,28,0.3,0,0,2,6,0,0,0,0.3,0.1,0.2,24,SPA
ae48c5cb,29,2134,23.7,26,8,3,1,50,30,20,40.9,31.1,9.9,24,SPA
ae59b359,21,1657,18.4,19,16,2,3,20,24,-4,18.2,27.3,-9.1,24,SPA
ae852b7d,10,708,7.9,8,6,2,18,7,20,-13,9.8,11.8,-2.0,24,SPA
ae9a9b2d,1,17,0.2,0,0,1,6,0,0,0,0.9,0.0,0.9,24,SPA
afdc14d7,24,1694,18.8,22,4,2,0,35,17,18,31.9,18.7,13.3,24,SPA
b05e2dbd,22,1749,19.4,22,14,0,0,24,22,2,23.4,23.9,-0.5,24,SPA
b0fce72c,22,1351,15.0,16,8,6,3,25,15,10,23.9,15.3,8.6,24,SPA
b151a3f2,1,5,0.1,0,0,1,13,0,0,0,0.0,0.0,0.0,24,SPA
b1b99435,8,414,4.6,4,1,4,18,3,6,-3,3.0,8.0,-4.9,24,SPA
b2bd0f6c,22,1710,19.0,21,9,1,1,19,24,-5,26.0,24.9,1.0,24,SPA
b3b9b8b8,19,1534,17.0,17,15,2,7,20,21,-1,18.9,22.6,-3.7,24,SPA
b418dbd4,13,210,2.3,0,0,13,16,4,1,3,3.3,2.7,0.6,24,SPA
b4819112,8,357,4.0,3,2,5,4,7,5,2,3.1,7.0,-3.9,24,SPA
b4b4d0a6,1,25,0.3,0,0,1,1,0,0,0,0.3,0.3,0.0,24,SPA
b682dcf6,10,747,8.3,8,7,2,7,11,12,-1,9.5,13.9,-4.4,24,SPA
b6e50615,22,1533,17.0,17,13,5,0,27,12,15,25.3,13.9,11.4,24,SPA
b742cc0d,3,225,2.5,3,2,0,2,2,6,-4,3.8,2.7,1.1,24,SPA
b793dea2,1,1,0.0,0,0,1,3,0,0,0,0.2,0.0,0.2,24,SPA
b7ca5c51,22,1758,19.5,20,16,2,4,21,25,-4,24.9,19.5,5.4,24,SPA
b857bd29,18,1475,16.4,17,14,1,3,13,16,-3,15.6,17.7,-2.2,24,SPA
b85bf253,8,398,4.4,5,1,3,1,4,12,-8,3.0,8.0,-5.0,24,SPA
b8bd60fe,23,1139,12.7,12,2,11,6,19,24,-5,19.3,21.1,-1.8,24,SPA
b906757a,28,2221,24.7,25,20,3,1,40,20,20,37.0,23.0,14.0,24,SPA
b92b456a,20,586,6.5,6,0,14,8,10,7,3,9.9,8.9,0.9,24,SPA
ba5004e1,16,1299,14.4,15,9,1,1,20,24,-4,15.8,21.7,-5.9,24,SPA
bb08bce9,23,1520,16.9,17,13,6,3,21,24,-3,21.4,25.3,-3.9,24,SPA
bbf5c11b,15,391,4.3,3,1,12,8,5,4,1,6.0,6.7,-0.6,24,SPA
bc49fd34,7,319,3.5,4,0,3,4,4,3,1,4.4,6.4,-2.0,24,SPA
bd4e3824,6,214,2.4,2,0,4,1,3,3,0,2.7,4.3,-1.6,24,SPA
bd6351cd,25,1963,21.8,23,17,2,0,40,25,15,44.2,21.8,22.4,24,SPA
bdb624a3,27,1772,19.7,22,3,5,1,33,14,19,29.4,19.7,9.7,24,SPA
bdc14559,5,82,0.9,1,0,4,12,1,3,-2,0.3,2.9,-2.6,24,SPA
bdc74a8f,27,1547,17.2,19,4,8,0,17,32,-15,19.4,28.1,-8.8,24,SPA
bdedffac,16,1440,16.0,16,16,0,4,22,17,5,19.6,24.7,-5.1,24,SPA
be170419,29,2549,28.3,28,26,1,1,31,43,-12,34.8,42.9,-8.1,24,SPA
be719093,11,868,9.6,11,3,0,0,12,13,-1,0.0,0.0,0.0,24,SPA
bece776f,12,711,7.9,8,3,4,1,13,10,3,7.9,7.9,0.1,24,SPA
bed68338,22,757,8.5,5,0,17,3,10,6,4,10.600000000000001,9.2,1.4,24,SPA
bfd381b3,23,1404,15.6,14,8,9,4,16,38,-22,17.0,29.0,-12.0,24,SPA
c05dfb74,16,431,4.8,3,0,13,13,9,10,-1,8.7,6.0,2.6,24,SPA
c0617e2b,14,238,2.6,1,0,13,7,3,2,1,5.5,2.4,3.1,24,SPA
c14bc029,29,1245,13.8,13,5,16,0,30,14,16,23.3,16.5,6.7,24,SPA
c1fe5f0b,23,936,10.4,8,0,15,6,19,7,12,20.2,10.0,10.2,24,SPA
c20bdcd7,9,593,6.6,6,6,3,7,13,7,6,11.4,4.7,6.8,24,SPA
c2111b45,3,108,1.2,1,1,2,1,1,4,-3,1.6,3.2,-1.6,24,SPA
c235e803,7,477,5.3,6,3,1,8,8,10,-2,6.2,9.2,-3.0,24,SPA
c2c8897d,20,1135,12.6,14,3,6,0,19,15,4,12.2,18.1,-5.9,24,SPA
c3e66ffe,15,992,11.0,12,4,3,14,17,10,7,15.4,14.5,0.9,24,SPA
c47541e0,5,239,2.7,3,0,2,2,9,3,6,5.1,2.4,2.7,24,SPA
c487901c,28,1986,22.1,22,5,6,0,21,23,-2,21.0,25.7,-4.8,24,SPA
c4b888df,28,2279,25.3,26,22,2,2,18,30,-12,23.0,32.2,-9.2,24,SPA
c4f5eb61,4,149,1.7,2,0,2,25,3,2,1,1.4,1.4,0.0,24,SPA
c5642098,2,21,0.2,0,0,2,8,0,0,0,0.1,0.3,-0.2,24,SPA
c77a8043,25,665,7.4,5,1,20,3,13,22,-9,10.8,13.5,-2.8,24,SPA
c78b352d,23,1662,18.5,19,11,4,1,21,19,2,18.6,20.4,-1.8,24,SPA
c997b942,20,1254,13.9,16,1,4,4,7,18,-11,12.1,15.5,-3.4,24,SPA
c9e39d91,27,2069,23.0,23,15,4,0,30,26,4,27.5,24.9,2.6,24,SPA
ca22ccb0,4,91,1.0,1,0,3,5,2,2,0,1.4,1.8,-0.3,24,SPA
ca6edaa0,6,247,2.7,3,0,3,3,3,3,0,2.6,4.1,-1.5,24,SPA
cb00f1e6,10,221,2.5,1,0,9,1,8,4,4,6.7,2.9,3.8,24,SPA
cb1e5807,1,26,0.3,0,0,1,12,2,2,0,0.7,1.6,-0.9,24,SPA
cb641b9d,21,782,8.7,10,0,11,3,11,10,1,10.2,13.2,-2.9,24,SPA
cc1c5035,10,900,10.0,10,10,0,17,21,17,4,24.6,11.9,12.7,24,SPA
cc2dd8a5,5,76,0.8,0,0,5,14,0,1,-1,0.5,2.2,-1.7,24,SPA
cc6de655,21,1031,11.5,10,6,11,8,12,16,-4,12.0,14.7,-2.6,24,SPA
cc7888f3,11,912,10.1,10,7,1,7,23,11,12,20.0,9.1,10.9,24,SPA
cc851506,1,28,0.3,0,0,1,0,1,0,1,0.9,0.1,0.8,24,SPA
cc9256ef,27,1492,16.6,16,4,11,1,20,33,-13,23.5,25.3,-1.8,24,SPA
cd59a7e6,1,61,0.7,0,0,1,6,2,0,2,1.5,0.4,1.1,24,SPA
cde52ef5,10,834,9.3,10,9,0,16,11,16,-5,13.1,13.4,-0.2,24,SPA
cee88597,27,2344,26.0,26,23,1,2,23,33,-10,30.6,29.4,1.2,24,SPA
cf9bdd43,6,286,3.2,4,1,2,21,3,5,-2,2.5,4.9,-2.3,24,SPA
d068118b,1,13,0.1,0,0,1,5,0,0,0,0.0,0.0,0.0,24,SPA
d080ed5e,25,1852,20.6,20,13,5,2,34,17,17,26.2,21.8,4.4,24,SPA
d0ee1652,23,1750,19.4,19,18,4,3,20,25,-5,16.9,30.0,-13.1,24,SPA
d1b060e2,26,1005,11.2,9,3,17,4,13,12,1,13.6,12.3,1.3,24,SPA
d2110326,14,1073,11.9,12,9,2,2,11,15,-4,9.0,16.3,-7.3,24,SPA
d29202c2,14,596,6.6,7,2,7,14,2,7,-5,4.8,10.1,-5.3,24,SPA
d2c8aacc,9,273,3.0,3,0,6,21,6,5,1,5.7,4.3,1.5,24,SPA
d3d774cc,3,74,0.8,1,0,2,12,1,0,1,2.5,0.5,2.0,24,SPA
d4808594,5,121,1.3,1,0,4,14,3,0,3,3.0,0.3,2.6,24,SPA
d49f3e6b,23,1854,20.6,22,10,1,0,18,39,-21,20.7,32.1,-11.4,24,SPA
d4b73232,30,2700,30.0,30,30,0,0,33,32,1,31.4,35.5,-4.1,24,SPA
d633fd46,1,29,0.3,0,0,1,3,1,1,0,0.4,0.3,0.1,24,SPA
d709cd5c,3,25,0.3,0,0,3,4,0,1,-1,0.4,0.4,0.0,24,SPA
d80d7f17,1,17,0.2,0,0,1,3,0,0,0,0.2,0.0,0.2,24,SPA
d8712bf9,16,171,1.9,0,0,16,10,2,2,0,4.3,3.6,0.7,24,SPA
d87e2cae,26,1583,17.6,20,6,6,1,20,24,-4,20.4,23.4,-3.1,24,SPA
d9235a45,1,90,1.0,1,1,0,29,0,2,-2,1.4,2.1,-0.7,24,SPA
d925b04e,1,1,0.0,0,0,1,1,0,0,0,0.0,0.0,0.0,24,SPA
d9ba39fc,25,2003,22.3,21,17,4,0,33,34,-1,28.5,32.8,-4.3,24,SPA
da27e268,24,1816,20.2,22,13,2,1,22,23,-1,23.8,27.4,-3.6,24,SPA
da82ccb1,2,44,0.5,0,0,2,5,1,0,1,0.6,0.3,0.3,24,SPA
daa2eab3,16,692,7.7,7,4,9,7,9,12,-3,8.4,14.0,-5.6,24,SPA
dabb2827,2,180,2.0,2,2,0,28,3,7,-4,1.3,2.8,-1.5,24,SPA
db001fa9,28,2237,24.9,26,17,2,1,20,33,-13,26.2,34.5,-8.3,24,SPA
db714daf,15,209,2.3,0,0,15,7,2,3,-1,2.4,4.2,-1.8,24,SPA
db8f0eba,28,1854,20.6,22,7,6,2,12,39,-27,20.8,34.1,-13.4,24,SPA
dc1c2fce,27,1215,13.5,11,6,16,1,15,14,1,16.5,12.8,3.7,24,SPA
dc1ce4f5,28,2355,26.2,25,24,3,1,30,28,2,27.4,32.2,-4.8,24,SPA
dc44b03c,29,1766,19.599999999999998,20,3,9,0,15,24,-9,21.6,24.599999999999998,-3.0,24,SPA
dc7a172e,6,429,4.8,4,2,2,6,4,6,-2,5.0,3.8,1.2,24,SPA
de39485a,3,221,2.5,3,1,0,0,6,1,5,5.1,2.0,3.1,24,SPA
dee86451,17,569,6.3,3,0,14,1,10,7,3,6.0,10.0,-3.9,24,SPA
df69b544,26,2057,22.9,24,15,2,1,40,25,15,38.5,26.9,11.6,24,SPA
e08647d6,10,408,4.5,5,1,5,6,7,4,3,3.4,5.9,-2.5,24,SPA
e19c989c,11,924,10.3,10,9,1,19,12,13,-1,9.2,14.4,-5.2,24,SPA
e27fdbca,4,240,2.7,3,1,1,14,1,6,-5,2.1,4.4,-2.2,24,SPA
e358587b,1,90,1.0,1,1,0,23,7,2,5,2.0,0.5,1.5,24,SPA
e447352c,8,89,1.0,0,0,8,8,2,3,-1,2.2,2.0,0.2,24,SPA
e54a9890,4,160,1.8,1,1,3,5,4,4,0,3.2,3.1,0.2,24,SPA
e5d01ecf,16,954,10.6,9,6,7,13,18,11,7,15.5,11.7,3.8,24,SPA
e5ec95f8,2,18,0.2,0,0,2,0,0,1,-1,0.1,0.1,0.0,24,SPA
e6697917,10,522,5.8,6,0,4,3,8,6,2,5.4,6.7,-1.3,24,SPA
e6777e6b,11,699,7.8,9,5,2,10,9,11,-2,5.8,9.4,-3.6,24,SPA
e6bc67d7,9,478,5.3,4,2,5,1,11,8,3,7.0,6.2,0.8,24,SPA
e7630876,28,2478,27.5,28,26,0,1,27,30,-3,23.6,39.8,-16.2,24,SPA
e7af9060,28,1511,16.8,17,2,11,1,14,17,-3,18.3,19.1,-0.7,24,SPA
e897d8ba,27,1054,11.7,10,1,17,2,13,13,0,18.4,14.0,4.4,24,SPA
e9241b40,26,1813,20.1,21,10,5,0,18,29,-11,22.8,28.1,-5.3,24,SPA
e92cd3f7,26,1850,20.6,22,17,4,1,40,35,5,32.1,29.7,2.4,24,SPA
e9ada8cf,26,1871,20.8,19,16,7,3,20,25,-5,26.0,24.1,1.9,24,SPA
ea0aa7e0,11,763,8.5,9,6,2,5,12,13,-1,11.1,11.6,-0.5,24,SPA
ea83bfa6,21,1845,20.5,21,20,0,6,23,27,-4,20.7,31.7,-11.0,24,SPA
ead61f73,18,1296,14.4,14,9,4,9,15,16,-1,17.6,14.6,3.0,24,SPA
eb3dd471,30,2325,25.8,29,4,1,0,23,29,-6,29.7,28.3,1.5,24,SPA
ec1a731e,15,1259,14.0,15,12,0,6,7,14,-7,13.1,15.2,-2.1,24,SPA
ec7c84c2,29,2153,23.9,25,14,4,0,25,29,-4,18.6,38.4,-19.9,24,SPA
ed5c5fa3,25,1795,19.9,21,13,4,5,25,29,-4,24.5,29.4,-4.9,24,SPA
ed6ea4d9,19,759,8.4,10,1,9,7,12,13,-1,9.8,12.1,-2.3,24,SPA
ee8508c0,30,2700,30.0,30,30,0,0,56,35,21,51.3,32.0,19.3,24,SPA
ee923664,11,630,7.0,9,3,2,19,7,11,-4,8.3,11.0,-2.7,24,SPA
eeba07f8,10,718,8.0,8,3,2,0,10,20,-10,14.7,14.3,0.4,24,SPA
ef322658,12,447,5.0,4,1,8,6,5,4,1,7.2,6.1,1.1,24,SPA
efa708aa,15,1035,11.5,13,3,2,1,8,13,-5,10.3,14.8,-4.6,24,SPA
efaefda0,25,1322,14.7,11,2,14,1,13,16,-3,12.0,20.0,-8.0,24,SPA
efecd633,4,152,1.7,3,0,1,5,1,2,-1,1.7,2.9,-1.3,24,SPA
f03f284b,18,1428,15.9,18,11,0,1,36,17,19,26.8,19.2,7.6,24,SPA
f0da930c,17,876,9.7,9,5,8,0,22,12,10,19.5,11.0,8.5,24,SPA
f0f499ea,1,21,0.2,0,0,1,0,0,0,0,0.0,0.8,-0.8,24,SPA
f0fe87dc,2,142,1.6,1,1,1,28,2,3,-1,2.0,2.5,-0.6,24,SPA
f1124008,1,3,0.0,0,0,1,3,0,0,0,0.0,0.2,-0.2,24,SPA
f2c6ac01,22,1844,20.5,22,18,0,0,18,28,-10,21.2,25.3,-4.1,24,SPA
f33b6ee6,5,103,1.1,1,0,4,22,2,2,0,1.4,2.3,-0.8,24,SPA
f35430a4,22,1898,21.1,21,21,1,4,19,24,-5,22.2,28.3,-6.1,24,SPA
f36016a5,14,618,6.9,5,1,9,4,10,17,-7,7.2,14.0,-6.9,24,SPA
f3b1d9a2,15,394,4.4,3,0,12,7,3,4,-1,7.1,6.2,0.9,24,SPA
f4290206,4,162,1.8,2,1,2,10,6,4,2,4.3,2.5,1.7,24,SPA
f4c69aa6,7,366,4.1,5,0,2,0,5,8,-3,5.8,6.3,-0.5,24,SPA
f553b2b3,30,2388,26.5,30,8,0,0,26,29,-3,30.0,33.4,-3.4,24,SPA
f6798fc3,1,90,1.0,1,1,0,0,1,2,-1,0.7,1.1,-0.4,24,SPA
f6ac68c1,18,1314,14.6,15,13,3,8,31,15,16,25.4,13.0,12.4,24,SPA
f7c12fbf,21,1097,12.2,10,7,11,8,13,13,0,13.3,16.6,-3.3,24,SPA
f7dc2ae5,9,492,5.5,4,3,5,8,8,4,4,6.2,6.7,-0.6,24,SPA
f7e87032,24,1691,18.8,21,4,3,0,38,22,16,29.6,25.2,4.4,24,SPA
f814e5d3,7,155,1.7,1,1,6,19,3,4,-1,2.0,3.7,-1.7,24,SPA
f8405304,11,249,2.8,1,1,10,6,5,7,-2,5.2,4.0,1.2,24,SPA
f874dd44,19,1476,16.4,18,14,1,4,20,17,3,18.9,19.8,-0.9,24,SPA
f8eca1b6,3,140,1.6,1,1,2,1,2,3,-1,1.6,2.1,-0.5,24,SPA
fb938d24,2,17,0.2,0,0,2,1,1,0,1,0.1,0.0,0.0,24,SPA
fbbb9269,6,537,6.0,6,5,0,3,10,11,-1,5.1,8.9,-3.8,24,SPA
fbd6378b,14,952,10.6,10,9,4,10,19,19,0,15.7,15.2,0.5,24,SPA
fc627681,12,1080,12.0,12,12,0,0,10,20,-10,13.4,17.4,-4.0,24,SPA
fc647b34,24,1019,11.3,13,0,11,2,12,15,-3,14.2,17.0,-2.8,24,SPA
fc70e345,30,2700,30.0,30,30,0,0,25,38,-13,33.1,37.4,-4.3,24,SPA
fc8b614b,2,19,0.2,0,0,2,23,0,0,0,0.0,0.1,-0.1,24,SPA
fce2302c,15,982,10.9,11,2,4,3,14,10,4,11.9,11.8,0.2,24,SPA
fce521d7,28,2070,23.0,23,13,5,1,27,49,-22,27.0,36.6,-9.6,24,SPA
fd51b456,23,1036,11.5,10,7,13,7,25,9,16,22.7,10.5,12.2,24,SPA
fdd26d71,8,101,1.1,1,0,7,17,4,5,-1,1.9,2.0,-0.1,24,SPA
fe6e7156,29,2353,26.1,28,13,1,0,54,31,23,46.2,35.3,11.0,24,SPA
fea23125,4,282,3.1,3,3,1,25,2,2,0,1.8,4.2,-2.4,24,SPA
ffacd3d5,24,1677,18.6,18,13,6,6,18,25,-7,21.9,27.6,-5.7,24,SPA
00459419,4,192,2.1,2,0,2,1,3,4,-1,3.8,3.9,-0.1,24,CL
0076ab7f,6,540,6.0,6,6,0,0,7,12,-5,5.9,10.8,-4.9,24,CL
008042f3,1,13,0.1,0,0,1,5,1,1,0,0.1,0.9,-0.8,24,CL
009a4f60,5,450,5.0,5,5,0,0,6,4,2,5.7,8.2,-2.6,24,CL
00a8d210,6,527,5.9,6,5,0,0,6,11,-5,5.4,7.3,-1.9,24,CL
016cb21b,5,266,3.0,4,0,1,0,3,6,-3,2.9,4.9,-2.0,24,CL
01bb93d5,3,41,0.5,0,0,3,1,2,0,2,1.5,0.4,1.1,24,CL
01e5f06e,5,194,2.2,2,1,3,1,4,3,1,5.1,2.2,2.9,24,CL
01eb744d,8,268,3.0,2,1,6,0,9,2,7,5.4,3.6,1.8,24,CL
02a5618e,1,8,0.1,0,0,1,5,1,0,1,0.3,0.2,0.1,24,CL
02c15616,7,468,5.2,4,2,3,1,10,3,7,7.6,6.3,1.3,24,CL
02caf6e0,7,425,4.7,3,2,4,1,7,2,5,8.5,6.0,2.5,24,CL
02ce2030,1,64,0.7,1,0,0,5,0,2,-2,0.5,0.5,0.0,24,CL
0355010f,2,55,0.6,0,0,2,2,0,4,-4,0.0,2.2,-2.2,24,CL
037f2523,4,111,1.2,1,0,3,1,1,2,-1,1.7,2.3,-0.5,24,CL
03998238,6,475,5.3,6,1,0,0,10,12,-2,6.6,9.2,-2.6,24,CL
042e8a49,6,421,4.7,5,0,1,0,9,4,5,6.9,5.1,1.8,24,CL
046ca6db,1,57,0.6,1,0,0,3,1,3,-2,0.6,0.6,-0.1,24,CL
048a1cbc,4,231,2.6,3,1,1,1,3,1,2,5.0,2.2,2.8,24,CL
04e17fd5,6,512,5.7,6,4,0,0,7,10,-3,5.6,9.6,-4.0,24,CL
05439de2,3,250,2.8,3,2,0,2,6,3,3,9.1,2.5,6.6,24,CL
056d2d95,3,126,1.4,1,1,2,3,1,2,-1,0.8,0.9,-0.1,24,CL
05d548d8,8,720,8.0,8,8,0,0,10,5,5,10.3,13.7,-3.3,24,CL
0670ee51,3,154,1.7,2,1,1,0,1,4,-3,0.7,3.4,-2.6,24,CL
068f4dec,6,192,2.1,1,1,5,2,1,0,1,3.0,1.5,1.5,24,CL
06c48679,6,510,5.7,6,4,0,0,6,10,-4,6.0,6.3,-0.3,24,CL
08273d48,1,45,0.5,0,0,1,5,0,0,0,0.1,0.7,-0.6,24,CL
08452314,4,74,0.8,0,0,4,0,2,1,1,1.6,1.4,0.2,24,CL
08511d65,5,450,5.0,5,5,0,0,7,10,-3,5.9,9.3,-3.4,24,CL
08990838,8,707,7.9,8,7,0,0,8,14,-6,8.3,12.6,-4.3,24,CL
089c7323,6,397,4.4,6,1,0,0,5,6,-1,7.1,5.5,1.6,24,CL
08f5afaa,8,720,8.0,8,8,0,0,13,9,4,16.0,7.8,8.2,24,CL
08fe932d,3,93,1.0,1,0,2,3,2,0,2,1.1,1.4,-0.3,24,CL
091c86e2,5,297,3.3,2,1,3,0,4,2,2,4.6,4.7,-0.2,24,CL
0959c2a2,8,597,6.6,7,5,1,0,15,7,8,14.3,9.1,5.2,24,CL
0a084b35,5,414,4.6,5,3,0,0,5,8,-3,4.8,10.6,-5.8,24,CL
0a69de7b,2,165,1.8,2,1,0,2,1,4,-3,1.3,2.9,-1.6,24,CL
0a89e877,6,491,5.5,6,4,0,1,9,5,4,9.2,5.8,3.4,24,CL
0ab1f153,2,113,1.3,1,1,1,1,1,0,1,1.9,0.8,1.0,24,CL
0af4dcf0,2,38,0.4,0,0,2,4,1,2,-1,1.3,1.3,0.0,24,CL
0b059e15,2,107,1.2,1,1,1,1,3,2,1,1.5,1.5,0.0,24,CL
0b5a292a,4,212,2.4,3,0,1,2,3,3,0,2.3,2.5,-0.1,24,CL
0c61c77c,4,246,2.7,3,1,1,1,4,5,-1,3.6,6.3,-2.7,24,CL
0ca476cc,1,9,0.1,0,0,1,3,0,1,-1,0.2,0.6,-0.4,24,CL
0caa2fd4,8,649,7.2,8,4,0,0,7,11,-4,9.5,9.7,-0.2,24,CL
0d267745,6,540,6.0,6,6,0,0,7,11,-4,7.8,15.9,-8.1,24,CL
0d7b6576,6,455,5.1,6,1,0,0,5,10,-5,3.8,5.5,-1.7,24,CL
0d9b2d31,4,238,2.6,2,1,2,0,4,3,1,3.8,3.0,0.7,24,CL
0db169ae,3,161,1.8,2,0,1,0,3,1,2,1.2,2.2,-1.0,24,CL
0de73fa4,6,380,4.2,4,3,2,0,4,10,-6,4.6,7.1,-2.5,24,CL
0e09dd0d,6,540,6.0,6,6,0,0,10,12,-2,7.4,10.9,-3.5,24,CL
0e6bc38c,4,38,0.4,0,0,4,3,1,2,-1,1.3,1.6,-0.3,24,CL
0f41e2ee,5,435,4.8,4,4,1,1,7,9,-2,7.0,13.4,-6.3,24,CL
0f422610,1,64,0.7,1,0,0,3,1,3,-2,0.4,1.7,-1.3,24,CL
0fa11d7d,3,161,1.8,1,1,2,3,3,2,1,3.4,5.3,-1.9,24,CL
0fdcef0e,6,205,2.3,2,1,4,2,4,4,0,4.8,3.3,1.5,24,CL
10745192,4,158,1.8,2,0,2,4,3,2,1,3.2,4.8,-1.6,24,CL
112521d1,4,327,3.6,4,2,0,2,3,5,-2,3.0,5.5,-2.5,24,CL
114bbdee,2,95,1.1,1,1,1,2,1,3,-2,0.4,1.7,-1.2,24,CL
116c35df,7,444,4.9,6,0,1,1,4,4,0,5.7,8.3,-2.6,24,CL
1227a22d,4,314,3.5,3,3,1,2,4,9,-5,4.1,8.1,-4.0,24,CL
129af0db,8,557,6.2,6,2,2,0,15,7,8,10.3,7.4,2.9,24,CL
12e6d21a,4,158,1.8,2,0,2,2,3,4,-1,2.2,2.7,-0.5,24,CL
13203c45,4,264,2.9,3,2,1,1,4,6,-2,2.7,5.9,-3.2,24,CL
136958ad,5,134,1.5,1,0,4,1,2,5,-3,1.8,3.5,-1.7,24,CL
15413fa5,7,431,4.8,4,3,3,1,8,1,7,6.3,7.4,-1.1,24,CL
1598599e,6,366,4.1,6,0,0,0,3,9,-6,2.7,4.2,-1.6,24,CL
15ab5a2b,5,248,2.8,2,2,3,3,12,2,10,6.8,2.1,4.7,24,CL
15b287da,7,258,2.9,3,1,4,1,4,2,2,3.3,3.1,0.2,24,CL
15fd5593,4,84,0.9,1,0,3,4,2,3,-1,2.0,1.6,0.4,24,CL
162efffd,6,449,5.0,6,2,0,0,9,6,3,7.1,6.4,0.7,24,CL
16aa3654,8,559,6.2,7,2,1,0,8,5,3,9.1,4.6,4.5,24,CL
16ceb862,6,510,5.7,6,4,0,0,4,8,-4,8.2,7.4,0.9,24,CL
172bab0a,5,384,4.3,5,2,0,0,3,12,-9,4.0,7.1,-3.1,24,CL
175bef1f,6,487,5.4,6,4,0,0,6,14,-8,7.3,13.4,-6.1,24,CL
17695062,3,45,0.5,0,0,3,3,1,0,1,1.2,0.2,1.0,24,CL
17e1261b,3,138,1.5,0,0,3,3,2,2,0,2.2,2.5,-0.3,24,CL
18b896d6,7,560,6.2,6,6,1,0,16,7,9,13.2,7.8,5.5,24,CL
18fae4ac,7,576,6.4,7,4,0,0,6,10,-4,7.8,8.5,-0.7,24,CL
19cae58d,3,226,2.5,3,0,0,0,5,1,4,3.0,1.6,1.3,24,CL
19cda00b,5,412,4.6,5,1,0,0,7,10,-3,7.1,14.1,-6.9,24,CL
1a4b9094,1,13,0.1,0,0,1,4,1,0,1,0.6,0.0,0.6,24,CL
1a799243,3,218,2.4,3,1,0,3,1,2,-1,1.4,3.6,-2.2,24,CL
1a7a4d84,6,540,6.0,6,6,0,0,7,15,-8,8.7,14.8,-6.1,24,CL
1adcf39e,5,450,5.0,5,5,0,0,9,9,0,6.9,9.0,-2.2,24,CL
1b82f8df,6,539,6.0,6,5,0,0,8,8,0,7.6,8.1,-0.5,24,CL
1bacc518,3,237,2.6,3,2,0,0,7,2,5,3.6,2.2,1.5,24,CL
1bf33a9a,6,440,4.9,5,2,1,0,4,8,-4,6.5,7.0,-0.4,24,CL
1c7012b8,8,658,7.3,7,5,1,0,15,4,11,10.7,4.1,6.6,24,CL
1cb49278,6,424,4.7,5,3,1,2,10,6,4,7.1,4.6,2.5,24,CL
1d1691ad,3,97,1.1,1,0,2,1,0,1,-1,0.7,1.1,-0.3,24,CL
1e1378e1,6,392,4.4,4,4,2,0,2,6,-4,4.1,8.8,-4.7,24,CL
1f44ac21,7,596,6.6,7,4,0,0,21,7,14,18.3,3.6,14.7,24,CL
1fc08838,1,5,0.1,0,0,1,5,0,0,0,0.0,0.5,-0.5,24,CL
20030c06,2,180,2.0,2,2,0,0,1,2,-1,2.4,2.2,0.2,24,CL
200e89e1,7,397,4.4,5,0,2,0,8,2,6,8.0,2.5,5.5,24,CL
20730eae,5,441,4.9,5,3,0,0,4,5,-1,6.6,5.7,0.9,24,CL
21166ff4,2,59,0.7,0,0,2,2,2,0,2,1.2,0.3,0.8,24,CL
213f0daf,7,585,6.5,7,4,0,0,9,10,-1,7.2,11.1,-3.9,24,CL
2146785a,6,428,4.8,5,3,1,0,5,7,-2,8.5,6.9,1.6,24,CL
21512407,6,512,5.7,6,5,0,0,6,6,0,5.7,11.0,-5.3,24,CL
21a66f6a,8,708,7.9,8,6,0,0,14,5,9,12.9,8.1,4.9,24,CL
2200181e,5,380,4.2,5,1,0,1,7,9,-2,7.3,7.9,-0.5,24,CL
22798128,6,276,3.1,3,0,3,0,3,4,-1,2.6,4.9,-2.3,24,CL
228b0d9d,6,474,5.3,5,4,1,0,6,2,4,7.5,3.7,3.8,24,CL
230a2fac,8,720,8.0,8,8,0,0,12,13,-1,10.5,11.6,-1.1,24,CL
232b3da4,3,209,2.3,3,0,0,3,2,7,-5,2.6,7.5,-4.9,24,CL
23610943,8,653,7.3,8,4,0,0,16,7,9,10.5,8.8,1.8,24,CL
24051310,4,307,3.4,4,2,0,0,10,6,4,7.3,3.9,3.4,24,CL
242e1043,6,540,6.0,6,6,0,0,9,10,-1,10.6,8.0,2.6,24,CL
24fc70d3,5,450,5.0,5,5,0,1,6,11,-5,4.8,14.5,-9.7,24,CL
25146df0,6,493,5.5,6,4,0,0,4,8,-4,7.3,10.6,-3.3,24,CL
262e5a82,5,58,0.6,0,0,5,1,0,0,0,0.3,1.7,-1.4,24,CL
2658c82f,2,117,1.3,1,1,1,4,3,0,3,3.7,0.9,2.8,24,CL
26777636,3,123,1.4,1,0,2,3,1,4,-3,2.1,2.1,-0.1,24,CL
26a2dc36,1,18,0.2,0,0,1,0,0,0,0,0.5,0.0,0.5,24,CL
277da414,8,720,8.0,8,8,0,0,8,10,-2,10.6,11.7,-1.1,24,CL
28c6e925,4,272,3.0,3,2,1,4,5,6,-1,1.7,5.1,-3.4,24,CL
28d596a0,4,360,4.0,4,4,0,2,9,5,4,8.9,4.8,4.1,24,CL
2946f9a1,8,616,6.8,7,6,1,0,14,6,8,13.0,8.7,4.4,24,CL
29fbdc88,5,205,2.3,2,0,3,0,3,3,0,3.3,3.0,0.3,24,CL
2a0c8ba4,2,81,0.9,1,0,1,3,0,4,-4,0.1,2.4,-2.3,24,CL
2a295d33,6,415,4.6,5,2,1,1,10,4,6,5.8,6.2,-0.4,24,CL
2a7d27c1,7,452,5.0,4,4,3,0,8,5,3,9.9,4.9,4.9,24,CL
2b0852db,3,206,2.3,3,1,0,0,3,4,-1,3.8,4.5,-0.8,24,CL
2b114be3,8,607,6.7,7,1,1,0,11,4,7,11.4,7.1,4.4,24,CL
2b8360f1,1,1,0.0,0,0,1,0,0,0,0,0.1,0.1,0.0,24,CL
2bd83368,6,437,4.9,5,2,1,0,6,5,1,5.5,9.8,-4.3,24,CL
2bef2bca,6,540,6.0,6,6,0,0,9,5,4,10.0,5.8,4.2,24,CL
2c0558b8,7,524,5.8,7,2,0,0,10,4,6,9.2,6.0,3.2,24,CL
2c0f8e9e,8,335,3.7,4,0,4,0,6,4,2,8.3,3.0,5.3,24,CL
2c56a792,6,222,2.5,2,0,4,1,1,1,0,2.2,1.6,0.6,24,CL
2c6835e5,3,170,1.9,2,1,1,2,2,2,0,3.1,5.0,-1.9,24,CL
2cf496fb,3,182,2.0,2,2,1,1,1,3,-2,2.2,4.4,-2.1,24,CL
2cfae697,7,621,6.9,7,6,0,0,7,12,-5,8.7,9.9,-1.2,24,CL
2d970560,6,440,4.9,5,3,1,0,4,7,-3,4.5,10.1,-5.6,24,CL
2e31f3a6,1,59,0.7,1,0,0,3,1,2,-1,0.6,0.9,-0.3,24,CL
2ef08833,2,24,0.3,0,0,2,6,1,1,0,0.9,0.9,0.0,24,CL
2f18d0b8,2,180,2.0,2,2,0,4,4,3,1,4.0,1.1,2.8,24,CL
2f3452eb,5,340,3.8,5,1,0,3,3,5,-2,3.1,4.4,-1.4,24,CL
2ffa6348,2,91,1.0,1,1,1,2,1,1,0,1.3,1.0,0.4,24,CL
3061e1ec,4,360,4.0,4,4,0,4,9,3,6,8.3,5.2,3.1,24,CL
30941e96,6,424,4.7,5,1,1,0,8,9,-1,5.9,7.7,-1.8,24,CL
30ae134d,5,299,3.3,4,1,1,1,5,6,-1,2.7,6.9,-4.2,24,CL
30d75bfb,6,540,6.0,6,6,0,0,5,15,-10,4.9,11.7,-6.8,24,CL
30f5ffa9,6,538,6.0,6,5,0,0,9,8,1,13.3,6.3,7.0,24,CL
31c69ef1,7,555,6.2,7,4,0,1,18,7,11,18.7,3.3,15.4,24,CL
31dce0c8,6,409,4.5,5,2,1,0,5,13,-8,5.1,7.5,-2.3,24,CL
3260690c,8,404,4.5,4,1,4,0,7,7,0,6.5,5.4,1.1,24,CL
3353737a,2,152,1.7,2,1,0,3,3,4,-1,2.5,3.1,-0.6,24,CL
335fa267,4,143,1.6,1,0,3,2,2,2,0,3.4,2.0,1.4,24,CL
3423f250,5,305,3.4,4,0,1,1,9,3,6,5.5,2.8,2.7,24,CL
343c0d52,6,97,1.1,1,0,5,2,1,2,-1,2.1,1.2,0.9,24,CL
34a0f5ff,1,12,0.1,0,0,1,5,1,1,0,1.2,0.8,0.4,24,CL
34e12499,7,526,5.8,6,5,1,0,5,4,1,6.7,9.1,-2.4,24,CL
35e413f1,8,574,6.4,5,5,3,0,10,2,8,9.4,3.2,6.2,24,CL
36a3ff67,8,417,4.6,5,1,3,0,7,3,4,6.9,8.9,-2.0,24,CL
37337aea,4,347,3.9,4,3,0,0,5,6,-1,6.6,5.7,0.9,24,CL
374ee424,8,720,8.0,8,8,0,0,8,6,2,10.3,6.4,3.9,24,CL
378825c7,5,375,4.2,4,4,1,3,5,2,3,6.2,8.1,-1.9,24,CL
37d0048f,1,5,0.1,0,0,1,5,1,0,1,0.0,0.0,0.0,24,CL
37dc1a48,4,64,0.7,0,0,4,3,1,1,0,1.4,1.8,-0.4,24,CL
38ceb24a,7,483,5.4,6,1,1,1,8,3,5,6.4,4.1,2.3,24,CL
395451fc,4,283,3.1,4,2,0,0,3,7,-4,2.3,4.6,-2.3,24,CL
3963c25b,3,172,1.9,2,1,1,5,3,4,-1,3.9,2.9,1.0,24,CL
39e1138f,6,540,6.0,6,6,0,0,9,10,-1,10.6,8.0,2.6,24,CL
3a089320,2,113,1.3,1,0,1,0,1,2,-1,0.9,2.8,-1.9,24,CL
3a949a25,1,90,1.0,1,1,0,4,1,2,-1,1.8,1.9,-0.1,24,CL
3b029691,8,554,6.2,6,4,2,0,12,5,7,12.4,5.4,7.0,24,CL
3b12b11f,1,4,0.0,0,0,1,5,0,1,-1,0.0,0.6,-0.6,24,CL
3b387cc7,1,22,0.2,0,0,1,5,0,0,0,0.2,0.3,-0.1,24,CL
3b61c9ec,4,161,1.8,2,1,2,3,0,4,-4,1.0,4.3,-3.2,24,CL
3bb7b8b4,6,540,6.0,6,6,0,1,18,5,13,18.0,3.2,14.8,24,CL
3c6089ab,7,340,3.8,3,1,4,1,8,4,4,8.8,4.4,4.4,24,CL
3ca7254a,8,193,2.1,1,0,7,0,5,3,2,4.3,2.8,1.5,24,CL
3cd7820a,5,399,4.4,4,3,1,0,4,8,-4,6.5,9.6,-3.2,24,CL
3ce20eda,4,360,4.0,4,4,0,1,9,3,6,6.0,3.0,2.9,24,CL
3cefcaef,6,392,4.4,4,2,2,2,9,3,6,8.1,5.2,2.9,24,CL
3d99999d,1,8,0.1,0,0,1,7,1,0,1,0.2,0.4,-0.1,24,CL
3dd738a1,2,100,1.1,1,1,1,3,2,1,1,1.4,1.8,-0.3,24,CL
3e2bbae6,6,47,0.5,0,0,6,2,0,1,-1,1.2,1.5,-0.3,24,CL
3ea50f67,1,1,0.0,0,0,1,0,0,0,0,0.1,0.0,0.1,24,CL
3ead85f9,6,540,6.0,6,6,0,0,6,8,-2,7.4,10.0,-2.6,24,CL
3eb22ec9,6,324,3.6,4,1,2,2,9,5,4,9.9,1.4,8.5,24,CL
3ec9f005,7,318,3.5,3,0,4,0,7,6,1,6.5,4.7,1.8,24,CL
3ee0dd59,8,712,7.9,8,7,0,0,7,6,1,10.0,6.0,4.0,24,CL
3ef0a2d7,2,180,2.0,2,2,0,0,2,2,0,3.9,2.6,1.3,24,CL
3effaa34,2,92,1.0,1,0,1,3,1,2,-1,1.0,1.4,-0.4,24,CL
3f10bd22,4,218,2.4,3,0,1,1,4,2,2,3.4,4.1,-0.8,24,CL
3f5f38fb,2,180,2.0,2,2,0,4,1,5,-4,3.2,3.4,-0.2,24,CL
3fc45c73,3,261,2.9,3,2,0,4,5,3,2,4.7,2.6,2.0,24,CL
402b0928,1,9,0.1,0,0,1,3,0,0,0,0.3,0.2,0.1,24,CL
403f5d20,7,611,6.8,7,4,0,1,5,11,-6,7.7,9.5,-1.8,24,CL
407db0d5,6,494,5.5,6,3,0,0,4,8,-4,6.8,10.8,-4.1,24,CL
407feb71,5,242,2.7,3,0,2,3,8,3,5,7.5,3.8,3.7,24,CL
4123bc9a,1,9,0.1,0,0,1,5,0,0,0,0.0,0.1,-0.1,24,CL
4142f132,6,312,3.5,2,0,4,0,3,7,-4,2.7,7.2,-4.5,24,CL
414b2ce4,6,127,1.4,0,0,6,0,5,4,1,3.6,2.9,0.6,24,CL
415568b5,4,221,2.5,2,1,2,1,3,7,-4,2.9,5.9,-2.9,24,CL
41c12f75,6,328,3.6,3,2,3,0,5,6,-1,5.4,5.3,0.0,24,CL
41f0b196,6,540,6.0,6,6,0,0,7,11,-4,7.8,15.9,-8.1,24,CL
41f32541,4,328,3.6,4,2,0,0,3,5,-2,3.2,5.3,-2.1,24,CL
420c18a1,7,660,7.3,7,7,0,1,7,4,3,13.2,7.0,6.2,24,CL
42fd9c7f,8,720,8.0,8,8,0,0,13,9,4,16.0,7.8,8.2,24,CL
433dc9a2,2,111,1.2,1,0,1,0,0,2,-2,0.4,3.9,-3.5,24,CL
437f2b00,6,118,1.3,0,0,6,2,4,6,-2,2.4,2.9,-0.5,24,CL
43b78598,6,518,5.8,6,5,0,0,9,11,-2,9.6,9.4,0.2,24,CL
44150beb,5,123,1.4,0,0,5,2,1,1,0,1.5,1.7,-0.2,24,CL
4431aed2,8,502,5.6,7,1,1,0,6,8,-2,6.7,7.7,-1.0,24,CL
44ac04e9,6,469,5.2,6,2,0,0,3,9,-6,4.7,9.0,-4.3,24,CL
450ab6fc,5,450,5.0,5,5,0,1,6,7,-1,5.6,10.4,-4.8,24,CL
4567a0b4,6,233,2.6,2,0,4,0,1,3,-2,4.6,6.2,-1.6,24,CL
45736cec,5,190,2.1,2,0,3,1,6,2,4,3.3,2.6,0.7,24,CL
45a03961,5,480,5.3,5,5,0,0,6,4,2,10.5,5.5,5.0,24,CL
45af8a54,3,37,0.4,0,0,3,0,1,0,1,1.6,0.4,1.2,24,CL
45c29ae7,5,405,4.5,5,1,0,0,4,9,-5,6.4,7.8,-1.4,24,CL
45db685d,7,399,4.4,4,2,3,1,7,3,4,6.1,2.6,3.5,24,CL
4658e309,1,8,0.1,0,0,1,1,0,1,-1,0.0,1.5,-1.5,24,CL
466fb2c5,1,90,1.0,1,1,0,7,1,1,0,1.0,1.3,-0.4,24,CL
47420f02,5,388,4.3,5,2,0,1,7,6,1,5.5,7.2,-1.7,24,CL
47a34c4f,2,62,0.7,1,0,1,6,1,1,0,0.3,1.2,-0.9,24,CL
47fd5136,5,343,3.8,4,3,1,1,7,8,-1,4.8,6.5,-1.7,24,CL
481c9ece,5,320,3.6,4,1,1,1,6,3,3,6.2,3.6,2.6,24,CL
4876c9ab,6,469,5.2,5,4,1,0,9,9,0,9.8,6.7,3.1,24,CL
48a5a5d6,4,349,3.9,4,2,0,0,10,2,8,6.4,2.1,4.3,24,CL
491a433d,6,485,5.4,6,2,0,0,10,11,-1,8.7,9.4,-0.7,24,CL
49296448,8,720,8.0,8,8,0,0,15,7,8,13.8,8.9,5.0,24,CL
4958bfb2,6,467,5.2,5,5,1,0,11,6,5,7.4,7.6,-0.2,24,CL
49fe9070,4,50,0.6,0,0,4,0,2,2,0,1.3,1.3,0.1,24,CL
4a5839fa,3,269,3.0,3,2,0,5,6,6,0,4.3,4.6,-0.3,24,CL
4b3e1a38,7,552,6.1,7,6,0,0,8,9,-1,7.5,8.9,-1.4,24,CL
4b40d9ca,5,450,5.0,5,5,0,0,5,5,0,4.1,10.4,-6.3,24,CL
4b511457,7,343,3.8,4,1,3,1,6,4,2,7.8,3.8,4.0,24,CL
4b5ed2f7,6,540,6.0,6,6,0,0,5,15,-10,4.9,11.7,-6.8,24,CL
4b96c347,6,290,3.2,3,1,3,0,2,9,-7,3.1,5.1,-2.0,24,CL
4c2a5d34,7,545,6.1,6,4,1,0,14,8,6,8.8,6.0,2.8,24,CL
4c53a688,2,15,0.2,0,0,2,1,0,1,-1,0.5,0.0,0.5,24,CL
4c6facae,6,370,4.1,5,1,1,0,6,10,-4,4.3,7.6,-3.3,24,CL
4c82730b,5,373,4.1,5,2,0,0,4,10,-6,5.4,12.4,-7.0,24,CL
4d1666ff,6,540,6.0,6,6,0,1,14,6,8,10.4,6.0,4.4,24,CL
4d1c4a5d,3,35,0.4,0,0,3,5,1,0,1,0.0,0.2,-0.2,24,CL
4d224fe8,2,166,1.8,2,1,0,0,5,6,-1,3.7,3.3,0.4,24,CL
4d8cd038,2,32,0.4,0,0,2,4,1,0,1,1.9,0.5,1.3,24,CL
4dd2a0be,8,552,6.1,7,0,1,0,8,9,-1,6.0,10.1,-4.1,24,CL
4dedd469,6,415,4.6,5,2,1,0,5,12,-7,6.4,12.1,-5.7,24,CL
4e219ad2,2,82,0.9,1,0,1,2,0,0,0,0.9,2.0,-1.1,24,CL
4e5a4cbc,2,180,2.0,2,2,0,0,2,6,-4,1.5,4.1,-2.6,24,CL
4f16405e,8,618,6.9,7,2,1,0,10,3,7,9.9,11.0,-1.1,24,CL
4f1e6a0b,3,177,2.0,2,1,1,0,0,2,-2,0.7,4.9,-4.2,24,CL
4f255115,5,354,3.9,4,3,1,0,5,3,2,5.2,5.1,0.1,24,CL
4f565d77,4,129,1.4,1,1,3,2,3,2,1,2.7,1.1,1.6,24,CL
4fac8f81,6,540,6.0,6,6,0,0,9,10,-1,10.6,8.0,2.6,24,CL
4fb17e20,6,540,6.0,6,6,0,0,5,15,-10,4.9,11.7,-6.8,24,CL
501055d8,7,362,4.0,3,1,4,0,6,3,3,4.9,7.4,-2.5,24,CL
507c7bdf,6,540,6.0,6,6,0,0,12,15,-3,10.5,11.4,-0.9,24,CL
50f9bec6,4,285,3.2,3,3,1,2,5,5,0,3.8,4.7,-0.9,24,CL
515ebe8d,2,90,1.0,1,0,1,3,1,1,0,0.8,0.7,0.1,24,CL
5167c97e,4,118,1.3,1,1,3,1,0,6,-6,1.3,2.9,-1.6,24,CL
51cf8561,5,233,2.6,3,0,2,2,10,2,8,4.8,1.5,3.3,24,CL
52611641,6,496,5.5,6,4,0,0,8,12,-4,6.8,9.2,-2.4,24,CL
5294a83f,8,642,7.1,8,3,0,0,6,10,-4,9.4,10.5,-1.1,24,CL
52ec54d0,3,259,2.9,3,2,0,1,4,5,-1,3.3,5.1,-1.8,24,CL
52f7e3a7,2,22,0.2,0,0,2,5,0,1,-1,0.4,0.9,-0.5,24,CL
530e7d85,1,78,0.9,1,0,0,5,0,1,-1,0.9,1.4,-0.5,24,CL
53cad200,4,155,1.7,1,1,3,3,5,2,3,2.0,2.9,-0.9,24,CL
53d93280,4,360,4.0,4,4,0,0,5,7,-2,6.7,6.9,-0.2,24,CL
543b9811,1,21,0.2,0,0,1,4,0,0,0,0.4,0.2,0.2,24,CL
54b4dc4e,2,61,0.7,1,0,1,4,0,2,-2,0.9,0.9,0.0,24,CL
55126f3b,7,591,6.6,6,5,1,0,16,7,9,10.9,8.1,2.9,24,CL
555f3a0b,8,727,8.1,8,7,0,0,19,7,12,12.3,9.5,2.8,24,CL
55a1cac2,4,149,1.7,2,0,2,2,1,1,0,4.2,1.3,2.8,24,CL
570bb4b9,2,100,1.1,1,0,1,0,2,2,0,1.6,2.0,-0.4,24,CL
5715bb71,5,245,2.7,2,1,3,2,5,1,4,4.6,3.0,1.6,24,CL
577efaec,8,532,5.9,6,3,2,0,14,7,7,8.8,6.2,2.7,24,CL
57d88cf9,6,532,5.9,6,4,0,1,14,8,6,12.3,7.0,5.3,24,CL
5853ac44,2,33,0.4,0,0,2,1,0,2,-2,0.1,1.0,-0.9,24,CL
58a05c2e,6,167,1.9,2,0,4,0,4,3,1,3.1,3.8,-0.7,24,CL
58a9a4d9,3,101,1.1,1,0,2,3,2,4,-2,1.1,3.0,-1.9,24,CL
5976f83e,8,647,7.2,7,7,1,0,8,12,-4,9.8,10.5,-0.8,24,CL
59948ef7,3,114,1.3,1,0,2,0,2,1,1,1.3,1.5,-0.2,24,CL
59e4b92e,4,290,3.2,4,0,0,0,3,5,-2,2.4,5.9,-3.5,24,CL
5a2cb25d,5,325,3.6,4,1,1,0,6,7,-1,4.8,6.5,-1.7,24,CL
5ad50391,4,359,4.0,4,3,0,3,12,4,8,8.1,2.2,5.9,24,CL
5b3d1a7a,7,649,7.2,7,3,0,0,14,9,5,8.8,7.0,1.8,24,CL
5b9512c5,7,619,6.9,7,6,0,1,14,11,3,10.7,8.9,1.8,24,CL
5bc43860,6,137,1.5,1,0,5,0,1,4,-3,1.5,3.1,-1.6,24,CL
5c4dc0ff,3,63,0.7,0,0,3,2,1,0,1,0.7,0.3,0.4,24,CL
5c7845f6,8,692,7.7,8,6,0,0,7,6,1,9.7,6.0,3.7,24,CL
5caa62a7,5,371,4.1,4,3,1,0,4,9,-5,5.3,8.4,-3.1,24,CL
5ccc9672,6,331,3.7,3,3,3,0,8,3,5,6.6,3.8,2.8,24,CL
5cdddffa,4,92,1.0,1,0,3,2,3,3,0,1.4,1.4,0.0,24,CL
5d51b074,6,498,5.5,6,4,0,0,7,13,-6,5.9,14.4,-8.4,24,CL
5d9cff53,6,540,6.0,6,6,0,0,10,13,-3,9.8,10.2,-0.4,24,CL
5dfc6ad5,8,706,7.8,8,6,0,0,19,7,12,12.0,9.5,2.5,24,CL
5e861944,8,576,6.4,8,0,0,0,11,8,3,8.2,7.6,0.6,24,CL
5ea8ef20,8,495,5.5,4,4,4,0,6,6,0,8.4,9.2,-0.8,24,CL
5eecec3d,4,242,2.7,3,1,1,3,8,2,6,6.7,1.6,5.1,24,CL
5ef3d210,8,241,2.7,2,0,6,0,3,2,1,3.6,1.9,1.7,24,CL
5f09991f,2,99,1.1,1,1,1,6,2,1,1,2.3,1.1,1.2,24,CL
6025fab1,6,316,3.5,3,2,3,1,6,3,3,6.5,3.7,2.9,24,CL
60d90c55,6,540,6.0,6,6,0,0,6,11,-5,6.1,7.5,-1.4,24,CL
61e65971,3,62,0.7,1,0,2,2,0,3,-3,0.4,0.8,-0.4,24,CL
62182b1d,8,720,8.0,8,8,0,0,10,14,-4,9.1,12.8,-3.7,24,CL
6265208f,7,257,2.9,2,2,5,0,7,2,5,9.1,2.1,7.1,24,CL
6412cc03,3,89,1.0,0,0,3,3,1,1,0,1.5,0.5,1.0,24,CL
6434f10d,6,486,5.4,6,3,0,2,18,7,11,15.9,3.1,12.8,24,CL
649b01d8,1,90,1.0,1,1,0,7,3,3,0,3.0,1.6,1.3,24,CL
64f69877,5,235,2.6,2,1,3,1,2,5,-3,2.8,6.9,-4.1,24,CL
65154df0,6,273,3.0,2,1,4,2,8,2,6,5.4,2.9,2.5,24,CL
6603fed7,6,500,5.6,6,3,0,0,5,12,-7,7.8,9.2,-1.4,24,CL
6622454d,5,249,2.8,3,0,2,0,3,6,-3,3.7,4.6,-0.9,24,CL
663e080e,5,450,5.0,5,5,0,3,11,9,2,9.1,6.9,2.1,24,CL
66a7effe,4,69,0.8,0,0,4,2,2,1,1,1.1,0.5,0.6,24,CL
6747869d,2,68,0.8,0,0,2,1,1,1,0,0.7,2.5,-1.9,24,CL
674dee62,3,38,0.4,0,0,3,0,0,2,-2,1.1,1.4,-0.3,24,CL
67ac5bb8,8,750,8.3,8,8,0,0,17,5,12,12.1,5.3,6.8,24,CL
6800f515,6,520,5.8,6,5,0,0,5,13,-8,4.9,11.2,-6.3,24,CL
686cbe7d,4,102,1.1,1,0,3,4,0,1,-1,0.7,1.3,-0.6,24,CL
6885cc44,4,212,2.4,2,2,2,1,0,1,-1,1.9,3.5,-1.6,24,CL
689c9cf4,5,324,3.6,4,2,1,1,4,9,-5,4.5,7.9,-3.4,24,CL
68cf59f0,3,31,0.3,0,0,3,3,0,0,0,0.2,0.0,0.2,24,CL
68dc0dac,8,684,7.6,8,4,0,0,8,13,-5,7.9,11.4,-3.6,24,CL
690d1049,4,296,3.3,4,1,0,2,3,9,-6,3.7,9.0,-5.3,24,CL
6928979a,8,468,5.2,4,2,4,0,7,3,4,11.6,5.3,6.3,24,CL
6a829019,4,276,3.1,4,0,0,0,3,9,-6,2.0,8.5,-6.6,24,CL
6b9960cf,7,630,7.0,7,7,0,0,12,8,4,11.6,6.5,5.1,24,CL
6bb2c084,7,627,7.0,7,6,0,0,11,13,-2,10.1,11.2,-1.0,24,CL
6bd5cd5d,3,270,3.0,3,3,0,1,3,5,-2,2.3,4.9,-2.6,24,CL
6c731625,6,115,1.3,0,0,6,0,0,4,-4,1.5,3.2,-1.7,24,CL
6c8ddd52,6,540,6.0,6,6,0,0,10,13,-3,9.8,10.2,-0.4,24,CL
6cbf8d0d,6,213,2.4,1,0,5,0,2,1,1,2.8,3.6,-0.7,24,CL
6cdd9d3d,1,15,0.2,0,0,1,2,1,2,-1,0.9,0.3,0.5,24,CL
6ce1f46f,7,481,5.3,5,3,2,1,15,6,9,12.7,7.0,5.7,24,CL
6ce43701,3,19,0.2,0,0,3,4,0,0,0,0.1,0.4,-0.3,24,CL
6e058f06,8,253,2.8,2,1,6,0,3,5,-2,3.8,3.8,0.0,24,CL
6e33125f,6,540,6.0,6,6,0,0,6,11,-5,6.1,7.5,-1.4,24,CL
6e44569a,5,184,2.0,3,0,2,2,1,3,-2,1.9,3.2,-1.3,24,CL
6f22e535,2,210,2.3,2,2,0,0,1,1,0,1.5,1.3,0.2,24,CL
6f3cc2fe,7,488,5.4,5,0,2,0,10,5,5,7.6,5.1,2.5,24,CL
6f51170f,1,16,0.2,0,0,1,1,1,1,0,0.8,1.2,-0.4,24,CL
6f51e382,6,540,6.0,6,6,0,0,12,4,8,10.9,5.0,6.0,24,CL
6f5ec8bb,6,495,5.5,6,5,0,0,6,10,-4,6.0,6.3,-0.3,24,CL
6f8cd6d0,8,457,5.1,5,1,3,0,5,2,3,8.6,4.1,4.6,24,CL
6fd8a334,6,540,6.0,6,6,0,0,7,15,-8,8.7,14.8,-6.1,24,CL
6fe5c35b,6,540,6.0,6,6,0,0,4,8,-4,7.4,11.4,-3.9,24,CL
70c52749,3,193,2.1,2,2,1,1,3,4,-1,1.7,2.1,-0.4,24,CL
70cf63ca,6,502,5.6,6,1,0,0,7,11,-4,7.6,14.3,-6.7,24,CL
70dcf94d,5,357,4.0,4,1,1,0,5,7,-2,4.6,5.8,-1.2,24,CL
7111d552,5,443,4.9,5,4,0,0,10,4,6,7.8,7.1,0.7,24,CL
7120a04d,5,229,2.5,3,0,2,1,5,5,0,3.4,3.8,-0.4,24,CL
71ec39ef,5,236,2.6,3,0,2,0,3,3,0,1.8,5.2,-3.4,24,CL
722494dc,6,540,6.0,6,6,0,0,6,17,-11,6.2,11.1,-4.9,24,CL
7226539b,4,189,2.1,2,1,2,4,6,3,3,5.6,2.8,2.8,24,CL
72984eee,5,104,1.2,1,0,4,3,4,1,3,2.7,1.7,0.9,24,CL
73d6a176,4,274,3.0,4,1,0,0,3,11,-8,2.0,4.8,-2.8,24,CL
7483d9f9,6,423,4.7,5,3,1,2,3,5,-2,4.9,6.0,-1.1,24,CL
75b86fb3,7,500,5.6,6,4,1,0,6,3,3,11.0,4.9,6.1,24,CL
760fd987,4,325,3.6,3,3,1,2,5,7,-2,4.9,5.0,0.0,24,CL
762179d9,7,630,7.0,7,7,0,0,9,11,-2,7.9,12.0,-4.2,24,CL
7713c72a,4,360,4.0,4,4,0,0,6,7,-1,4.6,7.2,-2.7,24,CL
7767cb03,5,357,4.0,4,0,1,0,3,13,-10,3.2,8.3,-5.1,24,CL
78c3ad07,6,157,1.7,1,0,5,0,1,4,-3,2.6,4.1,-1.6,24,CL
78c513b3,6,540,6.0,6,6,0,0,7,15,-8,8.7,14.8,-6.1,24,CL
78f21137,3,191,2.1,3,1,0,0,0,3,-3,1.9,4.7,-2.9,24,CL
78f85621,3,134,1.5,3,0,0,0,2,2,0,1.6,1.2,0.4,24,CL
79083382,5,428,4.8,5,3,0,1,8,8,0,6.4,7.8,-1.3,24,CL
79300479,7,570,6.3,6,4,1,0,14,4,10,9.7,3.9,5.8,24,CL
79b51257,4,70,0.8,0,0,4,1,1,1,0,2.2,1.5,0.7,24,CL
79c0821a,4,334,3.7,4,2,0,1,11,2,9,8.1,2.4,5.7,24,CL
7a42d0df,6,467,5.2,6,4,0,0,5,10,-5,5.6,6.1,-0.5,24,CL
7aa8adfe,6,301,3.3,3,1,3,0,9,11,-2,6.5,8.2,-1.7,24,CL
7b9c2d84,6,442,4.9,6,3,0,0,8,3,5,8.2,6.4,1.8,24,CL
7c2965bb,1,3,0.0,0,0,1,5,0,0,0,0.1,0.0,0.1,24,CL
7d3e7da6,3,270,3.0,3,3,0,3,9,5,4,4.9,5.2,-0.3,24,CL
7d450ed3,7,630,7.0,7,7,0,1,12,11,1,11.4,9.1,2.3,24,CL
7e0b6c50,1,3,0.0,0,0,1,5,0,0,0,0.6,0.0,0.6,24,CL
7edfbb8a,6,539,6.0,6,5,0,0,5,8,-3,9.6,7.7,1.9,24,CL
7f14ec2a,5,219,2.4,2,1,3,2,0,1,-1,2.2,1.8,0.4,24,CL
7f40333d,5,450,5.0,5,5,0,0,6,15,-9,5.6,8.9,-3.2,24,CL
7fa4e703,2,22,0.2,0,0,2,4,0,0,0,0.0,0.3,-0.3,24,CL
803e7aca,6,463,5.1,6,2,0,0,7,8,-1,8.4,7.0,1.4,24,CL
812e5ded,1,74,0.8,1,0,0,4,1,2,-1,2.7,1.2,1.4,24,CL
81442ecb,3,198,2.2,2,2,1,0,4,7,-3,2.9,5.3,-2.4,24,CL
817c6964,4,211,2.3,2,1,2,1,0,4,-4,3.1,2.1,1.0,24,CL
817ee048,3,94,1.0,1,1,2,3,0,2,-2,1.4,2.2,-0.8,24,CL
819b3158,8,661,7.3,7,7,1,0,15,6,9,13.3,6.9,6.4,24,CL
82464ce3,6,495,5.5,6,5,0,0,6,10,-4,6.0,6.3,-0.3,24,CL
82518f62,6,540,6.0,6,6,0,0,6,7,-1,5.9,12.3,-6.4,24,CL
829aa60c,8,145,1.6,1,0,7,0,4,3,1,2.9,1.8,1.1,24,CL
82a39b66,8,592,6.6,7,3,1,0,12,7,5,8.7,5.8,2.9,24,CL
82e9b1bb,8,720,8.0,8,8,0,0,9,13,-4,11.0,11.0,0.0,24,CL
82ec26c1,8,484,5.4,5,3,3,0,9,6,3,10.2,5.8,4.4,24,CL
83300259,6,451,5.0,5,3,1,0,5,14,-9,4.6,9.2,-4.6,24,CL
839c14e1,1,61,0.7,1,0,0,7,1,1,0,0.3,1.2,-0.9,24,CL
8455ad90,6,255,2.8,2,0,4,0,3,3,0,7.3,4.0,3.2,24,CL
858a54c3,6,356,4.0,5,0,1,0,3,10,-7,5.6,10.0,-4.4,24,CL
85f7d1be,1,90,1.0,1,1,0,0,0,3,-3,0.6,1.3,-0.8,24,CL
862a1c15,6,413,4.6,4,3,2,0,5,6,-1,5.4,10.1,-4.7,24,CL
8652a85c,8,553,6.1,7,1,1,0,10,7,3,10.0,7.7,2.2,24,CL
86dd77d1,5,383,4.3,5,3,0,3,12,5,7,12.7,2.0,10.7,24,CL
86df4d6b,4,236,2.6,3,0,1,3,7,3,4,5.3,1.4,3.9,24,CL
8778c910,5,450,5.0,5,5,0,0,6,2,4,8.9,3.7,5.2,24,CL
881cd6be,3,109,1.2,2,0,1,3,3,6,-3,1.8,5.6,-3.7,24,CL
8830d81d,3,38,0.4,0,0,3,3,0,2,-2,0.0,1.6,-1.6,24,CL
88ce7ddc,4,146,1.6,1,0,3,4,2,3,-1,2.2,2.1,0.1,24,CL
88ced02c,4,299,3.3,3,3,1,0,2,11,-9,1.7,7.5,-5.8,24,CL
88e357ef,4,94,1.0,1,0,3,0,3,2,1,1.7,1.3,0.4,24,CL
89ac64a6,6,464,5.2,5,4,1,2,15,7,8,10.5,4.0,6.5,24,CL
89b2c8a9,5,201,2.2,2,0,3,1,2,7,-5,5.0,3.5,1.5,24,CL
89f951b5,6,459,5.1,5,4,1,0,7,10,-3,5.7,8.6,-2.9,24,CL
8a2248b4,8,720,8.0,8,8,0,0,9,13,-4,11.0,11.0,0.0,24,CL
8aafd64f,7,330,3.7,4,0,3,1,11,2,9,7.8,2.8,5.0,24,CL
8b788c01,4,50,0.6,0,0,4,1,2,3,-1,1.8,1.9,0.0,24,CL
8b8a56ce,1,1,0.0,0,0,1,2,0,0,0,0.0,0.0,0.0,24,CL
8b8e759d,3,50,0.6,0,0,3,5,2,1,1,0.7,0.2,0.6,24,CL
8c3c640c,7,585,6.5,7,3,0,0,7,3,4,8.6,4.3,4.3,24,CL
8c451492,6,205,2.3,1,0,5,0,4,5,-1,5.0,6.2,-1.1,24,CL
8c90fd7a,6,458,5.1,5,2,1,0,9,10,-1,6.9,8.9,-1.9,24,CL
8d3cd59d,7,475,5.3,5,4,2,0,8,5,3,9.6,5.2,4.4,24,CL
8d4baac4,6,516,5.7,6,4,0,0,7,13,-6,6.0,15.0,-9.1,24,CL
8d78e732,7,554,6.2,7,5,0,0,12,6,6,9.9,5.7,4.2,24,CL
8e034340,2,165,1.8,2,1,0,0,2,6,-4,3.1,3.4,-0.3,24,CL
8e6d2fcd,1,90,1.0,1,1,0,5,0,2,-2,0.6,2.2,-1.6,24,CL
8e92be30,5,312,3.5,4,2,1,0,5,3,2,3.0,9.7,-6.7,24,CL
8eb55dbb,6,425,4.8,5,3,1,0,4,8,-4,4.1,6.5,-2.4,24,CL
8eef18aa,5,390,4.3,5,4,0,0,5,9,-4,6.1,7.8,-1.7,24,CL
8f0435c7,4,277,3.1,4,2,0,0,4,7,-3,3.3,7.7,-4.4,24,CL
8f056768,8,624,6.9,7,3,1,0,12,11,1,11.5,9.1,2.4,24,CL
8f5e92a6,8,603,6.7,7,1,1,0,15,7,8,16.1,8.5,7.6,24,CL
8f696594,3,104,1.2,0,0,3,1,3,1,2,2.0,1.6,0.4,24,CL
8f7e6783,6,470,5.2,6,3,0,0,7,7,0,8.6,5.9,2.7,24,CL
8fd9996f,3,158,1.8,2,0,1,4,2,1,1,4.4,1.6,2.7,24,CL
90ba7fa6,4,91,1.0,1,0,3,2,4,1,3,1.9,0.5,1.3,24,CL
90f87966,4,360,4.0,4,4,0,2,2,8,-6,5.6,7.1,-1.5,24,CL
90fcf472,3,55,0.6,0,0,3,3,1,0,1,1.1,0.9,0.3,24,CL
92432bc6,5,266,3.0,3,0,2,2,5,5,0,4.1,4.3,-0.2,24,CL
928a4a61,6,159,1.8,2,0,4,1,0,3,-3,1.0,2.5,-1.4,24,CL
92fa5d28,6,530,5.9,6,4,0,0,7,15,-8,8.7,14.8,-6.1,24,CL
93fffbcf,8,750,8.3,8,8,0,0,16,9,7,11.4,7.7,3.7,24,CL
9413b19f,8,720,8.0,8,8,0,0,12,13,-1,10.5,11.6,-1.1,24,CL
9440e587,5,303,3.4,3,2,2,1,3,4,-1,6.1,7.2,-1.1,24,CL
947e036f,5,129,1.4,0,0,5,1,7,3,4,3.7,2.5,1.2,24,CL
94bccc82,6,451,5.0,5,5,1,2,8,8,0,6.7,7.0,-0.3,24,CL
951f1739,3,33,0.4,0,0,3,3,0,0,0,0.6,0.5,0.1,24,CL
96094cbc,2,51,0.6,1,0,1,4,0,3,-3,0.8,0.8,0.0,24,CL
966e28d0,3,123,1.4,1,1,2,3,3,3,0,0.8,2.0,-1.2,24,CL
9674002f,2,91,1.0,1,0,1,1,2,4,-2,2.3,2.7,-0.4,24,CL
96e0490d,7,407,4.5,4,2,3,1,3,4,-1,8.9,4.9,3.9,24,CL
970b8574,7,364,4.0,4,0,3,1,3,1,2,7.6,3.4,4.2,24,CL
972aeb2a,8,721,8.0,8,7,0,0,17,5,12,11.4,5.2,6.3,24,CL
980522ec,4,203,2.3,2,0,2,0,5,7,-2,4.9,6.1,-1.2,24,CL
98ea5115,7,660,7.3,7,7,0,1,16,4,12,11.1,4.0,7.1,24,CL
99127249,4,232,2.6,3,1,1,1,3,4,-1,2.8,3.6,-0.8,24,CL
9a2e0ccc,6,406,4.5,6,0,0,0,9,4,5,7.3,5.2,2.1,24,CL
9a64e67e,7,572,6.4,7,5,0,1,8,6,2,8.7,5.1,3.6,24,CL
9b3ab988,1,45,0.5,0,0,1,5,1,1,0,1.5,2.2,-0.7,24,CL
9b5237b1,2,38,0.4,0,0,2,4,0,0,0,0.8,0.7,0.1,24,CL
9b909569,2,33,0.4,0,0,2,2,1,2,-1,0.9,1.5,-0.5,24,CL
9b94c838,1,1,0.0,0,0,1,1,0,0,0,0.0,0.0,0.0,24,CL
9bd73cce,2,97,1.1,1,0,1,4,1,2,-1,1.5,2.4,-0.8,24,CL
9bf914b4,5,263,2.9,3,0,2,0,2,5,-3,3.2,7.8,-4.6,24,CL
9c435456,4,350,3.9,4,3,0,4,3,5,-2,5.1,6.1,-1.0,24,CL
9c94165b,2,135,1.5,2,1,0,0,3,3,0,1.7,1.8,0.0,24,CL
9d21da85,4,280,3.1,3,1,1,1,4,6,-2,5.4,3.0,2.4,24,CL
9d7d5334,6,517,5.7,6,4,0,0,5,11,-6,7.8,9.4,-1.6,24,CL
9dff291c,6,540,6.0,6,6,0,0,6,17,-11,6.2,11.1,-4.9,24,CL
9e1035f8,6,334,3.7,3,2,3,0,5,5,0,6.6,4.2,2.4,24,CL
9e39fa2d,2,78,0.9,1,0,1,3,1,2,-1,1.1,1.7,-0.6,24,CL
9e525177,3,212,2.4,2,1,1,0,6,8,-2,4.2,4.4,-0.2,24,CL
9f1893b9,8,542,6.0,7,2,1,0,3,7,-4,6.4,8.9,-2.5,24,CL
9f8e9423,4,334,3.7,3,2,1,1,5,8,-3,6.3,7.6,-1.3,24,CL
9ffb2ce6,8,705,7.8,8,5,0,0,15,9,6,11.2,7.6,3.6,24,CL
a086ae11,6,338,3.8,4,1,2,0,3,4,-1,4.8,6.3,-1.5,24,CL
a08b974a,5,345,3.8,4,2,1,0,5,4,1,4.2,6.3,-2.1,24,CL
a0d55a09,6,262,2.9,3,0,3,2,5,2,3,7.3,1.9,5.4,24,CL
a167537f,7,402,4.5,5,2,2,0,4,3,1,5.2,8.0,-2.8,24,CL
a1d5bd30,4,288,3.2,4,2,0,0,8,5,3,7.4,4.4,3.0,24,CL
a29e5244,3,183,2.0,2,1,1,1,1,2,-1,2.5,2.1,0.5,24,CL
a2abe631,6,540,6.0,6,6,0,0,10,13,-3,9.8,10.2,-0.4,24,CL
a2b105e0,5,354,3.9,4,3,1,0,4,5,-1,2.6,7.3,-4.7,24,CL
a2b1ed42,8,136,1.5,1,1,7,0,4,3,1,3.8,1.9,2.0,24,CL
a39d11bc,2,84,0.9,1,0,1,1,2,5,-3,1.5,2.5,-1.0,24,CL
a3b03921,2,101,1.1,1,0,1,0,0,2,-2,0.7,1.3,-0.6,24,CL
a4b00319,4,251,2.8,3,1,1,4,2,6,-4,2.9,3.9000000000000004,-1.2,24,CL
a4b1028a,7,529,5.9,6,4,1,0,5,5,0,6.2,4.5,1.7,24,CL
a4e16ab4,1,63,0.7,1,0,0,6,0,1,-1,0.3,1.2,-0.8,24,CL
a5296e55,6,466,5.2,6,1,0,0,10,6,4,7.5,5.9,1.6,24,CL
a53649b7,5,136,1.5,1,1,4,2,2,1,1,2.3,1.6,0.7,24,CL
a5420709,8,505,5.6,5,3,3,0,8,8,0,8.9,6.3,2.6,24,CL
a63a995f,1,90,1.0,1,1,0,5,1,2,-1,1.5,0.7,0.8,24,CL
a65ce836,6,477,5.3,6,4,0,0,6,4,2,6.9,9.2,-2.2,24,CL
a686ef30,1,36,0.4,0,0,1,5,1,1,0,1.3,0.9,0.4,24,CL
a69e4806,7,377,4.2,4,0,3,0,5,6,-1,5.2,5.7,-0.5,24,CL
a70b8345,6,540,6.0,6,6,0,0,6,10,-4,5.6,11.5,-5.9,24,CL
a793f5a8,6,540,6.0,6,6,0,0,10,12,-2,7.4,10.9,-3.5,24,CL
a820e429,4,120,1.3,1,0,3,2,2,4,-2,1.8,4.2,-2.4,24,CL
a8b8af8d,1,74,0.8,1,0,0,2,1,0,1,1.4,0.9,0.5,24,CL
a93b6f4e,3,175,1.9,2,1,1,3,2,4,-2,2.0,6.0,-4.0,24,CL
aa34ed38,2,35,0.4,0,0,2,4,0,3,-3,0.1,0.8,-0.7,24,CL
ab57e591,6,476,5.3,6,0,0,0,4,7,-3,6.4,10.0,-3.5,24,CL
abb3bb95,7,627,7.0,7,4,0,1,8,12,-4,9.6,10.0,-0.4,24,CL
abc06eb3,5,450,5.0,5,5,0,1,6,11,-5,4.8,14.5,-9.7,24,CL
abe66106,3,186,2.1,2,1,1,0,2,3,-1,1.0,2.2,-1.2,24,CL
ac295d9e,4,360,4.0,4,4,0,2,4,8,-4,3.9,6.3,-2.4,24,CL
ac4003af,1,10,0.1,0,0,1,1,0,0,0,0.1,0.1,0.0,24,CL
ac73ec79,3,57,0.6,0,0,3,5,0,1,-1,0.7,1.0,-0.3,24,CL
ac7e7b1c,3,109,1.2,1,0,2,3,1,3,-2,1.2,1.9,-0.8,24,CL
ac861941,1,90,1.0,1,1,0,1,3,0,3,3.5,0.4,3.1,24,CL
adc77724,5,264,2.9,4,1,1,1,2,6,-4,3.8,5.5,-1.7,24,CL
adfbe1f5,6,535,5.9,6,5,0,0,9,12,-3,7.2,10.8,-3.5,24,CL
ae44e8e2,3,181,2.0,2,1,1,0,2,2,0,3.0,2.2,0.9,24,CL
ae59b359,4,216,2.4,2,2,2,1,2,4,-2,2.3,4.1,-1.8,24,CL
aee634bf,3,255,2.8,3,2,0,0,5,7,-2,3.6,6.2,-2.6,24,CL
af50141d,3,147,1.6,2,1,1,3,1,3,-2,2.0,2.7,-0.7,24,CL
afb61630,6,480,5.3,5,5,1,0,5,8,-3,8.2,7.5,0.7,24,CL
afed6722,3,270,3.0,3,3,0,3,2,5,-3,3.6,7.7,-4.1,24,CL
b0395623,1,26,0.3,0,0,1,3,0,0,0,0.1,0.1,0.0,24,CL
b05f4787,2,37,0.4,0,0,2,2,1,1,0,0.9,0.3,0.6,24,CL
b0b4fd3e,6,369,4.1,6,2,0,0,9,4,5,11.6,1.6,10.0,24,CL
b19db005,7,594,6.6,7,4,0,0,11,7,4,12.2,6.0,6.3,24,CL
b2bc3b1f,6,399,4.4,5,0,1,0,8,8,0,6.0,7.1,-1.1,24,CL
b2d31e83,4,277,3.1,3,2,1,0,4,3,1,2.2,5.9,-3.7,24,CL
b35a7399,4,189,2.1,1,1,3,4,4,4,0,3.2,2.9,0.3,24,CL
b3a712de,7,479,5.3,6,3,1,0,7,10,-3,5.9,9.1,-3.2,24,CL
b3af9be1,5,303,3.4,4,2,1,1,10,3,7,6.3,1.8,4.4,24,CL
b3f8bdef,5,367,4.1,4,0,1,0,4,5,-1,3.5,4.0,-0.5,24,CL
b51b1b9c,5,350,3.9,4,1,1,0,3,4,-1,4.6,5.1,-0.5,24,CL
b56dd813,1,90,1.0,1,1,0,7,1,1,0,0.9,1.6,-0.7,24,CL
b57e066e,7,548,6.1,6,6,1,1,18,7,11,13.8,3.8,10.0,24,CL
b66315ae,6,359,4.0,4,1,2,0,11,3,8,7.9,2.3,5.5,24,CL
b6db05c3,1,3,0.0,0,0,1,1,0,0,0,0.1,0.1,0.0,24,CL
b74277a0,5,392,4.4,5,3,0,1,6,4,2,6.1,5.9,0.2,24,CL
b7de5bad,4,312,3.5,4,1,0,0,2,8,-6,5.0,6.1,-1.1,24,CL
b7f2edff,2,23,0.3,0,0,2,4,1,1,0,0.5,0.6,0.0,24,CL
b825a650,7,282,3.1,3,3,4,1,8,3,5,6.6,3.3,3.3,24,CL
b8a642fc,4,165,1.8,2,0,2,1,2,3,-1,4.3,1.9,2.4,24,CL
b8aedf06,2,180,2.0,2,2,0,0,4,1,3,2.6,1.5,1.1,24,CL
b96b595c,6,423,4.7,4,4,2,1,6,4,2,11.0,4.8,6.2,24,CL
b9beb6c5,1,68,0.8,1,0,0,2,1,3,-2,0.9,0.6,0.2,24,CL
ba115a40,2,22,0.2,0,0,2,4,0,0,0,0.0,0.3,-0.3,24,CL
ba3d3bea,5,160,1.8,1,1,4,3,5,1,4,4.7,2.2,2.5,24,CL
bac46a10,1,90,1.0,1,1,0,0,3,4,-1,1.7,2.2,-0.5,24,CL
bbd86530,2,93,1.0,1,1,1,6,3,1,2,1.2,1.6,-0.3,24,CL
bbf5c11b,2,38,0.4,0,0,2,4,1,3,-2,1.0,1.6,-0.6,24,CL
bc2618f0,5,237,2.6,3,0,2,1,2,3,-1,4.0,4.5,-0.5,24,CL
bc62d898,4,68,0.8,0,0,4,2,0,0,0,0.7,0.9,-0.3,24,CL
bc6e544a,6,540,6.0,6,6,0,0,4,8,-4,7.4,11.4,-3.9,24,CL
bc7dc64d,7,540,6.0,7,2,0,1,14,3,11,8.4,3.2,5.2,24,CL
bcb2ccd8,3,270,3.0,3,3,0,5,3,3,0,3.1,3.7,-0.6,24,CL
bd6351cd,8,637,7.1,7,5,1,0,15,6,9,11.9,6.4,5.6,24,CL
bdedffac,2,180,2.0,2,2,0,1,3,4,-1,2.0,4.5,-2.4,24,CL
be47b750,6,341,3.8,4,2,2,0,6,8,-2,5.4,4.6,0.8,24,CL
beec76cc,5,175,1.9,2,0,3,1,2,4,-2,2.5,2.6,0.0,24,CL
bf356094,2,126,1.4,1,0,1,3,1,2,-1,1.9,1.9,0.0,24,CL
c0295327,5,151,1.7,1,0,4,0,4,7,-3,3.8,3.3,0.5,24,CL
c0347e9b,1,1,0.0,0,0,1,0,0,0,0,0.0,0.4,-0.3,24,CL
c0617e2b,3,152,1.7,2,0,1,3,5,4,1,3.5,2.6,1.0,24,CL
c0b3669f,8,441,4.9,6,0,2,0,7,8,-1,10.4,6.0,4.4,24,CL
c0c7ff58,5,307,3.4,3,2,2,2,6,1,5,7.4,2.7,4.7,24,CL
c1242d4e,2,180,2.0,2,2,0,6,6,4,2,3.1,1.6,1.5,24,CL
c14bc029,8,427,4.7,5,3,3,0,11,6,5,5.3,7.0,-1.7,24,CL
c17bfb65,4,334,3.7,4,3,0,0,2,6,-4,4.4,9.5,-5.1,24,CL
c1b7847c,7,412,4.6,4,3,3,0,11,6,5,6.9,6.0,0.9,24,CL
c1fe5f0b,6,264,2.9,3,0,3,2,6,4,2,5.9,2.5,3.4,24,CL
c20bdcd7,1,23,0.3,0,0,1,3,0,1,-1,0.3,0.9,-0.6,24,CL
c2a15a27,6,540,6.0,6,6,0,0,7,11,-4,7.8,15.9,-8.1,24,CL
c3cf087d,4,198,2.2,2,0,2,0,2,3,-1,3.8,2.3,1.5,24,CL
c3ee18ef,8,620,6.9,7,5,1,0,11,9,2,14.5,7.3,7.2,24,CL
c4987edc,6,540,6.0,6,6,0,0,6,10,-4,5.6,11.5,-5.9,24,CL
c54638ba,4,118,1.3,0,0,4,0,4,3,1,2.7,3.2,-0.5,24,CL
c596fcb0,4,239,2.7,2,1,2,0,1,4,-3,2.7,3.8,-1.0,24,CL
c5bdb6e3,5,177,2.0,1,0,4,3,3,1,2,2.8,1.5,1.3,24,CL
c6220452,2,44,0.5,0,0,2,0,0,2,-2,0.7,0.5,0.2,24,CL
c632fa35,1,90,1.0,1,1,0,3,1,3,-2,0.5,1.8,-1.3,24,CL
c693347d,3,82,0.9,0,0,3,1,0,1,-1,0.8,2.3,-1.6,24,CL
c70be9cf,4,238,2.6,2,1,2,0,3,6,-3,4.8,4.7,0.0,24,CL
c762b1a6,5,353,3.9,4,1,1,1,7,7,0,8.0,6.0,2.0,24,CL
c76b7567,5,224,2.5,2,0,3,1,3,3,0,2.3,3.2,-0.9,24,CL
c8829a58,3,45,0.5,0,0,3,5,2,1,1,1.7,1.3,0.3,24,CL
c8aa95da,6,540,6.0,6,6,0,0,6,7,-1,5.9,12.3,-6.4,24,CL
c8ccc39e,4,216,2.4,2,1,2,2,3,4,-1,1.9,7.4,-5.5,24,CL
c8d1c3a5,6,185,2.1,1,0,5,2,7,2,5,3.2,2.2,1.0,24,CL
c8e65157,1,9,0.1,0,0,1,5,0,0,0,0.0,0.1,-0.1,24,CL
c906ce0f,7,660,7.3,7,7,0,0,16,8,8,10.7,6.4,4.3,24,CL
c952f633,6,502,5.6,6,3,0,0,7,11,-4,6.3,13.7,-7.3,24,CL
c9817014,7,380,4.2,5,1,2,1,6,7,-1,8.0,4.8,3.3,24,CL
c9e39d91,7,526,5.8,7,1,0,0,7,5,2,7.9,4.3,3.6,24,CL
ca22ccb0,2,62,0.7,1,0,1,4,1,1,0,1.3,0.4,0.9,24,CL
ca607d59,3,36,0.4,0,0,3,1,1,0,1,1.5,0.5,1.0,24,CL
ca8033cb,6,356,4.0,3,3,3,0,6,9,-3,4.3,7.5,-3.2,24,CL
cab9634e,2,180,2.0,2,2,0,0,3,1,2,2.4,3.1,-0.7,24,CL
cabb3a1d,6,410,4.6,4,3,2,0,4,15,-11,4.8,8.1,-3.3,24,CL
cb4f24c6,6,540,6.0,6,6,0,0,5,15,-10,4.9,11.7,-6.8,24,CL
cc1c5035,2,180,2.0,2,2,0,6,4,4,0,3.0,2.8,0.2,24,CL
cc6de655,6,322,3.6,3,2,3,0,3,10,-7,2.6,6.7,-4.1,24,CL
cc7888f3,1,90,1.0,1,1,0,3,3,1,2,2.7,1.3,1.4,24,CL
cc86b9a3,7,536,6.0,6,5,1,0,11,5,6,11.2,5.6,5.7,24,CL
ccce7025,1,90,1.0,1,1,0,0,0,0,0,0.3,1.9,-1.6,24,CL
cd0fa27b,6,509,5.7,6,2,0,1,5,3,2,10.9,5.2,5.7,24,CL
cd1629bc,2,29,0.3,0,0,2,4,0,3,-3,0.4,0.5,-0.1,24,CL
cd59b9df,7,630,7.0,7,7,0,0,9,4,5,9.5,12.1,-2.6,24,CL
cd6a1a59,5,309,3.4,3,2,2,0,5,6,-1,4.6,5.2,-0.6,24,CL
cf007308,7,169,1.8,0,0,7,1,2,4,-2,2.0,3.3,-1.3,24,CL
d080ed5e,7,630,7.0,7,7,0,1,8,6,2,9.0,5.8,3.2,24,CL
d0b8e745,6,146,1.6,1,0,5,2,3,3,0,3.4,1.6,1.7,24,CL
d0d8dd44,6,496,5.5,5,3,1,1,8,7,1,10.4,7.1,3.3,24,CL
d17ce930,2,30,0.3,0,0,2,4,0,1,-1,0.1,1.2,-1.1,24,CL
d2416c2e,7,337,3.7,4,0,3,1,6,5,1,5.8,4.5,1.3,24,CL
d248cd8f,6,497,5.5,6,4,0,0,7,4,3,7.3,4.6,2.7,24,CL
d25422fb,5,104,1.2,0,0,5,1,1,8,-7,1.1,4.1,-3.0,24,CL
d3d774cc,2,35,0.4,0,0,2,2,1,1,0,0.9,1.0,-0.1,24,CL
d4535821,7,514,5.7,6,5,1,0,6,9,-3,8.5,8.7,-0.1,24,CL
d4808594,1,14,0.2,0,0,1,5,0,0,0,0.1,0.0,0.1,24,CL
d4c9725f,6,540,6.0,6,6,0,0,5,8,-3,9.6,7.7,1.9,24,CL
d5127c3f,5,79,0.9,0,0,5,1,3,3,0,2.0,2.6,-0.6,24,CL
d5f2f82b,6,540,6.0,6,6,0,1,10,7,3,10.2,5.6,4.5,24,CL
d6e53a3a,3,198,2.2,2,2,1,1,6,1,5,5.6,3.2,2.4,24,CL
d781d855,7,548,6.1,6,5,1,0,12,6,6,9.3,6.4,2.9,24,CL
d7a03bf3,3,129,1.4,1,0,2,3,1,0,1,1.1,1.2,-0.1,24,CL
d85c238b,6,460,5.1,6,2,0,0,3,9,-6,5.8,8.7,-2.9,24,CL
d874b374,3,16,0.2,0,0,3,3,1,0,1,0.2,0.1,0.1,24,CL
d8931174,4,309,3.4,4,3,0,1,7,7,0,6.4,5.8,0.6,24,CL
d93c2511,5,382,4.2,4,4,1,1,9,9,0,7.7,7.4,0.2,24,CL
d9565625,6,463,5.1,5,5,1,0,9,12,-3,9.5,10.1,-0.6,24,CL
d9d43555,1,36,0.4,0,0,1,1,1,1,0,0.5,2.0,-1.4,24,CL
da011f18,1,45,0.5,1,0,0,5,0,1,-1,0.1,0.7,-0.6,24,CL
da4d670f,8,596,6.6,7,3,1,0,9,9,0,10.1,8.9,1.2,24,CL
da76bab4,7,218,2.4,1,0,6,1,2,2,0,3.9,4.0,-0.1,24,CL
da7b447d,4,360,4.0,4,4,0,1,5,8,-3,7.3,8.0,-0.7,24,CL
dbf053da,2,141,1.6,2,0,0,0,2,1,1,1.8,2.6,-0.8,24,CL
dc234f98,4,223,2.5,3,0,1,0,4,6,-2,2.5,4.8,-2.3,24,CL
dc3e663e,6,336,3.7,3,2,3,2,3,2,1,3.4,3.0,0.4,24,CL
dc7a172e,1,3,0.0,0,0,1,1,0,0,0,0.1,0.0,0.1,24,CL
dd0daf32,7,516,5.7,7,1,0,1,3,3,0,8.9,5.5,3.4,24,CL
dd95af65,4,296,3.3,3,3,1,2,5,4,1,4.7,5.6,-0.9,24,CL
de112b84,3,87,1.0,1,0,2,0,1,0,1,0.4,1.6,-1.2,24,CL
de31038e,2,45,0.5,0,0,2,0,1,0,1,0.3,0.6,-0.3,24,CL
de8f6250,1,9,0.1,0,0,1,1,0,0,0,0.1,0.5,-0.4,24,CL
dea88efd,8,668,7.4,8,4,0,0,10,12,-2,9.1,11.0,-1.9,24,CL
df525574,7,465,5.2,5,4,2,1,5,11,-6,7.1,7.9,-0.7,24,CL
df69b544,8,638,7.1,8,3,0,0,15,7,8,10.8,9.1,1.6,24,CL
e08647d6,4,68,0.8,0,0,4,0,0,0,0,0.4,0.7,-0.3,24,CL
e095928e,4,218,2.4,2,0,2,0,4,3,1,2.5,2.9,-0.4,24,CL
e0f8151c,6,540,6.0,6,6,0,1,12,7,5,9.7,7.7,2.0,24,CL
e1cbb531,8,677,7.5,8,4,0,0,12,12,0,9.7,10.4,-0.8,24,CL
e280527c,7,485,5.4,6,5,1,0,9,2,7,7.5,7.3,0.1,24,CL
e288d4b3,4,158,1.8,1,1,3,2,2,1,1,2.8,2.3,0.5,24,CL
e2f16dcc,4,138,1.5,2,0,2,2,0,2,-2,1.9,2.2,-0.3,24,CL
e33c06cf,5,373,4.1,4,4,1,1,5,3,2,4.9,7.6,-2.6,24,CL
e42d61c7,8,711,7.9,8,6,0,0,13,8,5,15.6,7.6,8.1,24,CL
e46012d4,1,90,1.0,1,1,0,1,3,1,2,3.3,0.3,3.1,24,CL
e514ab62,2,22,0.2,0,0,2,1,0,0,0,0.3,0.0,0.3,24,CL
e53b5534,4,103,1.1,1,0,3,2,1,4,-3,1.5,1.9,-0.4,24,CL
e58cbfd5,3,136,1.5,2,0,1,2,0,2,-2,1.2,1.0,0.2,24,CL
e6af02e0,7,422,4.7,5,2,2,0,15,4,11,13.5,3.0,10.4,24,CL
e6bc67d7,2,29,0.3,0,0,2,2,1,0,1,1.7,0.3,1.5,24,CL
e717705a,6,251,2.8,2,2,4,0,3,5,-2,3.2,5.6,-2.4,24,CL
e73659d3,3,94,1.0,1,0,2,3,1,1,0,1.2,2.1,-0.9,24,CL
e7f3e8a7,4,152,1.7,1,0,3,2,2,3,-1,2.1,2.3,-0.2,24,CL
e82900ef,4,199,2.2,2,1,2,1,1,3,-2,2.0,3.7,-1.7,24,CL
e83d5f45,4,264,2.9,3,1,1,2,5,4,1,4.5,7.5,-3.0,24,CL
e8ef59da,5,161,1.8,1,0,4,1,4,2,2,3.4,1.5,1.9,24,CL
e97fd090,4,323,3.6,4,2,0,0,4,5,-1,5.7,5.2,0.5,24,CL
e9c0c1b2,6,540,6.0,6,6,0,0,12,15,-3,10.5,11.4,-0.9,24,CL
e9fda01d,3,16,0.2,0,0,3,4,1,0,1,0.6,0.2,0.4,24,CL
eab85789,6,486,5.4,5,4,1,0,7,14,-7,8.6,13.7,-5.0,24,CL
eaeca114,7,384,4.3,3,3,4,1,15,4,11,14.5,1.7,12.9,24,CL
eb907bfc,5,206,2.3,3,0,2,1,2,3,-1,1.7,3.9,-2.2,24,CL
ed1e53f3,6,475,5.3,5,3,1,2,15,7,8,15.3,2.9,12.4,24,CL
ed45a7d7,4,204,2.3,2,2,2,1,5,5,0,2.9,4.0,-1.1,24,CL
ee3519f5,6,495,5.5,6,3,0,0,10,12,-2,7.2,10.4,-3.2,24,CL
ee6e2b92,1,14,0.2,0,0,1,2,0,0,0,0.6,0.4,0.1,24,CL
ee8508c0,8,750,8.3,8,8,0,0,19,8,11,12.6,10.4,2.2,24,CL
eed2427e,4,218,2.4,2,2,2,4,6,3,3,3.3,2.3,1.0,24,CL
ef233486,4,278,3.1,4,0,0,0,4,7,-3,2.7,10.1,-7.4,24,CL
ef3909cd,6,540,6.0,6,6,0,0,6,12,-6,8.3,10.0,-1.7,24,CL
f0021247,5,322,3.6,5,0,0,1,6,8,-2,5.6,9.7,-4.1,24,CL
f0677ed7,6,540,6.0,6,6,0,0,7,11,-4,7.8,15.9,-8.1,24,CL
f0da930c,5,301,3.3,4,1,1,0,9,2,7,5.2,3.0,2.1,24,CL
f179ee11,8,707,7.9,8,7,0,0,10,13,-3,8.7,12.4,-3.6,24,CL
f20e4cc9,1,60,0.7,1,0,0,0,2,0,2,1.0,0.1,1.0,24,CL
f28659fb,6,440,4.9,5,3,1,0,7,9,-2,8.6,8.6,0.0,24,CL
f3945e07,2,7,0.1,0,0,2,5,1,0,1,0.2,0.1,0.1,24,CL
f40dd3c7,3,81,0.9,2,0,1,0,2,0,2,0.7,0.2,0.5,24,CL
f4290206,3,139,1.5,2,0,1,2,2,2,0,2.3,1.1,1.2,24,CL
f446748f,6,212,2.4,2,0,4,0,0,3,-3,2.6,3.4,-0.7,24,CL
f4b52308,7,530,5.9,7,0,0,0,7,8,-1,5.4,9.8,-4.4,24,CL
f4cda99f,4,209,2.3,2,0,2,1,1,7,-6,0.9,4.8,-3.9,24,CL
f5692b25,3,262,2.9,3,2,0,0,5,10,-5,2.9,6.2,-3.4,24,CL
f5a00fa4,5,291,3.2,3,2,2,1,2,6,-4,4.5,6.0,-1.5,24,CL
f5b6fb78,5,406,4.5,5,4,0,1,4,10,-6,2.7,13.2,-10.5,24,CL
f5deef4c,4,298,3.3,3,3,1,1,9,10,-1,6.4,7.1,-0.7,24,CL
f63cda26,5,147,1.6,1,1,4,2,3,4,-1,3.2,1.3,1.9,24,CL
f67c9d29,3,259,2.9,3,2,0,0,2,5,-3,2.6,5.1,-2.5,24,CL
f6ac68c1,5,412,4.6,4,3,1,2,7,5,2,7.0,6.1,0.8,24,CL
f7036e1c,8,532,5.9,5,3,3,0,7,4,3,12.1,6.2,5.9,24,CL
f7223718,5,370,4.1,4,4,1,1,6,2,4,5.5,3.9,1.7,24,CL
f7b10c66,1,90,1.0,1,1,0,5,1,2,-1,1.5,0.7,0.8,24,CL
f7d50789,5,450,5.0,5,5,0,0,6,15,-9,5.6,8.9,-3.2,24,CL
f7dc2ae5,5,172,1.9,2,0,3,0,3,1,2,4.0,1.8,2.1,24,CL
f8405304,4,131,1.5,1,0,3,1,0,1,-1,1.1,1.6,-0.5,24,CL
f882b0a1,5,205,2.3,2,0,3,1,3,4,-1,2.7,3.8,-1.1,24,CL
f8fcd2a5,2,66,0.7,1,0,1,3,1,1,0,1.1,0.9,0.2,24,CL
f9acca3a,5,387,4.3,4,2,1,1,0,3,-3,2.8,3.0,-0.3,24,CL
fa661778,5,281,3.1,3,1,2,3,3,3,0,4.2,6.1,-1.9,24,CL
fb495bb8,6,486,5.4,6,4,0,0,5,11,-6,4.9,10.2,-5.3,24,CL
fc3697dd,6,395,4.4,5,1,1,0,5,11,-6,6.4,7.2,-0.8,24,CL
fc4e7637,7,642,7.1,7,5,0,0,11,7,4,8.9,7.1,1.8,24,CL
fcb27134,7,598,6.6,7,6,0,0,13,11,2,11.0,9.4,1.5,24,CL
fcb38f57,6,530,5.9,6,5,0,0,5,8,-3,9.5,7.6,1.9,24,CL
fce2302c,2,66,0.7,1,0,1,2,1,0,1,1.2,0.1,1.1,24,CL
fcea4f04,2,5,0.1,0,0,2,2,0,0,0,0.0,0.9,-0.9,24,CL
fd4d5f81,6,447,5.0,6,1,0,0,4,9,-5,3.8,9.2,-5.3,24,CL
fd51b456,6,266,3.0,3,2,3,2,8,2,6,10.6,2.6,8.1,24,CL
fed17f5a,2,9,0.1,0,0,2,6,0,1,-1,0.4,0.2,0.1,24,CL
fed7cb61,8,655,7.3,7,5,1,0,15,4,11,9.3,4.5,4.7,24,CL
ff20acfe,6,534,5.9,6,5,0,0,7,12,-5,6.3,14.8,-8.4,24,CL
ff2fb007,4,137,1.5,2,0,2,2,5,3,2,2.0,3.7,-1.7,24,CL
ff5ea0bf,5,367,4.1,5,3,0,0,3,3,0,6.7,4.1,2.5,24,CL
ff9e56c6,3,60,0.7,0,0,3,3,0,1,-1,1.0,2.1,-1.1,24,CL
fffea3e5,6,255,2.8,1,0,5,0,12,3,9,9.7,1.5,8.1,24,CL
00459419,21,608,6.8,3,2,18,1,17,2,15,15.1,6.0,9.0,24,ITA
00a17eba,1,90,1.0,1,1,0,29,0,2,-2,1.0,2.0,-1.0,24,ITA
016ff750,27,1812,20.1,20,12,7,2,16,18,-2,19.2,19.0,0.2,24,ITA
01b8a2b2,28,2520,28.0,28,28,0,0,41,23,18,40.8,21.1,19.7,24,ITA
01c3aff5,28,2236,24.8,25,14,3,0,34,19,15,36.0,16.5,19.5,24,ITA
01efac19,14,299,3.3,2,0,12,12,3,3,0,4.4,3.4,1.0,24,ITA
028e70b9,28,2281,25.3,26,14,2,0,38,23,15,31.9,25.3,6.6,24,ITA
02caf6e0,20,1436,16.0,16,9,4,7,17,14,3,21.2,17.5,3.7,24,ITA
032f894e,6,124,1.4,1,0,5,8,6,3,3,2.1,0.7,1.4,24,ITA
0375723e,1,4,0.0,0,0,1,0,0,0,0,0.2,0.0,0.2,24,ITA
03f946ed,18,995,11.1,13,4,5,5,12,20,-8,10.9,19.2,-8.2,24,ITA
04c4edc1,1,24,0.3,0,0,1,1,0,1,-1,0.0,0.7,-0.7,24,ITA
04df29a5,22,1282,14.2,15,3,7,6,15,15,0,15.5,17.7,-2.2,24,ITA
0545a08e,28,1462,16.2,16,3,12,1,18,37,-19,17.0,28.7,-11.7,24,ITA
0630eb63,10,374,4.2,4,0,6,6,6,5,1,3.8,4.5,-0.7,24,ITA
06b08c45,24,946,10.5,11,2,13,0,7,18,-11,12.0,14.5,-2.5,24,ITA
0704d719,3,218,2.4,3,1,0,16,3,8,-5,1.8,4.2,-2.4,24,ITA
0821331c,25,2126,23.6,25,21,0,1,25,30,-5,19.3,26.3,-7.0,24,ITA
08aa9cd1,31,2528,28.1,31,7,0,0,34,48,-14,30.4,41.0,-10.6,24,ITA
08eb3b58,15,1014,11.3,13,3,2,0,16,15,1,13.5,18.5,-5.0,24,ITA
0917188a,24,1833,20.4,22,12,2,0,18,29,-11,22.3,28.5,-6.2,24,ITA
0967845b,15,1002,11.1,11,9,4,13,14,15,-1,14.4,12.5,1.9,24,ITA
09899de8,26,2103,23.4,23,22,3,3,32,44,-12,28.4,35.7,-7.3,24,ITA
099a2de5,14,417,4.6,2,0,12,8,10,10,0,5.5,7.3,-1.8,24,ITA
0a447501,27,1703,18.9,19,8,8,2,19,16,3,23.1,15.1,8.0,24,ITA
0a483542,21,1366,15.2,15,7,6,9,16,20,-4,14.1,22.2,-8.1,24,ITA
0ab1f153,7,156,1.7,0,0,7,1,4,0,4,3.1,1.0,2.1,24,ITA
0b5a292a,19,1105,12.3,13,5,6,7,20,17,3,20.5,11.8,8.6,24,ITA
0be276c6,20,1596,17.7,18,13,2,3,14,35,-21,13.5,30.5,-17.0,24,ITA
0ccac09c,26,2110,23.4,25,6,1,0,25,22,3,20.4,21.9,-1.5,24,ITA
0cf465f2,19,792,8.8,8,2,11,5,13,17,-4,12.6,12.6,0.0,24,ITA
0d077b88,10,200,2.2,3,0,7,10,1,9,-8,1.0,6.9,-5.9,24,ITA
0d422df7,17,1530,17.0,17,17,0,13,15,28,-13,20.0,24.6,-4.6,24,ITA
0d82903c,14,635,7.1,7,6,7,5,11,6,5,10.7,6.4,4.3,24,ITA
0def2376,17,910,10.1,8,5,9,11,15,15,0,12.2,13.9,-1.8,24,ITA
0dfce079,7,630,7.0,7,7,0,23,2,12,-10,5.5,10.0,-4.5,24,ITA
0fdcef0e,18,566,6.3,4,3,14,11,21,2,19,14.4,5.7,8.7,24,ITA
0fee6bda,26,2153,23.9,25,18,1,2,32,38,-6,27.7,33.5,-5.8,24,ITA
102e2599,21,994,11.100000000000001,10,3,11,3,8,16,-8,12.4,17.0,-4.5,24,ITA
10549b49,17,410,4.6,2,1,15,5,15,3,12,9.8,4.1,5.6,24,ITA
1079c685,8,369,4.1,6,0,2,2,4,5,-1,3.8,5.1,-1.3,24,ITA
11d8aff0,29,2609,29.0,29,28,0,0,32,35,-3,25.7,30.4,-4.7,24,ITA
12806697,18,1142,12.7,11,10,7,0,14,14,0,13.2,12.7,0.4,24,ITA
130a7a3f,17,536,6.0,6,0,11,8,8,12,-4,6.8,8.6,-1.8,24,ITA
13b9e2fb,2,22,0.2,0,0,2,15,0,0,0,0.2,0.1,0.1,24,ITA
149c5f5d,12,528,5.9,7,3,5,3,1,12,-11,2.6,10.2,-7.5,24,ITA
14aac43e,5,176,2.0,1,0,4,4,2,3,-1,2.7,3.3,-0.5,24,ITA
14b8fcdf,15,1021,11.3,11,9,4,15,17,9,8,17.0,8.1,8.9,24,ITA
15b287da,21,872,9.7,9,1,12,9,9,11,-2,13.1,10.8,2.3,24,ITA
15fd5593,11,162,1.8,1,0,10,17,3,0,3,4.1,1.3,2.8,24,ITA
16463a79,17,683,7.6,8,0,9,10,8,13,-5,9.1,12.2,-3.2,24,ITA
16657b95,29,2580,28.7,29,28,0,0,53,33,20,39.3,28.1,11.2,24,ITA
16bb656a,23,1777,19.7,21,17,2,0,14,24,-10,15.1,25.2,-10.1,24,ITA
16ceb862,27,1924,21.4,23,9,4,1,45,24,21,36.1,25.6,10.5,24,ITA
18950a80,7,523,5.8999999999999995,5,4,2,12,4,14,-10,4.800000000000001,13.5,-8.700000000000001,24,ITA
18dd3219,25,2054,22.8,23,18,2,4,31,20,11,33.6,16.4,17.2,24,ITA
1956a64b,2,14,0.2,0,0,2,0,0,0,0,0.0,1.2,-1.2,24,ITA
19a12bed,27,1563,17.4,19,2,8,2,18,25,-7,18.6,22.2,-3.6,24,ITA
1ac232b8,10,437,4.9,4,2,6,13,2,11,-9,4.3,7.7,-3.4,24,ITA
1bf33a9a,28,1983,22.0,25,6,3,0,45,19,26,35.2,21.5,13.7,24,ITA
1cadaf34,30,988,10.9,7,2,23,0,12,18,-6,12.8,18.599999999999998,-5.8,24,ITA
1ceeae3e,11,480,5.3,5,0,6,18,8,9,-1,6.4,6.9,-0.5,24,ITA
1d45fd81,16,483,5.4,6,0,10,7,7,7,0,7.2,8.7,-1.4,24,ITA
1d50130f,4,118,1.3,1,0,3,5,0,3,-3,1.0,3.4,-2.3,24,ITA
1dc5a029,4,202,2.2,3,0,1,20,3,4,-1,2.8,3.9,-1.2,24,ITA
1e9aa637,27,2130,23.7,26,15,1,0,46,29,17,36.0,27.1,8.9,24,ITA
1e9bde92,20,1800,20.0,20,20,0,3,13,42,-29,13.1,39.4,-26.3,24,ITA
1ea5f91c,17,844,9.4,12,0,5,9,11,17,-6,9.9,12.2,-2.3,24,ITA
1fca9171,2,15,0.2,0,0,2,0,2,0,2,0.2,0.6,-0.4,24,ITA
20094685,15,652,7.300000000000001,6,2,9,12,5,9,-4,8.4,13.7,-5.1,24,ITA
204ac005,27,1393,15.5,14,5,13,2,20,21,-1,18.7,22.5,-3.8,24,ITA
2054d037,7,365,4.1,3,0,4,1,5,5,0,5.7,4.8,0.9,24,ITA
20730eae,26,1953,21.7,23,11,3,0,42,23,19,38.1,23.4,14.7,24,ITA
20b3a502,2,102,1.1,1,0,1,0,0,3,-3,1.0,0.9,0.1,24,ITA
2146785a,26,1916,21.3,23,11,3,1,42,22,20,35.2,22.5,12.8,24,ITA
217875a4,21,1684,18.7,19,16,2,5,12,28,-16,18.0,26.7,-8.7,24,ITA
217c93a1,26,1682,18.7,20,8,6,4,15,21,-6,22.3,22.8,-0.4,24,ITA
22051fbe,3,16,0.2,0,0,3,22,1,1,0,0.1,0.5,-0.4,24,ITA
226008f1,25,1980,22.0,22,18,3,4,21,31,-10,23.8,33.6,-9.7,24,ITA
22ae86f9,16,1003,11.1,11,7,5,13,13,16,-3,8.5,15.7,-7.2,24,ITA
230a2fac,29,2610,29.0,29,29,0,0,43,35,8,47.3,29.1,18.2,24,ITA
230c3f3a,14,877,9.7,11,4,3,11,6,16,-10,6.5,15.3,-8.8,24,ITA
232b3da4,5,158,1.8,1,0,4,2,3,2,1,1.8,1.8,0.0,24,ITA
2374aaca,22,1440,16.0,17,10,5,1,23,19,4,20.2,17.6,2.6,24,ITA
23d73767,2,24,0.3,0,0,2,20,2,1,1,0.1,1.1,-0.9,24,ITA
2434f24a,11,990,11.0,11,11,0,20,12,22,-10,11.5,20.2,-8.7,24,ITA
244bc2c8,17,1143,12.7,12,8,5,1,9,30,-21,10.0,25.0,-15.0,24,ITA
247ed022,27,1815,20.2,21,2,6,1,27,16,11,29.7,13.9,15.8,24,ITA
24eb7ed6,11,502,5.6,4,1,7,20,3,12,-9,3.8,12.9,-9.1,24,ITA
26777636,18,1065,11.8,13,5,5,12,19,13,6,17.1,11.8,5.3,24,ITA
26db8853,29,2523,28.0,29,24,0,0,25,41,-16,29.3,35.6,-6.3,24,ITA
277da414,28,2519,28.0,28,27,0,0,33,31,2,33.4,31.5,1.8,24,ITA
279508bf,4,40,0.4,0,0,4,6,0,0,0,0.3,0.3,0.0,24,ITA
28f66c2e,5,178,2.0,2,0,3,6,0,0,0,2.3,1.1,1.2,24,ITA
2a1beb34,25,2250,25.0,25,25,0,3,48,24,24,35.9,25.4,10.5,24,ITA
2a6cd437,28,2499,27.8,28,27,0,0,26,39,-13,30.5,39.9,-9.3,24,ITA
2a7d27c1,24,615,6.8,3,1,21,4,19,2,17,16.3,8.2,8.1,24,ITA
2a82aa85,23,1321,14.7,16,3,7,3,12,26,-14,11.6,27.0,-15.4,24,ITA
2b8360f1,25,1552,17.2,17,7,8,1,17,24,-7,16.5,17.7,-1.2999999999999998,24,ITA
2b9fdeea,28,1620,18.0,18,3,10,2,14,26,-12,19.0,23.2,-4.2,24,ITA
2c0f8e9e,17,504,5.6,4,2,13,8,12,2,10,11.8,5.1,6.7,24,ITA
2c3a6c21,5,155,1.7,3,0,2,6,2,3,-1,3.1,2.0,1.1,24,ITA
2d22cea7,31,2462,27.4,30,12,1,0,32,46,-14,30.5,40.7,-10.1,24,ITA
2d3d7c0d,4,102,1.1,0,0,4,23,0,4,-4,0.4,2.0,-1.6,24,ITA
2d5f2ff0,1,4,0.0,0,0,1,0,0,0,0,0.0,0.1,-0.1,24,ITA
2d9d9e42,16,605,6.7,6,1,10,14,10,10,0,7.6,8.0,-0.4,24,ITA
2db2fd7b,6,193,2.1,3,0,3,1,1,6,-5,1.1,3.8,-2.7,24,ITA
2df7cc43,10,579,6.4,7,3,3,12,7,12,-5,5.7,8.9,-3.2,24,ITA
2ead2809,17,907,10.1,11,4,6,3,11,18,-7,9.3,14.5,-5.2,24,ITA
2edcd048,1,3,0.0,0,0,1,17,0,0,0,0.0,0.2,-0.2,24,ITA
2ef7c612,26,1566,17.4,20,1,6,1,34,21,13,26.4,19.1,7.3,24,ITA
2f067cf2,9,619,6.9,9,1,0,0,6,9,-3,6.3,9.1,-2.8,24,ITA
2f3452eb,15,801,8.9,8,4,7,14,13,17,-4,9.9,12.9,-2.9,24,ITA
2f3e911a,15,820,9.1,10,3,5,9,12,14,-2,7.5,11.1,-3.6,24,ITA
2f69d881,22,1694,18.799999999999997,21,9,1,4,19,33,-14,15.8,26.7,-10.8,24,ITA
30223b33,1,90,1.0,1,1,0,26,0,1,-1,0.3,1.4,-1.1,24,ITA
30297946,23,286,3.2,0,0,23,7,4,12,-8,6.0,7.1,-1.0,24,ITA
30941e96,8,542,6.0,7,1,1,0,14,6,8,8.4,6.6,1.9,24,ITA
31a62dc7,13,350,3.9,2,0,11,17,9,7,2,6.3,6.3,0.0,24,ITA
31b252fc,21,1446,16.1,16,13,5,7,18,35,-17,18.6,25.2,-6.6,24,ITA
343c0d52,22,658,7.3,6,1,16,7,10,9,1,13.1,6.6,6.5,24,ITA
34693494,21,1000,11.1,15,0,6,9,17,6,11,17.0,8.0,9.1,24,ITA
356c9002,30,2494,27.7,29,22,1,0,21,55,-34,20.7,53.2,-32.5,24,ITA
3626daea,20,1143,12.7,14,3,6,5,23,15,8,16.5,9.9,6.6,24,ITA
3649ece2,7,466,5.2,6,2,1,0,3,10,-7,3.1,7.6,-4.4,24,ITA
364e2d13,1,5,0.1,0,0,1,0,0,0,0,0.1,0.0,0.1,24,ITA
366be751,6,339,3.8,3,0,3,2,3,4,-1,3.6,2.8,0.8,24,ITA
379dc075,7,350,3.9,4,0,3,2,5,8,-3,3.9,9.2,-5.3,24,ITA
37dc1a48,20,345,3.8,1,0,19,6,8,7,1,8.2,3.7,4.5,24,ITA
3935e52e,26,1936,21.5,23,14,3,2,42,20,22,31.0,23.9,7.1,24,ITA
3963c25b,13,634,7.0,6,5,7,17,17,2,15,17.0,7.1,10.0,24,ITA
39769cff,25,1483,16.5,16,11,9,2,27,23,4,21.2,17.5,3.7,24,ITA
3aca6420,3,36,0.4,0,0,3,8,1,0,1,1.4,0.0,1.4,24,ITA
3ad34015,1,15,0.2,0,0,1,4,0,0,0,0.3,0.0,0.3,24,ITA
3b12b11f,14,614,6.8,6,2,8,16,5,10,-5,5.8999999999999995,11.899999999999999,-6.1,24,ITA
3b333ac3,15,684,7.6,6,4,9,7,15,12,3,9.4,11.2,-1.8,24,ITA
3b387cc7,15,561,6.2,6,2,9,11,8,7,1,7.1,5.9,1.2000000000000002,24,ITA
3b61c9ec,16,639,7.1,6,1,10,12,7,7,0,8.9,7.0,1.9,24,ITA
3bb7af3b,12,342,3.8,3,0,9,6,4,5,-1,2.8,4.8,-2.0,24,ITA
3c6bbbab,4,214,2.4,2,1,2,4,1,4,-3,1.1,4.3,-3.2,24,ITA
3ca7254a,26,681,7.6,5,0,21,3,8,8,0,10.8,6.6,4.2,24,ITA
3cd3b384,25,1825,20.3,21,9,4,4,23,35,-12,22.1,25.6,-3.5,24,ITA
3d13d9e4,7,316,3.5,4,0,3,14,2,7,-5,1.9,4.5,-2.6,24,ITA
3d50bcdb,15,575,6.4,7,0,8,1,6,3,3,8.4,4.4,4.0,24,ITA
3ead85f9,23,1961,21.8,21,21,2,0,26,24,2,25.4,25.3,0.1,24,ITA
3ec3c1c9,22,1746,19.4,20,16,2,3,25,22,3,23.1,26.1,-3.0,24,ITA
3ecc8c5f,13,815,9.1,9,6,4,14,7,16,-9,9.0,14.9,-5.8,24,ITA
3f5f38fb,14,1126,12.5,11,11,3,12,16,19,-3,14.4,17.6,-3.2,24,ITA
3f7e5a98,1,9,0.1,0,0,1,8,0,2,-2,0.0,1.0,-0.9,24,ITA
405f6586,29,1856,20.6,20,8,9,0,23,29,-6,21.3,25.7,-4.5,24,ITA
414e1f69,1,10,0.1,0,0,1,14,0,0,0,0.0,0.5,-0.5,24,ITA
41723204,8,267,3.0,2,0,6,0,3,4,-1,2.0,3.9,-2.0,24,ITA
41bd99ea,23,2070,23.0,23,23,0,7,28,39,-11,26.6,32.8,-6.1,24,ITA
41c12f75,17,1050,11.7,12,6,5,4,20,9,11,19.5,9.3,10.2,24,ITA
41fb0f4e,2,13,0.1,0,0,2,15,0,0,0,0.0,0.0,0.0,24,ITA
420c18a1,28,2520,28.0,28,28,0,1,67,14,53,57.5,21.9,35.6,24,ITA
42eaa028,21,1296,14.4,13,5,8,3,20,15,5,21.0,19.0,2.0,24,ITA
441197b8,19,1647,18.3,19,17,0,4,34,19,15,23.4,18.1,5.3,24,ITA
4431aed2,26,1455,16.2,18,5,8,0,20,23,-3,20.7,20.8,-0.1,24,ITA
44ac04e9,23,716,8.0,3,1,20,5,13,10,3,12.6,9.1,3.5,24,ITA
44eb9093,19,1360,15.1,15,9,4,3,16,16,0,15.6,22.6,-6.9,24,ITA
45191c29,19,774,8.6,8,1,11,10,11,10,1,9.7,11.4,-1.8,24,ITA
45392b06,21,1056,11.7,10,2,11,9,19,14,5,15.2,13.8,1.5,24,ITA
45a03961,18,1222,13.6,16,8,2,6,30,7,23,24.3,9.2,15.1,24,ITA
473803c9,28,1832,20.4,23,6,5,1,16,27,-11,22.0,27.6,-5.5,24,ITA
47c609d5,3,58,0.6,0,0,3,7,2,0,2,2.7,0.5,2.2,24,ITA
481c9ece,25,1409,15.7,16,5,9,2,42,8,34,33.1,12.0,21.2,24,ITA
482d2bc3,25,1398,15.5,18,3,7,2,23,15,8,20.0,20.3,-0.3,24,ITA
4887118d,11,307,3.4,5,0,6,9,2,5,-3,2.6,3.8,-1.2,24,ITA
48b3dd60,27,1641,18.2,20,4,7,1,27,20,7,22.4,19.5,2.9,24,ITA
48d5bd33,26,1472,16.4,17,6,9,2,18,19,-1,13.7,17.0,-3.3,24,ITA
4a5a45c7,21,1320,14.7,14,3,7,2,31,19,12,19.8,13.1,6.7,24,ITA
4abac767,4,177,2.0,1,0,3,1,3,2,1,3.4,2.2,1.3,24,ITA
4ae67f27,22,1908,21.2,22,20,0,0,24,13,11,23.9,19.2,4.7,24,ITA
4b029b31,13,1011,11.2,12,7,1,8,14,17,-3,13.7,15.3,-1.5,24,ITA
4b3e1a38,24,2060,22.9,24,21,0,2,28,28,0,33.7,23.2,10.5,24,ITA
4c62d0c8,2,180,2.0,2,2,0,23,3,1,2,3.5,0.8,2.7,24,ITA
4c8845f7,26,2105,23.4,25,15,1,0,15,36,-21,21.8,31.0,-9.2,24,ITA
4cdcbc14,2,33,0.4,0,0,2,13,0,0,0,0.1,0.6,-0.5,24,ITA
4d8cd038,19,662,7.4,6,0,13,5,12,8,4,10.8,8.5,2.4,24,ITA
4e0c8d66,27,2332,25.9,27,25,0,0,24,24,0,25.9,34.2,-8.2,24,ITA
4e1d5e59,9,681,7.6,8,3,1,1,7,7,0,6.1,6.8,-0.6,24,ITA
4e358a2d,12,924,10.3,10,8,2,7,13,21,-8,6.6,21.3,-14.7,24,ITA
505486d6,25,1770,19.7,20,11,5,2,29,16,13,26.5,21.3,5.1,24,ITA
5128bde4,24,1348,15.0,14,1,10,0,12,19,-7,16.0,20.4,-4.3,24,ITA
517cfb19,23,1378,15.3,15,6,8,1,13,23,-10,17.2,22.0,-4.8,24,ITA
528492ea,24,1524,16.9,19,5,5,4,25,19,6,22.5,19.0,3.4,24,ITA
5294a83f,27,1968,21.9,25,13,2,0,26,24,2,24.9,25.6,-0.7,24,ITA
53a0e358,17,1431,15.9,17,10,0,1,24,27,-3,21.0,23.7,-2.7,24,ITA
53e494ec,1,90,1.0,1,1,0,28,0,2,-2,0.4,1.5,-1.1,24,ITA
546c7f68,5,82,0.9,0,0,5,24,2,2,0,1.8,1.5,0.3,24,ITA
547c0119,5,92,1.0,1,0,4,13,3,3,0,0.9,1.5,-0.6,24,ITA
548bd0de,14,538,6.0,4,2,10,15,6,8,-2,5.4,8.0,-2.6,24,ITA
54e53b7e,4,255,2.8,4,1,0,0,3,5,-2,2.9,5.1,-2.2,24,ITA
55a1cac2,9,299,3.3,3,1,6,7,6,4,2,5.0,4.5,0.5,24,ITA
56fca564,7,192,2.1,1,0,6,2,3,5,-2,1.7,4.3,-2.6,24,ITA
570bb4b9,6,335,3.7,5,0,1,3,7,5,2,5.8,3.7,2.1,24,ITA
5715bb71,25,963,10.7,10,0,15,3,16,12,4,13.3,13.1,0.2,24,ITA
57469b2d,15,496,5.5,4,0,11,4,7,12,-5,7.5,8.5,-1.1,24,ITA
58e08f40,1,7,0.1,0,0,1,0,0,0,0,0.0,0.0,0.0,24,ITA
58e933d2,15,753,8.4,8,4,7,3,10,6,4,10.7,11.4,-0.7,24,ITA
591bf874,16,702,7.8,6,1,10,14,8,18,-10,6.9,17.0,-10.1,24,ITA
596cc50e,26,1581,17.6,16,14,10,2,14,38,-24,15.6,27.3,-11.7,24,ITA
599d91d0,9,86,1.0,0,0,9,18,3,3,0,1.8,1.5,0.3,24,ITA
5a08ee41,29,2574,28.6,29,28,0,0,25,45,-20,31.9,43.1,-11.3,24,ITA
5a7301ae,3,24,0.3,0,0,3,7,1,0,1,0.2,0.1,0.1,24,ITA
5aa53281,29,2390,26.6,29,21,0,0,44,28,16,34.1,24.7,9.4,24,ITA
5b418e15,9,212,2.4,2,0,7,10,2,2,0,2.3,2.5,-0.2,24,ITA
5bd72174,16,1112,12.4,14,4,2,2,7,21,-14,9.8,18.0,-8.3,24,ITA
5cbb5ad6,19,1300,14.4,14,10,5,10,12,18,-6,13.0,19.2,-6.2,24,ITA
5cfc74fc,22,954,10.6,9,0,13,2,10,14,-4,10.6,15.1,-4.5,24,ITA
5dde403b,1,19,0.2,0,0,1,13,0,0,0,0.1,0.6,-0.5,24,ITA
5de3866c,21,1561,17.3,18,10,3,6,15,16,-1,16.5,23.4,-6.8,24,ITA
5e3ecc35,3,23,0.3,0,0,3,21,2,0,2,1.3,0.6,0.7,24,ITA
5e861944,29,1838,20.4,24,0,5,0,29,24,5,31.9,21.1,10.9,24,ITA
5ea8ef20,27,1970,21.9,23,14,4,0,29,23,6,27.4,25.5,1.8,24,ITA
5eae500a,27,2234,24.8,25,21,2,0,47,26,21,33.1,26.0,7.1,24,ITA
5eaed77a,29,2148,23.9,24,19,5,0,22,25,-3,19.2,24.5,-5.3,24,ITA
5efc5389,19,797,8.9,9,2,10,10,16,9,7,10.5,7.7,2.8,24,ITA
5f9970a0,2,91,1.0,1,1,1,27,0,2,-2,1.0,1.2,-0.3,24,ITA
5fa57166,20,1267,14.1,15,9,5,9,11,24,-13,12.0,20.7,-8.7,24,ITA
5fd5ed86,29,2603,28.9,29,28,0,0,42,22,20,42.5,20.9,21.6,24,ITA
61b3978f,16,1098,12.2,14,9,2,7,12,22,-10,10.9,17.5,-6.5,24,ITA
61efb926,30,2542,28.2,28,26,2,0,28,44,-16,30.2,38.3,-8.2,24,ITA
620922ed,19,1710,19.0,19,19,0,0,20,24,-4,15.8,19.0,-3.2,24,ITA
6411925d,3,35,0.4,0,0,3,12,0,2,-2,1.1,0.3,0.8,24,ITA
6416adf0,4,271,3.0,3,2,1,4,0,6,-6,0.0,0.0,0.0,24,ITA
645dffbf,12,356,4.0,2,0,10,15,2,8,-6,1.8,6.0,-4.2,24,ITA
6499048c,30,2093,23.3,29,3,1,0,22,27,-5,23.7,31.5,-7.8,24,ITA
649b01d8,2,180,2.0,2,2,0,28,6,0,6,5.0,1.5,3.5,24,ITA
64cd167d,1,90,1.0,1,1,0,2,1,4,-3,0.2,1.0,-0.8,24,ITA
65fd099c,15,844,9.4,11,0,4,1,14,25,-11,10.9,16.7,-5.8,24,ITA
6662d731,4,360,4.0,4,4,0,26,8,1,7,5.6,2.2,3.3,24,ITA
6841f107,14,701,7.8,8,3,6,10,9,11,-2,8.5,8.4,0.0,24,ITA
68b7e72e,16,1198,13.3,14,12,2,0,15,23,-8,14.6,19.4,-4.9,24,ITA
6928979a,29,2266,25.2,27,14,2,0,59,12,47,51.5,17.9,33.6,24,ITA
6af30900,15,1099,12.2,11,10,4,7,5,15,-10,11.8,17.9,-6.1,24,ITA
6b21b7b5,16,897,10.0,11,0,5,8,12,16,-4,11.7,15.6,-3.9,24,ITA
6b587d3d,22,993,11.0,14,0,8,5,7,20,-13,10.3,17.4,-7.1,24,ITA
6b635f5c,22,1685,18.7,19,16,3,3,18,26,-8,19.1,20.8,-1.7,24,ITA
6bb2c084,26,2084,23.2,24,19,2,0,32,24,8,37.7,21.2,16.5,24,ITA
6caffe81,29,2186,24.3,25,14,4,0,30,51,-21,28.8,38.9,-10.2,24,ITA
6cc97b6a,23,1533,17.0,18,9,5,2,14,26,-12,17.8,19.9,-2.1,24,ITA
6d5701f2,11,632,7.0,7,5,4,10,9,12,-3,6.8999999999999995,9.5,-2.6999999999999997,24,ITA
6e058f06,30,1444,16.0,14,4,16,0,25,17,8,25.3,15.1,10.3,24,ITA
6e4df551,2,41,0.5,0,0,2,0,1,0,1,2.0,0.9,1.1,24,ITA
6eee05f1,28,2366,26.3,27,25,1,1,50,26,24,39.8,28.4,11.3,24,ITA
6f8cd6d0,28,2095,23.3,27,8,1,0,54,12,42,47.0,17.5,29.6,24,ITA
6fdac234,16,1364,15.2,15,15,1,0,10,21,-11,17.6,18.2,-0.6,24,ITA
70006831,5,63,0.7,0,0,5,24,0,3,-3,0.3,1.7,-1.3,24,ITA
705a1642,1,17,0.2,0,0,1,7,0,0,0,0.0,0.3,-0.2,24,ITA
707b98f1,23,848,9.4,7,2,16,6,13,16,-3,10.6,15.2,-4.5,24,ITA
72f5b81f,4,109,1.2,1,0,3,15,0,0,0,0.5,0.7,-0.2,24,ITA
72f87f25,17,413,4.6,2,0,15,13,5,12,-7,7.4,8.0,-0.6,24,ITA
74d4cec6,6,186,2.1,1,1,5,1,2,4,-2,2.6,3.5,-0.9,24,ITA
75374ee7,6,255,2.8,3,0,3,3,4,1,3,3.2,2.3,0.9,24,ITA
75438a9a,11,709,7.9,8,3,3,10,8,15,-7,6.9,10.8,-3.8,24,ITA
75b86fb3,23,1895,21.1,23,14,0,4,47,11,36,42.8,16.6,26.2,24,ITA
75bd6f48,4,100,1.1,0,0,4,6,2,6,-4,1.8,4.2,-2.4,24,ITA
75c62731,24,953,10.6,9,3,15,7,7,27,-20,8.6,19.2,-10.5,24,ITA
75f2c59f,22,1497,16.6,18,10,4,1,21,25,-4,18.2,21.7,-3.6,24,ITA
76b2817e,15,434,4.8,3,0,12,1,5,12,-7,3.9,9.3,-5.4,24,ITA
76ff8d0d,27,1912,21.2,23,8,4,3,25,40,-15,24.7,29.6,-4.9,24,ITA
780e3631,30,2592,28.8,30,23,0,0,31,34,-3,30.6,39.7,-9.1,24,ITA
78338347,10,287,3.2,1,0,9,9,2,3,-1,4.4,4.3,0.1,24,ITA
78a3c38e,10,638,7.1,10,2,0,12,2,13,-11,6.4,9.7,-3.3,24,ITA
78f13530,1,23,0.3,0,0,1,1,0,0,0,0.2,0.0,0.2,24,ITA
79083382,19,1666,18.5,18,15,1,4,21,22,-1,27.9,18.7,9.2,24,ITA
794364d7,6,199,2.2,0,0,6,10,3,4,-1,2.2,3.2,-1.0,24,ITA
79443529,25,1763,19.6,20,7,5,0,31,16,15,29.6,15.1,14.5,24,ITA
7952d0c2,6,323,3.6,4,0,2,12,1,2,-1,2.5,3.7,-1.2,24,ITA
79b0d6a0,23,2070,23.0,23,23,0,7,41,27,14,31.7,20.8,10.9,24,ITA
79ca3e23,26,2102,23.4,25,13,1,1,24,30,-6,19.4,29.3,-9.9,24,ITA
7afb1573,10,241,2.7,2,0,8,16,2,2,0,2.0,5.6,-3.6,24,ITA
7afbd2c3,22,728,8.1,5,1,17,1,8,9,-1,8.2,10.2,-2.0,24,ITA
7c104bb7,23,1342,14.9,16,1,7,0,21,18,3,17.5,14.9,2.6,24,ITA
7c4b4e36,1,8,0.1,0,0,1,12,2,0,2,0.2,0.0,0.2,24,ITA
7d6d4395,2,19,0.2,0,0,2,6,0,0,0,0.3,0.1,0.2,24,ITA
7e0b6c50,5,70,0.8,0,0,5,15,2,0,2,0.7,1.1,-0.4,24,ITA
7eb97a8e,21,646,7.2,4,1,17,3,11,10,1,9.3,12.3,-2.9,24,ITA
7edfbb8a,20,1629,18.1,19,15,1,0,36,16,20,29.7,20.5,9.3,24,ITA
7ef972c3,14,744,8.3,8,4,6,3,7,19,-12,7.9,17.1,-9.2,24,ITA
7f267d66,20,1103,12.3,13,8,7,10,11,19,-8,15.1,16.2,-1.1,24,ITA
7f609bfc,24,1813,20.1,22,13,2,0,28,19,9,23.0,17.6,5.4,24,ITA
7f78ad23,28,2235,24.8,27,19,1,1,25,22,3,24.1,24.0,0.1,24,ITA
7fac99d4,23,1327,14.7,15,6,8,4,8,21,-13,14.3,21.4,-7.1,24,ITA
7fe90ccd,25,1454,16.2,18,3,7,3,28,18,10,23.5,16.6,6.9,24,ITA
801831fe,14,471,5.199999999999999,5,0,9,8,9,7,2,4.9,5.7,-0.9,24,ITA
80490d7f,21,1497,16.6,15,14,6,4,22,11,11,22.1,13.7,8.4,24,ITA
80556f08,10,719,8.0,9,5,1,0,3,14,-11,5.7,15.0,-9.3,24,ITA
80dbbd10,13,648,7.2,6,2,7,6,7,11,-4,5.0,13.0,-8.0,24,ITA
817c6964,10,687,7.6,8,6,2,5,14,12,2,10.6,10.8,-0.3,24,ITA
822ed0ec,29,2474,27.5,28,23,1,0,24,39,-15,30.5,40.3,-9.8,24,ITA
82598b71,11,689,7.7,6,6,5,14,13,11,2,11.0,10.700000000000001,0.3,24,ITA
83c06f3a,30,2047,22.7,23,10,7,0,23,34,-11,23.6,30.5,-6.9,24,ITA
83fe71b8,24,1709,19.0,19,9,5,2,19,25,-6,17.5,24.0,-6.6,24,ITA
854ee61a,17,622,6.9,6,0,11,5,7,9,-2,8.1,9.0,-1.0,24,ITA
85613cf0,26,745,8.3,6,2,20,0,17,6,11,14.7,4.6,10.2,24,ITA
85a44ecc,22,1587,17.6,19,12,3,0,17,36,-19,14.3,34.9,-20.5,24,ITA
85f476cc,12,303,3.4,2,1,10,9,5,1,4,5.0,4.1,1.0,24,ITA
85f7d1be,6,183,2.0,2,0,4,3,1,2,-1,2.2,2.3,-0.1,24,ITA
85f7ed25,26,1808,20.1,21,13,5,1,25,33,-8,23.2,31.1,-8.0,24,ITA
8650af85,24,1642,18.2,18,17,6,6,17,31,-14,20.5,26.1,-5.6,24,ITA
867239d3,2,54,0.6,0,0,2,1,2,0,2,1.2,0.2,1.1,24,ITA
87278bce,13,470,5.199999999999999,3,2,10,14,9,9,0,6.0,6.5,-0.6,24,ITA
8790f988,22,1033,11.5,11,1,11,1,25,8,17,13.8,10.7,3.1,24,ITA
8794e251,24,2041,22.7,23,22,1,0,32,17,15,32.4,16.3,16.1,24,ITA
89976232,15,998,11.1,12,8,3,4,12,12,0,13.3,12.5,0.8,24,ITA
8a6de8c7,20,1305,14.5,16,2,4,0,15,22,-7,15.7,21.0,-5.2,24,ITA
8b66d9cc,10,162,1.8,1,0,9,8,3,2,1,2.2,2.2,0.0,24,ITA
8b8a56ce,17,1084,12.0,13,7,4,5,22,13,9,20.2,14.2,6.0,24,ITA
8bbe2df5,30,2403,26.7,26,22,4,0,22,54,-32,22.0,51.0,-28.9,24,ITA
8bc8829a,1,5,0.1,0,0,1,16,1,0,1,0.3,0.0,0.3,24,ITA
8c4b95af,2,27,0.3,0,0,2,2,0,0,0,0.0,0.0,0.0,24,ITA
8c63fae5,19,1435,15.9,16,12,3,8,23,19,4,21.1,20.8,0.3,24,ITA
8c90fd7a,18,1420,15.8,16,8,2,1,27,19,8,27.4,15.7,11.7,24,ITA
8cabdc1e,29,2610,29.0,29,29,0,0,30,53,-23,31.6,44.8,-13.2,24,ITA
8d3cd59d,29,1220,13.6,9,6,20,0,37,2,35,31.3,9.8,21.5,24,ITA
8da74c05,22,1577,17.5,18,9,4,3,15,14,1,19.7,15.6,4.1,24,ITA
8daee720,1,8,0.1,0,0,1,12,0,1,-1,0.0,0.1,-0.1,24,ITA
8e697a8f,25,1349,15.0,15,3,10,0,21,8,13,19.7,11.9,7.8,24,ITA
8ec109e6,26,2216,24.6,24,24,2,1,30,51,-21,28.7,38.6,-9.9,24,ITA
8ec56e62,19,1710,19.0,19,19,0,10,37,20,17,27.3,23.4,4.0,24,ITA
8eec784d,25,926,10.3,8,2,17,0,17,8,9,17.4,8.5,8.9,24,ITA
8ef2452a,5,368,4.1,3,3,2,25,8,13,-5,6.5,8.6,-2.1,24,ITA
911080b1,1,16,0.2,0,0,1,1,0,1,-1,0.0,0.7,-0.7,24,ITA
914ab9a1,11,859,9.5,10,9,1,16,9,17,-8,11.6,15.2,-3.6,24,ITA
91d0fabf,13,1148,12.8,13,12,0,0,18,21,-3,15.1,20.6,-5.5,24,ITA
91ff775f,29,2164,24.0,25,10,4,0,16,36,-20,21.1,32.8,-11.7,24,ITA
921f6058,4,27,0.3,0,0,4,9,0,0,0,0.4,0.3,0.1,24,ITA
928143e7,2,33,0.4,0,0,2,6,0,1,-1,0.4,0.4,0.0,24,ITA
928a4a61,19,615,6.8,6,1,13,7,14,13,1,12.1,8.6,3.5,24,ITA
933d3b51,13,759,8.4,8,4,5,2,10,8,2,8.9,6.1,2.8,24,ITA
938d8a55,1,15,0.2,0,0,1,11,0,1,-1,0.1,0.3,-0.2,24,ITA
9413b19f,23,2053,22.8,23,22,0,1,38,28,10,40.1,23.8,16.3,24,ITA
94816803,18,832,9.2,10,0,8,10,12,10,2,11.6,12.4,-0.8,24,ITA
94b2001f,22,1822,20.2,20,20,2,1,32,16,16,28.5,14.9,13.6,24,ITA
94bccc82,13,907,10.1,10,5,3,12,17,14,3,19.3,12.0,7.4,24,ITA
957e4c87,24,1629,18.1,18,8,6,3,19,30,-11,14.0,32.2,-18.2,24,ITA
95facda1,26,1799,20.0,23,12,3,0,13,38,-25,18.9,30.4,-11.5,24,ITA
966eea58,28,1967,21.9,21,11,7,0,22,34,-12,20.9,29.3,-8.4,24,ITA
967ac202,21,890,9.9,9,3,12,9,8,16,-8,11.5,16.6,-5.1,24,ITA
968a1c2f,10,217,2.4,2,1,8,20,3,6,-3,2.0,5.5,-3.5,24,ITA
96e0490d,27,2026,22.5,22,13,5,3,54,12,42,46.8,17.7,29.1,24,ITA
970b8574,24,1643,18.3,23,1,1,4,45,12,33,37.2,14.9,22.3,24,ITA
97d7afbd,15,1350,15.0,15,15,0,9,12,18,-6,14.4,18.3,-3.9,24,ITA
9823be92,25,1774,19.7,21,13,4,2,21,16,5,18.7,17.8,0.8,24,ITA
983ff2c7,9,214,2.4,2,1,7,20,0,6,-6,2.2,4.0,-1.8,24,ITA
986693ed,20,1466,16.3,16,9,4,2,22,36,-14,20.6,24.0,-3.4,24,ITA
98a84572,8,138,1.5,0,0,8,23,0,7,-7,1.2,3.7,-2.5,24,ITA
98d2c2c4,25,2018,22.4,23,15,2,1,37,20,17,29.0,21.9,7.1,24,ITA
997fff07,30,2700,30.0,30,30,0,0,22,45,-23,29.4,40.2,-10.9,24,ITA
9b3099d6,1,9,0.1,0,0,1,1,0,0,0,0.0,0.3,-0.3,24,ITA
9ba7b4fa,1,8,0.1,0,0,1,0,0,0,0,0.1,0.4,-0.3,24,ITA
9bc9a519,8,446,5.0,5,3,3,2,5,4,1,5.7,5.3,0.4,24,ITA
9bd97418,1,14,0.2,0,0,1,1,0,2,-2,0.0,0.3,-0.3,24,ITA
9c435456,16,1379,15.3,16,13,0,13,19,15,4,19.7,16.3,3.3,24,ITA
9d376bef,1,12,0.1,0,0,1,29,0,0,0,0.0,0.3,-0.3,24,ITA
9d60028d,15,563,6.3,4,0,11,8,9,8,1,8.3,10.4,-2.0,24,ITA
9deaf2c8,3,22,0.2,0,0,3,4,0,0,0,0.2,0.2,0.0,24,ITA
9e1577aa,24,1998,22.2,23,18,1,3,31,24,7,27.8,29.9,-2.1,24,ITA
9ef42479,15,309,3.4,2,0,13,5,3,2,1,3.9,5.0,-1.1,24,ITA
9f1893b9,30,2235,24.8,27,12,3,0,29,26,3,29.0,27.1,1.9,24,ITA
9f5a610b,30,2700,30.0,30,30,0,0,26,45,-19,32.8,44.6,-11.8,24,ITA
9f84febe,16,1134,12.6,14,4,2,12,20,10,10,17.5,10.0,7.5,24,ITA
9fa26bc2,29,2610,29.0,29,29,0,1,29,24,5,30.4,26.0,4.4,24,ITA
a111cf41,10,900,10.0,10,10,0,19,17,12,5,14.6,8.8,5.7,24,ITA
a14d0ab0,10,343,3.8,3,0,7,6,4,2,2,3.7,3.7,0.0,24,ITA
a26fb8aa,26,2123,23.6,24,15,2,0,42,26,16,33.9,26.1,7.9,24,ITA
a2d9f138,25,2095,23.3,23,21,2,0,26,46,-20,24.3,37.4,-13.2,24,ITA
a3695ac2,1,8,0.1,0,0,1,13,0,0,0,0.2,0.0,0.2,24,ITA
a378a02a,23,1310,14.6,14,9,9,4,18,36,-18,15.6,29.6,-14.0,24,ITA
a3c8b4d3,26,1470,16.3,16,7,10,2,18,36,-18,13.9,32.0,-18.1,24,ITA
a40819d9,3,44,0.5,0,0,3,6,0,1,-1,0.2,1.6,-1.4,24,ITA
a44d3a3c,20,573,6.4,5,0,15,6,5,8,-3,4.4,8.5,-4.1,24,ITA
a4948e67,28,1289,14.3,12,6,16,1,20,20,0,18.5,20.4,-1.9,24,ITA
a5296e55,25,1690,18.8,20,3,5,2,24,20,4,30.0,18.5,11.5,24,ITA
a5db0bec,14,635,7.1,7,2,7,9,11,7,4,11.0,7.0,4.1,24,ITA
a8567629,11,281,3.1,2,0,9,16,1,7,-6,3.5,5.7,-2.2,24,ITA
a8a874f1,29,2395,26.6,27,23,2,0,39,21,18,39.3,19.3,20.0,24,ITA
a9202def,28,2321,25.8,26,21,2,0,44,29,15,35.2,28.4,6.8,24,ITA
a96e5dc0,20,1794,19.9,20,19,0,2,28,35,-7,25.5,32.0,-6.5,24,ITA
a9aa0d1d,20,886,9.8,9,3,11,6,20,9,11,17.3,13.3,4.0,24,ITA
aa25ce92,11,575,6.4,6,3,5,19,4,19,-15,5.5,12.1,-6.6,24,ITA
aa54ec6f,26,1913,21.3,22,17,4,0,22,26,-4,22.6,29.8,-7.2,24,ITA
aa8e289e,28,2221,24.7,25,16,3,0,21,24,-3,24.3,24.5,-0.2,24,ITA
aae9d04a,15,888,9.9,10,3,5,9,8,17,-9,8.899999999999999,13.0,-4.2,24,ITA
ab4449d6,26,2340,26.0,26,26,0,4,37,24,13,32.6,26.9,5.7,24,ITA
ab5c36dd,13,1170,13.0,13,13,0,16,14,17,-3,11.8,15.3,-3.5,24,ITA
ac4003af,2,180,2.0,2,2,0,16,4,1,3,3.0,1.5,1.6,24,ITA
ac4a4508,19,1112,12.4,13,2,6,2,9,18,-9,11.9,19.0,-7.1,24,ITA
acf7e795,5,91,1.0,0,0,5,12,1,0,1,2.6,0.6,2.0,24,ITA
aded8e6f,25,1926,21.4,21,20,4,3,35,19,16,28.0,21.9,6.1,24,ITA
ae4e2852,1,45,0.5,1,0,0,1,0,0,0,0.2,0.6,-0.4,24,ITA
ae94a6c5,25,1464,16.3,15,7,10,5,26,18,8,22.4,15.7,6.7,24,ITA
ae9898c5,26,2033,22.6,24,5,2,2,43,24,19,31.1,22.2,8.9,24,ITA
aeca7743,21,1439,16.0,16,11,5,4,21,22,-1,19.2,18.8,0.4,24,ITA
af104654,2,180,2.0,2,2,0,17,2,6,-4,1.7,3.9,-2.2,24,ITA
afb61630,28,2206,24.5,26,16,2,1,50,26,24,41.5,27.9,13.6,24,ITA
b09e0873,23,1475,16.4,14,8,9,1,14,24,-10,17.3,22.5,-5.2,24,ITA
b0f7e36c,25,1657,18.4,19,6,6,0,25,16,9,27.7,14.8,12.9,24,ITA
b136c945,7,256,2.8,3,0,4,23,3,2,1,4.3,1.8,2.5,24,ITA
b1cd37e6,24,1557,17.3,22,3,2,5,25,14,11,24.5,11.7,12.8,24,ITA
b2e08cb6,1,11,0.1,0,0,1,0,0,1,-1,0.0,0.2,-0.2,24,ITA
b3325a30,18,1049,11.7,12,7,6,9,10,17,-7,9.8,14.3,-4.5,24,ITA
b35a7399,19,1172,13.0,13,11,6,9,24,16,8,21.6,11.7,9.9,24,ITA
b51b1b9c,24,1072,11.9,8,6,16,2,18,14,4,14.8,15.5,-0.8,24,ITA
b5b9bde7,4,51,0.6,0,0,4,17,4,1,3,1.2,1.1,0.1,24,ITA
b5f7d10b,6,336,3.7,5,2,1,2,5,10,-5,3.7,8.2,-4.5,24,ITA
b6964eb6,6,362,4.0,4,2,2,2,8,8,0,5.9,3.7,2.2,24,ITA
b6a1cdf9,28,1390,15.4,14,2,14,0,13,22,-9,18.4,18.9,-0.5,24,ITA
b6baba31,1,12,0.1,0,0,1,3,0,0,0,0.0,0.0,0.0,24,ITA
b70bde8f,3,30,0.3,0,0,3,16,1,0,1,0.9,0.4,0.5,24,ITA
b79858d5,28,2484,27.6,28,23,0,0,30,32,-2,24.2,28.4,-4.2,24,ITA
b85bf253,15,1084,12.0,12,9,3,4,8,12,-4,10.7,13.6,-2.9,24,ITA
b8a642fc,18,707,7.9,8,1,10,3,15,12,3,14.2,11.8,2.4,24,ITA
b937e490,6,91,1.0,0,0,6,3,0,2,-2,0.7,1.1,-0.4,24,ITA
b96b595c,24,1938,21.5,21,20,3,1,46,12,34,41.1,17.6,23.4,24,ITA
ba1e04b3,2,81,0.9,1,0,1,10,0,1,-1,0.5,0.4,0.1,24,ITA
ba3d3bea,23,1285,14.3,15,3,8,6,16,17,-1,17.8,17.4,0.5,24,ITA
ba492306,18,521,5.8,2,0,16,12,11,7,4,8.8,5.0,3.8,24,ITA
bb376bed,25,1563,17.4,19,11,6,0,18,16,2,19.7,15.7,4.0,24,ITA
bba30585,24,1810,20.1,22,16,2,3,37,23,14,27.5,19.8,7.8,24,ITA
bcf5058a,7,630,7.0,7,7,0,23,14,8,6,8.9,8.8,0.1,24,ITA
bdbff2b5,22,1239,13.8,15,4,7,4,18,23,-5,16.3,18.7,-2.5,24,ITA
be2706c0,20,859,9.5,9,6,11,4,13,9,4,11.2,9.2,2.0,24,ITA
bee704fc,27,2075,23.1,22,22,5,2,38,28,10,31.6,28.9,2.7,24,ITA
bf168004,27,2430,27.0,27,27,0,2,33,56,-23,32.9,42.9,-9.9,24,ITA
bf57eaab,18,736,8.2,6,0,12,12,9,7,2,6.7,8.5,-1.8,24,ITA
c13ddd3e,28,2431,27.0,28,15,0,0,34,54,-20,30.6,41.2,-10.6,24,ITA
c1b9b13c,7,167,1.9,1,0,6,20,3,1,2,4.1,2.2,1.8,24,ITA
c1d95617,30,2700,30.0,30,30,0,0,27,40,-13,26.7,37.9,-11.2,24,ITA
c20892ee,1,5,0.1,0,0,1,0,0,0,0,0.0,0.1,-0.1,24,ITA
c2357b65,17,697,7.7,8,2,9,8,17,6,11,14.7,7.9,6.8,24,ITA
c235e803,11,807,9.0,8,7,3,1,20,14,6,16.6,10.6,5.9,24,ITA
c23c8e0d,8,191,2.1,1,1,7,11,1,5,-4,3.7,1.9,1.8,24,ITA
c391a179,28,2344,26.0,28,17,0,0,21,39,-18,23.2,34.0,-10.8,24,ITA
c56dc39e,12,492,5.5,4,3,8,7,10,5,5,5.9,5.7,0.2,24,ITA
c69ef855,23,1037,11.5,9,5,14,4,13,19,-6,13.6,19.3,-5.7,24,ITA
c6db4f29,20,698,7.8,6,1,14,6,8,19,-11,8.9,17.1,-8.2,24,ITA
c707411f,6,424,4.7,6,1,0,1,2,8,-6,4.0,9.2,-5.2,24,ITA
c7259b83,26,1319,14.7,13,6,13,3,24,22,2,17.5,23.7,-6.3,24,ITA
c74d63ac,27,1796,20.0,22,6,5,3,15,32,-17,22.4,29.1,-6.6,24,ITA
c77be0cf,19,706,7.8,8,2,11,11,8,14,-6,10.0,15.2,-5.2,24,ITA
c83c203f,14,542,6.0,7,0,7,12,3,14,-11,5.1,11.7,-6.5,24,ITA
c84dcc88,1,10,0.1,0,0,1,19,0,0,0,0.0,0.0,0.0,24,ITA
c8d7131c,12,609,6.8,6,1,6,9,4,7,-3,7.2,4.3,3.0,24,ITA
c976160c,1,3,0.0,0,0,1,1,0,0,0,0.0,0.0,0.0,24,ITA
c9fc39ce,4,146,1.6,0,0,4,11,3,1,2,3.1,2.1,1.0,24,ITA
ca3db240,30,2164,24.0,21,15,9,0,30,43,-13,26.7,33.1,-6.5,24,ITA
ca607d59,22,715,7.9,5,1,17,2,16,12,4,13.6,9.8,3.7,24,ITA
ca6edaa0,4,88,1.0,0,0,4,17,0,2,-2,1.0,2.2,-1.2,24,ITA
caec77da,21,1520,16.9,18,12,3,1,14,37,-23,15.1,32.4,-17.3,24,ITA
cbe32194,2,11,0.1,0,0,2,4,0,0,0,0.1,0.5,-0.4,24,ITA
cce9f582,26,1980,22.0,22,21,4,2,17,29,-12,19.4,28.9,-9.5,24,ITA
cd0fa27b,26,2082,23.1,26,10,0,1,50,12,38,46.0,17.3,28.7,24,ITA
ce30bfc8,27,2039,22.7,25,17,2,1,25,27,-2,27.2,32.6,-5.4,24,ITA
cf007308,11,339,3.8,4,0,7,3,3,5,-2,3.3,4.8,-1.4,24,ITA
d023d70f,21,1319,14.7,14,6,7,5,12,10,2,16.0,12.2,3.8,24,ITA
d0d8dd44,21,1313,14.6,14,13,7,6,41,4,37,33.3,10.3,23.0,24,ITA
d125f22f,5,157,1.7,2,0,3,4,3,0,3,1.2,0.9,0.3,24,ITA
d19ef4ef,12,309,3.5,2,0,10,17,1,2,-1,4.8,4.9,-0.10000000000000003,24,ITA
d1ac669b,1,1,0.0,0,0,1,25,0,0,0,0.0,0.1,-0.1,24,ITA
d1b49282,16,699,7.8,5,3,11,12,8,14,-6,6.0,9.2,-3.1,24,ITA
d37b0350,19,628,7.0,5,2,14,5,9,11,-2,10.7,7.8,3.0,24,ITA
d3aaad90,26,1407,15.6,15,4,11,4,30,20,10,21.5,16.3,5.2,24,ITA
d3de9af0,29,2341,26.0,28,16,1,0,27,19,8,29.099999999999998,19.7,9.4,24,ITA
d4535821,29,2425,26.9,29,23,0,0,36,28,8,33.5,30.1,3.5,24,ITA
d4a2533d,11,652,7.2,8,2,3,9,13,11,2,7.0,9.5,-2.5,24,ITA
d4c9725f,26,2327,25.9,26,23,0,0,54,31,23,43.2,30.0,13.1,24,ITA
d705ba44,22,1315,14.6,13,7,9,8,24,22,2,21.5,17.4,4.2,24,ITA
d7918b13,1,5,0.1,0,0,1,0,0,0,0,0.0,0.1,-0.1,24,ITA
d7d32194,13,297,3.3,2,0,11,9,3,7,-4,3.0,5.7,-2.7,24,ITA
d8363914,20,1571,17.5,16,11,4,10,18,30,-12,20.7,25.7,-5.1,24,ITA
d85c238b,23,1659,18.4,20,3,3,0,22,20,2,22.6,22.5,0.1,24,ITA
d8cda243,20,634,7.0,7,0,13,9,12,7,5,11.1,5.2,5.8,24,ITA
d995ed27,26,1912,21.2,23,9,3,1,31,24,7,26.4,23.0,3.4,24,ITA
d9ebed1c,9,476,5.3,5,0,4,11,3,9,-6,4.0,9.0,-4.9,24,ITA
d9f83409,1,5,0.1,0,0,1,1,0,0,0,0.1,0.0,0.1,24,ITA
da76bab4,27,1193,13.3,11,4,16,2,16,10,6,16.8,12.8,4.0,24,ITA
dac2bed8,1,1,0.0,0,0,1,4,0,0,0,0.0,0.0,0.0,24,ITA
db092d3b,13,756,8.4,9,3,4,0,14,10,4,14.0,8.9,5.2,24,ITA
dbfa4f16,27,1616,18.0,20,4,7,2,17,27,-10,20.5,22.5,-2.0,24,ITA
dc3fa3b5,2,73,0.8,1,0,1,13,1,0,1,0.8,0.1,0.6,24,ITA
dc61b402,23,1742,19.4,20,10,3,1,25,34,-9,23.7,25.9,-2.2,24,ITA
dd0daf32,30,2381,26.5,29,13,1,0,66,14,52,55.1,20.0,35.1,24,ITA
dd403465,2,11,0.1,0,0,2,13,0,2,-2,0.4,0.4,0.0,24,ITA
dd86e8e4,24,1683,18.7,17,10,7,5,18,24,-6,21.0,23.1,-2.1,24,ITA
de0f152c,13,715,7.9,7,4,6,9,6,8,-2,6.6,7.7,-1.0999999999999999,24,ITA
de13cee5,25,2198,24.4,25,23,0,4,37,20,17,30.9,24.8,6.1,24,ITA
dea88efd,27,2169,24.1,25,12,2,0,37,30,7,39.2,25.9,13.3,24,ITA
dfd24c07,10,499,5.5,6,0,4,14,9,7,2,7.6,7.5,0.1,24,ITA
dfd56738,28,1701,18.9,17,8,11,1,23,41,-18,20.9,31.1,-10.2,24,ITA
dff153a4,28,2187,24.3,26,15,2,0,38,27,11,29.3,24.1,5.2,24,ITA
e04dca4a,1,45,0.5,0,0,1,12,0,0,0,0.4,0.8,-0.4,24,ITA
e08ac719,7,630,7.0,7,7,0,4,5,7,-2,6.2,7.7,-1.5,24,ITA
e0921a4f,21,1504,16.7,20,5,1,1,36,20,16,24.8,14.3,10.6,24,ITA
e0ce7038,11,234,2.6,0,0,11,14,0,5,-5,1.9,4.4,-2.5,24,ITA
e14ec482,26,1443,16.0,16,5,10,0,30,12,18,22.8,12.1,10.7,24,ITA
e19660a8,20,1548,17.2,16,12,4,5,27,14,13,22.8,17.5,5.2,24,ITA
e1b0a70d,27,2430,27.0,27,27,0,2,40,28,12,35.6,33.2,2.4,24,ITA
e1cbb531,30,2562,28.5,30,17,0,0,39,32,7,46.0,27.0,19.0,24,ITA
e288d4b3,25,1290,14.3,14,8,11,3,24,14,10,23.1,19.7,3.4,24,ITA
e34e086c,12,678,7.5,8,3,4,3,2,14,-12,5.3,12.4,-7.1,24,ITA
e3756e72,29,2396,26.6,28,14,1,0,25,23,2,27.1,23.7,3.4,24,ITA
e4ba67f2,3,22,0.30000000000000004,0,0,3,21,0,0,0,0.1,0.6,-0.5,24,ITA
e58cbfd5,18,1160,12.9,14,6,4,4,18,13,5,14.6,12.8,1.9,24,ITA
e599253a,26,1370,15.2,15,7,11,3,30,21,9,24.0,20.0,4.1,24,ITA
e613313c,9,770,8.6,9,8,0,0,6,9,-3,6.2,9.4,-3.2,24,ITA
e6536124,24,995,11.1,9,3,15,4,11,13,-2,11.9,16.8,-4.9,24,ITA
e74f0e59,13,578,6.4,6,0,7,14,11,5,6,7.3,8.0,-0.8,24,ITA
e7695e6c,23,1739,19.3,21,10,2,0,24,23,1,17.1,19.7,-2.6,24,ITA
e8271ad9,22,984,10.9,10,0,12,4,10,15,-5,12.0,13.9,-1.8,24,ITA
e8c930bb,26,2059,22.9,26,10,0,1,24,24,0,19.8,22.2,-2.4,24,ITA
e95069bb,1,17,0.2,0,0,1,27,0,0,0,0.3,0.1,0.2,24,ITA
e97fd090,26,1867,20.7,23,11,3,1,42,23,19,36.3,23.7,12.6,24,ITA
ea02beaf,24,1420,15.8,17,1,7,4,8,21,-13,16.9,21.1,-4.1,24,ITA
eb0ec070,24,1549,17.2,19,8,5,5,16,33,-17,14.5,28.6,-14.1,24,ITA
eb2fe5b6,18,409,4.5,2,0,16,4,7,7,0,7.4,6.7,0.6,24,ITA
ec315772,3,36,0.4,0,0,3,7,0,2,-2,0.5,1.3,-0.8,24,ITA
ec52b661,8,483,5.4,6,5,2,0,5,14,-9,5.1,10.2,-5.0,24,ITA
ec5dae45,4,67,0.7,0,0,4,5,1,1,0,1.1,0.5,0.6,24,ITA
ed5c0319,1,74,0.8,1,0,0,0,0,3,-3,0.5,1.8,-1.3,24,ITA
edd81e2a,4,52,0.6,0,0,4,13,0,4,-4,0.6,2.8,-2.3,24,ITA
ee251371,23,1462,16.2,16,5,7,1,27,11,16,21.2,17.2,4.1,24,ITA
ee5565ae,2,31,0.3,0,0,2,2,1,0,1,1.4,0.0,1.4,24,ITA
ee64a822,29,2561,28.5,29,24,0,0,41,24,17,34.7,28.2,6.6,24,ITA
ee6e2b92,2,20,0.2,0,0,2,7,1,1,0,0.1,0.1,-0.1,24,ITA
ee833569,14,1260,14.0,14,14,0,11,10,25,-15,14.0,19.9,-5.9,24,ITA
ef2e5e1a,21,1002,11.1,13,2,8,1,15,12,3,9.8,11.5,-1.7,24,ITA
ef3c876b,28,2457,27.3,28,23,0,0,20,41,-21,27.9,41.2,-13.3,24,ITA
ef6eef89,15,933,10.4,10,8,5,8,10,13,-3,9.9,13.7,-3.8,24,ITA
efc9e31f,29,1785,19.8,20,5,9,1,18,30,-12,20.7,31.1,-10.4,24,ITA
efdeaff3,3,270,3.0,3,3,0,27,5,5,0,2.4,4.9,-2.5,24,ITA
eff9c9ea,1,1,0.0,0,0,1,25,0,1,-1,0.8,0.9,-0.1,24,ITA
f025eade,22,1055,11.7,11,4,11,7,12,17,-5,14.4,15.9,-1.5,24,ITA
f0f7f62f,7,630,7.0,7,7,0,17,6,8,-2,8.1,6.0,2.2,24,ITA
f25de136,6,277,3.1,3,2,3,17,1,7,-6,3.2,4.7,-1.5,24,ITA
f37f3522,28,2342,26.0,28,21,0,0,27,48,-21,27.8,38.8,-10.9,24,ITA
f42d6c13,25,1196,13.3,14,1,11,4,19,29,-10,14.9,25.4,-10.5,24,ITA
f4797849,22,1750,19.4,19,15,3,5,22,21,1,19.8,21.0,-1.2,24,ITA
f49c4ae9,16,920,10.2,11,3,5,0,11,11,0,9.4,12.4,-3.0,24,ITA
f4d60499,29,2428,27.0,28,25,1,0,27,35,-8,22.6,27.8,-5.2,24,ITA
f554e29b,2,180,2.0,2,2,0,28,6,6,0,2.8,4.0,-1.1,24,ITA
f573a8bf,23,769,8.5,7,2,16,6,9,14,-5,10.4,10.6,-0.1,24,ITA
f5c4fd91,14,464,5.2,5,0,9,10,4,6,-2,5.6,7.1,-1.5,24,ITA
f7036e1c,27,2179,24.2,26,13,1,1,63,12,51,50.7,18.3,32.4,24,ITA
f7223718,13,1023,11.4,13,11,0,8,14,8,6,16.3,9.6,6.7,24,ITA
f794e9ab,3,181,2.0,2,2,1,24,4,2,2,4.0,2.7,1.4,24,ITA
f7c491f1,29,2609,29.0,29,28,0,0,29,43,-14,31.4,39.0,-7.6,24,ITA
f7e2af2c,20,1420,15.8,15,10,5,6,17,17,0,16.7,19.0,-2.3,24,ITA
f8342731,6,114,1.3,1,0,5,11,1,8,-7,0.8,2.3,-1.5,24,ITA
f95f49d2,1,4,0.0,0,0,1,6,0,1,-1,0.8,1.0,-0.2,24,ITA
f9758dae,25,1204,13.4,13,6,12,4,11,16,-5,13.5,14.5,-1.1,24,ITA
f97f9188,20,865,9.6,9,2,11,10,17,7,10,14.1,9.5,4.7,24,ITA
f9c927de,29,1631,18.1,19,8,10,0,20,15,5,20.1,17.5,2.6,24,ITA
fa449bba,1,90,1.0,1,1,0,1,0,2,-2,1.0,2.0,-1.0,24,ITA
faa13947,3,68,0.8,0,0,3,13,1,0,1,0.6,0.8,-0.2,24,ITA
fadf9a05,18,1376,15.3,15,12,3,6,15,26,-11,13.6,19.9,-6.3,24,ITA
faed84db,17,722,8.0,7,1,10,8,5,20,-15,5.8,14.5,-8.7,24,ITA
fb37a645,27,1603,17.8,17,10,10,2,22,25,-3,18.4,23.3,-4.9,24,ITA
fb77bfef,3,181,2.0,2,2,1,14,2,6,-4,2.3,4.6000000000000005,-2.1999999999999997,24,ITA
fcb38f57,27,2429,27.0,27,26,0,0,53,32,21,45.1,32.2,13.0,24,ITA
fd987f24,11,397,4.4,4,0,7,18,3,7,-4,5.5,5.8,-0.2,24,ITA
fdf4b948,14,459,5.1,5,1,9,13,6,9,-3,4.2,10.7,-6.4,24,ITA
ff579c7e,21,718,8.0,9,0,12,9,13,10,3,10.9,8.0,2.9,24,ITA
ff5ea0bf,16,1249,13.9,15,11,1,2,22,16,6,18.8,15.5,3.4,24,ITA
ff800ed8,17,927,10.3,11,3,6,2,13,24,-11,12.3,17.9,-5.7,24,ITA
00a8d210,23,1650,18.3,18,12,5,2,21,17,4,29.4,25.2,4.3,24,FRA
011b2a32,4,23,0.3,0,0,4,2,2,0,2,1.5,0.0,1.4,24,FRA
01870104,18,1321,14.7,16,4,2,0,12,15,-3,16.3,18.7,-2.5,24,FRA
01becd60,9,495,5.5,6,0,3,5,4,9,-5,5.9,9.4,-3.5999999999999996,24,FRA
01fd01e8,20,1710,19.0,19,18,1,1,24,33,-9,19.0,25.3,-6.3,24,FRA
02b3733e,9,631,7.0,8,4,1,8,7,10,-3,9.4,9.1,0.3,24,FRA
02bcaf8e,18,226,2.5,1,0,17,5,2,0,2,3.1,1.5,1.6,24,FRA
039f1983,20,1661,18.5,18,17,2,2,21,23,-2,23.1,22.6,0.5,24,FRA
0400dd2f,12,307,3.4000000000000004,2,0,10,11,2,0,2,4.4,3.2,1.2,24,FRA
04ac78d2,16,719,8.0,7,5,9,9,6,8,-2,9.0,9.5,-0.5,24,FRA
04bb2b06,1,32,0.4,0,0,1,0,0,0,0,0.1,0.7,-0.6,24,FRA
0512a60a,19,1462,16.2,17,10,2,1,13,27,-14,15.5,22.6,-7.1,24,FRA
0595569d,8,720,8.0,8,8,0,19,10,15,-5,12.6,12.6,0.0,24,FRA
059a83b8,6,153,1.7,1,0,5,4,2,2,0,3.3,3.3,0.0,24,FRA
05ba9d7c,11,295,3.3,3,0,8,1,6,8,-2,5.5,4.4,1.1,24,FRA
061266cd,18,943,10.5,9,7,9,6,11,13,-2,9.1,12.3,-3.3,24,FRA
065dc209,23,1561,17.3,18,5,5,0,20,10,10,24.5,17.9,6.6,24,FRA
06a1d642,25,1648,18.3,19,5,6,0,24,25,-1,26.8,20.5,6.4,24,FRA
06c48679,20,1615,17.9,20,15,0,1,25,17,8,28.3,23.1,5.2,24,FRA
06efa9dc,7,377,4.2,3,0,4,1,5,3,2,6.2,4.7,1.5,24,FRA
08f5afaa,23,1989,22.1,23,22,0,2,54,18,36,45.8,26.8,19.0,24,FRA
0959184b,6,181,2.0,2,0,4,2,1,2,-1,0.8,4.4,-3.5,24,FRA
0b33f6ad,8,720,8.0,8,8,0,2,14,12,2,11.5,12.7,-1.2,24,FRA
0b6911e4,7,117,1.3,0,0,7,2,3,0,3,2.9,1.0,1.9,24,FRA
0be95d34,27,2099,23.3,25,3,2,0,34,19,15,32.7,24.1,8.6,24,FRA
0bfca6a1,24,1886,21.0,22,11,2,1,29,36,-7,27.1,33.7,-6.6,24,FRA
0cbc8baa,16,1165,12.9,13,8,3,4,13,17,-4,13.6,18.2,-4.6,24,FRA
0d7b6576,22,1276,14.2,15,2,7,1,20,16,4,21.5,19.099999999999998,2.4,24,FRA
0da3d7ab,1,10,0.1,0,0,1,9,1,0,1,0.2,0.1,0.1,24,FRA
0e46fa2f,16,557,6.2,6,0,10,5,8,7,1,9.3,7.4,1.9,24,FRA
0e8d7b6c,11,688,7.6,9,1,2,2,11,13,-2,8.2,11.4,-3.2,24,FRA
0f8418aa,21,1221,13.6,13,10,8,2,17,21,-4,19.1,18.3,0.8,24,FRA
0f86995c,2,9,0.1,0,0,2,1,0,0,0,0.3,0.8,-0.5,24,FRA
102c9665,24,1923,21.4,21,19,3,2,32,13,19,33.2,22.0,11.2,24,FRA
10cff752,22,1399,15.5,17,1,5,0,16,22,-6,19.4,21.6,-2.2,24,FRA
10e51236,3,155,1.7,2,0,1,8,1,7,-6,1.9,3.8,-1.9,24,FRA
10f0fdd3,3,269,3.0,3,2,0,0,4,4,0,5.2,2.6,2.5,24,FRA
12a4e38c,17,1530,17.0,17,17,0,10,16,24,-8,18.5,25.7,-7.2,24,FRA
12de1b0d,7,270,3.0,4,0,3,4,2,6,-4,2.8,5.9,-3.1,24,FRA
12f9a649,2,16,0.2,0,0,2,3,0,0,0,0.0,0.4,-0.4,24,FRA
133d2aa5,3,14,0.2,0,0,3,1,0,0,0,0.3,0.2,0.0,24,FRA
13e827f8,20,848,9.4,10,0,10,4,6,13,-7,8.7,12.4,-3.7,24,FRA
148e136f,24,1222,13.6,12,5,12,1,22,10,12,24.9,13.2,11.7,24,FRA
15937e17,20,1684,18.7,19,16,1,2,19,26,-7,22.1,28.1,-6.0,24,FRA
15944afd,6,102,1.1,0,0,6,6,2,3,-1,1.9,2.2,-0.3,24,FRA
1598599e,11,612,6.8,8,1,3,6,8,6,2,10.4,8.3,2.1,24,FRA
1609700b,1,5,0.1,0,0,1,4,0,0,0,0.4,0.0,0.4,24,FRA
16aa7d4c,26,2340,26.0,26,26,0,1,36,19,17,36.2,26.8,9.4,24,FRA
17bb562c,24,2147,23.9,24,21,0,1,24,30,-6,26.0,35.1,-9.1,24,FRA
17e1261b,21,1299,14.4,14,7,7,1,23,12,11,23.2,22.7,0.5,24,FRA
19053e31,10,499,5.5,6,0,4,0,7,3,4,8.0,4.7,3.3,24,FRA
1906b842,10,347,3.9,4,0,6,4,6,8,-2,5.0,4.7,0.3,24,FRA
1956b948,26,1725,19.2,20,5,6,1,16,28,-12,17.8,32.2,-14.4,24,FRA
19ba6c6d,25,1201,13.3,13,1,12,0,17,11,6,17.7,13.4,4.4,24,FRA
19c2ffa4,25,1877,20.9,22,10,3,0,25,34,-9,22.0,34.2,-12.2,24,FRA
1a066e69,12,995,11.1,12,9,0,5,8,12,-4,12.5,14.9,-2.4,24,FRA
1a2935f6,10,718,8.0,8,4,2,6,13,14,-1,11.1,10.9,0.1,24,FRA
1a6b7ea4,23,1395,15.5,14,10,9,2,18,16,2,22.0,19.3,2.7,24,FRA
1b2ec72e,1,1,0.0,0,0,1,11,0,1,-1,0.0,0.3,-0.3,24,FRA
1bc6135b,14,727,8.1,8,1,6,1,10,14,-4,9.5,11.9,-2.4,24,FRA
1bfb6fef,15,1156,12.8,13,11,2,4,18,13,5,17.4,12.9,4.4,24,FRA
1d2d5cc8,27,2430,27.0,27,27,0,0,40,33,7,40.3,34.0,6.3,24,FRA
1d383c10,26,1711,19.0,18,13,8,0,21,29,-8,25.1,26.0,-0.8,24,FRA
1d5c96f8,20,1325,14.7,16,8,4,1,16,17,-1,17.8,19.6,-1.8,24,FRA
1d8aa290,7,237,2.6,3,0,4,4,2,7,-5,2.6,4.5,-1.9,24,FRA
1ddbc7ca,26,2130,23.7,25,17,1,0,23,17,6,32.9,25.5,7.4,24,FRA
1e52971c,6,253,2.8,2,1,4,5,1,7,-6,2.3,5.6,-3.3,24,FRA
20b9f052,27,2399,26.7,27,26,0,0,41,31,10,42.6,25.8,16.7,24,FRA
20de219a,5,450,5.0,5,5,0,22,11,6,5,10.1,7.6,2.4,24,FRA
20e73fac,25,1960,21.8,23,10,2,0,33,31,2,31.7,29.6,2.1,24,FRA
213ab9bb,6,260,2.9,4,0,2,0,2,2,0,1.5,3.6,-2.1,24,FRA
226673c2,5,113,1.3,1,0,4,12,1,1,0,1.6,1.6,-0.1,24,FRA
22bfb57e,10,478,5.3,5,1,5,12,6,8,-2,4.6,8.1,-3.6,24,FRA
22d90df9,7,121,1.3,0,0,7,5,3,3,0,1.8,3.1,-1.4,24,FRA
2321ea6e,9,541,6.0,8,1,1,7,8,13,-5,5.9,10.6,-4.8,24,FRA
234a703c,22,1476,16.4,17,2,5,0,20,23,-3,24.8,26.2,-1.3,24,FRA
23c63b7f,6,184,2.0,2,0,4,1,0,2,-2,3.3,3.0,0.3,24,FRA
25749008,19,756,8.4,9,0,10,0,4,13,-9,7.1,13.8,-6.6,24,FRA
25f2ef01,20,1739,19.3,20,19,0,4,26,28,-2,28.2,27.0,1.2,24,FRA
2677a1de,21,984,10.9,12,1,9,0,14,18,-4,16.5,15.4,1.0,24,FRA
29c91632,15,1227,13.6,13,11,2,9,17,21,-4,19.5,17.5,2.0,24,FRA
2acd49b9,19,1196,13.3,14,7,5,6,10,20,-10,13.2,18.9,-5.7,24,FRA
2acf0cd7,21,1656,18.4,19,13,2,0,23,26,-3,25.7,23.0,2.7,24,FRA
2b5a35e5,25,1687,18.7,19,8,6,1,20,26,-6,23.3,24.2,-0.9,24,FRA
2b7cdb79,21,1042,11.6,11,1,10,3,12,16,-4,12.8,14.8,-2.0,24,FRA
2c70d915,13,986,11.0,11,9,2,8,18,15,3,16.0,13.7,2.2,24,FRA
2ccd39ed,26,1849,20.5,22,10,4,0,23,25,-2,27.3,25.5,1.9,24,FRA
2ccd89a3,3,25,0.3,0,0,3,11,0,0,0,0.4,0.5,-0.1,24,FRA
2e1b7c83,23,1058,11.8,12,1,11,2,12,13,-1,13.1,17.5,-4.5,24,FRA
2eb1ec07,10,194,2.2,1,1,9,4,3,1,2,4.7,3.0,1.7,24,FRA
2f71c116,16,1292,14.4,16,12,0,3,14,20,-6,12.4,22.0,-9.5,24,FRA
2fa2a875,26,2340,26.0,26,26,0,0,31,34,-3,35.2,34.8,0.4,24,FRA
3010aefb,21,1161,12.9,15,1,6,4,14,17,-3,13.7,20.1,-6.3,24,FRA
301c287b,21,1636,18.2,20,9,1,0,17,25,-8,19.0,27.2,-8.2,24,FRA
30670b0e,3,259,2.9,2,2,1,11,5,2,3,4.6,3.7,0.9,24,FRA
307581ff,1,3,0.0,0,0,1,0,0,0,0,0.0,0.0,0.0,24,FRA
30af8b93,6,527,5.9,6,3,0,0,15,7,8,10.8,5.1,5.7,24,FRA
30f5ffa9,17,1221,13.6,13,12,4,1,36,12,24,30.2,16.2,13.9,24,FRA
315fe681,3,270,3.0,3,3,0,24,3,5,-2,3.4,4.8,-1.4,24,FRA
31626657,27,2387,26.5,27,24,0,0,33,49,-16,25.4,39.9,-14.5,24,FRA
31822f8c,22,1323,14.7,15,5,7,0,26,24,2,23.5,21.8,1.6,24,FRA
3189f61a,21,1517,16.9,18,14,3,0,26,15,11,25.6,19.6,6.0,24,FRA
31f5b89b,8,307,3.4,4,0,4,7,1,5,-4,4.8,5.8,-1.0,24,FRA
32100829,11,769,8.5,9,5,2,11,10,17,-7,8.8,12.9,-4.0,24,FRA
32c2d95f,24,2151,23.9,24,23,0,0,30,35,-5,32.8,30.6,2.1,24,FRA
32f3d97e,17,459,5.1,1,0,16,8,7,12,-5,8.8,12.0,-3.2,24,FRA
331c5a98,7,145,1.6,1,0,6,17,3,1,2,2.8,3.1,-0.3,24,FRA
3322e296,4,131,1.5,1,0,3,11,3,1,2,3.4,2.2,1.2,24,FRA
349cae8f,10,643,7.1,6,6,4,3,13,8,5,12.6,4.9,7.6,24,FRA
34a88e3e,27,1922,21.4,22,6,5,1,32,16,16,31.3,20.3,11.0,24,FRA
357103bd,2,58,0.6,0,0,2,0,1,1,0,0.2,2.0,-1.8,24,FRA
3681cfff,17,1437,16.0,16,13,1,3,12,21,-9,14.9,21.5,-6.6,24,FRA
36f65bdf,18,516,5.7,6,0,12,4,8,11,-3,6.3,9.3,-3.0,24,FRA
3708e9fa,24,2057,22.9,24,15,0,0,46,31,15,34.4,29.0,5.4,24,FRA
37143438,9,158,1.8,0,0,9,12,4,4,0,2.4,5.5,-3.1,24,FRA
375622c5,25,1788,19.9,20,9,5,0,30,32,-2,28.8,26.1,2.7,24,FRA
380a15e2,1,90,1.0,1,1,0,21,2,6,-4,2.3,1.5,0.8,24,FRA
384d58d9,21,1790,19.9,20,15,1,0,35,29,6,28.6,25.8,2.7,24,FRA
397ba086,21,719,8.0,7,0,14,4,5,14,-9,8.2,11.7,-3.5,24,FRA
39b326ed,24,1877,20.9,21,14,3,1,24,30,-6,25.2,30.1,-4.8,24,FRA
3b029691,25,1856,20.6,20,13,5,2,48,18,30,42.6,26.0,16.6,24,FRA
3b6ace25,2,11,0.1,0,0,2,5,0,1,-1,0.0,0.3,-0.3,24,FRA
3b88609d,3,28,0.3,0,0,3,14,1,0,1,1.6,0.7,0.9,24,FRA
3bd65247,10,267,3.0,2,0,8,2,5,2,3,3.8,3.2,0.6,24,FRA
3c6bbbab,3,94,1.0,1,0,2,0,0,1,-1,0.9,1.7,-0.8,24,FRA
3cc4bb19,21,1576,17.5,17,16,4,5,19,31,-12,18.2,30.3,-12.1,24,FRA
3d214e5f,25,2246,25.0,25,24,0,0,33,20,13,33.2,27.5,5.7,24,FRA
3dd738a1,20,1725,19.2,20,15,0,2,30,15,15,32.2,26.9,5.3,24,FRA
3eaf8817,15,617,6.9,5,2,10,1,11,8,3,9.9,8.6,1.3,24,FRA
3ecc8c5f,2,174,1.9,2,1,0,0,2,6,-4,2.0,4.8,-2.8,24,FRA
3eed9821,6,185,2.1,2,1,4,10,2,5,-3,3.6,1.1,2.5,24,FRA
3eeebc87,24,1926,21.4,21,21,3,4,33,20,13,35.2,22.1,13.1,24,FRA
3f319bb9,27,2393,26.6,27,26,0,0,32,35,-3,32.4,39.7,-7.3,24,FRA
40221fa7,27,2420,26.9,27,26,0,0,37,20,17,37.2,28.1,9.1,24,FRA
40774c6b,13,475,5.3,5,1,8,2,5,15,-10,5.5,9.4,-3.8,24,FRA
41e7ef1c,1,9,0.1,0,0,1,12,0,0,0,0.0,0.2,-0.2,24,FRA
41eebdf5,18,1476,16.4,17,13,1,1,25,22,3,26.0,17.6,8.4,24,FRA
42276181,21,1072,11.9,12,2,9,2,13,21,-8,14.6,17.8,-3.2,24,FRA
42f0113f,3,65,0.7,0,0,3,5,0,3,-3,1.0,1.9,-0.9,24,FRA
42fd9c7f,25,1909,21.2,22,17,3,1,53,20,33,43.1,26.9,16.2,24,FRA
42fdb11d,24,1318,14.6,13,5,11,0,16,19,-3,18.3,21.2,-2.9,24,FRA
44435c8f,21,1040,11.6,11,3,10,2,18,18,0,15.4,16.9,-1.5,24,FRA
4534a352,21,1711,19.0,19,16,2,2,25,21,4,28.4,23.8,4.7,24,FRA
45af8a54,13,702,7.8,8,3,5,4,19,7,12,18.7,10.7,8.0,24,FRA
45b9b619,11,372,4.1,5,0,6,6,5,7,-2,5.9,4.3,1.6,24,FRA
45cce300,10,308,3.4,3,0,7,5,8,8,0,5.7,5.8,-0.2,24,FRA
468fdbad,26,889,9.9,6,3,20,0,17,5,12,12.8,11.4,1.5,24,FRA
477e50ce,6,540,6.0,6,6,0,17,10,11,-1,7.1,12.6,-5.5,24,FRA
4788cb6b,13,1118,12.4,13,6,0,0,12,23,-11,13.4,22.3,-8.9,24,FRA
47f82561,3,109,1.2,1,0,2,18,3,2,1,2.6,0.6,2.0,24,FRA
481f76cf,23,1587,17.6,20,6,3,0,14,22,-8,18.0,23.5,-5.5,24,FRA
489e80e3,15,835,9.3,12,2,3,2,20,11,9,16.1,8.7,7.4,24,FRA
49070d66,25,2249,25.0,25,24,0,2,28,35,-7,32.1,33.3,-1.2,24,FRA
4a56052c,23,1689,18.8,18,15,5,0,27,27,0,32.9,21.0,11.9,24,FRA
4a987ffa,1,31,0.3,0,0,1,1,0,2,-2,0.4,1.1,-0.8,24,FRA
4b96c347,22,985,10.9,11,0,11,5,11,14,-3,13.2,14.8,-1.6,24,FRA
4d3e9033,1,90,1.0,1,1,0,22,1,2,-1,1.7,3.2,-1.5,24,FRA
4e7db402,21,1866,20.7,21,20,0,1,16,30,-14,23.5,29.8,-6.3,24,FRA
4fe2648c,1,1,0.0,0,0,1,8,0,0,0,0.0,0.0,0.0,24,FRA
5069b796,4,121,1.3,1,1,3,11,0,2,-2,0.9,2.6,-1.7,24,FRA
508a9011,1,2,0.0,0,0,1,4,0,0,0,0.0,0.0,0.0,24,FRA
514270e8,2,124,1.4,2,0,0,0,1,3,-2,0.5,3.4,-2.8,24,FRA
5148dcc5,19,1167,13.0,14,5,5,0,19,15,4,20.3,19.9,0.4,24,FRA
5167c97e,15,600,6.7,6,2,9,4,5,6,-1,6.5,10.7,-4.2,24,FRA
51c30111,3,88,1.0,1,0,2,4,2,0,2,2.6,1.0,1.7,24,FRA
51dbeea9,9,810,9.0,9,9,0,0,16,14,2,14.2,12.4,1.8,24,FRA
5219ab4a,23,1771,19.7,21,16,2,0,26,22,4,29.8,18.7,11.1,24,FRA
5271c8f1,8,358,4.0,3,0,5,0,7,17,-10,5.4,9.8,-4.4,24,FRA
546bb36e,4,210,2.3,3,1,1,6,3,9,-6,3.2,4.5,-1.3,24,FRA
547a72ad,11,359,3.9,3,3,8,12,7,6,1,4.8999999999999995,6.800000000000001,-2.0,24,FRA
548756f2,2,14,0.2,0,0,2,5,0,0,0,0.4,0.0,0.4,24,FRA
55abe554,22,1725,19.2,20,16,2,2,25,29,-4,25.0,28.5,-3.5,24,FRA
562a4799,20,1747,19.4,20,18,0,0,28,34,-6,30.7,26.0,4.7,24,FRA
5680bf3f,7,85,0.9,0,0,7,7,0,3,-3,1.8,3.1,-1.3,24,FRA
575b1a7b,1,10,0.1,0,0,1,2,0,1,-1,0.0,0.3,-0.3,24,FRA
576817b7,8,112,1.2,0,0,8,5,0,5,-5,2.5,2.9,-0.3,24,FRA
576ca93f,2,4,0.0,0,0,2,2,0,0,0,0.0,0.0,0.0,24,FRA
58aae0a9,8,310,3.4,2,1,6,1,4,6,-2,5.4,4.8,0.6,24,FRA
5939baa2,4,157,1.7,2,0,2,2,1,4,-3,1.9,2.7,-0.7,24,FRA
595e6f3e,23,1589,17.7,19,3,4,0,18,26,-8,16.8,27.9,-11.1,24,FRA
59878425,7,154,1.7,1,0,6,4,3,4,-1,3.8,4.3,-0.6,24,FRA
59948ef7,18,1019,11.3,12,2,6,2,18,12,6,17.0,17.9,-0.9,24,FRA
59bf127b,14,961,10.7,11,6,3,1,14,13,1,10.8,14.4,-3.6,24,FRA
59fcbd6d,26,2174,24.2,24,19,2,0,22,37,-15,23.0,36.6,-13.6,24,FRA
5a04fd92,6,354,3.9,4,0,2,0,5,3,2,5.6,5.8,-0.3,24,FRA
5b146df3,24,2137,23.7,24,22,0,0,33,17,16,33.1,23.6,9.5,24,FRA
5b479568,9,85,0.9,0,0,9,5,2,1,1,2.4,1.2,1.2,24,FRA
5b92d896,1,9,0.1,0,0,1,2,0,0,0,0.1,0.0,0.1,24,FRA
5c26ca51,23,1790,19.9,21,10,2,0,27,26,1,29.1,22.8,6.3,24,FRA
5d004b30,1,13,0.1,0,0,1,6,0,0,0,0.0,0.0,0.0,24,FRA
5d0e0a1f,25,1753,19.5,20,13,5,0,27,21,6,24.7,25.4,-0.7,24,FRA
5d36f616,1,2,0.0,0,0,1,0,0,0,0,0.1,0.0,0.1,24,FRA
5d8d7454,25,1879,20.9,22,17,3,1,23,31,-8,27.6,27.5,0.1,24,FRA
5dbefa9d,13,604,6.7,6,2,7,0,6,14,-8,6.8,13.0,-6.2,24,FRA
5e22e2a4,25,1618,18.0,18,12,7,2,27,21,6,26.7,21.0,5.8,24,FRA
5e6355f8,14,300,3.3,3,0,11,2,3,7,-4,3.3,8.5,-5.1,24,FRA
5ea8ef20,2,19,0.2,0,0,2,1,0,0,0,1.2,0.2,1.0,24,FRA
5ed97752,24,1452,16.1,18,2,6,0,23,21,2,24.1,16.3,7.8,24,FRA
5f3eaaf5,22,1788,19.9,21,15,1,0,21,31,-10,22.5,30.7,-8.2,24,FRA
5fdcb075,23,1627,18.1,20,11,3,1,24,27,-3,27.3,21.8,5.5,24,FRA
6043997c,13,1092,12.1,13,12,0,2,10,17,-7,13.1,15.8,-2.7,24,FRA
60d90c55,27,2430,27.0,27,27,0,0,36,29,7,40.6,38.3,2.3,24,FRA
6191093d,24,1405,15.6,17,6,7,1,19,20,-1,18.7,20.6,-1.9,24,FRA
61f80c89,1,8,0.1,0,0,1,8,0,0,0,0.0,0.1,-0.1,24,FRA
627c7a3d,4,50,0.6,0,0,4,3,1,0,1,1.3,0.1,1.2,24,FRA
6388e356,19,1382,15.4,15,13,4,2,17,24,-7,21.6,20.4,1.2,24,FRA
645a3363,25,2052,22.8,23,11,2,0,35,19,16,33.8,22.1,11.6,24,FRA
649b57e9,7,449,5.0,6,0,1,0,7,6,1,6.6,7.3,-0.7,24,FRA
64ba07c0,12,598,6.6,6,4,6,3,8,12,-4,7.8,13.4,-5.6,24,FRA
652d4c37,19,1381,15.3,16,8,3,1,14,19,-5,18.6,21.7,-3.1,24,FRA
65c55288,20,1616,18.0,19,15,1,0,17,14,3,24.9,16.5,8.4,24,FRA
6620c21a,10,457,5.1,6,2,4,7,6,6,0,6.9,7.7,-0.9,24,FRA
6763f716,27,2308,25.6,26,25,1,1,40,23,17,37.0,26.9,10.1,24,FRA
68a26d51,26,2175,24.2,26,18,0,0,24,36,-12,28.0,37.9,-9.8,24,FRA
698f11e3,16,892,9.9,9,6,7,4,11,13,-2,9.1,18.3,-9.2,24,FRA
6993927b,12,897,10.0,9,8,3,12,9,14,-5,11.2,15.6,-4.4,24,FRA
69c9532c,1,10,0.1,0,0,1,2,0,0,0,0.0,0.2,-0.2,24,FRA
69e930e4,8,101,1.1,0,0,8,6,1,1,0,1.6,2.1,-0.5,24,FRA
6a827d8e,6,359,4.0,5,1,1,2,3,1,2,7.0,1.9,5.1,24,FRA
6b5edd5d,13,471,5.2,5,0,8,3,8,6,2,8.5,6.2,2.3,24,FRA
6b91b999,27,2430,27.0,27,27,0,0,32,36,-4,32.7,39.9,-7.2,24,FRA
6b9960cf,23,1706,19.0,18,14,5,1,45,15,30,39.9,21.5,18.4,24,FRA
6bde367b,27,2355,26.2,27,17,0,0,31,38,-7,35.6,35.3,0.4,24,FRA
6be41a31,10,685,7.6,7,2,3,0,16,9,7,13.1,7.9,5.2,24,FRA
6c9642ae,6,22,0.2,0,0,6,7,1,0,1,0.6,1.5,-0.9,24,FRA
6ce2cdf0,19,1068,11.9,12,5,7,2,8,18,-10,0.0,0.0,0.0,24,FRA
6d0fe035,25,1837,20.4,22,12,3,0,23,30,-7,23.8,25.9,-2.1,24,FRA
6d2b0ada,5,153,1.7,1,0,4,8,2,6,-4,1.3,3.8,-2.5,24,FRA
6de23ab0,10,889,9.9,10,9,0,6,5,16,-11,12.0,18.7,-6.7,24,FRA
6dfd8f05,17,351,3.9,2,1,15,6,6,6,0,6.5,5.4,1.1,24,FRA
6e33125f,25,2250,25.0,25,25,0,0,33,27,6,37.8,33.9,3.9,24,FRA
6e7f1353,24,1659,18.4,20,6,4,0,18,12,6,25.1,16.3,8.8,24,FRA
6f5ec8bb,24,2084,23.2,23,22,1,0,33,28,5,35.5,34.6,0.9,24,FRA
6f806d99,19,1264,14.0,16,6,3,0,21,19,2,21.6,15.5,6.1,24,FRA
6fd76804,5,46,0.5,0,0,5,6,0,2,-2,1.3,1.0,0.3,24,FRA
705a1642,1,27,0.3,0,0,1,8,0,0,0,0.5,0.2,0.3,24,FRA
70c52749,1,16,0.2,0,0,1,0,2,0,2,1.2,0.2,1.0,24,FRA
7155e3e1,9,352,3.9,4,0,5,1,4,5,-1,5.0,5.2,-0.2,24,FRA
7304f3b1,1,16,0.2,0,0,1,2,0,0,0,0.3,1.3,-1.0,24,FRA
731f1f5a,9,111,1.2,0,0,9,0,2,2,0,1.1,2.4,-1.3,24,FRA
7362a6f2,5,61,0.7,0,0,5,18,2,0,2,1.6,1.2,0.3,24,FRA
737945d9,21,1094,12.2,11,5,10,1,11,17,-6,14.3,18.8,-4.5,24,FRA
7410d325,15,356,4.0,2,0,13,7,8,6,2,6.6,6.1,0.6,24,FRA
741418c3,15,418,4.6,3,1,12,4,5,4,1,7.6,8.2,-0.6,24,FRA
745ca0a3,17,1453,16.1,16,15,1,0,19,34,-15,14.8,24.8,-10.0,24,FRA
74d4cec6,18,923,10.3,10,4,8,1,17,10,7,20.6,9.6,10.9,24,FRA
75f1ed80,25,1966,21.8,22,20,3,1,29,28,1,32.4,27.8,4.6,24,FRA
76d679c7,6,534,5.9,6,4,0,1,10,10,0,9.6,9.3,0.3,24,FRA
770d7eb8,27,2430,27.0,27,27,0,0,37,20,17,37.2,28.2,9.0,24,FRA
77816c91,7,275,3.1,2,0,5,1,3,5,-2,3.2,4.3,-1.0,24,FRA
779847d6,17,1112,12.4,11,10,6,10,9,21,-12,13.4,19.4,-6.0,24,FRA
7909ffa4,24,2012,22.4,24,17,0,0,25,30,-5,28.8,31.0,-2.2,24,FRA
79b51257,19,517,5.7,2,0,17,4,11,4,7,10.7,7.8,2.9,24,FRA
7a42d0df,25,1977,22.0,22,14,3,0,27,26,1,31.8,29.8,1.9,24,FRA
7af655fe,5,177,2.0,2,0,3,8,3,1,2,4.6,1.3,3.4,24,FRA
7b082ec2,4,129,1.4,1,1,3,3,3,1,2,2.3,2.7,-0.5,24,FRA
7b9a9e25,16,908,10.1,11,3,5,0,18,18,0,16.4,13.9,2.4,24,FRA
7c3ed041,22,1821,20.2,21,16,1,3,31,23,8,31.0,19.8,11.2,24,FRA
7cdda3bf,27,1699,18.9,21,3,6,0,18,16,2,25.9,18.3,7.5,24,FRA
7d08063d,21,898,10.0,9,1,12,4,9,17,-8,12.8,16.1,-3.1999999999999997,24,FRA
7d827b4f,3,165,1.8,3,0,0,8,4,3,1,1.7,2.5,-0.8,24,FRA
7d9397f8,20,1519,16.9,18,11,2,0,16,11,5,22.8,18.9,3.9,24,FRA
7e82a78f,22,1680,18.7,19,11,3,2,18,29,-11,21.5,26.8,-5.3,24,FRA
7f41ee30,3,270,3.0,3,3,0,10,2,6,-4,2.3,6.1,-3.8,24,FRA
7f783431,12,764,8.5,7,4,5,12,12,14,-2,12.6,10.6,2.0,24,FRA
8006228f,7,96,1.1,1,0,6,11,2,0,2,1.8,0.7,1.1,24,FRA
8104e41e,19,695,7.7,6,5,13,1,15,12,3,11.5,9.0,2.5,24,FRA
822d51d7,25,2144,23.8,25,18,0,0,44,29,15,35.3,28.5,6.8,24,FRA
8236f673,10,301,3.3,2,0,8,0,7,4,3,6.2,3.9,2.3,24,FRA
82464ce3,24,1462,16.2,16,11,8,2,20,18,2,23.8,23.4,0.4,24,FRA
825ed0d1,14,767,8.5,9,2,5,2,8,13,-5,8.4,12.2,-3.8,24,FRA
83299cc0,19,1118,12.4,14,3,5,5,20,14,6,16.8,13.3,3.5,24,FRA
8332db56,21,1551,17.2,18,8,3,2,22,24,-2,20.9,22.9,-2.0,24,FRA
834b5c4c,19,1710,19.0,19,19,0,0,20,24,-4,21.2,23.3,-2.1,24,FRA
8455ad90,16,1104,12.3,14,5,2,1,27,10,17,17.5,13.7,3.8,24,FRA
8577e60a,25,1641,18.2,22,0,3,0,22,16,6,25.9,18.6,7.3,24,FRA
86383d0e,26,1286,14.3,14,1,12,0,22,9,13,20.0,15.9,4.1,24,FRA
868eaba0,21,1680,18.7,21,9,0,0,15,29,-14,18.8,33.4,-14.6,24,FRA
87935cf3,1,7,0.1,0,0,1,5,1,0,1,0.5,0.2,0.3,24,FRA
87d31635,5,56,0.6,0,0,5,5,0,3,-3,1.3,1.7,-0.5,24,FRA
8846a40f,23,993,11.0,11,0,12,1,15,6,9,17.0,10.5,6.6,24,FRA
88acf83f,22,985,10.9,11,2,11,5,13,16,-3,15.6,16.2,-0.6,24,FRA
88c4d190,26,1462,16.2,18,2,8,0,21,15,6,20.9,17.9,3.0,24,FRA
88f130ed,23,2037,22.6,23,21,0,0,23,19,4,31.3,24.5,6.8,24,FRA
8b609c34,20,1800,20.0,20,20,0,0,38,25,13,30.8,23.7,7.0,24,FRA
8b66d9cc,5,92,1.0,0,0,5,2,3,4,-1,2.0,0.9,1.0,24,FRA
8bfbf257,3,106,1.2,1,0,2,7,1,2,-1,2.4,0.8,1.6,24,FRA
8f325097,7,458,5.1,5,3,2,0,3,8,-5,5.4,7.9,-2.5,24,FRA
8fd9996f,21,1545,17.2,17,15,4,3,38,17,21,32.3,20.8,11.5,24,FRA
90eb507d,22,1695,18.8,21,9,1,3,24,22,2,25.2,18.8,6.4,24,FRA
90fcf472,21,819,9.1,9,0,12,1,12,9,3,14.2,13.3,0.9,24,FRA
914bb955,22,1905,21.2,22,20,0,0,22,30,-8,21.5,32.4,-10.9,24,FRA
91f04b44,12,278,3.1,1,0,11,4,1,4,-3,3.0,4.8,-1.8,24,FRA
9226aa22,19,558,6.2,3,0,16,0,11,1,10,8.1,4.8,3.3,24,FRA
92d90c8f,11,423,4.7,5,0,6,2,8,7,1,5.2,7.2,-2.0,24,FRA
92ffb8f9,25,1821,20.2,20,12,5,1,25,27,-2,24.2,28.2,-4.0,24,FRA
93c942fb,6,346,3.8,3,1,3,4,1,6,-5,3.8,3.9,-0.2,24,FRA
942b4f90,25,1795,19.9,20,10,5,1,42,28,14,29.8,23.9,5.9,24,FRA
94f8d10c,18,1453,16.1,16,15,2,3,21,21,0,21.9,27.1,-5.3,24,FRA
96726741,1,90,1.0,1,1,0,7,0,3,-3,0.1,2.3,-2.2,24,FRA
967f34d3,2,121,1.3,1,1,1,24,0,2,-2,1.5,2.1,-0.6,24,FRA
972183e0,1,4,0.0,0,0,1,3,0,0,0,0.0,0.0,0.0,24,FRA
979b811d,15,741,8.2,9,0,6,2,14,2,12,11.2,6.0,5.2,24,FRA
9b5237b1,22,1162,12.9,14,1,8,4,17,15,2,19.1,17.7,1.4,24,FRA
9b6d9b53,3,53,0.6,0,0,3,2,0,0,0,0.6,1.1,-0.5,24,FRA
9c4f39b3,15,766,8.5,8,2,7,1,11,21,-10,7.8,11.5,-3.7,24,FRA
9dbb75ca,22,1767,19.6,21,10,1,0,23,28,-5,22.7,26.3,-3.6,24,FRA
9dd5da03,5,234,2.6,2,2,3,13,2,6,-4,2.2,6.3,-4.1,24,FRA
9ddf7fae,23,1319,14.7,17,0,6,1,12,23,-11,11.6,23.4,-11.8,24,FRA
9e7483ff,24,1030,11.4,10,1,14,1,19,9,10,18.7,13.7,5.0,24,FRA
9f29c204,9,273,3.0,3,1,6,14,2,5,-3,2.1,5.7,-3.6,24,FRA
9f4a940f,7,90,1.0,0,0,7,11,0,1,-1,1.1,0.5,0.6,24,FRA
9f936061,21,1886,21.0,21,20,0,0,15,36,-21,22.4,34.8,-12.4,24,FRA
a0415710,21,1399,15.5,15,10,6,2,30,24,6,23.0,20.0,3.0,24,FRA
a08985b8,21,1359,15.100000000000001,14,11,7,2,15,22,-7,18.2,22.4,-4.2,24,FRA
a0c590b9,23,1687,18.7,19,6,4,0,22,24,-2,21.7,22.5,-0.8,24,FRA
a0d55a09,24,1376,15.3,17,4,7,1,29,19,10,25.2,20.799999999999997,4.3999999999999995,24,FRA
a1390d2f,2,61,0.7,1,0,1,1,1,1,0,1.2,1.6,-0.4,24,FRA
a17a94d6,23,1773,19.7,20,16,3,1,29,27,2,26.8,24.299999999999997,2.5,24,FRA
a1dbb2c7,1,12,0.1,0,0,1,0,0,0,0,0.0,0.1,-0.1,24,FRA
a26d3da7,1,7,0.1,0,0,1,2,0,2,-2,0.0,0.9,-0.9,24,FRA
a329a732,2,6,0.1,0,0,2,10,0,0,0,0.0,0.1,-0.1,24,FRA
a426a912,18,892,9.9,10,4,8,8,11,16,-5,12.7,15.8,-3.1,24,FRA
a4a44eb0,21,1844,20.5,21,20,0,0,29,39,-10,20.0,30.9,-11.0,24,FRA
a572e291,4,249,2.8,3,0,1,1,5,3,2,3.7,5.8,-2.1,24,FRA
a6138e4a,17,684,7.6,9,2,8,9,6,12,-6,8.0,8.9,-1.0,24,FRA
a758ca47,1,16,0.2,0,0,1,1,0,2,-2,0.0,0.0,0.0,24,FRA
a951ca82,2,43,0.5,0,0,2,2,0,0,0,0.6,0.1,0.4,24,FRA
aad56ca3,24,1689,18.8,19,8,5,2,27,28,-1,29.8,22.7,7.0,24,FRA
abd56820,8,518,5.8,6,1,2,1,12,8,4,6.3,6.4,-0.1,24,FRA
abddf25d,9,219,2.4,2,0,7,6,2,2,0,2.9,3.1,-0.2,24,FRA
abefc3af,26,1456,16.2,16,4,10,1,19,19,0,18.5,23.6,-5.2,24,FRA
ac73ec79,11,577,6.4,6,5,5,11,18,3,15,13.1,8.4,4.7,24,FRA
ac89503b,26,2329,25.9,26,25,0,1,25,33,-8,26.8,38.5,-11.7,24,FRA
add37c13,8,426,4.7,6,2,2,1,5,9,-4,6.5,6.8,-0.3,24,FRA
ae7d0ecd,27,2357,26.2,27,26,0,0,24,43,-19,25.4,41.5,-16.1,24,FRA
af0c835b,19,749,8.3,7,2,12,4,9,14,-5,12.2,14.2,-2.0,24,FRA
af3ddb2e,6,159,1.8,1,0,5,6,1,4,-3,2.2,4.2,-2.0,24,FRA
afe39ca8,25,1455,16.2,14,8,11,2,22,25,-3,15.8,24.0,-8.2,24,FRA
b003239d,12,918,10.2,10,8,2,11,14,12,2,13.5,14.0,-0.5,24,FRA
b026bbf6,14,1011,11.2,12,8,2,2,15,14,1,15.6,13.6,1.9,24,FRA
b19db005,23,1342,14.9,15,3,8,0,33,9,24,30.7,16.5,14.2,24,FRA
b2009f99,9,396,4.4,4,3,5,6,4,9,-5,6.0,8.7,-2.8,24,FRA
b229aa13,6,480,5.3,6,2,0,0,6,7,-1,8.3,7.9,0.4,24,FRA
b2fe86e5,23,933,10.4,10,0,13,4,15,18,-3,9.6,14.2,-4.5,24,FRA
b34c63a5,26,1398,15.5,16,4,10,1,14,28,-14,20.5,24.3,-3.8,24,FRA
b386310a,18,1009,11.2,12,0,6,1,10,14,-4,11.9,15.2,-3.3,24,FRA
b3d76d84,28,2520,28.0,28,28,0,0,42,25,17,42.2,28.4,13.8,24,FRA
b3f8bdef,12,634,7.0,7,2,5,1,11,10,1,8.1,8.9,-0.8,24,FRA
b4ef3fb5,19,916,10.2,10,8,9,5,19,11,8,15.5,13.4,2.1,24,FRA
b5bb8188,8,445,4.9,4,2,4,0,8,6,2,6.0,5.1,0.8,24,FRA
b625b241,22,1100,12.2,12,2,10,3,20,13,7,20.9,13.2,7.7,24,FRA
b666421b,20,1688,18.8,19,18,1,1,17,33,-16,16.8,31.8,-15.1,24,FRA
b70a4c6c,5,152,1.7,0,0,5,0,1,2,-1,0.0,0.0,0.0,24,FRA
b70afb45,26,1910,21.2,21,12,5,0,27,28,-1,27.1,31.7,-4.7,24,FRA
b73f17f8,27,1272,14.1,12,7,15,0,13,18,-5,20.9,18.1,2.8,24,FRA
b8aedf06,9,668,7.4,8,6,1,1,16,9,7,14.2,11.1,3.1,24,FRA
b8c1de25,21,1296,14.4,17,2,4,1,10,26,-16,11.9,26.2,-14.3,24,FRA
b99bec05,14,1172,13.0,14,11,0,0,21,20,1,19.4,17.6,1.8,24,FRA
b9ae8560,17,1077,12.0,13,5,4,2,11,17,-6,14.8,17.3,-2.5,24,FRA
bac89b96,1,21,0.2,0,0,1,6,1,0,1,0.6,0.1,0.5,24,FRA
badcdcae,8,430,4.8,5,1,3,7,4,6,-2,4.3,9.3,-5.0,24,FRA
bc7cc472,11,313,3.5,2,0,9,7,2,3,-1,4.0,3.5,0.4,24,FRA
bcc81786,5,326,3.6,5,3,0,0,3,5,-2,4.5,5.3,-0.8,24,FRA
bf4c41f9,24,1615,17.9,19,2,5,0,27,20,7,25.5,18.8,6.7,24,FRA
bfb2056e,24,2020,22.4,22,21,2,0,27,27,0,27.4,32.9,-5.4,24,FRA
bfdb33aa,20,1269,14.1,13,6,7,2,22,8,14,21.4,11.2,10.2,24,FRA
c0b3669f,21,993,11.0,10,3,11,1,29,8,21,24.6,14.0,10.6,24,FRA
c0c7ff58,19,1024,11.4,12,7,7,4,24,10,14,26.0,12.8,13.2,24,FRA
c1597cf7,8,573,6.4,7,1,1,0,7,5,2,6.3,7.0,-0.7,24,FRA
c19a2df1,11,461,5.1,5,0,6,0,7,5,2,5.4,5.8,-0.4,24,FRA
c21983bf,14,957,10.6,10,8,4,7,15,12,3,10.5,12.5,-2.0,24,FRA
c284d6fb,21,1682,18.7,19,17,2,2,18,20,-2,23.5,23.4,0.1,24,FRA
c2a6033c,7,395,4.4,4,1,3,0,5,5,0,3.8,8.8,-5.0,24,FRA
c2bd8585,10,262,2.9,2,0,8,6,5,5,0,4.8,3.3,1.5,24,FRA
c3725db2,14,1135,12.6,13,11,1,11,13,14,-1,12.7,18.0,-5.3,24,FRA
c385bf49,17,924,10.3,8,7,9,8,6,15,-9,11.8,15.9,-4.1,24,FRA
c3b6fa1e,23,1287,14.3,15,3,8,2,14,16,-2,15.7,21.5,-5.8,24,FRA
c3ee18ef,26,1846,20.5,22,12,4,1,47,21,26,41.2,27.5,13.7,24,FRA
c43a8336,5,313,3.5,4,1,1,12,5,4,1,4.0,4.3,-0.3,24,FRA
c4a71372,1,8,0.1,0,0,1,5,0,1,-1,0.1,0.6,-0.6,24,FRA
c55de1f5,9,732,8.1,8,8,1,0,12,11,1,10.6,10.7,-0.1,24,FRA
c678ddd7,19,1198,13.3,13,7,6,7,18,23,-5,19.3,16.0,3.2,24,FRA
c6f0d5d4,8,292,3.2,4,1,4,1,4,6,-2,3.5,3.0,0.5,24,FRA
c76b7567,24,1097,12.2,13,1,11,2,13,13,0,19.4,16.8,2.6,24,FRA
c8c02ac7,19,954,10.6,12,2,7,7,6,22,-16,9.4,17.5,-8.1,24,FRA
c92c24f0,16,1313,14.6,16,10,0,2,10,25,-15,14.1,27.4,-13.3,24,FRA
c952f633,8,477,5.3,5,4,3,2,5,8,-3,7.2,7.0,0.2,24,FRA
c9817014,21,1632,18.1,18,12,3,6,49,14,35,34.2,22.1,12.1,24,FRA
ca122e29,6,41,0.5,0,0,6,14,1,0,1,0.6,0.4,0.3,24,FRA
ca95200f,3,181,2.0,2,2,1,24,4,0,4,4.0,0.7,3.3,24,FRA
caa7aaea,24,1088,12.1,10,7,14,2,8,24,-16,13.8,24.0,-10.1,24,FRA
cad3fd4d,19,463,5.1,4,0,15,5,11,3,8,8.9,6.6,2.3,24,FRA
cc41f558,25,2250,25.0,25,25,0,0,22,37,-15,25.2,36.9,-11.7,24,FRA
cc588cbe,21,975,10.8,9,3,12,6,8,14,-6,12.3,18.4,-6.1,24,FRA
cc704d9c,1,16,0.2,0,0,1,0,0,2,-2,0.0,0.0,0.0,24,FRA
cce181df,20,1192,13.2,13,8,7,0,21,13,8,20.7,10.2,10.4,24,FRA
cd2cb5bb,1,8,0.1,0,0,1,0,0,0,0,0.1,0.0,0.1,24,FRA
cdc4458b,13,493,5.5,6,0,7,3,5,8,-3,7.5,7.8,-0.3,24,FRA
ce50fd99,28,2119,23.5,24,10,4,0,38,22,16,38.9,22.4,16.6,24,FRA
cea59f02,21,1412,15.7,16,13,5,1,12,22,-10,18.8,26.1,-7.3,24,FRA
cedc53d2,2,18,0.2,0,0,2,4,1,1,0,1.9,0.9,0.9,24,FRA
cef70c94,2,21,0.30000000000000004,0,0,2,9,0,0,0,0.30000000000000004,0.1,0.1,24,FRA
cf182add,24,1954,21.7,22,19,2,2,33,22,11,31.8,20.8,11.0,24,FRA
cf1ef7ec,14,1018,11.3,11,10,3,13,13,24,-11,13.7,21.4,-7.800000000000001,24,FRA
d17ce930,9,638,7.1,7,5,2,14,9,7,2,10.1,10.1,0.1,24,FRA
d2448564,18,537,6.0,4,1,14,6,4,11,-7,5.5,14.9,-9.5,24,FRA
d2c12fe0,4,44,0.5,0,0,4,5,2,0,2,1.4,0.9,0.5,24,FRA
d3b54513,1,90,1.0,1,1,0,1,0,3,-3,0.1,2.3,-2.2,24,FRA
d3ddf88b,15,537,6.0,5,3,10,6,6,13,-7,8.2,10.2,-2.0,24,FRA
d469252b,9,644,7.2,8,0,1,0,9,9,0,0.0,0.0,0.0,24,FRA
d4d35152,26,1792,19.9,24,3,2,0,23,17,6,26.4,21.4,5.0,24,FRA
d4e93bab,23,1732,19.2,20,7,3,0,18,23,-5,19.1,24.5,-5.4,24,FRA
d5326924,3,98,1.1,1,0,2,0,2,1,1,1.4,2.9,-1.5,24,FRA
d595de71,1,1,0.0,0,0,1,7,0,0,0,0.5,0.0,0.5,24,FRA
d5d22a58,19,1082,12.0,12,7,7,9,18,11,7,16.6,13.1,3.5,24,FRA
d5dd5f1f,28,2114,23.5,24,15,4,0,37,30,7,40.0,23.2,16.7,24,FRA
d5f2f82b,17,1295,14.4,15,11,2,2,34,9,25,31.1,15.7,15.3,24,FRA
d638ab17,9,340,3.8,3,0,6,8,4,6,-2,4.0,4.9,-0.9,24,FRA
d7547531,7,96,1.1,0,0,7,3,1,1,0,2.5,2.6,0.0,24,FRA
d8c19a60,5,109,1.2,1,0,4,5,1,3,-2,2.0,1.8,0.2,24,FRA
d9764034,20,1542,17.1,18,17,2,2,35,24,11,26.8,23.7,3.1,24,FRA
d97af612,18,929,10.3,11,1,7,1,14,12,2,14.9,11.6,3.3,24,FRA
daa11a4f,10,248,2.8,2,0,8,2,2,0,2,2.9,4.8,-1.9,24,FRA
dab1b8dc,1,24,0.3,0,0,1,8,0,1,-1,0.2,0.1,0.0,24,FRA
dacf856a,2,68,0.8,0,0,2,9,1,2,-1,1.1,1.1,0.0,24,FRA
db87a2c4,27,2430,27.0,27,27,0,0,28,22,6,38.4,29.1,9.4,24,FRA
dbd3a428,24,2132,23.7,24,18,0,0,30,31,-1,32.3,27.2,5.2,24,FRA
dc29b608,27,2430,27.0,27,27,0,0,35,50,-15,26.7,40.6,-13.9,24,FRA
dcd94cdb,1,8,0.1,1,0,0,3,0,1,-1,0.1,0.8,-0.7,24,FRA
dd211559,15,817,9.1,10,5,5,5,14,18,-4,10.3,14.6,-4.3,24,FRA
dd745366,4,214,2.4,2,1,2,2,5,1,4,4.7,2.2,2.5,24,FRA
de17db90,9,379,4.2,4,0,5,0,7,6,1,7.0,7.4,-0.4,24,FRA
df8d6029,22,1878,20.9,22,19,0,3,35,24,11,34.5,26.0,8.4,24,FRA
dfc5d4fa,18,1246,13.8,14,11,4,6,28,23,5,20.6,16.7,4.0,24,FRA
e0f3a1f6,23,2014,22.4,23,21,0,0,22,38,-16,24.3,38.1,-13.8,24,FRA
e11a39aa,1,73,0.8,0,0,1,26,1,1,0,0.7,1.3,-0.6,24,FRA
e1df6989,7,363,4.0,4,2,3,1,8,6,2,5.2,4.5,0.7,24,FRA
e2ae54db,20,903,10.0,10,0,10,7,9,14,-5,11.5,11.2,0.3,24,FRA
e33fb79d,22,1437,16.0,17,5,5,1,11,26,-15,15.9,30.6,-14.6,24,FRA
e3a5814e,16,1010,11.2,12,5,4,6,12,21,-9,15.0,21.3,-6.4,24,FRA
e3e32fbb,5,262,2.9,2,2,3,1,3,11,-8,2.2,7.3,-5.0,24,FRA
e42d61c7,21,1674,18.6,18,16,3,2,44,18,26,37.9,23.9,14.0,24,FRA
e43a4083,2,39,0.4,1,0,1,17,0,2,-2,0.2,1.0,-0.7,24,FRA
e4448c8c,7,97,1.1,0,0,7,15,1,0,1,2.5,1.2,1.3,24,FRA
e50623a0,16,1062,11.8,12,9,4,2,10,19,-9,7.9,18.9,-11.0,24,FRA
e546b2e3,25,1769,19.7,22,8,3,2,23,40,-17,18.9,31.1,-12.2,24,FRA
e54a9890,3,76,0.8,1,0,2,6,0,1,-1,1.8,1.0,0.9,24,FRA
e606b6c0,5,39,0.4,0,0,5,9,2,1,1,2.8,1.0,1.8,24,FRA
e768de1f,7,147,1.6,1,0,6,5,0,3,-3,0.3,2.3,-2.0,24,FRA
e76cb9cc,22,1937,21.5,22,20,0,1,36,22,14,34.8,20.0,14.8,24,FRA
e7d59f4f,25,1665,18.5,19,7,6,0,27,19,8,26.6,18.7,7.9,24,FRA
e8a65bc8,24,902,10.0,10,1,14,3,6,20,-14,11.9,19.3,-7.4,24,FRA
e8c5dd4d,26,2340,26.0,26,26,0,0,25,33,-8,26.4,37.3,-10.9,24,FRA
e980e78d,2,6,0.1,0,0,2,7,0,0,0,0.0,0.0,0.0,24,FRA
ea0893d6,13,276,3.1,0,0,13,3,2,4,-2,3.8,6.3,-2.5,24,FRA
eb7822d7,21,1708,19.0,19,13,2,0,22,22,0,25.700000000000003,26.7,-1.0,24,FRA
ecada4fc,2,180,2.0,2,2,0,15,5,3,2,4.1,2.4,1.6,24,FRA
ed45c4a5,10,851,9.5,10,8,0,0,11,12,-1,15.3,7.8,7.5,24,FRA
ed55b838,16,754,8.4,10,0,6,10,9,12,-3,6.9,14.7,-7.8,24,FRA
ed90babd,17,418,4.6,3,1,14,1,10,6,4,11.1,6.9,4.2,24,FRA
ed9f7cfe,14,1235,13.7,14,12,0,1,19,14,5,22.6,12.5,10.1,24,FRA
eda38706,8,238,2.6,2,0,6,0,2,6,-4,3.3,5.4,-2.1,24,FRA
ee158be5,20,1430,15.9,17,6,3,4,16,27,-11,17.4,24.9,-7.5,24,FRA
ee45fd85,15,1262,14.0,15,8,0,3,31,22,9,22.1,17.3,4.8,24,FRA
eedea60b,27,2430,27.0,27,27,0,0,35,36,-1,38.0,33.3,4.7,24,FRA
eef3f9c6,6,110,1.2,1,0,5,8,0,3,-3,0.9,2.6,-1.7,24,FRA
ef7cd87a,24,1848,20.5,22,11,2,0,13,27,-14,19.3,32.6,-13.4,24,FRA
ef9c1c95,26,2244,24.9,25,20,1,0,34,21,13,35.0,21.4,13.6,24,FRA
f00de885,24,2160,24.0,24,24,0,0,29,35,-6,34.0,36.3,-2.3,24,FRA
f02067df,1,14,0.2,0,0,1,0,0,1,-1,0.0,0.0,0.0,24,FRA
f066022d,18,1439,16.0,16,13,2,8,24,37,-13,16.8,28.6,-11.8,24,FRA
f0661424,21,1815,20.2,21,18,0,0,24,29,-5,27.1,33.5,-6.4,24,FRA
f15f8b2b,22,1684,18.7,20,8,2,0,24,26,-2,25.8,23.5,2.2,24,FRA
f18d7ab2,27,2359,26.2,26,26,1,0,19,43,-24,26.7,47.1,-20.4,24,FRA
f20e4cc9,4,118,1.3,0,0,4,0,5,0,5,3.6,0.2,3.4,24,FRA
f28474a4,8,440,4.9,4,2,4,12,5,8,-3,6.7,6.3,0.4,24,FRA
f323d995,15,858,9.5,9,7,6,6,12,12,0,11.9,12.2,-0.3,24,FRA
f365b837,13,751,8.3,7,5,6,9,5,13,-8,6.3,16.7,-10.4,24,FRA
f36d5624,9,380,4.2,4,3,5,2,4,7,-3,5.1,5.7,-0.6,24,FRA
f41a69e6,24,2160,24.0,24,24,0,0,16,41,-25,24.0,43.7,-19.7,24,FRA
f4547573,1,1,0.0,0,0,1,8,0,0,0,0.0,0.0,0.0,24,FRA
f5044e54,25,2225,24.7,25,23,0,0,35,19,16,35.6,25.6,10.0,24,FRA
f527a32c,27,2056,22.8,23,12,4,0,17,34,-17,23.4,38.2,-14.8,24,FRA
f5c8b425,23,1124,12.5,13,2,10,3,18,14,4,16.4,16.2,0.1,24,FRA
f63cda26,22,1014,11.3,11,2,11,3,26,10,16,22.1,13.2,8.9,24,FRA
f6857b4f,3,132,1.5,1,1,2,2,0,2,-2,0.7,3.6,-3.0,24,FRA
f6a3c84d,22,1493,16.6,16,6,6,1,14,25,-11,15.9,24.2,-8.4,24,FRA
f6b94e8d,7,494,5.5,5,5,2,8,7,7,0,7.0,7.4,-0.4,24,FRA
f81ef10d,27,2392,26.6,27,23,0,0,30,40,-10,36.0,41.2,-5.2,24,FRA
f833a830,24,1661,18.5,20,6,4,0,35,23,12,30.3,21.9,8.4,24,FRA
f8342731,8,442,4.9,6,3,2,1,7,6,1,6.5,8.6,-2.1,24,FRA
f8405304,10,438,4.9,5,0,5,0,2,3,-1,5.9,5.4,0.5,24,FRA
f86fe8c1,25,1506,16.7,18,8,7,2,21,23,-2,18.4,23.4,-5.1,24,FRA
f9124307,19,665,7.4,5,1,14,2,8,9,-1,9.2,10.1,-0.9,24,FRA
f999e9be,12,319,3.5,2,0,10,7,4,4,0,6.4,2.7,3.7,24,FRA
f9d5908e,22,1288,14.3,14,7,8,0,14,13,1,20.2,14.6,5.6,24,FRA
faf00ab8,19,866,9.6,9,0,10,6,6,15,-9,12.1,13.6,-1.4,24,FRA
fb14aa28,16,519,5.8,4,0,12,2,5,4,1,11.2,6.8,4.4,24,FRA
fb4c5b6e,10,792,8.8,9,8,1,6,5,12,-7,8.0,11.1,-3.1,24,FRA
fc46aab1,1,16,0.2,0,0,1,0,2,0,2,1.2,0.2,1.0,24,FRA
fc4cf6a7,23,1522,16.9,18,8,5,2,20,19,1,22.9,21.5,1.4,24,FRA
fcb9b1f8,1,45,0.5,0,0,1,4,0,3,-3,0.4,1.2,-0.8,24,FRA
fcc84a07,17,353,3.9,2,1,15,3,6,11,-5,6.7,5.8,1.0,24,FRA
fd2bc67d,26,2303,25.6,26,25,0,0,27,20,7,37.4,26.7,10.7,24,FRA
fe012aca,21,1408,15.6,17,3,4,0,18,12,6,22.1,16.4,5.7,24,FRA
fed17f5a,18,769,8.5,9,0,9,8,16,9,7,14.0,11.7,2.3,24,FRA
ff74841d,22,1980,22.0,22,22,0,5,41,32,9,31.4,26.8,4.6,24,FRA
fffea3e5,2,111,1.2,1,0,1,0,3,1,2,3.5,0.6,2.9,24,FRA
